"prov_code","muni_code","censo","votantes","validos","blancos","nulos","siglas","votos"
24,"24132",615,379,375,1,4,"ALCD",0
47,"47217",1910,1370,1366,1,4,"ALCD",0
47,"47176",219,139,139,1,0,"ALCD",0
47,"47038",105,77,77,0,0,"ALCD",1
24,"24157",2568,1943,1911,22,32,"ALCD",1
24,"24018",174,143,141,0,2,"ALCD",0
47,"47091",84,71,71,2,0,"ALCD",0
47,"47175",6564,4781,4728,39,53,"ALCD",2
24,"24158",320,207,203,2,4,"ALCD",0
24,"24224",616,454,451,4,3,"ALCD",1
24,"24031",215,172,168,0,4,"ALCD",0
24,"24215",152,113,113,0,0,"ALCD",0
47,"47069",124,105,104,1,1,"ALCD",0
47,"47152",78,60,60,0,0,"ALCD",0
24,"24029",735,539,535,3,4,"ALCD",0
47,"47215",53,45,45,0,0,"ALCD",0
24,"24063",374,254,252,2,2,"ALCD",0
24,"24004",463,350,348,4,2,"ALCD",0
24,"24053",442,286,280,1,6,"ALCD",0
47,"47143",118,91,90,0,1,"ALCD",0
47,"47178",172,140,140,3,0,"ALCD",0
47,"47062",163,130,130,0,0,"ALCD",0
24,"24099",171,132,132,0,0,"ALCD",0
47,"47232",102,77,74,1,3,"ALCD",0
24,"24095",320,234,232,0,2,"ALCD",0
24,"24131",724,511,507,3,4,"ALCD",1
47,"47090",2418,1728,1699,8,29,"ALCD",0
24,"24079",906,664,658,9,6,"ALCD",0
47,"47191",108,79,79,0,0,"ALCD",0
24,"24091",645,454,451,1,3,"ALCD",0
47,"47222",83,64,64,1,0,"ALCD",0
47,"47084",1150,887,870,7,17,"ALCD",0
47,"47061",256,212,211,2,1,"ALCD",0
47,"47115",281,236,233,3,3,"ALCD",0
24,"24069",41,35,35,0,0,"ALCD",0
47,"47197",876,673,668,8,5,"ALCD",0
24,"24202",8008,5367,5276,53,91,"ALCD",0
47,"47125",58,46,46,0,0,"ALCD",0
24,"24040",449,329,325,2,4,"ALCD",0
24,"24191",108,79,79,0,0,"ALCD",0
24,"24219",516,387,386,4,1,"ALCD",0
47,"47087",381,301,297,3,4,"ALCD",0
47,"47100",138,117,117,1,0,"ALCD",0
24,"24025",297,228,227,0,1,"ALCD",0
24,"24174",486,343,342,4,1,"ALCD",0
24,"24066",494,368,366,4,2,"ALCD",0
47,"47145",603,448,441,3,7,"ALCD",0
24,"24023",263,188,188,1,0,"ALCD",0
24,"24137",1099,783,778,7,5,"ALCD",0
47,"47209",41,34,34,0,0,"ALCD",0
47,"47026",46,40,40,1,0,"ALCD",0
24,"24161",285,203,201,3,2,"ALCD",0
47,"47203",62,53,53,1,0,"ALCD",0
24,"24011",203,133,132,0,1,"ALCD",0
47,"47099",150,135,135,1,0,"ALCD",0
24,"24110",1247,899,892,6,7,"ALCD",0
47,"47156",162,136,133,0,3,"ALCD",0
47,"47188",111,88,88,3,0,"ALCD",0
47,"47015",200,162,160,0,2,"ALCD",0
47,"47181",165,135,132,3,3,"ALCD",0
47,"47082",812,640,628,8,12,"ALCD",1
47,"47216",115,91,87,0,4,"ALCD",0
47,"47097",325,266,265,0,1,"ALCD",1
24,"24059",880,536,535,4,1,"ALCD",0
24,"24032",109,91,89,0,2,"ALCD",0
47,"47163",290,230,228,3,2,"ALCD",0
24,"24030",4277,3038,3007,11,31,"ALCD",1
24,"24182",416,294,290,2,4,"ALCD",1
24,"24102",652,470,467,2,3,"ALCD",0
24,"24007",773,550,548,4,2,"ALCD",0
24,"24152",464,295,291,1,4,"ALCD",0
47,"47081",45,36,35,1,1,"ALCD",0
47,"47204",256,204,198,0,6,"ALCD",0
24,"24020",456,314,307,4,7,"ALCD",0
47,"47221",111,94,94,0,0,"ALCD",0
47,"47043",297,239,237,0,2,"ALCD",0
47,"47142",141,99,97,0,2,"ALCD",0
47,"47116",416,341,339,0,2,"ALCD",0
47,"47187",84,61,58,0,3,"ALCD",0
47,"47093",813,613,600,5,13,"ALCD",0
24,"24199",424,302,301,0,1,"ALCD",0
24,"24008",9282,6685,6603,52,82,"ALCD",5
47,"47158",889,667,659,8,8,"ALCD",0
47,"47123",466,354,352,4,2,"ALCD",0
47,"47067",174,127,126,0,1,"ALCD",0
24,"24080",213,164,161,3,3,"ALCD",0
24,"24092",798,606,602,1,4,"ALCD",0
47,"47153",108,77,77,0,0,"ALCD",0
47,"47058",200,145,143,0,2,"ALCD",1
47,"47223",157,122,118,2,4,"ALCD",0
24,"24170",1908,1365,1345,8,20,"ALCD",0
24,"24902",347,270,269,2,1,"ALCD",0
47,"47199",80,63,63,0,0,"ALCD",0
47,"47150",274,209,205,0,4,"ALCD",0
47,"47032",152,117,116,1,1,"ALCD",0
24,"24207",294,241,238,3,3,"ALCD",1
47,"47162",74,60,60,0,0,"ALCD",0
47,"47016",69,56,55,0,1,"ALCD",0
47,"47024",259,208,207,1,1,"ALCD",0
24,"24133",356,257,257,1,0,"ALCD",0
47,"47066",1268,981,977,12,4,"ALCD",0
24,"24156",239,159,158,1,1,"ALCD",0
24,"24154",1005,673,666,4,7,"ALCD",4
47,"47106",50,39,39,0,0,"ALCD",0
24,"24167",750,505,499,4,6,"ALCD",0
47,"47035",921,717,715,3,2,"ALCD",0
24,"24086",270,223,218,0,5,"ALCD",0
47,"47166",259,204,197,2,7,"ALCD",0
24,"24051",423,309,307,0,2,"ALCD",0
24,"24065",2138,1503,1472,15,31,"ALCD",0
24,"24176",316,247,244,1,3,"ALCD",0
24,"24116",417,314,309,1,5,"ALCD",0
24,"24062",139,98,98,1,0,"ALCD",0
24,"24074",97,75,75,1,0,"ALCD",0
47,"47213",109,82,82,0,0,"ALCD",0
47,"47110",450,350,346,1,4,"ALCD",0
47,"47190",98,80,80,1,0,"ALCD",0
24,"24009",322,153,152,2,1,"ALCD",0
24,"24015",2265,1649,1635,18,14,"ALCD",0
47,"47149",42,34,34,3,0,"ALCD",0
47,"47020",280,234,231,2,3,"ALCD",0
47,"47011",565,461,458,5,3,"ALCD",0
47,"47206",92,80,80,0,0,"ALCD",0
47,"47063",103,81,80,1,1,"ALCD",1
24,"24177",476,325,322,3,3,"ALCD",0
47,"47103",267,197,192,5,5,"ALCD",0
47,"47076",17399,13097,12972,92,125,"ALCD",4
47,"47229",210,148,147,1,1,"ALCD",0
24,"24164",370,218,217,0,1,"ALCD",0
24,"24121",645,492,487,1,5,"ALCD",0
47,"47008",24,19,19,1,0,"ALCD",0
24,"24189",5865,3933,3885,31,48,"ALCD",2
47,"47073",122,103,101,1,2,"ALCD",0
47,"47009",107,86,85,0,1,"ALCD",0
47,"47052",6576,4988,4944,40,44,"ALCD",1
24,"24185",474,357,350,3,7,"ALCD",0
47,"47174",267,218,215,1,3,"ALCD",0
47,"47225",80,63,63,0,0,"ALCD",0
24,"24002",231,173,172,1,1,"ALCD",0
47,"47041",150,112,110,2,2,"ALCD",0
47,"47126",50,41,41,0,0,"ALCD",0
24,"24058",208,155,154,3,1,"ALCD",0
24,"24163",3962,2950,2933,24,17,"ALCD",0
24,"24097",218,140,139,3,1,"ALCD",0
24,"24047",783,545,540,2,5,"ALCD",1
47,"47094",133,115,114,1,1,"ALCD",0
24,"24183",805,555,549,6,6,"ALCD",0
47,"47054",635,507,495,9,12,"ALCD",0
47,"47133",2682,2033,2015,16,18,"ALCD",0
24,"24227",1607,1127,1116,22,11,"ALCD",0
47,"47010",13729,10549,10454,81,95,"ALCD",0
24,"24205",945,694,685,11,9,"ALCD",2
24,"24122",1342,930,924,8,6,"ALCD",0
47,"47208",58,38,36,1,2,"ALCD",0
24,"24107",236,175,173,0,2,"ALCD",0
24,"24103",283,163,157,1,6,"ALCD",0
24,"24145",654,463,461,2,2,"ALCD",0
24,"24214",656,490,485,3,5,"ALCD",0
24,"24221",795,543,538,7,5,"ALCD",0
24,"24019",354,272,267,3,5,"ALCD",0
47,"47193",1577,1251,1241,7,10,"ALCD",1
47,"47031",189,145,145,1,0,"ALCD",0
47,"47037",168,138,133,0,5,"ALCD",0
47,"47134",165,128,125,1,3,"ALCD",0
47,"47173",880,644,638,20,6,"ALCD",0
47,"47185",99,73,71,0,2,"ALCD",0
24,"24078",380,289,277,0,12,"ALCD",0
47,"47146",255,206,204,1,2,"ALCD",1
47,"47184",573,453,451,1,2,"ALCD",0
47,"47049",101,68,68,0,0,"ALCD",0
24,"24071",1006,745,734,10,11,"ALCD",0
24,"24171",356,197,196,0,1,"ALCD",0
24,"24168",460,361,359,0,2,"ALCD",0
47,"47080",30,22,21,0,1,"ALCD",0
24,"24178",70,59,58,0,1,"ALCD",0
47,"47012",113,93,93,0,0,"ALCD",0
24,"24229",418,322,319,2,3,"ALCD",0
47,"47074",149,117,116,2,1,"ALCD",0
47,"47056",87,67,67,0,0,"ALCD",0
47,"47018",34,28,28,0,0,"ALCD",0
24,"24143",510,358,349,0,9,"ALCD",0
24,"24198",592,412,407,2,5,"ALCD",0
24,"24201",1090,762,759,10,3,"ALCD",0
47,"47164",378,313,311,1,2,"ALCD",0
47,"47200",85,66,66,0,0,"ALCD",0
47,"47092",110,87,87,0,0,"ALCD",0
24,"24083",1042,727,715,6,12,"ALCD",1
47,"47039",185,141,140,0,1,"ALCD",0
24,"24190",165,123,121,1,2,"ALCD",0
47,"47140",115,102,102,1,0,"ALCD",1
24,"24115",54058,37780,37357,308,423,"ALCD",14
24,"24039",2063,1597,1596,41,1,"ALCD",0
47,"47205",384,266,260,0,6,"ALCD",0
47,"47002",23,21,20,1,1,"ALCD",0
47,"47057",268,197,196,0,1,"ALCD",0
24,"24142",25119,17336,17141,154,195,"ALCD",4
24,"24175",1832,1314,1297,14,17,"ALCD",0
24,"24901",889,636,623,5,13,"ALCD",1
47,"47088",103,86,85,1,1,"ALCD",0
24,"24180",1134,812,800,9,12,"ALCD",0
24,"24153",232,179,177,2,2,"ALCD",0
47,"47006",190,136,135,1,1,"ALCD",0
47,"47040",64,53,53,0,0,"ALCD",0
47,"47198",69,50,50,0,0,"ALCD",0
24,"24106",248,167,166,1,1,"ALCD",0
47,"47230",303,246,242,2,4,"ALCD",1
47,"47102",291,230,220,1,10,"ALCD",0
47,"47179",395,293,287,0,6,"ALCD",0
24,"24028",388,292,288,2,4,"ALCD",0
24,"24196",2057,1502,1485,9,17,"ALCD",1
24,"24070",4124,3024,2981,20,43,"ALCD",0
47,"47132",45,36,33,1,3,"ALCD",0
24,"24096",117,80,79,1,1,"ALCD",0
47,"47147",116,92,92,0,0,"ALCD",0
47,"47210",382,282,274,3,8,"ALCD",0
24,"24118",126,88,88,1,0,"ALCD",0
24,"24222",14256,9996,9884,101,112,"ALCD",0
24,"24026",1177,864,849,7,15,"ALCD",0
47,"47194",298,239,237,2,2,"ALCD",0
24,"24017",577,426,418,1,8,"ALCD",0
24,"24101",397,258,257,3,1,"ALCD",0
47,"47207",278,215,212,3,3,"ALCD",0
24,"24216",723,522,518,1,4,"ALCD",2
47,"47111",1020,742,732,7,10,"ALCD",0
24,"24076",1277,956,947,4,9,"ALCD",0
24,"24162",1683,1257,1246,13,11,"ALCD",0
24,"24179",290,197,192,4,5,"ALCD",0
24,"24021",1675,1162,1144,8,18,"ALCD",0
47,"47220",165,130,129,0,1,"ALCD",0
24,"24108",376,280,277,2,3,"ALCD",0
47,"47025",120,94,94,1,0,"ALCD",0
47,"47078",163,127,125,1,2,"ALCD",0
47,"47137",29,25,25,1,0,"ALCD",0
47,"47048",188,144,144,1,0,"ALCD",0
47,"47112",2587,2015,1988,7,27,"ALCD",2
47,"47224",87,76,76,0,0,"ALCD",0
47,"47005",549,413,408,2,5,"ALCD",1
24,"24077",225,190,187,2,3,"ALCD",0
24,"24149",152,120,116,3,4,"ALCD",0
47,"47122",2032,1563,1535,7,28,"ALCD",0
47,"47214",1409,1087,1062,7,25,"ALCD",1
24,"24055",708,516,512,0,4,"ALCD",1
47,"47118",168,127,127,2,0,"ALCD",0
24,"24197",763,538,533,1,5,"ALCD",0
24,"24073",478,332,328,2,4,"ALCD",0
47,"47144",78,64,64,1,0,"ALCD",0
24,"24056",2883,2040,2003,11,37,"ALCD",1
47,"47212",380,323,322,2,1,"ALCD",0
47,"47104",2836,2182,2121,19,61,"ALCD",0
47,"47029",57,52,52,0,0,"ALCD",0
47,"47119",92,80,79,1,1,"ALCD",0
24,"24206",1700,1253,1240,12,13,"ALCD",1
24,"24226",199,139,137,0,2,"ALCD",0
24,"24057",1373,1045,1023,11,22,"ALCD",0
24,"24090",343,235,233,1,2,"ALCD",0
47,"47196",34,27,27,0,0,"ALCD",0
47,"47021",76,64,64,0,0,"ALCD",0
47,"47139",1040,777,767,6,10,"ALCD",2
24,"24046",942,637,633,5,4,"ALCD",1
47,"47070",37,27,27,0,0,"ALCD",0
47,"47071",410,324,321,4,3,"ALCD",0
47,"47085",16612,11829,11706,114,123,"ALCD",3
47,"47013",100,82,81,1,1,"ALCD",0
24,"24064",1523,1101,1087,3,14,"ALCD",0
47,"47075",4856,3681,3637,24,44,"ALCD",1
47,"47157",515,424,423,1,1,"ALCD",0
47,"47065",857,674,669,1,5,"ALCD",0
47,"47171",407,303,301,6,2,"ALCD",0
24,"24088",1029,791,789,10,2,"ALCD",0
47,"47109",179,138,138,2,0,"ALCD",0
24,"24014",7425,5124,5053,32,71,"ALCD",1
24,"24159",1806,1386,1366,6,20,"ALCD",1
24,"24141",95,85,84,0,1,"ALCD",2
24,"24042",63,56,56,1,0,"ALCD",0
47,"47034",72,58,58,3,0,"ALCD",0
24,"24225",1014,752,739,10,13,"ALCD",0
47,"47096",140,110,110,0,0,"ALCD",0
24,"24081",140,98,92,0,6,"ALCD",0
24,"24173",951,679,674,9,5,"ALCD",2
47,"47169",68,59,59,0,0,"ALCD",0
47,"47195",459,345,344,4,1,"ALCD",0
47,"47138",241,170,164,1,6,"ALCD",0
47,"47014",51,45,45,0,0,"ALCD",0
24,"24036",288,184,184,2,0,"ALCD",0
24,"24184",198,118,117,0,1,"ALCD",0
24,"24228",660,430,422,6,8,"ALCD",0
47,"47155",3228,2277,2254,18,23,"ALCD",1
47,"47170",33,28,27,2,1,"ALCD",0
24,"24067",623,388,384,0,4,"ALCD",0
24,"24120",341,246,244,1,2,"ALCD",0
47,"47141",134,111,110,0,1,"ALCD",0
24,"24022",330,230,229,0,1,"ALCD",0
24,"24005",378,260,257,2,3,"ALCD",0
24,"24193",378,268,265,2,3,"ALCD",0
47,"47130",96,72,72,0,0,"ALCD",0
47,"47117",301,233,227,2,6,"ALCD",0
47,"47113",159,129,128,0,1,"ALCD",0
47,"47219",41,36,34,0,2,"ALCD",0
24,"24139",2183,1548,1525,16,23,"ALCD",0
47,"47030",993,766,751,6,15,"ALCD",0
24,"24165",354,240,238,2,2,"ALCD",0
24,"24146",265,210,207,1,3,"ALCD",0
24,"24061",1704,1213,1204,9,9,"ALCD",0
47,"47183",130,106,105,0,1,"ALCD",0
47,"47077",246,193,191,1,2,"ALCD",0
47,"47168",29,26,26,1,0,"ALCD",0
24,"24104",259,169,169,0,0,"ALCD",0
24,"24010",8386,5708,5632,60,76,"ALCD",5
47,"47045",763,575,567,1,8,"ALCD",1
24,"24187",857,603,593,7,10,"ALCD",1
47,"47177",105,76,73,1,3,"ALCD",0
24,"24203",95,69,68,0,1,"ALCD",0
24,"24166",1407,1013,993,8,20,"ALCD",0
24,"24123",746,488,485,2,3,"ALCD",0
47,"47047",199,157,156,2,1,"ALCD",0
47,"47161",3918,3145,3126,12,19,"ALCD",0
47,"47023",2995,2344,2326,18,18,"ALCD",0
47,"47022",59,50,49,0,1,"ALCD",0
24,"24043",134,75,75,1,0,"ALCD",0
24,"24113",366,293,287,5,6,"ALCD",0
24,"24181",1493,1054,1045,5,9,"ALCD",0
47,"47001",55,46,46,0,0,"ALCD",0
24,"24129",122,89,89,1,0,"ALCD",0
47,"47167",241,204,204,1,0,"ALCD",0
24,"24044",168,119,118,1,1,"ALCD",0
24,"24210",503,358,356,3,2,"ALCD",1
47,"47131",170,134,128,2,6,"ALCD",0
24,"24160",684,483,474,6,9,"ALCD",0
47,"47124",392,316,311,3,5,"ALCD",0
47,"47003",227,180,179,3,1,"ALCD",0
47,"47105",183,158,156,0,2,"ALCD",0
47,"47129",871,664,659,4,5,"ALCD",5
24,"24217",135,109,108,1,1,"ALCD",0
47,"47007",3769,2765,2736,24,29,"ALCD",3
24,"24223",2610,1917,1908,39,9,"ALCD",3
47,"47083",80,59,54,1,5,"ALCD",0
24,"24124",367,244,233,3,11,"ALCD",0
47,"47036",228,181,181,3,0,"ALCD",0
47,"47165",6955,4955,4303,66,652,"ALCD",12
24,"24130",438,323,321,4,2,"ALCD",0
24,"24050",102,77,76,0,1,"ALCD",0
47,"47046",118,92,90,1,2,"ALCD",0
24,"24006",472,353,347,0,6,"ALCD",0
24,"24212",1032,773,760,4,13,"ALCD",0
24,"24194",290,212,212,3,0,"ALCD",0
24,"24105",1459,1042,1025,16,17,"ALCD",0
47,"47017",201,158,153,1,5,"ALCD",0
24,"24049",1483,1054,1048,6,6,"ALCD",0
24,"24119",706,488,481,3,7,"ALCD",0
47,"47226",156,123,123,0,0,"ALCD",0
24,"24052",158,104,102,0,2,"ALCD",0
47,"47135",83,72,72,2,0,"ALCD",0
47,"47089",148,125,124,0,1,"ALCD",0
47,"47172",144,124,122,0,2,"ALCD",0
24,"24151",478,353,352,1,1,"ALCD",0
24,"24037",360,254,250,2,4,"ALCD",0
24,"24213",150,122,122,1,0,"ALCD",0
24,"24109",977,633,624,3,9,"ALCD",0
24,"24098",1193,842,831,11,11,"ALCD",0
24,"24150",243,172,172,6,0,"ALCD",1
24,"24127",296,226,215,4,11,"ALCD",0
24,"24093",360,249,248,2,1,"ALCD",1
47,"47044",331,293,290,2,3,"ALCD",0
47,"47027",2745,2036,2018,9,18,"ALCD",3
47,"47068",34,26,26,0,0,"ALCD",0
24,"24117",434,334,331,1,3,"ALCD",0
24,"24060",602,363,361,3,2,"ALCD",0
24,"24084",163,116,116,0,0,"ALCD",0
24,"24016",466,270,269,1,1,"ALCD",0
24,"24089",102747,74428,73688,631,740,"ALCD",19
24,"24082",858,629,614,8,15,"ALCD",1
24,"24114",3061,2025,1994,9,31,"ALCD",0
47,"47059",97,76,76,2,0,"ALCD",0
47,"47060",258,216,214,1,2,"ALCD",0
24,"24068",457,344,340,0,4,"ALCD",0
47,"47028",33,21,21,0,0,"ALCD",0
24,"24034",3394,2380,2342,28,38,"ALCD",0
24,"24136",540,387,383,4,4,"ALCD",0
47,"47227",61,50,50,0,0,"ALCD",0
24,"24169",2969,2140,2118,13,22,"ALCD",1
47,"47064",33,28,25,0,3,"ALCD",0
47,"47055",203,167,163,0,4,"ALCD",0
47,"47042",54,37,37,0,0,"ALCD",0
24,"24134",3416,2470,2417,19,53,"ALCD",1
47,"47095",38,31,31,0,0,"ALCD",0
47,"47051",335,268,263,2,5,"ALCD",0
47,"47121",544,437,425,6,12,"ALCD",0
47,"47033",196,154,154,1,0,"ALCD",0
47,"47218",993,743,734,2,9,"ALCD",0
24,"24033",205,158,157,0,1,"ALCD",0
47,"47180",73,61,60,4,1,"ALCD",0
47,"47189",152,119,118,0,1,"ALCD",0
24,"24112",309,228,227,1,1,"ALCD",0
24,"24024",692,496,491,4,5,"ALCD",0
24,"24148",1672,1249,1241,23,8,"ALCD",1
47,"47101",1710,1357,1336,16,21,"ALCD",0
24,"24100",761,561,555,7,6,"ALCD",1
24,"24209",2769,1888,1865,12,23,"ALCD",1
47,"47128",60,52,51,0,1,"ALCD",0
47,"47192",102,83,81,1,2,"ALCD",0
47,"47186",246129,186191,184733,1198,1458,"ALCD",59
47,"47148",442,342,338,2,4,"ALCD",0
24,"24054",430,314,313,1,1,"ALCD",0
47,"47053",119,98,96,0,2,"ALCD",0
47,"47098",576,464,452,4,12,"ALCD",1
47,"47114",4045,2787,2762,26,25,"ALCD",1
24,"24003",648,460,453,7,7,"ALCD",0
24,"24218",451,330,325,2,5,"ALCD",0
47,"47079",58,48,47,0,1,"ALCD",0
47,"47159",822,644,636,1,8,"ALCD",0
24,"24188",3822,2850,2817,19,33,"ALCD",3
24,"24087",631,470,466,7,4,"ALCD",0
47,"47211",47,35,34,0,1,"ALCD",0
47,"47127",137,98,97,0,1,"ALCD",0
24,"24230",426,322,320,5,2,"ALCD",0
47,"47154",152,128,125,1,3,"ALCD",0
24,"24038",3089,2312,2273,17,39,"ALCD",0
47,"47050",3719,2630,2598,26,32,"ALCD",0
24,"24027",1211,863,847,8,16,"ALCD",1
47,"47228",440,331,331,2,0,"ALCD",0
24,"24001",189,124,122,0,2,"ALCD",0
47,"47004",1181,939,930,7,9,"ALCD",1
24,"24211",272,205,205,2,0,"ALCD",0
47,"47019",85,74,73,0,1,"ALCD",0
47,"47086",3906,2970,2936,24,34,"ALCD",0
47,"47182",1323,977,967,8,10,"ALCD",0
24,"24094",1385,983,968,11,15,"ALCD",1
24,"24012",290,207,205,1,2,"ALCD",0
24,"24041",538,367,366,3,1,"ALCD",0
24,"24125",462,290,286,4,4,"ALCD",0
24,"24155",471,388,384,6,4,"ALCD",0
24,"24144",695,470,465,2,5,"ALCD",2
47,"47231",4401,3299,3277,24,22,"ALCD",0
24,"24172",418,255,250,2,5,"ALCD",0
47,"47160",425,308,303,0,5,"ALCD",0
47,"47151",27,24,24,0,0,"ALCD",0
29,"29036",632,423,416,2,7,"AND",0
14,"14050",2391,1822,1787,14,35,"AND",0
29,"29010",1651,1278,1237,4,41,"AND",0
14,"14025",2924,2466,2422,14,44,"AND",0
29,"29903",524,353,349,3,4,"AND",0
29,"29017",6553,4744,4668,33,76,"AND",11
29,"29058",1450,911,894,4,17,"AND",1
29,"29006",673,428,420,1,8,"AND",0
29,"29014",217,141,140,4,1,"AND",0
14,"14015",2125,1579,1554,10,25,"AND",3
29,"29081",261,197,197,1,0,"AND",0
14,"14062",1025,806,792,6,14,"AND",0
14,"14068",538,401,398,10,3,"AND",0
29,"29089",3228,2377,2321,10,56,"AND",1
29,"29055",1796,1354,1336,11,18,"AND",2
14,"14043",7574,5515,5443,81,72,"AND",3
29,"29080",6676,4469,4419,35,50,"AND",5
14,"14054",13697,10315,10109,93,206,"AND",6
14,"14031",593,469,459,3,10,"AND",0
14,"14009",2788,1852,1834,20,18,"AND",0
29,"29021",161,108,107,4,1,"AND",0
29,"29054",41997,28422,28238,189,184,"AND",34
29,"29043",2509,1608,1576,18,32,"AND",2
29,"29099",950,693,685,4,8,"AND",1
29,"29009",1468,1069,1045,8,24,"AND",0
14,"14055",18557,12950,12764,178,186,"AND",32
29,"29003",983,754,743,1,11,"AND",1
14,"14056",23581,16120,15958,143,162,"AND",67
14,"14034",308,247,244,2,3,"AND",0
29,"29077",199,149,146,2,3,"AND",0
14,"14024",1903,1405,1376,16,29,"AND",2
29,"29011",2900,1822,1803,9,19,"AND",1
29,"29095",3321,2376,2307,24,69,"AND",5
14,"14012",6173,4364,4291,35,73,"AND",7
29,"29072",3262,2382,2352,17,30,"AND",0
14,"14021",260178,181773,180348,1872,1425,"AND",187
29,"29068",7016,4300,4244,35,56,"AND",4
29,"29029",403,298,294,2,4,"AND",0
29,"29100",2433,1684,1667,5,17,"AND",3
14,"14065",1850,1384,1377,16,7,"AND",2
29,"29039",2666,1898,1873,22,25,"AND",2
29,"29096",2810,1944,1909,31,35,"AND",1
14,"14049",16309,11635,11515,115,120,"AND",23
14,"14003",1248,939,930,2,9,"AND",2
14,"14061",744,595,582,1,13,"AND",0
29,"29051",40391,25780,25419,232,361,"AND",22
29,"29092",570,397,390,4,7,"AND",0
29,"29085",144,109,108,0,1,"AND",0
14,"14074",2299,1896,1866,16,30,"AND",0
29,"29050",421,306,302,3,4,"AND",0
14,"14019",6464,4967,4909,49,58,"AND",4
29,"29020",3267,2408,2359,16,49,"AND",4
29,"29073",1579,1091,1080,7,11,"AND",0
14,"14044",1604,1172,1165,7,7,"AND",0
29,"29038",17676,11056,10970,141,86,"AND",22
29,"29026",1057,751,748,5,3,"AND",1
14,"14071",929,642,630,2,12,"AND",1
29,"29047",1117,885,866,1,19,"AND",1
29,"29904",421,338,335,3,3,"AND",0
14,"14040",3776,2873,2833,32,40,"AND",2
29,"29065",187,137,136,0,1,"AND",0
29,"29086",793,470,470,3,0,"AND",0
29,"29042",14016,9368,9192,88,176,"AND",21
14,"14005",6311,4143,4084,72,59,"AND",3
14,"14029",4178,3047,3009,28,38,"AND",5
14,"14013",16796,11830,11616,129,214,"AND",17
14,"14027",7925,5836,5746,58,90,"AND",4
29,"29025",39665,25907,25714,192,193,"AND",42
29,"29022",179,137,136,0,1,"AND",0
29,"29032",6657,5031,4977,33,54,"AND",6
14,"14010",4027,2850,2807,19,43,"AND",2
29,"29070",40333,25991,25728,214,263,"AND",68
29,"29091",8957,6186,6078,56,108,"AND",6
29,"29035",1567,1157,1144,11,13,"AND",1
29,"29062",654,551,545,2,6,"AND",1
14,"14037",3318,2374,2320,22,54,"AND",2
14,"14038",32322,22117,21887,179,230,"AND",22
14,"14047",1672,1187,1178,14,9,"AND",0
14,"14018",3709,2697,2653,26,44,"AND",7
29,"29053",1699,1105,1091,14,14,"AND",5
29,"29064",503,348,339,8,9,"AND",0
14,"14032",423,334,330,4,4,"AND",0
14,"14035",5966,4236,4177,39,59,"AND",2
29,"29024",386,227,219,2,8,"AND",1
29,"29052",224,144,144,3,0,"AND",0
14,"14006",1330,1120,1101,8,19,"AND",1
29,"29902",2567,1577,1559,11,18,"AND",2
14,"14011",578,464,462,4,2,"AND",0
14,"14067",3889,2946,2899,29,47,"AND",1
14,"14072",1048,806,795,6,11,"AND",0
29,"29087",376,270,266,1,4,"AND",1
14,"14070",1332,986,974,10,12,"AND",0
14,"14057",6136,4713,4631,47,82,"AND",5
14,"14026",2067,1424,1405,4,19,"AND",1
14,"14058",7970,5491,5417,66,74,"AND",8
29,"29045",1684,1178,1168,8,10,"AND",0
14,"14053",6006,4285,4232,49,53,"AND",80
14,"14002",10951,7706,7620,83,86,"AND",4
29,"29028",1237,836,826,6,10,"AND",0
29,"29069",85684,54130,53621,455,509,"AND",72
14,"14052",9379,5917,5854,68,63,"AND",8
29,"29061",1016,798,769,8,29,"AND",3
29,"29002",1177,804,789,5,15,"AND",0
14,"14039",2604,2062,2021,12,41,"AND",0
14,"14042",18891,14051,13848,190,203,"AND",21
29,"29066",334,234,233,4,1,"AND",0
14,"14001",3514,2837,2789,28,48,"AND",1
14,"14059",690,533,528,4,5,"AND",1
29,"29090",1688,1144,1134,15,10,"AND",2
29,"29079",2416,1788,1764,10,24,"AND",0
14,"14022",4006,2977,2949,17,28,"AND",0
29,"29060",692,510,508,1,2,"AND",0
14,"14028",314,253,249,1,4,"AND",0
29,"29015",31880,22220,21952,190,268,"AND",23
29,"29097",4108,2871,2821,37,50,"AND",3
29,"29082",31885,22572,22400,152,172,"AND",32
29,"29013",1610,1238,1207,9,31,"AND",3
29,"29094",57554,38071,37696,339,375,"AND",43
29,"29031",1614,1107,1094,13,13,"AND",2
14,"14036",3740,2747,2696,24,51,"AND",3
29,"29098",1253,917,895,9,22,"AND",0
29,"29033",1122,747,730,4,17,"AND",0
29,"29901",43826,29318,29107,250,211,"AND",49
29,"29023",2081,1354,1340,4,14,"AND",2
29,"29088",2714,1829,1800,12,29,"AND",1
29,"29057",357,241,238,1,3,"AND",0
29,"29046",2675,1825,1807,14,18,"AND",1
29,"29071",934,596,588,3,8,"AND",0
14,"14064",320,242,236,2,6,"AND",0
14,"14017",10868,7764,7665,71,99,"AND",7
14,"14020",387,269,264,2,5,"AND",0
29,"29007",27491,19071,18910,153,161,"AND",27
14,"14007",15207,10558,10417,82,141,"AND",8
29,"29030",805,620,614,4,6,"AND",1
29,"29084",27359,17843,17627,176,216,"AND",19
14,"14014",2557,2035,2007,9,28,"AND",1
29,"29044",809,561,561,3,0,"AND",1
29,"29008",14596,9519,9407,94,112,"AND",12
29,"29063",323,250,245,1,5,"AND",1
14,"14045",3052,2362,2335,11,27,"AND",2
14,"14004",2034,1531,1518,14,13,"AND",0
29,"29034",467,358,356,0,2,"AND",0
29,"29001",4170,3106,3068,19,38,"AND",3
29,"29040",1977,1290,1278,12,12,"AND",5
29,"29076",2153,1390,1360,10,30,"AND",2
29,"29012",9755,6689,6599,71,90,"AND",6
29,"29018",2010,1472,1420,9,52,"AND",1
29,"29083",2107,1540,1512,9,28,"AND",1
14,"14008",2839,1905,1895,19,10,"AND",2
14,"14033",1283,971,959,9,12,"AND",3
29,"29027",2326,1626,1609,12,17,"AND",1
14,"14060",4868,3473,3412,41,61,"AND",10
14,"14046",4485,3268,3208,33,60,"AND",1
14,"14073",2891,2079,2016,13,63,"AND",0
29,"29049",2962,2132,2110,5,22,"AND",5
29,"29004",312,236,233,2,3,"AND",0
14,"14066",5856,4150,4095,48,55,"AND",4
29,"29041",3175,2090,2045,24,45,"AND",1
14,"14041",3182,2296,2251,33,45,"AND",1
29,"29019",878,652,636,3,16,"AND",0
29,"29075",12934,8234,8147,69,87,"AND",12
14,"14063",1046,734,725,2,9,"AND",0
14,"14075",572,448,428,1,20,"AND",0
14,"14016",1337,1072,1060,2,12,"AND",0
29,"29037",209,158,157,1,1,"AND",0
29,"29016",251,188,188,1,0,"AND",0
14,"14030",8625,6248,6181,53,67,"AND",13
14,"14051",1397,1018,1000,2,18,"AND",0
14,"14069",7524,5460,5392,43,68,"AND",2
14,"14048",1207,884,869,13,15,"AND",6
29,"29093",2214,1643,1621,3,22,"AND",0
29,"29005",4358,2859,2817,28,42,"AND",10
29,"29074",794,586,581,0,5,"AND",0
29,"29067",424813,286785,284689,2351,2096,"AND",474
14,"14023",2021,1660,1639,8,21,"AND",0
29,"29059",2587,1965,1922,14,43,"AND",1
29,"29048",1405,1121,1110,8,11,"AND",1
29,"29056",1098,757,750,5,7,"AND",0
32,"32044",876,643,634,2,9,"BNG-NÓS",13
36,"36031",558,465,459,7,6,"BNG-NÓS",27
32,"32038",436,278,271,2,7,"BNG-NÓS",3
32,"32084",918,641,635,3,6,"BNG-NÓS",18
27,"27010",4327,2899,2837,53,62,"BNG-NÓS",81
15,"15901",3546,2247,2228,24,19,"BNG-NÓS",50
15,"15028",1409,1038,1024,6,14,"BNG-NÓS",107
15,"15074",4037,2841,2796,20,45,"BNG-NÓS",90
32,"32088",1622,1018,1002,8,16,"BNG-NÓS",13
32,"32083",835,559,550,4,9,"BNG-NÓS",4
27,"27039",4358,3143,3085,40,58,"BNG-NÓS",157
27,"27046",1530,1022,1007,9,15,"BNG-NÓS",34
32,"32090",774,530,511,4,19,"BNG-NÓS",55
32,"32073",1315,973,960,5,13,"BNG-NÓS",18
32,"32014",1142,848,834,6,14,"BNG-NÓS",11
15,"15060",5772,4032,3958,46,74,"BNG-NÓS",92
27,"27045",1038,613,603,10,10,"BNG-NÓS",3
15,"15902",4598,3209,3149,51,60,"BNG-NÓS",55
15,"15083",1086,757,746,5,11,"BNG-NÓS",57
27,"27038",935,679,671,7,8,"BNG-NÓS",3
15,"15032",3444,2322,2269,30,53,"BNG-NÓS",45
32,"32070",548,335,329,3,6,"BNG-NÓS",4
32,"32024",4821,3320,3254,34,66,"BNG-NÓS",77
36,"36017",17782,12411,12240,117,171,"BNG-NÓS",395
27,"27025",2831,2152,2110,17,42,"BNG-NÓS",89
36,"36007",1672,1119,1099,8,20,"BNG-NÓS",15
27,"27002",1633,1137,1108,9,29,"BNG-NÓS",23
32,"32002",2017,1413,1398,16,15,"BNG-NÓS",25
15,"15053",7729,5089,5043,49,46,"BNG-NÓS",208
32,"32012",784,505,497,2,8,"BNG-NÓS",2
36,"36058",4994,3292,3243,33,49,"BNG-NÓS",197
27,"27062",605,447,444,1,3,"BNG-NÓS",4
32,"32039",1262,957,941,6,16,"BNG-NÓS",22
15,"15040",2753,1905,1880,5,25,"BNG-NÓS",41
36,"36002",3147,2193,2169,20,24,"BNG-NÓS",152
15,"15078",78198,56154,55581,560,573,"BNG-NÓS",2055
27,"27020",3524,2816,2761,28,55,"BNG-NÓS",30
32,"32009",10803,7303,7227,48,76,"BNG-NÓS",85
15,"15015",2799,2045,2008,24,37,"BNG-NÓS",98
36,"36006",11520,8529,8396,63,133,"BNG-NÓS",412
32,"32055",1280,891,881,7,10,"BNG-NÓS",9
27,"27019",8111,5773,5680,53,93,"BNG-NÓS",223
27,"27027",1929,1369,1342,11,27,"BNG-NÓS",40
36,"36029",16077,11617,11471,100,146,"BNG-NÓS",664
36,"36901",4103,3153,3102,19,51,"BNG-NÓS",80
27,"27026",2397,1503,1471,9,32,"BNG-NÓS",38
32,"32052",1888,1399,1379,6,20,"BNG-NÓS",18
27,"27001",2370,1281,1256,13,25,"BNG-NÓS",26
36,"36018",3240,2198,2170,10,28,"BNG-NÓS",51
36,"36039",15401,10871,10609,71,262,"BNG-NÓS",313
32,"32008",8256,5542,5490,39,52,"BNG-NÓS",147
27,"27004",1227,760,749,7,11,"BNG-NÓS",15
32,"32058",5202,3650,3607,34,43,"BNG-NÓS",46
36,"36005",8121,5480,5400,52,80,"BNG-NÓS",151
36,"36050",7561,5280,5188,25,92,"BNG-NÓS",204
27,"27030",3327,2207,2159,31,48,"BNG-NÓS",65
36,"36027",4430,3137,3101,15,36,"BNG-NÓS",51
32,"32060",832,583,576,8,7,"BNG-NÓS",7
32,"32053",1438,1158,1144,11,14,"BNG-NÓS",18
36,"36046",4036,2971,2921,15,50,"BNG-NÓS",64
32,"32078",1188,855,838,4,17,"BNG-NÓS",7
27,"27018",3467,2086,2059,20,27,"BNG-NÓS",54
36,"36054",10993,7476,7363,67,113,"BNG-NÓS",381
32,"32022",1337,892,881,6,11,"BNG-NÓS",53
32,"32059",1790,1283,1263,7,20,"BNG-NÓS",13
32,"32074",1044,710,704,4,6,"BNG-NÓS",11
36,"36014",1942,1459,1444,9,15,"BNG-NÓS",23
15,"15023",6419,4348,4261,36,87,"BNG-NÓS",117
36,"36038",66390,47750,47273,449,477,"BNG-NÓS",2446
36,"36009",4503,3056,3001,15,55,"BNG-NÓS",35
32,"32033",737,478,476,3,2,"BNG-NÓS",2
32,"32067",1294,837,826,8,11,"BNG-NÓS",16
32,"32045",2443,1715,1690,14,25,"BNG-NÓS",15
15,"15035",11427,7779,7657,144,122,"BNG-NÓS",505
15,"15052",4314,2889,2838,21,51,"BNG-NÓS",64
32,"32049",760,510,507,9,3,"BNG-NÓS",8
27,"27055",1293,826,809,6,17,"BNG-NÓS",22
36,"36049",6804,4960,4860,36,100,"BNG-NÓS",115
32,"32069",4308,3221,3164,27,57,"BNG-NÓS",94
27,"27048",2140,1502,1467,20,35,"BNG-NÓS",25
15,"15045",3770,2184,2157,14,27,"BNG-NÓS",112
27,"27066",12696,8704,8537,98,167,"BNG-NÓS",236
32,"32080",328,249,244,5,5,"BNG-NÓS",1
32,"32034",1124,845,839,5,6,"BNG-NÓS",38
27,"27037",1065,750,740,11,10,"BNG-NÓS",7
27,"27029",1463,1023,1002,11,21,"BNG-NÓS",33
36,"36025",2257,1360,1350,10,10,"BNG-NÓS",18
15,"15033",2472,1863,1845,8,18,"BNG-NÓS",82
32,"32005",861,662,650,7,12,"BNG-NÓS",4
32,"32035",1442,957,942,3,15,"BNG-NÓS",5
15,"15003",1803,1227,1210,9,17,"BNG-NÓS",23
36,"36040",2575,1709,1680,15,29,"BNG-NÓS",63
27,"27057",11169,7551,7386,79,165,"BNG-NÓS",240
32,"32056",1592,1124,1118,7,6,"BNG-NÓS",3
15,"15090",1179,812,804,9,8,"BNG-NÓS",73
15,"15002",23083,16073,15889,159,184,"BNG-NÓS",485
15,"15044",1286,937,927,8,10,"BNG-NÓS",18
15,"15008",5627,4112,4072,36,40,"BNG-NÓS",67
15,"15073",21827,14058,13864,126,194,"BNG-NÓS",573
15,"15067",8029,5789,5732,37,57,"BNG-NÓS",306
36,"36032",3630,2587,2535,16,52,"BNG-NÓS",135
15,"15072",9574,6637,6562,35,75,"BNG-NÓS",412
32,"32016",790,550,543,2,7,"BNG-NÓS",3
15,"15077",8261,5186,5103,59,83,"BNG-NÓS",55
32,"32068",1415,982,978,5,4,"BNG-NÓS",36
36,"36015",4153,2721,2677,23,44,"BNG-NÓS",104
32,"32082",1243,891,878,1,13,"BNG-NÓS",10
15,"15093",4220,2533,2498,30,35,"BNG-NÓS",81
27,"27009",2097,1533,1507,12,26,"BNG-NÓS",25
36,"36034",3475,2403,2367,11,36,"BNG-NÓS",118
32,"32007",1517,1046,1028,8,18,"BNG-NÓS",128
15,"15004",4834,3436,3391,30,45,"BNG-NÓS",168
15,"15013",6151,4237,4189,48,48,"BNG-NÓS",113
32,"32047",1784,1255,1244,9,11,"BNG-NÓS",21
15,"15019",25888,16680,16460,186,220,"BNG-NÓS",798
27,"27031",15570,10606,10420,118,186,"BNG-NÓS",215
15,"15070",9069,6090,5976,94,114,"BNG-NÓS",299
15,"15082",15180,10841,10726,102,115,"BNG-NÓS",364
15,"15066",4009,2814,2776,33,38,"BNG-NÓS",54
36,"36055",13620,9580,9400,62,180,"BNG-NÓS",273
15,"15041",9568,6828,6710,75,118,"BNG-NÓS",190
27,"27007",2805,2133,2078,38,55,"BNG-NÓS",16
27,"27008",1379,1000,982,9,18,"BNG-NÓS",19
15,"15061",5571,3746,3691,27,55,"BNG-NÓS",88
32,"32001",4986,3488,3443,25,45,"BNG-NÓS",655
27,"27049",1409,921,909,7,12,"BNG-NÓS",14
36,"36051",14267,9638,9493,71,145,"BNG-NÓS",290
36,"36052",7292,4999,4907,45,92,"BNG-NÓS",125
36,"36044",2541,1674,1646,7,28,"BNG-NÓS",51
32,"32040",1477,1090,1084,7,6,"BNG-NÓS",25
32,"32072",3821,2705,2667,24,38,"BNG-NÓS",44
32,"32004",1798,1029,1023,4,6,"BNG-NÓS",5
32,"32071",1476,1010,1005,3,5,"BNG-NÓS",11
32,"32010",388,301,299,3,2,"BNG-NÓS",5
27,"27044",2879,1705,1662,27,43,"BNG-NÓS",64
27,"27033",623,415,409,8,6,"BNG-NÓS",24
15,"15010",1887,1168,1150,13,18,"BNG-NÓS",93
36,"36033",12298,8968,8788,53,180,"BNG-NÓS",189
15,"15087",5769,3766,3722,42,44,"BNG-NÓS",105
36,"36028",4102,2913,2868,17,45,"BNG-NÓS",91
32,"32042",1579,1094,1081,12,13,"BNG-NÓS",2
27,"27035",187,122,121,1,1,"BNG-NÓS",2
36,"36012",3732,2751,2717,9,34,"BNG-NÓS",69
36,"36057",236673,169244,167605,1366,1639,"BNG-NÓS",3301
36,"36001",2564,1858,1848,5,10,"BNG-NÓS",36
15,"15065",7315,5187,5099,42,88,"BNG-NÓS",123
36,"36008",21762,15447,15262,128,185,"BNG-NÓS",630
32,"32062",811,621,617,6,4,"BNG-NÓS",4
27,"27013",3766,2900,2851,25,49,"BNG-NÓS",83
15,"15091",1135,771,760,13,11,"BNG-NÓS",8
27,"27056",1248,848,836,9,12,"BNG-NÓS",17
15,"15001",4765,3280,3237,25,43,"BNG-NÓS",65
27,"27012",1355,736,729,5,7,"BNG-NÓS",17
36,"36045",24529,17613,17336,129,277,"BNG-NÓS",468
27,"27901",2386,1596,1569,25,27,"BNG-NÓS",18
32,"32086",2646,1693,1677,13,16,"BNG-NÓS",116
27,"27050",2975,2190,2154,16,36,"BNG-NÓS",34
15,"15048",4839,3456,3414,36,42,"BNG-NÓS",70
36,"36013",2344,1536,1514,11,22,"BNG-NÓS",40
36,"36026",20137,13779,13596,141,183,"BNG-NÓS",418
32,"32029",470,357,352,4,5,"BNG-NÓS",4
27,"27003",1876,1344,1320,12,24,"BNG-NÓS",16
32,"32048",895,574,569,5,5,"BNG-NÓS",12
32,"32037",728,518,509,6,9,"BNG-NÓS",2
36,"36041",13434,9297,9181,66,116,"BNG-NÓS",397
15,"15036",57885,39471,39096,417,375,"BNG-NÓS",958
32,"32079",1333,950,939,11,11,"BNG-NÓS",5
15,"15079",1540,1027,1007,16,20,"BNG-NÓS",35
15,"15069",6745,4910,4850,43,60,"BNG-NÓS",257
15,"15016",4749,3058,3020,19,38,"BNG-NÓS",51
27,"27052",915,676,667,6,9,"BNG-NÓS",5
15,"15038",2227,1463,1443,25,20,"BNG-NÓS",59
15,"15017",19420,13661,13505,175,156,"BNG-NÓS",303
36,"36016",1143,721,711,3,10,"BNG-NÓS",20
27,"27059",2163,1570,1543,17,27,"BNG-NÓS",21
32,"32075",4217,3089,3044,33,45,"BNG-NÓS",30
36,"36042",17891,12212,12003,93,209,"BNG-NÓS",379
36,"36022",9011,6310,6172,49,138,"BNG-NÓS",259
36,"36043",4747,3210,3162,20,48,"BNG-NÓS",118
32,"32077",1166,791,785,14,6,"BNG-NÓS",11
32,"32092",520,321,320,6,1,"BNG-NÓS",6
15,"15024",4393,3141,3073,32,68,"BNG-NÓS",90
15,"15088",3519,2304,2270,27,34,"BNG-NÓS",24
15,"15089",4291,3020,2972,28,48,"BNG-NÓS",64
15,"15022",5785,3811,3771,33,40,"BNG-NÓS",149
36,"36037",2571,1733,1707,11,26,"BNG-NÓS",51
32,"32032",8059,5708,5608,58,100,"BNG-NÓS",133
32,"32011",932,619,613,1,6,"BNG-NÓS",3
27,"27024",1598,1173,1158,8,15,"BNG-NÓS",36
15,"15051",4638,3182,3153,44,29,"BNG-NÓS",106
32,"32017",1244,870,857,6,13,"BNG-NÓS",6
15,"15039",1263,889,875,7,14,"BNG-NÓS",28
32,"32021",947,634,630,5,4,"BNG-NÓS",27
36,"36024",16455,11971,11781,109,190,"BNG-NÓS",283
15,"15064",2194,1592,1556,21,36,"BNG-NÓS",40
15,"15029",5688,3590,3544,32,46,"BNG-NÓS",99
32,"32028",1610,1211,1189,16,22,"BNG-NÓS",12
27,"27061",1027,753,732,6,21,"BNG-NÓS",13
32,"32063",1914,1297,1279,16,18,"BNG-NÓS",15
32,"32054",87167,60059,59333,540,726,"BNG-NÓS",1039
27,"27040",3200,2351,2310,21,41,"BNG-NÓS",59
32,"32013",2183,1428,1425,8,3,"BNG-NÓS",14
15,"15049",1098,758,752,7,6,"BNG-NÓS",116
27,"27032",3275,2128,2096,22,32,"BNG-NÓS",30
15,"15047",2429,1576,1549,19,27,"BNG-NÓS",47
15,"15005",24516,15761,15537,213,224,"BNG-NÓS",399
32,"32087",1765,1363,1343,13,20,"BNG-NÓS",8
32,"32061",1081,812,809,4,3,"BNG-NÓS",6
15,"15059",10362,7258,7106,91,152,"BNG-NÓS",261
32,"32050",2433,1829,1814,12,15,"BNG-NÓS",31
32,"32085",10716,7279,7152,66,127,"BNG-NÓS",235
27,"27034",1120,681,672,4,9,"BNG-NÓS",17
36,"36035",14433,10333,10188,79,145,"BNG-NÓS",152
36,"36003",9980,7191,7110,67,81,"BNG-NÓS",142
27,"27058",3495,2510,2480,30,30,"BNG-NÓS",72
27,"27041",2341,1718,1705,16,13,"BNG-NÓS",47
15,"15027",1536,1182,1155,6,27,"BNG-NÓS",24
15,"15020",3784,2476,2447,17,29,"BNG-NÓS",155
32,"32006",1531,1114,1090,10,24,"BNG-NÓS",6
15,"15043",5114,3476,3401,47,75,"BNG-NÓS",107
32,"32036",1345,971,953,14,18,"BNG-NÓS",33
27,"27015",4270,2832,2769,33,63,"BNG-NÓS",47
32,"32015",874,575,573,4,2,"BNG-NÓS",5
15,"15014",4002,2566,2524,28,42,"BNG-NÓS",58
32,"32066",566,418,416,0,2,"BNG-NÓS",0
36,"36020",2318,1646,1620,18,26,"BNG-NÓS",15
32,"32057",565,416,415,4,1,"BNG-NÓS",7
15,"15085",3332,2280,2247,25,33,"BNG-NÓS",83
36,"36053",5684,4099,4050,38,49,"BNG-NÓS",396
36,"36021",12073,8447,8342,89,105,"BNG-NÓS",166
32,"32041",767,524,515,4,9,"BNG-NÓS",3
32,"32027",1053,765,749,2,16,"BNG-NÓS",7
15,"15076",2611,1758,1739,17,19,"BNG-NÓS",214
15,"15092",6438,3976,3903,28,73,"BNG-NÓS",60
32,"32046",1160,787,779,4,8,"BNG-NÓS",17
36,"36010",2847,2102,2076,13,26,"BNG-NÓS",113
36,"36047",2454,1633,1621,13,12,"BNG-NÓS",30
32,"32089",1295,888,878,7,10,"BNG-NÓS",18
32,"32043",2561,1806,1774,9,32,"BNG-NÓS",37
36,"36030",4175,2832,2785,27,47,"BNG-NÓS",144
15,"15037",4061,2588,2552,19,36,"BNG-NÓS",136
32,"32023",1210,862,849,4,13,"BNG-NÓS",10
27,"27005",2595,1846,1816,13,30,"BNG-NÓS",146
27,"27060",2598,1690,1665,19,25,"BNG-NÓS",76
27,"27014",3254,2103,2067,21,36,"BNG-NÓS",101
15,"15056",5722,3869,3818,46,51,"BNG-NÓS",72
32,"32026",2704,1929,1896,22,33,"BNG-NÓS",18
27,"27053",537,316,308,3,8,"BNG-NÓS",6
32,"32081",2077,1517,1500,14,17,"BNG-NÓS",8
15,"15018",1142,741,732,18,9,"BNG-NÓS",28
27,"27017",1003,674,670,4,4,"BNG-NÓS",4
32,"32020",2576,1923,1899,5,24,"BNG-NÓS",52
15,"15012",3627,2659,2602,28,57,"BNG-NÓS",37
15,"15030",200176,143255,142070,1452,1185,"BNG-NÓS",3109
36,"36060",30323,21399,21162,164,237,"BNG-NÓS",555
15,"15006",5321,3341,3283,49,58,"BNG-NÓS",120
15,"15050",1822,1004,988,13,16,"BNG-NÓS",43
15,"15068",5049,3185,3129,25,56,"BNG-NÓS",82
15,"15054",32106,21026,20772,259,254,"BNG-NÓS",604
36,"36036",2518,1827,1801,18,26,"BNG-NÓS",53
32,"32051",1427,1184,1172,6,12,"BNG-NÓS",13
32,"32064",529,389,388,3,1,"BNG-NÓS",5
32,"32019",11537,7975,7861,56,114,"BNG-NÓS",175
27,"27042",1740,1235,1218,12,17,"BNG-NÓS",9
27,"27043",1295,805,793,9,12,"BNG-NÓS",22
27,"27054",1190,881,860,9,21,"BNG-NÓS",40
15,"15081",1034,791,782,11,9,"BNG-NÓS",11
36,"36004",10161,6939,6844,63,95,"BNG-NÓS",370
32,"32003",885,654,649,5,5,"BNG-NÓS",2
15,"15057",12075,8479,8377,66,102,"BNG-NÓS",304
15,"15031",23348,16380,16235,191,145,"BNG-NÓS",365
32,"32030",999,736,726,3,10,"BNG-NÓS",13
15,"15086",2869,1970,1950,13,20,"BNG-NÓS",33
15,"15009",10739,7688,7559,54,129,"BNG-NÓS",174
36,"36048",5331,3653,3603,22,50,"BNG-NÓS",184
36,"36023",8395,5965,5884,41,81,"BNG-NÓS",305
15,"15007",3303,2262,2246,15,16,"BNG-NÓS",37
27,"27021",1753,1090,1056,12,34,"BNG-NÓS",54
36,"36059",4882,3137,3085,28,52,"BNG-NÓS",83
32,"32025",1079,791,777,1,14,"BNG-NÓS",15
15,"15084",3260,2218,2191,27,27,"BNG-NÓS",55
15,"15042",3028,2033,2000,19,33,"BNG-NÓS",38
15,"15080",1756,1131,1117,11,14,"BNG-NÓS",19
32,"32091",1838,1368,1362,6,6,"BNG-NÓS",21
27,"27006",2564,1659,1637,17,22,"BNG-NÓS",10
27,"27011",2452,1494,1467,19,27,"BNG-NÓS",39
15,"15021",5127,3587,3543,38,44,"BNG-NÓS",84
27,"27023",2579,1891,1865,23,26,"BNG-NÓS",21
32,"32065",657,463,454,3,9,"BNG-NÓS",2
27,"27047",1629,1106,1089,8,17,"BNG-NÓS",92
15,"15055",4572,3070,3013,27,57,"BNG-NÓS",111
27,"27902",7205,4829,4754,53,75,"BNG-NÓS",146
15,"15058",27793,20392,20235,221,157,"BNG-NÓS",377
15,"15062",5887,3747,3701,36,46,"BNG-NÓS",99
15,"15025",1061,629,622,6,7,"BNG-NÓS",21
15,"15011",15432,10395,10248,74,147,"BNG-NÓS",455
32,"32018",1247,975,962,9,13,"BNG-NÓS",6
27,"27016",7172,4910,4846,51,64,"BNG-NÓS",97
27,"27022",4833,3022,2954,30,68,"BNG-NÓS",74
36,"36061",8606,6232,6133,41,99,"BNG-NÓS",152
36,"36019",1625,1042,1029,9,13,"BNG-NÓS",35
27,"27028",79049,54057,53355,559,702,"BNG-NÓS",1250
27,"27063",1737,1226,1186,14,40,"BNG-NÓS",27
27,"27051",8108,5503,5424,62,79,"BNG-NÓS",232
15,"15075",12336,8830,8725,91,105,"BNG-NÓS",209
32,"32076",2094,1488,1474,20,14,"BNG-NÓS",45
32,"32031",1069,822,795,4,27,"BNG-NÓS",8
15,"15071",7951,5255,5178,50,77,"BNG-NÓS",186
15,"15034",2885,1782,1760,18,22,"BNG-NÓS",23
36,"36011",1799,1144,1122,8,22,"BNG-NÓS",26
27,"27064",1581,1097,1068,12,29,"BNG-NÓS",18
27,"27065",12444,8261,8056,112,205,"BNG-NÓS",143
15,"15046",6332,4377,4262,40,115,"BNG-NÓS",171
36,"36056",5076,3584,3515,30,69,"BNG-NÓS",59
35,"35033",6398,4340,4266,19,74,"CCa-PNC",62
35,"35015",9950,5139,5070,29,69,"CCa-PNC",352
38,"38016",1223,638,623,3,15,"CCa-PNC",66
35,"35023",11686,8212,8076,55,136,"CCa-PNC",613
38,"38021",1629,1033,1022,9,11,"CCa-PNC",212
38,"38034",4049,2855,2807,19,48,"CCa-PNC",360
35,"35027",10344,7310,7216,50,94,"CCa-PNC",249
38,"38031",28687,21132,20858,104,274,"CCa-PNC",1899
35,"35004",39299,20523,20294,140,229,"CCa-PNC",1627
35,"35026",81091,51953,51195,407,758,"CCa-PNC",2028
38,"38007",1661,1114,1103,6,11,"CCa-PNC",109
35,"35018",12552,7609,7547,54,62,"CCa-PNC",487
38,"38001",20228,11032,10936,47,96,"CCa-PNC",816
38,"38032",13237,8908,8828,52,80,"CCa-PNC",752
38,"38040",5021,3136,3102,14,34,"CCa-PNC",440
35,"35001",4584,3282,3222,26,60,"CCa-PNC",51
38,"38019",13200,8123,8047,36,76,"CCa-PNC",1043
38,"38047",1777,1198,1170,4,28,"CCa-PNC",200
38,"38036",6592,4518,4440,45,78,"CCa-PNC",653
38,"38045",3837,2127,2111,12,16,"CCa-PNC",354
38,"38033",3702,2505,2464,8,41,"CCa-PNC",250
35,"35019",32481,19318,19067,123,251,"CCa-PNC",517
35,"35002",23328,15495,15313,94,182,"CCa-PNC",671
38,"38022",18450,12334,12160,62,174,"CCa-PNC",1976
38,"38035",9474,5616,5564,36,52,"CCa-PNC",857
35,"35032",3412,2473,2425,17,48,"CCa-PNC",23
35,"35005",1048,747,737,8,10,"CCa-PNC",7
38,"38020",15113,9928,9830,59,98,"CCa-PNC",1351
35,"35034",7873,3975,3943,27,32,"CCa-PNC",297
38,"38005",5468,3425,3392,18,33,"CCa-PNC",505
38,"38048",3901,2667,2637,20,30,"CCa-PNC",536
35,"35007",511,316,309,2,7,"CCa-PNC",41
35,"35014",11209,6016,5917,42,99,"CCa-PNC",252
35,"35031",7259,5037,4942,29,95,"CCa-PNC",52
35,"35028",9776,5476,5401,43,75,"CCa-PNC",225
38,"38046",9113,6850,6775,40,75,"CCa-PNC",868
38,"38901",1405,900,887,3,13,"CCa-PNC",209
38,"38050",2462,1624,1604,8,20,"CCa-PNC",316
38,"38010",4008,2733,2661,19,72,"CCa-PNC",195
35,"35021",14924,10477,10370,45,107,"CCa-PNC",84
38,"38026",32950,24443,24196,129,247,"CCa-PNC",4855
35,"35020",6034,3992,3934,20,58,"CCa-PNC",205
38,"38029",1517,744,734,1,10,"CCa-PNC",40
38,"38053",3735,2469,2435,17,34,"CCa-PNC",403
38,"38038",162027,104978,104035,575,943,"CCa-PNC",11655
38,"38044",2188,1348,1334,6,14,"CCa-PNC",168
35,"35003",5211,2949,2908,13,41,"CCa-PNC",152
38,"38052",1273,883,875,2,8,"CCa-PNC",100
38,"38009",4127,2915,2868,20,47,"CCa-PNC",362
35,"35016",297736,192251,190256,1386,1995,"CCa-PNC",3039
38,"38004",4456,3026,2983,23,43,"CCa-PNC",364
38,"38049",2655,1654,1627,8,27,"CCa-PNC",207
38,"38023",121908,81147,80333,494,814,"CCa-PNC",10829
35,"35022",48603,29443,29042,160,401,"CCa-PNC",878
38,"38025",6880,4839,4761,30,78,"CCa-PNC",477
35,"35012",10382,5443,5392,17,51,"CCa-PNC",91
38,"38037",12864,8287,8163,64,124,"CCa-PNC",742
38,"38013",2949,1896,1867,17,29,"CCa-PNC",401
38,"38018",4402,3058,3011,16,47,"CCa-PNC",623
35,"35024",13735,8545,8439,77,106,"CCa-PNC",1047
35,"35017",25676,15038,14716,94,322,"CCa-PNC",980
38,"38042",3802,2652,2625,14,27,"CCa-PNC",247
35,"35025",1797,1261,1245,4,16,"CCa-PNC",15
38,"38027",5414,3618,3571,16,47,"CCa-PNC",601
35,"35008",6131,4507,4459,34,48,"CCa-PNC",234
38,"38051",7194,5158,5080,31,78,"CCa-PNC",840
38,"38006",39766,20776,20587,139,189,"CCa-PNC",1751
35,"35029",4152,2530,2498,32,32,"CCa-PNC",362
38,"38011",20570,13831,13698,75,133,"CCa-PNC",1396
35,"35009",19905,14185,13961,89,224,"CCa-PNC",600
35,"35030",9250,5413,5326,34,87,"CCa-PNC",497
38,"38043",18892,13089,12928,87,161,"CCa-PNC",1692
38,"38041",6821,4908,4861,40,47,"CCa-PNC",1080
38,"38002",956,702,696,21,6,"CCa-PNC",131
38,"38015",4170,2862,2836,10,26,"CCa-PNC",587
35,"35006",30457,21398,21118,162,280,"CCa-PNC",1047
38,"38012",2347,1644,1630,7,14,"CCa-PNC",228
38,"38014",1357,935,926,3,9,"CCa-PNC",215
38,"38003",1439,969,952,10,17,"CCa-PNC",68
38,"38039",10641,7547,7459,49,88,"CCa-PNC",1256
38,"38028",22103,15036,14844,85,192,"CCa-PNC",1001
35,"35011",24002,15928,15684,95,244,"CCa-PNC",604
35,"35010",3558,2341,2301,28,40,"CCa-PNC",444
38,"38008",5520,3825,3766,17,59,"CCa-PNC",486
38,"38024",15077,9512,9356,55,156,"CCa-PNC",1215
38,"38030",1933,1296,1290,2,6,"CCa-PNC",265
35,"35013",6625,4896,4781,41,115,"CCa-PNC",123
38,"38017",28437,16239,16075,95,164,"CCa-PNC",1872
46,"46201",64,52,51,1,1,"CCD",0
46,"46222",384,307,304,1,3,"CCD",0
12,"12055",104,83,82,3,1,"CCD",0
46,"46001",795,601,592,3,9,"CCD",0
46,"46178",4637,3405,3381,27,24,"CCD",13
46,"46022",15365,11093,10997,59,96,"CCD",38
46,"46118",3763,2940,2908,16,32,"CCD",12
46,"46100",286,232,230,1,2,"CCD",2
12,"12088",62,59,59,0,0,"CCD",0
46,"46086",82,70,69,1,1,"CCD",0
12,"12142",158,117,117,1,0,"CCD",0
12,"12074",785,652,648,5,4,"CCD",6
12,"12135",35719,26016,25793,196,223,"CCD",196
12,"12050",1305,1015,1000,6,15,"CCD",4
46,"46083",15422,11179,11049,86,130,"CCD",34
46,"46031",10535,7543,7451,66,92,"CCD",19
12,"12096",777,587,577,6,10,"CCD",0
46,"46027",943,780,771,5,9,"CCD",1
46,"46216",5053,4109,4090,14,19,"CCD",3
46,"46161",1483,1188,1173,7,15,"CCD",3
12,"12031",3807,2941,2894,24,47,"CCD",16
46,"46110",21228,15563,15443,86,120,"CCD",70
46,"46062",4631,3511,3474,27,37,"CCD",11
46,"46163",1866,1504,1480,8,24,"CCD",2
46,"46902",364,306,303,0,3,"CCD",2
46,"46097",963,733,728,4,5,"CCD",2
46,"46120",1113,903,875,2,28,"CCD",3
46,"46066",1263,1024,1018,9,6,"CCD",2
46,"46057",487,321,317,1,4,"CCD",1
46,"46190",48947,35638,35419,211,219,"CCD",190
12,"12116",58,49,49,0,0,"CCD",1
46,"46069",162,124,123,0,1,"CCD",0
12,"12128",1393,1090,1072,10,18,"CCD",8
46,"46179",2165,1760,1737,16,23,"CCD",5
12,"12018",287,246,242,1,4,"CCD",1
12,"12095",959,749,742,8,7,"CCD",2
46,"46188",672,544,537,8,7,"CCD",2
46,"46060",9369,7052,6993,42,59,"CCD",20
12,"12081",608,486,480,5,6,"CCD",2
46,"46187",1306,1017,1000,0,17,"CCD",1
46,"46172",5042,3504,3477,22,27,"CCD",2
46,"46119",780,653,647,5,6,"CCD",2
46,"46084",1576,1263,1242,5,21,"CCD",0
46,"46125",847,689,684,5,5,"CCD",1
46,"46008",2651,2108,2089,21,19,"CCD",6
46,"46021",23649,17291,17153,100,138,"CCD",56
46,"46205",14313,10932,10834,51,98,"CCD",42
12,"12039",833,717,710,4,7,"CCD",4
12,"12089",4328,3078,3020,15,58,"CCD",15
12,"12040",117608,85588,84946,496,642,"CCD",579
12,"12034",1424,1065,1035,3,30,"CCD",4
46,"46247",1006,714,710,3,4,"CCD",2
46,"46258",2652,2084,2062,16,22,"CCD",5
46,"46065",1579,1174,1163,8,11,"CCD",2
46,"46254",1000,785,779,6,6,"CCD",1
12,"12132",480,396,389,3,7,"CCD",2
46,"46227",905,711,702,1,9,"CCD",2
12,"12046",191,151,150,2,1,"CCD",0
12,"12026",881,678,663,13,15,"CCD",2
46,"46196",147,125,125,1,0,"CCD",0
12,"12125",216,180,177,0,3,"CCD",1
12,"12099",539,416,403,7,13,"CCD",0
46,"46045",1249,1028,1010,3,18,"CCD",4
12,"12016",1582,1307,1297,6,10,"CCD",7
46,"46047",532,446,437,2,9,"CCD",3
12,"12119",148,95,93,0,2,"CCD",0
46,"46025",2499,1953,1934,8,19,"CCD",6
46,"46103",1264,1015,984,7,31,"CCD",1
46,"46225",337,290,281,5,9,"CCD",1
12,"12020",118,105,105,0,0,"CCD",0
12,"12012",2685,2234,2202,13,32,"CCD",1
12,"12058",71,63,62,1,1,"CCD",2
12,"12112",99,79,78,3,1,"CCD",0
12,"12106",1158,955,942,8,13,"CCD",2
46,"46144",663,532,529,2,3,"CCD",4
12,"12009",17445,12088,11999,75,89,"CCD",68
12,"12017",161,130,128,0,2,"CCD",0
46,"46071",464,383,377,0,6,"CCD",2
12,"12087",25,18,18,4,0,"CCD",0
12,"12060",446,368,364,4,4,"CCD",2
12,"12013",144,121,119,0,2,"CCD",0
46,"46015",7244,5615,5560,40,55,"CCD",27
12,"12065",188,169,169,2,0,"CCD",11
46,"46041",329,253,252,5,1,"CCD",0
46,"46156",2080,1697,1675,10,22,"CCD",2
12,"12134",141,95,94,0,1,"CCD",0
46,"46017",32949,23913,23685,142,228,"CCD",79
46,"46260",2581,2087,2068,22,19,"CCD",10
46,"46153",439,355,351,1,4,"CCD",0
46,"46091",118,94,94,0,0,"CCD",0
46,"46005",22918,16958,16827,102,131,"CCD",68
12,"12014",184,144,143,2,1,"CCD",0
46,"46056",182,167,166,1,1,"CCD",0
12,"12002",110,99,98,1,1,"CCD",0
12,"12004",4170,3125,3088,19,37,"CCD",10
46,"46108",469,378,375,1,3,"CCD",0
46,"46221",352,305,304,0,1,"CCD",0
46,"46263",251,214,212,0,2,"CCD",0
46,"46042",3380,2799,2755,20,44,"CCD",10
46,"46242",333,267,266,0,1,"CCD",2
12,"12005",8062,5829,5754,64,75,"CCD",33
12,"12078",325,235,233,0,2,"CCD",0
46,"46173",1328,1069,1057,4,12,"CCD",3
12,"12902",2158,1504,1489,14,15,"CCD",7
12,"12063",41,29,29,1,0,"CCD",0
46,"46202",16947,12814,12710,79,104,"CCD",63
46,"46150",1831,1341,1333,7,8,"CCD",1
46,"46248",4897,3596,3544,18,52,"CCD",5
12,"12051",471,339,335,1,4,"CCD",0
12,"12133",59,53,52,0,1,"CCD",0
46,"46011",7609,5249,5191,26,58,"CCD",10
46,"46092",276,192,189,0,3,"CCD",0
46,"46230",13960,10351,10241,54,110,"CCD",20
46,"46199",5718,4314,4266,28,48,"CCD",11
46,"46032",5653,4402,4361,33,41,"CCD",18
12,"12001",1051,821,800,4,21,"CCD",5
46,"46058",1772,1398,1373,15,25,"CCD",2
46,"46046",892,675,668,1,7,"CCD",0
46,"46029",20613,14964,14879,93,85,"CCD",79
12,"12137",36,23,23,0,0,"CCD",0
12,"12124",1840,1387,1381,33,6,"CCD",4
46,"46203",3606,2873,2844,9,29,"CCD",4
46,"46177",4690,3579,3526,19,53,"CCD",6
46,"46003",950,791,769,1,22,"CCD",2
46,"46171",16563,12213,12128,85,85,"CCD",43
46,"46198",839,684,674,4,10,"CCD",2
12,"12073",152,119,117,0,2,"CCD",0
46,"46255",3174,2448,2424,22,24,"CCD",9
46,"46095",610,467,459,1,8,"CCD",0
46,"46004",1922,1565,1547,11,18,"CCD",7
46,"46204",6681,5256,5202,32,54,"CCD",14
12,"12022",344,265,262,2,3,"CCD",0
12,"12027",17283,12015,11888,89,127,"CCD",50
46,"46033",191,156,155,0,1,"CCD",0
46,"46068",346,276,266,6,10,"CCD",1
46,"46094",20540,15378,15234,102,144,"CCD",58
46,"46013",17383,13569,13483,82,86,"CCD",30
46,"46233",3860,2859,2817,10,42,"CCD",7
46,"46231",2421,1721,1708,14,13,"CCD",5
12,"12129",1828,1322,1298,11,24,"CCD",9
46,"46040",1078,888,878,7,10,"CCD",3
46,"46014",3030,2383,2350,20,33,"CCD",1
46,"46121",105,95,94,0,1,"CCD",0
12,"12084",17615,12766,12644,105,122,"CCD",71
46,"46170",3417,2714,2688,10,26,"CCD",14
12,"12139",318,237,233,0,4,"CCD",2
46,"46239",442,340,338,3,2,"CCD",0
46,"46109",6150,4625,4556,25,69,"CCD",12
46,"46080",998,803,799,7,4,"CCD",0
46,"46147",16835,11920,11791,61,129,"CCD",41
12,"12028",12586,9733,9676,62,57,"CCD",41
46,"46016",1061,870,856,5,14,"CCD",5
46,"46043",136,124,124,0,0,"CCD",0
12,"12045",345,268,259,1,9,"CCD",0
46,"46090",1637,1391,1367,3,24,"CCD",3
12,"12038",167,120,118,2,2,"CCD",1
46,"46903",6065,4790,4763,18,27,"CCD",14
46,"46145",21990,16337,16187,93,150,"CCD",34
46,"46107",1900,1516,1504,5,12,"CCD",4
12,"12041",100,81,81,0,0,"CCD",0
46,"46038",327,242,242,3,0,"CCD",0
46,"46256",6853,4951,4890,25,61,"CCD",14
46,"46009",3121,2459,2427,8,32,"CCD",9
46,"46259",491,396,393,4,3,"CCD",1
46,"46099",901,689,684,1,5,"CCD",0
46,"46114",569,461,458,1,3,"CCD",2
46,"46074",2696,2069,2038,14,31,"CCD",3
46,"46238",13282,9786,9721,61,65,"CCD",14
12,"12121",1107,924,893,4,31,"CCD",2
12,"12015",93,81,78,0,3,"CCD",0
46,"46048",3452,2749,2713,14,36,"CCD",7
12,"12108",456,378,371,2,7,"CCD",1
46,"46010",935,729,723,4,6,"CCD",1
12,"12080",1932,1598,1570,10,28,"CCD",8
12,"12070",522,406,401,0,5,"CCD",0
46,"46053",553,445,436,2,9,"CCD",0
12,"12098",580,451,447,5,4,"CCD",2
12,"12011",4565,3331,3283,20,48,"CCD",17
12,"12067",537,435,427,0,8,"CCD",0
46,"46134",2357,1725,1712,14,13,"CCD",2
12,"12126",24464,18533,18331,113,202,"CCD",83
46,"46261",1725,1356,1337,5,19,"CCD",3
12,"12032",23525,17093,16966,104,127,"CCD",108
12,"12043",570,449,442,2,7,"CCD",2
46,"46228",2348,1815,1794,7,21,"CCD",1
46,"46252",118,99,98,0,1,"CCD",0
12,"12036",581,426,421,10,5,"CCD",2
46,"46132",2150,1803,1784,7,19,"CCD",2
12,"12123",48,40,40,3,0,"CCD",0
46,"46130",901,687,683,3,4,"CCD",1
46,"46138",343,275,272,1,3,"CCD",0
46,"46055",1262,1025,1012,5,13,"CCD",1
46,"46116",13159,10193,10135,53,58,"CCD",26
46,"46229",948,762,758,0,4,"CCD",1
12,"12025",136,104,104,0,0,"CCD",0
12,"12117",3585,2727,2677,20,50,"CCD",11
46,"46223",7801,5950,5899,34,51,"CCD",13
12,"12114",198,144,144,1,0,"CCD",0
46,"46081",10134,7771,7702,41,69,"CCD",27
46,"46044",4218,3222,3158,18,64,"CCD",19
12,"12029",702,557,555,4,2,"CCD",1
46,"46192",761,576,570,5,6,"CCD",3
46,"46175",456,389,387,3,2,"CCD",3
46,"46096",274,209,209,1,0,"CCD",2
46,"46140",344,284,279,0,5,"CCD",1
46,"46088",166,125,125,4,0,"CCD",0
46,"46079",318,241,232,1,9,"CCD",2
46,"46036",564,383,378,5,5,"CCD",4
46,"46117",495,402,399,5,3,"CCD",3
46,"46082",4918,3745,3712,33,33,"CCD",10
12,"12094",847,674,665,5,9,"CCD",1
46,"46195",1962,1531,1516,11,15,"CCD",2
46,"46160",1913,1452,1436,1,16,"CCD",4
46,"46169",32247,24214,24053,154,161,"CCD",80
46,"46234",348,279,275,3,4,"CCD",0
12,"12033",1919,1437,1404,19,33,"CCD",4
46,"46129",524,420,412,4,8,"CCD",2
12,"12136",2635,2201,2171,18,30,"CCD",14
46,"46164",11771,8564,8483,64,81,"CCD",35
46,"46034",1758,1390,1379,4,11,"CCD",6
46,"46219",127,112,112,1,0,"CCD",0
46,"46213",15409,10924,10805,97,119,"CCD",31
12,"12071",1274,992,979,3,13,"CCD",3
46,"46037",1122,936,923,4,13,"CCD",2
12,"12901",3405,2626,2598,23,28,"CCD",17
46,"46141",439,351,342,2,9,"CCD",1
46,"46087",120,98,97,0,1,"CCD",0
46,"46249",9288,6746,6676,56,70,"CCD",20
12,"12006",172,135,133,0,2,"CCD",1
46,"46006",4523,3665,3623,20,42,"CCD",6
12,"12037",17,16,14,0,2,"CCD",0
12,"12075",123,88,88,0,0,"CCD",1
46,"46023",327,280,278,2,2,"CCD",1
12,"12003",976,746,736,6,10,"CCD",2
46,"46067",1753,1418,1393,1,25,"CCD",7
12,"12049",441,322,312,1,10,"CCD",0
46,"46197",1942,1527,1514,5,13,"CCD",3
46,"46220",48410,34644,34292,279,352,"CCD",114
46,"46207",6676,5106,5040,41,66,"CCD",17
46,"46182",1266,929,922,6,7,"CCD",0
12,"12091",177,113,112,0,1,"CCD",0
12,"12083",93,79,76,0,3,"CCD",0
46,"46151",728,550,541,0,9,"CCD",1
12,"12115",219,179,177,0,2,"CCD",1
46,"46152",96,68,68,0,0,"CCD",2
46,"46039",2130,1728,1699,8,29,"CCD",2
46,"46059",1261,1035,1019,9,16,"CCD",1
46,"46224",159,121,121,0,0,"CCD",3
46,"46241",392,299,291,1,8,"CCD",1
12,"12008",222,193,192,1,1,"CCD",0
46,"46146",1654,1304,1278,7,26,"CCD",3
12,"12059",231,189,188,2,1,"CCD",1
46,"46052",499,421,417,2,4,"CCD",1
46,"46127",2692,2120,2091,18,29,"CCD",10
46,"46019",8849,7072,7004,33,68,"CCD",29
12,"12079",399,316,314,2,2,"CCD",0
12,"12102",522,423,418,1,5,"CCD",1
46,"46089",2132,1602,1574,9,28,"CCD",3
46,"46112",536,455,450,2,5,"CCD",2
46,"46181",16955,12313,12148,95,165,"CCD",40
46,"46077",7496,5909,5827,45,82,"CCD",11
46,"46028",387,330,328,3,2,"CCD",0
46,"46245",511,420,415,0,5,"CCD",0
46,"46054",11293,8477,8409,47,68,"CCD",19
12,"12090",102,86,85,1,1,"CCD",0
46,"46232",895,711,696,5,15,"CCD",1
12,"12130",404,340,335,0,5,"CCD",0
12,"12110",234,176,173,0,3,"CCD",3
46,"46123",1829,1407,1388,7,19,"CCD",1
46,"46075",150,130,123,1,7,"CCD",1
12,"12140",1143,939,930,6,9,"CCD",1
12,"12010",259,213,208,2,5,"CCD",0
46,"46128",1597,1290,1250,5,40,"CCD",3
46,"46078",28017,20288,20143,132,145,"CCD",49
12,"12085",4976,3236,3209,16,27,"CCD",7
46,"46185",378,320,313,2,7,"CCD",0
46,"46142",787,619,602,1,17,"CCD",3
46,"46143",4239,3104,3053,14,51,"CCD",16
46,"46063",1756,1367,1345,15,22,"CCD",2
46,"46002",1175,941,932,5,9,"CCD",3
12,"12100",1333,1065,1047,10,18,"CCD",2
12,"12127",75,55,55,0,0,"CCD",0
12,"12131",63,52,52,0,0,"CCD",3
46,"46251",2462,1997,1956,6,41,"CCD",3
46,"46904",792,610,603,8,7,"CCD",2
46,"46085",11081,7938,7866,46,72,"CCD",28
46,"46218",1060,910,885,7,25,"CCD",1
12,"12122",796,637,627,0,10,"CCD",3
12,"12061",373,285,282,3,3,"CCD",0
12,"12111",360,305,299,3,6,"CCD",0
12,"12024",143,125,124,0,1,"CCD",0
46,"46113",2457,1804,1782,6,22,"CCD",10
46,"46168",1938,1495,1486,2,9,"CCD",0
12,"12092",111,91,90,0,1,"CCD",0
12,"12120",177,152,152,0,0,"CCD",0
46,"46101",860,716,705,3,11,"CCD",2
46,"46135",9680,7682,7634,36,48,"CCD",12
12,"12109",649,532,524,6,8,"CCD",0
46,"46155",1029,833,822,4,11,"CCD",0
46,"46176",2017,1358,1349,5,9,"CCD",5
46,"46167",364,266,264,0,2,"CCD",1
46,"46051",8347,6355,6302,24,53,"CCD",14
46,"46214",15766,12131,12036,42,95,"CCD",23
12,"12057",606,487,474,5,13,"CCD",3
46,"46235",21579,15929,15763,113,166,"CCD",68
46,"46250",578719,442973,440154,2541,2819,"CCD",1368
46,"46200",1903,1561,1539,3,22,"CCD",3
46,"46206",571,453,445,2,8,"CCD",2
12,"12101",358,279,275,3,4,"CCD",0
46,"46026",1204,1015,1004,3,11,"CCD",2
46,"46262",223,162,159,2,3,"CCD",1
46,"46246",1058,835,823,5,12,"CCD",1
12,"12072",1101,929,911,11,18,"CCD",10
12,"12052",578,452,435,3,17,"CCD",2
46,"46020",3760,2916,2866,22,50,"CCD",5
46,"46007",11989,8784,8711,67,73,"CCD",29
46,"46106",1535,1150,1140,10,10,"CCD",3
46,"46102",19788,15154,15038,89,116,"CCD",47
46,"46035",6822,5202,5142,43,60,"CCD",29
46,"46154",808,636,631,5,5,"CCD",5
12,"12044",468,419,412,3,7,"CCD",0
46,"46149",363,271,268,2,3,"CCD",0
46,"46166",8155,6320,6251,30,69,"CCD",27
46,"46157",2980,2321,2298,10,23,"CCD",2
46,"46126",5556,4449,4405,24,44,"CCD",13
12,"12105",848,644,638,2,6,"CCD",1
46,"46236",972,818,809,2,9,"CCD",1
46,"46122",2704,2082,2063,10,19,"CCD",11
46,"46217",878,691,676,4,15,"CCD",5
46,"46183",5993,4443,4381,19,62,"CCD",9
46,"46184",26505,20428,20223,115,205,"CCD",81
46,"46061",342,274,272,1,2,"CCD",0
46,"46208",1112,887,881,4,6,"CCD",2
46,"46124",787,653,642,4,11,"CCD",6
12,"12107",355,303,299,4,4,"CCD",0
46,"46210",330,277,277,2,0,"CCD",0
12,"12068",48,36,35,1,1,"CCD",0
12,"12069",66,49,48,0,1,"CCD",1
46,"46180",682,553,549,0,4,"CCD",0
46,"46244",58771,42137,41867,270,270,"CCD",165
46,"46030",800,627,614,5,13,"CCD",0
46,"46240",210,164,161,1,3,"CCD",1
12,"12064",91,82,81,2,1,"CCD",0
46,"46194",15567,11156,11044,86,112,"CCD",48
46,"46215",1436,1154,1143,5,11,"CCD",2
46,"46174",972,764,752,2,12,"CCD",2
12,"12076",84,69,69,0,0,"CCD",2
46,"46111",10930,7931,7828,44,103,"CCD",46
12,"12056",282,236,231,1,5,"CCD",0
46,"46162",1189,938,929,3,9,"CCD",2
46,"46137",270,210,207,4,3,"CCD",0
46,"46237",7211,5395,5343,42,52,"CCD",14
46,"46148",1513,1160,1146,7,14,"CCD",2
46,"46093",2118,1647,1624,4,23,"CCD",1
46,"46024",413,314,313,2,1,"CCD",0
46,"46165",7129,5436,5388,25,48,"CCD",10
46,"46186",19068,14599,14474,69,125,"CCD",58
12,"12104",6933,5411,5342,25,69,"CCD",21
46,"46115",378,286,282,1,4,"CCD",1
46,"46098",2482,1907,1889,11,18,"CCD",5
46,"46105",16190,11323,11206,44,117,"CCD",31
46,"46050",194,150,149,0,1,"CCD",1
46,"46191",1937,1530,1505,5,25,"CCD",6
46,"46076",575,454,443,0,11,"CCD",0
46,"46211",1745,1387,1378,8,9,"CCD",5
46,"46193",8788,6925,6871,50,54,"CCD",18
46,"46064",509,412,399,1,13,"CCD",0
46,"46243",138,115,112,1,3,"CCD",0
46,"46189",467,393,390,2,3,"CCD",0
46,"46049",281,232,224,0,8,"CCD",1
46,"46136",2537,1952,1930,11,22,"CCD",8
46,"46159",22857,16840,16697,128,143,"CCD",57
46,"46158",1026,811,795,6,16,"CCD",1
12,"12097",63,49,49,0,0,"CCD",0
12,"12138",19061,13010,12847,129,163,"CCD",43
12,"12042",607,520,513,13,7,"CCD",1
46,"46133",533,415,410,6,5,"CCD",0
46,"46257",5571,4266,4224,25,42,"CCD",13
12,"12077",4605,3439,3382,15,57,"CCD",15
12,"12103",91,69,67,0,2,"CCD",1
12,"12007",746,651,636,3,15,"CCD",1
46,"46253",115,82,82,0,0,"CCD",0
12,"12118",72,55,53,0,2,"CCD",0
12,"12048",251,185,182,0,3,"CCD",0
12,"12021",4436,3381,3332,27,49,"CCD",25
12,"12141",101,83,83,0,0,"CCD",0
46,"46209",1933,1445,1415,5,30,"CCD",8
46,"46104",1940,1504,1487,7,17,"CCD",2
12,"12082",9617,7324,7231,46,93,"CCD",104
46,"46012",896,682,663,1,19,"CCD",1
12,"12093",178,137,136,2,1,"CCD",1
12,"12053",2034,1655,1633,6,22,"CCD",9
46,"46018",608,515,511,0,4,"CCD",5
46,"46131",49431,36570,36227,231,343,"CCD",120
46,"46212",1620,1150,1124,9,26,"CCD",2
12,"12113",83,67,66,3,1,"CCD",0
46,"46073",1092,888,884,6,4,"CCD",1
46,"46072",3611,2871,2821,23,50,"CCD",8
46,"46226",41,36,35,0,1,"CCD",0
46,"46139",4485,3617,3574,18,43,"CCD",11
46,"46070",16950,12765,12676,61,89,"CCD",56
47,"47222",83,64,64,1,0,"CCD-CI",1
47,"47082",812,640,628,8,12,"CCD-CI",2
47,"47110",450,350,346,1,4,"CCD-CI",5
47,"47068",34,26,26,0,0,"CCD-CI",0
47,"47076",17399,13097,12972,92,125,"CCD-CI",113
47,"47079",58,48,47,0,1,"CCD-CI",0
47,"47088",103,86,85,1,1,"CCD-CI",1
47,"47160",425,308,303,0,5,"CCD-CI",8
47,"47096",140,110,110,0,0,"CCD-CI",0
47,"47097",325,266,265,0,1,"CCD-CI",4
47,"47017",201,158,153,1,5,"CCD-CI",2
47,"47113",159,129,128,0,1,"CCD-CI",1
47,"47042",54,37,37,0,0,"CCD-CI",0
47,"47195",459,345,344,4,1,"CCD-CI",4
47,"47105",183,158,156,0,2,"CCD-CI",0
47,"47117",301,233,227,2,6,"CCD-CI",3
47,"47061",256,212,211,2,1,"CCD-CI",5
47,"47044",331,293,290,2,3,"CCD-CI",4
47,"47094",133,115,114,1,1,"CCD-CI",0
47,"47003",227,180,179,3,1,"CCD-CI",1
47,"47217",1910,1370,1366,1,4,"CCD-CI",17
47,"47156",162,136,133,0,3,"CCD-CI",4
47,"47149",42,34,34,3,0,"CCD-CI",0
47,"47116",416,341,339,0,2,"CCD-CI",0
47,"47139",1040,777,767,6,10,"CCD-CI",10
47,"47232",102,77,74,1,3,"CCD-CI",1
47,"47163",290,230,228,3,2,"CCD-CI",0
47,"47027",2745,2036,2018,9,18,"CCD-CI",6
47,"47127",137,98,97,0,1,"CCD-CI",0
47,"47018",34,28,28,0,0,"CCD-CI",1
47,"47008",24,19,19,1,0,"CCD-CI",0
47,"47084",1150,887,870,7,17,"CCD-CI",9
47,"47223",157,122,118,2,4,"CCD-CI",1
47,"47199",80,63,63,0,0,"CCD-CI",0
47,"47228",440,331,331,2,0,"CCD-CI",0
47,"47045",763,575,567,1,8,"CCD-CI",18
47,"47191",108,79,79,0,0,"CCD-CI",0
47,"47159",822,644,636,1,8,"CCD-CI",8
47,"47216",115,91,87,0,4,"CCD-CI",2
47,"47063",103,81,80,1,1,"CCD-CI",0
47,"47023",2995,2344,2326,18,18,"CCD-CI",22
47,"47146",255,206,204,1,2,"CCD-CI",3
47,"47099",150,135,135,1,0,"CCD-CI",8
47,"47172",144,124,122,0,2,"CCD-CI",0
47,"47118",168,127,127,2,0,"CCD-CI",1
47,"47125",58,46,46,0,0,"CCD-CI",0
47,"47057",268,197,196,0,1,"CCD-CI",1
47,"47170",33,28,27,2,1,"CCD-CI",0
47,"47036",228,181,181,3,0,"CCD-CI",1
47,"47194",298,239,237,2,2,"CCD-CI",3
47,"47177",105,76,73,1,3,"CCD-CI",0
47,"47098",576,464,452,4,12,"CCD-CI",2
47,"47015",200,162,160,0,2,"CCD-CI",0
47,"47074",149,117,116,2,1,"CCD-CI",0
47,"47168",29,26,26,1,0,"CCD-CI",0
47,"47126",50,41,41,0,0,"CCD-CI",0
47,"47119",92,80,79,1,1,"CCD-CI",3
47,"47142",141,99,97,0,2,"CCD-CI",0
47,"47077",246,193,191,1,2,"CCD-CI",1
47,"47020",280,234,231,2,3,"CCD-CI",3
47,"47106",50,39,39,0,0,"CCD-CI",0
47,"47144",78,64,64,1,0,"CCD-CI",1
47,"47111",1020,742,732,7,10,"CCD-CI",3
47,"47171",407,303,301,6,2,"CCD-CI",6
47,"47122",2032,1563,1535,7,28,"CCD-CI",9
47,"47183",130,106,105,0,1,"CCD-CI",1
47,"47200",85,66,66,0,0,"CCD-CI",0
47,"47092",110,87,87,0,0,"CCD-CI",1
47,"47214",1409,1087,1062,7,25,"CCD-CI",7
47,"47124",392,316,311,3,5,"CCD-CI",0
47,"47062",163,130,130,0,0,"CCD-CI",1
47,"47060",258,216,214,1,2,"CCD-CI",1
47,"47065",857,674,669,1,5,"CCD-CI",3
47,"47178",172,140,140,3,0,"CCD-CI",2
47,"47093",813,613,600,5,13,"CCD-CI",3
47,"47148",442,342,338,2,4,"CCD-CI",4
47,"47150",274,209,205,0,4,"CCD-CI",5
47,"47035",921,717,715,3,2,"CCD-CI",8
47,"47115",281,236,233,3,3,"CCD-CI",3
47,"47014",51,45,45,0,0,"CCD-CI",0
47,"47087",381,301,297,3,4,"CCD-CI",0
47,"47184",573,453,451,1,2,"CCD-CI",5
47,"47049",101,68,68,0,0,"CCD-CI",0
47,"47102",291,230,220,1,10,"CCD-CI",1
47,"47085",16612,11829,11706,114,123,"CCD-CI",106
47,"47006",190,136,135,1,1,"CCD-CI",1
47,"47196",34,27,27,0,0,"CCD-CI",1
47,"47147",116,92,92,0,0,"CCD-CI",3
47,"47128",60,52,51,0,1,"CCD-CI",0
47,"47056",87,67,67,0,0,"CCD-CI",0
47,"47083",80,59,54,1,5,"CCD-CI",0
47,"47218",993,743,734,2,9,"CCD-CI",5
47,"47179",395,293,287,0,6,"CCD-CI",2
47,"47086",3906,2970,2936,24,34,"CCD-CI",24
47,"47185",99,73,71,0,2,"CCD-CI",0
47,"47024",259,208,207,1,1,"CCD-CI",0
47,"47225",80,63,63,0,0,"CCD-CI",2
47,"47188",111,88,88,3,0,"CCD-CI",1
47,"47162",74,60,60,0,0,"CCD-CI",0
47,"47114",4045,2787,2762,26,25,"CCD-CI",28
47,"47001",55,46,46,0,0,"CCD-CI",0
47,"47180",73,61,60,4,1,"CCD-CI",1
47,"47206",92,80,80,0,0,"CCD-CI",0
47,"47064",33,28,25,0,3,"CCD-CI",0
47,"47016",69,56,55,0,1,"CCD-CI",0
47,"47050",3719,2630,2598,26,32,"CCD-CI",19
47,"47007",3769,2765,2736,24,29,"CCD-CI",35
47,"47021",76,64,64,0,0,"CCD-CI",1
47,"47101",1710,1357,1336,16,21,"CCD-CI",26
47,"47189",152,119,118,0,1,"CCD-CI",1
47,"47166",259,204,197,2,7,"CCD-CI",0
47,"47205",384,266,260,0,6,"CCD-CI",2
47,"47231",4401,3299,3277,24,22,"CCD-CI",37
47,"47013",100,82,81,1,1,"CCD-CI",0
47,"47025",120,94,94,1,0,"CCD-CI",0
47,"47030",993,766,751,6,15,"CCD-CI",6
47,"47004",1181,939,930,7,9,"CCD-CI",2
47,"47198",69,50,50,0,0,"CCD-CI",0
47,"47019",85,74,73,0,1,"CCD-CI",0
47,"47066",1268,981,977,12,4,"CCD-CI",12
47,"47040",64,53,53,0,0,"CCD-CI",1
47,"47215",53,45,45,0,0,"CCD-CI",0
47,"47152",78,60,60,0,0,"CCD-CI",0
47,"47026",46,40,40,1,0,"CCD-CI",0
47,"47229",210,148,147,1,1,"CCD-CI",1
47,"47046",118,92,90,1,2,"CCD-CI",1
47,"47224",87,76,76,0,0,"CCD-CI",1
47,"47134",165,128,125,1,3,"CCD-CI",1
47,"47052",6576,4988,4944,40,44,"CCD-CI",44
47,"47043",297,239,237,0,2,"CCD-CI",1
47,"47067",174,127,126,0,1,"CCD-CI",2
47,"47204",256,204,198,0,6,"CCD-CI",12
47,"47138",241,170,164,1,6,"CCD-CI",7
47,"47009",107,86,85,0,1,"CCD-CI",0
47,"47038",105,77,77,0,0,"CCD-CI",0
47,"47012",113,93,93,0,0,"CCD-CI",0
47,"47091",84,71,71,2,0,"CCD-CI",0
47,"47210",382,282,274,3,8,"CCD-CI",3
47,"47137",29,25,25,1,0,"CCD-CI",0
47,"47207",278,215,212,3,3,"CCD-CI",0
47,"47132",45,36,33,1,3,"CCD-CI",0
47,"47197",876,673,668,8,5,"CCD-CI",8
47,"47103",267,197,192,5,5,"CCD-CI",0
47,"47213",109,82,82,0,0,"CCD-CI",0
47,"47089",148,125,124,0,1,"CCD-CI",1
47,"47145",603,448,441,3,7,"CCD-CI",11
47,"47071",410,324,321,4,3,"CCD-CI",1
47,"47095",38,31,31,0,0,"CCD-CI",0
47,"47219",41,36,34,0,2,"CCD-CI",0
47,"47078",163,127,125,1,2,"CCD-CI",3
47,"47010",13729,10549,10454,81,95,"CCD-CI",98
47,"47153",108,77,77,0,0,"CCD-CI",0
47,"47028",33,21,21,0,0,"CCD-CI",0
47,"47151",27,24,24,0,0,"CCD-CI",0
47,"47208",58,38,36,1,2,"CCD-CI",0
47,"47175",6564,4781,4728,39,53,"CCD-CI",45
47,"47169",68,59,59,0,0,"CCD-CI",0
47,"47051",335,268,263,2,5,"CCD-CI",0
47,"47034",72,58,58,3,0,"CCD-CI",0
47,"47167",241,204,204,1,0,"CCD-CI",0
47,"47002",23,21,20,1,1,"CCD-CI",3
47,"47037",168,138,133,0,5,"CCD-CI",3
47,"47226",156,123,123,0,0,"CCD-CI",0
47,"47011",565,461,458,5,3,"CCD-CI",2
47,"47005",549,413,408,2,5,"CCD-CI",8
47,"47203",62,53,53,1,0,"CCD-CI",0
47,"47158",889,667,659,8,8,"CCD-CI",3
47,"47073",122,103,101,1,2,"CCD-CI",0
47,"47055",203,167,163,0,4,"CCD-CI",0
47,"47227",61,50,50,0,0,"CCD-CI",0
47,"47190",98,80,80,1,0,"CCD-CI",0
47,"47029",57,52,52,0,0,"CCD-CI",0
47,"47154",152,128,125,1,3,"CCD-CI",2
47,"47221",111,94,94,0,0,"CCD-CI",0
47,"47058",200,145,143,0,2,"CCD-CI",0
47,"47041",150,112,110,2,2,"CCD-CI",0
47,"47141",134,111,110,0,1,"CCD-CI",0
47,"47070",37,27,27,0,0,"CCD-CI",0
47,"47039",185,141,140,0,1,"CCD-CI",0
47,"47182",1323,977,967,8,10,"CCD-CI",5
47,"47129",871,664,659,4,5,"CCD-CI",8
47,"47080",30,22,21,0,1,"CCD-CI",0
47,"47135",83,72,72,2,0,"CCD-CI",0
47,"47100",138,117,117,1,0,"CCD-CI",1
47,"47165",6955,4955,4303,66,652,"CCD-CI",65
47,"47181",165,135,132,3,3,"CCD-CI",2
47,"47164",378,313,311,1,2,"CCD-CI",1
47,"47187",84,61,58,0,3,"CCD-CI",1
47,"47143",118,91,90,0,1,"CCD-CI",0
47,"47109",179,138,138,2,0,"CCD-CI",0
47,"47155",3228,2277,2254,18,23,"CCD-CI",19
47,"47173",880,644,638,20,6,"CCD-CI",5
47,"47031",189,145,145,1,0,"CCD-CI",1
47,"47075",4856,3681,3637,24,44,"CCD-CI",37
47,"47157",515,424,423,1,1,"CCD-CI",1
47,"47112",2587,2015,1988,7,27,"CCD-CI",16
47,"47054",635,507,495,9,12,"CCD-CI",2
47,"47069",124,105,104,1,1,"CCD-CI",0
47,"47032",152,117,116,1,1,"CCD-CI",5
47,"47186",246129,186191,184733,1198,1458,"CCD-CI",1450
47,"47090",2418,1728,1699,8,29,"CCD-CI",12
47,"47048",188,144,144,1,0,"CCD-CI",0
47,"47140",115,102,102,1,0,"CCD-CI",0
47,"47230",303,246,242,2,4,"CCD-CI",3
47,"47209",41,34,34,0,0,"CCD-CI",0
47,"47212",380,323,322,2,1,"CCD-CI",1
47,"47133",2682,2033,2015,16,18,"CCD-CI",26
47,"47059",97,76,76,2,0,"CCD-CI",1
47,"47176",219,139,139,1,0,"CCD-CI",0
47,"47121",544,437,425,6,12,"CCD-CI",14
47,"47131",170,134,128,2,6,"CCD-CI",2
47,"47130",96,72,72,0,0,"CCD-CI",1
47,"47123",466,354,352,4,2,"CCD-CI",1
47,"47047",199,157,156,2,1,"CCD-CI",0
47,"47081",45,36,35,1,1,"CCD-CI",2
47,"47033",196,154,154,1,0,"CCD-CI",2
47,"47104",2836,2182,2121,19,61,"CCD-CI",29
47,"47220",165,130,129,0,1,"CCD-CI",2
47,"47192",102,83,81,1,2,"CCD-CI",0
47,"47193",1577,1251,1241,7,10,"CCD-CI",12
47,"47022",59,50,49,0,1,"CCD-CI",0
47,"47161",3918,3145,3126,12,19,"CCD-CI",20
47,"47053",119,98,96,0,2,"CCD-CI",1
47,"47174",267,218,215,1,3,"CCD-CI",0
47,"47211",47,35,34,0,1,"CCD-CI",0
25,"25912",857,547,539,1,8,"CDC",74
8,"8016",1831,1136,1129,19,7,"CDC",288
8,"8242",219,153,153,4,0,"CDC",46
43,"43134",282,191,191,4,0,"CDC",32
17,"17227",129,86,85,5,1,"CDC",21
8,"8010",4168,2631,2606,20,25,"CDC",637
8,"8019",1136351,768170,764030,5799,4140,"CDC",103028
43,"43116",451,324,317,5,7,"CDC",86
43,"43160",1276,837,826,8,11,"CDC",102
8,"8060",144,87,87,0,0,"CDC",37
25,"25151",685,425,419,7,6,"CDC",142
25,"25024",351,226,223,2,3,"CDC",59
25,"25209",1495,995,978,9,17,"CDC",248
25,"25003",3762,2215,2195,22,20,"CDC",544
8,"8105",9630,6394,6339,49,55,"CDC",199
43,"43161",17197,10481,10400,95,81,"CDC",2127
43,"43119",799,470,468,8,2,"CDC",63
17,"17173",180,132,131,0,1,"CDC",35
17,"17191",141,92,89,1,3,"CDC",44
8,"8117",2450,1602,1594,11,8,"CDC",439
8,"8100",2001,1395,1380,25,15,"CDC",603
25,"25039",277,181,180,3,1,"CDC",42
43,"43123",70482,44051,43675,345,376,"CDC",5959
17,"17172",454,300,297,0,3,"CDC",89
43,"43039",99,66,66,0,0,"CDC",16
8,"8259",6637,4611,4577,39,34,"CDC",971
25,"25114",98,72,72,0,0,"CDC",40
8,"8118",17547,12183,12108,105,75,"CDC",2019
25,"25146",227,140,140,3,0,"CDC",64
17,"17144",206,141,141,3,0,"CDC",41
8,"8087",152,121,121,2,0,"CDC",45
43,"43007",641,456,455,3,1,"CDC",127
17,"17010",336,224,224,3,0,"CDC",70
8,"8275",247,179,179,4,0,"CDC",77
17,"17093",891,563,560,6,3,"CDC",156
17,"17102",571,400,400,6,0,"CDC",115
17,"17196",220,150,150,4,0,"CDC",28
25,"25136",95,64,64,1,0,"CDC",23
8,"8197",7648,5020,5000,37,20,"CDC",1000
8,"8086",13582,8612,8557,75,55,"CDC",977
8,"8007",6483,4281,4250,33,31,"CDC",943
25,"25250",345,210,204,0,6,"CDC",67
25,"25096",902,534,525,10,9,"CDC",129
8,"8037",1864,1242,1230,14,12,"CDC",463
43,"43048",805,525,513,8,12,"CDC",86
25,"25911",451,273,271,7,2,"CDC",116
8,"8078",219,112,111,3,1,"CDC",52
8,"8149",993,569,567,10,2,"CDC",187
25,"25071",49,31,31,0,0,"CDC",10
8,"8264",4325,2929,2908,26,21,"CDC",672
8,"8073",61814,42275,42025,294,250,"CDC",1335
25,"25179",162,103,103,2,0,"CDC",43
8,"8237",1643,1105,1096,8,9,"CDC",398
17,"17117",14353,8469,8426,49,43,"CDC",1573
43,"43038",21366,13061,12943,111,118,"CDC",1571
17,"17162",150,86,86,1,0,"CDC",20
17,"17200",613,424,422,5,2,"CDC",114
25,"25223",922,553,543,8,10,"CDC",183
8,"8201",442,278,278,4,0,"CDC",87
25,"25248",891,592,586,6,6,"CDC",244
43,"43094",2143,1395,1375,13,20,"CDC",289
8,"8158",3082,2054,2041,21,13,"CDC",263
25,"25133",706,432,427,8,5,"CDC",181
43,"43103",880,547,545,4,2,"CDC",69
25,"25051",1527,931,920,11,11,"CDC",260
17,"17089",5543,3349,3326,22,23,"CDC",907
25,"25137",8585,5143,5095,56,48,"CDC",1295
17,"17202",3791,2280,2263,18,17,"CDC",458
8,"8168",358,231,231,5,0,"CDC",55
8,"8200",61409,41278,41024,312,254,"CDC",1833
17,"17020",3592,2333,2315,20,18,"CDC",682
25,"25044",188,122,120,7,2,"CDC",41
43,"43001",691,441,439,4,2,"CDC",99
43,"43082",365,290,286,5,4,"CDC",96
17,"17134",228,162,161,0,1,"CDC",45
17,"17218",582,404,401,1,3,"CDC",122
17,"17169",2475,1619,1601,11,18,"CDC",338
25,"25255",417,298,296,2,2,"CDC",82
43,"43075",89,61,60,1,1,"CDC",22
25,"25183",499,326,323,7,3,"CDC",97
8,"8196",19233,12733,12671,94,62,"CDC",498
43,"43114",392,271,268,2,3,"CDC",47
43,"43015",112,87,86,0,1,"CDC",28
25,"25097",84,65,65,3,0,"CDC",14
25,"25154",122,74,72,0,2,"CDC",24
43,"43138",2672,1629,1585,37,44,"CDC",280
8,"8218",8009,5105,5075,59,30,"CDC",799
17,"17028",293,205,204,6,1,"CDC",79
25,"25166",181,110,109,2,1,"CDC",32
25,"25254",728,457,451,2,6,"CDC",104
43,"43170",868,566,562,5,4,"CDC",141
8,"8224",820,557,551,2,6,"CDC",98
25,"25011",5243,2796,2767,23,29,"CDC",542
8,"8905",2346,1689,1681,26,8,"CDC",320
43,"43025",600,408,404,2,4,"CDC",48
8,"8207",1865,1407,1402,19,5,"CDC",399
17,"17039",1759,1159,1145,14,14,"CDC",380
25,"25194",423,246,244,6,2,"CDC",105
17,"17158",476,276,274,1,2,"CDC",57
43,"43113",393,279,278,5,1,"CDC",96
8,"8106",7279,4871,4845,40,26,"CDC",683
25,"25085",148,107,107,0,0,"CDC",29
8,"8280",97,66,66,2,0,"CDC",22
25,"25021",2607,1490,1481,20,9,"CDC",315
8,"8188",115,78,78,0,0,"CDC",22
17,"17094",1059,602,600,4,2,"CDC",173
25,"25069",451,247,246,4,1,"CDC",68
8,"8052",141,88,88,0,0,"CDC",38
17,"17194",80,55,54,0,1,"CDC",17
25,"25010",211,113,113,2,0,"CDC",21
25,"25150",181,115,113,3,2,"CDC",42
17,"17193",4216,2555,2525,16,30,"CDC",476
8,"8103",625,395,395,2,0,"CDC",86
43,"43152",439,323,320,2,3,"CDC",106
8,"8150",255,186,186,1,0,"CDC",69
25,"25035",398,249,247,2,2,"CDC",59
43,"43078",846,543,531,8,12,"CDC",132
25,"25126",290,200,198,2,2,"CDC",54
8,"8187",152377,102805,102199,805,606,"CDC",11459
8,"8110",13315,8457,8368,73,89,"CDC",1141
8,"8146",1286,885,881,12,4,"CDC",67
8,"8240",9348,6512,6483,38,29,"CDC",1196
25,"25155",647,421,418,0,3,"CDC",144
43,"43102",480,332,324,3,8,"CDC",56
17,"17111",880,590,586,7,4,"CDC",203
25,"25233",275,178,178,4,0,"CDC",37
25,"25041",568,347,344,4,3,"CDC",82
25,"25002",482,316,314,2,2,"CDC",92
43,"43080",239,183,181,0,2,"CDC",55
17,"17183",277,180,179,1,1,"CDC",63
8,"8006",11470,7210,7132,60,78,"CDC",1513
43,"43021",357,232,231,6,1,"CDC",63
17,"17198",429,270,267,2,3,"CDC",65
43,"43111",2044,1291,1275,9,16,"CDC",109
25,"25030",135,74,72,1,2,"CDC",32
17,"17145",1482,967,956,8,11,"CDC",331
25,"25905",375,249,246,3,3,"CDC",80
17,"17082",417,255,253,2,2,"CDC",98
25,"25157",181,115,114,7,1,"CDC",31
17,"17044",6770,4411,4376,33,35,"CDC",1306
8,"8291",4536,2975,2965,21,10,"CDC",281
25,"25012",2334,1322,1310,8,12,"CDC",219
25,"25253",159,105,105,1,0,"CDC",34
25,"25007",1405,850,841,8,9,"CDC",150
17,"17095",19555,11537,11428,89,109,"CDC",1481
17,"17041",218,130,129,2,1,"CDC",22
8,"8047",3899,2292,2260,16,32,"CDC",443
8,"8066",1365,926,921,8,5,"CDC",119
17,"17062",5958,3463,3441,22,22,"CDC",727
8,"8098",2381,1544,1534,5,10,"CDC",282
8,"8134",810,541,538,7,3,"CDC",111
8,"8054",8998,6172,6129,44,43,"CDC",556
17,"17130",325,223,222,3,1,"CDC",93
17,"17177",549,332,331,1,1,"CDC",112
17,"17112",190,127,125,2,2,"CDC",52
17,"17071",1134,778,774,10,4,"CDC",244
25,"25023",4531,2782,2763,30,19,"CDC",625
17,"17088",533,368,366,4,2,"CDC",108
43,"43051",8512,5418,5366,32,52,"CDC",294
25,"25005",279,175,175,4,0,"CDC",50
8,"8032",1981,1319,1311,11,8,"CDC",271
43,"43074",1754,1170,1157,9,13,"CDC",274
8,"8172",20326,13875,13802,92,73,"CDC",1748
25,"25111",117,72,70,2,2,"CDC",38
8,"8131",704,471,468,7,3,"CDC",135
25,"25038",1545,995,986,17,9,"CDC",326
43,"43173",100,53,51,0,2,"CDC",11
25,"25240",1383,925,919,16,6,"CDC",203
25,"25180",234,143,143,1,0,"CDC",53
8,"8051",17948,12140,12076,102,64,"CDC",1717
8,"8092",3736,2369,2342,13,27,"CDC",702
8,"8295",10870,6972,6918,51,54,"CDC",616
8,"8104",679,432,430,3,2,"CDC",133
17,"17022",6910,4207,4184,58,23,"CDC",855
17,"17136",178,125,124,0,1,"CDC",44
8,"8270",18490,12343,12274,93,69,"CDC",1835
43,"43053",191,144,143,3,1,"CDC",30
43,"43004",6281,3993,3929,38,64,"CDC",342
25,"25224",126,70,70,5,0,"CDC",21
8,"8241",73,52,52,0,0,"CDC",21
8,"8302",9218,5946,5891,82,55,"CDC",278
17,"17052",125,78,78,0,0,"CDC",24
43,"43041",216,152,151,0,1,"CDC",20
25,"25020",289,206,205,3,1,"CDC",70
8,"8043",3201,2056,2041,9,15,"CDC",208
25,"25048",1651,1051,1040,11,11,"CDC",295
25,"25009",627,444,440,8,4,"CDC",150
8,"8170",450,276,274,7,2,"CDC",92
8,"8089",33850,22230,22096,170,134,"CDC",1467
43,"43050",2505,1507,1496,12,11,"CDC",145
25,"25910",100,63,61,2,2,"CDC",17
25,"25140",788,435,430,9,5,"CDC",116
8,"8121",86351,57040,56655,446,385,"CDC",6703
17,"17205",208,157,155,1,2,"CDC",68
8,"8090",128,101,101,2,0,"CDC",46
17,"17210",551,350,349,9,1,"CDC",107
25,"25205",566,382,372,8,10,"CDC",107
25,"25145",86,65,64,1,1,"CDC",29
25,"25055",169,105,104,4,1,"CDC",53
8,"8157",8382,5823,5789,45,34,"CDC",512
17,"17234",182,115,114,0,1,"CDC",20
8,"8136",11450,7703,7641,84,62,"CDC",381
8,"8904",10553,6623,6579,52,44,"CDC",61
17,"17015",12546,7832,7777,66,55,"CDC",2474
8,"8122",1698,1080,1073,5,7,"CDC",148
17,"17054",370,236,236,1,0,"CDC",53
43,"43166",1584,1029,1022,6,7,"CDC",141
8,"8273",2333,1654,1637,10,17,"CDC",452
8,"8193",944,601,596,12,5,"CDC",104
17,"17161",992,726,721,10,5,"CDC",239
17,"17143",142,103,99,1,4,"CDC",40
8,"8283",5963,3670,3642,24,28,"CDC",1128
8,"8038",1487,959,954,15,5,"CDC",251
8,"8261",2327,1499,1493,11,6,"CDC",220
25,"25186",213,124,122,3,2,"CDC",47
8,"8025",1490,981,978,4,3,"CDC",158
25,"25131",403,248,241,7,7,"CDC",42
8,"8147",16967,11220,11138,65,82,"CDC",1118
25,"25173",1705,1156,1143,14,13,"CDC",173
25,"25168",509,354,352,7,2,"CDC",110
43,"43127",743,528,527,2,1,"CDC",148
17,"17225",214,139,139,3,0,"CDC",37
8,"8297",134,85,84,0,1,"CDC",43
43,"43059",252,188,188,2,0,"CDC",73
43,"43168",96,57,57,3,0,"CDC",18
8,"8057",60,45,44,1,1,"CDC",17
17,"17160",14747,9189,9129,65,60,"CDC",1614
8,"8107",11502,7510,7445,67,65,"CDC",554
17,"17226",867,549,546,8,3,"CDC",93
8,"8272",151,90,90,1,0,"CDC",38
8,"8281",4802,3343,3318,17,25,"CDC",802
8,"8018",2636,1690,1675,23,15,"CDC",331
25,"25243",3646,2193,2167,33,26,"CDC",217
17,"17014",64,48,48,1,0,"CDC",8
43,"43155",22873,14209,14082,153,127,"CDC",2388
43,"43024",1537,993,983,8,10,"CDC",110
8,"8290",1507,1118,1110,12,8,"CDC",258
8,"8024",386,243,236,0,7,"CDC",79
25,"25163",231,135,132,2,3,"CDC",52
17,"17186",3788,2554,2526,27,28,"CDC",436
43,"43157",353,268,264,5,4,"CDC",71
43,"43034",477,350,342,9,8,"CDC",78
25,"25034",2326,1361,1340,15,21,"CDC",454
43,"43156",3946,2524,2470,28,54,"CDC",321
43,"43020",2215,1508,1497,9,11,"CDC",195
17,"17032",1721,967,961,10,6,"CDC",228
43,"43061",45,30,29,0,1,"CDC",15
25,"25121",644,415,410,8,5,"CDC",45
43,"43144",1247,842,836,6,6,"CDC",114
25,"25104",130,76,74,1,2,"CDC",34
8,"8123",19140,13557,13484,106,73,"CDC",1851
17,"17055",150,110,109,0,1,"CDC",39
17,"17047",4798,2773,2757,28,16,"CDC",437
17,"17061",156,104,103,1,1,"CDC",35
43,"43171",14599,9083,9011,72,72,"CDC",793
25,"25086",522,346,341,2,5,"CDC",111
43,"43150",1281,937,923,6,14,"CDC",227
25,"25153",192,130,128,2,2,"CDC",23
8,"8284",12097,7157,7089,59,68,"CDC",1131
17,"17221",4153,2577,2564,27,13,"CDC",415
43,"43136",10351,6279,6218,63,61,"CDC",763
8,"8243",162,113,113,7,0,"CDC",53
43,"43167",375,277,275,9,2,"CDC",81
17,"17171",165,117,116,2,1,"CDC",36
8,"8294",1966,1287,1280,17,7,"CDC",255
8,"8116",578,387,383,2,4,"CDC",166
43,"43169",450,370,367,10,3,"CDC",77
17,"17070",111,76,76,2,0,"CDC",36
17,"17115",282,183,183,1,0,"CDC",48
8,"8267",6461,4265,4245,51,20,"CDC",548
8,"8271",70,48,48,0,0,"CDC",15
8,"8026",188,134,134,0,0,"CDC",54
8,"8076",16169,10652,10563,75,89,"CDC",912
17,"17125",130,80,80,0,0,"CDC",37
25,"25037",375,247,246,5,1,"CDC",71
25,"25124",166,106,105,1,1,"CDC",41
25,"25062",750,486,482,1,4,"CDC",131
43,"43120",441,270,267,1,3,"CDC",25
8,"8171",2103,1288,1280,12,8,"CDC",478
17,"17085",301,215,214,5,1,"CDC",67
8,"8268",1005,665,659,4,6,"CDC",132
8,"8308",131,87,87,1,0,"CDC",69
43,"43052",938,628,621,12,7,"CDC",101
17,"17206",146,88,86,1,2,"CDC",23
25,"25077",463,256,253,6,3,"CDC",58
25,"25210",1108,685,677,3,8,"CDC",244
8,"8215",2588,1663,1647,16,16,"CDC",497
8,"8050",141,99,99,2,0,"CDC",48
17,"17024",268,153,152,1,1,"CDC",55
43,"43093",3919,2461,2434,47,27,"CDC",496
17,"17073",1873,1363,1356,15,7,"CDC",474
43,"43175",554,363,360,5,3,"CDC",105
25,"25211",680,386,379,4,7,"CDC",81
8,"8202",12680,8341,8278,75,63,"CDC",1746
43,"43013",4411,2750,2739,19,11,"CDC",410
8,"8902",3761,2570,2558,31,12,"CDC",419
43,"43058",90,63,63,0,0,"CDC",23
8,"8070",266,194,191,2,3,"CDC",75
25,"25197",133,89,88,1,1,"CDC",31
25,"25040",10546,6367,6300,61,67,"CDC",1289
17,"17188",164,124,124,1,0,"CDC",45
8,"8289",4338,2912,2898,27,14,"CDC",391
25,"25212",233,154,153,6,1,"CDC",55
43,"43100",3301,2183,2172,24,11,"CDC",193
8,"8014",1962,1366,1359,15,7,"CDC",355
25,"25102",707,420,407,6,13,"CDC",119
17,"17142",2550,1806,1797,30,9,"CDC",397
8,"8035",12547,7877,7828,51,49,"CDC",1596
17,"17146",2969,1868,1855,8,13,"CDC",265
43,"43151",107,90,89,0,1,"CDC",13
8,"8226",891,648,645,6,3,"CDC",213
17,"17181",3372,2135,2112,12,23,"CDC",425
8,"8217",24989,17765,17661,114,104,"CDC",1237
25,"25049",151,110,108,1,2,"CDC",47
8,"8204",3055,2094,2082,17,12,"CDC",314
25,"25001",144,73,73,0,0,"CDC",23
8,"8245",78562,50821,50538,384,283,"CDC",1181
8,"8023",6734,4350,4323,35,27,"CDC",594
43,"43070",238,192,191,1,1,"CDC",34
43,"43107",383,238,237,7,1,"CDC",38
8,"8068",6718,4373,4343,33,30,"CDC",476
8,"8232",1775,1183,1176,6,7,"CDC",292
25,"25216",226,138,136,1,2,"CDC",53
43,"43097",393,291,289,1,2,"CDC",83
17,"17223",801,516,506,9,10,"CDC",103
25,"25903",236,161,161,3,0,"CDC",57
8,"8082",1139,711,708,4,3,"CDC",76
25,"25904",148,112,111,2,1,"CDC",41
17,"17081",246,163,162,2,1,"CDC",61
8,"8109",216,162,161,0,1,"CDC",40
17,"17101",559,347,338,2,9,"CDC",58
43,"43902",2743,1551,1531,23,20,"CDC",157
8,"8192",5678,3729,3707,35,22,"CDC",842
25,"25172",1797,1170,1146,10,24,"CDC",355
43,"43085",226,180,180,1,0,"CDC",38
17,"17042",419,272,272,2,0,"CDC",87
25,"25013",2146,1240,1226,16,14,"CDC",199
8,"8256",650,484,484,5,0,"CDC",71
17,"17123",354,266,263,0,3,"CDC",132
8,"8151",466,288,287,2,1,"CDC",144
25,"25067",719,467,460,7,7,"CDC",100
43,"43095",2474,1575,1551,17,24,"CDC",260
17,"17212",141,104,102,0,2,"CDC",51
17,"17051",218,145,142,1,3,"CDC",50
43,"43077",463,272,272,5,0,"CDC",16
8,"8239",453,304,302,3,2,"CDC",77
8,"8013",1224,802,793,9,9,"CDC",237
17,"17133",1255,805,796,9,9,"CDC",353
17,"17138",928,637,633,4,4,"CDC",100
17,"17057",968,641,636,11,5,"CDC",162
17,"17027",2821,1896,1889,17,7,"CDC",458
8,"8258",830,557,551,6,6,"CDC",170
8,"8227",2326,1508,1487,20,21,"CDC",393
17,"17092",3509,2256,2223,18,33,"CDC",445
17,"17124",1607,1027,1007,11,20,"CDC",288
8,"8045",73,37,35,0,2,"CDC",13
25,"25190",262,185,183,0,2,"CDC",43
43,"43129",4580,2844,2805,23,39,"CDC",825
17,"17019",1775,1201,1188,7,13,"CDC",465
17,"17214",705,423,419,2,4,"CDC",127
8,"8015",155409,99368,98735,820,633,"CDC",6413
43,"43089",292,190,186,0,4,"CDC",36
8,"8002",201,130,124,0,6,"CDC",49
8,"8072",10259,6462,6422,42,40,"CDC",817
25,"25220",1015,634,632,1,2,"CDC",185
25,"25060",72,46,44,1,2,"CDC",17
17,"17190",844,528,528,3,0,"CDC",160
17,"17046",717,459,458,4,1,"CDC",129
8,"8182",2811,1799,1789,22,10,"CDC",156
43,"43047",4161,2359,2341,27,18,"CDC",203
17,"17060",424,268,266,5,2,"CDC",65
25,"25164",376,242,238,4,4,"CDC",101
25,"25148",219,124,124,0,0,"CDC",58
25,"25176",309,216,211,1,5,"CDC",78
17,"17021",131,86,85,4,1,"CDC",24
25,"25221",122,81,81,0,0,"CDC",24
8,"8137",262,188,187,2,1,"CDC",61
25,"25203",8931,5003,4955,72,48,"CDC",1075
25,"25226",253,155,152,3,3,"CDC",61
8,"8229",535,357,354,9,3,"CDC",142
25,"25913",86,67,67,3,0,"CDC",24
8,"8262",6836,4175,4144,50,31,"CDC",561
43,"43163",25248,15802,15663,104,139,"CDC",1531
8,"8220",2356,1690,1683,18,7,"CDC",679
25,"25901",293,202,202,7,0,"CDC",47
17,"17137",3437,2293,2275,19,18,"CDC",707
25,"25165",285,179,176,2,3,"CDC",73
43,"43141",106,68,67,0,1,"CDC",13
17,"17216",165,110,110,1,0,"CDC",39
43,"43118",419,311,308,5,3,"CDC",70
25,"25222",66,52,52,1,0,"CDC",24
17,"17129",133,101,101,1,0,"CDC",14
25,"25098",253,151,150,0,1,"CDC",59
43,"43037",16781,10376,10265,71,111,"CDC",896
17,"17048",6241,3831,3801,36,30,"CDC",834
43,"43064",2015,1310,1296,23,14,"CDC",345
17,"17023",27269,17209,17032,122,177,"CDC",1900
8,"8130",95,56,55,0,1,"CDC",21
43,"43174",138,102,100,1,2,"CDC",29
8,"8254",1739,1159,1156,10,3,"CDC",404
25,"25050",3233,1936,1912,25,24,"CDC",565
43,"43133",5666,3397,3356,27,41,"CDC",329
43,"43011",1077,743,737,2,6,"CDC",186
17,"17233",2260,1528,1514,23,14,"CDC",504
17,"17036",2717,1730,1716,15,14,"CDC",476
17,"17168",380,260,258,0,2,"CDC",87
8,"8255",134,78,78,0,0,"CDC",35
25,"25167",230,138,138,3,0,"CDC",42
17,"17064",322,214,211,4,3,"CDC",56
8,"8214",6872,4699,4675,47,24,"CDC",986
17,"17077",548,369,368,1,1,"CDC",111
8,"8064",1847,1245,1230,9,15,"CDC",353
17,"17090",545,370,368,4,2,"CDC",131
43,"43135",340,235,234,1,1,"CDC",96
43,"43176",785,523,520,4,3,"CDC",158
43,"43121",599,354,348,1,6,"CDC",60
43,"43040",330,257,255,5,2,"CDC",67
43,"43108",1774,1172,1160,14,12,"CDC",274
25,"25118",346,198,189,3,9,"CDC",66
25,"25031",52,29,29,0,0,"CDC",1
8,"8097",1021,715,712,8,3,"CDC",151
25,"25193",759,485,480,2,5,"CDC",213
8,"8138",4248,2638,2618,27,20,"CDC",576
43,"43162",4346,2983,2958,21,25,"CDC",430
8,"8165",1649,1100,1085,9,15,"CDC",240
17,"17192",144,96,93,1,3,"CDC",48
8,"8120",6835,4708,4688,44,20,"CDC",1966
25,"25036",184,112,111,4,1,"CDC",22
8,"8148",2233,1491,1483,7,8,"CDC",81
43,"43110",259,175,175,6,0,"CDC",48
17,"17002",556,401,396,0,5,"CDC",132
43,"43069",182,136,134,1,2,"CDC",25
8,"8022",12212,7210,7155,66,55,"CDC",1976
17,"17209",630,443,438,7,5,"CDC",91
25,"25182",1036,660,655,9,5,"CDC",115
8,"8298",26471,16674,16591,139,83,"CDC",5248
43,"43164",301,205,204,2,1,"CDC",8
25,"25902",567,365,356,8,9,"CDC",105
43,"43083",144,109,108,0,1,"CDC",32
43,"43098",343,235,233,5,2,"CDC",68
25,"25247",123,66,66,1,0,"CDC",6
17,"17135",362,253,253,1,0,"CDC",38
17,"17106",140,103,102,0,1,"CDC",42
25,"25185",692,400,397,6,3,"CDC",94
25,"25201",112,73,72,3,1,"CDC",23
43,"43002",1801,1156,1128,7,28,"CDC",157
8,"8205",59828,43344,43140,367,204,"CDC",8937
8,"8041",10343,6645,6582,57,63,"CDC",445
25,"25202",104,73,72,0,1,"CDC",14
8,"8233",1871,1153,1140,16,13,"CDC",393
8,"8274",4665,3028,3009,26,19,"CDC",523
25,"25171",2185,1416,1410,8,6,"CDC",340
8,"8042",2231,1565,1558,17,7,"CDC",190
17,"17121",224,140,140,1,0,"CDC",61
43,"43071",921,613,607,6,6,"CDC",194
8,"8164",913,618,609,7,9,"CDC",173
25,"25217",10625,6319,6260,99,59,"CDC",1678
8,"8257",107,71,71,0,0,"CDC",40
8,"8174",392,283,279,3,4,"CDC",68
17,"17025",1134,793,787,6,6,"CDC",264
25,"25113",1168,811,803,8,8,"CDC",243
43,"43067",552,397,393,2,4,"CDC",91
25,"25057",208,141,140,0,1,"CDC",13
17,"17026",544,370,367,5,3,"CDC",152
17,"17208",995,594,590,8,4,"CDC",209
25,"25101",561,364,358,2,6,"CDC",105
17,"17150",1401,962,951,6,11,"CDC",368
8,"8248",5419,3566,3546,45,20,"CDC",542
17,"17030",641,400,398,1,2,"CDC",111
8,"8180",26613,17585,17490,153,95,"CDC",774
8,"8190",256,168,165,2,3,"CDC",48
43,"43115",143,100,98,2,2,"CDC",46
25,"25249",182,99,98,1,1,"CDC",21
17,"17084",238,146,144,5,2,"CDC",46
8,"8195",82,63,63,0,0,"CDC",32
43,"43032",517,332,329,5,3,"CDC",88
25,"25103",135,76,76,4,0,"CDC",22
8,"8303",274,193,192,2,1,"CDC",60
8,"8001",8907,6316,6269,46,47,"CDC",279
8,"8113",52035,32351,32150,254,201,"CDC",7245
8,"8277",157,108,107,0,1,"CDC",42
8,"8167",5910,4081,4051,40,30,"CDC",208
25,"25059",805,527,523,7,4,"CDC",50
17,"17189",1516,1076,1070,5,6,"CDC",404
25,"25019",4572,2726,2698,34,28,"CDC",478
43,"43905",14392,8444,8393,45,51,"CDC",696
8,"8059",347,195,195,2,0,"CDC",49
8,"8154",696,494,488,5,6,"CDC",120
43,"43143",54,47,47,3,0,"CDC",19
17,"17152",10737,6308,6252,45,56,"CDC",966
8,"8033",12813,8564,8509,63,55,"CDC",1348
8,"8141",4563,2953,2929,34,24,"CDC",750
43,"43090",1076,565,558,6,7,"CDC",27
25,"25175",186,117,117,1,0,"CDC",38
8,"8017",2762,1701,1688,9,13,"CDC",351
43,"43057",38,25,25,1,0,"CDC",7
43,"43031",1458,1020,1014,15,6,"CDC",281
43,"43149",686,447,443,8,4,"CDC",84
25,"25142",364,229,225,2,4,"CDC",42
17,"17005",413,257,252,3,5,"CDC",69
8,"8021",70,49,46,0,3,"CDC",14
43,"43018",408,325,320,3,5,"CDC",166
8,"8179",579,396,396,5,0,"CDC",68
17,"17087",225,152,149,2,3,"CDC",59
8,"8199",663,456,453,14,3,"CDC",172
25,"25208",331,183,182,1,1,"CDC",28
25,"25076",145,81,81,2,0,"CDC",27
25,"25135",1028,600,593,10,7,"CDC",186
8,"8102",28296,18466,18367,172,99,"CDC",4258
43,"43132",373,264,261,4,3,"CDC",73
17,"17180",8295,4958,4935,36,23,"CDC",1359
17,"17154",92,67,66,0,1,"CDC",6
17,"17100",194,133,131,3,2,"CDC",55
17,"17167",2700,1765,1749,37,16,"CDC",570
8,"8062",956,619,618,4,1,"CDC",125
43,"43106",810,526,522,7,4,"CDC",93
17,"17076",124,86,84,3,2,"CDC",25
25,"25110",2766,1628,1602,22,26,"CDC",447
25,"25064",108,68,68,2,0,"CDC",32
8,"8145",2599,1774,1761,11,13,"CDC",358
17,"17116",354,228,224,3,4,"CDC",67
43,"43065",399,252,251,3,1,"CDC",72
8,"8162",2047,1400,1392,7,8,"CDC",152
8,"8285",10224,6396,6342,52,54,"CDC",1784
43,"43079",364,248,248,0,0,"CDC",83
17,"17063",162,111,109,0,2,"CDC",34
43,"43003",324,217,217,3,0,"CDC",31
43,"43043",3130,2053,2036,18,17,"CDC",209
43,"43016",3416,2335,2309,15,26,"CDC",271
43,"43030",427,288,283,1,5,"CDC",62
17,"17157",125,95,95,1,0,"CDC",47
8,"8119",6180,4155,4123,28,32,"CDC",348
17,"17132",1298,884,877,12,7,"CDC",293
17,"17103",4954,2877,2850,25,27,"CDC",402
25,"25138",569,363,360,4,3,"CDC",108
43,"43148",90275,59182,58757,388,425,"CDC",5468
25,"25025",1353,871,864,16,7,"CDC",113
8,"8163",18641,11801,11729,68,72,"CDC",1193
8,"8230",7635,5177,5121,54,56,"CDC",931
8,"8128",563,375,372,2,3,"CDC",112
17,"17012",1145,703,698,9,5,"CDC",110
17,"17174",178,99,97,2,2,"CDC",26
17,"17204",572,355,354,4,1,"CDC",86
8,"8160",327,208,208,1,0,"CDC",85
17,"17038",366,234,232,6,2,"CDC",89
8,"8161",11144,6994,6938,73,56,"CDC",745
43,"43096",99,81,80,1,1,"CDC",24
25,"25127",210,136,136,2,0,"CDC",37
43,"43055",1975,1384,1379,21,5,"CDC",333
8,"8053",2788,1605,1591,8,14,"CDC",264
17,"17105",247,147,147,1,0,"CDC",31
43,"43014",14251,8737,8624,101,113,"CDC",967
25,"25068",556,346,341,11,5,"CDC",157
25,"25169",173,112,111,3,1,"CDC",32
43,"43177",299,231,230,6,1,"CDC",55
8,"8040",10710,6845,6802,51,43,"CDC",1089
8,"8027",687,486,485,2,1,"CDC",129
25,"25215",345,240,236,0,4,"CDC",40
17,"17040",537,347,345,3,2,"CDC",129
17,"17120",786,517,512,8,5,"CDC",135
25,"25245",435,289,280,5,9,"CDC",36
25,"25191",334,205,204,4,1,"CDC",65
8,"8140",4774,3118,3098,23,20,"CDC",694
43,"43178",1350,856,844,5,12,"CDC",200
25,"25129",175,83,83,2,0,"CDC",35
8,"8304",812,562,558,3,4,"CDC",153
25,"25170",266,169,167,1,2,"CDC",50
25,"25230",1558,1008,993,13,15,"CDC",232
8,"8081",339,222,221,3,1,"CDC",94
8,"8178",435,309,308,4,1,"CDC",80
25,"25056",235,143,143,2,0,"CDC",56
8,"8247",961,637,634,4,3,"CDC",243
43,"43084",526,363,361,10,2,"CDC",55
17,"17109",696,422,419,1,3,"CDC",130
8,"8219",15422,10701,10619,98,82,"CDC",2089
17,"17199",6853,4147,4122,27,25,"CDC",1050
25,"25207",6212,3710,3680,47,30,"CDC",903
8,"8292",1072,730,725,6,5,"CDC",108
17,"17901",987,623,620,9,3,"CDC",161
25,"25004",571,376,373,3,3,"CDC",118
25,"25192",743,449,436,2,13,"CDC",131
25,"25079",299,198,193,2,5,"CDC",82
43,"43045",149,110,110,2,0,"CDC",38
8,"8301",48557,32715,32533,253,182,"CDC",1218
8,"8288",1659,1004,994,7,10,"CDC",145
43,"43072",105,74,72,0,2,"CDC",16
8,"8044",4141,2739,2726,15,13,"CDC",465
17,"17175",578,321,312,5,9,"CDC",34
8,"8084",1142,773,768,14,5,"CDC",183
8,"8249",266,211,209,2,2,"CDC",61
17,"17213",5424,3239,3219,24,20,"CDC",744
8,"8031",2322,1552,1537,6,15,"CDC",437
25,"25189",2110,1198,1186,10,12,"CDC",223
17,"17139",1364,884,865,8,19,"CDC",291
25,"25088",96,73,72,0,1,"CDC",45
17,"17176",124,92,92,1,0,"CDC",19
25,"25219",141,102,101,0,1,"CDC",25
8,"8236",1527,1006,999,4,7,"CDC",197
8,"8250",7061,4480,4448,48,32,"CDC",244
25,"25006",340,201,200,6,1,"CDC",32
17,"17097",196,148,148,3,0,"CDC",49
8,"8063",453,337,336,4,1,"CDC",121
17,"17067",696,467,464,5,3,"CDC",160
8,"8181",7887,5178,5144,48,34,"CDC",743
17,"17049",3117,2092,2072,14,20,"CDC",374
25,"25125",417,250,250,5,0,"CDC",66
8,"8077",34508,24070,23956,127,114,"CDC",1724
43,"43165",577,436,433,3,3,"CDC",133
8,"8124",36804,24782,24632,184,150,"CDC",1611
8,"8127",2225,1349,1334,14,15,"CDC",229
43,"43906",2102,1364,1346,15,18,"CDC",334
25,"25122",1915,1208,1197,16,11,"CDC",295
8,"8238",14531,10378,10325,98,53,"CDC",1684
25,"25134",623,369,366,3,3,"CDC",102
25,"25251",707,443,442,2,1,"CDC",115
17,"17086",1729,1068,1059,8,9,"CDC",146
25,"25156",783,543,537,7,6,"CDC",145
43,"43026",782,524,520,6,4,"CDC",121
25,"25052",1555,1027,1016,14,11,"CDC",284
17,"17230",468,318,317,3,1,"CDC",76
8,"8039",362,266,266,0,0,"CDC",74
43,"43028",2688,1659,1639,6,20,"CDC",259
8,"8266",43030,30192,30039,229,153,"CDC",2271
43,"43023",231,170,169,0,1,"CDC",27
8,"8184",53822,34744,34545,264,199,"CDC",1990
17,"17009",4015,2584,2567,14,17,"CDC",813
8,"8004",223,165,164,2,1,"CDC",76
43,"43159",81,59,59,0,0,"CDC",29
8,"8212",488,319,316,0,3,"CDC",153
17,"17075",330,205,205,1,0,"CDC",50
8,"8036",163,105,104,1,1,"CDC",51
8,"8005",6205,4187,4167,22,20,"CDC",1024
25,"25109",231,163,162,2,1,"CDC",87
25,"25244",361,223,220,5,3,"CDC",56
25,"25014",260,165,165,5,0,"CDC",58
8,"8299",391,244,244,5,0,"CDC",88
25,"25239",590,258,256,5,2,"CDC",70
17,"17155",14515,8393,8330,65,63,"CDC",1417
25,"25094",137,98,95,1,3,"CDC",31
25,"25196",113,57,57,0,0,"CDC",22
25,"25063",87,58,58,1,0,"CDC",6
8,"8286",2879,1802,1797,14,5,"CDC",219
8,"8126",8748,5927,5895,56,32,"CDC",558
17,"17197",132,102,101,1,1,"CDC",23
17,"17185",2265,1420,1404,15,16,"CDC",517
43,"43124",482,308,307,2,1,"CDC",87
8,"8095",73,48,47,0,1,"CDC",22
17,"17128",308,205,203,3,2,"CDC",52
25,"25075",117,72,72,2,0,"CDC",26
43,"43112",279,175,174,0,1,"CDC",50
25,"25070",823,554,549,15,5,"CDC",185
8,"8091",5244,3611,3584,17,27,"CDC",425
17,"17182",263,181,181,6,0,"CDC",15
8,"8282",6578,4714,4690,45,24,"CDC",935
17,"17170",171,125,123,1,2,"CDC",41
17,"17050",652,453,453,3,0,"CDC",134
25,"25908",226,144,143,3,1,"CDC",44
43,"43104",1783,1157,1142,10,15,"CDC",213
8,"8020",4926,3523,3502,33,21,"CDC",607
25,"25181",172,123,120,4,3,"CDC",39
25,"25072",5850,3493,3444,29,49,"CDC",846
8,"8276",237,165,165,2,0,"CDC",39
8,"8009",9180,6207,6192,50,15,"CDC",1163
25,"25139",467,294,291,5,3,"CDC",83
43,"43122",106,77,77,4,0,"CDC",12
8,"8008",190,110,110,5,0,"CDC",22
17,"17079",64395,41049,40699,342,350,"CDC",9208
25,"25027",976,633,630,7,3,"CDC",207
25,"25227",652,402,400,4,2,"CDC",130
17,"17001",587,404,398,2,6,"CDC",95
25,"25029",1655,1042,1029,15,13,"CDC",298
43,"43109",2606,1491,1475,20,16,"CDC",174
8,"8080",34,26,26,3,0,"CDC",7
25,"25238",204,140,138,4,2,"CDC",46
25,"25242",720,456,450,2,6,"CDC",148
43,"43033",765,531,530,4,1,"CDC",97
25,"25128",136,75,75,0,0,"CDC",19
8,"8067",5739,3616,3577,47,39,"CDC",928
17,"17148",1515,981,972,4,9,"CDC",260
17,"17003",104,67,66,0,1,"CDC",25
25,"25082",285,186,178,5,8,"CDC",49
25,"25907",494,266,265,6,1,"CDC",67
17,"17232",152,92,91,1,1,"CDC",28
8,"8263",20972,13710,13583,149,127,"CDC",763
25,"25141",153,95,95,0,0,"CDC",31
8,"8108",5016,3501,3474,21,27,"CDC",386
8,"8209",6773,4410,4382,29,28,"CDC",465
25,"25123",193,134,131,2,3,"CDC",39
17,"17091",407,258,253,5,5,"CDC",105
25,"25143",84,56,55,0,1,"CDC",19
8,"8223",1852,1182,1171,12,11,"CDC",278
8,"8083",1675,1146,1144,9,2,"CDC",441
43,"43153",10688,6675,6615,39,60,"CDC",712
25,"25115",824,489,487,7,2,"CDC",217
8,"8029",3480,2472,2460,25,12,"CDC",680
8,"8234",3200,2128,2114,21,14,"CDC",315
8,"8133",128,72,72,0,0,"CDC",38
17,"17211",830,581,580,10,1,"CDC",218
17,"17078",336,223,220,6,3,"CDC",96
17,"17119",74,54,54,0,0,"CDC",12
8,"8065",1176,797,784,10,13,"CDC",259
8,"8244",5851,4095,4058,36,37,"CDC",370
8,"8166",991,631,625,7,6,"CDC",184
17,"17069",374,256,251,0,5,"CDC",88
17,"17149",364,248,248,0,0,"CDC",80
17,"17056",1715,1120,1106,16,14,"CDC",425
17,"17018",480,327,322,2,5,"CDC",105
43,"43903",2392,1324,1313,10,11,"CDC",206
25,"25017",236,169,167,7,2,"CDC",66
17,"17031",168,97,97,3,0,"CDC",34
8,"8221",12368,8798,8763,67,35,"CDC",1552
8,"8125",25081,16406,16329,164,77,"CDC",906
8,"8003",7084,4839,4803,39,36,"CDC",1040
8,"8129",462,319,316,3,3,"CDC",80
8,"8183",4550,2809,2796,20,13,"CDC",831
25,"25105",125,92,92,2,0,"CDC",37
17,"17151",174,111,110,3,1,"CDC",24
8,"8222",1895,1358,1351,14,7,"CDC",203
25,"25906",218,125,125,1,0,"CDC",31
17,"17164",3982,2363,2350,11,13,"CDC",772
8,"8153",538,386,385,2,1,"CDC",98
43,"43147",524,381,373,4,8,"CDC",121
8,"8135",6677,4813,4775,51,38,"CDC",309
17,"17903",897,568,563,2,5,"CDC",192
25,"25046",422,279,275,2,4,"CDC",72
43,"43172",344,211,209,4,2,"CDC",48
43,"43137",1868,1254,1242,11,12,"CDC",180
8,"8175",3347,2080,2064,20,16,"CDC",614
25,"25045",57,40,40,0,0,"CDC",4
8,"8306",506,299,297,5,2,"CDC",61
8,"8028",1024,648,644,4,4,"CDC",40
8,"8278",4779,3161,3148,20,13,"CDC",1355
25,"25074",178,132,128,6,4,"CDC",38
8,"8088",11899,8149,8097,69,52,"CDC",1743
25,"25206",260,150,150,5,0,"CDC",62
25,"25008",1124,715,702,10,13,"CDC",279
8,"8206",728,523,515,5,8,"CDC",132
43,"43076",439,300,299,0,1,"CDC",55
8,"8055",519,331,327,4,4,"CDC",66
17,"17187",631,445,441,2,4,"CDC",112
8,"8155",6730,4353,4320,39,33,"CDC",440
17,"17195",329,237,234,0,3,"CDC",61
17,"17083",2940,1895,1876,16,19,"CDC",381
43,"43105",162,123,122,2,1,"CDC",25
8,"8075",3883,2479,2467,14,12,"CDC",299
25,"25252",548,343,342,9,1,"CDC",102
8,"8049",1293,790,779,3,11,"CDC",296
43,"43010",322,233,227,0,6,"CDC",55
43,"43092",7036,4226,4185,39,41,"CDC",530
8,"8048",582,419,417,4,2,"CDC",133
43,"43091",132,86,86,0,0,"CDC",20
8,"8159",14096,9393,9347,76,46,"CDC",665
43,"43081",593,400,395,3,5,"CDC",100
25,"25200",329,213,213,0,0,"CDC",44
43,"43904",2900,1602,1573,32,29,"CDC",199
17,"17037",104,69,69,1,0,"CDC",39
17,"17096",179,106,105,1,1,"CDC",38
43,"43146",39,29,28,0,1,"CDC",6
8,"8143",2682,1718,1707,17,11,"CDC",290
8,"8144",717,447,437,5,10,"CDC",135
8,"8213",6319,3950,3935,37,15,"CDC",898
17,"17147",8053,4988,4933,52,55,"CDC",1301
25,"25174",397,280,280,2,0,"CDC",87
43,"43019",1381,862,846,12,16,"CDC",161
25,"25081",308,189,189,2,0,"CDC",74
17,"17080",138,96,96,1,0,"CDC",19
8,"8046",13290,9054,9000,103,54,"CDC",1343
43,"43008",307,156,154,6,2,"CDC",9
17,"17099",81,57,57,1,0,"CDC",16
8,"8211",33081,23576,23413,226,163,"CDC",1855
43,"43044",3963,2671,2640,33,31,"CDC",199
43,"43139",2039,1218,1191,8,27,"CDC",421
17,"17011",637,444,439,6,5,"CDC",146
17,"17207",2375,1590,1579,11,11,"CDC",607
43,"43012",3534,2559,2548,34,11,"CDC",356
25,"25225",564,356,356,1,0,"CDC",132
17,"17166",522,374,367,1,7,"CDC",111
43,"43125",933,680,677,14,3,"CDC",103
25,"25016",2107,1268,1259,14,9,"CDC",334
25,"25177",368,226,226,0,0,"CDC",67
17,"17201",135,87,84,0,3,"CDC",29
43,"43062",281,217,215,2,2,"CDC",51
8,"8252",24570,17009,16901,145,108,"CDC",627
17,"17006",1127,686,682,1,4,"CDC",221
8,"8079",343,256,255,4,1,"CDC",89
17,"17013",2787,1780,1762,17,18,"CDC",302
25,"25231",486,330,330,4,0,"CDC",90
17,"17222",101,76,75,0,1,"CDC",29
8,"8093",27,21,21,0,0,"CDC",8
17,"17118",12711,7567,7515,42,52,"CDC",1420
8,"8132",383,213,212,4,1,"CDC",93
43,"43005",3626,2157,2138,29,19,"CDC",341
43,"43006",681,438,437,9,1,"CDC",55
8,"8296",1777,1237,1231,7,6,"CDC",267
17,"17217",354,265,263,2,2,"CDC",79
8,"8114",18292,12102,12009,72,93,"CDC",1168
17,"17114",23041,13985,13880,135,105,"CDC",4005
8,"8085",1000,662,658,5,4,"CDC",251
8,"8176",156,109,107,2,2,"CDC",44
25,"25042",208,123,121,1,2,"CDC",47
8,"8011",1756,1087,1082,16,5,"CDC",332
8,"8210",4329,2624,2594,31,30,"CDC",572
43,"43029",310,213,211,3,2,"CDC",41
43,"43086",5249,3271,3244,37,27,"CDC",582
43,"43142",1100,698,688,5,10,"CDC",182
17,"17215",2087,1481,1466,7,15,"CDC",321
8,"8216",25,15,15,1,0,"CDC",1
43,"43901",8737,4703,4639,62,64,"CDC",690
43,"43128",907,587,577,5,10,"CDC",110
25,"25033",1096,729,723,4,6,"CDC",190
17,"17153",188,133,133,0,0,"CDC",38
8,"8300",5678,3983,3964,35,19,"CDC",449
25,"25130",195,113,112,2,1,"CDC",39
43,"43126",1177,782,772,4,10,"CDC",150
8,"8246",1665,1086,1078,9,8,"CDC",424
25,"25161",360,219,218,2,1,"CDC",51
17,"17068",245,158,156,1,2,"CDC",60
8,"8253",131,81,81,2,0,"CDC",40
8,"8208",5732,3976,3952,30,24,"CDC",373
8,"8293",219,168,167,0,1,"CDC",62
43,"43035",254,156,155,2,1,"CDC",51
25,"25112",273,192,188,4,4,"CDC",59
17,"17163",2626,1764,1747,10,17,"CDC",577
8,"8056",42140,28129,27977,257,152,"CDC",2068
43,"43140",2367,1550,1532,4,18,"CDC",128
17,"17178",1059,654,650,7,4,"CDC",178
8,"8235",3686,2488,2470,16,18,"CDC",679
25,"25218",81,64,63,1,1,"CDC",28
25,"25047",1014,675,674,8,1,"CDC",231
25,"25093",640,403,395,7,8,"CDC",128
25,"25053",1055,671,661,7,10,"CDC",187
43,"43066",158,100,98,5,2,"CDC",16
17,"17004",512,335,334,4,1,"CDC",90
17,"17902",1357,886,878,13,8,"CDC",296
8,"8203",2390,1466,1456,8,10,"CDC",219
17,"17065",331,230,230,1,0,"CDC",107
8,"8139",175,132,132,2,0,"CDC",39
43,"43046",99,68,65,1,3,"CDC",17
43,"43060",2860,1950,1926,12,24,"CDC",368
25,"25073",582,328,324,8,4,"CDC",90
17,"17035",548,381,379,5,2,"CDC",141
43,"43036",843,493,485,4,8,"CDC",83
8,"8307",48295,32010,31798,195,212,"CDC",3683
8,"8074",10611,6728,6679,52,49,"CDC",508
8,"8189",127,90,89,3,1,"CDC",39
17,"17184",1254,814,809,6,5,"CDC",316
17,"17007",1731,1191,1182,7,9,"CDC",507
17,"17140",670,478,473,5,5,"CDC",171
43,"43130",195,127,127,1,0,"CDC",29
8,"8305",27339,17960,17809,147,151,"CDC",3362
8,"8061",1497,986,983,14,3,"CDC",129
8,"8177",40,30,30,0,0,"CDC",10
17,"17033",5307,3264,3241,29,23,"CDC",592
17,"17165",656,439,435,3,4,"CDC",160
8,"8191",5239,3454,3438,27,16,"CDC",737
25,"25078",998,628,627,7,1,"CDC",171
17,"17159",643,413,406,3,7,"CDC",128
8,"8058",1730,1102,1095,6,7,"CDC",143
8,"8069",3169,2161,2148,32,13,"CDC",276
17,"17066",26562,15223,15087,150,136,"CDC",2516
43,"43054",2812,1755,1739,16,16,"CDC",455
43,"43027",161,118,116,15,2,"CDC",49
8,"8071",240,163,162,5,1,"CDC",43
17,"17043",161,122,117,1,5,"CDC",48
17,"17141",5887,3197,3165,34,32,"CDC",649
17,"17074",510,337,335,2,2,"CDC",62
8,"8279",153025,101133,100621,840,512,"CDC",10509
17,"17220",796,538,536,5,2,"CDC",183
17,"17029",207,127,127,1,0,"CDC",34
25,"25099",1273,761,752,7,9,"CDC",267
8,"8228",301,199,197,6,2,"CDC",52
25,"25032",64,44,44,1,0,"CDC",6
17,"17126",311,236,234,0,2,"CDC",86
8,"8901",227,148,145,1,3,"CDC",69
43,"43017",124,101,101,1,0,"CDC",32
25,"25089",105,60,59,0,1,"CDC",14
43,"43117",146,108,105,0,3,"CDC",31
17,"17110",1322,856,853,3,3,"CDC",161
43,"43101",145,104,102,3,2,"CDC",33
8,"8185",188,123,122,2,1,"CDC",30
43,"43131",4647,2934,2916,21,18,"CDC",274
25,"25232",1397,874,871,12,3,"CDC",208
8,"8096",42622,28797,28615,263,182,"CDC",4229
8,"8111",218,185,184,3,1,"CDC",88
8,"8099",749,487,485,2,2,"CDC",102
8,"8251",4984,3257,3241,17,16,"CDC",383
25,"25909",148,93,92,2,1,"CDC",25
8,"8287",1048,736,735,2,1,"CDC",249
17,"17098",301,192,188,2,4,"CDC",36
43,"43042",2129,1439,1437,12,2,"CDC",288
8,"8225",92,66,66,4,0,"CDC",39
25,"25149",1385,963,956,6,7,"CDC",352
25,"25152",140,86,86,1,0,"CDC",30
8,"8012",1672,1075,1061,17,14,"CDC",375
25,"25015",357,219,219,2,0,"CDC",57
25,"25022",104,79,79,0,0,"CDC",36
43,"43088",1996,1271,1255,7,16,"CDC",228
8,"8903",214,166,165,0,1,"CDC",66
43,"43049",728,464,461,4,3,"CDC",125
43,"43099",306,228,226,4,2,"CDC",105
43,"43068",520,330,326,7,4,"CDC",25
8,"8156",10891,7322,7259,43,63,"CDC",963
25,"25100",211,125,124,1,1,"CDC",49
43,"43073",83,60,58,0,2,"CDC",19
25,"25120",92002,55658,55214,587,444,"CDC",7952
8,"8269",2673,1788,1776,14,12,"CDC",625
43,"43009",1403,918,905,14,13,"CDC",151
43,"43158",85,52,52,1,0,"CDC",20
8,"8231",20564,13037,12952,96,85,"CDC",1111
25,"25043",807,501,497,11,4,"CDC",108
8,"8101",174621,113632,112942,847,690,"CDC",4582
8,"8260",18335,12325,12263,106,62,"CDC",757
17,"17107",264,167,165,8,2,"CDC",69
8,"8034",763,538,537,1,1,"CDC",167
8,"8194",25660,15045,14941,122,104,"CDC",580
43,"43907",4374,2793,2783,24,10,"CDC",196
17,"17058",177,101,100,3,1,"CDC",28
17,"17224",314,190,188,2,2,"CDC",79
25,"25092",130,98,95,2,3,"CDC",29
8,"8094",1559,1112,1097,14,15,"CDC",258
8,"8115",3799,2589,2572,17,17,"CDC",298
8,"8198",4411,2972,2954,23,18,"CDC",566
25,"25228",3035,1933,1921,26,12,"CDC",477
17,"17008",3639,2191,2171,16,20,"CDC",728
25,"25158",1620,1019,1012,15,7,"CDC",346
43,"43056",854,480,470,5,10,"CDC",80
17,"17203",153,99,99,0,0,"CDC",33
25,"25058",4357,2624,2595,20,29,"CDC",755
17,"17016",731,500,496,1,4,"CDC",144
25,"25132",136,88,87,0,1,"CDC",26
17,"17034",6931,4166,4150,29,16,"CDC",863
8,"8169",47759,32651,32439,243,212,"CDC",1518
8,"8030",5122,3482,3466,21,16,"CDC",937
43,"43063",557,355,349,9,6,"CDC",91
25,"25061",83,46,46,0,0,"CDC",26
25,"25087",60,43,43,0,0,"CDC",16
8,"8142",133,103,101,5,2,"CDC",41
25,"25234",4279,2546,2508,23,38,"CDC",664
43,"43145",4096,2795,2760,19,35,"CDC",577
25,"25119",2248,1449,1442,15,7,"CDC",452
43,"43022",1497,897,889,14,8,"CDC",125
8,"8265",1553,1028,1018,11,10,"CDC",303
8,"8112",12911,7790,7723,74,67,"CDC",2097
25,"25204",1231,731,724,5,7,"CDC",175
8,"8152",114,80,79,0,1,"CDC",31
43,"43154",130,101,100,0,1,"CDC",19
17,"17228",288,179,176,1,3,"CDC",47
3,"3017",374,314,307,1,7,"CENTRO MODERADO",2
3,"3069",3076,2123,2102,17,21,"CENTRO MODERADO",5
3,"3111",5436,3918,3883,18,35,"CENTRO MODERADO",8
3,"3011",7753,5464,5415,27,49,"CENTRO MODERADO",17
3,"3058",4951,3897,3851,30,46,"CENTRO MODERADO",8
3,"3121",21273,14569,14468,62,101,"CENTRO MODERADO",56
3,"3124",460,388,384,3,4,"CENTRO MODERADO",1
3,"3088",5498,4041,3989,29,52,"CENTRO MODERADO",8
3,"3024",3901,3067,3024,11,43,"CENTRO MODERADO",5
3,"3901",1135,822,817,8,5,"CENTRO MODERADO",0
3,"3027",157,138,135,0,3,"CENTRO MODERADO",0
3,"3131",175,154,147,0,7,"CENTRO MODERADO",1
3,"3120",2406,1753,1720,11,33,"CENTRO MODERADO",2
3,"3063",26462,18591,18492,91,99,"CENTRO MODERADO",51
3,"3041",5954,4218,4194,22,24,"CENTRO MODERADO",16
3,"3110",291,241,241,1,0,"CENTRO MODERADO",0
3,"3062",212,169,165,0,4,"CENTRO MODERADO",0
3,"3048",4847,3719,3683,20,36,"CENTRO MODERADO",3
3,"3008",168,130,129,0,1,"CENTRO MODERADO",0
3,"3028",998,818,812,2,6,"CENTRO MODERADO",7
3,"3016",93,75,75,0,0,"CENTRO MODERADO",0
3,"3135",211,170,166,2,4,"CENTRO MODERADO",0
3,"3068",47,44,44,0,0,"CENTRO MODERADO",0
3,"3071",3982,3048,3012,26,36,"CENTRO MODERADO",11
3,"3037",346,282,278,3,4,"CENTRO MODERADO",1
3,"3079",18224,13904,13709,80,195,"CENTRO MODERADO",56
3,"3030",524,448,440,5,8,"CENTRO MODERADO",0
3,"3074",1707,1397,1389,4,8,"CENTRO MODERADO",1
3,"3090",17182,12487,12385,74,102,"CENTRO MODERADO",52
3,"3021",5613,4570,4500,26,70,"CENTRO MODERADO",7
3,"3098",505,393,386,0,7,"CENTRO MODERADO",3
3,"3033",117,96,95,0,1,"CENTRO MODERADO",0
3,"3117",362,318,313,2,5,"CENTRO MODERADO",1
3,"3093",19683,14633,14484,70,149,"CENTRO MODERADO",39
3,"3038",355,288,285,3,3,"CENTRO MODERADO",0
3,"3100",503,440,437,0,3,"CENTRO MODERADO",0
3,"3055",5164,3695,3647,21,48,"CENTRO MODERADO",13
3,"3045",210,176,172,0,4,"CENTRO MODERADO",0
3,"3902",10254,6996,6930,34,66,"CENTRO MODERADO",16
3,"3139",22437,15315,15170,100,145,"CENTRO MODERADO",84
3,"3014",237287,167428,166445,847,983,"CENTRO MODERADO",591
3,"3099",42319,31083,30801,165,282,"CENTRO MODERADO",59
3,"3128",4092,2861,2840,10,21,"CENTRO MODERADO",5
3,"3061",1056,776,768,4,8,"CENTRO MODERADO",2
3,"3105",5373,3911,3828,15,83,"CENTRO MODERADO",8
3,"3025",1270,950,941,2,9,"CENTRO MODERADO",3
3,"3104",27103,19953,19787,131,166,"CENTRO MODERADO",62
3,"3007",166,139,137,0,2,"CENTRO MODERADO",0
3,"3077",1371,1071,1060,13,11,"CENTRO MODERADO",4
3,"3086",151,135,134,1,1,"CENTRO MODERADO",0
3,"3019",15269,11520,11398,72,122,"CENTRO MODERADO",44
3,"3092",6743,5254,5178,37,76,"CENTRO MODERADO",13
3,"3060",109,91,91,0,0,"CENTRO MODERADO",1
3,"3013",1113,839,836,4,3,"CENTRO MODERADO",2
3,"3138",3145,2310,2275,9,35,"CENTRO MODERADO",9
3,"3044",4521,3510,3465,21,45,"CENTRO MODERADO",12
3,"3047",9207,6309,6226,25,83,"CENTRO MODERADO",26
3,"3051",348,296,294,0,2,"CENTRO MODERADO",2
3,"3022",145,125,125,0,0,"CENTRO MODERADO",2
3,"3075",147,128,128,0,0,"CENTRO MODERADO",0
3,"3020",99,79,79,0,0,"CENTRO MODERADO",0
3,"3106",583,480,478,2,2,"CENTRO MODERADO",0
3,"3115",255,222,220,2,2,"CENTRO MODERADO",0
3,"3113",4243,3091,3046,10,45,"CENTRO MODERADO",9
3,"3095",4579,3489,3459,25,30,"CENTRO MODERADO",6
3,"3904",1396,1033,1026,4,7,"CENTRO MODERADO",3
3,"3089",9571,6775,6639,47,136,"CENTRO MODERADO",14
3,"3076",8467,6238,6157,30,81,"CENTRO MODERADO",4
3,"3066",42121,29655,29419,214,236,"CENTRO MODERADO",116
3,"3119",16636,12281,12194,57,87,"CENTRO MODERADO",41
3,"3040",254,216,213,2,3,"CENTRO MODERADO",0
3,"3046",1599,1153,1143,8,10,"CENTRO MODERADO",1
3,"3083",5586,3971,3928,33,43,"CENTRO MODERADO",17
3,"3059",20583,15125,15018,63,107,"CENTRO MODERADO",41
3,"3001",337,269,268,0,1,"CENTRO MODERADO",0
3,"3003",450,378,376,2,2,"CENTRO MODERADO",2
3,"3023",1398,1184,1167,7,17,"CENTRO MODERADO",3
3,"3081",1436,1084,1075,5,9,"CENTRO MODERADO",2
3,"3127",350,278,273,1,5,"CENTRO MODERADO",0
3,"3109",2850,2181,2164,8,17,"CENTRO MODERADO",2
3,"3035",652,547,541,1,6,"CENTRO MODERADO",3
3,"3082",12567,8537,8464,44,73,"CENTRO MODERADO",21
3,"3006",497,384,380,1,4,"CENTRO MODERADO",0
3,"3057",182,147,147,1,0,"CENTRO MODERADO",0
3,"3903",2494,1880,1865,7,15,"CENTRO MODERADO",5
3,"3012",1085,852,841,3,11,"CENTRO MODERADO",3
3,"3080",1300,1035,1025,3,10,"CENTRO MODERADO",1
3,"3102",7229,5492,5414,52,78,"CENTRO MODERADO",4
3,"3078",478,389,389,5,0,"CENTRO MODERADO",0
3,"3032",108,91,90,1,1,"CENTRO MODERADO",0
3,"3034",1376,1067,1052,5,15,"CENTRO MODERADO",2
3,"3065",167284,123032,122305,711,727,"CENTRO MODERADO",467
3,"3134",143,112,111,0,1,"CENTRO MODERADO",0
3,"3123",7476,5557,5501,29,56,"CENTRO MODERADO",9
3,"3026",1224,949,936,5,13,"CENTRO MODERADO",1
3,"3096",5786,4358,4289,17,69,"CENTRO MODERADO",16
3,"3049",12088,9121,9027,52,94,"CENTRO MODERADO",15
3,"3132",534,436,435,3,1,"CENTRO MODERADO",2
3,"3122",42425,30153,29954,154,199,"CENTRO MODERADO",143
3,"3029",245,185,183,1,2,"CENTRO MODERADO",1
3,"3118",2437,1659,1642,4,17,"CENTRO MODERADO",4
3,"3009",46657,35143,34801,223,342,"CENTRO MODERADO",132
3,"3067",99,85,85,0,0,"CENTRO MODERADO",1
3,"3114",1562,1198,1188,9,10,"CENTRO MODERADO",4
3,"3073",236,200,199,1,1,"CENTRO MODERADO",0
3,"3056",8676,6638,6541,34,97,"CENTRO MODERADO",19
3,"3031",41499,27031,26813,128,218,"CENTRO MODERADO",81
3,"3112",628,511,507,2,4,"CENTRO MODERADO",1
3,"3097",993,822,812,6,10,"CENTRO MODERADO",0
3,"3005",7769,5917,5866,19,51,"CENTRO MODERADO",15
3,"3129",1194,957,938,0,19,"CENTRO MODERADO",1
3,"3039",81,62,61,1,1,"CENTRO MODERADO",0
3,"3002",3605,2583,2557,15,26,"CENTRO MODERADO",8
3,"3050",18652,13325,13234,57,91,"CENTRO MODERADO",67
3,"3004",581,438,437,2,1,"CENTRO MODERADO",1
3,"3133",41576,25849,25639,127,210,"CENTRO MODERADO",108
3,"3137",651,492,489,5,3,"CENTRO MODERADO",1
3,"3036",87,81,78,0,3,"CENTRO MODERADO",0
3,"3043",2911,2431,2399,13,32,"CENTRO MODERADO",2
3,"3042",1393,1010,996,7,14,"CENTRO MODERADO",3
3,"3052",970,769,755,8,14,"CENTRO MODERADO",3
3,"3094",9080,6440,6396,34,44,"CENTRO MODERADO",19
3,"3125",343,254,251,0,3,"CENTRO MODERADO",1
3,"3130",48,25,25,0,0,"CENTRO MODERADO",0
3,"3054",343,277,275,3,2,"CENTRO MODERADO",0
3,"3018",12240,8853,8777,47,76,"CENTRO MODERADO",41
3,"3101",4808,3627,3580,22,47,"CENTRO MODERADO",13
3,"3084",539,454,446,3,8,"CENTRO MODERADO",0
3,"3064",5015,3660,3611,11,49,"CENTRO MODERADO",12
3,"3072",348,289,285,0,4,"CENTRO MODERADO",0
3,"3053",7226,5651,5584,32,67,"CENTRO MODERADO",18
3,"3091",252,217,215,2,2,"CENTRO MODERADO",0
3,"3085",272,217,213,0,4,"CENTRO MODERADO",0
3,"3070",2051,1455,1437,7,18,"CENTRO MODERADO",4
3,"3140",26070,18999,18742,174,257,"CENTRO MODERADO",114
3,"3103",272,235,234,1,1,"CENTRO MODERADO",1
3,"3010",325,277,275,1,2,"CENTRO MODERADO",1
3,"3015",12566,9257,9177,39,80,"CENTRO MODERADO",22
3,"3107",2508,1755,1744,7,11,"CENTRO MODERADO",9
3,"3116",1155,877,875,6,2,"CENTRO MODERADO",6
3,"3136",441,338,334,0,4,"CENTRO MODERADO",1
23,"23072",1986,1542,1530,7,12,"CILUS",1
23,"23074",3021,2317,2295,11,22,"CILUS",1
23,"23024",12435,9058,8833,55,225,"CILUS",32
23,"23097",6443,4117,4063,21,54,"CILUS",19
23,"23088",6089,4558,4472,34,86,"CILUS",12
23,"23004",436,364,358,1,6,"CILUS",0
23,"23008",1502,1144,1131,9,13,"CILUS",3
23,"23031",747,637,619,0,18,"CILUS",2
23,"23019",1536,1196,1174,2,22,"CILUS",2
23,"23029",843,628,624,2,4,"CILUS",0
23,"23093",3226,2302,2273,19,29,"CILUS",0
23,"23020",1590,1370,1349,9,21,"CILUS",1
23,"23086",11511,7997,7874,91,123,"CILUS",12
23,"23070",3914,2433,2407,14,26,"CILUS",2
23,"23006",4660,3687,3647,24,40,"CILUS",10
23,"23044",4816,3663,3569,27,94,"CILUS",9
23,"23061",7560,5303,5234,29,69,"CILUS",10
23,"23905",1868,1277,1272,6,5,"CILUS",4
23,"23053",9531,6704,6658,37,46,"CILUS",3
23,"23030",1238,968,960,3,8,"CILUS",1
23,"23012",4162,2907,2889,14,18,"CILUS",2
23,"23016",387,321,320,0,1,"CILUS",2
23,"23069",5353,4310,4212,27,98,"CILUS",9
23,"23003",8688,6326,6257,52,69,"CILUS",16
23,"23015",1374,1029,1019,5,10,"CILUS",2
23,"23009",12861,9649,9543,72,106,"CILUS",10
23,"23075",3298,2564,2541,18,23,"CILUS",2
23,"23010",14347,9669,9560,86,109,"CILUS",21
23,"23095",8735,6347,6310,14,37,"CILUS",6
23,"23087",11292,8222,8084,59,138,"CILUS",18
23,"23025",2802,2056,2037,9,19,"CILUS",0
23,"23099",4769,3359,3309,16,50,"CILUS",4
23,"23054",382,282,281,1,1,"CILUS",2
23,"23096",2642,2164,2138,9,26,"CILUS",1
23,"23027",723,576,572,3,4,"CILUS",2
23,"23052",1125,936,922,4,14,"CILUS",0
23,"23040",1480,1199,1192,2,7,"CILUS",0
23,"23041",499,398,394,2,4,"CILUS",1
23,"23067",2460,1831,1805,11,26,"CILUS",4
23,"23049",1813,1238,1222,9,16,"CILUS",21
23,"23056",3088,2243,2203,15,40,"CILUS",3
23,"23021",524,431,429,0,2,"CILUS",1
23,"23011",2170,1515,1496,7,19,"CILUS",4
23,"23033",1352,1045,1034,12,11,"CILUS",5
23,"23039",2204,1596,1558,11,38,"CILUS",0
23,"23032",566,450,448,4,2,"CILUS",0
23,"23902",2320,1867,1847,4,20,"CILUS",2
23,"23051",2758,2171,2144,9,27,"CILUS",10
23,"23042",292,217,213,1,4,"CILUS",0
23,"23082",1921,1425,1416,8,9,"CILUS",3
23,"23066",4347,3465,3410,15,55,"CILUS",9
23,"23002",17428,12820,12644,70,176,"CILUS",36
23,"23091",729,555,553,5,2,"CILUS",0
23,"23046",2391,1916,1895,6,21,"CILUS",1
23,"23048",870,619,613,1,6,"CILUS",2
23,"23092",27775,19734,19541,175,193,"CILUS",44
23,"23904",2796,1825,1798,8,27,"CILUS",4
23,"23079",3717,2825,2801,28,24,"CILUS",3
23,"23903",3540,2662,2634,13,28,"CILUS",11
23,"23014",2559,1971,1942,13,29,"CILUS",9
23,"23062",1454,1141,1128,1,13,"CILUS",1
23,"23077",620,501,494,3,7,"CILUS",0
23,"23098",867,713,701,1,12,"CILUS",1
23,"23081",1513,1103,1084,10,19,"CILUS",4
23,"23076",827,640,630,1,10,"CILUS",0
23,"23007",3087,2205,2187,6,18,"CILUS",1
23,"23005",30465,20878,20630,177,248,"CILUS",28
23,"23085",2252,1655,1644,6,11,"CILUS",2
23,"23901",1154,970,964,3,6,"CILUS",2
23,"23018",2325,1668,1653,10,15,"CILUS",2
23,"23058",8678,6532,6461,37,71,"CILUS",14
23,"23064",1655,1363,1353,1,10,"CILUS",4
23,"23017",1572,1269,1257,4,12,"CILUS",1
23,"23057",766,625,619,4,6,"CILUS",1
23,"23035",1106,873,855,1,18,"CILUS",1
23,"23101",378,276,271,1,5,"CILUS",0
23,"23084",935,658,653,7,5,"CILUS",1
23,"23026",3586,2620,2585,16,35,"CILUS",3
23,"23055",47167,31479,31198,264,281,"CILUS",164
23,"23094",3839,3009,2954,14,55,"CILUS",7
23,"23047",1629,1258,1250,10,8,"CILUS",1
23,"23060",19003,12924,12812,102,112,"CILUS",25
23,"23037",502,404,400,6,4,"CILUS",0
23,"23043",546,398,396,3,2,"CILUS",1
23,"23065",1597,1170,1149,2,21,"CILUS",5
23,"23059",5837,4387,4310,40,77,"CILUS",3
23,"23073",4507,3229,3200,13,29,"CILUS",4
23,"23080",1762,1332,1322,4,10,"CILUS",2
23,"23090",1312,1041,1018,5,23,"CILUS",2
23,"23071",1715,1290,1278,7,12,"CILUS",2
23,"23028",6220,4409,4369,23,40,"CILUS",7
23,"23034",2540,1957,1934,14,23,"CILUS",0
23,"23038",3587,2794,2770,16,24,"CILUS",2
23,"23050",90992,64810,64218,485,592,"CILUS",136
23,"23045",2132,1260,1247,5,13,"CILUS",0
23,"23063",3829,2560,2522,21,38,"CILUS",7
23,"23001",963,801,799,1,2,"CILUS",1
42,"42069",1536,1036,1019,6,17,"C's",66
2,"2033",1892,1505,1474,6,31,"C's",136
45,"45058",375,311,304,1,7,"C's",10
19,"19075",64,39,39,0,0,"C's",5
3,"3050",18652,13325,13234,57,91,"C's",2299
44,"44178",58,37,37,0,0,"C's",5
27,"27054",1190,881,860,9,21,"C's",20
36,"36037",2571,1733,1707,11,26,"C's",104
46,"46125",847,689,684,5,5,"C's",44
48,"48047",159,111,111,0,0,"C's",0
10,"10015",675,483,473,3,10,"C's",52
19,"19185",28,21,20,0,1,"C's",2
19,"19095",12,9,9,0,0,"C's",0
19,"19074",72,62,62,0,0,"C's",11
44,"44031",97,62,62,0,0,"C's",9
9,"9329",121,87,87,1,0,"C's",7
46,"46021",23649,17291,17153,100,138,"C's",2711
40,"40125",87,58,58,1,0,"C's",9
37,"37347",468,348,346,2,2,"C's",54
44,"44108",320,222,222,1,0,"C's",28
20,"20063",8017,5263,5231,35,32,"C's",58
16,"16263",959,722,715,4,7,"C's",50
40,"40095",477,377,369,0,8,"C's",40
19,"19132",92,81,81,0,0,"C's",15
35,"35020",6034,3992,3934,20,58,"C's",218
47,"47169",68,59,59,0,0,"C's",6
9,"9120",38,32,32,1,0,"C's",6
45,"45139",167,139,139,1,0,"C's",3
45,"45125",2305,1865,1841,8,24,"C's",164
39,"39091",1926,1493,1476,10,17,"C's",151
37,"37329",42,34,34,0,0,"C's",6
40,"40189",512,401,392,2,9,"C's",39
15,"15084",3260,2218,2191,27,27,"C's",105
18,"18083",247,200,196,0,4,"C's",15
9,"9317",19,16,16,0,0,"C's",0
12,"12141",101,83,83,0,0,"C's",12
2,"2032",276,207,202,1,5,"C's",15
16,"16041",358,275,271,0,4,"C's",28
19,"19036",263,229,229,0,0,"C's",23
41,"41096",6161,4553,4476,32,77,"C's",663
32,"32082",1243,891,878,1,13,"C's",44
45,"45131",282,234,230,0,4,"C's",16
9,"9375",36,31,31,0,0,"C's",8
38,"38029",1517,744,734,1,10,"C's",79
9,"9110",80,63,63,0,0,"C's",11
7,"7027",20769,13097,12987,100,110,"C's",1821
2,"2069",11490,8470,8373,41,97,"C's",1327
44,"44067",114,81,81,1,0,"C's",4
31,"31252",87,61,61,0,0,"C's",4
42,"42050",31,18,18,0,0,"C's",1
29,"29079",2416,1788,1764,10,24,"C's",149
32,"32026",2704,1929,1896,22,33,"C's",141
39,"39084",838,631,624,2,7,"C's",68
1,"1059",186557,126506,125278,798,1228,"C's",7023
16,"16065",388,320,314,2,6,"C's",23
37,"37253",135,109,109,2,0,"C's",22
23,"23096",2642,2164,2138,9,26,"C's",161
12,"12097",63,49,49,0,0,"C's",6
9,"9070",34,26,26,0,0,"C's",2
24,"24039",2063,1597,1596,41,1,"C's",214
47,"47104",2836,2182,2121,19,61,"C's",263
37,"37356",87,67,65,0,2,"C's",9
11,"11041",9866,6477,6402,69,75,"C's",727
49,"49209",505,342,341,2,1,"C's",30
31,"31262",228,179,178,5,1,"C's",4
12,"12105",848,644,638,2,6,"C's",79
37,"37065",312,223,222,3,1,"C's",11
28,"28045",33328,24620,24434,146,186,"C's",4857
16,"16088",108,88,87,0,1,"C's",7
40,"40015",28,26,26,1,0,"C's",4
18,"18014",6581,4584,4545,37,39,"C's",862
44,"44190",71,58,56,0,2,"C's",6
44,"44232",378,284,276,6,8,"C's",28
26,"26092",107,92,90,0,2,"C's",14
37,"37310",178,123,123,1,0,"C's",6
5,"5172",123,93,93,1,0,"C's",5
22,"22907",1435,1059,1046,18,13,"C's",149
49,"49067",367,250,249,0,1,"C's",50
40,"40071",43,39,38,1,1,"C's",2
31,"31154",224,126,126,3,0,"C's",3
5,"5080",58,45,43,0,2,"C's",3
1,"1022",799,557,544,2,13,"C's",34
20,"20038",387,261,259,0,2,"C's",1
33,"33050",592,387,376,2,11,"C's",21
24,"24176",316,247,244,1,3,"C's",26
19,"19284",10,10,9,0,1,"C's",0
44,"44029",559,425,424,5,1,"C's",32
39,"39098",1402,1046,1036,8,10,"C's",138
49,"49229",126,93,93,0,0,"C's",10
18,"18107",943,663,655,1,8,"C's",36
16,"16129",95,81,79,0,2,"C's",13
12,"12060",446,368,364,4,4,"C's",33
20,"20901",1437,908,906,2,2,"C's",11
22,"22199",7000,4737,4688,104,49,"C's",706
19,"19004",67,53,53,1,0,"C's",5
46,"46139",4485,3617,3574,18,43,"C's",407
28,"28067",4063,3102,3079,3,23,"C's",515
49,"49245",262,176,173,2,3,"C's",21
6,"6134",547,335,332,1,3,"C's",9
10,"10061",1628,1055,1035,8,20,"C's",77
15,"15015",2799,2045,2008,24,37,"C's",150
40,"40129",177,148,147,1,1,"C's",16
49,"49179",371,238,237,0,1,"C's",16
10,"10049",3819,3031,2950,18,81,"C's",230
37,"37203",158,117,117,0,0,"C's",22
29,"29087",376,270,266,1,4,"C's",33
9,"9312",96,78,77,0,1,"C's",4
46,"46040",1078,888,878,7,10,"C's",56
35,"35008",6131,4507,4459,34,48,"C's",578
44,"44090",78,53,53,0,0,"C's",2
5,"5226",76,55,54,3,1,"C's",2
10,"10127",4703,3183,3132,21,51,"C's",357
41,"41099",3976,2369,2347,12,22,"C's",229
5,"5078",115,91,89,1,2,"C's",7
50,"50047",48,36,36,0,0,"C's",4
5,"5090",77,68,68,1,0,"C's",7
7,"7012",1876,1369,1353,13,16,"C's",101
30,"30021",9099,6095,6045,20,50,"C's",831
22,"22189",185,145,144,5,1,"C's",16
45,"45047",2606,1666,1647,6,19,"C's",273
22,"22079",118,83,83,1,0,"C's",9
50,"50083",89,75,75,1,0,"C's",11
42,"42135",72,52,52,1,0,"C's",3
31,"31077",5352,3908,3848,41,60,"C's",342
46,"46208",1112,887,881,4,6,"C's",67
28,"28063",258,194,193,1,1,"C's",30
22,"22217",385,287,281,1,6,"C's",51
5,"5013",868,728,721,6,7,"C's",52
46,"46058",1772,1398,1373,15,25,"C's",131
47,"47231",4401,3299,3277,24,22,"C's",695
19,"19108",111,97,96,0,1,"C's",17
46,"46015",7244,5615,5560,40,55,"C's",776
23,"23002",17428,12820,12644,70,176,"C's",1607
24,"24051",423,309,307,0,2,"C's",17
7,"7017",851,582,571,7,11,"C's",73
3,"3105",5373,3911,3828,15,83,"C's",489
6,"6051",1571,1192,1178,7,14,"C's",45
34,"34017",918,744,736,9,8,"C's",55
21,"21001",637,462,455,6,7,"C's",26
41,"41037",3213,2376,2342,30,34,"C's",123
50,"50161",106,75,72,0,3,"C's",11
5,"5159",252,165,164,0,1,"C's",14
38,"38022",18450,12334,12160,62,174,"C's",1109
30,"30006",803,691,685,2,6,"C's",37
50,"50212",40,36,36,0,0,"C's",4
34,"34107",81,52,51,5,1,"C's",1
3,"3122",42425,30153,29954,154,199,"C's",5547
33,"33005",1449,936,924,11,12,"C's",39
12,"12028",12586,9733,9676,62,57,"C's",1937
24,"24141",95,85,84,0,1,"C's",6
28,"28046",4460,3447,3422,16,25,"C's",613
34,"34069",2266,1666,1637,11,29,"C's",212
3,"3013",1113,839,836,4,3,"C's",79
24,"24139",2183,1548,1525,16,23,"C's",172
20,"20077",5213,3614,3591,36,23,"C's",59
50,"50176",236,165,165,3,0,"C's",21
22,"22066",702,502,498,7,4,"C's",50
22,"22151",93,64,64,1,0,"C's",12
28,"28085",3922,2972,2954,14,18,"C's",482
22,"22041",163,134,134,1,0,"C's",15
23,"23043",546,398,396,3,2,"C's",30
10,"10153",309,222,218,0,4,"C's",11
37,"37294",11692,8317,8221,71,96,"C's",1666
44,"44204",24,21,21,0,0,"C's",0
20,"20037",99,64,64,2,0,"C's",3
20,"20041",255,123,123,0,0,"C's",5
10,"10188",499,382,374,4,8,"C's",21
34,"34215",164,141,140,1,1,"C's",15
26,"26095",100,83,82,0,1,"C's",6
1,"1010",2268,1623,1603,11,20,"C's",26
42,"42088",67,47,47,1,0,"C's",4
18,"18904",775,565,558,1,7,"C's",61
31,"31203",40,28,28,0,0,"C's",0
32,"32042",1579,1094,1081,12,13,"C's",57
37,"37132",351,256,253,2,3,"C's",13
18,"18106",425,293,290,0,3,"C's",28
49,"49059",94,64,64,0,0,"C's",7
19,"19091",26,20,20,0,0,"C's",2
48,"48007",364,240,240,5,0,"C's",0
14,"14055",18557,12950,12764,178,186,"C's",2013
45,"45122",5212,4004,3961,16,43,"C's",678
4,"4030",1119,819,812,5,7,"C's",62
4,"4019",249,196,196,1,0,"C's",9
34,"34087",129,103,102,1,1,"C's",10
47,"47212",380,323,322,2,1,"C's",24
31,"31257",875,634,625,8,9,"C's",46
40,"40223",216,163,163,1,0,"C's",22
49,"49251",163,127,121,1,6,"C's",7
16,"16266",368,264,259,1,5,"C's",15
10,"10048",233,168,168,0,0,"C's",16
32,"32039",1262,957,941,6,16,"C's",52
12,"12099",539,416,403,7,13,"C's",57
22,"22013",288,216,210,3,6,"C's",30
22,"22129",183,120,118,1,2,"C's",21
22,"22088",153,110,110,2,0,"C's",5
15,"15058",27793,20392,20235,221,157,"C's",2661
33,"33059",4646,3075,3033,29,42,"C's",230
45,"45008",139,118,118,1,0,"C's",5
6,"6063",3015,2268,2246,16,22,"C's",141
24,"24024",692,496,491,4,5,"C's",36
19,"19018",155,119,118,3,1,"C's",10
29,"29083",2107,1540,1512,9,28,"C's",128
40,"40143",86,75,74,0,1,"C's",7
16,"16108",49,45,42,0,3,"C's",3
20,"20001",246,133,132,2,1,"C's",0
5,"5081",40,36,36,1,0,"C's",2
44,"44197",56,36,36,0,0,"C's",1
37,"37146",117,96,95,1,1,"C's",7
9,"9062",51,40,39,0,1,"C's",4
45,"45165",62718,44420,44006,236,414,"C's",6501
37,"37271",368,297,296,0,1,"C's",28
5,"5114",1345,1067,1044,3,23,"C's",107
9,"9448",212,169,165,0,4,"C's",14
3,"3031",41499,27031,26813,128,218,"C's",4084
9,"9024",156,112,110,1,2,"C's",6
40,"40144",18,14,14,0,0,"C's",2
6,"6081",1074,806,792,7,14,"C's",68
10,"10170",267,210,206,3,4,"C's",23
10,"10057",143,117,117,1,0,"C's",5
34,"34082",83,74,73,0,1,"C's",10
14,"14018",3709,2697,2653,26,44,"C's",252
10,"10119",620,460,452,1,8,"C's",31
12,"12115",219,179,177,0,2,"C's",38
30,"30033",10188,7403,7285,68,118,"C's",1095
45,"45067",2318,1791,1752,19,39,"C's",153
20,"20902",14156,9664,9613,74,51,"C's",407
9,"9268",95,68,66,0,2,"C's",2
24,"24078",380,289,277,0,12,"C's",44
26,"26166",141,124,122,0,2,"C's",13
40,"40174",349,254,251,2,3,"C's",27
29,"29085",144,109,108,0,1,"C's",4
45,"45083",472,368,365,0,3,"C's",35
50,"50040",89,75,75,0,0,"C's",12
50,"50122",68,52,52,1,0,"C's",4
41,"41091",541987,385251,382091,3298,3160,"C's",52401
37,"37086",101,72,71,1,1,"C's",7
13,"13027",3415,2380,2354,4,26,"C's",175
45,"45202",3894,2776,2744,14,32,"C's",267
5,"5029",121,96,94,0,2,"C's",10
46,"46009",3121,2459,2427,8,32,"C's",340
29,"29019",878,652,636,3,16,"C's",21
46,"46038",327,242,242,3,0,"C's",18
32,"32035",1442,957,942,3,15,"C's",56
9,"9194",2020,1472,1459,9,13,"C's",218
16,"16118",1375,1106,1086,13,20,"C's",67
26,"26127",212,181,176,0,5,"C's",11
50,"50214",27,18,17,0,1,"C's",0
9,"9065",143,122,122,1,0,"C's",15
48,"48010",458,318,317,0,1,"C's",4
31,"31248",299,165,162,0,3,"C's",8
42,"42097",23,14,11,0,3,"C's",2
13,"13035",984,747,730,7,17,"C's",40
19,"19252",69,60,60,0,0,"C's",4
5,"5060",116,95,95,0,0,"C's",6
50,"50284",141,107,104,0,3,"C's",5
21,"21017",3600,2187,2164,26,23,"C's",134
18,"18020",1028,691,686,3,5,"C's",49
39,"39038",1452,997,990,8,7,"C's",120
47,"47184",573,453,451,1,2,"C's",60
5,"5243",85,61,60,0,1,"C's",9
49,"49180",148,103,102,2,1,"C's",12
48,"48075",1996,1364,1359,6,5,"C's",17
49,"49061",150,114,112,2,2,"C's",13
19,"19257",3403,2430,2402,19,28,"C's",276
2,"2061",637,516,511,4,5,"C's",31
5,"5101",292,240,236,1,4,"C's",26
44,"44056",501,345,342,2,3,"C's",32
37,"37257",52,46,46,0,0,"C's",5
44,"44046",49,34,34,1,0,"C's",3
4,"4078",1078,758,746,8,12,"C's",46
9,"9398",75,56,56,0,0,"C's",5
37,"37102",404,307,305,2,2,"C's",31
5,"5156",256,160,159,1,1,"C's",22
7,"7043",3389,2290,2252,26,38,"C's",196
37,"37063",69,59,58,0,1,"C's",10
39,"39042",5915,4530,4474,21,56,"C's",769
13,"13068",1061,747,740,4,7,"C's",67
45,"45004",567,410,406,1,4,"C's",39
5,"5219",38,30,30,0,0,"C's",3
33,"33043",683,446,441,2,5,"C's",17
22,"22062",167,116,116,1,0,"C's",15
37,"37114",84,70,69,2,1,"C's",4
10,"10178",769,565,553,3,12,"C's",26
50,"50004",522,390,388,0,2,"C's",43
19,"19247",139,102,100,1,2,"C's",5
46,"46035",6822,5202,5142,43,60,"C's",661
9,"9045",268,181,181,4,0,"C's",23
47,"47062",163,130,130,0,0,"C's",20
40,"40072",211,162,159,1,3,"C's",41
22,"22232",93,71,69,1,2,"C's",9
14,"14026",2067,1424,1405,4,19,"C's",150
16,"16165",61,54,53,0,1,"C's",5
26,"26068",80,61,61,1,0,"C's",5
33,"33055",1514,1109,1092,5,17,"C's",137
44,"44264",248,191,189,1,2,"C's",27
14,"14030",8625,6248,6181,53,67,"C's",551
42,"42145",138,108,107,2,1,"C's",11
48,"48908",249,181,181,0,0,"C's",1
24,"24216",723,522,518,1,4,"C's",38
40,"40058",325,277,276,4,1,"C's",18
14,"14062",1025,806,792,6,14,"C's",53
47,"47076",17399,13097,12972,92,125,"C's",2389
19,"19087",18,18,18,0,0,"C's",1
46,"46097",963,733,728,4,5,"C's",156
16,"16062",24,23,23,0,0,"C's",2
42,"42043",3791,2727,2682,25,45,"C's",285
31,"31050",6014,3489,3450,57,39,"C's",99
48,"48089",3306,2341,2329,20,12,"C's",56
32,"32029",470,357,352,4,5,"C's",13
33,"33053",1141,742,732,6,10,"C's",57
40,"40018",91,72,72,1,0,"C's",12
11,"11010",6410,4189,4130,88,59,"C's",388
4,"4071",394,338,337,3,1,"C's",20
37,"37047",180,84,84,0,0,"C's",7
15,"15902",4598,3209,3149,51,60,"C's",273
5,"5046",44,38,38,1,0,"C's",3
40,"40029",35,27,26,0,1,"C's",1
50,"50062",1829,1304,1290,16,14,"C's",212
28,"28116",704,528,523,2,5,"C's",110
31,"31117",620,383,375,3,8,"C's",1
27,"27016",7172,4910,4846,51,64,"C's",343
37,"37173",1504,1129,1114,4,15,"C's",119
47,"47200",85,66,66,0,0,"C's",3
34,"34051",101,88,83,0,5,"C's",18
31,"31199",146,92,89,3,3,"C's",0
44,"44161",443,314,313,2,1,"C's",34
31,"31022",518,332,331,4,1,"C's",6
36,"36012",3732,2751,2717,9,34,"C's",165
40,"40161",36,28,28,2,0,"C's",3
16,"16237",110,87,87,0,0,"C's",15
18,"18175",11670,8200,8097,36,103,"C's",1121
45,"45143",1170,881,874,4,7,"C's",67
15,"15089",4291,3020,2972,28,48,"C's",242
40,"40053",83,66,65,0,1,"C's",7
24,"24028",388,292,288,2,4,"C's",36
16,"16191",899,675,671,2,4,"C's",69
20,"20023",441,252,251,1,1,"C's",5
4,"4103",1476,1018,1008,3,10,"C's",78
11,"11005",4583,3018,2967,25,51,"C's",241
45,"45144",783,620,618,3,2,"C's",35
3,"3106",583,480,478,2,2,"C's",36
21,"21016",1023,746,723,4,23,"C's",61
4,"4093",1882,1216,1204,11,12,"C's",102
34,"34134",50,40,40,2,0,"C's",0
16,"16238",501,428,422,3,6,"C's",21
26,"26065",50,43,42,0,1,"C's",4
36,"36038",66390,47750,47273,449,477,"C's",4571
32,"32043",2561,1806,1774,9,32,"C's",103
49,"49042",244,178,176,1,2,"C's",19
37,"37058",58,45,45,0,0,"C's",5
11,"11039",10018,6186,6109,103,77,"C's",726
31,"31010",5705,3718,3680,29,38,"C's",121
34,"34208",51,42,42,0,0,"C's",5
4,"4051",436,360,356,1,4,"C's",55
32,"32004",1798,1029,1023,4,6,"C's",25
45,"45101",3756,3020,2984,12,36,"C's",307
24,"24171",356,197,196,0,1,"C's",8
7,"7049",1480,1003,993,14,10,"C's",69
18,"18027",2570,1711,1700,13,11,"C's",161
23,"23086",11511,7997,7874,91,123,"C's",893
16,"16150",97,72,72,0,0,"C's",7
9,"9410",3040,2117,2095,16,22,"C's",177
46,"46041",329,253,252,5,1,"C's",26
44,"44266",115,90,90,0,0,"C's",4
5,"5053",82,57,57,0,0,"C's",14
21,"21037",472,341,336,2,5,"C's",45
22,"22908",197,142,140,3,2,"C's",13
14,"14060",4868,3473,3412,41,61,"C's",354
4,"4095",714,471,468,5,3,"C's",53
4,"4096",266,209,208,0,1,"C's",16
49,"49080",685,520,514,2,6,"C's",51
3,"3904",1396,1033,1026,4,7,"C's",138
21,"21078",2726,1793,1768,17,25,"C's",105
37,"37104",27,22,22,0,0,"C's",3
9,"9215",368,256,256,2,0,"C's",27
9,"9445",44,32,32,3,0,"C's",0
3,"3096",5786,4358,4289,17,69,"C's",714
46,"46260",2581,2087,2068,22,19,"C's",296
29,"29028",1237,836,826,6,10,"C's",67
16,"16099",203,153,147,0,6,"C's",17
26,"26148",165,135,133,1,2,"C's",18
2,"2034",1382,1110,1093,7,17,"C's",111
12,"12067",537,435,427,0,8,"C's",33
7,"7011",27721,17817,17720,139,97,"C's",2741
4,"4002",1039,748,740,2,8,"C's",93
27,"27008",1379,1000,982,9,18,"C's",42
41,"41083",1147,864,856,4,8,"C's",59
12,"12063",41,29,29,1,0,"C's",3
2,"2021",1017,784,778,6,6,"C's",60
46,"46034",1758,1390,1379,4,11,"C's",198
13,"13060",263,200,194,0,6,"C's",18
3,"3094",9080,6440,6396,34,44,"C's",1307
5,"5139",74,65,65,0,0,"C's",10
28,"28054",11257,8349,8273,55,76,"C's",1541
40,"40141",842,593,584,10,9,"C's",71
3,"3125",343,254,251,0,3,"C's",26
44,"44039",221,165,159,0,6,"C's",15
22,"22075",125,83,83,1,0,"C's",11
7,"7901",610,462,459,7,3,"C's",38
9,"9353",76,57,56,1,1,"C's",15
1,"1062",313,211,210,2,1,"C's",16
46,"46243",138,115,112,1,3,"C's",11
9,"9140",124,80,79,0,1,"C's",6
4,"4079",51383,33777,33586,257,191,"C's",5582
50,"50207",106,93,93,1,0,"C's",13
39,"39053",219,153,152,2,1,"C's",19
10,"10055",710,505,497,1,8,"C's",47
48,"48002",7829,5490,5451,44,39,"C's",137
32,"32076",2094,1488,1474,20,14,"C's",80
4,"4004",425,329,329,0,0,"C's",42
34,"34081",61,53,52,0,1,"C's",6
45,"45172",689,530,522,2,8,"C's",82
10,"10128",5697,3958,3891,32,67,"C's",328
24,"24025",297,228,227,0,1,"C's",32
23,"23057",766,625,619,4,6,"C's",24
18,"18184",2168,1629,1607,13,22,"C's",110
40,"40049",49,43,43,0,0,"C's",2
13,"13089",1706,1368,1332,8,36,"C's",106
41,"41060",15242,10021,9847,86,174,"C's",1379
9,"9020",259,196,188,5,8,"C's",23
44,"44112",429,290,290,2,0,"C's",26
47,"47164",378,313,311,1,2,"C's",23
42,"42184",57,43,43,0,0,"C's",6
42,"42022",221,173,171,5,2,"C's",23
13,"13048",504,390,387,2,3,"C's",13
46,"46141",439,351,342,2,9,"C's",20
20,"20065",3012,1985,1967,12,18,"C's",34
44,"44027",164,123,123,1,0,"C's",3
34,"34232",750,578,564,7,14,"C's",36
16,"16249",1995,1519,1499,6,20,"C's",114
37,"37172",888,572,566,3,6,"C's",72
32,"32034",1124,845,839,5,6,"C's",18
15,"15037",4061,2588,2552,19,36,"C's",155
5,"5240",3374,2283,2257,7,26,"C's",286
13,"13015",5431,3993,3950,17,43,"C's",299
28,"28010",9963,7745,7688,25,57,"C's",1604
16,"16905",1224,920,910,4,10,"C's",138
1,"1028",1070,716,710,3,6,"C's",29
39,"39016",23868,17883,17701,122,182,"C's",2934
19,"19327",418,350,348,1,2,"C's",33
40,"40160",102,71,70,1,1,"C's",10
37,"37284",316,246,238,4,8,"C's",26
45,"45142",7871,6007,5927,37,80,"C's",682
14,"14038",32322,22117,21887,179,230,"C's",3626
42,"42093",37,29,28,1,1,"C's",2
26,"26111",242,180,176,0,4,"C's",9
46,"46253",115,82,82,0,0,"C's",9
40,"40047",30,25,25,0,0,"C's",2
37,"37299",219,166,163,4,3,"C's",28
35,"35025",1797,1261,1245,4,16,"C's",108
44,"44256",38,34,34,0,0,"C's",11
37,"37039",301,217,213,0,4,"C's",25
28,"28901",799,558,554,0,4,"C's",86
47,"47220",165,130,129,0,1,"C's",16
2,"2029",3282,2467,2445,17,22,"C's",378
19,"19325",121,83,82,0,1,"C's",12
19,"19138",255,202,201,2,1,"C's",17
42,"42075",83,62,62,0,0,"C's",9
24,"24058",208,155,154,3,1,"C's",11
10,"10185",571,409,405,2,4,"C's",25
24,"24059",880,536,535,4,1,"C's",29
37,"37175",403,314,312,6,2,"C's",34
11,"11038",13737,10181,10034,99,147,"C's",1351
37,"37260",150,116,116,1,0,"C's",19
34,"34103",98,77,76,0,1,"C's",7
42,"42026",24,20,20,0,0,"C's",3
13,"13002",1483,1012,998,3,14,"C's",71
39,"39075",137376,99899,99048,718,851,"C's",14728
5,"5066",453,367,367,5,0,"C's",44
9,"9225",83,55,54,0,1,"C's",2
34,"34206",866,661,654,4,7,"C's",66
44,"44189",56,41,41,0,0,"C's",4
21,"21049",3361,2049,1984,17,65,"C's",153
14,"14040",3776,2873,2833,32,40,"C's",207
6,"6037",1748,1148,1134,9,14,"C's",74
46,"46153",439,355,351,1,4,"C's",26
19,"19266",236,188,188,1,0,"C's",25
19,"19038",28,24,23,0,1,"C's",5
18,"18069",502,362,357,0,5,"C's",24
14,"14014",2557,2035,2007,9,28,"C's",142
1,"1046",601,432,428,3,4,"C's",13
15,"15030",200176,143255,142070,1452,1185,"C's",14944
24,"24064",1523,1101,1087,3,14,"C's",120
24,"24199",424,302,301,0,1,"C's",30
6,"6129",577,438,429,0,9,"C's",26
12,"12064",91,82,81,2,1,"C's",9
50,"50255",209,163,163,5,0,"C's",11
4,"4010",576,444,443,3,1,"C's",50
47,"47016",69,56,55,0,1,"C's",6
22,"22011",88,71,69,0,2,"C's",10
4,"4075",5196,3735,3706,23,29,"C's",494
16,"16010",152,115,112,0,3,"C's",12
6,"6160",3153,2176,2146,16,30,"C's",126
4,"4011",2765,2119,2096,21,23,"C's",163
19,"19256",43,36,36,0,0,"C's",4
4,"4046",858,609,599,7,10,"C's",55
37,"37344",241,175,174,2,1,"C's",20
4,"4083",1776,1345,1336,6,9,"C's",100
42,"42127",38,31,31,1,0,"C's",2
37,"37335",406,296,290,0,6,"C's",50
37,"37315",96,70,70,0,0,"C's",5
45,"45070",1427,1147,1142,1,5,"C's",111
29,"29024",386,227,219,2,8,"C's",34
39,"39001",2102,1622,1601,18,21,"C's",176
42,"42178",115,83,83,0,0,"C's",4
6,"6162",2934,2182,2162,14,20,"C's",219
2,"2007",1030,824,818,4,6,"C's",24
2,"2004",612,479,473,5,6,"C's",30
16,"16104",51,41,41,0,0,"C's",5
49,"49082",359,304,301,6,3,"C's",25
26,"26142",787,612,606,3,6,"C's",60
9,"9139",103,87,85,3,2,"C's",6
16,"16043",95,73,73,1,0,"C's",4
46,"46043",136,124,124,0,0,"C's",9
10,"10054",547,431,421,1,10,"C's",29
16,"16225",73,57,57,3,0,"C's",2
21,"21027",48,36,35,1,1,"C's",0
24,"24100",761,561,555,7,6,"C's",61
22,"22128",188,146,144,3,2,"C's",20
50,"50079",249,175,174,0,1,"C's",21
49,"49054",894,617,601,13,16,"C's",90
37,"37364",820,607,598,6,9,"C's",65
39,"39033",568,418,415,2,3,"C's",45
9,"9338",227,170,169,0,1,"C's",34
50,"50289",51,38,38,0,0,"C's",0
22,"22076",311,201,199,0,2,"C's",23
37,"37034",85,65,65,0,0,"C's",14
15,"15009",10739,7688,7559,54,129,"C's",717
4,"4099",4989,3636,3588,27,48,"C's",447
49,"49135",626,434,430,1,4,"C's",43
12,"12100",1333,1065,1047,10,18,"C's",94
35,"35031",7259,5037,4942,29,95,"C's",606
28,"28036",2539,1899,1878,11,21,"C's",368
29,"29061",1016,798,769,8,29,"C's",97
22,"22077",379,279,273,2,6,"C's",35
34,"34098",777,551,545,8,6,"C's",75
22,"22087",67,45,45,2,0,"C's",5
3,"3034",1376,1067,1052,5,15,"C's",161
37,"37184",327,255,252,2,3,"C's",25
47,"47172",144,124,122,0,2,"C's",19
49,"49246",227,190,183,2,7,"C's",15
6,"6120",3389,2502,2478,12,24,"C's",193
28,"28104",14040,11151,11096,57,55,"C's",3049
10,"10210",543,356,355,1,1,"C's",17
37,"37051",85,66,66,0,0,"C's",3
44,"44126",329,234,229,4,5,"C's",20
34,"34083",1769,1218,1201,10,17,"C's",125
34,"34175",90,72,70,0,2,"C's",8
3,"3056",8676,6638,6541,34,97,"C's",855
16,"16047",232,175,175,2,0,"C's",26
45,"45041",3752,2633,2597,12,36,"C's",413
16,"16081",48,34,34,0,0,"C's",7
27,"27033",623,415,409,8,6,"C's",13
37,"37298",179,127,126,0,1,"C's",6
44,"44093",80,66,66,0,0,"C's",3
16,"16017",366,294,294,2,0,"C's",9
46,"46037",1122,936,923,4,13,"C's",93
10,"10044",1428,1040,1025,5,15,"C's",110
23,"23033",1352,1045,1034,12,11,"C's",107
1,"1042",904,653,648,6,5,"C's",6
5,"5012",133,105,102,0,3,"C's",11
9,"9406",251,192,191,2,1,"C's",34
4,"4072",313,247,245,2,2,"C's",42
5,"5192",101,82,79,2,3,"C's",7
44,"44141",135,97,96,1,1,"C's",13
9,"9266",91,74,74,0,0,"C's",3
9,"9407",28,23,23,0,0,"C's",0
37,"37055",123,98,94,0,4,"C's",4
39,"39057",2330,1671,1645,7,26,"C's",207
24,"24207",294,241,238,3,3,"C's",24
9,"9374",90,71,70,1,1,"C's",10
50,"50180",119,99,99,2,0,"C's",10
26,"26171",176,139,133,1,6,"C's",16
16,"16159",220,159,159,0,0,"C's",8
4,"4017",1296,857,854,5,3,"C's",115
34,"34071",171,132,132,1,0,"C's",10
29,"29065",187,137,136,0,1,"C's",11
33,"33024",226679,158750,157564,1209,1186,"C's",22309
37,"37121",575,418,413,3,5,"C's",54
49,"49264",578,383,377,5,6,"C's",24
3,"3038",355,288,285,3,3,"C's",27
22,"22110",738,531,527,4,4,"C's",60
19,"19037",141,115,114,1,1,"C's",9
31,"31211",27,15,15,1,0,"C's",2
5,"5015",82,61,61,1,0,"C's",3
5,"5261",41,26,26,0,0,"C's",3
6,"6035",937,696,681,5,15,"C's",27
1,"1003",1190,782,774,2,8,"C's",1
33,"33015",1540,998,986,8,12,"C's",83
46,"46170",3417,2714,2688,10,26,"C's",360
10,"10063",173,139,137,0,2,"C's",13
5,"5016",6335,4670,4586,41,84,"C's",602
28,"28060",1510,1134,1117,1,17,"C's",129
12,"12116",58,49,49,0,0,"C's",6
9,"9255",89,63,62,0,1,"C's",9
1,"1032",517,361,354,1,7,"C's",17
16,"16177",78,64,64,0,0,"C's",3
46,"46023",327,280,278,2,2,"C's",25
13,"13091",538,450,446,0,4,"C's",20
4,"4020",288,201,197,0,4,"C's",19
5,"5069",73,64,63,0,1,"C's",7
13,"13039",14366,10282,10185,81,97,"C's",1353
19,"19231",10,9,9,0,0,"C's",0
22,"22186",181,130,129,1,1,"C's",14
49,"49255",418,319,316,1,3,"C's",18
31,"31003",122,87,87,0,0,"C's",4
31,"31047",254,191,188,2,3,"C's",7
28,"28033",3899,2805,2788,7,17,"C's",514
22,"22096",301,240,240,0,0,"C's",47
41,"41062",2223,1653,1637,7,16,"C's",74
3,"3010",325,277,275,1,2,"C's",28
26,"26035",17,12,11,0,1,"C's",0
31,"31015",1994,1412,1392,25,20,"C's",97
36,"36004",10161,6939,6844,63,95,"C's",570
32,"32056",1592,1124,1118,7,6,"C's",42
45,"45069",1847,1391,1376,6,15,"C's",120
24,"24166",1407,1013,993,8,20,"C's",131
20,"20031",176,90,90,0,0,"C's",0
10,"10175",1416,1006,980,4,26,"C's",81
18,"18181",223,174,172,0,2,"C's",6
24,"24157",2568,1943,1911,22,32,"C's",274
16,"16186",456,375,371,0,4,"C's",19
9,"9438",538,437,433,6,4,"C's",75
48,"48021",1336,908,899,1,9,"C's",16
31,"31260",1238,794,788,12,6,"C's",31
19,"19081",29,22,22,1,0,"C's",0
40,"40069",83,66,63,0,3,"C's",3
33,"33038",2303,1584,1559,13,25,"C's",167
28,"28034",361,274,269,1,5,"C's",28
5,"5218",121,97,97,0,0,"C's",9
13,"13077",3489,2205,2152,18,53,"C's",260
31,"31149",2305,1461,1441,8,20,"C's",14
31,"31094",111,82,82,0,0,"C's",2
49,"49083",52,44,44,2,0,"C's",1
19,"19323",40,31,31,0,0,"C's",6
37,"37293",115,84,84,1,0,"C's",17
28,"28091",5440,3596,3558,24,38,"C's",400
10,"10069",838,626,615,2,11,"C's",63
37,"37113",433,334,333,3,1,"C's",42
28,"28141",5823,4297,4262,29,35,"C's",964
37,"37322",2465,1592,1564,8,28,"C's",269
50,"50186",42,31,31,0,0,"C's",4
14,"14063",1046,734,725,2,9,"C's",71
31,"31195",182,130,128,0,2,"C's",2
18,"18062",10393,7235,7161,63,74,"C's",1249
50,"50018",953,656,655,1,1,"C's",51
31,"31007",131,87,86,1,1,"C's",3
2,"2037",22865,14632,14477,91,155,"C's",2022
5,"5107",62,39,39,0,0,"C's",3
34,"34037",302,218,216,1,2,"C's",26
12,"12110",234,176,173,0,3,"C's",21
49,"49271",194,145,141,1,4,"C's",7
26,"26144",188,155,155,3,0,"C's",8
9,"9162",141,101,101,0,0,"C's",17
37,"37143",389,301,300,6,1,"C's",32
30,"30042",1922,1504,1491,7,13,"C's",170
46,"46062",4631,3511,3474,27,37,"C's",399
31,"31053",523,372,368,1,4,"C's",22
10,"10027",77,69,69,1,0,"C's",8
46,"46123",1829,1407,1388,7,19,"C's",190
2,"2025",7461,5759,5618,34,141,"C's",873
45,"45107",3257,2504,2472,15,32,"C's",422
28,"28018",3768,2968,2945,26,23,"C's",497
19,"19071",7840,5537,5489,45,48,"C's",1235
5,"5126",70,56,55,0,1,"C's",1
12,"12080",1932,1598,1570,10,28,"C's",162
34,"34163",45,38,38,0,0,"C's",2
46,"46089",2132,1602,1574,9,28,"C's",187
46,"46028",387,330,328,3,2,"C's",48
41,"41002",1473,1038,1014,9,24,"C's",76
39,"39045",367,271,268,1,3,"C's",14
37,"37297",425,328,322,2,6,"C's",43
16,"16004",259,198,197,2,1,"C's",8
5,"5208",40,36,36,0,0,"C's",2
5,"5127",643,519,514,3,5,"C's",70
39,"39066",872,667,661,4,6,"C's",95
20,"20036",13210,8518,8475,67,43,"C's",309
28,"28134",61008,45177,44904,263,273,"C's",9210
9,"9119",46,28,28,0,0,"C's",2
9,"9249",46,33,33,0,0,"C's",2
13,"13050",493,378,375,3,3,"C's",29
31,"31153",2159,1403,1387,12,16,"C's",50
16,"16173",205,157,156,0,1,"C's",5
18,"18036",3851,2870,2841,17,29,"C's",483
29,"29063",323,250,245,1,5,"C's",23
48,"48006",290,239,239,2,0,"C's",2
31,"31110",91,61,58,1,3,"C's",1
9,"9345",123,93,91,2,2,"C's",5
34,"34041",90,71,71,1,0,"C's",5
42,"42201",22,22,21,0,1,"C's",0
49,"49114",43,34,33,0,1,"C's",3
47,"47084",1150,887,870,7,17,"C's",75
15,"15051",4638,3182,3153,44,29,"C's",241
4,"4092",2838,2127,2103,10,24,"C's",277
4,"4029",8859,5834,5790,35,44,"C's",575
45,"45110",1786,1403,1398,5,5,"C's",69
16,"16253",337,264,263,2,1,"C's",24
5,"5099",491,395,386,6,9,"C's",37
14,"14039",2604,2062,2021,12,41,"C's",152
13,"13054",4944,3729,3678,27,51,"C's",409
45,"45045",1318,905,888,5,17,"C's",99
2,"2043",1239,937,927,3,10,"C's",77
19,"19129",28,26,26,0,0,"C's",3
22,"22068",79,60,60,0,0,"C's",7
39,"39007",417,278,275,2,3,"C's",19
49,"49154",127,78,77,0,1,"C's",4
40,"40122",512,395,394,2,1,"C's",43
44,"44175",122,85,84,1,1,"C's",5
18,"18162",938,698,686,1,12,"C's",55
3,"3029",245,185,183,1,2,"C's",16
42,"42038",36,28,28,1,0,"C's",2
49,"49047",107,75,75,0,0,"C's",6
26,"26089",110582,82972,82186,588,786,"C's",13000
42,"42175",21,16,16,0,0,"C's",1
37,"37302",290,196,195,2,1,"C's",22
44,"44257",166,123,119,1,4,"C's",12
13,"13021",434,365,363,4,2,"C's",12
16,"16068",137,98,97,1,1,"C's",6
41,"41061",2195,1749,1703,11,46,"C's",56
28,"28088",261,178,178,0,0,"C's",28
35,"35010",3558,2341,2301,28,40,"C's",233
2,"2058",337,234,231,0,3,"C's",15
46,"46231",2421,1721,1708,14,13,"C's",143
33,"33006",1540,1010,1003,5,7,"C's",72
40,"40010",121,102,101,1,1,"C's",9
16,"16198",1348,981,971,10,10,"C's",94
27,"27059",2163,1570,1543,17,27,"C's",72
44,"44026",90,77,76,0,1,"C's",4
20,"20904",95,44,44,2,0,"C's",0
44,"44070",53,48,48,0,0,"C's",1
1,"1019",150,106,105,1,1,"C's",7
31,"31026",144,118,117,0,1,"C's",7
19,"19172",57,48,47,0,1,"C's",4
16,"16185",43,37,37,0,0,"C's",1
9,"9256",354,258,258,2,0,"C's",30
6,"6054",5446,3920,3833,32,87,"C's",295
22,"22158",11995,8197,8126,62,71,"C's",1277
49,"49094",224,149,149,2,0,"C's",14
40,"40054",108,90,90,0,0,"C's",7
10,"10901",1174,752,741,4,11,"C's",70
22,"22022",552,414,408,6,6,"C's",66
39,"39011",1585,1169,1160,5,9,"C's",170
9,"9381",30,24,24,1,0,"C's",1
12,"12108",456,378,371,2,7,"C's",51
44,"44038",104,83,82,0,1,"C's",7
23,"23094",3839,3009,2954,14,55,"C's",215
34,"34049",359,266,260,1,6,"C's",30
22,"22160",209,168,168,6,0,"C's",18
28,"28053",6498,4995,4955,28,40,"C's",1158
1,"1020",327,237,234,3,3,"C's",4
18,"18029",1833,1196,1190,12,6,"C's",129
13,"13095",85,66,66,0,0,"C's",5
5,"5088",30,23,23,0,0,"C's",2
24,"24023",263,188,188,1,0,"C's",15
47,"47009",107,86,85,0,1,"C's",10
16,"16203",9972,7094,7007,34,87,"C's",646
31,"31205",427,299,297,4,2,"C's",10
47,"47153",108,77,77,0,0,"C's",2
12,"12020",118,105,105,0,0,"C's",14
48,"48052",1562,1160,1150,4,10,"C's",13
12,"12089",4328,3078,3020,15,58,"C's",426
34,"34141",177,149,145,2,4,"C's",16
31,"31194",311,217,216,3,1,"C's",9
9,"9113",449,339,332,4,7,"C's",46
49,"49148",260,137,134,1,3,"C's",11
13,"13097",2270,1687,1671,7,16,"C's",113
50,"50217",446,342,342,1,0,"C's",25
31,"31229",47,35,35,0,0,"C's",3
23,"23030",1238,968,960,3,8,"C's",33
5,"5903",151,104,104,2,0,"C's",11
26,"26082",112,87,87,1,0,"C's",14
2,"2077",55,47,47,0,0,"C's",2
36,"36020",2318,1646,1620,18,26,"C's",102
49,"49123",546,391,384,1,7,"C's",25
4,"4024",3074,2347,2327,20,20,"C's",354
37,"37255",49,34,34,1,0,"C's",2
46,"46201",64,52,51,1,1,"C's",1
19,"19070",74,53,53,0,0,"C's",2
49,"49085",996,684,680,2,4,"C's",57
31,"31030",141,100,99,0,1,"C's",2
34,"34199",1218,918,899,10,19,"C's",114
40,"40130",130,107,106,1,1,"C's",6
47,"47118",168,127,127,2,0,"C's",8
19,"19214",75,60,58,0,2,"C's",2
6,"6045",506,379,374,3,5,"C's",11
26,"26050",113,88,85,0,3,"C's",10
13,"13014",492,398,397,1,1,"C's",16
4,"4026",66,54,51,0,3,"C's",4
18,"18034",505,366,364,1,2,"C's",13
9,"9405",130,98,96,0,2,"C's",9
44,"44217",29,25,25,3,0,"C's",3
10,"10073",747,524,516,4,8,"C's",21
30,"30003",24332,16183,16040,104,143,"C's",2029
50,"50210",38,30,30,1,0,"C's",1
50,"50125",360,248,246,3,2,"C's",11
46,"46011",7609,5249,5191,26,58,"C's",673
49,"49005",149,91,91,2,0,"C's",17
41,"41079",9294,6670,6580,51,90,"C's",888
49,"49006",154,99,95,0,4,"C's",12
48,"48056",966,705,700,5,5,"C's",9
16,"16048",408,313,312,1,1,"C's",22
28,"28057",1458,1097,1088,3,9,"C's",243
2,"2040",559,484,483,3,1,"C's",54
24,"24027",1211,863,847,8,16,"C's",99
31,"31165",2780,1995,1960,30,35,"C's",105
46,"46237",7211,5395,5343,42,52,"C's",816
6,"6154",2802,1923,1894,23,29,"C's",153
34,"34902",139,106,106,0,0,"C's",5
45,"45187",4062,3277,3233,15,44,"C's",254
27,"27017",1003,674,670,4,4,"C's",10
4,"4038",3084,2140,2126,16,14,"C's",259
41,"41901",2682,2107,2086,28,21,"C's",126
23,"23901",1154,970,964,3,6,"C's",58
47,"47175",6564,4781,4728,39,53,"C's",750
16,"16006",120,98,96,3,2,"C's",5
50,"50232",175,110,110,3,0,"C's",8
49,"49250",1245,935,920,7,15,"C's",129
26,"26075",329,267,264,2,3,"C's",42
20,"20060",88,67,67,2,0,"C's",0
41,"41016",7355,5248,5175,51,73,"C's",844
27,"27019",8111,5773,5680,53,93,"C's",433
3,"3121",21273,14569,14468,62,101,"C's",2314
39,"39088",69,52,52,0,0,"C's",4
44,"44084",54,41,41,0,0,"C's",6
7,"7033",27104,15524,15337,174,187,"C's",1941
31,"31067",1922,1312,1294,10,18,"C's",62
14,"14012",6173,4364,4291,35,73,"C's",272
16,"16051",142,120,119,0,1,"C's",4
5,"5148",25,15,15,0,0,"C's",1
22,"22156",289,220,220,2,0,"C's",37
40,"40022",213,164,161,2,3,"C's",23
14,"14022",4006,2977,2949,17,28,"C's",205
31,"31046",57,39,39,1,0,"C's",2
29,"29066",334,234,233,4,1,"C's",15
3,"3069",3076,2123,2102,17,21,"C's",322
45,"45145",2565,1695,1675,12,20,"C's",257
10,"10080",366,257,255,1,2,"C's",10
19,"19208",43,30,30,0,0,"C's",3
34,"34059",426,347,342,6,5,"C's",29
41,"41006",2740,1782,1768,14,14,"C's",115
44,"44014",2521,1896,1867,8,29,"C's",202
50,"50244",201,162,161,1,1,"C's",23
22,"22157",192,129,128,3,1,"C's",8
31,"31258",7879,5707,5666,50,41,"C's",263
36,"36015",4153,2721,2677,23,44,"C's",186
18,"18117",506,383,373,1,10,"C's",20
33,"33037",34454,22881,22586,243,295,"C's",1936
3,"3060",109,91,91,0,0,"C's",2
47,"47194",298,239,237,2,2,"C's",24
45,"45023",2177,1571,1556,6,15,"C's",285
7,"7036",26955,18578,18433,148,145,"C's",3529
31,"31904",1563,1029,1022,23,7,"C's",40
49,"49170",102,72,71,0,1,"C's",8
42,"42084",25,22,22,1,0,"C's",0
44,"44087",80,69,67,1,2,"C's",4
6,"6068",446,347,345,5,2,"C's",18
49,"49050",507,342,338,1,4,"C's",37
50,"50045",1243,926,925,6,1,"C's",101
31,"31170",47,42,42,3,0,"C's",2
27,"27024",1598,1173,1158,8,15,"C's",34
9,"9272",282,210,206,3,4,"C's",20
5,"5039",54,42,41,0,1,"C's",4
42,"42017",140,113,112,0,1,"C's",5
39,"39071",397,261,256,1,5,"C's",19
47,"47115",281,236,233,3,3,"C's",25
35,"35012",10382,5443,5392,17,51,"C's",552
10,"10174",174,135,132,0,3,"C's",6
28,"28100",4196,2987,2955,14,32,"C's",508
9,"9138",85,72,70,0,2,"C's",6
34,"34213",57,45,44,1,1,"C's",2
31,"31104",1834,1257,1235,16,22,"C's",55
31,"31038",1339,957,942,11,15,"C's",63
46,"46060",9369,7052,6993,42,59,"C's",942
7,"7038",2010,1424,1412,18,12,"C's",98
42,"42044",54,42,39,0,3,"C's",2
49,"49173",375,230,221,3,9,"C's",9
30,"30010",6869,5194,5142,21,52,"C's",579
40,"40001",702,560,554,3,6,"C's",88
45,"45072",671,484,483,2,1,"C's",41
50,"50268",44,37,37,0,0,"C's",3
29,"29037",209,158,157,1,1,"C's",5
16,"16058",103,77,77,0,0,"C's",3
45,"45127",696,514,511,3,3,"C's",48
34,"34066",59,49,48,0,1,"C's",7
31,"31128",359,265,263,0,2,"C's",7
18,"18045",1126,756,742,4,14,"C's",54
19,"19324",176,126,125,3,1,"C's",15
5,"5041",1001,775,762,8,13,"C's",97
29,"29026",1057,751,748,5,3,"C's",42
37,"37081",930,728,722,3,6,"C's",48
22,"22015",319,234,228,3,6,"C's",33
49,"49174",125,95,92,1,3,"C's",9
22,"22051",100,81,81,0,0,"C's",5
12,"12033",1919,1437,1404,19,33,"C's",174
10,"10148",32850,22161,21856,177,305,"C's",2913
50,"50156",215,181,178,2,3,"C's",21
28,"28027",1203,872,857,3,15,"C's",167
10,"10179",294,231,229,2,2,"C's",11
14,"14045",3052,2362,2335,11,27,"C's",247
35,"35032",3412,2473,2425,17,48,"C's",233
45,"45062",1112,878,867,4,11,"C's",81
20,"20035",486,337,334,1,3,"C's",1
9,"9141",616,485,483,5,2,"C's",65
31,"31241",133,98,98,2,0,"C's",6
47,"47209",41,34,34,0,0,"C's",5
16,"16206",204,158,157,6,1,"C's",6
27,"27031",15570,10606,10420,118,186,"C's",745
4,"4049",5313,3620,3579,18,41,"C's",393
6,"6075",465,383,372,0,11,"C's",20
37,"37242",91,74,73,0,1,"C's",11
23,"23006",4660,3687,3647,24,40,"C's",276
24,"24228",660,430,422,6,8,"C's",43
2,"2039",984,790,786,10,4,"C's",75
44,"44065",60,40,40,0,0,"C's",6
37,"37085",4712,3366,3333,27,33,"C's",860
31,"31043",38,31,30,1,1,"C's",1
36,"36035",14433,10333,10188,79,145,"C's",1094
44,"44195",88,60,60,1,0,"C's",9
9,"9277",120,101,99,0,2,"C's",6
50,"50052",90,68,68,0,0,"C's",8
3,"3036",87,81,78,0,3,"C's",7
48,"48096",6577,4794,4728,31,66,"C's",99
34,"34070",154,123,123,2,0,"C's",3
34,"34025",57,39,39,1,0,"C's",3
7,"7003",11761,6631,6541,55,90,"C's",872
47,"47228",440,331,331,2,0,"C's",54
12,"12902",2158,1504,1489,14,15,"C's",209
45,"45098",2159,1632,1609,12,23,"C's",97
5,"5260",105,90,90,0,0,"C's",9
50,"50242",93,75,75,3,0,"C's",7
2,"2055",1127,679,668,6,11,"C's",58
19,"19228",26,20,20,0,0,"C's",1
21,"21019",612,400,391,2,9,"C's",26
42,"42142",50,35,35,1,0,"C's",4
4,"4052",12274,8372,8306,93,66,"C's",1662
23,"23035",1106,873,855,1,18,"C's",48
16,"16212",247,203,202,0,1,"C's",19
16,"16213",36,34,34,0,0,"C's",6
46,"46099",901,689,684,1,5,"C's",78
9,"9267",111,99,97,1,2,"C's",13
49,"49207",239,150,146,0,4,"C's",9
47,"47023",2995,2344,2326,18,18,"C's",498
12,"12083",93,79,76,0,3,"C's",13
26,"26136",107,85,85,0,0,"C's",9
38,"38050",2462,1624,1604,8,20,"C's",71
49,"49141",340,248,246,0,2,"C's",17
28,"28136",647,528,518,2,10,"C's",88
37,"37189",121,88,88,0,0,"C's",10
41,"41027",3922,2660,2604,23,56,"C's",289
30,"30026",15734,10007,9901,51,106,"C's",1430
41,"41005",9068,6366,6281,58,85,"C's",840
50,"50234",243,189,185,6,4,"C's",34
46,"46255",3174,2448,2424,22,24,"C's",280
9,"9151",448,362,360,6,2,"C's",42
2,"2044",1105,768,758,7,10,"C's",85
37,"37041",78,52,52,0,0,"C's",8
50,"50202",152,100,99,1,1,"C's",5
4,"4044",1547,1166,1156,5,10,"C's",133
1,"1018",1386,939,930,3,9,"C's",22
49,"49227",315,230,228,2,2,"C's",31
9,"9283",44,32,31,0,1,"C's",3
5,"5214",38,28,28,0,0,"C's",14
19,"19118",11,9,9,0,0,"C's",1
7,"7048",17252,10055,9984,105,71,"C's",1470
50,"50213",94,75,74,0,1,"C's",4
27,"27040",3200,2351,2310,21,41,"C's",89
26,"26012",23,23,23,1,0,"C's",0
24,"24131",724,511,507,3,4,"C's",43
10,"10187",438,308,305,1,3,"C's",24
12,"12107",355,303,299,4,4,"C's",26
13,"13092",1846,1477,1462,5,15,"C's",98
31,"31147",100,82,82,2,0,"C's",4
11,"11018",1468,1046,1031,9,15,"C's",79
5,"5264",61,38,37,2,1,"C's",6
19,"19160",886,558,552,2,6,"C's",71
26,"26140",253,208,206,0,2,"C's",13
20,"20075",4371,2692,2679,18,13,"C's",61
15,"15006",5321,3341,3283,49,58,"C's",218
31,"31148",92,69,69,5,0,"C's",5
3,"3061",1056,776,768,4,8,"C's",102
12,"12065",188,169,169,2,0,"C's",0
40,"40181",4233,3260,3219,23,41,"C's",557
34,"34092",288,230,226,1,4,"C's",8
46,"46068",346,276,266,6,10,"C's",37
27,"27043",1295,805,793,9,12,"C's",56
18,"18180",633,410,410,3,0,"C's",55
16,"16151",64,61,59,0,2,"C's",13
16,"16119",169,127,127,0,0,"C's",4
9,"9029",168,131,129,4,2,"C's",20
5,"5021",1914,1483,1464,5,19,"C's",161
44,"44061",70,54,51,0,3,"C's",7
46,"46051",8347,6355,6302,24,53,"C's",818
1,"1036",14955,10052,9959,55,93,"C's",230
5,"5073",297,253,252,2,1,"C's",27
49,"49185",157,123,122,2,1,"C's",22
19,"19269",102,81,80,0,1,"C's",5
26,"26106",86,72,72,0,0,"C's",12
14,"14044",1604,1172,1165,7,7,"C's",151
40,"40127",32,25,25,0,0,"C's",1
39,"39062",1812,1379,1366,5,13,"C's",213
29,"29070",40333,25991,25728,214,263,"C's",5445
9,"9292",87,75,73,1,2,"C's",11
10,"10024",695,525,520,3,5,"C's",64
26,"26004",67,50,50,0,0,"C's",3
50,"50216",235,186,184,5,2,"C's",16
27,"27046",1530,1022,1007,9,15,"C's",44
44,"44263",376,266,263,3,3,"C's",37
39,"39023",6330,4737,4672,25,65,"C's",627
46,"46104",1940,1504,1487,7,17,"C's",89
45,"45128",2502,1680,1668,6,12,"C's",229
42,"42182",56,43,41,1,2,"C's",2
9,"9114",86,66,66,0,0,"C's",8
9,"9339",128,110,110,0,0,"C's",11
9,"9427",1419,978,959,8,19,"C's",100
4,"4059",1079,723,712,4,11,"C's",44
34,"34177",179,149,149,2,0,"C's",12
34,"34112",46,38,37,0,1,"C's",1
11,"11011",1716,1195,1165,12,30,"C's",143
9,"9190",86,58,56,0,2,"C's",5
45,"45084",2257,1679,1656,13,23,"C's",114
6,"6135",1092,846,828,0,18,"C's",83
40,"40073",401,345,343,3,2,"C's",53
13,"13902",469,367,363,0,4,"C's",42
15,"15010",1887,1168,1150,13,18,"C's",53
34,"34130",212,164,163,1,1,"C's",14
49,"49272",88,70,69,1,1,"C's",4
47,"47055",203,167,163,0,4,"C's",11
28,"28144",6010,4676,4644,22,32,"C's",835
34,"34231",229,168,167,1,1,"C's",19
49,"49069",367,258,254,5,4,"C's",17
44,"44092",81,59,57,0,2,"C's",6
9,"9265",37,28,28,0,0,"C's",5
39,"39035",9502,7017,6928,57,89,"C's",909
46,"46236",972,818,809,2,9,"C's",65
27,"27015",4270,2832,2769,33,63,"C's",129
9,"9416",53,35,35,0,0,"C's",0
3,"3015",12566,9257,9177,39,80,"C's",1369
27,"27050",2975,2190,2154,16,36,"C's",96
6,"6001",686,522,515,0,7,"C's",43
14,"14057",6136,4713,4631,47,82,"C's",480
9,"9073",926,691,686,4,5,"C's",131
33,"33073",8554,4945,4884,41,61,"C's",463
3,"3046",1599,1153,1143,8,10,"C's",166
15,"15012",3627,2659,2602,28,57,"C's",222
49,"49190",63,47,45,0,2,"C's",3
9,"9297",323,251,250,6,1,"C's",45
26,"26110",152,131,129,0,2,"C's",11
28,"28029",520,408,406,0,2,"C's",75
23,"23020",1590,1370,1349,9,21,"C's",108
45,"45176",3706,2554,2521,22,33,"C's",518
22,"22029",127,100,100,0,0,"C's",11
14,"14001",3514,2837,2789,28,48,"C's",177
12,"12013",144,121,119,0,2,"C's",8
31,"31155",256,169,167,2,2,"C's",14
42,"42110",59,45,45,2,0,"C's",4
47,"47112",2587,2015,1988,7,27,"C's",212
45,"45109",2883,2271,2214,9,57,"C's",165
1,"1056",219,136,135,0,1,"C's",3
32,"32021",947,634,630,5,4,"C's",22
49,"49192",130,110,109,2,1,"C's",12
40,"40007",78,63,61,0,2,"C's",7
45,"45020",1290,1037,1026,6,11,"C's",67
38,"38026",32950,24443,24196,129,247,"C's",2341
46,"46247",1006,714,710,3,4,"C's",70
19,"19169",40,34,34,0,0,"C's",2
31,"31223",985,704,698,4,6,"C's",46
16,"16130",571,450,448,1,2,"C's",34
12,"12050",1305,1015,1000,6,15,"C's",67
44,"44209",833,611,602,6,9,"C's",59
9,"9037",111,91,91,0,0,"C's",15
5,"5082",529,432,422,1,10,"C's",29
9,"9419",78,55,55,0,0,"C's",6
18,"18024",855,665,654,7,11,"C's",68
22,"22057",370,271,270,3,1,"C's",31
19,"19254",45,34,34,0,0,"C's",6
28,"28041",4524,3508,3490,20,18,"C's",891
10,"10018",1689,1101,1081,6,20,"C's",80
6,"6142",273,205,197,2,8,"C's",17
19,"19279",57,55,55,0,0,"C's",4
41,"41017",15158,10718,10616,92,102,"C's",1964
50,"50140",166,115,115,0,0,"C's",10
18,"18178",719,549,544,4,5,"C's",22
28,"28119",2092,1590,1582,12,8,"C's",323
39,"39008",13877,10258,10153,96,105,"C's",1545
28,"28051",1541,1163,1149,1,14,"C's",199
41,"41095",41232,27076,26793,315,283,"C's",3985
16,"16242",317,272,270,1,2,"C's",14
15,"15042",3028,2033,2000,19,33,"C's",144
49,"49183",100,77,77,2,0,"C's",8
19,"19304",219,173,171,3,2,"C's",21
18,"18087",184857,134428,133526,864,902,"C's",19308
9,"9169",95,78,78,0,0,"C's",13
15,"15054",32106,21026,20772,259,254,"C's",2209
22,"22069",429,333,331,2,2,"C's",56
5,"5231",165,133,133,2,0,"C's",17
7,"7022",11545,7385,7306,88,79,"C's",815
3,"3020",99,79,79,0,0,"C's",15
42,"42028",75,51,51,0,0,"C's",5
44,"44211",42,35,35,0,0,"C's",3
44,"44111",92,69,68,0,1,"C's",7
10,"10082",1868,1451,1412,11,39,"C's",83
14,"14024",1903,1405,1376,16,29,"C's",140
5,"5217",56,44,43,0,1,"C's",3
9,"9172",129,103,101,1,2,"C's",14
3,"3103",272,235,234,1,1,"C's",15
46,"46085",11081,7938,7866,46,72,"C's",959
7,"7010",4880,3395,3361,32,34,"C's",458
18,"18120",264,209,208,1,1,"C's",12
49,"49200",949,720,715,10,5,"C's",63
20,"20020",125,71,69,3,2,"C's",0
42,"42029",137,104,104,2,0,"C's",11
40,"40168",34,29,29,1,0,"C's",2
36,"36054",10993,7476,7363,67,113,"C's",635
15,"15045",3770,2184,2157,14,27,"C's",90
31,"31061",54,49,49,0,0,"C's",0
29,"29081",261,197,197,1,0,"C's",16
31,"31193",1426,1024,1013,13,11,"C's",42
12,"12055",104,83,82,3,1,"C's",11
30,"30040",732,617,607,2,10,"C's",31
16,"16013",27,24,24,0,0,"C's",4
42,"42208",22,13,13,2,0,"C's",1
50,"50166",255,208,206,2,2,"C's",19
13,"13061",5702,3867,3822,28,45,"C's",488
29,"29059",2587,1965,1922,14,43,"C's",117
37,"37252",112,79,79,0,0,"C's",8
22,"22245",309,267,261,1,6,"C's",40
40,"40083",77,59,59,0,0,"C's",2
6,"6088",12616,8436,8313,70,123,"C's",945
24,"24046",942,637,633,5,4,"C's",52
49,"49084",287,229,228,4,1,"C's",30
5,"5187",1754,1323,1303,7,20,"C's",178
10,"10904",745,507,504,8,3,"C's",74
44,"44114",243,178,173,0,5,"C's",32
40,"40171",32,23,23,0,0,"C's",1
41,"41044",7423,5273,5241,34,32,"C's",844
37,"37128",260,202,196,0,6,"C's",24
13,"13011",4792,3112,3077,14,35,"C's",298
37,"37115",123,89,87,0,2,"C's",2
47,"47054",635,507,495,9,12,"C's",54
31,"31008",75,54,54,2,0,"C's",4
19,"19189",120,91,90,2,1,"C's",10
46,"46010",935,729,723,4,6,"C's",90
5,"5189",449,351,349,2,2,"C's",36
16,"16248",859,654,636,5,18,"C's",60
46,"46251",2462,1997,1956,6,41,"C's",194
19,"19248",78,63,63,0,0,"C's",12
9,"9441",74,65,65,0,0,"C's",4
28,"28056",863,630,617,4,13,"C's",77
9,"9007",57,39,39,0,0,"C's",3
3,"3024",3901,3067,3024,11,43,"C's",332
3,"3117",362,318,313,2,5,"C's",47
32,"32018",1247,975,962,9,13,"C's",48
45,"45040",1349,846,838,4,8,"C's",55
19,"19249",32,29,29,0,0,"C's",0
50,"50230",1165,833,828,8,5,"C's",75
16,"16234",25,18,18,0,0,"C's",0
3,"3107",2508,1755,1744,7,11,"C's",287
1,"1901",2354,1592,1571,8,21,"C's",80
6,"6107",1581,999,995,8,4,"C's",71
31,"31098",1903,1428,1419,19,9,"C's",116
30,"30901",10309,7821,7718,43,103,"C's",1028
23,"23019",1536,1196,1174,2,22,"C's",92
20,"20025",1143,765,760,8,5,"C's",3
26,"26086",16,15,15,1,0,"C's",0
18,"18007",781,521,512,5,9,"C's",41
37,"37215",136,104,103,1,1,"C's",3
42,"42215",773,531,520,7,11,"C's",49
50,"50292",125,102,102,1,0,"C's",11
27,"27052",915,676,667,6,9,"C's",36
46,"46003",950,791,769,1,22,"C's",62
36,"36060",30323,21399,21162,164,237,"C's",2013
22,"22208",188,150,145,0,5,"C's",21
34,"34101",50,41,41,0,0,"C's",5
20,"20026",197,145,133,0,12,"C's",0
42,"42036",50,41,41,1,0,"C's",3
15,"15064",2194,1592,1556,21,36,"C's",127
37,"37133",111,78,73,1,5,"C's",9
31,"31099",62,47,47,2,0,"C's",1
10,"10138",555,448,446,2,2,"C's",31
19,"19105",2334,1753,1739,8,14,"C's",354
47,"47203",62,53,53,1,0,"C's",6
6,"6095",9504,6621,6475,96,146,"C's",557
4,"4073",330,234,233,2,1,"C's",24
5,"5130",90,85,85,0,0,"C's",8
22,"22168",23,18,18,0,0,"C's",8
38,"38002",956,702,696,21,6,"C's",48
6,"6110",148,108,108,1,0,"C's",4
28,"28002",3007,2091,2074,14,17,"C's",447
41,"41049",9299,6896,6771,98,125,"C's",664
46,"46039",2130,1728,1699,8,29,"C's",193
24,"24901",889,636,623,5,13,"C's",51
9,"9302",112,83,83,1,0,"C's",15
31,"31189",1161,720,709,6,11,"C's",15
9,"9253",109,94,91,1,3,"C's",14
26,"26102",6111,4486,4435,28,51,"C's",533
50,"50264",156,115,115,0,0,"C's",9
19,"19219",13,9,9,0,0,"C's",0
5,"5196",50,37,36,0,1,"C's",6
36,"36901",4103,3153,3102,19,51,"C's",228
47,"47141",134,111,110,0,1,"C's",6
31,"31057",1781,1287,1268,10,19,"C's",88
23,"23025",2802,2056,2037,9,19,"C's",104
16,"16197",59,42,42,0,0,"C's",8
50,"50044",230,145,145,1,0,"C's",11
15,"15067",8029,5789,5732,37,57,"C's",423
31,"31168",246,172,171,1,1,"C's",9
12,"12096",777,587,577,6,10,"C's",40
39,"39009",3216,2366,2337,17,29,"C's",327
39,"39070",144,96,94,2,2,"C's",6
47,"47033",196,154,154,1,0,"C's",28
38,"38004",4456,3026,2983,23,43,"C's",332
42,"42176",29,25,25,0,0,"C's",2
41,"41051",2180,1529,1501,2,28,"C's",118
14,"14042",18891,14051,13848,190,203,"C's",1837
46,"46256",6853,4951,4890,25,61,"C's",641
37,"37221",430,293,290,0,3,"C's",15
37,"37263",342,237,229,0,8,"C's",15
22,"22083",463,394,390,5,4,"C's",31
2,"2006",579,464,458,3,6,"C's",30
11,"11008",17471,10952,10812,128,140,"C's",1795
37,"37137",105,66,66,0,0,"C's",0
10,"10098",378,289,287,1,2,"C's",24
49,"49256",256,204,204,0,0,"C's",10
16,"16103",261,222,222,0,0,"C's",20
2,"2074",5935,4193,4139,32,54,"C's",463
44,"44191",764,586,583,6,3,"C's",49
18,"18088",1541,1124,1117,5,7,"C's",44
21,"21038",1095,705,693,4,12,"C's",60
19,"19294",29,27,27,0,0,"C's",1
31,"31071",17,16,16,0,0,"C's",0
29,"29002",1177,804,789,5,15,"C's",108
28,"28006",78966,59065,58698,267,367,"C's",11139
37,"37306",259,186,183,1,3,"C's",26
27,"27026",2397,1503,1471,9,32,"C's",81
6,"6116",1587,1171,1160,10,11,"C's",72
18,"18105",3782,2450,2420,17,30,"C's",219
10,"10191",527,405,397,2,8,"C's",49
47,"47126",50,41,41,0,0,"C's",2
27,"27027",1929,1369,1342,11,27,"C's",84
26,"26153",13,12,11,0,1,"C's",0
47,"47207",278,215,212,3,3,"C's",18
41,"41020",12887,8210,8118,82,92,"C's",715
19,"19258",90,77,77,0,0,"C's",3
37,"37140",674,443,439,5,4,"C's",60
40,"40055",37,26,26,0,0,"C's",7
49,"49096",170,131,124,2,7,"C's",11
27,"27028",79049,54057,53355,559,702,"C's",5013
3,"3116",1155,877,875,6,2,"C's",125
23,"23055",47167,31479,31198,264,281,"C's",4142
16,"16014",602,485,483,0,2,"C's",23
31,"31106",698,533,529,3,4,"C's",58
19,"19259",30,25,25,1,0,"C's",0
37,"37225",103,89,86,0,3,"C's",16
15,"15034",2885,1782,1760,18,22,"C's",114
46,"46200",1903,1561,1539,3,22,"C's",159
49,"49220",135,110,109,0,1,"C's",7
12,"12069",66,49,48,0,1,"C's",13
48,"48063",372,279,277,2,2,"C's",0
31,"31041",1606,1114,1101,15,13,"C's",102
19,"19235",93,71,71,1,0,"C's",4
6,"6060",5786,4146,4071,24,75,"C's",342
18,"18018",634,472,468,5,4,"C's",37
40,"40185",863,646,642,3,4,"C's",65
4,"4015",124,96,96,2,0,"C's",7
37,"37008",4266,3216,3197,19,19,"C's",444
10,"10103",450,322,318,1,4,"C's",16
33,"33031",35120,22295,22024,271,271,"C's",1930
19,"19031",15,9,9,0,0,"C's",0
24,"24170",1908,1365,1345,8,20,"C's",114
13,"13031",2452,1919,1909,11,10,"C's",213
23,"23071",1715,1290,1278,7,12,"C's",118
12,"12070",522,406,401,0,5,"C's",33
29,"29039",2666,1898,1873,22,25,"C's",192
50,"50208",1774,1207,1195,10,12,"C's",166
11,"11013",2312,1547,1518,15,29,"C's",210
24,"24124",367,244,233,3,11,"C's",14
3,"3025",1270,950,941,2,9,"C's",113
37,"37269",447,326,324,1,2,"C's",42
31,"31109",1582,1155,1150,9,5,"C's",64
10,"10058",1021,718,708,2,10,"C's",64
9,"9061",162,124,123,0,1,"C's",2
22,"22222",530,384,379,3,5,"C's",84
41,"41024",22600,14263,14048,128,215,"C's",1765
29,"29040",1977,1290,1278,12,12,"C's",155
6,"6077",341,256,249,0,7,"C's",15
49,"49100",295,212,208,5,4,"C's",11
44,"44160",466,304,301,2,3,"C's",51
14,"14047",1672,1187,1178,14,9,"C's",171
22,"22167",493,388,381,9,7,"C's",44
50,"50200",511,410,403,2,7,"C's",75
16,"16112",1497,1031,1021,9,10,"C's",50
37,"37314",82,65,65,0,0,"C's",8
45,"45199",2940,1848,1805,14,43,"C's",298
49,"49101",153,102,99,0,3,"C's",16
10,"10107",1031,801,792,3,9,"C's",43
34,"34116",62,49,49,0,0,"C's",3
47,"47157",515,424,423,1,1,"C's",47
24,"24172",418,255,250,2,5,"C's",18
38,"38013",2949,1896,1867,17,29,"C's",148
45,"45065",271,207,206,1,1,"C's",10
4,"4082",297,200,200,0,0,"C's",16
9,"9418",82,62,61,1,1,"C's",7
19,"19302",59,49,49,1,0,"C's",3
1,"1030",156,129,129,3,0,"C's",0
9,"9050",68,56,55,1,1,"C's",1
26,"26173",6,6,6,1,0,"C's",0
15,"15002",23083,16073,15889,159,184,"C's",1959
5,"5115",523,378,373,0,5,"C's",31
16,"16115",44,35,34,0,1,"C's",2
42,"42052",15,13,13,0,0,"C's",1
39,"39028",3739,2850,2817,16,33,"C's",533
11,"11016",14929,9426,9302,123,124,"C's",1232
49,"49226",255,198,195,0,3,"C's",20
10,"10002",364,272,270,0,2,"C's",21
31,"31068",2885,2060,2027,20,33,"C's",172
24,"24174",486,343,342,4,1,"C's",14
7,"7047",2246,1517,1482,18,35,"C's",190
34,"34073",185,149,149,0,0,"C's",17
10,"10155",1126,773,763,5,10,"C's",58
37,"37135",1207,905,899,15,6,"C's",117
16,"16255",140,122,121,0,1,"C's",9
26,"26103",796,616,610,6,6,"C's",43
39,"39059",7986,5879,5806,45,73,"C's",677
40,"40192",159,117,117,2,0,"C's",13
37,"37149",68,64,64,0,0,"C's",5
32,"32054",87167,60059,59333,540,726,"C's",5505
16,"16117",1040,787,777,4,10,"C's",69
46,"46049",281,232,224,0,8,"C's",13
31,"31113",133,87,86,0,1,"C's",4
22,"22214",128,106,105,3,1,"C's",19
10,"10203",4558,3120,3079,20,41,"C's",280
29,"29045",1684,1178,1168,8,10,"C's",143
9,"9464",35,27,27,0,0,"C's",0
34,"34123",1648,1287,1258,12,29,"C's",131
49,"49145",236,162,157,0,5,"C's",10
3,"3102",7229,5492,5414,52,78,"C's",566
15,"15043",5114,3476,3401,47,75,"C's",259
9,"9334",50,39,37,0,2,"C's",7
5,"5215",164,123,122,2,1,"C's",8
19,"19267",19,13,13,0,0,"C's",1
18,"18028",928,765,758,2,7,"C's",27
10,"10204",429,331,329,6,2,"C's",21
28,"28111",596,467,467,3,0,"C's",65
10,"10189",2630,1880,1851,4,29,"C's",158
12,"12128",1393,1090,1072,10,18,"C's",163
2,"2060",1294,997,983,2,14,"C's",105
16,"16278",70,55,55,0,0,"C's",1
19,"19120",101,88,88,1,0,"C's",6
6,"6040",1009,648,645,1,3,"C's",42
49,"49025",173,133,133,1,0,"C's",8
9,"9067",437,295,294,6,1,"C's",26
5,"5266",100,86,86,0,0,"C's",6
46,"46155",1029,833,822,4,11,"C's",66
1,"1008",786,513,509,11,4,"C's",25
22,"22229",114,80,80,1,0,"C's",12
3,"3136",441,338,334,0,4,"C's",18
9,"9199",92,72,71,1,1,"C's",6
37,"37154",140,113,110,3,3,"C's",6
9,"9200",50,32,31,0,1,"C's",3
3,"3002",3605,2583,2557,15,26,"C's",309
28,"28016",79,53,51,0,2,"C's",6
2,"2062",408,297,292,0,5,"C's",31
39,"39093",299,229,226,4,3,"C's",34
4,"4088",2454,1660,1650,15,10,"C's",128
3,"3104",27103,19953,19787,131,166,"C's",3544
44,"44028",183,151,150,4,1,"C's",14
37,"37279",750,522,513,4,9,"C's",67
24,"24079",906,664,658,9,6,"C's",93
37,"37182",75,56,55,0,1,"C's",8
14,"14054",13697,10315,10109,93,206,"C's",1321
44,"44236",63,48,47,0,1,"C's",5
16,"16227",113,93,93,0,0,"C's",7
13,"13098",2092,1503,1461,8,42,"C's",111
10,"10025",400,327,318,1,9,"C's",27
37,"37196",75,64,64,0,0,"C's",11
24,"24080",213,164,161,3,3,"C's",13
44,"44135",113,88,87,0,1,"C's",3
40,"40198",24,19,19,0,0,"C's",1
31,"31217",321,226,223,1,3,"C's",4
14,"14073",2891,2079,2016,13,63,"C's",179
31,"31207",273,182,177,2,5,"C's",1
6,"6044",28875,19791,19616,145,175,"C's",2311
18,"18124",381,277,277,2,0,"C's",17
9,"9387",117,95,90,0,5,"C's",12
26,"26179",41,32,31,0,1,"C's",3
44,"44064",69,49,49,0,0,"C's",4
10,"10026",648,500,492,7,8,"C's",62
50,"50124",415,318,317,2,1,"C's",65
4,"4090",304,238,234,0,4,"C's",20
15,"15085",3332,2280,2247,25,33,"C's",151
26,"26145",246,197,197,2,0,"C's",23
44,"44238",2323,1603,1590,5,13,"C's",160
31,"31220",744,583,579,8,4,"C's",33
40,"40200",40,31,31,0,0,"C's",2
16,"16033",1714,1319,1305,6,14,"C's",114
46,"46132",2150,1803,1784,7,19,"C's",229
34,"34131",59,52,51,0,1,"C's",2
33,"33072",1566,1008,994,11,14,"C's",85
48,"48014",1211,806,801,7,5,"C's",27
16,"16904",472,378,373,4,5,"C's",51
31,"31186",299,195,194,3,1,"C's",8
12,"12081",608,486,480,5,6,"C's",49
4,"4027",250,159,159,0,0,"C's",19
37,"37069",968,695,689,7,6,"C's",111
5,"5128",354,281,271,2,10,"C's",28
31,"31187",111,68,63,1,5,"C's",0
50,"50251",8262,5946,5872,44,74,"C's",891
22,"22107",112,74,74,0,0,"C's",7
40,"40075",160,139,139,0,0,"C's",26
6,"6138",1047,727,715,5,12,"C's",49
1,"1055",838,538,527,8,11,"C's",13
31,"31055",257,175,172,2,3,"C's",0
18,"18037",535,402,396,2,6,"C's",59
19,"19277",19,13,13,0,0,"C's",1
31,"31222",62,36,34,3,2,"C's",0
37,"37160",615,434,429,8,5,"C's",32
50,"50252",5138,3642,3611,24,31,"C's",477
47,"47057",268,197,196,0,1,"C's",25
9,"9166",97,81,81,0,0,"C's",10
5,"5129",125,88,87,2,1,"C's",3
48,"48016",5271,3694,3674,24,20,"C's",167
37,"37285",403,310,308,2,2,"C's",23
41,"41070",6032,4312,4258,44,54,"C's",807
36,"36061",8606,6232,6133,41,99,"C's",490
9,"9063",209,168,167,2,1,"C's",24
45,"45077",556,428,427,1,1,"C's",57
47,"47193",1577,1251,1241,7,10,"C's",219
16,"16908",186,152,152,1,0,"C's",1
19,"19204",148,120,120,0,0,"C's",16
37,"37162",204,152,151,0,1,"C's",11
44,"44241",533,396,389,0,7,"C's",59
10,"10124",852,665,655,2,10,"C's",30
44,"44142",35,27,27,0,0,"C's",3
50,"50064",437,342,339,0,3,"C's",33
9,"9281",145,114,109,1,5,"C's",21
16,"16161",57,48,46,0,2,"C's",6
44,"44176",158,115,114,0,1,"C's",5
44,"44003",19,17,17,0,0,"C's",2
37,"37372",144,111,108,0,3,"C's",8
24,"24154",1005,673,666,4,7,"C's",86
10,"10216",1538,1175,1162,4,13,"C's",73
47,"47221",111,94,94,0,0,"C's",5
4,"4064",2771,2001,1988,13,13,"C's",259
49,"49034",432,327,325,2,2,"C's",30
38,"38028",22103,15036,14844,85,192,"C's",1371
50,"50065",53,43,43,0,0,"C's",4
23,"23011",2170,1515,1496,7,19,"C's",127
34,"34185",63,38,37,2,1,"C's",4
10,"10081",182,142,135,2,7,"C's",7
9,"9197",144,111,109,1,2,"C's",9
16,"16087",208,179,177,5,2,"C's",7
41,"41040",10541,7752,7698,68,54,"C's",1495
22,"22112",9566,6354,6305,56,49,"C's",1091
5,"5134",48,38,38,0,0,"C's",1
15,"15092",6438,3976,3903,28,73,"C's",225
31,"31025",766,524,518,6,6,"C's",10
37,"37289",232,167,166,3,1,"C's",20
9,"9077",34,27,27,0,0,"C's",6
11,"11029",5430,3039,3000,44,39,"C's",178
31,"31226",591,342,340,2,2,"C's",7
49,"49119",227,169,168,0,1,"C's",16
14,"14061",744,595,582,1,13,"C's",22
29,"29080",6676,4469,4419,35,50,"C's",608
31,"31181",145,112,112,0,0,"C's",1
30,"30029",11864,8125,8058,73,67,"C's",1016
9,"9306",106,82,82,1,0,"C's",12
44,"44212",39,37,37,1,0,"C's",9
22,"22243",45,28,28,0,0,"C's",4
46,"46059",1261,1035,1019,9,16,"C's",71
22,"22113",495,370,368,4,2,"C's",63
37,"37166",214,152,151,2,1,"C's",15
18,"18136",1851,1354,1337,5,17,"C's",76
4,"4097",248,189,189,1,0,"C's",11
9,"9216",387,270,265,1,5,"C's",25
5,"5185",95,82,81,0,1,"C's",17
37,"37167",173,143,140,2,3,"C's",16
3,"3022",145,125,125,0,0,"C's",10
31,"31228",486,341,337,2,4,"C's",34
28,"28025",420,320,315,4,5,"C's",25
42,"42071",171,115,115,3,0,"C's",4
48,"48082",37605,25134,24938,176,196,"C's",720
22,"22039",863,671,667,4,4,"C's",75
14,"14006",1330,1120,1101,8,19,"C's",110
44,"44075",323,248,246,0,2,"C's",32
40,"40210",106,74,71,0,3,"C's",9
37,"37168",439,316,311,0,5,"C's",25
16,"16245",419,327,323,7,4,"C's",39
48,"48083",6958,4885,4856,40,29,"C's",79
42,"42195",101,62,62,0,0,"C's",5
19,"19053",2008,1422,1404,10,18,"C's",126
48,"48022",2336,1444,1433,6,11,"C's",17
16,"16246",482,361,355,3,6,"C's",11
6,"6012",3267,2300,2277,15,23,"C's",184
6,"6149",10295,7651,7536,56,115,"C's",764
9,"9083",37,33,33,0,0,"C's",2
26,"26049",172,125,122,1,3,"C's",19
13,"13063",3706,2539,2514,33,25,"C's",241
47,"47010",13729,10549,10454,81,95,"C's",2593
39,"39074",6902,5113,5039,40,74,"C's",775
10,"10117",255,135,134,0,1,"C's",6
47,"47163",290,230,228,3,2,"C's",27
15,"15022",5785,3811,3771,33,40,"C's",235
31,"31196",38,35,35,1,0,"C's",2
9,"9084",186,136,135,4,1,"C's",12
45,"45185",7700,5771,5691,20,80,"C's",715
22,"22116",1430,1004,994,5,10,"C's",152
50,"50259",88,67,66,0,1,"C's",10
4,"4100",8768,5390,5353,32,37,"C's",845
44,"44009",809,596,593,7,3,"C's",83
14,"14065",1850,1384,1377,16,7,"C's",167
3,"3055",5164,3695,3647,21,48,"C's",545
12,"12091",177,113,112,0,1,"C's",14
6,"6015",116758,77960,77205,583,755,"C's",11054
18,"18185",541,434,432,2,2,"C's",48
27,"27902",7205,4829,4754,53,75,"C's",358
42,"42213",27,21,21,1,0,"C's",2
11,"11002",4273,2835,2815,16,20,"C's",86
50,"50260",33,33,32,0,1,"C's",3
10,"10135",1302,981,969,3,12,"C's",44
4,"4006",7022,4792,4749,30,43,"C's",665
46,"46063",1756,1367,1345,15,22,"C's",152
19,"19286",720,547,543,2,4,"C's",110
14,"14037",3318,2374,2320,22,54,"C's",192
47,"47012",113,93,93,0,0,"C's",10
49,"49087",521,322,318,0,4,"C's",26
14,"14010",4027,2850,2807,19,43,"C's",238
49,"49126",235,155,154,2,1,"C's",12
37,"37341",53,39,39,0,0,"C's",5
18,"18144",781,567,558,4,9,"C's",87
37,"37038",788,595,583,4,12,"C's",75
42,"42035",769,527,516,2,11,"C's",41
16,"16005",255,180,178,2,2,"C's",12
28,"28094",865,624,622,4,2,"C's",104
50,"50262",1170,896,887,15,9,"C's",96
40,"40215",84,60,60,0,0,"C's",8
16,"16145",450,363,361,5,2,"C's",28
46,"46220",48410,34644,34292,279,352,"C's",4736
26,"26053",208,168,163,4,5,"C's",13
6,"6018",753,535,529,3,6,"C's",19
16,"16251",1849,1381,1366,7,15,"C's",150
31,"31233",97,74,74,0,0,"C's",12
50,"50170",371,283,280,0,3,"C's",31
12,"12026",881,678,663,13,15,"C's",81
4,"4008",505,423,417,5,6,"C's",23
19,"19278",28,26,26,0,0,"C's",1
37,"37300",566,398,395,0,3,"C's",59
34,"34102",205,169,168,1,1,"C's",20
14,"14067",3889,2946,2899,29,47,"C's",330
18,"18146",965,703,685,9,18,"C's",85
19,"19289",28,25,24,1,1,"C's",2
31,"31034",37,25,25,0,0,"C's",0
47,"47014",51,45,45,0,0,"C's",7
34,"34904",315,234,230,2,4,"C's",19
18,"18011",4335,3037,3015,20,22,"C's",384
26,"26043",365,292,281,1,11,"C's",30
23,"23050",90992,64810,64218,485,592,"C's",8458
9,"9315",378,245,243,1,2,"C's",54
28,"28157",609,433,430,1,3,"C's",60
5,"5100",278,227,223,1,4,"C's",28
9,"9446",12,7,7,0,0,"C's",1
6,"6157",443,321,316,1,5,"C's",9
29,"29089",3228,2377,2321,10,56,"C's",101
16,"16008",89,69,69,0,0,"C's",1
38,"38003",1439,969,952,10,17,"C's",51
44,"44221",372,303,300,1,3,"C's",31
37,"37177",289,220,219,2,1,"C's",24
22,"22009",617,444,441,6,3,"C's",52
18,"18148",817,637,634,5,3,"C's",57
31,"31069",832,637,635,3,2,"C's",26
35,"35027",10344,7310,7216,50,94,"C's",856
24,"24222",14256,9996,9884,101,112,"C's",1818
9,"9136",192,142,137,2,5,"C's",14
37,"37304",169,124,124,0,0,"C's",9
2,"2045",3665,2895,2855,21,40,"C's",294
6,"6159",2329,1351,1318,16,33,"C's",119
44,"44258",67,47,47,0,0,"C's",3
9,"9227",119,91,89,4,2,"C's",10
46,"46067",1753,1418,1393,1,25,"C's",204
31,"31136",447,299,298,2,1,"C's",9
37,"37044",466,362,360,2,2,"C's",66
40,"40221",49,39,39,0,0,"C's",14
24,"24098",1193,842,831,11,11,"C's",105
39,"39081",437,337,332,4,5,"C's",28
38,"38005",5468,3425,3392,18,33,"C's",308
6,"6115",1261,841,832,5,9,"C's",65
21,"21051",239,174,170,1,4,"C's",20
18,"18103",757,579,575,4,4,"C's",56
9,"9318",61,41,41,0,0,"C's",3
20,"20064",12503,7803,7755,52,48,"C's",205
6,"6161",302,236,235,1,1,"C's",11
30,"30019",25857,17544,17374,125,170,"C's",1953
48,"48031",332,233,231,1,2,"C's",2
3,"3001",337,269,268,0,1,"C's",25
10,"10144",975,746,735,3,11,"C's",79
19,"19110",56,50,50,0,0,"C's",5
22,"22084",535,403,399,4,4,"C's",44
49,"49257",291,190,184,1,6,"C's",21
47,"47017",201,158,153,1,5,"C's",13
34,"34157",2442,1792,1768,21,24,"C's",202
49,"49095",291,221,220,0,1,"C's",30
18,"18903",889,669,661,5,8,"C's",59
49,"49219",7464,4988,4914,53,74,"C's",586
4,"4077",295,263,261,2,2,"C's",15
19,"19024",8196,5613,5563,28,50,"C's",1199
44,"44049",849,616,604,9,12,"C's",69
5,"5155",52,44,44,0,0,"C's",10
20,"20066",454,236,234,1,2,"C's",0
2,"2049",823,573,564,1,9,"C's",43
16,"16265",20,19,19,0,0,"C's",0
18,"18138",2486,1620,1606,13,14,"C's",98
42,"42045",301,206,197,2,9,"C's",18
10,"10009",266,201,194,0,7,"C's",5
3,"3033",117,96,95,0,1,"C's",12
6,"6073",733,496,484,8,12,"C's",19
44,"44019",67,50,49,0,1,"C's",11
2,"2010",1789,1437,1421,11,16,"C's",141
44,"44158",1180,876,862,10,14,"C's",138
31,"31140",117,84,84,1,0,"C's",3
16,"16154",4871,3547,3509,24,38,"C's",342
19,"19297",32,24,24,1,0,"C's",2
18,"18153",8597,6024,5972,40,52,"C's",880
2,"2078",920,675,664,1,11,"C's",50
6,"6903",2021,1377,1360,12,17,"C's",121
24,"24068",457,344,340,0,4,"C's",26
38,"38046",9113,6850,6775,40,75,"C's",827
2,"2011",632,520,516,1,4,"C's",19
9,"9231",69,38,38,1,0,"C's",6
19,"19153",22,17,17,0,0,"C's",0
41,"41056",3687,2841,2812,30,29,"C's",239
50,"50081",511,382,378,4,4,"C's",26
49,"49260",755,590,586,8,4,"C's",48
10,"10149",421,283,280,1,3,"C's",22
14,"14074",2299,1896,1866,16,30,"C's",143
34,"34161",23,16,16,0,0,"C's",2
2,"2052",459,372,369,4,3,"C's",28
26,"26062",89,72,71,2,1,"C's",8
46,"46019",8849,7072,7004,33,68,"C's",655
6,"6122",6634,4427,4321,26,106,"C's",505
34,"34218",461,343,339,2,4,"C's",37
24,"24069",41,35,35,0,0,"C's",1
16,"16209",116,101,101,2,0,"C's",5
31,"31142",1403,958,949,10,9,"C's",37
5,"5160",323,256,253,2,3,"C's",12
18,"18021",17485,11800,11669,95,131,"C's",2063
9,"9456",130,97,96,0,1,"C's",7
26,"26134",82,68,68,2,0,"C's",2
12,"12071",1274,992,979,3,13,"C's",99
22,"22133",115,81,80,1,1,"C's",13
45,"45064",3858,2804,2763,20,41,"C's",402
37,"37313",550,386,384,2,2,"C's",36
5,"5161",579,459,447,3,12,"C's",40
19,"19034",22,16,16,0,0,"C's",2
12,"12003",976,746,736,6,10,"C's",92
10,"10106",130,109,108,2,1,"C's",7
46,"46262",223,162,159,2,3,"C's",23
9,"9104",53,42,42,0,0,"C's",3
49,"49019",243,188,182,2,6,"C's",32
47,"47183",130,106,105,0,1,"C's",12
12,"12103",91,69,67,0,2,"C's",5
37,"37187",572,427,423,1,4,"C's",48
29,"29098",1253,917,895,9,22,"C's",83
12,"12004",4170,3125,3088,19,37,"C's",415
6,"6125",1743,1285,1269,7,16,"C's",106
3,"3099",42319,31083,30801,165,282,"C's",4041
2,"2042",837,618,611,1,7,"C's",50
24,"24105",1459,1042,1025,16,17,"C's",186
21,"21061",5084,3223,3177,28,46,"C's",253
18,"18115",2553,1800,1781,17,19,"C's",189
9,"9238",921,573,561,4,12,"C's",59
13,"13088",610,458,453,6,5,"C's",40
31,"31245",81,55,55,2,0,"C's",1
2,"2016",569,413,410,6,3,"C's",30
45,"45100",188,150,150,0,0,"C's",5
3,"3068",47,44,44,0,0,"C's",5
46,"46074",2696,2069,2038,14,31,"C's",351
9,"9012",89,64,63,0,1,"C's",7
24,"24040",449,329,325,2,4,"C's",39
5,"5164",26,14,14,0,0,"C's",0
20,"20072",4728,2902,2886,21,16,"C's",108
14,"14050",2391,1822,1787,14,35,"C's",142
16,"16023",469,335,335,2,0,"C's",48
24,"24211",272,205,205,2,0,"C's",27
9,"9064",324,271,267,1,4,"C's",80
7,"7007",421,296,293,2,3,"C's",41
15,"15004",4834,3436,3391,30,45,"C's",267
19,"19303",43,35,35,0,0,"C's",0
47,"47103",267,197,192,5,5,"C's",16
42,"42096",272,171,170,6,1,"C's",12
9,"9378",31,24,23,0,1,"C's",7
24,"24009",322,153,152,2,1,"C's",15
44,"44165",175,135,133,2,2,"C's",11
1,"1004",1399,1008,995,8,13,"C's",25
15,"15005",24516,15761,15537,213,224,"C's",1669
49,"49143",225,163,162,0,1,"C's",9
45,"45001",1835,1281,1251,3,30,"C's",155
40,"40193",229,174,172,3,2,"C's",36
37,"37150",41,34,34,0,0,"C's",0
4,"4085",387,304,301,2,3,"C's",19
6,"6038",805,543,541,2,2,"C's",33
6,"6130",195,164,158,0,6,"C's",11
10,"10158",330,269,267,0,2,"C's",8
5,"5120",36,26,26,0,0,"C's",5
5,"5168",3560,2589,2561,19,28,"C's",401
37,"37361",86,66,66,0,0,"C's",6
10,"10066",160,122,122,0,0,"C's",2
12,"12008",222,193,192,1,1,"C's",7
39,"39031",1236,878,868,4,10,"C's",150
36,"36005",8121,5480,5400,52,80,"C's",417
49,"49268",403,313,309,1,4,"C's",31
20,"20009",11452,7388,7345,62,43,"C's",230
42,"42056",23,20,20,0,0,"C's",2
49,"49146",295,216,213,3,3,"C's",9
9,"9112",109,85,85,0,0,"C's",12
18,"18072",667,424,420,0,4,"C's",55
15,"15007",3303,2262,2246,15,16,"C's",122
49,"49269",229,165,162,1,3,"C's",16
34,"34174",200,159,154,5,5,"C's",10
46,"46077",7496,5909,5827,45,82,"C's",500
19,"19307",27,23,23,0,0,"C's",1
38,"38019",13200,8123,8047,36,76,"C's",633
10,"10115",3544,2705,2647,11,58,"C's",294
13,"13044",2671,1960,1936,13,24,"C's",183
18,"18121",129,98,98,1,0,"C's",15
47,"47216",115,91,87,0,4,"C's",11
40,"40904",357,308,306,3,2,"C's",55
28,"28080",48554,38885,38691,164,194,"C's",8289
37,"37195",46,36,36,1,0,"C's",3
19,"19198",14,12,12,0,0,"C's",1
47,"47027",2745,2036,2018,9,18,"C's",370
19,"19308",56,53,53,0,0,"C's",2
18,"18032",246,175,174,2,1,"C's",26
9,"9201",28,18,18,1,0,"C's",1
3,"3074",1707,1397,1389,4,8,"C's",298
40,"40906",2003,1569,1550,12,19,"C's",318
21,"21068",998,605,592,11,13,"C's",29
24,"24014",7425,5124,5053,32,71,"C's",484
49,"49149",390,273,268,3,5,"C's",23
49,"49027",140,112,108,1,4,"C's",14
39,"39003",297,220,215,0,5,"C's",14
34,"34160",139,115,114,3,1,"C's",11
44,"44171",178,126,124,2,2,"C's",10
47,"47081",45,36,35,1,1,"C's",3
18,"18171",2120,1572,1551,9,21,"C's",106
42,"42059",21,15,14,0,1,"C's",5
46,"46001",795,601,592,3,9,"C's",35
9,"9340",77,49,49,0,0,"C's",3
24,"24081",140,98,92,0,6,"C's",5
49,"49112",126,75,75,0,0,"C's",5
36,"36009",4503,3056,3001,15,55,"C's",227
34,"34178",117,103,103,0,0,"C's",9
22,"22149",305,228,228,0,0,"C's",24
30,"30002",9903,7011,6943,28,68,"C's",769
39,"39095",2266,1760,1726,14,34,"C's",193
15,"15011",15432,10395,10248,74,147,"C's",1103
29,"29050",421,306,302,3,4,"C's",49
22,"22027",329,221,218,0,3,"C's",33
45,"45007",696,534,522,3,12,"C's",30
47,"47190",98,80,80,1,0,"C's",13
19,"19088",79,61,61,0,0,"C's",6
49,"49030",86,69,69,0,0,"C's",5
24,"24082",858,629,614,8,15,"C's",59
3,"3140",26070,18999,18742,174,257,"C's",3206
6,"6047",849,639,628,2,11,"C's",41
29,"29073",1579,1091,1080,7,11,"C's",93
10,"10166",308,206,204,0,2,"C's",5
16,"16126",770,634,624,3,10,"C's",40
18,"18035",1232,992,988,6,4,"C's",85
20,"20080",7910,5294,5260,49,34,"C's",161
46,"46081",10134,7771,7702,41,69,"C's",1026
49,"49275",52210,36205,35754,356,451,"C's",4973
37,"37200",187,136,136,0,0,"C's",10
41,"41036",3941,2674,2642,23,32,"C's",153
44,"44001",68,53,52,1,1,"C's",7
31,"31255",102,79,79,1,0,"C's",2
3,"3077",1371,1071,1060,13,11,"C's",148
50,"50093",92,66,66,1,0,"C's",6
24,"24017",577,426,418,1,8,"C's",30
12,"12082",9617,7324,7231,46,93,"C's",1012
13,"13052",6422,4651,4580,46,71,"C's",429
24,"24018",174,143,141,0,2,"C's",7
50,"50001",100,77,77,0,0,"C's",4
33,"33013",446,321,318,3,3,"C's",17
19,"19203",30,24,24,0,0,"C's",3
50,"50283",70,57,57,1,0,"C's",2
46,"46238",13282,9786,9721,61,65,"C's",1071
5,"5033",176,144,142,1,2,"C's",12
6,"6004",1600,1212,1207,2,5,"C's",70
47,"47005",549,413,408,2,5,"C's",48
40,"40077",842,632,619,3,13,"C's",144
16,"16176",38,30,30,0,0,"C's",5
34,"34045",76,66,66,2,0,"C's",3
45,"45010",415,311,310,2,1,"C's",13
47,"47113",159,129,128,0,1,"C's",9
31,"31256",107,59,59,0,0,"C's",1
10,"10017",825,620,611,3,9,"C's",29
41,"41094",6288,4497,4449,38,48,"C's",552
18,"18133",2168,1648,1636,6,12,"C's",95
31,"31224",893,671,662,3,9,"C's",23
9,"9348",148,111,110,2,1,"C's",4
37,"37287",310,213,210,2,3,"C's",31
10,"10125",888,635,622,4,13,"C's",27
16,"16910",91,69,69,1,0,"C's",4
4,"4094",207,144,144,0,0,"C's",11
23,"23010",14347,9669,9560,86,109,"C's",1108
6,"6052",4030,2735,2688,20,47,"C's",264
31,"31157",3518,2298,2267,23,31,"C's",167
30,"30007",6411,4360,4329,24,31,"C's",581
14,"14003",1248,939,930,2,9,"C's",97
49,"49118",203,161,160,1,1,"C's",18
31,"31158",255,180,179,3,1,"C's",8
27,"27058",3495,2510,2480,30,30,"C's",105
37,"37164",256,191,189,5,2,"C's",24
44,"44177",115,84,84,1,0,"C's",9
19,"19209",40,29,29,1,0,"C's",4
6,"6053",602,454,444,3,10,"C's",36
14,"14004",2034,1531,1518,14,13,"C's",150
12,"12017",161,130,128,0,2,"C's",12
9,"9394",715,533,521,3,12,"C's",56
31,"31059",186,131,131,1,0,"C's",4
48,"48050",191,147,146,0,1,"C's",0
37,"37206",94,73,73,3,0,"C's",12
42,"42116",45,39,38,3,1,"C's",2
45,"45113",1915,1390,1366,6,24,"C's",103
37,"37334",76,48,48,1,0,"C's",2
26,"26013",347,249,246,2,3,"C's",30
7,"7024",6843,3657,3612,38,45,"C's",418
26,"26080",472,391,389,0,2,"C's",49
46,"46137",270,210,207,4,3,"C's",12
19,"19210",21,19,18,1,1,"C's",0
37,"37207",287,195,193,1,2,"C's",54
9,"9125",584,432,430,1,2,"C's",41
5,"5038",115,83,81,0,2,"C's",5
14,"14005",6311,4143,4084,72,59,"C's",376
40,"40126",79,56,54,0,2,"C's",3
19,"19322",31,25,25,0,0,"C's",1
48,"48051",213,163,163,0,0,"C's",3
16,"16187",74,55,55,1,0,"C's",4
6,"6056",479,407,399,1,8,"C's",17
24,"24225",1014,752,739,10,13,"C's",92
4,"4034",160,99,99,2,0,"C's",10
27,"27009",2097,1533,1507,12,26,"C's",70
1,"1021",473,310,309,0,1,"C's",10
39,"39072",344,198,196,2,2,"C's",15
19,"19283",30,25,25,0,0,"C's",0
49,"49002",63,51,49,0,2,"C's",8
27,"27010",4327,2899,2837,53,62,"C's",183
9,"9044",46,35,34,1,1,"C's",5
9,"9082",39,36,36,0,0,"C's",1
49,"49244",43,29,29,0,0,"C's",1
44,"44180",70,61,61,0,0,"C's",8
24,"24226",199,139,137,0,2,"C's",7
23,"23016",387,321,320,0,1,"C's",14
37,"37337",139,124,124,0,0,"C's",14
34,"34192",90,75,72,0,3,"C's",4
46,"46087",120,98,97,0,1,"C's",5
45,"45016",4204,3146,3105,22,41,"C's",505
28,"28122",513,375,370,2,5,"C's",55
19,"19213",70,62,61,2,1,"C's",7
33,"33020",13307,9011,8914,99,97,"C's",938
15,"15021",5127,3587,3543,38,44,"C's",336
16,"16030",24,19,19,0,0,"C's",0
35,"35023",11686,8212,8076,55,136,"C's",823
9,"9905",384,279,279,2,0,"C's",33
16,"16002",187,158,158,1,0,"C's",19
16,"16045",222,172,171,1,1,"C's",5
9,"9261",469,332,329,2,3,"C's",55
49,"49163",219,158,154,5,4,"C's",19
7,"7028",899,601,595,7,6,"C's",60
28,"28055",916,693,687,5,6,"C's",73
40,"40003",139,107,104,0,3,"C's",7
44,"44182",197,157,157,0,0,"C's",22
22,"22042",117,95,92,0,3,"C's",7
15,"15023",6419,4348,4261,36,87,"C's",349
22,"22164",35,28,28,0,0,"C's",4
1,"1027",416,257,254,3,3,"C's",14
18,"18048",2387,1683,1662,8,21,"C's",239
41,"41101",5928,4209,4173,18,36,"C's",303
6,"6152",1319,945,932,4,13,"C's",89
5,"5190",53,42,41,2,1,"C's",9
47,"47038",105,77,77,0,0,"C's",3
7,"7029",4166,2949,2913,37,36,"C's",297
37,"37213",89,74,73,0,1,"C's",5
5,"5191",121,106,105,1,1,"C's",15
39,"39076",3476,2594,2559,19,35,"C's",391
42,"42124",64,49,49,0,0,"C's",3
33,"33022",893,578,567,11,11,"C's",40
41,"41014",2492,1882,1852,11,30,"C's",94
45,"45119",3330,2096,2067,15,29,"C's",276
9,"9907",1420,1058,1041,12,17,"C's",193
22,"22165",487,364,360,6,4,"C's",38
37,"37214",129,93,91,0,2,"C's",19
48,"48026",1140,830,823,5,7,"C's",3
30,"30014",1567,1174,1160,8,14,"C's",72
16,"16193",66,49,48,0,1,"C's",2
2,"2081",18342,13244,13075,80,169,"C's",1664
46,"46090",1637,1391,1367,3,24,"C's",140
37,"37087",862,639,635,2,4,"C's",164
5,"5047",4163,3198,3142,17,56,"C's",410
37,"37174",1056,820,812,3,8,"C's",93
42,"42125",70,59,59,1,0,"C's",6
19,"19181",56,42,42,0,0,"C's",1
34,"34903",198,131,131,1,0,"C's",5
27,"27018",3467,2086,2059,20,27,"C's",109
4,"4102",13694,8944,8865,50,79,"C's",1098
5,"5048",118,104,104,0,0,"C's",7
16,"16050",245,201,195,1,6,"C's",13
37,"37216",302,252,248,3,4,"C's",37
22,"22045",82,65,64,1,1,"C's",8
18,"18051",1147,817,810,8,7,"C's",65
10,"10184",756,613,604,10,9,"C's",31
36,"36025",2257,1360,1350,10,10,"C's",126
31,"31902",4405,3092,3061,25,31,"C's",328
45,"45021",2500,1708,1665,12,43,"C's",236
34,"34058",189,172,172,2,0,"C's",10
47,"47204",256,204,198,0,6,"C's",17
14,"14002",10951,7706,7620,83,86,"C's",667
26,"26054",320,263,260,4,3,"C's",15
26,"26162",121,99,99,1,0,"C's",12
9,"9091",724,500,490,4,10,"C's",57
28,"28096",18354,13310,13205,68,105,"C's",2777
47,"47176",219,139,139,1,0,"C's",10
10,"10186",977,795,778,1,17,"C's",42
24,"24130",438,323,321,4,2,"C's",51
46,"46092",276,192,189,0,3,"C's",11
7,"7034",1008,743,734,7,9,"C's",75
22,"22046",728,566,561,5,5,"C's",56
50,"50013",219,180,180,0,0,"C's",9
26,"26091",161,146,146,0,0,"C's",9
28,"28128",444,315,314,0,1,"C's",42
19,"19332",92,71,69,1,2,"C's",8
5,"5151",91,71,71,1,0,"C's",8
21,"21009",857,532,523,4,9,"C's",41
3,"3030",524,448,440,5,8,"C's",49
23,"23026",3586,2620,2585,16,35,"C's",165
22,"22172",556,372,370,6,2,"C's",61
10,"10050",1053,846,837,6,9,"C's",35
42,"42001",278,212,210,3,2,"C's",23
12,"12029",702,557,555,4,2,"C's",45
46,"46093",2118,1647,1624,4,23,"C's",136
46,"46249",9288,6746,6676,56,70,"C's",967
31,"31905",2843,1983,1966,15,17,"C's",145
19,"19333",115,82,82,0,0,"C's",5
9,"9270",163,115,115,0,0,"C's",22
45,"45024",1062,793,785,4,8,"C's",47
50,"50015",96,67,67,0,0,"C's",9
6,"6024",1172,905,883,4,22,"C's",52
19,"19064",70,64,64,2,0,"C's",6
34,"34211",178,155,152,1,3,"C's",16
22,"22173",232,152,152,3,0,"C's",13
7,"7037",3197,1934,1917,26,17,"C's",247
22,"22048",12598,8790,8731,91,59,"C's",1445
19,"19222",110,82,82,0,0,"C's",11
2,"2047",117,88,88,2,0,"C's",2
49,"49132",316,235,232,1,3,"C's",22
15,"15032",3444,2322,2269,30,53,"C's",158
9,"9321",1626,1238,1227,8,11,"C's",175
2,"2048",1226,981,975,7,6,"C's",61
5,"5055",568,456,451,4,5,"C's",31
37,"37348",115,96,95,0,1,"C's",9
39,"39021",487,381,376,2,5,"C's",20
48,"48062",302,237,236,4,1,"C's",3
6,"6117",1424,960,938,4,22,"C's",103
46,"46147",16835,11920,11791,61,129,"C's",1525
10,"10053",287,215,210,1,5,"C's",13
13,"13078",9041,6325,6266,47,59,"C's",715
37,"37224",206,183,175,3,8,"C's",23
24,"24133",356,257,257,1,0,"C's",22
5,"5056",96,76,76,0,0,"C's",8
24,"24033",205,158,157,0,1,"C's",6
9,"9274",1079,848,835,12,13,"C's",78
5,"5057",2465,1969,1953,15,16,"C's",160
5,"5002",1963,1422,1390,3,32,"C's",174
33,"33029",350,181,174,2,7,"C's",11
16,"16153",949,778,772,7,6,"C's",57
50,"50144",34,29,29,2,0,"C's",6
22,"22176",173,134,130,1,4,"C's",21
33,"33030",895,669,666,9,3,"C's",57
12,"12130",404,340,335,0,5,"C's",23
31,"31073",294,212,208,2,4,"C's",9
24,"24134",3416,2470,2417,19,53,"C's",243
49,"49055",102,82,82,2,0,"C's",9
1,"1037",587,411,408,1,3,"C's",8
19,"19224",93,87,87,0,0,"C's",5
24,"24036",288,184,184,2,0,"C's",16
48,"48064",606,447,445,4,2,"C's",2
45,"45095",689,513,505,0,8,"C's",48
9,"9372",212,176,176,4,0,"C's",28
44,"44125",61,44,44,0,0,"C's",9
11,"11012",99886,70290,69673,693,617,"C's",8541
2,"2051",1676,1177,1162,6,15,"C's",111
3,"3004",581,438,437,2,1,"C's",52
22,"22177",98,75,75,0,0,"C's",8
12,"12034",1424,1065,1035,3,30,"C's",126
45,"45029",201,171,171,1,0,"C's",20
47,"47128",60,52,51,0,1,"C's",2
10,"10195",7709,5572,5481,37,91,"C's",497
30,"30023",3780,2874,2850,12,24,"C's",399
10,"10012",595,466,459,0,7,"C's",23
42,"42185",26,22,22,0,0,"C's",1
16,"16110",93,70,70,0,0,"C's",7
28,"28106",76907,52773,52265,385,508,"C's",9268
47,"47156",162,136,133,0,3,"C's",11
28,"28009",14086,10611,10545,57,66,"C's",2221
18,"18907",1843,1393,1388,4,5,"C's",100
45,"45130",317,253,250,1,3,"C's",26
42,"42010",19,14,14,1,0,"C's",0
50,"50020",809,564,559,2,5,"C's",78
10,"10151",207,165,162,0,3,"C's",7
37,"37354",5240,3823,3771,39,52,"C's",792
48,"48066",348,258,258,1,0,"C's",0
49,"49177",278,179,177,1,2,"C's",13
46,"46150",1831,1341,1333,7,8,"C's",105
10,"10014",1852,1370,1346,6,24,"C's",79
16,"16272",221,176,175,0,1,"C's",13
1,"1001",1979,1339,1318,7,21,"C's",62
48,"48036",24073,16076,15971,86,105,"C's",450
44,"44229",152,112,111,3,1,"C's",15
11,"11014",16858,10366,10245,153,121,"C's",1527
12,"12037",17,16,14,0,2,"C's",1
27,"27035",187,122,121,1,1,"C's",10
50,"50211",249,176,173,0,3,"C's",22
18,"18908",801,593,588,3,5,"C's",69
37,"37231",250,196,193,4,3,"C's",27
15,"15039",1263,889,875,7,14,"C's",66
48,"48067",1158,813,810,2,3,"C's",7
9,"9148",87,70,68,3,2,"C's",8
44,"44267",70,57,56,0,1,"C's",6
22,"22019",180,151,150,2,1,"C's",25
9,"9377",632,485,480,1,5,"C's",99
44,"44055",69,56,56,4,0,"C's",7
45,"45066",7570,5550,5484,25,66,"C's",675
50,"50150",649,402,397,2,5,"C's",42
22,"22094",101,74,74,1,0,"C's",10
42,"42094",621,444,433,10,11,"C's",68
10,"10200",392,306,302,1,4,"C's",10
37,"37233",61,48,47,1,1,"C's",2
50,"50118",2165,1552,1540,10,12,"C's",148
19,"19117",1579,1135,1123,8,12,"C's",188
48,"48038",1126,798,794,3,4,"C's",9
32,"32008",8256,5542,5490,39,52,"C's",607
40,"40021",27,27,26,0,1,"C's",1
47,"47131",170,134,128,2,6,"C's",6
15,"15003",1803,1227,1210,9,17,"C's",69
37,"37190",215,171,171,1,0,"C's",9
24,"24008",9282,6685,6603,52,82,"C's",822
12,"12005",8062,5829,5754,64,75,"C's",832
44,"44199",44,41,41,2,0,"C's",7
21,"21022",171,107,105,0,2,"C's",7
24,"24041",538,367,366,3,1,"C's",25
22,"22058",194,164,162,1,2,"C's",22
3,"3009",46657,35143,34801,223,342,"C's",5172
16,"16217",74,62,62,0,0,"C's",4
23,"23039",2204,1596,1558,11,38,"C's",114
31,"31080",508,391,385,3,6,"C's",8
47,"47050",3719,2630,2598,26,32,"C's",496
9,"9026",386,301,300,0,1,"C's",52
18,"18912",1473,994,979,3,15,"C's",94
50,"50025",4562,3158,3124,31,34,"C's",493
34,"34171",968,708,703,5,5,"C's",65
47,"47025",120,94,94,1,0,"C's",9
42,"42149",381,277,273,2,4,"C's",36
6,"6084",1093,828,818,8,10,"C's",64
42,"42151",34,26,26,0,0,"C's",8
20,"20008",716,362,361,6,1,"C's",0
26,"26175",51,41,41,0,0,"C's",2
9,"9466",129,97,97,1,0,"C's",5
45,"45002",2564,1681,1665,17,16,"C's",184
5,"5019",44555,33259,32939,277,320,"C's",6617
46,"46024",413,314,313,2,1,"C's",24
37,"37319",114,78,74,0,4,"C's",8
22,"22059",1149,807,800,3,7,"C's",131
3,"3011",7753,5464,5415,27,49,"C's",993
38,"38901",1405,900,887,3,13,"C's",53
37,"37061",225,168,168,1,0,"C's",22
16,"16219",89,71,71,0,0,"C's",4
50,"50215",24,19,19,0,0,"C's",1
47,"47105",183,158,156,0,2,"C's",14
9,"9424",36,29,29,1,0,"C's",1
37,"37237",324,244,240,1,4,"C's",25
34,"34079",1616,1222,1205,5,17,"C's",227
16,"16072",146,104,103,2,1,"C's",5
30,"30030",312993,231648,230185,1207,1463,"C's",39102
1,"1051",3603,2259,2235,17,24,"C's",51
24,"24044",168,119,118,1,1,"C's",8
18,"18074",262,201,200,2,1,"C's",18
47,"47106",50,39,39,0,0,"C's",1
9,"9337",117,92,91,0,1,"C's",13
19,"19234",43,33,33,0,0,"C's",6
4,"4057",1325,894,884,5,10,"C's",113
34,"34228",83,74,74,1,0,"C's",7
6,"6087",2110,1583,1561,8,22,"C's",83
40,"40028",105,91,90,2,1,"C's",11
9,"9425",517,384,378,0,6,"C's",28
28,"28072",5709,4356,4324,22,32,"C's",895
50,"50027",225,178,177,2,1,"C's",19
45,"45038",3356,2376,2350,15,26,"C's",422
24,"24148",1672,1249,1241,23,8,"C's",146
9,"9160",85,64,64,0,0,"C's",6
19,"19086",1473,1123,1111,7,12,"C's",94
16,"16078",41429,30053,29775,235,278,"C's",3600
32,"32015",874,575,573,4,2,"C's",25
32,"32016",790,550,543,2,7,"C's",14
27,"27048",2140,1502,1467,20,35,"C's",77
7,"7054",22334,12814,12708,99,106,"C's",1791
21,"21028",375,277,271,2,6,"C's",45
19,"19123",40,32,31,1,1,"C's",6
5,"5173",60,49,49,0,0,"C's",2
13,"13901",893,665,655,5,10,"C's",55
5,"5125",55,47,47,0,0,"C's",4
39,"39004",1518,1090,1074,4,16,"C's",117
50,"50188",28,25,25,0,0,"C's",1
22,"22025",1071,676,669,18,7,"C's",84
44,"44205",700,460,453,4,7,"C's",50
45,"45140",1087,833,823,3,10,"C's",58
18,"18078",732,570,566,2,4,"C's",28
31,"31086",13188,9713,9642,111,71,"C's",829
47,"47138",241,170,164,1,6,"C's",9
5,"5222",147,127,126,1,1,"C's",15
9,"9295",61,44,44,0,0,"C's",4
15,"15048",4839,3456,3414,36,42,"C's",305
6,"6091",3774,2709,2666,23,43,"C's",156
50,"50901",138,105,105,0,0,"C's",11
37,"37367",201,164,161,0,3,"C's",18
33,"33042",4306,2988,2970,35,18,"C's",407
7,"7056",5026,3410,3375,32,35,"C's",432
46,"46106",1535,1150,1140,10,10,"C's",96
45,"45174",301,237,233,1,4,"C's",12
34,"34039",61,49,47,0,2,"C's",2
39,"39036",969,743,739,2,4,"C's",94
19,"19202",8,6,6,0,0,"C's",0
46,"46107",1900,1516,1504,5,12,"C's",117
28,"28076",398,325,317,1,8,"C's",43
9,"9430",22,18,17,0,1,"C's",3
42,"42023",63,51,51,0,0,"C's",5
5,"5079",68,53,53,0,0,"C's",5
2,"2067",1158,858,847,6,11,"C's",77
1,"1014",371,280,272,4,8,"C's",11
19,"19126",1627,1155,1134,11,21,"C's",237
23,"23047",1629,1258,1250,10,8,"C's",89
36,"36048",5331,3653,3603,22,50,"C's",284
37,"37369",137,95,94,0,1,"C's",6
12,"12114",198,144,144,1,0,"C's",17
39,"39006",1711,1307,1287,10,20,"C's",166
19,"19240",51,44,42,0,2,"C's",0
26,"26009",401,325,321,4,4,"C's",24
49,"49076",321,217,217,2,0,"C's",32
9,"9431",118,98,98,0,0,"C's",9
39,"39037",1987,1516,1503,8,13,"C's",188
37,"37120",99,82,78,0,4,"C's",9
27,"27001",2370,1281,1256,13,25,"C's",57
9,"9251",375,277,274,4,3,"C's",33
18,"18176",250,191,189,2,2,"C's",10
22,"22032",110,76,74,0,2,"C's",10
21,"21034",1188,798,786,8,12,"C's",58
1,"1057",240,201,200,1,1,"C's",6
46,"46030",800,627,614,5,13,"C's",52
16,"16085",138,113,112,0,1,"C's",12
10,"10215",431,311,308,2,3,"C's",23
9,"9432",182,145,138,0,7,"C's",14
7,"7060",2568,1677,1653,16,24,"C's",135
28,"28050",4076,2860,2839,21,21,"C's",619
35,"35018",12552,7609,7547,54,62,"C's",1036
7,"7061",9819,6351,6280,53,71,"C's",723
19,"19130",60145,45531,45085,286,446,"C's",7724
5,"5035",100,84,84,0,0,"C's",6
42,"42161",137,102,101,0,1,"C's",8
24,"24020",456,314,307,4,7,"C's",59
15,"15053",7729,5089,5043,49,46,"C's",256
20,"20018",11064,6719,6690,41,29,"C's",71
40,"40164",177,139,138,0,1,"C's",7
3,"3019",15269,11520,11398,72,122,"C's",1688
14,"14031",593,469,459,3,10,"C's",29
7,"7021",230,177,174,2,3,"C's",23
10,"10218",1126,803,795,3,8,"C's",44
37,"37332",68,51,50,0,1,"C's",7
22,"22036",92,77,77,0,0,"C's",13
29,"29056",1098,757,750,5,7,"C's",90
7,"7062",7513,4273,4219,52,54,"C's",531
46,"46110",21228,15563,15443,86,120,"C's",2308
23,"23051",2758,2171,2144,9,27,"C's",143
33,"33047",1107,852,843,9,9,"C's",70
34,"34238",330,268,266,3,2,"C's",27
3,"3113",4243,3091,3046,10,45,"C's",366
42,"42163",50,41,40,0,1,"C's",3
23,"23052",1125,936,922,4,14,"C's",38
40,"40165",77,65,64,1,1,"C's",4
45,"45146",107,84,83,0,1,"C's",1
22,"22072",191,136,135,0,1,"C's",14
50,"50194",88,63,63,1,0,"C's",5
5,"5086",80,67,67,2,0,"C's",2
22,"22037",115,86,86,0,0,"C's",9
50,"50098",174,130,124,0,6,"C's",14
14,"14033",1283,971,959,9,12,"C's",120
34,"34240",89,64,64,0,0,"C's",4
19,"19245",1155,855,835,5,20,"C's",86
44,"44006",248,185,183,2,2,"C's",13
29,"29057",357,241,238,1,3,"C's",15
21,"21039",311,225,223,1,2,"C's",14
13,"13008",438,299,295,0,4,"C's",23
27,"27061",1027,753,732,6,21,"C's",25
37,"37375",700,578,570,4,8,"C's",82
34,"34093",85,70,70,0,0,"C's",7
49,"49201",302,270,268,3,2,"C's",21
46,"46112",536,455,450,2,5,"C's",33
3,"3115",255,222,220,2,2,"C's",9
21,"21040",3170,2129,2071,20,58,"C's",210
46,"46190",48947,35638,35419,211,219,"C's",6421
24,"24121",645,492,487,1,5,"C's",34
20,"20906",119,87,87,1,0,"C's",1
4,"4098",1516,1115,1106,11,9,"C's",145
28,"28026",6317,4734,4701,33,33,"C's",890
33,"33049",6322,4116,4062,43,54,"C's",435
5,"5235",124,111,110,0,1,"C's",13
10,"10903",826,578,569,3,9,"C's",55
5,"5089",485,384,376,0,8,"C's",54
40,"40043",1802,1400,1381,8,19,"C's",179
42,"42032",146,118,118,0,0,"C's",4
16,"16093",60,49,47,0,2,"C's",0
46,"46191",1937,1530,1505,5,25,"C's",118
46,"46113",2457,1804,1782,6,22,"C's",251
20,"20022",839,473,472,4,1,"C's",2
9,"9440",91,78,78,2,0,"C's",12
34,"34243",325,252,248,0,4,"C's",15
15,"15059",10362,7258,7106,91,152,"C's",576
9,"9219",27509,19084,18859,146,225,"C's",2280
18,"18046",1832,1160,1140,6,20,"C's",122
39,"39013",511,402,399,4,3,"C's",31
5,"5043",84,66,66,0,0,"C's",8
21,"21042",15350,7643,7530,124,113,"C's",939
29,"29060",692,510,508,1,2,"C's",45
9,"9175",127,94,93,2,1,"C's",5
32,"32032",8059,5708,5608,58,100,"C's",393
5,"5093",408,294,292,1,2,"C's",38
31,"31096",113,82,79,0,3,"C's",1
19,"19015",84,69,68,0,1,"C's",9
47,"47146",255,206,204,1,2,"C's",32
26,"26121",25,22,22,0,0,"C's",1
40,"40045",109,85,85,2,0,"C's",9
10,"10089",1359,882,868,3,14,"C's",91
10,"10180",4134,2643,2601,25,42,"C's",306
40,"40046",89,75,75,1,0,"C's",7
36,"36022",9011,6310,6172,49,138,"C's",446
32,"32033",737,478,476,3,2,"C's",17
18,"18096",341,227,224,3,3,"C's",5
37,"37380",56,47,45,0,2,"C's",10
34,"34099",60,48,48,0,0,"C's",6
28,"28154",5408,3806,3767,16,39,"C's",669
34,"34901",1104,825,814,5,11,"C's",84
9,"9047",54,47,46,1,1,"C's",5
46,"46115",378,286,282,1,4,"C's",20
24,"24161",285,203,201,3,2,"C's",16
32,"32080",328,249,244,5,5,"C's",10
49,"49165",59,51,51,0,0,"C's",9
37,"37131",185,139,139,0,0,"C's",28
42,"42172",29,26,26,0,0,"C's",3
10,"10182",136,95,95,0,0,"C's",11
49,"49206",840,614,604,9,10,"C's",38
31,"31198",37,25,25,0,0,"C's",1
18,"18098",6135,4206,4161,21,45,"C's",437
3,"3026",1224,949,936,5,13,"C's",115
28,"28156",1019,742,738,3,4,"C's",126
26,"26123",126,108,107,2,1,"C's",7
46,"46194",15567,11156,11044,86,112,"C's",1611
24,"24162",1683,1257,1246,13,11,"C's",196
32,"32036",1345,971,953,14,18,"C's",64
22,"22007",792,581,581,8,0,"C's",71
40,"40216",759,574,571,3,3,"C's",113
28,"28126",39,29,29,0,0,"C's",2
45,"45154",1493,1079,1074,6,5,"C's",186
2,"2001",656,527,523,1,4,"C's",30
39,"39047",1962,1385,1371,10,14,"C's",206
42,"42173",29281,20286,20035,261,251,"C's",2469
9,"9444",72,58,58,3,0,"C's",3
16,"16254",214,174,170,2,4,"C's",20
37,"37259",44,28,28,0,0,"C's",4
3,"3028",998,818,812,2,6,"C's",75
46,"46117",495,402,399,5,3,"C's",58
50,"50043",253,171,171,0,0,"C's",26
23,"23061",7560,5303,5234,29,69,"C's",526
37,"37134",230,168,165,0,3,"C's",16
39,"39048",1716,1329,1312,12,17,"C's",178
50,"50294",70,63,63,0,0,"C's",7
28,"28059",4323,3171,3157,11,14,"C's",610
26,"26021",2827,2098,2076,15,22,"C's",217
19,"19331",2609,1872,1844,12,28,"C's",300
5,"5244",50,39,39,1,0,"C's",4
18,"18100",7807,5452,5398,50,54,"C's",565
24,"24164",370,218,217,0,1,"C's",21
19,"19145",46,41,41,1,0,"C's",5
11,"11006",24455,15750,15587,193,163,"C's",1990
37,"37261",221,163,160,1,3,"C's",11
16,"16101",154,132,132,0,0,"C's",3
9,"9052",29,23,23,0,0,"C's",4
34,"34104",246,185,182,1,3,"C's",17
40,"40009",49,43,43,0,0,"C's",3
26,"26163",136,118,118,0,0,"C's",15
34,"34060",137,111,108,0,3,"C's",9
16,"16258",194,150,150,1,0,"C's",7
34,"34106",109,89,86,2,3,"C's",13
44,"44222",131,98,98,0,0,"C's",14
9,"9054",101,68,66,1,2,"C's",8
32,"32040",1477,1090,1084,7,6,"C's",43
9,"9447",44,41,41,0,0,"C's",4
28,"28005",134246,99236,98481,583,755,"C's",17776
20,"20030",21423,13960,13898,101,62,"C's",339
32,"32041",767,524,515,4,9,"C's",17
44,"44016",482,363,360,2,3,"C's",56
6,"6114",137,112,112,0,0,"C's",0
5,"5103",72,52,52,0,0,"C's",5
19,"19022",625,476,469,3,7,"C's",64
49,"49171",646,514,508,10,6,"C's",45
19,"19148",45,32,31,0,1,"C's",8
5,"5104",35,28,28,0,0,"C's",0
42,"42042",45,35,35,0,0,"C's",3
35,"35003",5211,2949,2908,13,41,"C's",355
50,"50142",26,17,17,0,0,"C's",2
50,"50016",52,40,40,0,0,"C's",3
18,"18902",816,632,620,4,12,"C's",47
6,"6025",5106,3571,3523,44,48,"C's",313
31,"31238",112,93,93,0,0,"C's",7
16,"16202",769,564,558,0,6,"C's",48
5,"5105",341,249,247,7,2,"C's",38
48,"48092",836,618,613,5,5,"C's",7
9,"9095",84,61,61,0,0,"C's",6
34,"34063",83,76,75,1,1,"C's",2
9,"9273",52,40,39,2,1,"C's",1
46,"46258",2652,2084,2062,16,22,"C's",181
36,"36030",4175,2832,2785,27,47,"C's",172
13,"13026",438,345,343,2,2,"C's",19
32,"32044",876,643,634,2,9,"C's",50
47,"47070",37,27,27,0,0,"C's",1
5,"5252",64,45,45,1,0,"C's",4
46,"46199",5718,4314,4266,28,48,"C's",610
3,"3032",108,91,90,1,1,"C's",6
37,"37350",420,318,314,5,4,"C's",54
38,"38008",5520,3825,3766,17,59,"C's",402
3,"3127",350,278,273,1,5,"C's",16
16,"16107",109,86,85,1,1,"C's",8
47,"47071",410,324,321,4,3,"C's",53
44,"44124",77,64,64,3,0,"C's",9
26,"26130",203,167,167,1,0,"C's",16
41,"41055",14954,10068,9945,64,123,"C's",1134
34,"34110",88,71,71,1,0,"C's",2
9,"9323",61,46,46,1,0,"C's",6
45,"45161",13688,9007,8902,32,105,"C's",1848
23,"23069",5353,4310,4212,27,98,"C's",309
9,"9058",390,283,279,1,4,"C's",53
9,"9451",238,191,190,0,1,"C's",19
26,"26131",35,33,33,1,0,"C's",0
19,"19260",42,39,39,1,0,"C's",0
26,"26168",5340,3774,3717,22,57,"C's",656
7,"7001",3573,2531,2497,21,34,"C's",306
7,"7042",10666,6680,6613,64,67,"C's",719
22,"22220",166,126,125,2,1,"C's",21
39,"39054",4493,3376,3334,33,42,"C's",567
16,"16109",44,38,38,1,0,"C's",3
32,"32047",1784,1255,1244,9,11,"C's",59
50,"50051",816,616,614,2,2,"C's",49
38,"38010",4008,2733,2661,19,72,"C's",147
50,"50147",777,552,552,2,0,"C's",43
50,"50019",55,41,41,0,0,"C's",2
49,"49017",251,180,177,1,3,"C's",9
49,"49222",380,279,272,0,7,"C's",32
21,"21057",1041,661,657,12,4,"C's",37
31,"31076",2417,1918,1906,9,12,"C's",136
9,"9143",27,19,18,0,1,"C's",0
31,"31108",1855,1368,1348,7,20,"C's",78
39,"39055",1086,824,816,6,8,"C's",101
37,"37144",363,277,276,1,1,"C's",22
33,"33063",415,320,318,3,2,"C's",19
28,"28066",7182,5422,5371,17,51,"C's",1065
28,"28164",2993,2183,2168,8,15,"C's",380
42,"42049",116,81,81,1,0,"C's",3
2,"2013",119,92,90,0,2,"C's",6
46,"46124",787,653,642,4,11,"C's",77
47,"47021",76,64,64,0,0,"C's",12
24,"24104",259,169,169,0,0,"C's",21
16,"16064",684,568,562,4,6,"C's",52
23,"23034",2540,1957,1934,14,23,"C's",139
19,"19192",1736,1324,1308,8,16,"C's",122
45,"45198",1809,1475,1442,7,33,"C's",103
9,"9458",469,343,336,5,7,"C's",76
48,"48097",1297,900,894,8,6,"C's",20
38,"38012",2347,1644,1630,7,14,"C's",121
12,"12072",1101,929,911,11,18,"C's",100
40,"40061",67,55,54,1,1,"C's",3
37,"37012",154,116,115,1,1,"C's",14
26,"26135",164,125,124,1,1,"C's",10
45,"45031",2723,1835,1822,12,13,"C's",214
40,"40148",238,188,187,2,1,"C's",19
37,"37188",181,129,129,3,0,"C's",17
19,"19264",33,26,26,0,0,"C's",3
49,"49020",289,214,214,2,0,"C's",10
34,"34168",52,47,47,2,0,"C's",5
48,"48037",673,481,478,5,3,"C's",3
27,"27038",935,679,671,7,8,"C's",33
50,"50054",58,50,50,0,0,"C's",4
44,"44024",27,25,25,0,0,"C's",3
19,"19157",55,46,46,0,0,"C's",5
46,"46126",5556,4449,4405,24,44,"C's",639
20,"20006",259,143,143,3,0,"C's",0
9,"9330",1507,1108,1092,10,16,"C's",148
16,"16275",11,11,11,1,0,"C's",1
26,"26032",51,41,39,0,2,"C's",4
45,"45033",343,249,243,2,6,"C's",7
5,"5213",103,84,82,0,2,"C's",6
46,"46902",364,306,303,0,3,"C's",50
13,"13038",1630,1230,1207,7,23,"C's",88
10,"10110",2300,1623,1574,11,49,"C's",129
5,"5263",173,129,129,1,0,"C's",12
26,"26139",54,45,44,0,1,"C's",5
34,"34122",83,60,60,0,0,"C's",11
19,"19159",93,78,77,0,1,"C's",5
44,"44231",38,33,33,0,0,"C's",5
24,"24175",1832,1314,1297,14,17,"C's",228
32,"32055",1280,891,881,7,10,"C's",49
40,"40065",493,373,373,3,0,"C's",67
2,"2018",829,661,653,1,8,"C's",69
37,"37015",224,144,144,1,0,"C's",13
44,"44131",25,20,20,0,0,"C's",2
14,"14051",1397,1018,1000,2,18,"C's",57
24,"24076",1277,956,947,4,9,"C's",114
42,"42192",42,27,27,2,0,"C's",4
42,"42054",19,16,16,0,0,"C's",0
31,"31014",275,194,192,4,2,"C's",7
42,"42055",164,121,121,0,0,"C's",7
50,"50056",409,300,300,3,0,"C's",52
9,"9380",78,58,58,0,0,"C's",4
5,"5216",220,171,168,0,3,"C's",11
19,"19232",71,57,57,1,0,"C's",4
40,"40110",349,265,263,3,2,"C's",27
9,"9423",27,24,24,0,0,"C's",1
16,"16279",203,128,127,1,1,"C's",6
18,"18119",1702,1298,1283,13,15,"C's",171
36,"36041",13434,9297,9181,66,116,"C's",996
40,"40154",20,15,15,0,0,"C's",0
39,"39061",3478,2695,2677,13,18,"C's",437
6,"6131",1076,843,837,2,6,"C's",46
11,"11019",1826,1302,1248,7,54,"C's",124
23,"23080",1762,1332,1322,4,10,"C's",74
19,"19268",35,24,24,1,0,"C's",4
12,"12077",4605,3439,3382,15,57,"C's",453
37,"37278",732,532,528,3,4,"C's",166
50,"50058",66,39,39,0,0,"C's",4
5,"5121",249,185,185,4,0,"C's",29
49,"49231",330,232,232,2,0,"C's",27
42,"42194",170,118,114,1,4,"C's",9
3,"3012",1085,852,841,3,11,"C's",97
49,"49147",263,190,186,0,4,"C's",26
12,"12078",325,235,233,0,2,"C's",16
45,"45071",1835,1426,1408,5,18,"C's",102
5,"5122",134,102,101,0,1,"C's",8
20,"20044",367,236,236,0,0,"C's",2
22,"22102",179,141,138,2,3,"C's",33
9,"9068",29,24,24,0,0,"C's",2
42,"42057",164,104,104,2,0,"C's",9
19,"19042",25,24,24,0,0,"C's",3
5,"5123",97,73,73,1,0,"C's",13
39,"39063",967,697,690,9,7,"C's",63
50,"50123",449,334,331,1,3,"C's",38
23,"23003",8688,6326,6257,52,69,"C's",511
11,"11022",48675,26491,26256,270,235,"C's",3728
19,"19270",20,17,17,0,0,"C's",2
48,"48013",79716,53419,52997,345,422,"C's",2022
16,"16902",137,107,107,0,0,"C's",6
9,"9472",55,45,44,0,1,"C's",6
42,"42058",113,92,89,0,3,"C's",12
37,"37280",78,53,53,0,0,"C's",2
16,"16124",1858,1476,1459,12,17,"C's",102
29,"29071",934,596,588,3,8,"C's",61
24,"24015",2265,1649,1635,18,14,"C's",202
3,"3138",3145,2310,2275,9,35,"C's",341
9,"9473",85,70,65,1,5,"C's",5
12,"12142",158,117,117,1,0,"C's",19
37,"37157",78,63,62,0,1,"C's",7
37,"37282",204,149,148,1,1,"C's",20
31,"31119",39,26,26,0,0,"C's",0
6,"6136",1565,1131,1102,11,29,"C's",78
22,"22233",82,57,57,3,0,"C's",5
24,"24180",1134,812,800,9,12,"C's",96
44,"44032",16,11,11,0,0,"C's",4
26,"26039",39,35,35,2,0,"C's",2
26,"26040",70,60,60,0,0,"C's",10
9,"9072",316,242,241,0,1,"C's",45
18,"18126",1483,1081,1074,15,7,"C's",83
50,"50061",202,172,172,3,0,"C's",5
4,"4091",334,268,267,6,1,"C's",19
46,"46054",11293,8477,8409,47,68,"C's",1074
24,"24114",3061,2025,1994,9,31,"C's",156
49,"49235",443,301,292,0,9,"C's",36
47,"47003",227,180,179,3,1,"C's",8
37,"37024",89,67,67,0,0,"C's",7
28,"28019",1233,893,885,4,8,"C's",129
35,"35016",297736,192251,190256,1386,1995,"C's",26740
32,"32064",529,389,388,3,1,"C's",21
47,"47165",6955,4955,4303,66,652,"C's",727
19,"19045",140,120,120,0,0,"C's",8
9,"9035",311,227,225,2,2,"C's",33
50,"50902",87,79,79,2,0,"C's",8
39,"39067",790,513,505,1,8,"C's",46
49,"49236",75,58,58,0,0,"C's",8
40,"40202",60,46,46,0,0,"C's",5
42,"42062",22,12,12,0,0,"C's",0
32,"32066",566,418,416,0,2,"C's",8
27,"27053",537,316,308,3,8,"C's",8
19,"19046",21588,15689,15515,82,174,"C's",2769
45,"45076",553,368,364,3,4,"C's",30
28,"28175",863,670,668,5,2,"C's",132
14,"14058",7970,5491,5417,66,74,"C's",686
35,"35017",25676,15038,14716,94,322,"C's",1897
39,"39068",646,450,445,2,5,"C's",57
18,"18128",343,270,269,1,1,"C's",21
3,"3902",10254,6996,6930,34,66,"C's",1018
26,"26042",834,635,625,5,10,"C's",44
49,"49077",183,103,103,0,0,"C's",8
34,"34133",107,91,90,0,1,"C's",5
9,"9482",33,28,28,0,0,"C's",4
46,"46134",2357,1725,1712,14,13,"C's",256
48,"48017",13261,8543,8482,42,61,"C's",65
41,"41071",5586,3724,3661,22,63,"C's",348
42,"42064",86,68,68,0,0,"C's",4
45,"45078",1379,1129,1119,6,10,"C's",83
26,"26010",93,80,80,2,0,"C's",7
44,"44068",659,509,503,3,6,"C's",59
9,"9483",211,158,157,0,1,"C's",19
31,"31024",99,42,42,0,0,"C's",1
9,"9168",290,217,217,3,0,"C's",16
50,"50254",180,118,116,1,2,"C's",10
16,"16086",890,740,735,6,5,"C's",47
24,"24086",270,223,218,0,5,"C's",13
48,"48018",869,522,522,2,0,"C's",3
19,"19049",10,10,9,0,1,"C's",2
19,"19280",3464,2469,2438,14,31,"C's",479
24,"24185",474,357,350,3,7,"C's",60
47,"47086",3906,2970,2936,24,34,"C's",326
49,"49035",226,200,196,3,4,"C's",18
34,"34089",155,124,124,2,0,"C's",10
1,"1058",1345,799,793,7,6,"C's",18
15,"15091",1135,771,760,13,11,"C's",44
18,"18134",5828,3840,3800,36,40,"C's",575
9,"9485",55,43,42,0,1,"C's",1
47,"47007",3769,2765,2736,24,29,"C's",625
35,"35019",32481,19318,19067,123,251,"C's",2307
21,"21077",1711,1224,1202,3,22,"C's",79
20,"20052",1090,779,776,8,3,"C's",10
16,"16133",4389,3358,3316,24,42,"C's",322
32,"32071",1476,1010,1005,3,5,"C's",31
40,"40080",59,43,41,0,2,"C's",3
9,"9350",469,350,343,2,7,"C's",48
45,"45181",2315,1674,1640,7,34,"C's",153
19,"19050",16,15,15,0,0,"C's",1
45,"45080",6,6,6,0,0,"C's",0
16,"16243",407,338,334,3,4,"C's",17
3,"3114",1562,1198,1188,9,10,"C's",146
50,"50164",390,247,246,6,1,"C's",31
15,"15093",4220,2533,2498,30,35,"C's",159
37,"37291",272,207,206,0,1,"C's",27
40,"40081",124,94,92,2,2,"C's",10
42,"42070",34,27,26,1,1,"C's",0
45,"45081",17875,12656,12533,82,123,"C's",2374
3,"3051",348,296,294,0,2,"C's",32
6,"6146",1084,838,830,1,8,"C's",33
41,"41075",10212,6419,6295,49,124,"C's",682
32,"32074",1044,710,704,4,6,"C's",43
11,"11031",76455,49854,49405,535,449,"C's",8130
6,"6147",354,268,268,0,0,"C's",9
3,"3052",970,769,755,8,14,"C's",121
34,"34001",34,28,28,2,0,"C's",5
41,"41076",2183,1341,1327,19,14,"C's",46
20,"20054",447,286,284,2,2,"C's",0
5,"5138",306,221,220,1,1,"C's",17
7,"7025",472,355,351,1,4,"C's",52
9,"9001",27,22,22,0,0,"C's",1
20,"20055",17475,11073,10997,56,76,"C's",200
39,"39073",9837,7356,7298,31,58,"C's",1400
22,"22001",225,151,151,1,0,"C's",28
10,"10131",12861,8813,8721,52,92,"C's",1067
19,"19175",32,28,28,0,0,"C's",0
34,"34003",164,122,119,0,3,"C's",17
34,"34004",5608,4120,4063,43,57,"C's",483
22,"22002",107,95,95,0,0,"C's",11
28,"28180",5251,3927,3893,7,34,"C's",612
9,"9218",369,275,275,1,0,"C's",40
16,"16139",335,256,255,2,1,"C's",17
40,"40084",62,55,52,0,3,"C's",6
26,"26154",13,10,10,0,0,"C's",2
49,"49003",900,612,599,5,13,"C's",44
45,"45184",200,129,129,0,0,"C's",11
42,"42211",82,66,66,1,0,"C's",11
3,"3054",343,277,275,3,2,"C's",9
11,"11033",20903,12949,12771,164,178,"C's",1688
44,"44249",55,44,44,2,0,"C's",3
24,"24092",798,606,602,1,4,"C's",48
6,"6014",6682,4479,4409,14,70,"C's",521
44,"44041",56,44,44,1,0,"C's",0
24,"24191",108,79,79,0,0,"C's",8
6,"6151",1070,770,766,3,4,"C's",73
34,"34146",51,40,39,0,1,"C's",3
48,"48024",995,757,754,7,3,"C's",2
31,"31230",106,82,82,1,0,"C's",3
41,"41078",2508,1823,1810,19,13,"C's",87
16,"16141",143,102,102,0,0,"C's",5
31,"31264",180,105,101,2,4,"C's",2
49,"49204",63,51,51,0,0,"C's",1
32,"32078",1188,855,838,4,17,"C's",41
42,"42078",1020,717,703,7,14,"C's",61
9,"9356",42,33,32,0,1,"C's",10
4,"4101",4266,2909,2876,26,33,"C's",408
12,"12092",111,91,90,0,1,"C's",10
32,"32079",1333,950,939,11,11,"C's",52
16,"16143",16,14,14,2,0,"C's",0
50,"50072",170,125,125,0,0,"C's",13
50,"50261",213,157,157,0,0,"C's",14
15,"15024",4393,3141,3073,32,68,"C's",205
28,"28183",1039,743,735,2,8,"C's",91
22,"22006",298,204,204,5,0,"C's",23
44,"44150",28,22,21,0,1,"C's",2
24,"24094",1385,983,968,11,15,"C's",111
31,"31232",25155,17648,17450,196,198,"C's",1788
2,"2041",336,265,260,0,5,"C's",2
19,"19287",148,109,108,0,1,"C's",11
3,"3057",182,147,147,1,0,"C's",21
9,"9086",666,462,459,2,3,"C's",80
45,"45087",8311,5828,5747,43,81,"C's",750
34,"34149",23,18,18,0,0,"C's",6
22,"22249",116,95,95,4,0,"C's",15
22,"22122",64,57,57,2,0,"C's",4
19,"19251",43,29,28,0,1,"C's",1
11,"11003",1261,836,822,7,14,"C's",70
24,"24061",1704,1213,1204,9,9,"C's",169
9,"9358",255,194,190,3,4,"C's",15
48,"48027",22150,15089,14982,78,107,"C's",411
9,"9088",66,45,45,0,0,"C's",4
42,"42080",157,117,115,0,2,"C's",6
5,"5147",159,128,124,5,4,"C's",11
10,"10001",282,225,223,3,2,"C's",12
46,"46065",1579,1174,1163,8,11,"C's",161
22,"22124",201,144,143,1,1,"C's",19
34,"34011",397,321,320,5,1,"C's",31
9,"9224",162,131,131,1,0,"C's",20
40,"40092",118,87,87,1,0,"C's",9
41,"41082",3415,2671,2647,16,24,"C's",217
24,"24197",763,538,533,1,5,"C's",66
39,"39079",8874,6547,6478,47,69,"C's",787
21,"21048",305,214,210,4,4,"C's",28
6,"6020",1815,1366,1345,10,21,"C's",148
6,"6112",393,323,321,2,2,"C's",14
9,"9361",115,90,89,0,1,"C's",9
45,"45190",475,371,366,0,5,"C's",21
3,"3059",20583,15125,15018,63,107,"C's",2161
10,"10140",1106,820,808,4,12,"C's",70
10,"10003",569,414,408,1,6,"C's",16
38,"38040",5021,3136,3102,14,34,"C's",289
49,"49010",345,279,273,5,6,"C's",37
4,"4902",45437,28936,28699,214,237,"C's",4064
34,"34015",41,35,35,3,0,"C's",2
37,"37136",652,440,435,3,5,"C's",61
28,"28903",33082,27065,26922,154,143,"C's",6409
19,"19061",57,42,42,0,0,"C's",4
41,"41084",2845,2124,2081,9,43,"C's",125
48,"48029",8338,5721,5683,37,38,"C's",308
46,"46145",21990,16337,16187,93,150,"C's",2221
22,"22126",88,64,64,0,0,"C's",7
14,"14069",7524,5460,5392,43,68,"C's",503
24,"24097",218,140,139,3,1,"C's",14
35,"35028",9776,5476,5401,43,75,"C's",726
26,"26056",419,338,332,1,6,"C's",14
47,"47095",38,31,31,0,0,"C's",2
23,"23904",2796,1825,1798,8,27,"C's",168
44,"44154",256,192,188,3,4,"C's",32
10,"10005",540,377,362,3,15,"C's",28
5,"5153",103,78,77,1,1,"C's",7
5,"5247",241,138,138,1,0,"C's",13
38,"38042",3802,2652,2625,14,27,"C's",161
31,"31037",84,66,66,1,0,"C's",0
18,"18150",6763,4733,4678,21,55,"C's",646
5,"5154",38,33,33,0,0,"C's",3
35,"35029",4152,2530,2498,32,32,"C's",302
9,"9365",29,19,19,0,0,"C's",0
22,"22127",505,374,371,3,3,"C's",96
47,"47125",58,46,46,0,0,"C's",5
10,"10052",182,130,129,0,1,"C's",11
37,"37264",65,40,40,0,0,"C's",3
24,"24099",171,132,132,0,0,"C's",8
42,"42086",36,27,26,2,1,"C's",1
31,"31171",680,495,486,8,9,"C's",10
26,"26165",358,304,299,2,5,"C's",33
14,"14043",7574,5515,5443,81,72,"C's",519
15,"15070",9069,6090,5976,94,114,"C's",340
29,"29092",570,397,390,4,7,"C's",46
16,"16264",435,366,364,2,2,"C's",23
46,"46225",337,290,281,5,9,"C's",35
49,"49133",304,214,213,1,1,"C's",21
19,"19296",30,19,18,0,1,"C's",2
31,"31239",322,211,211,5,0,"C's",7
29,"29003",983,754,743,1,11,"C's",65
19,"19187",48,43,43,0,0,"C's",7
6,"6902",1667,1121,1113,13,8,"C's",102
49,"49258",114,93,91,2,2,"C's",4
18,"18152",944,707,703,0,4,"C's",36
44,"44262",135,108,107,2,1,"C's",25
34,"34159",357,253,248,4,5,"C's",16
14,"14072",1048,806,795,6,11,"C's",65
41,"41088",509,360,356,0,4,"C's",16
22,"22902",221,159,156,0,3,"C's",25
50,"50269",285,193,188,0,5,"C's",15
5,"5005",182,148,147,3,1,"C's",28
46,"46148",1513,1160,1146,7,14,"C's",203
20,"20067",30828,19984,19882,140,102,"C's",682
40,"40100",270,213,211,2,2,"C's",31
38,"38045",3837,2127,2111,12,16,"C's",152
41,"41089",6493,4398,4331,43,67,"C's",566
48,"48033",217,149,149,0,0,"C's",0
5,"5109",450,352,339,4,13,"C's",33
18,"18108",850,659,656,3,3,"C's",81
40,"40225",1138,883,867,3,16,"C's",113
45,"45196",1400,1047,1033,5,14,"C's",150
37,"37311",227,182,182,3,0,"C's",30
28,"28037",1559,1177,1166,5,11,"C's",80
46,"46149",363,271,268,2,3,"C's",33
47,"47099",150,135,135,1,0,"C's",11
47,"47020",280,234,231,2,3,"C's",12
29,"29096",2810,1944,1909,31,35,"C's",183
32,"32003",885,654,649,5,5,"C's",25
6,"6030",169,137,135,0,2,"C's",8
49,"49136",318,220,218,1,2,"C's",26
38,"38011",20570,13831,13698,75,133,"C's",1883
48,"48095",2347,1555,1546,12,9,"C's",39
9,"9102",36,30,30,0,0,"C's",1
6,"6031",469,277,272,2,5,"C's",10
12,"12102",522,423,418,1,5,"C's",47
39,"39086",358,256,253,0,3,"C's",29
9,"9327",26,24,24,0,0,"C's",4
48,"48035",413,293,292,1,1,"C's",4
44,"44265",186,141,138,2,3,"C's",18
50,"50271",252,200,197,2,3,"C's",25
16,"16158",535,416,413,5,3,"C's",38
22,"22017",866,650,642,5,8,"C's",86
3,"3066",42121,29655,29419,214,236,"C's",4846
2,"2014",356,283,280,1,3,"C's",32
6,"6124",1708,1202,1165,8,37,"C's",67
37,"37011",121,91,91,3,0,"C's",15
19,"19301",40,33,33,1,0,"C's",5
39,"39087",41985,31178,30805,228,373,"C's",3953
37,"37054",250,195,192,1,3,"C's",12
20,"20070",1092,748,746,5,2,"C's",5
6,"6033",1327,1011,1006,10,5,"C's",43
28,"28107",457,312,312,0,0,"C's",50
47,"47101",1710,1357,1336,16,21,"C's",104
40,"40106",201,158,158,2,0,"C's",10
18,"18066",2107,1392,1384,4,8,"C's",104
28,"28012",887,664,661,2,3,"C's",129
50,"50243",331,250,246,0,4,"C's",32
28,"28108",3374,2482,2465,10,17,"C's",571
16,"16113",3077,2225,2202,10,23,"C's",238
46,"46204",6681,5256,5202,32,54,"C's",816
34,"34120",64214,47193,46683,331,510,"C's",6330
42,"42051",20,14,14,1,0,"C's",1
10,"10154",181,131,129,0,2,"C's",9
50,"50181",993,733,720,5,13,"C's",80
18,"18067",702,469,466,0,3,"C's",36
39,"39089",143,104,100,1,4,"C's",8
16,"16022",78,67,66,0,1,"C's",3
37,"37316",744,563,558,3,5,"C's",62
37,"37057",215,172,171,1,1,"C's",11
36,"36001",2564,1858,1848,5,10,"C's",126
38,"38015",4170,2862,2836,10,26,"C's",204
5,"5165",368,290,281,3,9,"C's",27
36,"36002",3147,2193,2169,20,24,"C's",166
20,"20073",4677,3014,2995,15,19,"C's",55
26,"26066",251,201,194,1,7,"C's",26
49,"49022",288,229,225,3,4,"C's",22
5,"5166",185,139,139,1,0,"C's",18
47,"47185",99,73,71,0,2,"C's",16
16,"16162",43,35,34,0,1,"C's",0
19,"19078",50,44,43,0,1,"C's",1
18,"18025",288,220,220,1,0,"C's",23
34,"34032",40,33,33,1,0,"C's",3
29,"29011",2900,1822,1803,9,19,"C's",208
16,"16163",74,62,62,0,0,"C's",4
12,"12006",172,135,133,0,2,"C's",6
3,"3070",2051,1455,1437,7,18,"C's",164
16,"16024",129,98,97,0,1,"C's",10
16,"16025",26,23,23,0,0,"C's",3
10,"10157",263,204,201,0,3,"C's",14
1,"1006",175,140,140,0,0,"C's",18
37,"37060",243,187,187,1,0,"C's",51
24,"24108",376,280,277,2,3,"C's",25
40,"40194",39602,29382,29042,206,340,"C's",4700
48,"48904",3511,2625,2600,22,25,"C's",80
45,"45102",3610,2506,2470,14,36,"C's",296
39,"39030",1895,1225,1212,10,13,"C's",138
10,"10021",5147,3744,3648,31,96,"C's",350
13,"13093",4103,2963,2929,21,34,"C's",381
29,"29013",1610,1238,1207,9,31,"C's",134
24,"24213",150,122,122,1,0,"C's",8
37,"37193",390,279,275,4,4,"C's",28
19,"19306",25,20,20,1,0,"C's",1
34,"34034",123,95,95,1,0,"C's",8
10,"10159",320,251,250,0,1,"C's",26
29,"29903",524,353,349,3,4,"C's",27
24,"24011",203,133,132,0,1,"C's",7
10,"10022",427,349,341,0,8,"C's",17
26,"26069",236,194,189,0,5,"C's",19
3,"3072",348,289,285,0,4,"C's",42
24,"24214",656,490,485,3,5,"C's",24
31,"31215",4676,3284,3240,36,44,"C's",322
47,"47134",165,128,125,1,3,"C's",11
31,"31216",3865,2702,2671,33,31,"C's",172
32,"32059",1790,1283,1263,7,20,"C's",75
36,"36006",11520,8529,8396,63,133,"C's",657
29,"29904",421,338,335,3,3,"C's",15
15,"15008",5627,4112,4072,36,40,"C's",407
49,"49026",226,179,176,0,3,"C's",10
5,"5022",1588,1238,1222,5,16,"C's",153
42,"42103",575,450,445,1,5,"C's",49
3,"3073",236,200,199,1,1,"C's",14
36,"36007",1672,1119,1099,8,20,"C's",66
34,"34176",133,102,101,0,1,"C's",15
29,"29015",31880,22220,21952,190,268,"C's",3136
22,"22024",226,174,171,3,3,"C's",36
46,"46026",1204,1015,1004,3,11,"C's",94
16,"16169",58,37,37,3,0,"C's",4
19,"19082",85,64,64,0,0,"C's",11
40,"40113",425,323,316,0,7,"C's",44
45,"45901",771,547,544,3,3,"C's",61
24,"24215",152,113,113,0,0,"C's",12
29,"29016",251,188,188,1,0,"C's",16
50,"50279",86,64,64,0,0,"C's",4
48,"48043",4423,3118,3108,17,10,"C's",64
31,"31151",66,46,46,1,0,"C's",4
20,"20045",46626,30525,30353,197,172,"C's",1637
9,"9386",54,39,38,1,1,"C's",6
36,"36008",21762,15447,15262,128,185,"C's",1212
45,"45073",298,233,233,1,0,"C's",3
46,"46079",318,241,232,1,9,"C's",21
19,"19200",71,52,52,1,0,"C's",4
12,"12111",360,305,299,3,6,"C's",18
44,"44172",301,218,216,4,2,"C's",8
12,"12011",4565,3331,3283,20,48,"C's",399
16,"16032",278,224,221,1,3,"C's",10
42,"42106",14,10,10,0,0,"C's",2
50,"50280",332,253,250,0,3,"C's",39
9,"9388",34,27,26,0,1,"C's",4
6,"6046",1255,1004,995,8,9,"C's",72
49,"49273",187,112,112,0,0,"C's",6
48,"48045",5167,3809,3757,28,52,"C's",56
26,"26073",97,78,78,0,0,"C's",6
40,"40119",169,138,133,1,5,"C's",26
28,"28173",517,390,388,1,2,"C's",37
24,"24217",135,109,108,1,1,"C's",15
18,"18174",446,330,324,2,6,"C's",26
22,"22150",472,331,330,1,1,"C's",35
33,"33012",5201,3466,3432,25,34,"C's",332
36,"36010",2847,2102,2076,13,26,"C's",121
5,"5027",269,229,225,2,4,"C's",32
5,"5176",235,181,174,4,7,"C's",26
39,"39005",1380,1053,1046,9,7,"C's",139
16,"16034",180,146,144,2,2,"C's",11
26,"26074",105,86,85,1,1,"C's",14
30,"30004",1137,870,862,3,8,"C's",26
49,"49031",148,120,119,6,1,"C's",5
37,"37201",262,187,186,1,1,"C's",34
26,"26183",64,49,49,0,0,"C's",12
16,"16174",185,145,143,0,2,"C's",12
47,"47166",259,204,197,2,7,"C's",22
5,"5030",45,38,38,1,0,"C's",2
9,"9390",611,484,482,3,2,"C's",76
37,"37070",529,399,392,1,7,"C's",59
6,"6049",1015,725,707,3,18,"C's",51
28,"28049",58480,45136,44820,242,316,"C's",7778
49,"49032",326,259,259,1,0,"C's",18
40,"40121",280,226,218,3,8,"C's",21
15,"15014",4002,2566,2524,28,42,"C's",162
37,"37071",78,65,64,0,1,"C's",10
24,"24183",805,555,549,6,6,"C's",59
9,"9391",361,264,263,3,1,"C's",26
46,"46082",4918,3745,3712,33,33,"C's",685
3,"3078",478,389,389,5,0,"C's",62
9,"9122",94,67,66,1,1,"C's",3
10,"10169",531,420,409,2,11,"C's",31
10,"10032",1681,1257,1237,5,20,"C's",101
45,"45111",65,50,50,0,0,"C's",1
23,"23009",12861,9649,9543,72,106,"C's",1089
19,"19048",18,15,15,1,0,"C's",1
6,"6005",1696,1197,1178,1,19,"C's",72
24,"24221",795,543,538,7,5,"C's",55
40,"40205",261,202,198,2,4,"C's",22
50,"50192",236,180,180,2,0,"C's",21
46,"46057",487,321,317,1,4,"C's",24
20,"20903",4330,2756,2734,28,22,"C's",83
18,"18039",3490,2406,2378,33,28,"C's",304
27,"27004",1227,760,749,7,11,"C's",33
48,"48049",549,416,416,1,0,"C's",3
10,"10033",423,320,320,0,0,"C's",8
47,"47114",4045,2787,2762,26,25,"C's",392
3,"3049",12088,9121,9027,52,94,"C's",1108
15,"15016",4749,3058,3020,19,38,"C's",139
10,"10172",709,466,465,0,1,"C's",31
3,"3080",1300,1035,1025,3,10,"C's",122
16,"16181",64,52,52,2,0,"C's",0
49,"49156",237,184,175,0,9,"C's",15
9,"9124",1506,1040,1028,6,12,"C's",102
50,"50096",39,27,27,0,0,"C's",1
16,"16040",80,62,62,0,0,"C's",7
45,"45012",661,510,503,6,7,"C's",42
37,"37205",231,189,182,0,7,"C's",23
27,"27006",2564,1659,1637,17,22,"C's",95
12,"12117",3585,2727,2677,20,50,"C's",332
23,"23012",4162,2907,2889,14,18,"C's",223
24,"24223",2610,1917,1908,39,9,"C's",164
19,"19321",39,30,30,1,0,"C's",0
34,"34048",73,59,59,1,0,"C's",6
28,"28024",151,125,124,1,1,"C's",19
19,"19051",67,63,63,0,0,"C's",1
36,"36017",17782,12411,12240,117,171,"C's",805
24,"24224",616,454,451,4,3,"C's",36
3,"3082",12567,8537,8464,44,73,"C's",1319
49,"49158",215,170,166,2,4,"C's",18
18,"18043",123,80,79,1,1,"C's",5
47,"47195",459,345,344,4,1,"C's",39
44,"44179",337,229,226,1,3,"C's",26
47,"47116",416,341,339,0,2,"C's",33
16,"16042",1157,933,921,4,12,"C's",75
19,"19211",369,289,284,0,5,"C's",28
41,"41097",3137,2180,2134,18,46,"C's",170
19,"19097",16,10,10,0,0,"C's",0
41,"41009",1222,812,805,3,7,"C's",85
18,"18044",181,107,107,0,0,"C's",10
46,"46242",333,267,266,0,1,"C's",28
15,"15020",3784,2476,2447,17,29,"C's",152
3,"3083",5586,3971,3928,33,43,"C's",555
50,"50068",1982,1348,1335,8,13,"C's",156
28,"28090",8505,6654,6609,33,45,"C's",1337
42,"42119",158,100,99,3,1,"C's",13
10,"10176",371,262,261,0,1,"C's",24
45,"45015",606,437,433,2,4,"C's",57
41,"41098",5004,3665,3630,26,35,"C's",391
10,"10039",417,291,291,0,0,"C's",21
10,"10177",1707,1228,1201,5,27,"C's",202
7,"7026",31074,18280,18135,168,145,"C's",2805
20,"20907",118,85,85,2,0,"C's",0
50,"50100",329,246,241,1,5,"C's",20
10,"10040",441,313,307,4,6,"C's",15
50,"50007",45,34,34,1,0,"C's",3
46,"46165",7129,5436,5388,25,48,"C's",782
5,"5042",153,122,121,0,1,"C's",9
30,"30011",4697,3421,3383,15,38,"C's",388
40,"40002",36,32,32,0,0,"C's",4
41,"41100",1013,692,673,6,19,"C's",37
49,"49162",186,142,140,1,2,"C's",22
37,"37338",79,65,64,0,1,"C's",5
18,"18183",658,438,434,3,4,"C's",39
49,"49040",114,101,101,0,0,"C's",5
44,"44076",2203,1690,1663,18,27,"C's",190
6,"6059",1851,1268,1258,7,10,"C's",119
42,"42121",64,47,47,0,0,"C's",7
26,"26083",284,205,205,2,0,"C's",13
49,"49041",432,326,322,5,4,"C's",35
12,"12022",344,265,262,2,3,"C's",20
16,"16046",245,180,180,1,0,"C's",18
28,"28124",74,54,54,1,0,"C's",9
50,"50290",386,283,282,1,1,"C's",23
26,"26084",6696,5012,4955,35,57,"C's",927
12,"12122",796,637,627,0,10,"C's",68
6,"6061",1084,853,837,4,16,"C's",21
31,"31163",2013,1418,1383,13,35,"C's",80
42,"42123",164,117,116,4,1,"C's",20
31,"31064",1424,1121,1104,3,17,"C's",65
49,"49164",155,119,115,2,4,"C's",17
50,"50010",68,58,58,0,0,"C's",5
31,"31065",1878,1351,1326,20,25,"C's",75
44,"44183",77,50,49,0,1,"C's",12
5,"5045",91,66,66,0,0,"C's",4
34,"34202",29,18,18,1,0,"C's",3
12,"12123",48,40,40,3,0,"C's",4
40,"40132",56,37,36,1,1,"C's",1
19,"19103",251,208,208,2,0,"C's",23
9,"9132",171,122,122,2,0,"C's",17
18,"18049",595,459,452,3,7,"C's",41
29,"29030",805,620,614,4,6,"C's",26
34,"34056",1998,1452,1444,13,8,"C's",208
24,"24125",462,290,286,4,4,"C's",29
19,"19104",14,12,12,1,0,"C's",0
3,"3088",5498,4041,3989,29,52,"C's",664
47,"47121",544,437,425,6,12,"C's",27
31,"31166",258,181,181,1,0,"C's",9
41,"41015",5297,3478,3405,41,73,"C's",487
50,"50073",2141,1592,1577,7,15,"C's",188
39,"39077",236,173,171,1,2,"C's",9
6,"6155",1874,1218,1202,16,16,"C's",140
10,"10183",980,733,728,1,5,"C's",51
10,"10046",203,168,168,1,0,"C's",18
24,"24127",296,226,215,4,11,"C's",22
40,"40134",731,579,570,1,9,"C's",86
49,"49167",197,147,145,0,2,"C's",15
6,"6064",841,666,656,2,10,"C's",27
7,"7032",20034,12824,12710,110,114,"C's",1898
46,"46013",17383,13569,13483,82,86,"C's",2463
16,"16195",497,392,390,1,2,"C's",18
18,"18189",776,581,574,4,7,"C's",73
10,"10047",955,732,727,1,5,"C's",73
49,"49046",268,203,203,0,0,"C's",21
12,"12125",216,180,177,0,3,"C's",9
5,"5049",401,272,266,1,6,"C's",55
28,"28031",2048,1500,1486,3,14,"C's",122
9,"9135",41,31,31,1,0,"C's",2
5,"5149",106,77,77,1,0,"C's",5
18,"18053",1630,1082,1076,8,6,"C's",107
5,"5051",179,145,139,1,6,"C's",15
24,"24902",347,270,269,2,1,"C's",18
9,"9409",111,86,86,4,0,"C's",3
39,"39018",4220,3264,3204,35,60,"C's",524
15,"15029",5688,3590,3544,32,46,"C's",261
42,"42129",681,503,495,3,8,"C's",47
50,"50203",1040,748,739,7,9,"C's",133
29,"29033",1122,747,730,4,17,"C's",66
16,"16053",426,351,347,5,4,"C's",30
14,"14013",16796,11830,11616,129,214,"C's",1555
37,"37345",163,128,128,3,0,"C's",15
2,"2085",322,253,252,2,1,"C's",19
31,"31169",2193,1472,1445,9,27,"C's",52
33,"33026",8530,5397,5337,48,60,"C's",562
29,"29034",467,358,356,0,2,"C's",32
40,"40138",2169,1673,1656,7,17,"C's",209
46,"46171",16563,12213,12128,85,85,"C's",1819
4,"4045",1757,1309,1288,6,21,"C's",99
28,"28129",8030,5986,5941,42,45,"C's",1376
3,"3092",6743,5254,5178,37,76,"C's",729
21,"21010",14687,8293,8220,92,73,"C's",980
31,"31070",2638,1808,1784,20,24,"C's",149
5,"5198",73,62,62,0,0,"C's",5
6,"6069",3065,2053,2035,14,18,"C's",173
19,"19293",1867,1358,1342,7,16,"C's",226
18,"18057",5305,3827,3791,27,36,"C's",674
21,"21011",3453,2441,2419,15,22,"C's",261
12,"12031",3807,2941,2894,24,47,"C's",483
5,"5199",40,32,31,0,1,"C's",1
19,"19334",35,31,31,0,0,"C's",2
9,"9411",151,102,101,0,1,"C's",5
23,"23028",6220,4409,4369,23,40,"C's",412
4,"4904",1777,1230,1221,12,9,"C's",131
37,"37180",75,56,56,0,0,"C's",4
12,"12098",580,451,447,5,4,"C's",57
37,"37223",110,85,83,0,2,"C's",5
28,"28130",28293,21253,21040,116,213,"C's",3887
37,"37004",30,21,21,0,0,"C's",2
16,"16057",75,63,63,0,0,"C's",3
10,"10190",545,406,395,2,11,"C's",37
47,"47097",325,266,265,0,1,"C's",21
23,"23029",843,628,624,2,4,"C's",22
22,"22049",78,64,64,0,0,"C's",11
6,"6071",245,206,200,0,6,"C's",4
21,"21013",10591,6580,6452,55,128,"C's",660
26,"26094",83,70,70,0,0,"C's",4
42,"42134",2627,1927,1890,19,37,"C's",266
9,"9413",436,306,302,2,4,"C's",26
31,"31907",10745,8067,8009,116,58,"C's",622
5,"5201",523,419,418,1,1,"C's",35
5,"5204",603,456,451,1,5,"C's",56
44,"44192",355,280,278,4,2,"C's",31
7,"7040",280477,173945,172463,1359,1482,"C's",28277
44,"44193",78,54,54,1,0,"C's",6
47,"47045",763,575,567,1,8,"C's",38
45,"45027",346,275,272,0,3,"C's",14
42,"42007",113,86,86,5,0,"C's",8
50,"50113",618,489,484,2,5,"C's",35
46,"46174",972,764,752,2,12,"C's",44
9,"9414",189,148,146,0,2,"C's",16
3,"3003",450,378,376,2,2,"C's",29
27,"27029",1463,1023,1002,11,21,"C's",63
14,"14017",10868,7764,7665,71,99,"C's",908
19,"19225",823,623,619,3,4,"C's",107
44,"44051",2683,1977,1946,17,31,"C's",205
10,"10011",560,458,448,5,10,"C's",44
49,"49016",247,176,174,5,2,"C's",14
49,"49175",230,172,171,1,1,"C's",10
10,"10194",542,415,407,2,8,"C's",48
28,"28133",5979,4140,4098,18,42,"C's",490
23,"23032",566,450,448,4,2,"C's",18
46,"46175",456,389,387,3,2,"C's",15
22,"22052",925,712,710,8,2,"C's",79
45,"45129",131,92,92,0,0,"C's",5
50,"50114",116,89,88,0,1,"C's",12
44,"44052",77,56,56,0,0,"C's",4
12,"12132",480,396,389,3,7,"C's",32
15,"15036",57885,39471,39096,417,375,"C's",3590
45,"45197",1906,1455,1430,8,25,"C's",85
26,"26170",446,330,326,2,4,"C's",26
19,"19226",43,38,38,0,0,"C's",2
1,"1041",149,103,100,1,3,"C's",5
10,"10196",301,225,225,1,0,"C's",8
36,"36034",3475,2403,2367,11,36,"C's",172
9,"9144",53,40,40,0,0,"C's",3
33,"33032",11395,7592,7465,90,127,"C's",645
18,"18065",618,496,470,3,26,"C's",36
16,"16063",97,85,84,1,1,"C's",4
44,"44196",131,101,98,2,3,"C's",10
5,"5062",179,148,147,0,1,"C's",31
19,"19115",24,18,18,0,0,"C's",5
44,"44053",105,78,78,0,0,"C's",16
3,"3098",505,393,386,0,7,"C's",34
19,"19191",14,13,12,0,1,"C's",0
39,"39026",1750,1236,1224,11,12,"C's",118
12,"12134",141,95,94,0,1,"C's",8
36,"36036",2518,1827,1801,18,26,"C's",105
47,"47130",96,72,72,0,0,"C's",18
45,"45132",2197,1645,1632,14,13,"C's",244
47,"47048",188,144,144,1,0,"C's",26
28,"28135",948,713,709,4,4,"C's",99
31,"31177",255,169,166,2,3,"C's",6
50,"50022",530,397,390,7,7,"C's",36
22,"22136",806,588,588,5,0,"C's",70
21,"21020",365,223,222,1,1,"C's",15
24,"24007",773,550,548,4,2,"C's",44
7,"7005",6710,4127,4090,25,37,"C's",593
22,"22906",186,141,139,3,2,"C's",15
10,"10016",330,237,235,0,2,"C's",28
16,"16215",242,172,169,2,3,"C's",13
42,"42013",34,28,27,0,1,"C's",3
9,"9149",35,24,24,2,0,"C's",1
13,"13036",799,601,595,2,6,"C's",32
28,"28068",10955,8136,8076,49,60,"C's",1467
46,"46178",4637,3405,3381,27,24,"C's",609
31,"31079",73,54,53,0,1,"C's",3
37,"37358",159,135,133,0,2,"C's",24
31,"31178",490,345,342,3,3,"C's",13
50,"50085",167,126,126,1,0,"C's",10
42,"42014",64,43,43,1,0,"C's",7
3,"3101",4808,3627,3580,22,47,"C's",461
37,"37107",10764,7379,7264,56,115,"C's",1043
16,"16216",315,268,265,1,3,"C's",8
6,"6082",383,287,286,2,1,"C's",28
47,"47132",45,36,33,1,3,"C's",1
45,"45134",1581,1204,1192,6,12,"C's",104
28,"28069",50,44,41,0,3,"C's",5
19,"19230",505,360,357,3,3,"C's",85
10,"10202",606,473,463,4,10,"C's",38
39,"39029",618,488,481,3,7,"C's",64
49,"49181",362,277,276,2,1,"C's",6
50,"50119",927,724,713,5,11,"C's",94
9,"9152",257,183,183,0,0,"C's",17
12,"12041",100,81,81,0,0,"C's",13
37,"37235",224,153,148,2,5,"C's",21
49,"49064",515,346,338,6,8,"C's",25
31,"31180",212,154,154,5,0,"C's",12
22,"22187",293,218,216,2,2,"C's",21
34,"34224",47,37,37,1,0,"C's",6
40,"40152",760,592,584,3,8,"C's",105
5,"5018",29,22,22,0,0,"C's",2
24,"24212",1032,773,760,4,13,"C's",78
6,"6085",3428,2453,2414,25,39,"C's",344
47,"47186",246129,186191,184733,1198,1458,"C's",28775
21,"21024",492,338,326,6,12,"C's",16
34,"34077",347,244,238,4,6,"C's",43
49,"49065",1103,836,818,2,18,"C's",77
12,"12138",19061,13010,12847,129,163,"C's",1623
9,"9027",46,42,41,0,1,"C's",2
47,"47215",53,45,45,0,0,"C's",4
7,"7051",5215,3171,3134,39,37,"C's",362
42,"42152",78,55,55,0,0,"C's",8
18,"18914",1649,1238,1213,3,25,"C's",95
37,"37362",4632,3389,3351,25,38,"C's",825
44,"44101",58,46,46,2,0,"C's",10
34,"34227",77,61,61,2,0,"C's",7
37,"37238",110,87,85,0,2,"C's",13
10,"10068",735,570,557,2,13,"C's",43
33,"33039",1655,1223,1209,12,14,"C's",113
29,"29069",85684,54130,53621,455,509,"C's",9237
10,"10206",215,157,157,3,0,"C's",15
29,"29014",217,141,140,4,1,"C's",12
31,"31182",34,28,28,0,0,"C's",1
40,"40156",322,238,235,1,3,"C's",30
5,"5074",686,564,558,5,6,"C's",87
31,"31083",52,37,37,0,0,"C's",0
47,"47053",119,98,96,0,2,"C's",12
18,"18915",745,533,525,2,8,"C's",28
37,"37239",217,185,183,3,2,"C's",18
42,"42153",14,12,12,0,0,"C's",1
9,"9159",60,52,51,2,1,"C's",3
46,"46182",1266,929,922,6,7,"C's",137
19,"19122",96,68,68,1,0,"C's",4
34,"34080",5560,3723,3665,32,58,"C's",426
31,"31084",1940,1293,1274,16,19,"C's",18
16,"16074",37,30,30,1,0,"C's",1
10,"10070",718,546,542,1,4,"C's",27
12,"12044",468,419,412,3,7,"C's",24
28,"28073",12549,8788,8701,54,87,"C's",1814
23,"23044",4816,3663,3569,27,94,"C's",288
18,"18076",804,551,549,1,2,"C's",28
40,"40030",473,369,363,3,6,"C's",26
31,"31085",480,350,350,2,0,"C's",4
37,"37197",84,57,57,2,0,"C's",8
22,"22193",276,225,224,2,1,"C's",24
27,"27049",1409,921,909,7,12,"C's",54
45,"45006",1406,942,931,4,11,"C's",70
31,"31185",494,341,341,1,0,"C's",11
23,"23045",2132,1260,1247,5,13,"C's",75
46,"46027",943,780,771,5,9,"C's",72
32,"32017",1244,870,857,6,13,"C's",43
14,"14027",7925,5836,5746,58,90,"C's",567
9,"9428",108,92,91,0,1,"C's",8
33,"33041",7199,4922,4877,52,45,"C's",516
50,"50029",626,450,450,3,0,"C's",48
10,"10072",859,617,615,5,2,"C's",29
26,"26006",1800,1419,1405,8,14,"C's",128
23,"23046",2391,1916,1895,6,21,"C's",120
1,"1054",960,654,651,4,3,"C's",10
12,"12046",191,151,150,2,1,"C's",14
9,"9163",582,467,459,2,8,"C's",55
5,"5224",102,86,84,3,2,"C's",12
12,"12901",3405,2626,2598,23,28,"C's",409
24,"24151",478,353,352,1,1,"C's",28
45,"45141",884,700,689,3,11,"C's",46
18,"18082",861,616,611,5,5,"C's",70
6,"6092",577,415,405,3,10,"C's",44
40,"40032",390,289,285,2,4,"C's",58
28,"28146",1787,1205,1194,0,11,"C's",123
5,"5225",372,285,281,1,4,"C's",29
47,"47219",41,36,34,0,2,"C's",4
24,"24050",102,77,76,0,1,"C's",2
29,"29052",224,144,144,3,0,"C's",17
6,"6093",4447,3254,3204,15,50,"C's",222
19,"19239",92,62,62,1,0,"C's",4
50,"50031",154,93,93,0,0,"C's",8
7,"7058",2791,2060,2034,13,26,"C's",254
4,"4028",221,191,190,1,1,"C's",9
45,"45042",187,140,140,0,0,"C's",6
19,"19005",84,66,66,0,0,"C's",8
31,"31088",5572,3897,3862,44,35,"C's",319
44,"44208",37,22,22,0,0,"C's",5
37,"37245",346,261,259,2,2,"C's",10
10,"10077",677,479,472,1,7,"C's",66
33,"33044",178278,125469,124554,1124,915,"C's",19302
10,"10214",214,181,177,2,4,"C's",8
16,"16175",5095,3980,3914,35,66,"C's",288
27,"27055",1293,826,809,6,17,"C's",46
5,"5228",174,121,120,0,1,"C's",6
15,"15052",4314,2889,2838,21,51,"C's",146
20,"20016",1520,826,821,2,5,"C's",7
37,"37246",5304,3993,3949,26,44,"C's",517
40,"40035",137,105,104,0,1,"C's",27
24,"24153",232,179,177,2,2,"C's",25
50,"50129",235,161,158,2,3,"C's",17
26,"26076",129,107,106,0,1,"C's",12
24,"24019",354,272,267,3,5,"C's",24
12,"12051",471,339,335,1,4,"C's",17
19,"19242",87,65,65,1,0,"C's",3
37,"37247",196,163,162,3,1,"C's",18
47,"47058",200,145,143,0,2,"C's",9
31,"31190",45,34,32,2,2,"C's",0
40,"40163",53,44,43,0,1,"C's",5
36,"36051",14267,9638,9493,71,145,"C's",939
42,"42027",76,61,60,0,1,"C's",5
28,"28149",5759,4352,4310,25,42,"C's",1027
22,"22201",266,188,187,3,1,"C's",24
16,"16039",392,261,254,1,7,"C's",26
19,"19243",44,31,31,0,0,"C's",1
50,"50130",383,240,238,2,2,"C's",31
12,"12052",578,452,435,3,17,"C's",37
33,"33046",499,379,367,5,12,"C's",19
6,"6098",549,385,381,7,4,"C's",17
40,"40037",41,29,29,0,0,"C's",2
37,"37123",177,126,126,0,0,"C's",9
14,"14032",423,334,330,4,4,"C's",25
49,"49197",175,123,123,1,0,"C's",12
34,"34091",123,94,93,3,1,"C's",9
26,"26115",19,16,16,0,0,"C's",0
15,"15055",4572,3070,3013,27,57,"C's",207
6,"6099",1145,655,638,6,17,"C's",51
49,"49199",254,193,189,3,4,"C's",9
42,"42162",2352,1637,1601,16,36,"C's",222
24,"24055",708,516,512,0,4,"C's",46
19,"19133",83,72,72,0,0,"C's",4
37,"37250",356,229,228,0,1,"C's",19
19,"19244",82,65,64,1,1,"C's",8
13,"13006",597,456,447,4,9,"C's",17
37,"37374",1166,935,919,9,16,"C's",88
32,"32027",1053,765,749,2,16,"C's",36
22,"22074",313,228,225,4,3,"C's",31
19,"19010",8,8,8,0,0,"C's",1
39,"39041",1760,1370,1354,9,16,"C's",183
47,"47224",87,76,76,0,0,"C's",10
50,"50132",751,543,536,0,7,"C's",90
7,"7065",2083,1346,1328,9,18,"C's",93
5,"5233",221,191,191,1,0,"C's",8
20,"20021",200,100,100,2,0,"C's",2
27,"27062",605,447,444,1,3,"C's",8
24,"24056",2883,2040,2003,11,37,"C's",218
45,"45148",292,223,223,0,0,"C's",12
47,"47144",78,64,64,1,0,"C's",5
46,"46008",2651,2108,2089,21,19,"C's",178
28,"28121",198,160,158,1,2,"C's",18
14,"14035",5966,4236,4177,39,59,"C's",366
18,"18093",2750,1793,1776,7,17,"C's",189
4,"4067",570,441,436,2,5,"C's",32
22,"22204",1114,745,739,12,6,"C's",119
9,"9308",67,42,42,1,0,"C's",8
44,"44215",159,109,109,2,0,"C's",17
19,"19013",125,108,108,1,0,"C's",2
28,"28152",16093,12945,12877,58,68,"C's",2951
30,"30041",13621,8970,8889,46,81,"C's",1319
36,"36056",5076,3584,3515,30,69,"C's",275
37,"37377",241,201,199,1,2,"C's",23
50,"50038",1502,1121,1111,7,10,"C's",117
19,"19136",18,14,14,0,0,"C's",1
23,"23056",3088,2243,2203,15,40,"C's",156
32,"32031",1069,822,795,4,27,"C's",46
6,"6104",674,491,487,3,4,"C's",45
16,"16247",67,58,58,0,0,"C's",0
49,"49203",313,240,232,0,8,"C's",21
10,"10905",656,446,439,2,7,"C's",62
5,"5237",162,130,124,2,6,"C's",11
50,"50135",91,70,70,3,0,"C's",3
26,"26120",1454,1139,1126,7,13,"C's",119
40,"40172",39,34,34,0,0,"C's",1
50,"50229",62,47,47,2,0,"C's",4
47,"47226",156,123,123,0,0,"C's",3
41,"41045",5756,3988,3924,53,64,"C's",445
19,"19016",65,49,49,0,0,"C's",6
46,"46192",761,576,570,5,6,"C's",88
24,"24160",684,483,474,6,9,"C's",51
5,"5238",782,565,563,5,2,"C's",44
42,"42034",30,22,22,0,0,"C's",1
48,"48085",10338,7190,7153,39,37,"C's",216
26,"26018",10477,8053,7956,65,97,"C's",1155
9,"9176",63,47,46,2,1,"C's",2
37,"37130",172,151,150,0,1,"C's",21
5,"5239",214,164,162,3,2,"C's",35
31,"31197",69,56,56,2,0,"C's",3
23,"23058",8678,6532,6461,37,71,"C's",743
21,"21044",17591,10679,10558,118,121,"C's",1283
44,"44116",83,60,60,1,0,"C's",9
37,"37256",218,156,152,1,4,"C's",18
50,"50041",12,9,9,0,0,"C's",0
19,"19250",20,17,17,0,0,"C's",1
15,"15062",5887,3747,3701,36,46,"C's",238
10,"10091",371,287,284,0,3,"C's",37
50,"50137",1011,772,764,8,8,"C's",90
3,"3119",16636,12281,12194,57,87,"C's",2063
23,"23059",5837,4387,4310,40,77,"C's",479
21,"21045",249,180,178,3,2,"C's",19
16,"16097",156,124,121,0,3,"C's",3
44,"44117",340,271,268,4,3,"C's",32
37,"37382",173,137,137,0,0,"C's",8
45,"45153",1615,1258,1243,7,15,"C's",143
38,"38001",20228,11032,10936,47,96,"C's",1393
50,"50042",15,15,15,1,0,"C's",0
40,"40048",38,29,27,0,2,"C's",1
3,"3027",157,138,135,0,3,"C's",17
42,"42037",33,25,25,2,0,"C's",2
13,"13017",256,200,197,0,3,"C's",8
22,"22080",280,197,194,6,3,"C's",25
2,"2002",470,394,389,3,5,"C's",31
19,"19143",1738,1306,1297,12,9,"C's",189
11,"11004",88783,51500,51015,513,485,"C's",8746
46,"46195",1962,1531,1516,11,15,"C's",175
50,"50139",313,241,239,3,2,"C's",15
24,"24062",139,98,98,1,0,"C's",5
10,"10093",398,317,312,4,5,"C's",29
19,"19019",20,18,17,0,1,"C's",1
16,"16100",670,564,559,0,5,"C's",25
47,"47150",274,209,205,0,4,"C's",16
26,"26088",37,32,31,0,1,"C's",1
28,"28003",173,141,141,0,0,"C's",20
42,"42174",174,137,135,5,2,"C's",16
31,"31002",414,288,287,3,1,"C's",19
4,"4074",2840,2000,1979,23,21,"C's",239
18,"18147",3729,2335,2304,16,31,"C's",258
46,"46196",147,125,125,1,0,"C's",11
22,"22081",254,181,181,0,0,"C's",40
19,"19020",44,30,30,1,0,"C's",3
45,"45057",222,180,177,1,3,"C's",10
23,"23063",3829,2560,2522,21,38,"C's",156
47,"47067",174,127,126,0,1,"C's",9
26,"26022",198,164,163,1,1,"C's",10
31,"31202",4305,2845,2803,31,42,"C's",211
2,"2005",559,424,416,5,8,"C's",43
5,"5246",59,46,44,0,2,"C's",2
19,"19021",1030,759,744,7,15,"C's",81
20,"20029",4281,2813,2802,19,11,"C's",44
13,"13022",348,260,258,4,2,"C's",17
37,"37002",139,87,86,0,1,"C's",15
28,"28159",589,468,468,5,0,"C's",60
33,"33057",1593,1063,1049,16,14,"C's",110
9,"9182",80,69,67,1,2,"C's",7
40,"40180",299,246,241,1,5,"C's",29
24,"24165",354,240,238,2,2,"C's",17
48,"48091",1121,771,765,7,6,"C's",7
35,"35002",23328,15495,15313,94,182,"C's",1961
26,"26024",228,181,181,0,0,"C's",13
41,"41052",3013,2116,2064,14,52,"C's",140
44,"44223",72,54,54,0,0,"C's",2
37,"37138",203,149,148,2,1,"C's",15
37,"37003",115,93,93,0,0,"C's",8
3,"3124",460,388,384,3,4,"C's",23
23,"23065",1597,1170,1149,2,21,"C's",87
31,"31906",2562,1800,1779,26,21,"C's",122
42,"42004",2285,1757,1737,15,20,"C's",192
37,"37222",93,72,72,0,0,"C's",8
44,"44017",285,227,223,4,4,"C's",35
9,"9183",51,41,41,0,0,"C's",4
9,"9228",160,137,136,1,1,"C's",17
24,"24001",189,124,122,0,2,"C's",11
37,"37265",220,181,181,0,0,"C's",24
28,"28062",292,231,226,1,5,"C's",37
45,"45159",90,75,75,0,0,"C's",6
44,"44224",22,14,14,0,0,"C's",1
37,"37005",74,54,54,2,0,"C's",6
34,"34109",59,48,48,0,0,"C's",1
21,"21053",3316,2141,2107,17,34,"C's",201
26,"26129",967,775,766,6,9,"C's",71
41,"41053",21259,15147,14853,132,294,"C's",2192
46,"46121",105,95,94,0,1,"C's",6
50,"50143",566,394,391,6,3,"C's",46
50,"50238",91,66,66,1,0,"C's",7
28,"28007",124592,94222,93521,491,701,"C's",15892
32,"32045",2443,1715,1690,14,25,"C's",100
22,"22086",215,161,159,1,2,"C's",22
23,"23067",2460,1831,1805,11,26,"C's",99
15,"15071",7951,5255,5178,50,77,"C's",421
22,"22218",43,33,33,0,0,"C's",6
20,"20033",868,600,599,1,1,"C's",4
50,"50048",34,29,29,0,0,"C's",0
24,"24067",623,388,384,0,4,"C's",31
21,"21055",6975,5293,5241,48,52,"C's",590
26,"26027",157,112,108,0,4,"C's",4
5,"5108",47,35,35,0,0,"C's",0
5,"5254",190,160,159,0,1,"C's",25
48,"48003",14339,9918,9838,53,80,"C's",173
50,"50146",187,145,144,3,1,"C's",5
49,"49221",245,129,127,1,2,"C's",16
36,"36033",12298,8968,8788,53,180,"C's",697
23,"23070",3914,2433,2407,14,26,"C's",255
50,"50239",62,50,48,0,2,"C's",3
15,"15073",21827,14058,13864,126,194,"C's",1452
44,"44226",140,98,98,2,0,"C's",4
42,"42046",49,39,39,0,0,"C's",3
44,"44227",74,63,62,0,1,"C's",3
45,"45063",417,310,303,1,7,"C's",21
5,"5110",711,510,505,4,5,"C's",68
42,"42140",16,12,12,0,0,"C's",0
48,"48004",335,222,222,0,0,"C's",0
18,"18109",597,411,408,2,3,"C's",37
46,"46045",1249,1028,1010,3,18,"C's",101
3,"3097",993,822,812,6,10,"C's",63
9,"9191",38,28,27,0,1,"C's",2
28,"28163",442,344,339,1,5,"C's",54
26,"26132",112,82,82,0,0,"C's",5
41,"41057",269,183,181,0,2,"C's",6
48,"48005",115,63,61,0,2,"C's",0
5,"5112",97,71,70,2,1,"C's",6
37,"37270",189,152,151,2,1,"C's",19
45,"45163",8298,5942,5855,28,87,"C's",978
50,"50148",316,233,229,4,4,"C's",30
9,"9192",55,43,43,0,0,"C's",1
44,"44022",493,323,318,7,5,"C's",40
44,"44127",68,51,51,0,0,"C's",4
27,"27034",1120,681,672,4,9,"C's",23
9,"9328",76,56,56,0,0,"C's",5
21,"21059",221,166,163,5,3,"C's",10
19,"19262",135,100,100,0,0,"C's",4
14,"14048",1207,884,869,13,15,"C's",76
19,"19155",66,56,56,0,0,"C's",11
31,"31210",196,152,152,2,0,"C's",4
3,"3131",175,154,147,0,7,"C's",13
22,"22135",189,128,127,0,1,"C's",23
15,"15076",2611,1758,1739,17,19,"C's",117
46,"46203",3606,2873,2844,9,29,"C's",289
13,"13034",58191,42423,42027,291,396,"C's",6202
31,"31011",693,459,456,8,3,"C's",29
7,"7045",1295,947,936,5,11,"C's",120
16,"16274",121,92,92,0,0,"C's",3
9,"9460",176,131,131,1,0,"C's",14
9,"9195",59,36,36,2,0,"C's",3
37,"37273",107,71,71,1,0,"C's",6
29,"29043",2509,1608,1576,18,32,"C's",175
3,"3132",534,436,435,3,1,"C's",38
45,"45166",1617,1305,1286,8,19,"C's",123
49,"49103",414,330,328,5,2,"C's",33
34,"34028",143,116,113,1,3,"C's",4
10,"10109",1762,1149,1125,14,24,"C's",88
23,"23075",3298,2564,2541,18,23,"C's",165
31,"31013",642,406,401,1,5,"C's",17
31,"31112",89,62,62,0,0,"C's",3
28,"28167",8356,6158,6106,46,52,"C's",1347
23,"23038",3587,2794,2770,16,24,"C's",361
3,"3039",81,62,61,1,1,"C's",3
12,"12074",785,652,648,5,4,"C's",62
11,"11017",3212,2233,2203,39,30,"C's",158
37,"37274",118913,85506,84764,566,742,"C's",14028
4,"4084",341,249,247,2,2,"C's",37
37,"37275",118,70,69,0,1,"C's",1
48,"48008",606,424,414,6,10,"C's",1
46,"46205",14313,10932,10834,51,98,"C's",1703
21,"21063",2615,2001,1957,22,44,"C's",145
10,"10111",1325,970,949,2,21,"C's",86
23,"23076",827,640,630,1,10,"C's",38
48,"48009",783,586,575,1,11,"C's",7
49,"49228",54,44,43,0,1,"C's",2
5,"5118",79,53,53,0,0,"C's",6
15,"15080",1756,1131,1117,11,14,"C's",73
22,"22227",206,163,160,3,3,"C's",15
50,"50245",88,65,64,0,1,"C's",6
45,"45068",160,126,126,0,0,"C's",7
50,"50152",1430,1008,994,14,14,"C's",103
37,"37016",569,406,401,2,5,"C's",78
9,"9198",104,83,82,1,1,"C's",6
37,"37276",143,104,103,1,1,"C's",14
13,"13041",244,170,165,1,5,"C's",13
48,"48071",6087,4294,4254,32,40,"C's",72
33,"33068",1093,645,641,4,4,"C's",39
10,"10113",2338,1679,1638,9,41,"C's",130
41,"41063",2695,1850,1830,13,20,"C's",132
14,"14052",9379,5917,5854,68,63,"C's",604
24,"24077",225,190,187,2,3,"C's",27
31,"31016",7608,5474,5413,50,61,"C's",260
32,"32058",5202,3650,3607,34,43,"C's",372
9,"9467",64,43,42,1,1,"C's",2
24,"24177",476,325,322,3,3,"C's",36
21,"21066",498,392,389,3,3,"C's",30
46,"46207",6676,5106,5040,41,66,"C's",713
13,"13042",920,652,648,2,4,"C's",54
41,"41064",5596,3517,3456,55,61,"C's",291
31,"31116",62,51,50,1,1,"C's",4
16,"16121",258,202,202,3,0,"C's",13
19,"19041",163,129,129,3,0,"C's",21
16,"16280",192,164,161,1,3,"C's",7
23,"23042",292,217,213,1,4,"C's",13
19,"19162",68,49,47,0,2,"C's",7
40,"40196",30,25,25,0,0,"C's",2
37,"37019",150,123,120,0,3,"C's",15
50,"50247",823,588,581,3,7,"C's",115
48,"48906",766,547,544,0,3,"C's",1
31,"31017",358,242,239,0,3,"C's",20
23,"23081",1513,1103,1084,10,19,"C's",119
5,"5901",263,182,180,2,2,"C's",27
49,"49109",619,483,483,11,0,"C's",34
50,"50155",103,80,78,0,2,"C's",16
3,"3137",651,492,489,5,3,"C's",41
23,"23082",1921,1425,1416,8,9,"C's",110
49,"49110",348,231,229,0,2,"C's",25
19,"19163",56,41,40,0,1,"C's",3
5,"5902",284,236,232,0,4,"C's",30
13,"13046",724,529,525,1,4,"C's",30
22,"22230",284,216,216,1,0,"C's",30
35,"35013",6625,4896,4781,41,115,"C's",476
32,"32061",1081,812,809,4,3,"C's",49
37,"37240",945,623,619,5,4,"C's",152
44,"44136",49,43,43,1,0,"C's",3
5,"5124",102,83,81,0,2,"C's",7
3,"3044",4521,3510,3465,21,45,"C's",457
46,"46131",49431,36570,36227,231,343,"C's",4934
9,"9071",41,35,35,1,0,"C's",6
18,"18123",301,228,222,1,6,"C's",27
49,"49233",93,58,55,0,3,"C's",5
37,"37021",79,60,60,0,0,"C's",10
34,"34129",179,130,129,1,1,"C's",7
13,"13047",5760,4295,4224,23,71,"C's",517
37,"37022",268,215,215,2,0,"C's",23
42,"42197",75,58,56,0,2,"C's",2
3,"3139",22437,15315,15170,100,145,"C's",2259
44,"44137",193,149,148,0,1,"C's",28
31,"31020",449,228,228,3,0,"C's",2
47,"47082",812,640,628,8,12,"C's",67
9,"9476",62,43,43,0,0,"C's",7
9,"9206",59,45,45,0,0,"C's",1
19,"19044",304,245,244,0,1,"C's",17
42,"42198",23,16,16,4,0,"C's",2
37,"37158",246,183,183,0,0,"C's",16
37,"37283",123,92,90,0,2,"C's",6
31,"31120",388,250,249,3,1,"C's",4
9,"9208",210,136,134,3,2,"C's",16
45,"45075",143,109,108,0,1,"C's",14
10,"10121",7978,5517,5429,35,88,"C's",465
21,"21072",10262,7442,7307,85,135,"C's",873
28,"28174",1795,1232,1221,7,11,"C's",187
31,"31221",1214,798,786,12,12,"C's",39
20,"20048",182,100,98,2,2,"C's",0
18,"18127",16635,11440,11332,91,108,"C's",1803
2,"2027",315,248,246,2,2,"C's",32
15,"15088",3519,2304,2270,27,34,"C's",148
24,"24083",1042,727,715,6,12,"C's",44
19,"19168",292,204,198,1,6,"C's",20
45,"45175",664,545,543,5,2,"C's",27
3,"3047",9207,6309,6226,25,83,"C's",1093
16,"16906",80,67,67,1,0,"C's",2
49,"49237",165,119,117,2,2,"C's",6
6,"6139",553,420,419,1,1,"C's",17
19,"19047",64,55,55,0,0,"C's",5
10,"10123",578,481,475,1,6,"C's",23
6,"6140",630,506,499,3,7,"C's",19
9,"9346",92,64,63,1,1,"C's",4
22,"22236",253,200,200,0,0,"C's",26
18,"18132",3291,2524,2494,9,30,"C's",176
40,"40203",899,722,715,4,7,"C's",139
32,"32067",1294,837,826,8,11,"C's",49
37,"37286",207,152,145,4,7,"C's",8
13,"13053",14328,10164,10041,72,123,"C's",1381
50,"50253",423,330,328,4,2,"C's",31
16,"16909",699,535,532,0,3,"C's",34
40,"40204",167,113,110,1,3,"C's",10
49,"49116",383,276,269,3,7,"C's",15
26,"26112",236,194,190,1,4,"C's",20
9,"9347",143,117,115,2,2,"C's",16
14,"14059",690,533,528,4,5,"C's",57
9,"9213",307,220,218,2,2,"C's",22
34,"34135",399,293,289,0,4,"C's",37
45,"45179",525,391,386,3,5,"C's",31
42,"42065",21,18,18,0,0,"C's",2
20,"20051",6877,4699,4679,34,20,"C's",68
37,"37163",41,34,34,0,0,"C's",5
45,"45079",369,288,286,3,2,"C's",20
5,"5132",960,669,657,1,12,"C's",60
19,"19171",4961,3670,3628,27,42,"C's",561
28,"28023",4775,3755,3735,12,20,"C's",706
3,"3903",2494,1880,1865,7,15,"C's",315
44,"44143",380,307,306,2,1,"C's",41
44,"44036",25,21,21,0,0,"C's",1
23,"23092",27775,19734,19541,175,193,"C's",2576
44,"44244",75,47,47,1,0,"C's",4
6,"6144",556,431,425,0,6,"C's",20
22,"22242",62,45,44,0,1,"C's",4
40,"40206",173,135,134,0,1,"C's",23
48,"48019",3553,2406,2397,18,9,"C's",62
45,"45180",2727,1966,1940,9,26,"C's",278
42,"42068",82,63,60,1,3,"C's",10
26,"26151",448,370,368,1,2,"C's",38
37,"37165",33,26,25,0,1,"C's",4
37,"37077",261,226,223,1,3,"C's",24
34,"34137",27,23,22,0,1,"C's",0
13,"13058",4100,2986,2954,25,32,"C's",322
40,"40207",763,599,593,3,6,"C's",162
24,"24187",857,603,593,7,10,"C's",60
19,"19173",45,38,36,0,2,"C's",2
6,"6145",922,696,694,5,2,"C's",34
23,"23093",3226,2302,2273,19,29,"C's",180
10,"10129",365,275,271,0,4,"C's",23
16,"16134",4371,3288,3254,20,34,"C's",439
40,"40208",766,596,589,3,7,"C's",86
4,"4001",1062,823,814,5,9,"C's",110
16,"16135",134,92,92,2,0,"C's",9
44,"44145",1020,719,709,9,10,"C's",88
18,"18001",251,168,167,5,1,"C's",6
31,"31027",836,532,530,2,2,"C's",10
5,"5136",96,61,60,3,1,"C's",10
24,"24188",3822,2850,2817,19,33,"C's",390
9,"9217",351,251,249,6,2,"C's",20
18,"18137",989,761,760,7,1,"C's",43
46,"46138",343,275,272,1,3,"C's",23
16,"16137",54,32,31,1,1,"C's",1
38,"38031",28687,21132,20858,104,274,"C's",1902
50,"50165",1814,1287,1264,26,23,"C's",191
18,"18002",553,395,393,1,2,"C's",22
4,"4003",17357,11157,11075,64,82,"C's",1222
19,"19052",25,21,21,1,0,"C's",3
2,"2036",95,78,78,0,0,"C's",1
6,"6148",966,691,678,8,13,"C's",41
2,"2035",1960,1483,1465,13,18,"C's",233
50,"50069",73,53,53,1,0,"C's",12
22,"22115",360,257,256,3,1,"C's",22
3,"3053",7226,5651,5584,32,67,"C's",967
16,"16001",76,61,61,0,0,"C's",2
12,"12090",102,86,85,1,1,"C's",7
46,"46061",342,274,272,1,2,"C's",48
46,"46217",878,691,676,4,15,"C's",74
44,"44147",412,298,293,5,5,"C's",35
24,"24091",645,454,451,1,3,"C's",44
19,"19176",237,181,181,0,0,"C's",17
34,"34143",168,123,120,2,3,"C's",11
6,"6013",265,212,209,3,3,"C's",8
26,"26155",160,132,132,0,0,"C's",4
20,"20056",4082,2589,2570,27,19,"C's",25
50,"50070",60,36,36,0,0,"C's",2
49,"49004",126,100,100,4,0,"C's",12
13,"13064",1696,1231,1225,9,6,"C's",185
38,"38034",4049,2855,2807,19,48,"C's",251
47,"47011",565,461,458,5,3,"C's",37
46,"46140",344,284,279,0,5,"C's",55
50,"50071",132,92,92,0,0,"C's",5
45,"45085",1500,1011,999,4,12,"C's",127
14,"14064",320,242,236,2,6,"C's",17
18,"18141",404,285,282,0,3,"C's",17
44,"44149",103,78,78,3,0,"C's",7
11,"11035",13593,8375,8276,90,99,"C's",993
47,"47173",880,644,638,20,6,"C's",66
13,"13066",2506,1971,1947,11,24,"C's",145
50,"50168",28,27,27,0,0,"C's",1
31,"31031",220,131,129,0,2,"C's",0
45,"45186",3061,2242,2214,11,28,"C's",136
22,"22004",135,81,80,0,1,"C's",6
26,"26051",239,193,191,1,2,"C's",18
13,"13067",351,281,279,0,2,"C's",10
19,"19057",76,59,59,1,0,"C's",0
5,"5143",66,51,49,0,2,"C's",2
5,"5144",76,55,54,0,1,"C's",3
41,"41080",1274,910,892,6,18,"C's",80
31,"31131",901,646,638,7,8,"C's",55
38,"38036",6592,4518,4440,45,78,"C's",435
49,"49125",1391,933,918,10,15,"C's",112
6,"6153",20377,14329,14163,103,166,"C's",1553
22,"22248",116,92,90,1,2,"C's",17
44,"44252",86,65,65,0,0,"C's",9
20,"20059",8874,5873,5855,29,18,"C's",45
26,"26160",709,552,549,2,3,"C's",55
23,"23101",378,276,271,1,5,"C's",22
13,"13069",660,508,499,7,9,"C's",25
5,"5145",50,40,40,0,0,"C's",3
10,"10137",397,320,317,3,3,"C's",4
31,"31033",49,31,31,1,0,"C's",0
44,"44151",190,151,148,0,3,"C's",10
9,"9223",45,37,37,0,0,"C's",6
49,"49127",2367,1668,1650,16,18,"C's",289
50,"50171",106,79,79,0,0,"C's",12
45,"45188",2785,1960,1938,15,22,"C's",286
31,"31133",43,28,28,0,0,"C's",2
38,"38038",162027,104978,104035,575,943,"C's",13491
28,"28902",471,363,356,4,7,"C's",52
24,"24196",2057,1502,1485,9,17,"C's",105
6,"6156",1175,869,865,8,4,"C's",68
16,"16007",1177,888,880,7,8,"C's",52
23,"23902",2320,1867,1847,4,20,"C's",83
26,"26161",8,7,7,0,0,"C's",0
45,"45189",599,470,462,2,8,"C's",50
35,"35026",81091,51953,51195,407,758,"C's",6954
31,"31035",59,45,43,0,2,"C's",1
48,"48028",717,543,537,3,6,"C's",1
34,"34012",357,269,264,5,5,"C's",30
12,"12095",959,749,742,8,7,"C's",77
24,"24029",735,539,535,3,4,"C's",33
42,"42218",82,55,55,0,0,"C's",7
14,"14068",538,401,398,10,3,"C's",29
19,"19060",146,119,118,1,1,"C's",13
4,"4901",545,395,394,0,1,"C's",31
6,"6021",926,645,636,8,9,"C's",42
16,"16148",573,504,500,4,4,"C's",27
31,"31236",1320,865,854,5,11,"C's",35
47,"47015",200,162,160,0,2,"C's",12
6,"6022",2651,2089,2054,10,35,"C's",164
44,"44153",1774,1135,1121,5,14,"C's",143
37,"37303",190,142,139,1,3,"C's",28
32,"32086",2646,1693,1677,13,16,"C's",89
10,"10142",832,627,621,5,6,"C's",46
22,"22252",121,86,81,0,5,"C's",10
28,"28097",119,94,94,0,0,"C's",13
13,"13074",974,835,828,3,7,"C's",69
6,"6023",4302,3041,3007,16,34,"C's",198
46,"46223",7801,5950,5899,34,51,"C's",869
45,"45191",543,472,468,3,4,"C's",28
40,"40220",66,50,46,1,4,"C's",8
34,"34156",50,45,45,0,0,"C's",3
44,"44260",137,91,89,3,2,"C's",9
29,"29001",4170,3106,3068,19,38,"C's",192
13,"13075",211,164,161,1,3,"C's",14
41,"41085",4086,3058,3012,22,46,"C's",409
18,"18149",5230,3903,3864,20,39,"C's",672
44,"44048",61,52,52,0,0,"C's",4
14,"14071",929,642,630,2,12,"C's",58
34,"34018",209,168,164,1,4,"C's",26
42,"42085",189,129,127,3,2,"C's",6
32,"32088",1622,1018,1002,8,16,"C's",59
11,"11009",605,414,410,1,4,"C's",30
37,"37305",216,171,170,0,1,"C's",23
31,"31137",205,112,109,6,3,"C's",7
31,"31138",932,601,599,2,2,"C's",12
1,"1034",161,124,123,1,1,"C's",1
40,"40140",92,69,67,0,2,"C's",6
19,"19186",81,68,68,0,0,"C's",3
31,"31005",301,212,211,3,1,"C's",11
6,"6026",837,598,591,0,7,"C's",45
3,"3062",212,169,165,0,4,"C's",15
37,"37181",286,210,207,4,3,"C's",11
44,"44261",739,536,529,6,7,"C's",40
5,"5001",191,148,147,2,1,"C's",15
19,"19066",55,48,48,0,0,"C's",6
28,"28101",231,187,187,0,0,"C's",39
45,"45093",155,129,127,1,2,"C's",15
34,"34158",288,186,184,3,2,"C's",26
50,"50206",460,363,357,4,6,"C's",50
9,"9230",38,32,32,0,0,"C's",3
10,"10146",1507,1004,977,7,27,"C's",62
45,"45194",68,54,53,0,1,"C's",7
44,"44050",3113,2120,2100,25,20,"C's",324
22,"22901",742,478,470,5,8,"C's",47
22,"22014",243,192,188,3,4,"C's",20
9,"9100",59,45,44,0,1,"C's",5
49,"49015",227,179,177,0,2,"C's",9
6,"6028",4233,3588,3499,30,89,"C's",212
50,"50177",308,245,244,4,1,"C's",30
26,"26167",59,47,46,1,1,"C's",3
2,"2050",98,83,82,0,1,"C's",7
24,"24101",397,258,257,3,1,"C's",20
5,"5158",367,290,286,6,4,"C's",29
13,"13081",636,480,472,9,8,"C's",15
16,"16016",224,171,168,0,3,"C's",15
9,"9059",136488,101469,100463,907,1006,"C's",16259
6,"6029",1195,855,841,3,14,"C's",44
50,"50080",33,27,27,0,0,"C's",4
18,"18154",1007,664,660,2,4,"C's",39
5,"5007",111,81,80,3,1,"C's",2
42,"42089",54,44,44,0,0,"C's",3
22,"22016",601,413,411,6,2,"C's",37
24,"24004",463,350,348,4,2,"C's",41
50,"50178",293,190,187,0,3,"C's",26
48,"48034",12866,8798,8747,43,51,"C's",447
22,"22131",82,63,63,0,0,"C's",15
33,"33001",1588,887,880,8,7,"C's",53
50,"50270",38,26,26,0,0,"C's",2
42,"42048",66,51,51,0,0,"C's",2
14,"14075",572,448,428,1,20,"C's",36
46,"46228",2348,1815,1794,7,21,"C's",269
31,"31242",260,164,163,1,1,"C's",5
24,"24005",378,260,257,2,3,"C's",13
20,"20069",147046,100691,100232,836,459,"C's",4972
28,"28038",4952,3730,3688,34,42,"C's",567
35,"35033",6398,4340,4266,19,74,"C's",575
9,"9235",156,132,131,3,1,"C's",10
5,"5010",152,117,116,1,1,"C's",7
29,"29007",27491,19071,18910,153,161,"C's",3885
16,"16018",394,318,315,1,3,"C's",22
33,"33002",9995,6765,6672,47,93,"C's",505
49,"49138",234,184,184,3,0,"C's",19
46,"46072",3611,2871,2821,23,50,"C's",328
49,"49139",171,135,135,0,0,"C's",11
9,"9236",38,32,32,0,0,"C's",2
22,"22905",281,209,209,1,0,"C's",40
31,"31044",289,230,227,1,3,"C's",0
7,"7004",3854,2574,2547,30,27,"C's",306
29,"29008",14596,9519,9407,94,112,"C's",1709
49,"49178",705,496,487,4,9,"C's",77
22,"22018",327,245,244,3,1,"C's",27
49,"49263",51,36,36,0,0,"C's",1
42,"42012",35,28,28,0,0,"C's",3
40,"40231",108,90,89,0,1,"C's",11
50,"50053",687,513,510,2,3,"C's",40
34,"34167",113,94,94,0,0,"C's",9
26,"26172",30,23,23,0,0,"C's",4
31,"31244",158,87,86,1,1,"C's",3
16,"16160",60,44,42,1,2,"C's",1
22,"22225",2679,1700,1665,17,35,"C's",214
34,"34029",714,587,570,3,17,"C's",47
46,"46230",13960,10351,10241,54,110,"C's",1486
29,"29099",950,693,685,4,8,"C's",75
7,"7046",15797,9127,9043,86,84,"C's",1199
15,"15040",2753,1905,1880,5,25,"C's",122
49,"49265",128,91,91,1,0,"C's",9
2,"2057",2020,1487,1461,10,26,"C's",129
50,"50274",71,55,55,0,0,"C's",7
5,"5014",5379,4009,3970,18,39,"C's",540
19,"19193",20,19,19,1,0,"C's",4
29,"29010",1651,1278,1237,4,41,"C's",68
49,"49142",249,180,179,0,1,"C's",12
22,"22020",115,86,86,1,0,"C's",14
38,"38051",7194,5158,5080,31,78,"C's",340
44,"44164",27,23,23,0,0,"C's",2
9,"9241",202,156,154,4,2,"C's",30
26,"26174",146,107,105,2,2,"C's",7
31,"31146",35,30,29,1,1,"C's",0
24,"24107",236,175,173,0,2,"C's",14
45,"45201",3447,2082,2050,9,32,"C's",347
10,"10156",97,73,72,1,1,"C's",1
46,"46075",150,130,123,1,7,"C's",16
22,"22021",1971,1414,1398,17,16,"C's",204
38,"38052",1273,883,875,2,8,"C's",80
38,"38053",3735,2469,2435,17,34,"C's",278
39,"39090",756,553,542,0,11,"C's",81
29,"29012",9755,6689,6599,71,90,"C's",659
37,"37059",124,94,93,1,1,"C's",12
19,"19305",155,116,115,0,1,"C's",12
19,"19195",40,32,32,1,0,"C's",0
50,"50183",331,246,246,3,0,"C's",35
46,"46232",895,711,696,5,15,"C's",76
46,"46154",808,636,631,5,5,"C's",97
45,"45203",2563,1801,1771,8,30,"C's",255
50,"50086",187,132,128,2,4,"C's",14
49,"49267",88,73,69,2,4,"C's",7
33,"33007",1514,946,942,12,4,"C's",51
24,"24010",8386,5708,5632,60,76,"C's",704
28,"28043",5921,3803,3759,18,44,"C's",495
34,"34033",17,17,17,0,0,"C's",3
40,"40903",86,67,67,0,0,"C's",5
50,"50087",26,17,17,1,0,"C's",3
47,"47026",46,40,40,1,0,"C's",3
26,"26176",53,44,44,1,0,"C's",1
45,"45103",397,331,327,3,4,"C's",5
44,"44168",189,139,138,2,1,"C's",16
16,"16166",243,176,174,1,2,"C's",11
42,"42098",10,7,7,1,0,"C's",1
50,"50185",133,108,108,1,0,"C's",13
9,"9244",46,34,34,1,0,"C's",1
16,"16167",316,249,244,1,5,"C's",16
13,"13043",231,180,179,1,1,"C's",9
40,"40112",2555,1932,1909,8,23,"C's",391
9,"9384",295,211,206,0,5,"C's",26
50,"50088",302,246,237,5,9,"C's",22
13,"13096",7652,5480,5415,19,65,"C's",713
47,"47188",111,88,88,3,0,"C's",7
5,"5171",74,52,50,1,2,"C's",7
24,"24012",290,207,205,1,2,"C's",31
6,"6133",1775,1324,1312,15,12,"C's",77
10,"10207",504,357,350,6,7,"C's",16
31,"31051",251,170,170,2,0,"C's",14
1,"1009",1265,849,845,2,4,"C's",11
31,"31150",213,156,155,1,1,"C's",3
20,"20078",1155,850,846,4,4,"C's",4
47,"47109",179,138,138,2,0,"C's",23
40,"40905",133,103,100,1,3,"C's",8
7,"7013",6881,4693,4587,39,106,"C's",548
12,"12010",259,213,208,2,5,"C's",23
50,"50187",69,44,44,0,0,"C's",0
39,"39094",848,655,651,3,4,"C's",75
12,"12079",399,316,314,2,2,"C's",34
10,"10163",350,293,290,2,3,"C's",19
44,"44063",71,54,54,0,0,"C's",9
40,"40115",101,86,85,1,1,"C's",10
2,"2064",372,325,324,1,1,"C's",28
19,"19309",26,21,21,0,0,"C's",2
46,"46157",2980,2321,2298,10,23,"C's",214
5,"5174",68,53,53,2,0,"C's",7
22,"22144",243,188,187,1,1,"C's",11
7,"7014",7320,4163,4116,45,47,"C's",468
26,"26072",281,254,254,0,0,"C's",20
34,"34038",277,204,203,1,1,"C's",31
10,"10164",737,484,475,3,9,"C's",24
9,"9248",78,59,59,1,0,"C's",9
19,"19201",58,49,48,1,1,"C's",8
18,"18173",8939,5922,5849,42,73,"C's",631
2,"2066",234,189,187,1,2,"C's",12
50,"50091",41,36,36,0,0,"C's",6
5,"5175",159,131,131,1,0,"C's",18
5,"5026",195,166,164,2,2,"C's",5
28,"28115",60892,49705,49510,209,195,"C's",10160
37,"37199",142,105,105,1,0,"C's",19
7,"7016",2809,1865,1836,23,29,"C's",271
37,"37327",185,149,146,3,3,"C's",30
10,"10028",90,73,73,0,0,"C's",3
13,"13904",531,400,392,4,8,"C's",30
50,"50189",705,527,519,13,8,"C's",44
3,"3076",8467,6238,6157,30,81,"C's",797
50,"50220",40,32,32,0,0,"C's",3
31,"31254",1915,1428,1411,3,17,"C's",76
41,"41003",2333,1693,1671,13,22,"C's",149
49,"49152",525,339,334,2,5,"C's",41
19,"19089",30,22,22,0,0,"C's",1
7,"7057",7169,4719,4659,47,60,"C's",540
47,"47191",108,79,79,0,0,"C's",11
23,"23007",3087,2205,2187,6,18,"C's",190
36,"36011",1799,1144,1122,8,22,"C's",43
49,"49153",174,136,132,0,4,"C's",23
16,"16035",261,203,198,4,5,"C's",24
40,"40120",192,170,166,0,4,"C's",27
41,"41092",7743,5358,5311,55,47,"C's",515
45,"45009",524,344,341,2,3,"C's",10
5,"5178",368,284,280,0,4,"C's",30
47,"47192",102,83,81,1,2,"C's",10
39,"39097",697,371,368,2,3,"C's",40
22,"22155",76,51,51,0,0,"C's",9
24,"24219",516,387,386,4,1,"C's",33
41,"41093",18554,13978,13874,99,104,"C's",2478
36,"36013",2344,1536,1514,11,22,"C's",90
12,"12014",184,144,143,2,1,"C's",12
37,"37202",978,734,727,10,7,"C's",167
18,"18038",1066,828,802,1,26,"C's",50
29,"29021",161,108,107,4,1,"C's",3
50,"50191",470,310,308,1,2,"C's",38
47,"47031",189,145,145,1,0,"C's",16
27,"27002",1633,1137,1108,9,29,"C's",48
5,"5034",14,13,13,0,0,"C's",0
42,"42111",303,229,227,2,2,"C's",17
27,"27003",1876,1344,1320,12,24,"C's",81
36,"36014",1942,1459,1444,9,15,"C's",70
2,"2071",1011,831,825,5,6,"C's",49
46,"46083",15422,11179,11049,86,130,"C's",1412
1,"1017",849,571,565,5,6,"C's",12
24,"24118",126,88,88,1,0,"C's",5
28,"28118",57,46,45,0,1,"C's",4
39,"39100",860,633,629,15,4,"C's",81
50,"50193",651,514,501,2,13,"C's",100
10,"10171",344,245,244,0,1,"C's",5
34,"34046",41,36,35,0,1,"C's",2
31,"31058",208,148,144,3,4,"C's",7
19,"19092",409,306,300,1,6,"C's",47
40,"40124",237,182,177,6,5,"C's",17
45,"45112",1922,1247,1211,6,36,"C's",108
42,"42115",61,47,47,1,0,"C's",4
29,"29022",179,137,136,0,1,"C's",13
46,"46162",1189,938,929,3,9,"C's",78
18,"18040",231,136,133,0,3,"C's",10
4,"4032",5586,3642,3623,23,19,"C's",524
27,"27005",2595,1846,1816,13,30,"C's",106
5,"5183",138,111,110,0,1,"C's",10
10,"10173",577,400,399,5,1,"C's",36
7,"7063",1418,1043,1033,6,10,"C's",136
37,"37333",224,142,142,1,0,"C's",27
26,"26079",634,520,512,4,8,"C's",46
2,"2073",4867,3520,3474,40,46,"C's",393
45,"45013",1758,1352,1329,8,23,"C's",93
31,"31259",484,291,286,2,5,"C's",6
46,"46241",392,299,291,1,8,"C's",40
9,"9257",93,81,80,4,1,"C's",6
39,"39010",631,480,475,7,5,"C's",43
39,"39101",274,197,192,3,5,"C's",11
31,"31159",1107,844,833,6,11,"C's",28
7,"7064",5315,3475,3434,31,41,"C's",510
4,"4033",135,97,93,1,4,"C's",11
19,"19096",91,72,69,0,3,"C's",6
24,"24120",341,246,244,1,2,"C's",31
29,"29025",39665,25907,25714,192,193,"C's",4811
34,"34190",56,41,40,2,1,"C's",5
50,"50287",270,191,191,0,0,"C's",19
50,"50099",3083,2148,2132,13,16,"C's",255
46,"46164",11771,8564,8483,64,81,"C's",1307
37,"37079",77,73,73,1,0,"C's",13
50,"50195",54,40,40,0,0,"C's",6
18,"18182",1906,1298,1288,4,10,"C's",137
46,"46086",82,70,69,1,1,"C's",2
10,"10038",87,68,68,0,0,"C's",3
9,"9258",172,141,139,5,2,"C's",12
15,"15057",12075,8479,8377,66,102,"C's",651
6,"6057",576,479,471,0,8,"C's",16
9,"9128",80,63,63,0,0,"C's",5
9,"9259",230,186,186,5,0,"C's",17
45,"45116",687,509,505,1,4,"C's",41
16,"16044",39,30,30,0,0,"C's",1
16,"16188",91,65,65,0,0,"C's",6
27,"27011",2452,1494,1467,19,27,"C's",77
33,"33019",3072,2020,2005,18,15,"C's",202
49,"49039",338,245,239,3,6,"C's",31
48,"48053",895,666,662,6,4,"C's",30
3,"3084",539,454,446,3,8,"C's",43
47,"47117",301,233,227,2,6,"C's",41
42,"42120",145,91,89,2,2,"C's",5
29,"29027",2326,1626,1609,12,17,"C's",153
16,"16190",5105,3945,3887,17,58,"C's",422
4,"4035",8364,5810,5766,28,44,"C's",549
9,"9129",104,83,83,0,0,"C's",6
9,"9400",317,247,245,1,2,"C's",22
23,"23017",1572,1269,1257,4,12,"C's",63
46,"46088",166,125,125,4,0,"C's",7
39,"39014",883,619,614,6,5,"C's",77
46,"46244",58771,42137,41867,270,270,"C's",6784
27,"27013",3766,2900,2851,25,49,"C's",120
50,"50198",54,41,41,1,0,"C's",6
48,"48054",24171,16797,16711,118,86,"C's",766
41,"41012",3290,2071,2030,20,41,"C's",200
46,"46166",8155,6320,6251,30,69,"C's",875
3,"3085",272,217,213,0,4,"C's",29
34,"34053",207,170,169,3,1,"C's",10
5,"5044",266,183,183,1,0,"C's",7
31,"31164",568,421,417,5,4,"C's",20
48,"48055",2668,1872,1849,11,23,"C's",28
40,"40004",459,356,352,2,4,"C's",37
2,"2080",528,406,400,2,6,"C's",37
24,"24026",1177,864,849,7,15,"C's",88
10,"10181",686,533,523,1,10,"C's",43
9,"9131",462,365,364,2,1,"C's",55
10,"10043",800,562,553,3,9,"C's",27
46,"46167",364,266,264,0,2,"C's",14
19,"19216",131,98,98,0,0,"C's",11
39,"39015",839,647,642,4,5,"C's",96
41,"41013",4839,3151,3094,33,57,"C's",149
22,"22043",93,66,65,0,1,"C's",4
7,"7030",1551,1127,1101,13,26,"C's",77
29,"29029",403,298,294,2,4,"C's",21
31,"31265",82,53,53,2,0,"C's",2
44,"44218",35,28,28,1,0,"C's",3
9,"9010",32,23,23,1,0,"C's",1
12,"12025",136,104,104,0,0,"C's",2
44,"44184",45,34,34,0,0,"C's",0
31,"31901",15459,11119,11026,108,93,"C's",667
33,"33023",3321,2299,2265,31,34,"C's",225
15,"15027",1536,1182,1155,6,27,"C's",101
14,"14011",578,464,462,4,2,"C's",31
21,"21006",3368,2182,2146,13,36,"C's",154
34,"34204",46,41,41,0,0,"C's",5
50,"50105",296,214,211,1,3,"C's",14
37,"37343",60,47,47,0,0,"C's",17
16,"16194",242,185,179,1,6,"C's",15
47,"47040",64,53,53,0,0,"C's",5
26,"26087",201,153,149,3,4,"C's",22
3,"3089",9571,6775,6639,47,136,"C's",926
5,"5194",140,119,116,1,3,"C's",15
46,"46091",118,94,94,0,0,"C's",12
50,"50201",448,339,335,7,4,"C's",55
4,"4043",549,465,461,1,4,"C's",35
39,"39017",569,398,391,4,7,"C's",44
18,"18192",1538,1151,1123,6,28,"C's",103
47,"47122",2032,1563,1535,7,28,"C's",176
6,"6065",311,236,228,1,8,"C's",8
40,"40008",44,39,39,1,0,"C's",2
3,"3090",17182,12487,12385,74,102,"C's",2183
40,"40136",112,88,87,0,1,"C's",18
40,"40051",38,34,34,0,0,"C's",2
27,"27020",3524,2816,2761,28,55,"C's",99
28,"28127",64827,51776,51613,220,163,"C's",12162
37,"37218",67,42,41,0,1,"C's",2
16,"16196",633,508,503,2,5,"C's",26
27,"27021",1753,1090,1056,12,34,"C's",61
37,"37090",52,43,43,0,0,"C's",1
5,"5052",95,77,76,0,1,"C's",8
50,"50295",48,43,42,0,1,"C's",6
16,"16052",547,418,416,2,2,"C's",51
36,"36027",4430,3137,3101,15,36,"C's",221
19,"19220",2302,1519,1501,1,18,"C's",315
27,"27022",4833,3022,2954,30,68,"C's",176
47,"47205",384,266,260,0,6,"C's",38
37,"37219",173,109,108,0,1,"C's",11
18,"18054",849,606,605,7,1,"C's",64
41,"41018",9480,6523,6455,53,68,"C's",598
2,"2086",2586,1701,1687,7,14,"C's",113
37,"37091",177,117,116,1,1,"C's",12
27,"27023",2579,1891,1865,23,26,"C's",81
28,"28061",21389,16277,16135,67,142,"C's",3232
48,"48060",3634,2143,2134,7,9,"C's",15
47,"47124",392,316,311,3,5,"C's",43
9,"9016",85,60,59,3,1,"C's",7
34,"34061",106,82,82,1,0,"C's",21
40,"40012",269,192,191,2,1,"C's",21
1,"1033",651,484,479,2,5,"C's",24
19,"19221",48,38,37,1,1,"C's",1
37,"37092",1758,1225,1215,8,10,"C's",332
3,"3093",19683,14633,14484,70,149,"C's",2451
16,"16199",30,25,25,1,0,"C's",4
37,"37096",214,166,163,2,3,"C's",12
40,"40097",128,93,92,0,1,"C's",12
36,"36029",16077,11617,11471,100,146,"C's",1017
45,"45126",260,176,175,3,1,"C's",22
16,"16056",457,306,305,3,1,"C's",31
47,"47069",124,105,104,1,1,"C's",12
50,"50046",178,133,133,5,0,"C's",17
49,"49172",527,347,343,1,4,"C's",20
5,"5200",44,31,30,1,1,"C's",3
31,"31072",5279,3734,3679,40,55,"C's",345
12,"12032",23525,17093,16966,104,127,"C's",2779
47,"47044",331,293,290,2,3,"C's",45
30,"30020",6303,4543,4497,25,46,"C's",380
4,"4047",2281,1893,1878,11,15,"C's",181
9,"9017",89,68,67,4,1,"C's",6
42,"42006",163,109,107,2,2,"C's",15
19,"19335",55,47,47,0,0,"C's",8
29,"29036",632,423,416,2,7,"C's",23
16,"16106",2727,2009,1989,12,20,"C's",124
41,"41021",21294,13762,13570,145,192,"C's",1709
14,"14016",1337,1072,1060,2,12,"C's",58
50,"50111",180,143,143,0,0,"C's",13
50,"50017",1773,1276,1269,13,7,"C's",244
3,"3095",4579,3489,3459,25,30,"C's",423
24,"24034",3394,2380,2342,28,38,"C's",245
36,"36031",558,465,459,7,6,"C's",33
21,"21014",4016,3025,2991,21,34,"C's",267
28,"28132",11685,8130,8062,56,68,"C's",1456
37,"37351",281,229,227,0,2,"C's",29
5,"5058",78,49,48,0,1,"C's",7
31,"31173",861,683,667,3,16,"C's",21
37,"37099",73,41,41,0,0,"C's",1
30,"30022",16913,11371,11214,93,157,"C's",1383
27,"27030",3327,2207,2159,31,48,"C's",114
12,"12001",1051,821,800,4,21,"C's",64
19,"19112",60,46,46,0,0,"C's",6
5,"5205",74,57,55,1,2,"C's",5
31,"31074",387,286,286,5,0,"C's",5
18,"18063",1200,679,675,2,4,"C's",58
37,"37100",80,61,61,1,0,"C's",10
9,"9276",382,251,240,3,11,"C's",22
26,"26096",245,190,190,1,0,"C's",29
34,"34068",27,22,22,0,0,"C's",0
41,"41023",7905,5402,5347,41,55,"C's",530
42,"42009",78,63,63,0,0,"C's",12
32,"32002",2017,1413,1398,16,15,"C's",84
16,"16270",162,137,137,0,0,"C's",10
18,"18157",1121,815,803,3,12,"C's",120
18,"18064",377,291,290,2,1,"C's",21
5,"5207",692,547,543,0,4,"C's",50
31,"31075",103,63,63,0,0,"C's",0
9,"9021",56,33,31,1,2,"C's",4
37,"37229",135,112,112,0,0,"C's",18
4,"4050",800,558,553,3,5,"C's",51
20,"20003",547,308,308,3,0,"C's",1
22,"22053",789,520,513,9,7,"C's",46
12,"12133",59,53,52,0,1,"C's",5
34,"34114",207,144,144,0,0,"C's",8
37,"37355",178,142,142,1,0,"C's",16
3,"3006",497,384,380,1,4,"C's",40
37,"37230",221,159,159,2,0,"C's",19
46,"46020",3760,2916,2866,22,50,"C's",328
20,"20004",252,121,121,0,0,"C's",0
7,"7044",8439,5681,5543,48,138,"C's",531
37,"37103",436,310,308,8,2,"C's",27
41,"41025",2020,1361,1320,7,41,"C's",114
5,"5063",32,28,27,0,1,"C's",1
18,"18112",123,82,82,2,0,"C's",9
10,"10060",967,648,640,2,8,"C's",49
29,"29042",14016,9368,9192,88,176,"C's",1932
33,"33064",234,168,167,1,1,"C's",14
45,"45032",436,283,275,1,8,"C's",42
31,"31078",2429,1795,1767,15,28,"C's",140
5,"5210",87,70,69,0,1,"C's",14
46,"46177",4690,3579,3526,19,53,"C's",436
19,"19116",12,9,9,0,0,"C's",1
3,"3007",166,139,137,0,2,"C's",20
28,"28040",15811,10118,10009,56,109,"C's",1742
4,"4053",12320,8946,8866,70,80,"C's",1416
3,"3100",503,440,437,0,3,"C's",48
10,"10062",406,337,331,0,6,"C's",30
39,"39058",810,559,557,2,2,"C's",48
6,"6034",171,121,120,4,1,"C's",9
22,"22182",250,161,158,1,3,"C's",19
5,"5065",471,394,392,4,2,"C's",54
1,"1044",236,169,167,0,2,"C's",4
50,"50023",224,175,175,0,0,"C's",21
21,"21021",12254,7339,7244,78,95,"C's",970
44,"44097",142,92,92,0,0,"C's",12
12,"12136",2635,2201,2171,18,30,"C's",266
34,"34222",120,87,87,3,0,"C's",5
34,"34223",218,155,155,1,0,"C's",21
9,"9421",230,166,163,3,3,"C's",12
4,"4054",358,285,281,2,4,"C's",6
40,"40150",69,61,61,1,0,"C's",10
16,"16276",21,16,16,1,0,"C's",2
15,"15041",9568,6828,6710,75,118,"C's",598
9,"9025",122,83,83,1,0,"C's",9
46,"46101",860,716,705,3,11,"C's",47
18,"18911",7473,5098,5035,51,63,"C's",927
42,"42015",30,20,19,1,1,"C's",0
27,"27041",2341,1718,1705,16,13,"C's",91
20,"20007",310,218,218,3,0,"C's",1
1,"1047",968,673,668,5,5,"C's",60
31,"31081",338,216,212,4,4,"C's",6
10,"10065",206,156,155,1,1,"C's",12
50,"50120",52,40,40,1,0,"C's",7
16,"16070",30,26,26,1,0,"C's",2
18,"18070",288,227,226,0,1,"C's",34
37,"37360",225,174,173,1,1,"C's",28
26,"26104",13,10,10,0,0,"C's",1
16,"16071",20,20,20,0,0,"C's",4
4,"4055",371,310,308,0,2,"C's",12
27,"27042",1740,1235,1218,12,17,"C's",42
7,"7050",3348,2156,2139,19,17,"C's",216
5,"5070",30,27,27,0,0,"C's",1
45,"45035",281,212,209,1,3,"C's",10
9,"9154",137,98,97,2,1,"C's",12
10,"10067",10422,7113,7014,62,99,"C's",751
28,"28140",3007,2276,2256,7,20,"C's",433
24,"24043",134,75,75,1,0,"C's",3
19,"19233",80,65,63,1,2,"C's",4
32,"32012",784,505,497,2,8,"C's",30
1,"1049",138,109,109,1,0,"C's",0
6,"6086",1221,814,799,2,15,"C's",58
22,"22060",1164,858,850,3,8,"C's",119
46,"46025",2499,1953,1934,8,19,"C's",285
9,"9289",1451,1014,1000,5,14,"C's",118
48,"48072",977,716,713,4,3,"C's",1
41,"41031",1238,825,814,11,11,"C's",48
27,"27045",1038,613,603,10,10,"C's",29
26,"26003",413,331,329,2,2,"C's",18
7,"7052",4667,2908,2886,29,22,"C's",415
31,"31183",691,544,542,4,2,"C's",36
21,"21067",414,288,287,1,1,"C's",18
15,"15083",1086,757,746,5,11,"C's",29
48,"48042",1369,1068,1053,7,15,"C's",34
34,"34126",277,200,199,2,1,"C's",16
29,"29048",1405,1121,1110,8,11,"C's",41
49,"49186",261,188,185,0,3,"C's",16
22,"22061",6630,4555,4526,40,29,"C's",747
10,"10208",123,94,93,1,1,"C's",5
9,"9030",112,75,73,1,2,"C's",11
33,"33040",4549,2986,2942,35,44,"C's",320
15,"15046",6332,4377,4262,40,115,"C's",285
31,"31184",62,44,44,3,0,"C's",3
49,"49068",462,310,304,4,6,"C's",10
49,"49187",1236,896,888,4,8,"C's",99
16,"16170",692,501,493,4,8,"C's",28
37,"37365",172,134,133,1,1,"C's",19
4,"4058",354,261,259,1,2,"C's",24
10,"10209",282,179,177,1,2,"C's",5
46,"46183",5993,4443,4381,19,62,"C's",554
40,"40157",47,44,44,0,0,"C's",7
19,"19237",47,38,38,0,0,"C's",4
46,"46105",16190,11323,11206,44,117,"C's",1241
22,"22063",169,133,129,1,4,"C's",11
44,"44105",82,64,64,0,0,"C's",7
6,"6090",869,617,602,3,15,"C's",33
48,"48074",3312,2330,2309,6,21,"C's",39
31,"31219",84,66,66,0,0,"C's",5
28,"28074",138947,103687,102762,620,925,"C's",16347
19,"19238",42,28,28,0,0,"C's",2
18,"18079",3441,2442,2411,16,31,"C's",159
49,"49189",202,142,142,1,0,"C's",4
16,"16231",46,37,37,0,0,"C's",4
37,"37116",69,50,50,0,0,"C's",4
46,"46184",26505,20428,20223,115,205,"C's",2673
20,"20014",1108,611,609,4,2,"C's",4
29,"29051",40391,25780,25419,232,361,"C's",4231
24,"24049",1483,1054,1048,6,6,"C's",82
9,"9164",157,127,126,0,1,"C's",14
14,"14028",314,253,249,1,4,"C's",18
34,"34084",138,109,107,0,2,"C's",8
22,"22195",235,182,181,3,1,"C's",35
3,"3109",2850,2181,2164,8,17,"C's",221
48,"48015",33581,22727,22528,122,199,"C's",695
15,"15049",1098,758,752,7,6,"C's",45
48,"48076",308,218,217,2,1,"C's",1
26,"26008",1860,1399,1387,5,12,"C's",134
40,"40033",58,51,51,0,0,"C's",9
31,"31121",62,44,43,0,1,"C's",1
46,"46133",533,415,410,6,5,"C's",19
42,"42158",103,76,76,0,0,"C's",7
14,"14029",4178,3047,3009,28,38,"C's",255
42,"42024",86,61,59,0,2,"C's",7
10,"10213",566,469,463,0,6,"C's",29
4,"4062",4504,3534,3490,18,44,"C's",316
49,"49191",272,213,206,2,7,"C's",13
24,"24152",464,295,291,1,4,"C's",22
28,"28020",145,94,94,0,0,"C's",9
29,"29053",1699,1105,1091,14,14,"C's",181
9,"9301",625,473,467,2,6,"C's",83
3,"3017",374,314,307,1,7,"C's",30
45,"45043",793,657,649,1,8,"C's",57
9,"9167",58,41,41,1,0,"C's",3
40,"40162",392,303,302,1,1,"C's",35
18,"18084",4257,3107,3075,26,32,"C's",481
4,"4063",1096,776,768,2,8,"C's",94
23,"23049",1813,1238,1222,9,16,"C's",69
16,"16084",48,38,37,1,1,"C's",4
3,"3111",5436,3918,3883,18,35,"C's",510
49,"49238",254,194,193,1,1,"C's",19
41,"41038",100095,67313,66687,760,626,"C's",10901
16,"16239",135,110,105,0,5,"C's",9
37,"37371",272,165,162,1,3,"C's",13
29,"29054",41997,28422,28238,189,184,"C's",4854
32,"32023",1210,862,849,4,13,"C's",33
30,"30036",14698,9859,9734,41,125,"C's",1498
10,"10079",894,662,648,7,14,"C's",66
13,"13003",480,382,380,1,2,"C's",19
27,"27056",1248,848,836,9,12,"C's",48
33,"33045",4487,3057,2999,28,58,"C's",303
24,"24053",442,286,280,1,6,"C's",27
9,"9303",86,68,68,0,0,"C's",3
10,"10217",526,404,402,1,2,"C's",26
16,"16240",102,78,78,0,0,"C's",6
45,"45046",2412,1667,1654,7,13,"C's",128
29,"29055",1796,1354,1336,11,18,"C's",140
50,"50223",920,712,701,4,11,"C's",51
46,"46188",672,544,537,8,7,"C's",75
50,"50034",826,567,563,5,4,"C's",71
32,"32025",1079,791,777,1,14,"C's",40
48,"48080",9976,6820,6763,62,57,"C's",148
13,"13005",23298,17250,17070,140,180,"C's",2413
5,"5085",35,27,27,0,0,"C's",3
31,"31092",662,439,435,4,4,"C's",12
37,"37029",209,137,135,1,2,"C's",19
50,"50286",77,50,50,3,0,"C's",6
20,"20019",9986,6428,6392,48,36,"C's",148
24,"24054",430,314,313,1,1,"C's",30
40,"40166",253,218,215,1,3,"C's",25
4,"4065",363,284,282,7,2,"C's",17
47,"47223",157,122,118,2,4,"C's",15
40,"40039",210,156,153,3,3,"C's",13
27,"27060",2598,1690,1665,19,25,"C's",87
46,"46033",191,156,155,0,1,"C's",9
37,"37125",228,161,156,0,5,"C's",22
9,"9041",28,27,27,0,0,"C's",3
38,"38030",1933,1296,1290,2,6,"C's",117
15,"15056",5722,3869,3818,46,51,"C's",368
34,"34241",18,13,13,1,0,"C's",2
18,"18089",14719,10163,10099,63,64,"C's",1153
1,"1060",197,160,157,0,3,"C's",8
16,"16244",718,593,587,6,6,"C's",45
10,"10902",721,548,540,4,8,"C's",35
3,"3021",5613,4570,4500,26,70,"C's",691
32,"32028",1610,1211,1189,16,22,"C's",59
26,"26014",474,327,324,1,3,"C's",22
48,"48915",362,227,226,0,1,"C's",3
10,"10084",1345,888,875,4,13,"C's",60
50,"50257",171,134,134,2,0,"C's",11
45,"45149",556,446,440,0,6,"C's",26
24,"24057",1373,1045,1023,11,22,"C's",111
24,"24090",343,235,233,1,2,"C's",18
6,"6102",1048,843,825,6,18,"C's",40
9,"9173",124,100,99,2,1,"C's",7
45,"45049",433,305,304,1,1,"C's",29
40,"40170",1320,1030,1021,7,9,"C's",136
47,"47145",603,448,441,3,7,"C's",44
45,"45050",457,333,328,1,5,"C's",33
19,"19135",107,90,90,3,0,"C's",6
44,"44007",173,122,121,4,1,"C's",16
49,"49202",187,130,130,4,0,"C's",12
27,"27064",1581,1097,1068,12,29,"C's",59
26,"26015",196,158,157,2,1,"C's",12
12,"12056",282,236,231,1,5,"C's",30
28,"28153",697,499,499,1,0,"C's",89
9,"9309",301,224,220,0,4,"C's",22
1,"1063",1798,1269,1261,19,8,"C's",58
36,"36057",236673,169244,167605,1366,1639,"C's",15912
5,"5092",152,125,122,0,3,"C's",12
45,"45051",1590,1171,1152,5,19,"C's",114
42,"42033",48,45,45,1,0,"C's",0
39,"39044",3849,2765,2732,21,33,"C's",433
27,"27066",12696,8704,8537,98,167,"C's",620
50,"50039",491,392,390,2,2,"C's",28
37,"37254",181,142,141,0,1,"C's",17
46,"46114",569,461,458,1,3,"C's",65
37,"37379",174,133,131,1,2,"C's",12
46,"46036",564,383,378,5,5,"C's",42
9,"9046",29,25,25,0,0,"C's",0
16,"16095",83,64,63,0,1,"C's",1
31,"31097",10410,7082,7002,75,80,"C's",386
40,"40173",138,99,93,1,6,"C's",21
36,"36058",4994,3292,3243,33,49,"C's",245
27,"27901",2386,1596,1569,25,27,"C's",81
12,"12058",71,63,62,1,1,"C's",7
46,"46252",118,99,98,0,1,"C's",7
49,"49086",115,96,91,0,5,"C's",10
47,"47147",116,92,92,0,0,"C's",8
46,"46193",8788,6925,6871,50,54,"C's",1120
3,"3118",2437,1659,1642,4,17,"C's",211
45,"45053",8005,6211,6140,42,71,"C's",709
44,"44010",175,130,128,1,2,"C's",12
12,"12059",231,189,188,2,1,"C's",11
26,"26122",118,102,102,0,0,"C's",17
6,"6108",2275,1567,1527,11,40,"C's",167
13,"13016",664,517,509,4,8,"C's",57
16,"16096",274,232,229,1,3,"C's",15
28,"28001",61,46,45,0,1,"C's",1
31,"31132",145,109,109,0,0,"C's",8
44,"44011",52,40,38,0,2,"C's",6
5,"5096",80,60,59,0,1,"C's",5
47,"47065",857,674,669,1,5,"C's",63
45,"45054",3959,2882,2848,12,34,"C's",370
49,"49088",87,61,60,0,1,"C's",5
5,"5241",3063,2056,2032,15,24,"C's",303
21,"21046",1705,1099,996,16,103,"C's",65
40,"40176",395,306,305,2,1,"C's",25
9,"9178",47,35,35,0,0,"C's",0
23,"23060",19003,12924,12812,102,112,"C's",1640
26,"26020",476,349,339,3,10,"C's",19
44,"44012",334,263,261,5,2,"C's",25
29,"29064",503,348,339,8,9,"C's",24
47,"47066",1268,981,977,12,4,"C's",159
18,"18099",1584,1228,1206,14,22,"C's",155
44,"44219",194,145,143,1,2,"C's",18
46,"46254",1000,785,779,6,6,"C's",77
45,"45055",1020,821,790,6,31,"C's",59
44,"44220",121,84,83,1,1,"C's",10
13,"13019",5181,3621,3579,18,42,"C's",418
45,"45155",355,291,285,0,6,"C's",15
6,"6111",500,337,337,1,0,"C's",22
49,"49208",394,248,244,2,4,"C's",13
15,"15066",4009,2814,2776,33,38,"C's",218
32,"32038",436,278,271,2,7,"C's",11
26,"26125",2699,1931,1907,23,24,"C's",221
45,"45089",1495,1102,1094,0,8,"C's",114
49,"49009",393,293,288,2,5,"C's",24
23,"23062",1454,1141,1128,1,13,"C's",47
20,"20028",2237,1373,1365,11,8,"C's",18
2,"2003",132346,95878,95217,630,661,"C's",17378
50,"50075",80,62,61,1,1,"C's",1
45,"45090",384,294,293,3,1,"C's",24
31,"31201",147715,105455,104658,1007,797,"C's",5879
28,"28158",665,537,533,4,4,"C's",90
41,"41050",5150,3817,3777,19,40,"C's",375
42,"42039",226,138,138,4,0,"C's",17
18,"18101",9265,6618,6560,59,58,"C's",1128
18,"18102",8400,5592,5504,44,88,"C's",509
50,"50235",2339,1664,1648,11,16,"C's",307
22,"22082",291,213,212,1,1,"C's",43
11,"11007",17964,10038,9856,197,182,"C's",1155
28,"28004",6234,4202,4167,16,35,"C's",666
19,"19255",79,63,61,1,2,"C's",3
9,"9181",300,221,221,0,0,"C's",28
49,"49210",471,370,365,1,5,"C's",15
46,"46119",780,653,647,5,6,"C's",49
31,"31103",42,34,34,2,0,"C's",0
44,"44121",60,47,47,2,0,"C's",2
15,"15068",5049,3185,3129,25,56,"C's",217
29,"29091",8957,6186,6078,56,108,"C's",686
45,"45158",2514,1777,1760,11,17,"C's",151
13,"13023",8973,6291,6242,44,49,"C's",673
10,"10097",101,75,74,0,1,"C's",12
24,"24065",2138,1503,1472,15,31,"C's",227
45,"45059",1712,1337,1311,1,26,"C's",144
9,"9055",52,42,41,1,1,"C's",4
24,"24032",109,91,89,0,2,"C's",4
47,"47232",102,77,74,1,3,"C's",9
44,"44122",1333,925,913,8,12,"C's",133
47,"47152",78,60,60,0,0,"C's",6
16,"16012",84,72,71,0,1,"C's",0
11,"11042",1186,868,858,7,10,"C's",81
49,"49013",246,182,181,2,1,"C's",21
24,"24066",494,368,366,4,2,"C's",27
2,"2008",1193,857,847,7,10,"C's",77
22,"22085",104,86,86,0,0,"C's",10
31,"31006",1927,1350,1332,13,18,"C's",73
5,"5106",35,25,25,0,0,"C's",1
50,"50237",101,74,73,1,1,"C's",6
41,"41054",692,560,546,3,14,"C's",58
24,"24168",460,361,359,0,2,"C's",46
10,"10100",799,578,574,4,4,"C's",36
20,"20032",8797,5672,5630,40,42,"C's",141
35,"35004",39299,20523,20294,140,229,"C's",2235
26,"26026",1321,1039,1025,6,14,"C's",94
44,"44225",107,74,74,1,0,"C's",14
45,"45160",1109,874,864,6,10,"C's",97
6,"6118",192,145,144,1,1,"C's",5
19,"19151",1064,744,726,1,18,"C's",105
9,"9189",125,90,87,2,3,"C's",10
37,"37007",437,314,306,3,8,"C's",33
47,"47154",152,128,125,1,3,"C's",10
21,"21054",8100,5656,5571,46,85,"C's",721
35,"35005",1048,747,737,8,10,"C's",57
20,"20034",3145,2026,2014,14,12,"C's",29
33,"33061",378,202,200,0,2,"C's",17
6,"6119",689,501,499,4,2,"C's",33
16,"16269",419,336,332,2,4,"C's",17
28,"28008",1799,1182,1174,4,8,"C's",159
37,"37268",112,76,76,0,0,"C's",13
44,"44020",24,20,19,1,1,"C's",2
9,"9454",43,34,33,0,1,"C's",7
21,"21056",2895,1990,1906,18,84,"C's",127
26,"26028",134,113,112,0,1,"C's",11
24,"24102",652,470,467,2,3,"C's",36
32,"32048",895,574,569,5,5,"C's",13
4,"4080",209,162,162,3,0,"C's",15
3,"3129",1194,957,938,0,19,"C's",152
5,"5256",112,100,98,1,2,"C's",12
19,"19032",165,126,124,1,2,"C's",7
19,"19299",97,79,77,1,2,"C's",11
26,"26029",37,32,32,0,0,"C's",1
19,"19154",68,56,54,0,2,"C's",2
10,"10104",5119,3633,3585,15,48,"C's",417
40,"40186",42,29,29,0,0,"C's",4
18,"18111",2765,1949,1936,18,13,"C's",303
4,"4081",355,287,287,0,0,"C's",18
46,"46202",16947,12814,12710,79,104,"C's",2390
49,"49223",752,608,600,4,8,"C's",47
9,"9455",45,33,33,0,0,"C's",4
9,"9060",145,114,113,2,1,"C's",9
37,"37186",104,85,85,2,0,"C's",11
22,"22089",302,225,223,0,2,"C's",20
39,"39056",2286,1714,1684,8,30,"C's",255
40,"40060",82,61,61,0,0,"C's",5
15,"15075",12336,8830,8725,91,105,"C's",1025
28,"28011",442,317,316,1,1,"C's",47
5,"5113",71,56,56,0,0,"C's",7
47,"47075",4856,3681,3637,24,44,"C's",554
19,"19263",26,15,15,1,0,"C's",0
26,"26030",16,16,15,0,1,"C's",4
31,"31243",306,224,221,2,3,"C's",15
22,"22181",92,61,61,2,0,"C's",9
22,"22223",75,58,58,0,0,"C's",7
24,"24209",2769,1888,1865,12,23,"C's",126
9,"9279",174,131,130,3,1,"C's",12
11,"11015",62476,38177,37875,488,302,"C's",6277
16,"16273",321,242,236,3,6,"C's",9
37,"37272",141,107,104,0,3,"C's",10
37,"37147",193,134,132,1,2,"C's",9
18,"18114",609,424,422,8,2,"C's",22
49,"49102",196,143,139,2,4,"C's",13
28,"28166",320,254,251,2,3,"C's",38
24,"24073",478,332,328,2,4,"C's",44
46,"46263",251,214,212,0,2,"C's",10
1,"1002",8124,5722,5654,31,68,"C's",134
45,"45133",2797,2068,2048,13,20,"C's",226
44,"44129",39,32,32,0,0,"C's",5
42,"42144",436,353,348,2,5,"C's",31
35,"35009",19905,14185,13961,89,224,"C's",1469
34,"34121",187,148,148,3,0,"C's",15
44,"44230",155,123,123,2,0,"C's",11
9,"9196",149,103,103,1,0,"C's",4
3,"3133",41576,25849,25639,127,210,"C's",3349
45,"45167",1440,1144,1133,6,11,"C's",106
5,"5262",357,276,276,1,0,"C's",22
37,"37148",427,298,295,3,3,"C's",32
42,"42190",89,65,64,0,1,"C's",8
34,"34169",404,287,286,0,1,"C's",34
49,"49104",343,234,232,0,2,"C's",9
49,"49266",76,63,61,2,2,"C's",7
47,"47077",246,193,191,1,2,"C's",31
18,"18163",324,235,233,2,2,"C's",21
22,"22095",72,58,58,1,0,"C's",6
31,"31213",104,52,52,0,0,"C's",1
44,"44130",34,24,24,0,0,"C's",8
48,"48903",1835,1361,1351,7,10,"C's",41
29,"29067",424813,286785,284689,2351,2096,"C's",48456
3,"3040",254,216,213,2,3,"C's",22
16,"16277",113,84,83,1,1,"C's",9
39,"39060",6679,5196,5121,29,75,"C's",724
23,"23077",620,501,494,3,7,"C's",31
2,"2019",2405,1871,1835,12,36,"C's",185
46,"46903",6065,4790,4763,18,27,"C's",1179
13,"13040",868,678,672,4,6,"C's",47
5,"5265",82,66,66,1,0,"C's",10
28,"28079",2362038,1743924,1733354,8859,10570,"C's",287711
19,"19161",211,159,157,1,2,"C's",17
38,"38017",28437,16239,16075,95,164,"C's",1962
37,"37277",75,58,58,0,0,"C's",10
28,"28169",1448,1122,1113,5,9,"C's",265
28,"28015",18736,14221,14127,68,94,"C's",3993
22,"22099",483,379,377,4,2,"C's",33
37,"37152",418,290,286,2,4,"C's",39
9,"9243",76,59,57,1,2,"C's",3
50,"50246",41,28,28,0,0,"C's",0
4,"4087",182,135,135,0,0,"C's",20
34,"34125",86,65,64,0,1,"C's",8
26,"26036",16986,11940,11816,66,124,"C's",1790
48,"48011",9673,6468,6423,45,45,"C's",187
10,"10114",953,665,660,3,5,"C's",47
47,"47079",58,48,47,0,1,"C's",6
40,"40195",885,672,669,1,3,"C's",71
14,"14053",6006,4285,4232,49,53,"C's",411
44,"44235",92,62,60,0,2,"C's",5
9,"9471",149,114,114,1,0,"C's",18
6,"6132",855,587,582,3,5,"C's",31
11,"11020",165378,109810,108830,1188,980,"C's",17195
6,"6042",1011,698,687,2,11,"C's",29
18,"18030",576,413,409,6,4,"C's",38
44,"44133",21,15,15,0,0,"C's",5
26,"26037",128,108,108,2,0,"C's",3
37,"37155",65,57,57,0,0,"C's",4
22,"22103",682,508,502,3,6,"C's",79
28,"28082",5683,4324,4286,25,38,"C's",730
49,"49232",96,74,74,1,0,"C's",6
16,"16901",675,506,501,6,5,"C's",43
2,"2023",568,486,479,3,7,"C's",40
46,"46052",499,421,417,2,4,"C's",47
47,"47001",55,46,46,0,0,"C's",3
33,"33071",595,433,430,10,3,"C's",19
16,"16123",82,61,61,3,0,"C's",7
50,"50297",498961,362043,359558,2748,2485,"C's",63727
26,"26107",94,77,77,2,0,"C's",9
16,"16031",46,28,28,1,0,"C's",3
19,"19165",47,41,41,0,0,"C's",1
46,"46209",1933,1445,1415,5,30,"C's",127
9,"9202",25,22,22,1,0,"C's",1
19,"19043",84,72,72,0,0,"C's",5
48,"48907",348,266,266,2,0,"C's",0
22,"22105",114,78,77,2,1,"C's",7
47,"47002",23,21,20,1,1,"C's",1
50,"50060",172,128,127,1,1,"C's",16
5,"5077",158,140,139,1,1,"C's",11
50,"50250",52,44,44,0,0,"C's",6
16,"16903",1070,777,765,4,12,"C's",59
49,"49234",412,328,324,0,4,"C's",32
5,"5905",217,165,164,0,1,"C's",11
14,"14056",23581,16120,15958,143,162,"C's",1980
22,"22106",22,14,14,0,0,"C's",1
11,"11024",6723,4696,4634,44,62,"C's",504
40,"40074",255,222,219,2,3,"C's",39
6,"6137",972,744,737,1,7,"C's",47
15,"15086",2869,1970,1950,13,20,"C's",158
10,"10120",171,121,117,1,4,"C's",4
24,"24181",1493,1054,1045,5,9,"C's",74
48,"48909",209,161,161,0,0,"C's",0
42,"42061",291,214,213,3,1,"C's",25
44,"44239",22,20,20,0,0,"C's",2
47,"47056",87,67,67,0,0,"C's",7
21,"21071",203,157,153,4,4,"C's",8
31,"31021",62,39,38,0,1,"C's",0
41,"41069",29138,18991,18683,341,308,"C's",2753
44,"44033",269,191,190,0,1,"C's",13
46,"46029",20613,14964,14879,93,85,"C's",2315
26,"26041",132,92,91,0,1,"C's",3
10,"10122",218,156,153,3,3,"C's",11
11,"11025",4398,2899,2848,51,51,"C's",240
48,"48910",2909,1950,1937,10,13,"C's",53
37,"37025",257,220,220,4,0,"C's",32
40,"40076",6492,4768,4700,26,68,"C's",809
34,"34042",296,237,234,1,3,"C's",23
24,"24182",416,294,290,2,4,"C's",24
34,"34181",448,322,319,7,3,"C's",38
22,"22109",261,191,190,1,1,"C's",40
2,"2028",126,98,98,0,0,"C's",7
9,"9074",794,575,569,6,6,"C's",129
29,"29075",12934,8234,8147,69,87,"C's",974
20,"20049",4122,2677,2666,15,11,"C's",30
42,"42063",49,35,35,0,0,"C's",4
50,"50063",61,51,51,0,0,"C's",0
23,"23088",6089,4558,4472,34,86,"C's",375
24,"24084",163,116,116,0,0,"C's",17
34,"34182",786,606,597,10,9,"C's",47
29,"29076",2153,1390,1360,10,30,"C's",232
24,"24117",434,334,331,1,3,"C's",21
28,"28021",554,370,364,3,6,"C's",49
32,"32068",1415,982,978,5,4,"C's",51
47,"47167",241,204,204,1,0,"C's",22
6,"6141",1719,1201,1189,8,12,"C's",61
22,"22239",88,72,72,0,0,"C's",5
15,"15090",1179,812,804,9,8,"C's",37
40,"40078",161,125,124,2,1,"C's",10
16,"16131",130,100,97,2,3,"C's",7
11,"11028",32488,21971,21672,316,299,"C's",2456
49,"49239",663,458,448,3,10,"C's",30
41,"41072",4054,2965,2933,14,32,"C's",174
21,"21076",2121,1458,1437,17,21,"C's",96
32,"32069",4308,3221,3164,27,57,"C's",199
40,"40079",234,179,179,3,0,"C's",18
41,"41073",1707,1055,1041,5,14,"C's",101
10,"10126",1548,1120,1102,8,18,"C's",65
22,"22111",154,103,102,0,1,"C's",16
31,"31225",36,27,27,0,0,"C's",6
6,"6143",3360,2353,2321,12,32,"C's",133
48,"48913",1248,884,869,10,15,"C's",14
26,"26045",12,12,12,0,0,"C's",1
12,"12085",4976,3236,3209,16,27,"C's",507
46,"46136",2537,1952,1930,11,22,"C's",244
34,"34136",179,110,110,1,0,"C's",7
28,"28177",10270,8083,8030,36,53,"C's",2013
26,"26078",82,70,70,0,0,"C's",8
13,"13057",1147,961,954,1,7,"C's",68
3,"3081",1436,1084,1075,5,9,"C's",132
50,"50131",231,167,165,0,2,"C's",23
11,"11030",22775,15157,14958,149,199,"C's",2465
44,"44245",248,179,176,2,3,"C's",20
37,"37290",141,113,113,0,0,"C's",20
26,"26046",1581,1175,1159,4,16,"C's",113
21,"21079",722,494,490,5,4,"C's",28
19,"19281",21,15,15,2,0,"C's",2
48,"48020",273626,184710,183628,1185,1082,"C's",7477
50,"50256",83,53,53,0,0,"C's",5
42,"42117",140,101,99,0,2,"C's",18
12,"12088",62,59,59,0,0,"C's",0
6,"6009",204,153,153,0,0,"C's",10
24,"24089",102747,74428,73688,631,740,"C's",11244
19,"19282",163,124,123,0,1,"C's",7
34,"34139",166,107,106,1,1,"C's",10
40,"40082",114,84,82,1,2,"C's",11
45,"45182",1034,806,791,1,15,"C's",51
28,"28179",1432,1040,1037,4,3,"C's",178
37,"37032",548,401,399,0,2,"C's",64
47,"47196",34,27,27,0,0,"C's",2
31,"31028",212,131,131,0,0,"C's",0
36,"36018",3240,2198,2170,10,28,"C's",154
45,"45183",2220,1444,1428,3,16,"C's",253
11,"11032",53874,31273,31008,348,265,"C's",4435
47,"47035",921,717,715,3,2,"C's",62
44,"44247",316,218,215,3,3,"C's",18
45,"45082",1224,1020,1011,8,9,"C's",58
37,"37292",104,77,77,1,0,"C's",15
38,"38032",13237,8908,8828,52,80,"C's",1296
23,"23095",8735,6347,6310,14,37,"C's",540
41,"41077",8702,5983,5875,29,108,"C's",620
40,"40211",74,64,64,0,0,"C's",7
13,"13062",574,453,448,3,5,"C's",35
24,"24189",5865,3933,3885,31,48,"C's",831
42,"42073",75,58,58,0,0,"C's",13
24,"24190",165,123,121,1,2,"C's",10
9,"9904",478,374,370,5,4,"C's",45
47,"47171",407,303,301,6,2,"C's",45
37,"37169",176,127,126,0,1,"C's",15
47,"47089",148,125,124,0,1,"C's",15
5,"5141",94,80,80,1,0,"C's",10
19,"19285",24,21,21,1,0,"C's",2
48,"48023",600,455,452,0,3,"C's",2
50,"50167",233,183,178,1,5,"C's",14
22,"22003",137,110,107,1,3,"C's",15
37,"37170",1449,994,971,3,23,"C's",136
10,"10133",1206,956,945,5,11,"C's",53
11,"11034",2334,1549,1517,14,32,"C's",172
13,"13065",2854,1901,1888,9,13,"C's",126
29,"29084",27359,17843,17627,176,216,"C's",3023
37,"37171",409,317,310,2,7,"C's",64
10,"10134",567,401,396,2,5,"C's",28
28,"28182",210,171,169,0,2,"C's",28
18,"18005",372,262,258,0,4,"C's",29
44,"44042",123,91,90,0,1,"C's",6
24,"24093",360,249,248,2,1,"C's",22
9,"9355",98,75,75,0,0,"C's",6
28,"28093",2096,1670,1653,10,17,"C's",268
37,"37036",61,44,43,0,1,"C's",3
44,"44250",19,12,12,0,0,"C's",1
34,"34147",166,118,117,0,1,"C's",12
9,"9220",75,56,54,1,2,"C's",4
26,"26158",251,214,210,0,4,"C's",15
44,"44251",254,198,191,1,7,"C's",17
48,"48025",883,642,637,7,5,"C's",1
49,"49248",186,151,150,1,1,"C's",9
26,"26052",154,121,117,0,4,"C's",11
9,"9085",475,347,342,2,5,"C's",58
22,"22119",1291,942,935,5,7,"C's",103
34,"34009",31,29,29,1,0,"C's",0
42,"42079",26,18,18,1,0,"C's",1
42,"42171",127,80,79,0,1,"C's",7
46,"46142",787,619,602,1,17,"C's",66
6,"6017",272,222,221,1,1,"C's",8
34,"34010",577,440,438,5,2,"C's",64
14,"14066",5856,4150,4095,48,55,"C's",440
46,"46064",509,412,399,1,13,"C's",45
11,"11036",689,407,400,3,7,"C's",11
11,"11037",5661,4347,4265,33,82,"C's",160
38,"38037",12864,8287,8163,64,124,"C's",781
47,"47013",100,82,81,1,1,"C's",9
40,"40089",222,167,164,0,3,"C's",23
19,"19217",54,40,39,0,1,"C's",4
50,"50263",193,121,121,0,0,"C's",12
13,"13070",760,583,574,11,9,"C's",27
18,"18145",10491,7538,7477,59,61,"C's",1387
31,"31234",144,106,106,4,0,"C's",5
39,"39078",1401,975,963,5,12,"C's",173
24,"24095",320,234,232,0,2,"C's",21
50,"50074",6366,4230,4165,31,65,"C's",717
44,"44152",64,46,45,0,1,"C's",6
6,"6019",2079,1451,1417,8,34,"C's",119
44,"44045",366,274,269,2,5,"C's",27
20,"20061",4273,2601,2590,21,11,"C's",28
47,"47093",813,613,600,5,13,"C's",65
50,"50172",193,132,129,1,3,"C's",24
49,"49168",93,74,74,0,0,"C's",10
24,"24096",117,80,79,1,1,"C's",7
22,"22170",651,498,491,5,7,"C's",55
24,"24129",122,89,89,1,0,"C's",16
19,"19290",834,561,558,5,3,"C's",74
4,"4009",162,123,122,2,1,"C's",13
40,"40219",587,455,444,5,11,"C's",59
9,"9180",142,107,102,1,5,"C's",19
6,"6066",1762,1189,1182,2,7,"C's",55
46,"46144",663,532,529,2,3,"C's",48
28,"28032",4762,3428,3401,19,27,"C's",699
22,"22251",364,284,284,0,0,"C's",61
26,"26055",39,32,32,0,0,"C's",2
29,"29090",1688,1144,1134,15,10,"C's",164
37,"37042",44,28,27,0,1,"C's",5
49,"49252",320,254,252,5,2,"C's",26
9,"9362",208,172,171,2,1,"C's",22
11,"11040",397,307,292,1,15,"C's",35
19,"19291",1191,879,869,3,10,"C's",97
34,"34155",129,104,103,2,1,"C's",10
40,"40094",374,279,276,2,3,"C's",43
19,"19184",71,50,48,0,2,"C's",6
50,"50265",79,61,61,0,0,"C's",4
42,"42083",26,20,20,0,0,"C's",1
9,"9363",965,737,734,2,3,"C's",83
2,"2046",1098,896,878,12,18,"C's",91
23,"23027",723,576,572,3,4,"C's",37
37,"37179",209,180,180,0,0,"C's",9
49,"49131",264,194,192,6,2,"C's",18
45,"45091",394,269,267,3,2,"C's",40
37,"37045",26,23,21,0,2,"C's",4
48,"48030",606,441,439,1,2,"C's",1
10,"10006",1263,978,970,2,8,"C's",54
22,"22253",61,52,52,0,0,"C's",5
32,"32087",1765,1363,1343,13,20,"C's",77
49,"49012",73,43,43,0,0,"C's",6
45,"45193",613,504,497,1,7,"C's",23
9,"9094",53,42,42,1,0,"C's",6
44,"44088",29,21,21,0,0,"C's",2
6,"6070",7743,5438,5317,39,121,"C's",670
47,"47206",92,80,80,0,0,"C's",8
37,"37349",117,88,88,0,0,"C's",12
39,"39082",1653,1173,1157,11,16,"C's",138
9,"9366",86,62,62,2,0,"C's",10
40,"40099",52,44,42,0,2,"C's",1
9,"9098",507,369,362,5,7,"C's",44
50,"50078",235,177,173,0,4,"C's",9
18,"18016",307,235,233,0,2,"C's",13
22,"22254",1124,801,792,11,9,"C's",116
47,"47018",34,28,28,0,0,"C's",0
34,"34108",542,421,417,3,4,"C's",42
6,"6072",2307,1696,1681,12,15,"C's",157
39,"39083",1135,679,670,8,9,"C's",65
28,"28035",1353,1006,998,2,8,"C's",144
6,"6027",676,561,552,2,9,"C's",46
38,"38044",2188,1348,1334,6,14,"C's",107
47,"47098",576,464,452,4,12,"C's",65
13,"13080",351,266,266,2,0,"C's",13
31,"31240",527,327,326,2,1,"C's",5
4,"4014",144,117,114,1,3,"C's",4
9,"9369",436,319,316,1,3,"C's",40
47,"47019",85,74,73,0,1,"C's",3
22,"22130",10092,6671,6608,59,63,"C's",1160
24,"24203",95,69,68,0,1,"C's",1
9,"9275",192,129,129,2,0,"C's",12
29,"29094",57554,38071,37696,339,375,"C's",5844
34,"34023",5236,3685,3636,30,49,"C's",441
46,"46070",16950,12765,12676,61,89,"C's",2543
16,"16015",374,263,262,4,1,"C's",18
32,"32092",520,321,320,6,1,"C's",18
16,"16155",508,398,391,2,7,"C's",37
24,"24205",945,694,685,11,9,"C's",69
19,"19298",65,45,45,0,0,"C's",10
37,"37228",360,297,295,2,2,"C's",32
46,"46227",905,711,702,1,9,"C's",62
39,"39085",6836,5086,5032,44,54,"C's",893
16,"16156",97,78,77,0,1,"C's",2
41,"41090",3523,2576,2512,13,64,"C's",222
44,"44021",107,89,88,0,1,"C's",5
26,"26169",64,60,60,0,0,"C's",5
40,"40103",159,125,123,2,2,"C's",18
44,"44159",38,31,31,1,0,"C's",2
5,"5008",227,170,168,1,2,"C's",12
42,"42090",91,69,67,1,2,"C's",4
10,"10013",276,207,200,0,7,"C's",15
19,"19190",2369,1760,1745,10,15,"C's",211
24,"24206",1700,1253,1240,12,13,"C's",110
47,"47100",138,117,117,1,0,"C's",7
12,"12002",110,99,98,1,1,"C's",5
50,"50082",82,65,64,0,1,"C's",9
38,"38048",3901,2667,2637,20,30,"C's",218
40,"40229",36,24,24,0,0,"C's",0
50,"50179",249,214,213,2,1,"C's",9
18,"18158",8358,5096,5031,28,65,"C's",459
50,"50116",182,136,132,0,4,"C's",7
13,"13086",175,137,134,0,3,"C's",8
5,"5162",86,66,63,0,3,"C's",9
38,"38049",2655,1654,1627,8,27,"C's",133
10,"10152",468,340,332,1,8,"C's",17
26,"26063",124,94,94,2,0,"C's",7
44,"44094",113,94,94,0,0,"C's",10
13,"13085",2342,1921,1855,10,66,"C's",153
10,"10198",1143,981,964,6,17,"C's",44
32,"32005",861,662,650,7,12,"C's",31
3,"3037",346,282,278,3,4,"C's",34
20,"20071",14801,9466,9421,60,45,"C's",161
2,"2056",1718,1296,1274,6,22,"C's",88
31,"31045",508,355,350,8,5,"C's",22
18,"18161",212,175,174,3,1,"C's",14
33,"33004",66857,46390,45960,426,430,"C's",5532
26,"26064",2275,1659,1638,17,21,"C's",177
9,"9105",109,86,81,1,5,"C's",14
12,"12104",6933,5411,5342,25,69,"C's",717
6,"6080",1924,1412,1392,9,20,"C's",100
14,"14021",260178,181773,180348,1872,1425,"C's",25564
42,"42189",60,46,45,0,1,"C's",7
32,"32007",1517,1046,1028,8,18,"C's",49
40,"40149",514,375,369,5,6,"C's",38
49,"49021",14330,9878,9758,95,120,"C's",1237
46,"46152",96,68,68,0,0,"C's",4
24,"24210",503,358,356,3,2,"C's",23
16,"16067",123,87,87,0,0,"C's",2
44,"44268",25,25,24,0,1,"C's",7
24,"24106",248,167,166,1,1,"C's",28
9,"9108",384,283,279,1,4,"C's",56
42,"42148",10,10,10,1,0,"C's",0
42,"42095",1773,1269,1251,15,18,"C's",214
31,"31179",502,348,345,0,3,"C's",24
28,"28109",1576,1103,1098,1,5,"C's",141
26,"26033",170,132,129,1,3,"C's",9
40,"40234",397,298,292,2,6,"C's",49
21,"21062",1392,887,879,6,8,"C's",88
47,"47024",259,208,207,1,1,"C's",22
19,"19194",98,69,69,1,0,"C's",4
28,"28137",1664,1232,1220,7,12,"C's",194
29,"29901",43826,29318,29107,250,211,"C's",5192
2,"2059",302,234,232,1,2,"C's",12
31,"31247",151,114,113,0,1,"C's",1
50,"50275",108,55,55,0,0,"C's",1
44,"44059",544,425,412,9,13,"C's",57
36,"36003",9980,7191,7110,67,81,"C's",704
28,"28042",1173,890,883,3,7,"C's",129
24,"24144",695,470,465,2,5,"C's",56
20,"20074",11592,7954,7914,45,40,"C's",87
40,"40902",123,99,96,1,3,"C's",2
18,"18164",1836,1146,1126,6,20,"C's",142
37,"37109",183,129,127,0,2,"C's",11
10,"10020",1604,1185,1169,9,16,"C's",56
48,"48070",544,362,362,4,0,"C's",3
46,"46076",575,454,443,0,11,"C's",16
19,"19196",105,84,81,0,3,"C's",10
29,"29902",2567,1577,1559,11,18,"C's",166
50,"50184",115,85,85,0,0,"C's",7
31,"31082",617,371,365,10,6,"C's",5
4,"4022",347,249,249,7,0,"C's",17
45,"45136",5845,4091,4019,25,72,"C's",426
24,"24109",977,633,624,3,9,"C's",38
44,"44060",41,32,32,0,0,"C's",1
5,"5169",226,187,185,1,2,"C's",19
18,"18167",1895,1258,1250,4,8,"C's",101
47,"47187",84,61,58,0,3,"C's",5
28,"28112",161,136,136,1,0,"C's",33
22,"22142",97,75,74,1,1,"C's",0
31,"31249",1872,1290,1273,14,17,"C's",65
4,"4023",138,96,95,2,1,"C's",7
22,"22023",421,313,309,6,4,"C's",35
45,"45104",428,324,323,1,1,"C's",27
24,"24110",1247,899,892,6,7,"C's",54
49,"49270",133,99,99,1,0,"C's",12
32,"32014",1142,848,834,6,14,"C's",39
6,"6041",460,372,367,0,5,"C's",16
18,"18168",804,546,543,7,3,"C's",85
12,"12109",649,532,524,6,8,"C's",55
20,"20010",1499,992,986,9,6,"C's",12
5,"5023",168,146,145,1,1,"C's",7
22,"22143",217,143,141,1,2,"C's",25
2,"2063",1463,1073,1060,3,13,"C's",99
44,"44169",342,252,252,3,0,"C's",31
10,"10162",575,437,433,2,4,"C's",28
44,"44062",34,25,22,0,3,"C's",1
6,"6043",665,490,484,2,6,"C's",60
37,"37323",516,376,372,5,4,"C's",49
30,"30001",4582,3620,3594,18,26,"C's",341
22,"22190",119,86,85,0,1,"C's",7
9,"9032",109,75,73,0,2,"C's",7
42,"42155",167,103,102,1,1,"C's",4
9,"9247",24,21,21,1,0,"C's",1
42,"42105",50,45,45,0,0,"C's",3
18,"18033",282,201,200,5,1,"C's",9
1,"1011",235,174,171,4,3,"C's",11
16,"16171",1800,1469,1443,8,26,"C's",68
31,"31052",96,62,61,0,1,"C's",3
37,"37324",360,276,275,2,1,"C's",28
21,"21029",1562,1127,1097,14,30,"C's",98
5,"5904",127,88,87,1,1,"C's",3
2,"2065",476,394,392,1,2,"C's",20
37,"37198",207,160,157,3,3,"C's",21
33,"33011",11260,6250,6163,83,87,"C's",636
3,"3075",147,128,128,0,0,"C's",10
49,"49029",623,495,488,3,7,"C's",60
37,"37068",365,267,267,1,0,"C's",28
49,"49151",619,459,456,2,3,"C's",34
12,"12112",99,79,78,3,1,"C's",7
42,"42107",74,54,54,3,0,"C's",2
28,"28047",40914,30019,29788,169,231,"C's",5650
39,"39096",690,487,479,4,8,"C's",57
44,"44173",101,81,79,2,2,"C's",10
26,"26181",14,14,14,0,0,"C's",1
13,"13903",524,419,415,3,4,"C's",28
9,"9478",41,32,32,1,0,"C's",1
50,"50030",215,141,140,1,1,"C's",1
10,"10029",414,339,333,0,6,"C's",19
48,"48046",12611,8836,8794,39,42,"C's",144
47,"47030",993,766,751,6,15,"C's",83
16,"16128",63,50,50,0,0,"C's",2
32,"32019",11537,7975,7861,56,114,"C's",568
24,"24218",451,330,325,2,5,"C's",40
22,"22028",371,282,280,3,2,"C's",40
10,"10167",314,239,239,1,0,"C's",4
2,"2068",337,251,246,1,5,"C's",31
50,"50190",695,523,515,3,8,"C's",48
12,"12049",441,322,312,1,10,"C's",42
6,"6048",849,691,677,7,14,"C's",32
21,"21032",1800,1286,1259,10,27,"C's",61
28,"28048",500,391,387,3,4,"C's",49
15,"15013",6151,4237,4189,48,48,"C's",394
29,"29020",3267,2408,2359,16,49,"C's",241
10,"10168",312,213,208,0,5,"C's",18
13,"13001",1254,934,925,6,9,"C's",50
1,"1016",433,228,226,5,2,"C's",5
41,"41004",56640,37110,36649,440,461,"C's",5700
46,"46160",1913,1452,1436,1,16,"C's",130
19,"19090",91,73,73,1,0,"C's",1
9,"9036",37,31,30,1,1,"C's",4
31,"31056",174,121,120,0,1,"C's",6
48,"48078",38617,26366,26212,158,154,"C's",851
19,"19317",139,110,109,1,1,"C's",8
2,"2070",403,332,328,4,4,"C's",18
7,"7019",187,133,129,2,4,"C's",8
50,"50002",143,108,104,1,4,"C's",8
50,"50095",12323,8628,8550,110,78,"C's",926
19,"19318",25,18,18,0,0,"C's",2
42,"42113",534,409,399,1,10,"C's",36
31,"31156",251,189,188,0,1,"C's",5
34,"34184",57,46,45,0,1,"C's",1
9,"9123",40,35,35,0,0,"C's",0
46,"46005",22918,16958,16827,102,131,"C's",2597
7,"7020",3581,2542,2502,43,40,"C's",319
12,"12016",1582,1307,1297,6,10,"C's",134
9,"9392",53,40,37,1,3,"C's",11
37,"37204",276,198,195,1,3,"C's",15
5,"5181",43,34,34,1,0,"C's",3
31,"31091",351,220,217,1,3,"C's",7
19,"19008",37,28,27,1,1,"C's",3
37,"37074",150,123,120,0,3,"C's",7
46,"46240",210,164,161,1,3,"C's",19
41,"41007",12341,8039,7844,103,195,"C's",856
34,"34047",1782,1397,1374,12,23,"C's",168
46,"46084",1576,1263,1242,5,21,"C's",108
15,"15017",19420,13661,13505,175,156,"C's",1626
33,"33017",3144,2094,2071,35,23,"C's",169
37,"37373",748,503,499,1,4,"C's",53
50,"50285",644,436,434,2,2,"C's",57
46,"46006",4523,3665,3623,20,42,"C's",420
18,"18042",403,324,322,2,2,"C's",56
50,"50035",72,54,53,1,1,"C's",0
5,"5037",255,173,172,1,1,"C's",17
49,"49157",206,163,160,2,3,"C's",13
24,"24022",330,230,229,0,1,"C's",14
30,"30008",13918,9757,9645,59,112,"C's",1418
50,"50005",229,189,189,1,0,"C's",23
12,"12018",287,246,242,1,4,"C's",31
31,"31060",13744,9400,9320,72,80,"C's",441
33,"33048",154,95,94,0,1,"C's",4
47,"47143",118,91,90,0,1,"C's",6
48,"48081",1868,1361,1350,4,11,"C's",21
46,"46007",11989,8784,8711,67,73,"C's",1364
5,"5184",246,183,183,0,0,"C's",13
9,"9396",156,121,121,0,0,"C's",11
10,"10037",76232,55104,54464,418,640,"C's",8081
23,"23014",2559,1971,1942,13,29,"C's",128
39,"39102",2277,1615,1598,9,17,"C's",200
49,"49159",271,209,205,4,4,"C's",18
42,"42165",409,271,261,10,10,"C's",26
12,"12119",148,95,93,0,2,"C's",7
19,"19174",109,80,79,0,1,"C's",4
37,"37336",52,50,50,1,0,"C's",4
31,"31160",106,89,88,2,1,"C's",1
42,"42031",26,21,21,0,0,"C's",2
44,"44213",62,50,50,0,0,"C's",3
5,"5186",1575,1225,1194,3,31,"C's",153
19,"19212",703,543,531,3,12,"C's",66
47,"47036",228,181,181,3,0,"C's",19
31,"31161",338,264,259,2,5,"C's",6
12,"12021",4436,3381,3332,27,49,"C's",416
2,"2076",329,237,236,1,1,"C's",9
24,"24122",1342,930,924,8,6,"C's",82
42,"42166",59,45,45,0,0,"C's",4
40,"40128",129,95,93,0,2,"C's",5
19,"19098",19,17,17,0,0,"C's",2
37,"37209",412,272,270,7,2,"C's",40
31,"31029",914,638,625,6,13,"C's",24
44,"44181",76,57,56,0,1,"C's",4
31,"31162",47,31,31,0,0,"C's",0
14,"14008",2839,1905,1895,19,10,"C's",192
24,"24227",1607,1127,1116,22,11,"C's",172
50,"50101",864,603,597,8,6,"C's",55
5,"5188",45,39,38,0,1,"C's",4
24,"24123",746,488,485,2,3,"C's",46
9,"9130",74,51,50,1,1,"C's",2
30,"30012",9091,6962,6897,36,65,"C's",761
9,"9006",59,39,39,0,0,"C's",4
31,"31063",92,75,73,2,2,"C's",0
45,"45017",262,204,203,0,1,"C's",17
37,"37339",315,251,251,4,0,"C's",10
44,"44077",74,60,58,0,2,"C's",5
50,"50102",859,658,653,8,5,"C's",77
1,"1023",267,187,186,1,1,"C's",9
50,"50009",105,80,80,0,0,"C's",16
10,"10042",84,63,63,0,0,"C's",1
2,"2079",2875,2209,2181,12,28,"C's",214
9,"9262",163,130,127,1,3,"C's",8
36,"36021",12073,8447,8342,89,105,"C's",813
30,"30013",7396,5147,5102,32,45,"C's",560
9,"9009",163,133,131,2,2,"C's",29
14,"14009",2788,1852,1834,20,18,"C's",185
19,"19215",168,144,140,0,4,"C's",11
24,"24229",418,322,319,2,3,"C's",27
21,"21003",690,471,458,6,13,"C's",25
45,"45019",7377,5307,5251,37,56,"C's",795
40,"40131",48,42,42,0,0,"C's",8
6,"6062",594,441,437,5,4,"C's",21
47,"47199",80,63,63,0,0,"C's",5
40,"40005",30,23,23,0,0,"C's",0
34,"34100",142,108,108,1,0,"C's",13
6,"6016",2986,2114,2078,14,36,"C's",148
9,"9048",1467,1048,1033,13,15,"C's",126
41,"41102",14655,10183,9919,142,264,"C's",1376
28,"28125",3002,2180,2163,11,17,"C's",342
10,"10045",1019,762,755,3,7,"C's",42
50,"50011",122,95,94,1,1,"C's",9
7,"7031",23833,14836,14707,124,129,"C's",2311
24,"24230",426,322,320,5,2,"C's",32
18,"18188",1653,1183,1175,5,8,"C's",108
22,"22044",252,198,197,0,1,"C's",33
23,"23021",524,431,429,0,2,"C's",28
33,"33054",1682,1159,1149,12,10,"C's",133
12,"12124",1840,1387,1381,33,6,"C's",164
28,"28058",139342,100637,99753,634,884,"C's",18179
30,"30015",19171,13561,13464,61,97,"C's",1907
44,"44185",99,76,75,0,1,"C's",6
29,"29031",1614,1107,1094,13,13,"C's",98
37,"37088",207,163,162,3,1,"C's",16
49,"49044",80,60,58,0,2,"C's",7
45,"45121",6796,4743,4692,22,51,"C's",696
34,"34205",61,50,50,0,0,"C's",4
30,"30016",151668,102093,101363,484,730,"C's",18265
46,"46169",32247,24214,24053,154,161,"C's",3599
19,"19218",50,33,33,0,0,"C's",6
2,"2083",219,191,191,0,0,"C's",8
9,"9179",41,32,32,1,0,"C's",2
2,"2084",323,231,225,0,6,"C's",14
45,"45056",2201,1260,1243,12,17,"C's",192
48,"48088",136,102,102,0,0,"C's",1
47,"47041",150,112,110,2,2,"C's",6
37,"37089",67,56,56,0,0,"C's",12
13,"13020",4781,3198,3161,31,37,"C's",337
46,"46066",1263,1024,1018,9,6,"C's",149
32,"32084",918,641,635,3,6,"C's",39
19,"19107",294,239,237,0,2,"C's",18
12,"12126",24464,18533,18331,113,202,"C's",2432
45,"45022",391,285,281,3,4,"C's",19
30,"30017",11605,8541,8451,46,90,"C's",1116
48,"48059",400,294,291,0,3,"C's",3
44,"44086",449,342,336,3,6,"C's",46
39,"39019",2079,1560,1531,10,29,"C's",233
9,"9013",48,37,37,0,0,"C's",3
22,"22047",243,205,203,2,2,"C's",39
7,"7035",1524,1078,1055,8,23,"C's",43
50,"50014",147,94,94,0,0,"C's",12
47,"47042",54,37,37,0,0,"C's",2
39,"39050",270,187,186,0,1,"C's",27
37,"37346",273,212,211,1,1,"C's",20
40,"40139",279,202,198,1,4,"C's",32
12,"12127",75,55,55,0,0,"C's",3
39,"39020",23592,15594,15384,128,210,"C's",1917
50,"50141",109,90,90,1,0,"C's",5
34,"34210",103,90,90,0,0,"C's",5
36,"36028",4102,2913,2868,17,45,"C's",202
50,"50296",396,286,275,4,11,"C's",42
50,"50109",103,78,78,3,0,"C's",12
18,"18056",3530,2641,2614,24,27,"C's",254
47,"47043",297,239,237,0,2,"C's",15
24,"24132",615,379,375,1,4,"C's",29
5,"5054",1224,935,924,8,11,"C's",68
46,"46094",20540,15378,15234,102,144,"C's",2588
14,"14015",2125,1579,1554,10,25,"C's",158
48,"48061",762,565,561,0,4,"C's",18
24,"24167",750,505,499,4,6,"C's",79
46,"46120",1113,903,875,2,28,"C's",100
15,"15069",6745,4910,4850,43,60,"C's",316
18,"18015",434,334,333,0,1,"C's",18
46,"46016",1061,870,856,5,14,"C's",54
13,"13025",302,244,244,1,0,"C's",10
21,"21012",316,235,233,2,2,"C's",12
37,"37097",39,27,27,1,0,"C's",0
46,"46173",1328,1069,1057,4,12,"C's",110
28,"28131",12990,9512,9433,38,79,"C's",1801
9,"9450",28,22,21,0,1,"C's",1
15,"15033",2472,1863,1845,8,18,"C's",109
16,"16152",38,32,32,0,0,"C's",2
9,"9056",4919,3395,3344,20,51,"C's",506
40,"40014",58,46,45,0,1,"C's",7
46,"46095",610,467,459,1,8,"C's",52
16,"16204",261,199,199,1,0,"C's",24
18,"18061",1057,812,804,1,8,"C's",52
31,"31908",1004,686,682,2,4,"C's",37
7,"7039",4839,3136,3060,31,76,"C's",365
19,"19901",41,38,37,0,1,"C's",3
9,"9325",190,130,129,2,1,"C's",7
40,"40142",53,39,37,0,2,"C's",7
2,"2009",19660,14256,14116,127,140,"C's",2122
37,"37049",137,96,96,1,0,"C's",8
46,"46226",41,36,35,0,1,"C's",0
40,"40057",1456,1154,1148,7,6,"C's",121
16,"16060",744,565,554,7,11,"C's",43
4,"4048",1503,1090,1085,9,5,"C's",121
34,"34067",127,93,93,1,0,"C's",7
31,"31174",110,63,63,0,0,"C's",3
1,"1039",209,155,153,0,2,"C's",4
18,"18905",14618,9789,9682,110,107,"C's",1737
39,"39024",1879,1390,1372,2,18,"C's",167
24,"24136",540,387,383,4,4,"C's",37
37,"37142",586,430,429,1,1,"C's",83
45,"45028",3649,2701,2673,12,28,"C's",269
19,"19113",485,366,366,3,0,"C's",30
15,"15035",11427,7779,7657,144,122,"C's",576
18,"18906",905,664,657,3,7,"C's",43
47,"47181",165,135,132,3,3,"C's",19
3,"3065",167284,123032,122305,711,727,"C's",20932
14,"14046",4485,3268,3208,33,60,"C's",157
22,"22178",103,82,81,0,1,"C's",21
5,"5061",252,186,184,3,2,"C's",35
27,"27032",3275,2128,2096,22,32,"C's",147
6,"6076",831,611,607,2,4,"C's",22
50,"50115",3235,2128,2109,14,19,"C's",315
26,"26098",88,73,73,1,0,"C's",6
40,"40145",1103,879,870,2,9,"C's",88
47,"47047",199,157,156,2,1,"C's",8
10,"10059",364,253,248,1,5,"C's",9
49,"49057",109,85,83,1,2,"C's",4
40,"40059",110,95,95,1,0,"C's",11
3,"3130",48,25,25,0,0,"C's",1
14,"14019",6464,4967,4909,49,58,"C's",466
21,"21018",1769,1120,1095,11,25,"C's",73
46,"46046",892,675,668,1,7,"C's",106
9,"9022",66,57,57,1,0,"C's",13
49,"49058",307,237,233,0,4,"C's",26
33,"33033",9873,6512,6431,68,81,"C's",541
50,"50021",30,21,21,0,0,"C's",3
14,"14020",387,269,264,2,5,"C's",15
5,"5259",124,105,105,1,0,"C's",5
31,"31176",2869,2010,1963,33,47,"C's",187
19,"19227",66,44,43,2,1,"C's",7
49,"49262",392,279,274,1,5,"C's",14
26,"26100",49,44,43,0,1,"C's",6
34,"34220",147,126,125,3,1,"C's",28
9,"9280",28,20,20,0,0,"C's",1
6,"6079",652,449,442,4,7,"C's",19
32,"32006",1531,1114,1090,10,24,"C's",56
41,"41026",4314,3380,3322,18,58,"C's",190
10,"10199",165,112,111,1,1,"C's",20
12,"12039",833,717,710,4,7,"C's",69
37,"37232",390,341,339,1,2,"C's",35
26,"26031",106,83,83,0,0,"C's",3
48,"48901",4839,3459,3426,32,33,"C's",85
45,"45200",4592,3539,3476,14,63,"C's",423
29,"29009",1468,1069,1045,8,24,"C's",56
37,"37106",258,165,162,0,3,"C's",25
26,"26101",44,36,35,0,1,"C's",3
7,"7006",5178,3366,3329,52,37,"C's",313
22,"22184",184,155,155,3,0,"C's",20
15,"15078",78198,56154,55581,560,573,"C's",5255
44,"44198",182,147,146,4,1,"C's",16
3,"3008",168,130,129,0,1,"C's",9
33,"33035",11284,7681,7618,70,63,"C's",1114
9,"9463",264,195,195,7,0,"C's",23
49,"49062",122,90,89,0,1,"C's",9
18,"18116",2850,2059,2025,20,34,"C's",205
24,"24143",510,358,349,0,9,"C's",16
6,"6036",5075,3575,3535,35,40,"C's",388
5,"5117",200,174,173,1,1,"C's",16
34,"34031",30,30,29,0,1,"C's",3
6,"6083",46149,31049,30739,234,310,"C's",4577
44,"44099",709,465,462,3,3,"C's",36
42,"42053",26,19,19,1,0,"C's",0
36,"36039",15401,10871,10609,71,262,"C's",1047
40,"40151",46,33,33,0,0,"C's",2
50,"50024",571,437,437,6,0,"C's",44
16,"16218",191,150,150,3,0,"C's",11
14,"14023",2021,1660,1639,8,21,"C's",150
41,"41029",13445,9507,9416,78,91,"C's",1349
19,"19039",61,54,54,1,0,"C's",2
5,"5167",254,207,202,4,5,"C's",6
45,"45135",4269,3340,3288,8,52,"C's",309
47,"47078",163,127,125,1,2,"C's",15
32,"32011",932,619,613,1,6,"C's",12
46,"46128",1597,1290,1250,5,40,"C's",140
37,"37110",113,86,86,1,0,"C's",12
44,"44200",39,26,26,0,0,"C's",0
49,"49184",172,115,112,0,3,"C's",6
46,"46102",19788,15154,15038,89,116,"C's",1788
45,"45169",189,140,138,0,2,"C's",18
9,"9155",27,20,20,0,0,"C's",0
12,"12076",84,69,69,0,0,"C's",4
12,"12042",607,520,513,13,7,"C's",43
23,"23041",499,398,394,2,4,"C's",38
45,"45036",656,471,469,2,2,"C's",23
24,"24146",265,210,207,1,3,"C's",9
12,"12043",570,449,442,2,7,"C's",36
50,"50026",439,335,325,10,10,"C's",33
46,"46103",1264,1015,984,7,31,"C's",96
14,"14025",2924,2466,2422,14,44,"C's",108
12,"12139",318,237,233,0,4,"C's",15
16,"16073",185,164,164,1,0,"C's",11
37,"37363",118,88,87,0,1,"C's",12
45,"45137",1604,1032,1024,4,8,"C's",104
47,"47135",83,72,72,2,0,"C's",10
31,"31250",2810,1786,1770,19,16,"C's",92
32,"32013",2183,1428,1425,8,3,"C's",91
39,"39092",894,626,620,1,6,"C's",40
26,"26070",183,153,153,1,0,"C's",8
45,"45171",1361,1035,1023,0,12,"C's",123
7,"7053",1188,926,918,16,8,"C's",112
42,"42019",516,363,356,3,7,"C's",52
39,"39032",1463,1087,1081,7,6,"C's",116
44,"44103",132,102,102,1,0,"C's",9
12,"12140",1143,939,930,6,9,"C's",96
42,"42154",97,69,69,1,0,"C's",9
44,"44102",30,27,26,0,1,"C's",5
50,"50028",78,51,51,0,0,"C's",5
34,"34229",68,57,56,1,1,"C's",3
42,"42196",10,7,7,0,0,"C's",0
47,"47217",1910,1370,1366,1,4,"C's",241
29,"29049",2962,2132,2110,5,22,"C's",161
20,"20011",1658,1219,1210,7,9,"C's",8
26,"26005",2381,1598,1577,23,21,"C's",184
19,"19002",69,58,57,0,1,"C's",4
10,"10071",139,96,94,0,2,"C's",6
12,"12045",345,268,259,1,9,"C's",18
24,"24047",783,545,540,2,5,"C's",45
5,"5221",351,254,250,2,4,"C's",20
50,"50218",113,91,91,1,0,"C's",12
49,"49111",127,98,96,4,2,"C's",5
45,"45039",224,192,190,0,2,"C's",35
31,"31019",1785,1254,1238,9,16,"C's",57
16,"16079",30,19,18,0,1,"C's",0
37,"37366",43,32,32,0,0,"C's",2
40,"40031",526,398,396,2,2,"C's",83
7,"7055",7442,4604,4553,42,51,"C's",493
19,"19003",42,35,34,1,1,"C's",1
36,"36046",4036,2971,2921,15,50,"C's",254
45,"45074",414,327,323,1,4,"C's",34
21,"21030",1830,1452,1430,13,22,"C's",72
26,"26007",511,384,375,0,9,"C's",32
26,"26109",81,69,69,0,0,"C's",4
21,"21031",1199,852,837,6,15,"C's",59
28,"28145",2431,1760,1736,6,24,"C's",345
37,"37243",98,70,70,1,0,"C's",5
10,"10075",253,167,166,1,1,"C's",16
50,"50281",73,51,50,0,1,"C's",5
26,"26146",94,73,72,0,1,"C's",4
37,"37118",123,92,90,0,2,"C's",9
44,"44106",155,116,114,5,2,"C's",6
16,"16236",910,656,651,4,5,"C's",76
34,"34180",66,55,55,1,0,"C's",6
29,"29086",793,470,470,3,0,"C's",41
19,"19274",902,660,651,7,9,"C's",78
10,"10076",832,556,541,1,15,"C's",63
30,"30034",1129,858,844,7,14,"C's",44
22,"22197",473,354,354,1,0,"C's",51
31,"31188",235,161,161,2,0,"C's",4
42,"42200",81,59,58,2,1,"C's",7
40,"40034",84,70,70,0,0,"C's",18
7,"7018",382,272,269,1,3,"C's",30
9,"9209",4473,3223,3192,20,31,"C's",446
22,"22235",98,76,76,1,0,"C's",4
34,"34234",71,52,50,0,2,"C's",2
34,"34086",103,89,88,0,1,"C's",14
28,"28086",5154,3530,3493,13,37,"C's",675
50,"50032",261,189,189,5,0,"C's",14
24,"24052",158,104,102,0,2,"C's",3
46,"46186",19068,14599,14474,69,125,"C's",2570
46,"46108",469,378,375,1,3,"C's",29
48,"48911",380,276,272,1,4,"C's",0
7,"7059",2996,2053,2013,17,40,"C's",233
46,"46004",1922,1565,1547,11,18,"C's",238
24,"24184",198,118,117,0,1,"C's",11
42,"42025",1189,844,833,2,11,"C's",76
19,"19006",769,547,540,2,7,"C's",69
19,"19007",459,341,336,0,5,"C's",29
46,"46109",6150,4625,4556,25,69,"C's",642
6,"6096",220,176,171,2,5,"C's",2
3,"3018",12240,8853,8777,47,76,"C's",1330
20,"20017",8559,5478,5435,24,43,"C's",73
30,"30037",18793,13150,13003,47,147,"C's",2019
31,"31090",144,77,77,1,0,"C's",2
20,"20050",266,170,169,1,1,"C's",1
32,"32024",4821,3320,3254,34,66,"C's",244
40,"40036",515,421,410,3,11,"C's",47
37,"37248",152,126,125,1,1,"C's",20
47,"47059",97,76,76,2,0,"C's",12
39,"39039",568,382,379,0,3,"C's",21
50,"50162",146,109,105,4,4,"C's",9
47,"47168",29,26,26,1,0,"C's",4
30,"30038",15411,10847,10767,46,80,"C's",1721
5,"5084",74,53,53,0,0,"C's",1
9,"9434",1227,922,909,6,13,"C's",183
9,"9039",58,46,46,2,0,"C's",6
31,"31191",3016,2167,2147,22,20,"C's",138
46,"46032",5653,4402,4361,33,41,"C's",630
36,"36052",7292,4999,4907,45,92,"C's",402
50,"50163",3689,2702,2680,37,22,"C's",628
46,"46214",15766,12131,12036,42,95,"C's",2045
5,"5036",123,101,101,1,0,"C's",6
33,"33016",19130,13666,13526,125,140,"C's",1778
39,"39040",4292,3208,3166,14,42,"C's",478
50,"50224",72,57,56,2,1,"C's",5
30,"30039",19277,13165,13054,75,111,"C's",1847
44,"44005",50,30,30,0,0,"C's",9
10,"10219",1276,796,790,7,6,"C's",69
47,"47060",258,216,214,1,2,"C's",32
40,"40040",2607,1843,1828,19,15,"C's",266
12,"12053",2034,1655,1633,6,22,"C's",172
18,"18135",4568,3009,2961,14,48,"C's",291
37,"37124",212,146,144,1,2,"C's",11
26,"26152",33,28,28,1,0,"C's",2
26,"26117",2152,1625,1605,10,20,"C's",164
13,"13007",1271,993,977,8,16,"C's",47
19,"19134",24,15,15,0,0,"C's",3
42,"42030",94,78,78,1,0,"C's",13
42,"42164",1600,1150,1127,8,23,"C's",150
37,"37251",124,93,92,1,1,"C's",18
16,"16091",65,53,53,0,0,"C's",5
49,"49120",74,53,52,0,1,"C's",7
46,"46216",5053,4109,4090,14,19,"C's",758
34,"34050",200,153,152,0,1,"C's",4
6,"6011",24723,16883,16718,137,165,"C's",2285
37,"37126",29,24,24,0,0,"C's",1
9,"9903",3221,2304,2281,27,23,"C's",257
49,"49243",111,94,93,0,1,"C's",6
19,"19011",250,184,184,0,0,"C's",23
1,"1061",154,127,127,1,0,"C's",3
19,"19246",46,36,34,2,2,"C's",3
27,"27063",1737,1226,1186,14,40,"C's",41
39,"39043",1481,1122,1115,9,7,"C's",149
9,"9439",1028,752,744,9,8,"C's",166
46,"46250",578719,442973,440154,2541,2819,"C's",67957
36,"36019",1625,1042,1029,9,13,"C's",60
50,"50037",136,98,96,0,2,"C's",20
10,"10132",396,278,275,0,3,"C's",8
50,"50228",268,210,208,5,2,"C's",31
18,"18003",14022,9938,9820,80,118,"C's",1587
44,"44113",71,52,52,0,0,"C's",0
32,"32030",999,736,726,3,10,"C's",18
22,"22205",438,322,320,0,2,"C's",27
34,"34096",55,42,42,0,0,"C's",5
33,"33051",7061,4640,4587,27,53,"C's",557
3,"3023",1398,1184,1167,7,17,"C's",123
44,"44115",102,90,90,3,0,"C's",1
15,"15060",5772,4032,3958,46,74,"C's",385
48,"48084",22449,14670,14553,90,117,"C's",348
37,"37129",251,204,201,3,3,"C's",36
45,"45151",578,417,414,0,3,"C's",26
2,"2038",281,223,223,0,0,"C's",21
21,"21043",1871,1310,1285,9,25,"C's",121
47,"47063",103,81,80,1,1,"C's",9
26,"26017",381,293,293,5,0,"C's",27
6,"6105",624,418,417,1,1,"C's",28
20,"20024",386,210,209,3,1,"C's",3
15,"15061",5571,3746,3691,27,55,"C's",251
22,"22207",125,72,71,2,1,"C's",11
9,"9310",13,9,8,0,1,"C's",2
6,"6106",423,274,272,5,2,"C's",32
20,"20058",755,529,525,3,4,"C's",18
9,"9906",1219,902,898,8,4,"C's",103
30,"30043",24967,18981,18685,101,296,"C's",3069
44,"44080",292,229,223,3,6,"C's",15
50,"50136",575,414,410,2,4,"C's",54
45,"45152",587,458,451,0,7,"C's",35
9,"9311",59,46,45,0,1,"C's",2
41,"41047",10117,7515,7422,74,93,"C's",1257
47,"47064",33,28,25,0,3,"C's",2
9,"9443",179,128,124,0,4,"C's",10
45,"45086",496,351,343,2,8,"C's",19
26,"26019",355,274,271,1,3,"C's",34
45,"45164",182,162,160,1,2,"C's",17
9,"9177",1121,757,749,9,8,"C's",105
19,"19142",265,182,180,3,2,"C's",14
47,"47174",267,218,215,1,3,"C's",27
49,"49007",370,255,249,1,6,"C's",23
9,"9908",449,307,306,3,1,"C's",34
47,"47148",442,342,338,2,4,"C's",55
47,"47229",210,148,147,1,1,"C's",14
44,"44118",164,132,131,2,1,"C's",21
18,"18050",1710,1165,1152,3,13,"C's",118
50,"50138",46,37,37,2,0,"C's",1
46,"46246",1058,835,823,5,12,"C's",94
44,"44082",89,78,77,0,1,"C's",11
9,"9314",94,73,70,0,3,"C's",6
12,"12061",373,285,282,3,3,"C's",29
20,"20027",2814,1761,1750,15,11,"C's",9
13,"13018",822,642,640,6,2,"C's",46
5,"5242",681,559,558,8,1,"C's",31
15,"15065",7315,5187,5099,42,88,"C's",426
40,"40218",92,65,64,1,1,"C's",3
32,"32037",728,518,509,6,9,"C's",25
24,"24163",3962,2950,2933,24,17,"C's",562
47,"47149",42,34,34,3,0,"C's",4
34,"34152",125,96,92,1,4,"C's",11
49,"49091",260,193,193,0,0,"C's",13
40,"40135",283,236,231,2,5,"C's",18
22,"22008",173,137,133,3,4,"C's",11
49,"49128",552,423,414,3,9,"C's",30
50,"50233",106,81,81,0,0,"C's",14
37,"37176",133,110,110,0,0,"C's",9
19,"19182",38,34,33,0,1,"C's",4
31,"31212",147,102,102,4,0,"C's",5
19,"19183",74,65,65,0,0,"C's",4
22,"22213",3003,2169,2131,19,38,"C's",278
47,"47230",303,246,242,2,4,"C's",38
10,"10095",338,259,251,1,8,"C's",20
5,"5245",353,286,285,3,1,"C's",48
40,"40052",74,60,60,0,0,"C's",6
33,"33056",4997,3269,3244,22,25,"C's",374
31,"31102",143,69,69,0,0,"C's",0
5,"5102",1780,1339,1317,3,22,"C's",124
10,"10096",3408,2440,2391,12,49,"C's",212
44,"44047",220,137,132,2,5,"C's",7
47,"47068",34,26,26,0,0,"C's",0
47,"47177",105,76,73,1,3,"C's",9
49,"49093",280,223,222,1,1,"C's",28
26,"26023",469,358,354,0,4,"C's",27
21,"21050",12427,8036,7969,80,67,"C's",848
4,"4903",4320,2858,2825,19,33,"C's",276
50,"50266",122,90,90,0,0,"C's",6
38,"38041",6821,4908,4861,40,47,"C's",521
23,"23064",1655,1363,1353,1,10,"C's",59
50,"50174",91,69,68,0,1,"C's",3
10,"10143",154,112,112,0,0,"C's",5
31,"31004",35,21,21,0,0,"C's",0
39,"39051",66,57,57,0,0,"C's",9
21,"21052",4583,2734,2663,22,71,"C's",162
5,"5249",105,84,82,0,2,"C's",4
19,"19023",124,100,98,2,2,"C's",15
4,"4076",1279,960,944,8,16,"C's",101
46,"46224",159,121,121,0,0,"C's",12
45,"45192",2491,2069,2049,2,20,"C's",192
34,"34019",125,107,105,0,2,"C's",17
46,"46172",5042,3504,3477,22,27,"C's",501
13,"13024",898,633,627,3,6,"C's",42
46,"46233",3860,2859,2817,10,42,"C's",322
40,"40182",178,133,130,2,3,"C's",12
9,"9449",86,68,66,0,2,"C's",21
28,"28161",48848,35503,35203,210,300,"C's",8290
42,"42181",412,313,307,2,6,"C's",24
4,"4013",141378,94872,94288,741,584,"C's",14265
18,"18151",260,171,170,3,1,"C's",16
9,"9184",5,4,4,0,0,"C's",1
3,"3042",1393,1010,996,7,14,"C's",126
45,"45060",173,126,125,1,1,"C's",12
40,"40183",130,120,119,2,1,"C's",6
38,"38007",1661,1114,1103,6,11,"C's",86
13,"13079",12244,8582,8450,72,132,"C's",875
37,"37006",138,103,103,2,0,"C's",8
19,"19027",138,105,105,1,0,"C's",7
9,"9057",145,108,108,0,0,"C's",11
33,"33060",14633,9647,9474,72,173,"C's",612
31,"31040",192,139,138,4,1,"C's",5
32,"32091",1838,1368,1362,6,6,"C's",30
46,"46259",491,396,393,4,3,"C's",47
11,"11902",3629,2275,2252,25,23,"C's",178
37,"37183",414,306,304,0,2,"C's",22
24,"24169",2969,2140,2118,13,22,"C's",130
37,"37267",200,156,147,2,9,"C's",25
15,"15072",9574,6637,6562,35,75,"C's",443
31,"31107",1710,1255,1243,16,12,"C's",83
42,"42183",111,82,82,2,0,"C's",2
3,"3128",4092,2861,2840,10,21,"C's",493
47,"47155",3228,2277,2254,18,23,"C's",392
26,"26060",84,62,62,2,0,"C's",5
28,"28102",894,644,636,6,8,"C's",85
26,"26061",1565,1160,1141,13,19,"C's",148
29,"29095",3321,2376,2307,24,69,"C's",177
33,"33062",400,238,233,2,5,"C's",17
44,"44194",109,78,73,3,5,"C's",9
37,"37185",591,423,417,2,6,"C's",92
22,"22903",652,514,507,1,7,"C's",71
9,"9326",140,112,111,0,1,"C's",27
3,"3035",652,547,541,1,6,"C's",43
49,"49176",667,433,431,1,2,"C's",18
49,"49137",176,139,138,0,1,"C's",11
49,"49099",115,87,87,0,0,"C's",10
5,"5257",132,101,101,0,0,"C's",10
31,"31009",677,507,505,5,2,"C's",15
16,"16271",633,517,516,4,1,"C's",26
22,"22221",84,58,58,0,0,"C's",13
46,"46261",1725,1356,1337,5,19,"C's",108
37,"37312",258,201,200,2,1,"C's",18
49,"49018",329,261,256,2,5,"C's",10
5,"5258",111,95,95,0,0,"C's",13
47,"47074",149,117,116,2,1,"C's",7
47,"47210",382,282,274,3,8,"C's",21
10,"10212",1684,1233,1203,7,30,"C's",115
49,"49224",162,112,112,1,0,"C's",8
23,"23073",4507,3229,3200,13,29,"C's",255
24,"24071",1006,745,734,10,11,"C's",49
41,"41058",17395,12556,12332,111,224,"C's",1849
40,"40230",94,68,66,0,2,"C's",11
40,"40105",47,42,42,2,0,"C's",9
31,"31143",96,55,54,1,1,"C's",2
19,"19300",772,595,591,5,4,"C's",115
24,"24006",472,353,347,0,6,"C's",35
9,"9298",82,70,69,1,1,"C's",13
44,"44128",68,54,54,1,0,"C's",6
32,"32051",1427,1184,1172,6,12,"C's",44
21,"21060",11957,7356,7279,88,77,"C's",956
32,"32052",1888,1399,1379,6,20,"C's",79
15,"15077",8261,5186,5103,59,83,"C's",378
10,"10108",219,148,146,0,2,"C's",18
40,"40062",60,51,48,0,3,"C's",11
40,"40233",417,314,310,3,4,"C's",38
27,"27037",1065,750,740,11,10,"C's",23
34,"34221",179,144,144,3,0,"C's",14
12,"12135",35719,26016,25793,196,223,"C's",4091
50,"50149",34,24,24,0,0,"C's",0
16,"16066",2325,1788,1745,19,43,"C's",161
5,"5179",214,178,176,1,2,"C's",15
40,"40107",100,73,73,1,0,"C's",9
19,"19076",27,19,19,0,0,"C's",0
20,"20039",2111,1480,1472,14,8,"C's",12
2,"2017",838,594,589,1,5,"C's",29
5,"5116",109,89,89,1,0,"C's",7
9,"9239",52,40,39,0,1,"C's",6
47,"47159",822,644,636,1,8,"C's",71
16,"16038",38,31,31,0,0,"C's",2
37,"37234",345,247,247,1,0,"C's",16
10,"10201",173,142,142,2,0,"C's",13
12,"12106",1158,955,942,8,13,"C's",104
27,"27039",4358,3143,3085,40,58,"C's",231
37,"37317",304,238,234,1,4,"C's",24
20,"20040",15289,9444,9373,66,71,"C's",186
47,"47213",109,82,82,0,0,"C's",7
46,"46127",2692,2120,2091,18,29,"C's",171
9,"9332",140,106,106,2,0,"C's",23
26,"26067",22,15,15,1,0,"C's",4
3,"3134",143,112,111,0,1,"C's",9
12,"12075",123,88,88,0,0,"C's",5
26,"26034",654,497,489,1,8,"C's",37
31,"31048",176,132,130,4,2,"C's",11
19,"19079",8,8,7,0,1,"C's",0
21,"21023",2124,1298,1264,7,34,"C's",99
5,"5119",32,22,22,0,0,"C's",2
40,"40068",26,24,24,0,0,"C's",5
3,"3071",3982,3048,3012,26,36,"C's",380
50,"50153",935,713,708,6,5,"C's",56
28,"28138",60,46,46,0,0,"C's",7
37,"37017",245,182,177,1,5,"C's",13
22,"22228",514,364,360,5,4,"C's",89
31,"31115",165,102,101,1,1,"C's",4
31,"31214",91,64,62,1,2,"C's",1
22,"22141",117,91,90,1,1,"C's",6
19,"19040",52,41,39,0,2,"C's",4
12,"12007",746,651,636,3,15,"C's",49
19,"19080",65,41,41,0,0,"C's",1
16,"16026",82,62,61,2,1,"C's",5
44,"44132",60,54,54,1,0,"C's",5
46,"46129",524,420,412,4,8,"C's",21
50,"50154",116,96,96,0,0,"C's",15
40,"40070",149,107,105,1,2,"C's",9
47,"47088",103,86,85,1,1,"C's",7
49,"49108",466,346,344,0,2,"C's",28
33,"33069",3491,2430,2390,17,40,"C's",236
48,"48905",2553,1792,1771,12,21,"C's",39
15,"15082",15180,10841,10726,102,115,"C's",1221
5,"5267",101,72,70,0,2,"C's",8
47,"47080",30,22,21,0,1,"C's",3
42,"42018",152,117,116,1,1,"C's",17
26,"26081",16,14,14,0,0,"C's",1
36,"36042",17891,12212,12003,93,209,"C's",1107
34,"34140",107,67,67,0,0,"C's",3
10,"10116",3749,2726,2670,21,56,"C's",269
41,"41065",22779,14769,14636,132,133,"C's",1735
11,"11021",6764,4434,4362,52,72,"C's",525
33,"33070",3351,2403,2373,26,30,"C's",240
3,"3043",2911,2431,2399,13,32,"C's",355
32,"32060",832,583,576,8,7,"C's",27
26,"26143",220,175,173,1,2,"C's",32
24,"24179",290,197,192,4,5,"C's",21
38,"38020",15113,9928,9830,59,98,"C's",1035
4,"4089",742,521,518,1,3,"C's",54
47,"47189",152,119,118,0,1,"C's",14
5,"5075",107,72,72,0,0,"C's",6
19,"19001",49,42,42,0,0,"C's",2
48,"48073",6910,4306,4271,31,35,"C's",18
45,"45106",7439,5613,5534,52,79,"C's",467
33,"33010",1822,1190,1180,17,10,"C's",126
39,"39064",1345,1031,1015,7,16,"C's",139
37,"37281",36,33,31,0,2,"C's",1
23,"23084",935,658,653,7,5,"C's",28
45,"45173",9520,6938,6864,30,74,"C's",993
21,"21070",6258,4165,4092,48,73,"C's",370
24,"24149",152,120,116,3,4,"C's",5
19,"19124",386,260,257,0,3,"C's",25
40,"40158",17,12,12,0,0,"C's",1
20,"20046",1223,739,737,5,2,"C's",25
35,"35015",9950,5139,5070,29,69,"C's",475
3,"3045",210,176,172,0,4,"C's",16
16,"16172",325,268,267,1,1,"C's",17
32,"32063",1914,1297,1279,16,18,"C's",73
16,"16125",1667,1249,1231,3,18,"C's",136
9,"9117",76,60,60,0,0,"C's",5
37,"37023",1413,1072,1060,5,12,"C's",279
20,"20047",469,307,304,5,3,"C's",3
50,"50157",290,220,218,3,2,"C's",9
9,"9343",93,66,65,0,1,"C's",4
50,"50092",299,233,231,0,2,"C's",36
46,"46002",1175,941,932,5,9,"C's",92
40,"40201",49,42,42,0,0,"C's",4
27,"27051",8108,5503,5424,62,79,"C's",434
31,"31087",171,128,124,2,4,"C's",1
49,"49113",167,137,135,1,2,"C's",12
38,"38024",15077,9512,9356,55,156,"C's",1260
34,"34132",114,89,86,0,3,"C's",7
50,"50199",334,244,242,3,2,"C's",27
50,"50231",250,195,192,4,3,"C's",18
46,"46211",1745,1387,1378,8,9,"C's",189
44,"44240",158,130,129,0,1,"C's",18
9,"9480",110,90,90,1,0,"C's",10
3,"3901",1135,822,817,8,5,"C's",138
32,"32065",657,463,454,3,9,"C's",23
50,"50282",69,54,54,0,0,"C's",11
24,"24116",417,314,309,1,5,"C's",37
3,"3110",291,241,241,1,0,"C's",23
28,"28095",1529,1119,1106,6,13,"C's",175
16,"16083",52,33,33,0,0,"C's",3
49,"49115",184,136,135,0,1,"C's",10
37,"37026",189,146,146,0,0,"C's",18
23,"23048",870,619,613,1,6,"C's",45
21,"21074",2649,1755,1733,13,22,"C's",94
46,"46212",1620,1150,1124,9,26,"C's",130
6,"6003",823,627,616,1,11,"C's",68
50,"50094",1617,1173,1159,12,14,"C's",124
23,"23008",1502,1144,1131,9,13,"C's",56
37,"37330",339,248,246,0,2,"C's",21
32,"32022",1337,892,881,6,11,"C's",34
49,"49033",714,508,505,1,3,"C's",46
44,"44035",113,90,88,1,2,"C's",10
31,"31134",176,125,124,0,1,"C's",3
11,"11027",67913,45219,44833,454,386,"C's",7196
42,"42202",20,14,13,0,1,"C's",1
33,"33075",271,154,153,2,1,"C's",8
21,"21075",349,275,270,4,5,"C's",22
31,"31123",647,369,361,5,8,"C's",12
19,"19170",193,135,135,0,0,"C's",15
37,"37288",262,182,181,4,1,"C's",30
31,"31903",6654,4402,4343,27,59,"C's",273
2,"2031",565,457,455,0,2,"C's",33
28,"28022",33479,27129,27037,133,92,"C's",6372
6,"6006",4572,3088,3049,26,39,"C's",290
26,"26150",112,101,95,0,6,"C's",3
29,"29077",199,149,146,2,3,"C's",6
37,"37122",201,154,153,5,1,"C's",27
3,"3112",628,511,507,2,4,"C's",63
5,"5133",66,53,53,0,0,"C's",6
32,"32070",548,335,329,3,6,"C's",14
31,"31124",208,148,148,2,0,"C's",5
31,"31125",274,194,193,6,1,"C's",16
33,"33077",1192,811,808,5,3,"C's",41
6,"6007",1475,1038,1032,1,6,"C's",51
44,"44037",453,317,315,0,2,"C's",30
29,"29023",2081,1354,1340,4,14,"C's",268
28,"28099",1748,1290,1283,7,7,"C's",194
5,"5197",102,85,83,1,2,"C's",6
50,"50173",182,132,131,1,1,"C's",10
10,"10035",1920,1343,1315,5,28,"C's",68
6,"6008",632,525,519,2,6,"C's",26
28,"28178",1065,824,818,5,6,"C's",162
37,"37030",85,66,66,0,0,"C's",12
9,"9351",62,49,48,1,1,"C's",6
47,"47087",381,301,297,3,4,"C's",53
5,"5135",425,317,315,5,2,"C's",31
49,"49241",248,177,177,0,0,"C's",20
27,"27007",2805,2133,2078,38,55,"C's",114
32,"32072",3821,2705,2667,24,38,"C's",137
46,"46111",10930,7931,7828,44,103,"C's",1249
9,"9078",41,30,30,1,0,"C's",5
42,"42207",40,33,32,0,1,"C's",3
26,"26047",1947,1578,1563,8,15,"C's",94
15,"15901",3546,2247,2228,24,19,"C's",148
37,"37031",361,269,266,2,3,"C's",40
42,"42131",51,37,37,1,0,"C's",2
22,"22244",52,38,37,0,1,"C's",5
33,"33018",2901,2000,1976,18,24,"C's",216
45,"45014",4010,2646,2616,22,30,"C's",264
9,"9352",114,92,92,1,0,"C's",18
5,"5040",66,50,50,1,0,"C's",2
49,"49121",365,273,273,2,0,"C's",43
31,"31261",231,173,169,3,4,"C's",14
34,"34020",52,39,39,0,0,"C's",3
44,"44246",1543,1045,1027,12,18,"C's",157
50,"50175",1002,695,688,5,7,"C's",93
22,"22114",123,81,81,0,0,"C's",7
23,"23015",1374,1029,1019,5,10,"C's",74
14,"14007",15207,10558,10417,82,141,"C's",1295
37,"37033",95,68,68,5,0,"C's",7
9,"9003",194,147,146,0,1,"C's",11
24,"24158",320,207,203,2,4,"C's",31
49,"49122",782,526,520,5,6,"C's",90
37,"37127",214,154,151,1,3,"C's",19
42,"42209",140,107,106,4,1,"C's",2
6,"6103",4796,3265,3220,20,45,"C's",332
47,"47180",73,61,60,4,1,"C's",9
44,"44040",201,160,157,1,3,"C's",13
5,"5157",232,162,159,1,3,"C's",14
31,"31129",395,234,234,0,0,"C's",1
5,"5140",111,89,87,0,2,"C's",4
35,"35022",48603,29443,29042,160,401,"C's",3589
18,"18140",43496,28038,27872,212,166,"C's",3536
23,"23097",6443,4117,4063,21,54,"C's",469
40,"40212",27,23,22,2,1,"C's",1
9,"9354",33,29,28,2,1,"C's",4
19,"19177",76,61,59,0,2,"C's",5
47,"47198",69,50,50,0,0,"C's",2
19,"19055",52,41,41,1,0,"C's",2
47,"47090",2418,1728,1699,8,29,"C's",186
28,"28092",151841,110916,109954,582,962,"C's",18788
37,"37035",190,150,150,2,0,"C's",16
42,"42212",69,43,43,1,0,"C's",6
40,"40213",86,65,65,3,0,"C's",7
5,"5142",99,88,85,0,3,"C's",10
47,"47091",84,71,71,2,0,"C's",4
49,"49247",443,283,279,2,4,"C's",29
31,"31231",117,76,73,1,3,"C's",8
34,"34201",193,158,155,1,3,"C's",17
19,"19178",33,22,22,0,0,"C's",2
18,"18143",973,742,730,5,12,"C's",61
34,"34055",270,209,207,2,2,"C's",24
50,"50169",351,269,265,0,4,"C's",26
24,"24193",378,268,265,2,3,"C's",34
44,"44043",102,74,72,0,2,"C's",17
9,"9221",461,343,338,3,5,"C's",60
5,"5095",262,225,223,1,2,"C's",14
23,"23099",4769,3359,3309,16,50,"C's",297
50,"50104",348,271,269,2,2,"C's",46
16,"16111",171,123,123,1,0,"C's",4
42,"42011",18,10,10,1,0,"C's",3
31,"31032",1713,1209,1193,24,16,"C's",77
47,"47092",110,87,87,0,0,"C's",16
47,"47039",185,141,140,0,1,"C's",5
16,"16019",214,156,152,0,4,"C's",4
49,"49043",289,217,213,1,4,"C's",12
19,"19058",6793,5258,5218,19,40,"C's",1123
19,"19179",69,56,56,1,0,"C's",0
41,"41081",29189,20205,20015,196,190,"C's",2549
10,"10030",465,309,309,1,0,"C's",25
41,"41048",2228,1470,1447,15,23,"C's",153
36,"36024",16455,11971,11781,109,190,"C's",1138
4,"4041",322,240,238,6,2,"C's",25
9,"9133",40,32,32,0,0,"C's",4
40,"40091",119,97,95,1,2,"C's",15
19,"19059",77,61,58,1,3,"C's",9
42,"42217",31,25,24,0,1,"C's",3
45,"45088",2115,1351,1338,4,13,"C's",230
37,"37040",391,299,297,2,2,"C's",39
29,"29088",2714,1829,1800,12,29,"C's",153
31,"31200",761,517,508,3,9,"C's",17
13,"13071",39454,26316,26107,183,209,"C's",2983
16,"16147",64,45,45,0,0,"C's",8
23,"23037",502,404,400,6,4,"C's",27
9,"9134",221,161,156,7,5,"C's",15
50,"50012",100,80,79,2,1,"C's",4
31,"31001",88,62,62,0,0,"C's",2
21,"21008",2658,1660,1636,10,24,"C's",106
42,"42128",42,42,41,1,1,"C's",3
13,"13072",768,579,572,5,7,"C's",54
3,"3058",4951,3897,3851,30,46,"C's",450
16,"16116",77,68,68,0,0,"C's",5
6,"6127",2863,2112,2088,10,24,"C's",164
18,"18193",14343,9951,9847,93,104,"C's",1661
38,"38039",10641,7547,7459,49,88,"C's",861
42,"42082",8,8,8,1,0,"C's",1
34,"34154",74,55,53,1,2,"C's",1
9,"9226",63,54,54,0,0,"C's",4
20,"20062",973,653,653,11,0,"C's",6
10,"10004",704,492,482,9,10,"C's",31
9,"9093",154,121,119,0,2,"C's",16
31,"31036",909,636,628,7,8,"C's",30
5,"5152",678,554,551,3,3,"C's",38
42,"42130",59,46,45,1,1,"C's",1
49,"49011",232,168,165,6,3,"C's",7
31,"31135",106,70,66,2,4,"C's",10
50,"50076",78,66,65,0,1,"C's",6
36,"36040",2575,1709,1680,15,29,"C's",121
4,"4021",185,151,148,1,3,"C's",11
50,"50276",125,104,103,2,1,"C's",7
45,"45124",2140,1677,1641,10,36,"C's",132
47,"47151",27,24,24,0,0,"C's",3
30,"30018",7978,5866,5811,30,55,"C's",762
9,"9014",195,115,114,1,1,"C's",11
16,"16055",691,466,463,2,3,"C's",56
24,"24031",215,172,168,0,4,"C's",20
26,"26057",48,38,38,0,0,"C's",5
47,"47178",172,140,140,3,0,"C's",12
44,"44155",1090,793,782,4,11,"C's",65
22,"22012",111,87,86,3,1,"C's",11
4,"4012",191,161,161,0,0,"C's",16
45,"45092",232,197,191,0,6,"C's",11
33,"33028",1276,649,641,4,8,"C's",44
27,"27025",2831,2152,2110,17,42,"C's",164
50,"50205",90,63,61,0,2,"C's",10
50,"50110",367,256,254,0,2,"C's",23
9,"9382",33,28,28,0,0,"C's",3
40,"40155",3518,2656,2605,18,51,"C's",641
32,"32089",1295,888,878,7,10,"C's",37
26,"26058",154,116,115,0,1,"C's",9
41,"41087",10237,6923,6774,48,149,"C's",1029
50,"50267",602,433,430,8,3,"C's",45
26,"26025",87,71,70,1,1,"C's",3
19,"19150",128,99,99,1,0,"C's",8
47,"47162",74,60,60,0,0,"C's",12
33,"33008",1777,1238,1229,3,9,"C's",94
37,"37062",83,65,64,1,1,"C's",8
37,"37376",2233,1539,1515,6,24,"C's",225
29,"29004",312,236,233,2,3,"C's",19
31,"31172",373,278,272,3,6,"C's",29
9,"9368",22,17,17,2,0,"C's",2
11,"11901",5648,3676,3631,67,45,"C's",346
48,"48032",5743,4065,4048,29,17,"C's",55
3,"3063",26462,18591,18492,91,99,"C's",3018
34,"34214",183,144,144,0,0,"C's",14
49,"49259",89,66,65,1,1,"C's",8
37,"37309",44,30,30,1,0,"C's",4
45,"45005",238,193,192,3,1,"C's",7
18,"18017",18114,11610,11510,77,100,"C's",1780
41,"41066",1342,945,927,2,18,"C's",54
10,"10193",1412,1090,1078,6,12,"C's",124
37,"37050",66,52,52,0,0,"C's",7
32,"32001",4986,3488,3443,25,45,"C's",204
9,"9101",76,56,55,1,1,"C's",4
24,"24003",648,460,453,7,7,"C's",36
13,"13082",25805,16871,16706,120,165,"C's",2307
40,"40101",877,635,628,8,7,"C's",166
9,"9415",268,175,175,2,0,"C's",32
40,"40016",58,49,49,0,0,"C's",8
49,"49056",300,211,208,2,3,"C's",22
32,"32062",811,621,617,6,4,"C's",11
28,"28065",126539,96997,96210,505,787,"C's",15670
40,"40228",510,390,382,1,8,"C's",27
47,"47073",122,103,101,1,2,"C's",7
47,"47046",118,92,90,1,2,"C's",12
13,"13030",139,98,96,0,2,"C's",12
45,"45096",1004,807,799,1,8,"C's",61
31,"31141",110,71,70,1,1,"C's",1
19,"19261",37,25,24,0,1,"C's",1
12,"12036",581,426,421,10,5,"C's",39
10,"10150",346,285,279,3,6,"C's",15
31,"31042",2714,1974,1942,22,32,"C's",117
19,"19073",23,19,19,0,0,"C's",3
9,"9232",154,119,116,0,3,"C's",9
38,"38047",1777,1198,1170,4,28,"C's",129
49,"49261",1537,1048,1033,8,15,"C's",131
32,"32049",760,510,507,9,3,"C's",9
40,"40104",265,198,195,0,3,"C's",16
37,"37052",273,209,209,2,0,"C's",15
19,"19114",37,26,26,0,0,"C's",1
24,"24115",54058,37780,37357,308,423,"C's",4754
22,"22078",438,319,316,3,3,"C's",48
22,"22904",815,579,575,8,4,"C's",57
2,"2054",386,291,290,0,1,"C's",28
47,"47022",59,50,49,0,1,"C's",6
46,"46159",22857,16840,16697,128,143,"C's",2442
46,"46098",2482,1907,1889,11,18,"C's",210
15,"15001",4765,3280,3237,25,43,"C's",359
42,"42092",56,44,42,1,2,"C's",8
15,"15050",1822,1004,988,13,16,"C's",56
15,"15025",1061,629,622,6,7,"C's",36
19,"19314",51,36,36,0,0,"C's",4
32,"32020",2576,1923,1899,5,24,"C's",44
35,"35034",7873,3975,3943,27,32,"C's",493
37,"37056",37,30,29,0,1,"C's",3
5,"5163",1737,1347,1340,4,7,"C's",140
13,"13087",23137,15677,15480,133,197,"C's",2359
31,"31144",796,445,444,6,1,"C's",9
44,"44163",126,94,94,1,0,"C's",10
40,"40020",157,118,117,1,1,"C's",16
19,"19156",970,704,699,4,5,"C's",75
37,"37013",119,79,76,0,3,"C's",11
14,"14049",16309,11635,11515,115,120,"C's",1337
46,"46056",182,167,166,1,1,"C's",12
22,"22200",244,184,182,5,2,"C's",28
40,"40178",98,73,71,1,2,"C's",2
37,"37357",262,205,203,1,2,"C's",19
46,"46022",15365,11093,10997,59,96,"C's",1517
50,"50182",3399,2364,2335,21,29,"C's",508
31,"31145",172,128,128,4,0,"C's",6
13,"13037",842,661,652,1,9,"C's",38
3,"3079",18224,13904,13709,80,195,"C's",2306
46,"46031",10535,7543,7451,66,92,"C's",955
40,"40063",7096,5184,5100,36,84,"C's",681
47,"47049",101,68,68,0,0,"C's",4
31,"31246",140,111,107,1,4,"C's",7
32,"32053",1438,1158,1144,11,14,"C's",48
40,"40108",112,82,82,0,0,"C's",6
13,"13090",1094,843,828,4,15,"C's",45
50,"50151",636,499,499,0,0,"C's",60
41,"41028",2003,1524,1511,9,13,"C's",277
5,"5067",83,68,67,0,1,"C's",9
12,"12137",36,23,23,0,0,"C's",0
37,"37191",114,78,75,1,3,"C's",3
10,"10019",1498,1063,1054,3,9,"C's",119
22,"22139",79,64,64,1,0,"C's",5
37,"37359",184,130,129,0,1,"C's",7
47,"47222",83,64,64,1,0,"C's",6
16,"16102",1205,912,905,12,7,"C's",78
3,"3123",7476,5557,5501,29,56,"C's",801
49,"49024",672,459,454,5,5,"C's",65
9,"9287",208,158,156,3,2,"C's",26
23,"23040",1480,1199,1192,2,7,"C's",92
31,"31114",366,245,241,8,4,"C's",8
47,"47133",2682,2033,2015,16,18,"C's",409
26,"26002",830,632,622,0,10,"C's",69
7,"7009",738,521,510,12,11,"C's",49
6,"6039",1840,1469,1437,9,32,"C's",60
44,"44234",61,51,51,1,0,"C's",5
9,"9335",88,68,68,0,0,"C's",10
41,"41030",514,387,373,3,14,"C's",21
32,"32057",565,416,415,4,1,"C's",18
21,"21025",4026,2433,2396,30,37,"C's",226
29,"29046",2675,1825,1807,14,18,"C's",215
5,"5072",81,67,67,1,0,"C's",7
13,"13094",304,249,247,1,2,"C's",17
34,"34189",56,44,44,1,0,"C's",4
50,"50006",925,674,657,6,17,"C's",88
20,"20076",6990,4666,4648,29,18,"C's",79
37,"37321",168,132,132,2,0,"C's",17
16,"16027",710,542,538,5,4,"C's",40
12,"12009",17445,12088,11999,75,89,"C's",2004
19,"19197",27,22,22,0,0,"C's",2
10,"10023",835,616,607,2,9,"C's",39
40,"40041",979,725,717,5,8,"C's",121
13,"13009",1439,1115,1098,9,17,"C's",128
34,"34242",95,71,68,3,3,"C's",5
48,"48041",693,533,529,3,4,"C's",13
10,"10161",76,53,53,0,0,"C's",3
2,"2022",351,281,279,1,2,"C's",23
28,"28170",2472,1640,1622,13,18,"C's",218
33,"33009",905,611,609,3,2,"C's",72
16,"16029",99,72,70,0,2,"C's",10
28,"28113",34751,25832,25612,120,220,"C's",5236
46,"46078",28017,20288,20143,132,145,"C's",2765
50,"50278",197,145,145,0,0,"C's",14
50,"50089",8225,6074,6043,43,31,"C's",1586
31,"31095",75,59,59,1,0,"C's",0
18,"18122",16114,11098,10945,83,153,"C's",1532
37,"37211",224,172,172,4,0,"C's",29
40,"40224",22,21,21,0,0,"C's",1
37,"37082",796,551,544,4,7,"C's",46
42,"42020",4263,2877,2821,35,56,"C's",307
47,"47137",29,25,25,1,0,"C's",1
24,"24113",366,293,287,5,6,"C's",41
18,"18170",330,219,217,0,2,"C's",16
20,"20012",147,99,98,5,1,"C's",1
5,"5025",94,79,78,0,1,"C's",8
46,"46235",21579,15929,15763,113,166,"C's",1884
50,"50249",302,226,220,0,6,"C's",18
45,"45118",1991,1351,1339,6,12,"C's",144
40,"40199",105,84,84,0,0,"C's",32
28,"28172",9077,6992,6936,31,56,"C's",1605
7,"7015",20991,12552,12433,184,119,"C's",1912
10,"10165",257,208,207,0,1,"C's",12
24,"24150",243,172,172,6,0,"C's",12
48,"48044",62774,45594,45399,287,195,"C's",2328
40,"40118",51,35,34,1,1,"C's",5
4,"4060",445,348,345,5,3,"C's",36
42,"42156",28,16,16,1,0,"C's",4
41,"41035",1108,794,780,7,14,"C's",54
19,"19311",82,69,67,0,2,"C's",7
47,"47110",450,350,346,1,4,"C's",27
28,"28084",15859,11156,11058,64,98,"C's",1932
44,"44206",114,90,87,0,3,"C's",12
12,"12012",2685,2234,2202,13,32,"C's",209
31,"31054",462,255,250,4,5,"C's",12
50,"50159",665,512,507,2,5,"C's",45
50,"50126",2371,1573,1559,19,14,"C's",199
9,"9389",73,60,60,1,0,"C's",1
28,"28155",506,416,411,0,5,"C's",47
13,"13084",892,701,685,6,16,"C's",54
10,"10090",513,362,353,2,9,"C's",15
18,"18097",960,693,685,5,8,"C's",81
42,"42108",12,9,9,1,0,"C's",0
12,"12093",178,137,136,2,1,"C's",5
37,"37328",186,135,131,1,4,"C's",13
47,"47111",1020,742,732,7,10,"C's",101
37,"37244",131,98,98,0,0,"C's",11
45,"45120",129,104,104,1,0,"C's",12
20,"20081",7470,4856,4833,40,23,"C's",91
50,"50293",413,276,275,4,1,"C's",22
37,"37342",259,189,186,0,3,"C's",33
44,"44174",428,307,304,3,3,"C's",51
9,"9250",269,196,194,1,2,"C's",9
37,"37161",136,106,106,1,0,"C's",8
6,"6094",1485,929,926,2,3,"C's",45
50,"50221",35,17,17,0,0,"C's",2
16,"16036",126,109,106,0,3,"C's",14
10,"10078",406,321,314,6,7,"C's",18
47,"47140",115,102,102,1,0,"C's",6
22,"22067",65,50,50,1,0,"C's",4
30,"30005",29526,20713,20526,121,187,"C's",3368
51,"51001",59125,31093,30737,316,356,"C's",3542
48,"48058",968,647,646,2,1,"C's",13
23,"23024",12435,9058,8833,55,225,"C's",984
9,"9075",112,91,91,3,0,"C's",14
48,"48048",557,395,393,5,2,"C's",2
18,"18177",418,258,256,0,2,"C's",10
46,"46239",442,340,338,3,2,"C's",33
47,"47032",152,117,116,1,1,"C's",7
12,"12015",93,81,78,0,3,"C's",3
36,"36026",20137,13779,13596,141,183,"C's",1319
5,"5195",220,169,169,2,0,"C's",20
5,"5180",86,67,63,3,4,"C's",4
37,"37073",586,448,438,2,10,"C's",80
19,"19319",4449,3086,3056,18,30,"C's",662
5,"5229",82,68,67,0,1,"C's",9
28,"28148",85454,62367,61884,370,483,"C's",11747
42,"42204",54,38,38,1,0,"C's",5
9,"9433",60,48,45,1,3,"C's",2
26,"26114",79,66,65,1,1,"C's",7
5,"5230",66,63,62,1,1,"C's",6
4,"4031",2338,1772,1762,2,10,"C's",149
49,"49240",206,162,161,2,1,"C's",10
9,"9214",672,427,427,4,0,"C's",27
10,"10034",353,260,257,2,3,"C's",12
5,"5182",786,538,532,2,6,"C's",52
48,"48090",6001,4345,4295,28,50,"C's",97
49,"49023",967,673,662,10,11,"C's",87
46,"46179",2165,1760,1737,16,23,"C's",180
19,"19147",43,33,33,0,0,"C's",1
45,"45157",2128,1456,1427,13,29,"C's",187
28,"28150",3087,2294,2277,10,17,"C's",415
19,"19009",259,200,195,6,5,"C's",14
24,"24021",1675,1162,1144,8,18,"C's",89
9,"9395",138,104,104,0,0,"C's",7
12,"12118",72,55,53,0,2,"C's",3
45,"45114",588,447,447,0,0,"C's",44
46,"46163",1866,1504,1480,8,24,"C's",222
31,"31093",292,188,188,2,0,"C's",2
10,"10036",329,241,238,1,3,"C's",5
5,"5087",134,87,85,1,2,"C's",5
46,"46189",467,393,390,2,3,"C's",40
37,"37078",829,674,664,8,10,"C's",78
6,"6055",2051,1453,1422,8,31,"C's",92
42,"42118",23,17,17,0,0,"C's",0
22,"22215",128,96,96,1,0,"C's",13
26,"26105",2205,1670,1658,12,12,"C's",227
45,"45115",2552,1999,1966,8,33,"C's",262
47,"47061",256,212,211,2,1,"C's",13
45,"45048",358,278,275,1,3,"C's",25
9,"9043",192,137,133,1,4,"C's",18
18,"18059",4180,2907,2870,20,37,"C's",358
15,"15019",25888,16680,16460,186,220,"C's",1656
9,"9229",198,146,143,0,3,"C's",5
5,"5251",60,42,42,1,0,"C's",6
34,"34035",111,98,97,0,1,"C's",2
26,"26048",22,22,22,0,0,"C's",2
39,"39012",6687,5021,4957,51,64,"C's",691
29,"29058",1450,911,894,4,17,"C's",100
36,"36055",13620,9580,9400,62,180,"C's",931
12,"12120",177,152,152,0,0,"C's",13
10,"10086",320,238,233,1,5,"C's",26
31,"31062",1087,830,818,3,12,"C's",51
41,"41043",639,436,427,5,9,"C's",42
32,"32075",4217,3089,3044,33,45,"C's",268
45,"45094",387,298,297,1,1,"C's",25
31,"31139",159,96,95,0,1,"C's",6
46,"46156",2080,1697,1675,10,22,"C's",167
5,"5253",86,70,68,0,2,"C's",11
27,"27012",1355,736,729,5,7,"C's",29
50,"50197",90,67,67,2,0,"C's",10
45,"45150",443,356,354,0,2,"C's",15
26,"26119",197,156,155,4,1,"C's",5
12,"12121",1107,924,893,4,31,"C's",43
9,"9403",94,78,78,1,0,"C's",10
21,"21002",15478,10597,10507,94,90,"C's",1900
12,"12057",606,487,474,5,13,"C's",51
50,"50050",98,64,64,2,0,"C's",7
37,"37212",104,78,74,0,4,"C's",17
42,"42167",251,175,172,2,3,"C's",15
23,"23018",2325,1668,1653,10,15,"C's",123
33,"33021",4573,3024,2971,22,53,"C's",289
19,"19102",98,79,78,0,1,"C's",5
37,"37083",182,156,155,0,1,"C's",14
27,"27014",3254,2103,2067,21,36,"C's",139
4,"4036",226,175,175,0,0,"C's",13
45,"45018",498,333,330,4,3,"C's",46
49,"49124",253,174,169,1,5,"C's",9
40,"40087",92,71,70,1,1,"C's",6
50,"50291",96,74,74,0,0,"C's",3
42,"42076",216,179,174,5,5,"C's",14
18,"18187",557,383,379,0,4,"C's",24
12,"12024",143,125,124,0,1,"C's",8
4,"4037",1314,969,955,6,14,"C's",85
16,"16192",48,31,30,1,1,"C's",3
40,"40088",284,228,224,0,4,"C's",26
19,"19139",29,19,18,0,1,"C's",2
47,"47182",1323,977,967,8,10,"C's",116
19,"19167",130,101,99,0,2,"C's",14
37,"37010",939,708,702,0,6,"C's",109
6,"6078",507,409,404,1,5,"C's",8
19,"19017",69,57,57,0,0,"C's",3
22,"22054",1542,1091,1077,13,14,"C's",186
9,"9417",40,32,32,1,0,"C's",0
4,"4007",734,524,522,1,2,"C's",68
31,"31066",855,589,579,8,10,"C's",23
50,"50272",12904,8880,8819,84,61,"C's",1860
24,"24194",290,212,212,3,0,"C's",13
44,"44107",218,152,152,5,0,"C's",18
37,"37119",107,84,82,0,2,"C's",9
6,"6109",3919,3139,3012,24,127,"C's",221
16,"16049",149,111,110,0,1,"C's",4
5,"5193",193,167,164,1,3,"C's",15
1,"1043",2304,1552,1532,13,20,"C's",109
9,"9011",65,48,48,0,0,"C's",5
34,"34057",471,339,338,1,1,"C's",41
19,"19330",71,63,63,2,0,"C's",6
22,"22209",155,120,120,3,0,"C's",17
31,"31100",262,170,168,1,2,"C's",20
12,"12094",847,674,665,5,9,"C's",82
31,"31167",826,606,596,9,10,"C's",34
40,"40190",53,45,44,0,1,"C's",10
34,"34072",152,136,135,2,1,"C's",7
31,"31101",1373,973,966,8,7,"C's",56
22,"22212",79,64,62,0,2,"C's",6
19,"19106",89,59,59,0,0,"C's",8
41,"41902",4659,2679,2646,23,33,"C's",206
9,"9051",170,130,128,0,2,"C's",7
33,"33025",9174,5838,5786,57,52,"C's",659
22,"22137",1069,727,718,3,9,"C's",97
28,"28013",40471,28739,28490,188,249,"C's",4676
48,"48902",19008,12566,12447,76,119,"C's",351
47,"47094",133,115,114,1,1,"C's",4
1,"1031",1169,882,863,6,19,"C's",46
6,"6067",1972,1308,1292,8,16,"C's",104
50,"50108",48,38,38,0,0,"C's",7
3,"3091",252,217,215,2,2,"C's",9
44,"44085",52,35,35,0,0,"C's",3
45,"45123",3081,2144,2131,11,13,"C's",417
47,"47123",466,354,352,4,2,"C's",44
24,"24030",4277,3038,3007,11,31,"C's",310
49,"49169",35,26,26,0,0,"C's",5
42,"42041",34,25,25,0,0,"C's",5
49,"49048",124,97,95,0,2,"C's",15
32,"32010",388,301,299,3,2,"C's",7
33,"33067",784,587,579,9,8,"C's",44
42,"42205",89,71,71,2,0,"C's",8
33,"33036",11542,8062,7987,60,75,"C's",926
7,"7008",5692,3956,3913,26,43,"C's",505
37,"37318",208,159,158,1,1,"C's",28
48,"48040",1281,877,869,3,8,"C's",11
46,"46197",1942,1527,1514,5,13,"C's",179
39,"39080",3542,2656,2628,20,28,"C's",342
29,"29035",1567,1157,1144,11,13,"C's",38
18,"18194",2128,1451,1437,9,14,"C's",181
42,"42003",67,48,47,0,1,"C's",8
50,"50204",2436,1785,1770,3,15,"C's",172
9,"9137",174,132,131,3,1,"C's",18
26,"26093",53,39,38,0,1,"C's",5
33,"33027",834,506,498,4,8,"C's",37
22,"22174",478,379,378,2,1,"C's",32
46,"46198",839,684,674,4,10,"C's",54
33,"33058",1796,1232,1209,11,23,"C's",86
38,"38006",39766,20776,20587,139,189,"C's",2243
28,"28071",60,55,53,1,2,"C's",7
23,"23054",382,282,281,1,1,"C's",9
22,"22188",82,60,59,6,1,"C's",2
48,"48001",5838,3923,3898,28,25,"C's",116
45,"45025",1205,831,827,2,4,"C's",104
12,"12129",1828,1322,1298,11,24,"C's",125
16,"16224",83,66,65,1,1,"C's",7
10,"10008",1319,1019,1008,6,11,"C's",79
21,"21026",266,166,159,3,7,"C's",29
45,"45204",632,488,487,1,1,"C's",55
44,"44146",174,153,152,2,1,"C's",12
2,"2075",1670,1321,1304,4,17,"C's",94
28,"28151",3142,2235,2199,8,36,"C's",408
49,"49053",931,709,699,8,10,"C's",86
22,"22050",88,77,77,0,0,"C's",6
19,"19111",155,126,126,1,0,"C's",4
37,"37098",333,247,247,1,0,"C's",26
44,"44089",45,39,39,1,0,"C's",7
9,"9018",24668,17575,17369,111,206,"C's",2857
37,"37141",154,122,122,2,0,"C's",16
49,"49097",85,52,51,0,1,"C's",5
34,"34127",93,65,64,1,1,"C's",5
37,"37156",4292,2996,2966,24,30,"C's",411
28,"28017",1208,907,899,7,8,"C's",152
37,"37307",159,104,103,1,1,"C's",4
26,"26059",1125,828,812,5,16,"C's",102
6,"6074",4791,3513,3449,18,64,"C's",387
28,"28162",2617,2029,2016,6,13,"C's",468
7,"7041",2044,1486,1451,13,35,"C's",99
5,"5059",106,82,81,1,1,"C's",8
37,"37226",155,123,123,2,0,"C's",11
10,"10056",586,457,452,4,5,"C's",21
13,"13029",84,71,71,0,0,"C's",8
9,"9019",150,92,90,0,2,"C's",10
23,"23004",436,364,358,1,6,"C's",21
5,"5076",478,386,378,4,8,"C's",52
37,"37352",207,153,152,1,1,"C's",26
45,"45162",669,494,486,2,8,"C's",36
19,"19166",156,120,119,1,1,"C's",14
46,"46053",553,445,436,2,9,"C's",36
34,"34024",31,21,21,1,0,"C's",2
2,"2012",1835,1476,1453,7,23,"C's",161
40,"40017",92,75,75,0,0,"C's",16
46,"46071",464,383,377,0,6,"C's",30
20,"20068",190,135,135,3,0,"C's",0
24,"24137",1099,783,778,7,5,"C's",53
24,"24037",360,254,250,2,4,"C's",22
37,"37101",160,128,125,0,3,"C's",7
39,"39025",8637,6486,6378,47,108,"C's",834
42,"42141",112,80,80,0,0,"C's",5
2,"2053",2998,2231,2189,16,42,"C's",263
19,"19125",41,32,32,0,0,"C's",5
22,"22064",166,122,121,1,1,"C's",6
35,"35007",511,316,309,2,7,"C's",25
16,"16082",291,213,212,0,1,"C's",4
10,"10136",302,218,215,4,3,"C's",17
35,"35024",13735,8545,8439,77,106,"C's",1284
48,"48086",2050,1414,1401,5,13,"C's",33
10,"10197",123,90,89,0,1,"C's",9
6,"6002",4322,2819,2762,22,57,"C's",300
22,"22234",794,552,544,3,8,"C's",97
18,"18022",13432,8491,8407,67,84,"C's",1362
15,"15038",2227,1463,1443,25,20,"C's",104
23,"23087",11292,8222,8084,59,138,"C's",864
12,"12113",83,67,66,3,1,"C's",1
3,"3120",2406,1753,1720,11,33,"C's",209
37,"37258",172,116,115,3,1,"C's",12
16,"16098",561,456,454,3,2,"C's",40
5,"5064",103,83,82,0,1,"C's",4
18,"18909",579,435,429,0,6,"C's",30
49,"49166",1227,946,933,6,13,"C's",111
30,"30025",4908,3667,3630,16,37,"C's",462
5,"5211",459,345,343,1,2,"C's",33
9,"9023",1102,818,811,11,7,"C's",164
23,"23074",3021,2317,2295,11,22,"C's",171
47,"47102",291,230,220,1,10,"C's",17
5,"5212",231,164,163,2,1,"C's",10
33,"33014",9037,5999,5938,53,61,"C's",614
6,"6050",4106,3134,3075,25,59,"C's",278
31,"31012",793,563,555,6,8,"C's",21
9,"9090",54,48,48,0,0,"C's",5
42,"42160",254,206,205,0,1,"C's",16
38,"38014",1357,935,926,3,9,"C's",88
24,"24142",25119,17336,17141,154,195,"C's",2751
22,"22226",767,570,562,10,8,"C's",63
34,"34236",156,120,119,0,1,"C's",11
26,"26113",35,35,34,0,1,"C's",2
47,"47085",16612,11829,11706,114,123,"C's",1711
26,"26138",4588,3290,3247,15,43,"C's",419
40,"40191",215,181,179,1,2,"C's",17
12,"12040",117608,85588,84946,496,642,"C's",14244
44,"44243",24,20,20,0,0,"C's",3
28,"28087",3186,2503,2487,19,16,"C's",370
34,"34074",707,540,531,9,9,"C's",64
45,"45034",1353,1082,1078,6,4,"C's",131
38,"38016",1223,638,623,3,15,"C's",24
9,"9422",17,11,11,0,0,"C's",0
29,"29044",809,561,561,3,0,"C's",62
47,"47214",1409,1087,1062,7,25,"C's",118
19,"19119",82,72,71,1,1,"C's",10
26,"26011",7321,5133,5083,38,50,"C's",643
24,"24155",471,388,384,6,4,"C's",35
37,"37108",99,79,78,0,1,"C's",9
2,"2072",1549,1086,1070,2,16,"C's",81
26,"26164",59,46,45,2,1,"C's",8
40,"40109",73,59,59,1,0,"C's",7
37,"37192",356,231,227,2,4,"C's",50
24,"24042",63,56,56,1,0,"C's",2
47,"47160",425,308,303,0,5,"C's",15
46,"46050",194,150,149,0,1,"C's",12
40,"40025",136,117,115,0,2,"C's",7
47,"47051",335,268,263,2,5,"C's",51
18,"18165",4123,2787,2758,18,29,"C's",429
9,"9242",80,66,66,2,0,"C's",4
47,"47161",3918,3145,3126,12,19,"C's",585
22,"22909",315,226,225,4,1,"C's",18
44,"44167",38,31,31,0,0,"C's",1
37,"37320",95,72,72,0,0,"C's",2
38,"38018",4402,3058,3011,16,47,"C's",207
41,"41042",5844,4424,4378,40,46,"C's",323
31,"31227",8180,5885,5809,76,76,"C's",263
19,"19121",246,199,194,1,5,"C's",13
50,"50121",277,216,214,1,2,"C's",13
47,"47052",6576,4988,4944,40,44,"C's",1046
50,"50036",104,91,90,0,1,"C's",8
29,"29047",1117,885,866,1,19,"C's",56
42,"42132",141,114,114,0,0,"C's",6
44,"44074",429,333,326,4,7,"C's",42
49,"49014",112,91,91,2,0,"C's",9
47,"47179",395,293,287,0,6,"C's",50
37,"37208",76,56,54,1,2,"C's",3
50,"50227",109,79,79,0,0,"C's",8
16,"16122",249,188,187,0,1,"C's",23
50,"50196",107,87,86,0,1,"C's",4
36,"36043",4747,3210,3162,20,48,"C's",243
30,"30031",492,409,401,0,8,"C's",55
44,"44203",10,10,10,0,0,"C's",0
1,"1052",245,184,181,0,3,"C's",0
41,"41032",3984,2811,2725,27,86,"C's",286
50,"50134",128,91,89,2,2,"C's",12
34,"34022",1082,873,861,9,12,"C's",67
32,"32090",774,530,511,4,19,"C's",26
26,"26178",75,57,55,1,2,"C's",7
31,"31018",393,292,285,4,7,"C's",14
37,"37378",111,77,75,2,2,"C's",6
10,"10087",1687,1218,1212,6,6,"C's",99
50,"50090",150,113,112,0,1,"C's",19
16,"16228",172,137,137,4,0,"C's",10
41,"41034",23070,14805,14625,186,180,"C's",1974
31,"31118",164,112,111,1,1,"C's",1
26,"26108",266,215,213,0,2,"C's",17
15,"15047",2429,1576,1549,19,27,"C's",94
44,"44148",90,75,73,2,2,"C's",14
28,"28181",20386,16155,16069,57,86,"C's",3236
9,"9294",108,86,82,0,4,"C's",3
30,"30032",2856,2163,2144,6,19,"C's",213
42,"42168",107,80,80,0,0,"C's",4
13,"13013",7068,5147,5063,25,84,"C's",659
47,"47029",57,52,52,0,0,"C's",7
47,"47218",993,743,734,2,9,"C's",82
49,"49071",765,495,490,2,5,"C's",35
24,"24016",466,270,269,1,1,"C's",17
46,"46210",330,277,277,2,0,"C's",34
39,"39065",252,191,189,1,2,"C's",21
40,"40159",142,100,99,1,1,"C's",10
10,"10211",444,337,336,0,1,"C's",16
34,"34179",28,21,20,0,1,"C's",4
46,"46080",998,803,799,7,4,"C's",61
42,"42157",13,10,10,0,0,"C's",1
46,"46219",127,112,112,1,0,"C's",9
37,"37037",117,84,82,0,2,"C's",22
38,"38023",121908,81147,80333,494,814,"C's",8773
1,"1902",734,514,502,4,12,"C's",29
16,"16157",211,179,179,2,0,"C's",8
12,"12048",251,185,182,0,3,"C's",21
24,"24038",3089,2312,2273,17,39,"C's",211
37,"37381",147,114,107,2,7,"C's",17
24,"24060",602,363,361,3,2,"C's",31
16,"16250",76,59,59,0,0,"C's",2
49,"49075",137,120,119,0,1,"C's",8
44,"44207",156,118,115,4,3,"C's",7
32,"32081",2077,1517,1500,14,17,"C's",96
46,"46168",1938,1495,1486,2,9,"C's",203
34,"34233",130,107,107,1,0,"C's",7
37,"37368",17,17,17,0,0,"C's",5
44,"44066",108,79,74,0,5,"C's",3
33,"33074",3484,2298,2274,24,24,"C's",184
38,"38025",6880,4839,4761,30,78,"C's",515
28,"28165",1794,1293,1285,3,8,"C's",188
31,"31122",4773,3520,3506,26,14,"C's",236
9,"9211",1441,1056,1039,9,17,"C's",108
50,"50128",26,25,25,1,0,"C's",1
19,"19127",89,64,64,0,0,"C's",2
28,"28078",38,32,32,0,0,"C's",5
19,"19241",43,34,34,1,0,"C's",2
28,"28147",963,722,720,5,2,"C's",81
21,"21047",1917,1111,1065,15,46,"C's",66
26,"26124",807,649,639,7,10,"C's",28
10,"10031",165,135,134,1,1,"C's",19
32,"32083",835,559,550,4,9,"C's",28
46,"46143",4239,3104,3053,14,51,"C's",306
50,"50222",1622,1091,1071,7,20,"C's",103
5,"5083",140,110,105,1,5,"C's",16
46,"46187",1306,1017,1000,0,17,"C's",104
44,"44187",201,152,149,4,3,"C's",28
41,"41903",6757,4562,4504,51,58,"C's",639
46,"46048",3452,2749,2713,14,36,"C's",263
28,"28176",12491,9723,9667,37,56,"C's",2074
48,"48912",2308,1707,1679,14,28,"C's",50
21,"21036",200,141,139,0,2,"C's",4
46,"46118",3763,2940,2908,16,32,"C's",293
18,"18012",2278,1662,1641,13,21,"C's",145
41,"41039",31663,22062,21830,193,232,"C's",3079
24,"24063",374,254,252,2,2,"C's",32
26,"26044",52,46,46,0,0,"C's",7
16,"16132",35,27,26,0,1,"C's",3
47,"47142",141,99,97,0,2,"C's",14
23,"23091",729,555,553,5,2,"C's",23
44,"44110",49,42,42,1,0,"C's",2
35,"35001",4584,3282,3222,26,60,"C's",225
42,"42191",185,136,133,0,3,"C's",17
44,"44144",346,248,245,2,3,"C's",24
15,"15079",1540,1027,1007,16,20,"C's",40
50,"50055",3611,2445,2407,22,38,"C's",431
10,"10064",1476,1092,1072,7,20,"C's",62
49,"49134",172,121,119,0,2,"C's",8
37,"37249",43,29,29,0,0,"C's",2
28,"28110",1944,1478,1463,4,15,"C's",157
31,"31192",156,129,127,3,2,"C's",5
41,"41041",9706,7239,7120,36,119,"C's",897
22,"22202",141,119,119,0,0,"C's",18
49,"49081",1382,1016,1003,9,13,"C's",120
5,"5232",102,84,79,1,5,"C's",8
48,"48914",332,272,272,1,0,"C's",0
6,"6100",935,780,774,1,6,"C's",25
46,"46215",1436,1154,1143,5,11,"C's",69
45,"45147",581,450,446,1,4,"C's",53
22,"22203",83,67,67,1,0,"C's",6
50,"50225",1570,956,950,3,6,"C's",105
46,"46146",1654,1304,1278,7,26,"C's",144
49,"49230",97,72,72,0,0,"C's",4
46,"46904",792,610,603,8,7,"C's",71
32,"32073",1315,973,960,5,13,"C's",41
30,"30009",12433,9586,9503,41,83,"C's",1173
9,"9127",56,41,39,0,2,"C's",3
10,"10099",583,378,374,2,4,"C's",33
31,"31105",1507,1167,1142,7,25,"C's",65
45,"45170",228,176,167,0,9,"C's",8
23,"23066",4347,3465,3410,15,55,"C's",320
42,"42100",32,30,30,0,0,"C's",3
23,"23001",963,801,799,1,2,"C's",29
44,"44156",45,31,31,1,0,"C's",3
31,"31127",138,98,95,0,3,"C's",3
50,"50258",54,34,34,0,0,"C's",6
5,"5234",49,44,44,2,0,"C's",6
16,"16092",158,125,125,1,0,"C's",8
47,"47197",876,673,668,8,5,"C's",51
34,"34094",64,45,44,0,1,"C's",8
37,"37080",225,171,167,0,4,"C's",31
22,"22162",130,102,102,0,0,"C's",27
10,"10147",1278,961,925,7,36,"C's",49
50,"50059",769,549,544,8,5,"C's",74
37,"37020",430,326,321,1,5,"C's",38
45,"45105",392,301,297,3,4,"C's",29
45,"45061",2447,1703,1689,12,14,"C's",156
19,"19288",21,21,20,0,1,"C's",2
10,"10102",529,411,405,5,6,"C's",19
4,"4069",4687,3471,3437,27,34,"C's",468
22,"22246",76,50,50,0,0,"C's",4
44,"44008",1613,1163,1153,6,10,"C's",129
13,"13012",413,274,273,1,1,"C's",17
44,"44216",26555,18997,18737,168,260,"C's",3039
34,"34245",307,209,208,5,1,"C's",18
46,"46018",608,515,511,0,4,"C's",35
34,"34216",66,50,50,0,0,"C's",10
4,"4005",556,437,431,3,6,"C's",37
40,"40086",685,561,552,4,9,"C's",72
42,"42139",23,15,15,1,0,"C's",3
42,"42060",38,21,19,1,2,"C's",2
33,"33052",721,485,482,3,3,"C's",49
34,"34246",67,53,51,0,2,"C's",6
9,"9442",375,279,277,2,2,"C's",29
45,"45052",2948,2321,2295,16,26,"C's",413
5,"5094",139,116,116,1,0,"C's",11
20,"20057",196,122,122,0,0,"C's",1
9,"9373",425,287,285,2,2,"C's",21
16,"16142",136,101,101,1,0,"C's",3
50,"50240",1025,729,718,10,11,"C's",82
46,"46245",511,420,415,0,5,"C's",44
34,"34006",81,67,66,2,1,"C's",6
50,"50209",2601,1731,1721,13,10,"C's",305
3,"3086",151,135,134,1,1,"C's",14
18,"18006",4130,2904,2864,13,40,"C's",262
45,"45097",1046,839,834,4,5,"C's",88
28,"28075",5621,4186,4148,26,38,"C's",805
39,"39046",1404,1001,973,6,28,"C's",77
29,"29062",654,551,545,2,6,"C's",16
31,"31209",155,107,106,0,1,"C's",1
19,"19033",64,52,50,1,2,"C's",3
37,"37145",259,190,189,2,1,"C's",21
42,"42187",62,46,45,1,1,"C's",3
29,"29041",3175,2090,2045,24,45,"C's",286
6,"6032",68,53,53,1,0,"C's",8
15,"15087",5769,3766,3722,42,44,"C's",256
3,"3016",93,75,75,0,0,"C's",12
47,"47004",1181,939,930,7,9,"C's",101
46,"46012",896,682,663,1,19,"C's",95
40,"40006",22,18,18,0,0,"C's",2
46,"46116",13159,10193,10135,53,58,"C's",1700
11,"11026",4782,3451,3378,26,73,"C's",511
48,"48087",427,344,338,0,6,"C's",8
5,"5097",475,317,313,0,4,"C's",30
40,"40177",153,125,125,1,0,"C's",10
10,"10139",114,82,78,1,4,"C's",4
22,"22250",353,261,258,4,3,"C's",35
49,"49249",69,58,58,1,0,"C's",2
2,"2015",1441,1112,1093,5,19,"C's",88
31,"31111",95,65,65,2,0,"C's",1
37,"37301",74,63,63,0,0,"C's",9
5,"5227",358,253,250,1,3,"C's",28
9,"9408",41,36,36,0,0,"C's",5
44,"44119",130,92,91,3,1,"C's",8
10,"10094",234,196,196,1,0,"C's",9
44,"44013",11244,7815,7712,82,103,"C's",1254
18,"18068",1569,1189,1166,6,23,"C's",161
37,"37014",1155,817,808,7,9,"C's",89
46,"46135",9680,7682,7634,36,48,"C's",1249
49,"49155",79,61,60,3,1,"C's",4
49,"49078",170,141,140,1,1,"C's",7
49,"49129",853,592,574,9,18,"C's",37
19,"19265",122,97,95,2,2,"C's",12
27,"27057",11169,7551,7386,79,165,"C's",607
14,"14041",3182,2296,2251,33,45,"C's",244
29,"29100",2433,1684,1667,5,17,"C's",202
26,"26126",31,27,27,0,0,"C's",2
37,"37001",192,151,148,0,3,"C's",23
9,"9316",105,80,80,1,0,"C's",11
37,"37262",78,64,63,0,1,"C's",6
32,"32085",10716,7279,7152,66,127,"C's",454
44,"44025",6009,4087,3997,25,90,"C's",517
50,"50066",2621,1862,1851,9,11,"C's",361
5,"5017",85,82,81,5,1,"C's",8
22,"22035",234,165,159,3,6,"C's",18
34,"34170",61,42,42,0,0,"C's",7
9,"9038",119,100,100,0,0,"C's",0
46,"46185",378,320,313,2,7,"C's",22
44,"44157",64,48,48,1,0,"C's",1
29,"29038",17676,11056,10970,141,86,"C's",1853
9,"9109",1056,619,595,8,24,"C's",72
14,"14070",1332,986,974,10,12,"C's",49
3,"3135",211,170,166,2,4,"C's",5
16,"16259",29,22,21,0,1,"C's",1
47,"47096",140,110,110,0,0,"C's",13
50,"50236",102,79,77,0,2,"C's",5
42,"42177",69,60,60,1,0,"C's",5
26,"26128",105,81,81,1,0,"C's",8
23,"23905",1868,1277,1272,6,5,"C's",118
34,"34062",171,119,118,2,1,"C's",10
40,"40026",119,109,109,0,0,"C's",12
49,"49242",447,360,357,5,3,"C's",36
6,"6010",1105,819,801,5,18,"C's",64
42,"42193",14,10,10,0,0,"C's",1
4,"4056",143,113,109,0,4,"C's",3
31,"31204",36,28,28,1,0,"C's",1
26,"26177",304,255,254,7,1,"C's",17
37,"37018",107,79,79,0,0,"C's",6
31,"31039",80,61,60,0,1,"C's",1
20,"20043",1739,1090,1088,9,2,"C's",8
37,"37046",11225,7824,7697,53,127,"C's",1259
9,"9412",790,528,523,4,5,"C's",46
10,"10007",629,459,454,5,5,"C's",31
14,"14034",308,247,244,2,3,"C's",23
35,"35021",14924,10477,10370,45,107,"C's",1744
9,"9307",109,81,80,0,1,"C's",8
29,"29093",2214,1643,1621,3,22,"C's",103
40,"40056",34,28,28,1,0,"C's",1
10,"10101",185,145,141,1,4,"C's",11
13,"13028",10418,8075,7976,52,99,"C's",940
46,"46069",162,124,123,0,1,"C's",10
48,"48012",2049,1527,1512,7,15,"C's",15
50,"50288",3387,2415,2398,31,17,"C's",543
48,"48093",893,653,643,7,10,"C's",7
24,"24202",8008,5367,5276,53,91,"C's",423
46,"46234",348,279,275,3,4,"C's",29
19,"19329",59,50,50,1,0,"C's",10
36,"36023",8395,5965,5884,41,81,"C's",482
19,"19152",556,390,382,1,8,"C's",24
46,"46044",4218,3222,3158,18,64,"C's",440
48,"48094",3161,2094,2073,12,21,"C's",17
12,"12101",358,279,275,3,4,"C's",32
21,"21015",680,398,393,8,5,"C's",40
19,"19271",46,39,39,0,0,"C's",1
21,"21069",1702,1167,1149,6,18,"C's",99
49,"49188",112,90,89,1,1,"C's",9
29,"29072",3262,2382,2352,17,30,"C's",252
10,"10088",204,131,128,1,3,"C's",6
41,"41067",7093,4930,4866,37,64,"C's",494
26,"26157",296,241,237,4,4,"C's",31
13,"13083",2423,1693,1653,10,40,"C's",140
15,"15074",4037,2841,2796,20,45,"C's",237
31,"31208",2556,1949,1920,16,29,"C's",143
6,"6121",3355,2279,2248,8,31,"C's",209
19,"19272",72,54,53,1,1,"C's",3
29,"29006",673,428,420,1,8,"C's",31
2,"2026",836,690,679,3,11,"C's",56
10,"10105",2512,1644,1620,12,24,"C's",164
13,"13032",1137,841,835,2,6,"C's",62
31,"31253",129,109,109,0,0,"C's",0
50,"50241",588,415,410,4,5,"C's",37
29,"29018",2010,1472,1420,9,52,"C's",148
4,"4061",638,506,498,4,8,"C's",77
38,"38035",9474,5616,5564,36,52,"C's",693
37,"37117",1494,1067,1048,3,19,"C's",258
36,"36047",2454,1633,1621,13,12,"C's",64
24,"24070",4124,3024,2981,20,43,"C's",195
41,"41046",3023,2213,2183,5,30,"C's",202
29,"29074",794,586,581,0,5,"C's",60
46,"46055",1262,1025,1012,5,13,"C's",131
13,"13051",346,264,264,1,0,"C's",15
20,"20015",1265,858,851,7,7,"C's",2
46,"46176",2017,1358,1349,5,9,"C's",185
47,"47083",80,59,54,1,5,"C's",4
6,"6128",4447,2975,2935,26,40,"C's",295
47,"47139",1040,777,767,6,10,"C's",76
44,"44138",135,98,94,0,4,"C's",9
21,"21005",15523,9038,8913,56,125,"C's",838
48,"48057",5723,3988,3962,26,26,"C's",20
46,"46229",948,762,758,0,4,"C's",71
49,"49225",147,91,90,0,1,"C's",6
41,"41059",34165,24949,24709,196,240,"C's",4389
46,"46047",532,446,437,2,9,"C's",29
46,"46151",728,550,541,0,9,"C's",75
39,"39027",3118,2322,2295,26,27,"C's",321
24,"24173",951,679,674,9,5,"C's",68
50,"50903",2214,1602,1585,8,17,"C's",259
28,"28117",104,89,89,1,0,"C's",12
36,"36049",6804,4960,4860,36,100,"C's",506
33,"33034",10612,6602,6536,62,66,"C's",615
29,"29032",6657,5031,4977,33,54,"C's",490
37,"37217",58,45,44,0,1,"C's",4
48,"48068",1550,1130,1118,12,12,"C's",3
33,"33065",1102,722,713,7,9,"C's",79
34,"34088",246,193,186,1,7,"C's",25
2,"2030",3065,2287,2263,6,24,"C's",228
18,"18910",788,541,536,3,5,"C's",63
26,"26077",22,22,21,1,1,"C's",0
21,"21035",9617,6033,5943,76,90,"C's",511
40,"40123",147,114,106,0,8,"C's",21
37,"37028",147,116,112,0,4,"C's",5
46,"46222",384,307,304,1,3,"C's",37
49,"49194",368,218,216,1,2,"C's",19
38,"38027",5414,3618,3571,16,47,"C's",366
16,"16009",62,51,50,0,1,"C's",4
30,"30027",48176,35521,35266,153,255,"C's",6356
40,"40901",384,309,307,4,2,"C's",67
44,"44120",222,154,150,2,4,"C's",18
18,"18013",4218,3024,2986,15,38,"C's",365
49,"49079",106,93,92,1,1,"C's",7
40,"40024",856,651,639,6,12,"C's",97
6,"6158",13314,9654,9507,67,147,"C's",1167
44,"44123",105,71,70,1,1,"C's",3
34,"34027",1085,751,741,6,10,"C's",64
5,"5209",85,70,70,0,0,"C's",2
41,"41011",15401,10170,9986,111,184,"C's",872
28,"28143",72,57,57,1,0,"C's",8
30,"30028",6649,4797,4726,21,71,"C's",546
24,"24088",1029,791,789,10,2,"C's",76
9,"9901",371,263,259,4,4,"C's",43
2,"2020",432,365,364,1,1,"C's",24
50,"50057",1395,919,907,11,12,"C's",142
3,"3041",5954,4218,4194,22,24,"C's",590
35,"35011",24002,15928,15684,95,244,"C's",1979
44,"44100",185,153,151,0,2,"C's",10
15,"15081",1034,791,782,11,9,"C's",19
44,"44201",495,411,406,0,5,"C's",50
31,"31126",358,223,223,2,0,"C's",6
19,"19109",39,32,32,0,0,"C's",4
49,"49052",187,133,132,1,1,"C's",13
4,"4066",13571,8786,8724,50,62,"C's",864
49,"49037",185,153,151,0,2,"C's",17
40,"40111",58,49,49,0,0,"C's",4
6,"6101",463,381,378,2,3,"C's",25
10,"10145",127,97,95,0,2,"C's",1
10,"10160",229,190,189,2,1,"C's",10
41,"41086",16170,10162,10088,73,74,"C's",1359
37,"37194",251,196,195,1,1,"C's",12
15,"15044",1286,937,927,8,10,"C's",53
50,"50277",50,42,41,0,1,"C's",3
37,"37139",205,169,168,2,1,"C's",33
10,"10130",1761,1300,1277,6,23,"C's",64
1,"1013",712,454,450,0,4,"C's",14
29,"29082",31885,22572,22400,152,172,"C's",4608
49,"49038",99,71,65,1,6,"C's",7
50,"50248",508,387,374,2,13,"C's",34
13,"13045",674,508,499,1,9,"C's",48
46,"46130",901,687,683,3,4,"C's",63
13,"13010",883,646,634,3,12,"C's",42
44,"44018",19,19,19,0,0,"C's",0
31,"31251",3115,2240,2205,15,35,"C's",159
47,"47225",80,63,63,0,0,"C's",9
32,"32050",2433,1829,1814,12,15,"C's",69
23,"23903",3540,2662,2634,13,28,"C's",181
19,"19223",111,83,83,3,0,"C's",6
44,"44044",88,72,71,2,1,"C's",6
28,"28064",129,106,106,2,0,"C's",15
19,"19199",17,17,17,1,0,"C's",2
26,"26038",89,68,67,0,1,"C's",5
5,"5024",224,169,168,3,1,"C's",10
11,"11023",9348,6410,6349,64,61,"C's",646
34,"34005",851,673,658,4,15,"C's",65
47,"47037",168,138,133,0,5,"C's",5
31,"31263",233,138,137,2,1,"C's",0
18,"18047",5903,3893,3857,28,36,"C's",612
19,"19054",192,164,164,1,0,"C's",16
41,"41033",5075,3313,3277,34,36,"C's",346
32,"32077",1166,791,785,14,6,"C's",48
38,"38033",3702,2505,2464,8,41,"C's",210
23,"23005",30465,20878,20630,177,248,"C's",2699
26,"26180",221,173,172,0,1,"C's",28
50,"50219",4119,2833,2804,19,29,"C's",626
49,"49150",139,112,111,1,1,"C's",4
31,"31152",1328,924,900,11,24,"C's",45
23,"23085",2252,1655,1644,6,11,"C's",85
22,"22117",2478,1714,1693,22,21,"C's",229
9,"9429",56,41,41,0,0,"C's",3
45,"45108",509,412,411,1,1,"C's",22
21,"21004",1631,1045,1028,13,17,"C's",68
19,"19310",9,7,7,0,0,"C's",0
47,"47119",92,80,79,1,1,"C's",6
40,"40214",208,168,168,2,0,"C's",24
22,"22125",38773,27021,26732,258,289,"C's",4599
48,"48079",427,305,304,2,1,"C's",1
13,"13004",1025,807,800,4,7,"C's",32
47,"47129",871,664,659,4,5,"C's",84
49,"49205",382,293,291,2,2,"C's",22
34,"34165",66,58,58,1,0,"C's",4
9,"9103",217,184,183,1,1,"C's",9
29,"29097",4108,2871,2821,37,50,"C's",357
5,"5177",158,130,129,0,1,"C's",12
40,"40093",77,65,65,1,0,"C's",10
28,"28044",5826,4445,4409,24,36,"C's",896
42,"42087",49,43,42,0,1,"C's",7
6,"6123",4627,3182,3120,18,62,"C's",318
37,"37159",90,70,70,1,0,"C's",10
6,"6150",802,602,596,4,6,"C's",65
10,"10092",292,236,235,1,1,"C's",22
26,"26147",30,28,27,0,1,"C's",3
30,"30035",18671,13103,12979,54,124,"C's",2316
44,"44034",139,109,108,0,1,"C's",10
50,"50160",2238,1546,1528,12,18,"C's",185
42,"42159",37,29,29,0,0,"C's",4
37,"37370",328,258,254,1,4,"C's",34
12,"12038",167,120,118,2,2,"C's",15
18,"18010",566,427,421,1,6,"C's",42
47,"47158",889,667,659,8,8,"C's",75
46,"46257",5571,4266,4224,25,42,"C's",321
19,"19065",127,104,104,3,0,"C's",7
49,"49193",467,313,308,4,5,"C's",40
52,"52001",53306,27373,27012,267,361,"C's",3343
50,"50106",134,104,104,0,0,"C's",10
24,"24074",97,75,75,1,0,"C's",5
37,"37072",168,140,138,0,2,"C's",11
18,"18085",720,507,499,3,8,"C's",49
44,"44109",108,73,73,0,0,"C's",10
45,"45177",2110,1679,1656,3,23,"C's",142
50,"50033",66,49,48,0,1,"C's",1
37,"37331",212,137,135,0,2,"C's",9
46,"46248",4897,3596,3544,18,52,"C's",397
3,"3005",7769,5917,5866,19,51,"C's",704
37,"37340",151,106,106,1,0,"C's",7
44,"44210",746,554,545,3,9,"C's",57
16,"16149",148,124,122,2,2,"C's",16
39,"39069",1972,1510,1489,12,21,"C's",234
44,"44004",408,303,297,0,6,"C's",25
48,"48069",12798,8679,8612,55,67,"C's",262
49,"49063",338,272,266,4,6,"C's",18
45,"45156",3410,2751,2711,13,40,"C's",327
48,"48039",239,190,188,0,2,"C's",6
35,"35030",9250,5413,5326,34,87,"C's",547
40,"40146",254,197,196,0,1,"C's",21
50,"50133",113,80,80,4,0,"C's",4
30,"30024",58746,42036,41731,206,305,"C's",6343
31,"31049",699,469,465,2,4,"C's",12
45,"45030",478,368,360,2,8,"C's",22
34,"34052",174,135,133,0,2,"C's",14
26,"26001",195,161,157,2,4,"C's",12
4,"4086",1760,1243,1234,9,9,"C's",110
12,"12087",25,18,18,4,0,"C's",1
13,"13059",202,160,156,0,4,"C's",10
28,"28120",1223,892,884,2,8,"C's",131
33,"33078",142,101,99,0,2,"C's",2
44,"44071",591,398,398,5,0,"C's",35
24,"24201",1090,762,759,10,3,"C's",102
9,"9170",205,162,162,1,0,"C's",23
2,"2024",3409,2589,2554,29,35,"C's",331
47,"47006",190,136,135,1,1,"C's",13
23,"23098",867,713,701,1,12,"C's",27
24,"24145",654,463,461,2,2,"C's",47
47,"47008",24,19,19,1,0,"C's",1
47,"47170",33,28,27,2,1,"C's",4
38,"38043",18892,13089,12928,87,161,"C's",1448
10,"10205",2020,1319,1293,5,26,"C's",81
5,"5170",50,43,43,0,0,"C's",2
28,"28160",8256,6102,6059,31,43,"C's",1250
26,"26141",113,87,82,0,5,"C's",9
45,"45003",562,408,402,1,6,"C's",43
49,"49066",492,336,332,4,4,"C's",29
37,"37266",82,63,63,2,0,"C's",4
9,"9076",23,17,17,1,0,"C's",6
34,"34237",592,462,452,6,10,"C's",32
26,"26118",59,48,48,2,0,"C's",4
41,"41010",4420,2960,2916,30,44,"C's",398
18,"18094",2359,1744,1720,14,24,"C's",168
10,"10192",828,590,584,1,6,"C's",29
39,"39002",3298,2342,2309,13,33,"C's",297
10,"10085",323,235,233,0,2,"C's",29
26,"26099",1264,1003,991,9,12,"C's",88
39,"39049",322,229,229,0,0,"C's",24
45,"45117",747,606,601,4,5,"C's",49
33,"33003",646,355,352,9,3,"C's",16
46,"46218",1060,910,885,7,25,"C's",75
20,"20042",3228,1967,1958,27,9,"C's",25
46,"46122",2704,2082,2063,10,19,"C's",212
5,"5236",123,91,90,1,1,"C's",18
21,"21041",113337,72318,71637,748,681,"C's",10481
18,"18004",714,518,509,2,9,"C's",22
19,"19188",51,35,35,0,0,"C's",1
10,"10010",2290,1362,1341,7,21,"C's",96
23,"23031",747,637,619,0,18,"C's",29
39,"39034",286,188,185,5,3,"C's",8
22,"22163",425,360,355,0,5,"C's",79
19,"19326",1841,1280,1272,1,8,"C's",341
34,"34113",38,36,36,0,0,"C's",5
9,"9288",90,70,70,0,0,"C's",6
12,"12084",17615,12766,12644,105,122,"C's",1831
16,"16003",125,105,104,0,1,"C's",14
31,"31130",312,214,213,3,1,"C's",6
22,"22247",33,20,20,0,0,"C's",0
18,"18095",1967,1450,1430,11,20,"C's",179
37,"37353",126,97,97,1,0,"C's",7
31,"31175",71,48,48,0,0,"C's",0
4,"4016",2138,1551,1536,9,15,"C's",254
7,"7002",6341,4295,4255,39,40,"C's",529
45,"45138",1091,877,871,4,6,"C's",67
22,"22055",320,243,238,2,5,"C's",33
46,"46042",3380,2799,2755,20,44,"C's",235
18,"18023",15655,10879,10774,82,105,"C's",1640
46,"46014",3030,2383,2350,20,33,"C's",346
36,"36050",7561,5280,5188,25,92,"C's",442
13,"13073",531,399,391,3,8,"C's",15
49,"49130",180,143,141,5,2,"C's",11
40,"40019",36,31,31,1,0,"C's",5
40,"40188",90,72,70,0,2,"C's",10
16,"16211",370,263,263,3,0,"C's",17
21,"21058",2609,1883,1856,23,27,"C's",104
19,"19146",41,35,32,0,3,"C's",2
20,"20005",1260,738,736,11,2,"C's",8
45,"45011",278,239,233,1,6,"C's",19
46,"46161",1483,1188,1173,7,15,"C's",122
34,"34217",1207,937,923,8,14,"C's",169
13,"13076",484,400,394,1,6,"C's",14
24,"24156",239,159,158,1,1,"C's",10
47,"47208",58,38,36,1,2,"C's",3
28,"28039",128,98,97,2,1,"C's",6
42,"42216",25,23,23,0,0,"C's",0
16,"16146",83,57,57,0,0,"C's",4
28,"28030",1726,1320,1299,8,21,"C's",203
30,"30902",7975,5318,5273,24,45,"C's",796
34,"34151",159,104,103,0,1,"C's",16
46,"46213",15409,10924,10805,97,119,"C's",1816
23,"23072",1986,1542,1530,7,12,"C's",123
9,"9066",62,48,47,0,1,"C's",8
10,"10118",286,251,249,1,2,"C's",13
23,"23090",1312,1041,1018,5,23,"C's",46
26,"26149",57,47,46,0,1,"C's",7
21,"21007",6225,4080,3999,52,81,"C's",468
15,"15028",1409,1038,1024,6,14,"C's",67
46,"46100",286,232,230,1,2,"C's",17
6,"6126",2170,1523,1507,1,16,"C's",104
50,"50067",14119,9909,9819,112,90,"C's",1593
13,"13049",799,540,531,0,9,"C's",43
40,"40013",62,49,48,0,1,"C's",4
12,"12068",48,36,35,1,1,"C's",3
16,"16011",27,22,22,1,0,"C's",1
40,"40222",168,145,144,0,1,"C's",17
20,"20002",346,203,203,4,0,"C's",2
49,"49214",698,525,512,3,13,"C's",66
1,"1053",582,321,320,4,1,"C's",5
50,"50008",5097,3457,3417,31,40,"C's",489
50,"50107",947,738,733,4,5,"C's",120
46,"46017",32949,23913,23685,142,228,"C's",3445
42,"42219",43,31,30,0,1,"C's",4
49,"49117",465,330,324,6,6,"C's",31
24,"24198",592,412,407,2,5,"C's",27
32,"32009",10803,7303,7227,48,76,"C's",550
50,"50077",221,168,167,1,1,"C's",10
45,"45037",1603,1122,1111,5,11,"C's",85
37,"37178",100,76,75,0,1,"C's",9
34,"34230",15,12,12,0,0,"C's",1
5,"5131",99,69,69,0,0,"C's",5
38,"38021",1629,1033,1022,9,11,"C's",58
37,"37027",228,172,171,0,1,"C's",15
4,"4068",187,154,152,0,2,"C's",16
45,"45195",2141,1635,1606,7,29,"C's",133
34,"34186",52,45,45,0,0,"C's",5
46,"46180",682,553,549,0,4,"C's",62
31,"31237",193,155,153,2,2,"C's",6
41,"41019",4691,3089,3056,27,33,"C's",425
37,"37325",89,62,62,0,0,"C's",1
49,"49092",129,90,89,1,1,"C's",3
26,"26016",28,25,24,1,1,"C's",3
48,"48065",3281,2271,2237,8,34,"C's",36
31,"31089",242,172,170,1,2,"C's",9
37,"37009",213,172,171,3,1,"C's",17
28,"28089",3677,2748,2730,10,18,"C's",553
16,"16089",375,303,303,6,0,"C's",34
21,"21065",273,186,184,0,2,"C's",24
9,"9902",458,331,327,3,4,"C's",27
27,"27044",2879,1705,1662,27,43,"C's",73
42,"42021",83,55,55,3,0,"C's",3
9,"9079",49,45,45,0,0,"C's",2
22,"22040",144,117,115,1,2,"C's",14
44,"44237",398,304,301,4,3,"C's",16
46,"46158",1026,811,795,6,16,"C's",70
24,"24178",70,59,58,0,1,"C's",4
50,"50003",128,92,91,1,1,"C's",15
9,"9437",282,219,218,3,1,"C's",23
42,"42188",50,39,38,0,1,"C's",5
10,"10083",90,59,59,2,0,"C's",2
39,"39099",3114,2308,2281,12,27,"C's",328
6,"6097",2362,1750,1727,7,23,"C's",156
6,"6901",2118,1559,1546,23,13,"C's",147
19,"19067",70,52,51,1,1,"C's",3
45,"45205",6824,4424,4362,22,62,"C's",743
9,"9115",92,68,67,0,1,"C's",2
20,"20079",17886,11860,11799,91,61,"C's",253
39,"39022",980,721,713,2,8,"C's",88
12,"12073",152,119,117,0,2,"C's",11
50,"50084",77,59,59,2,0,"C's",8
41,"41068",13939,9787,9674,72,113,"C's",949
36,"36045",24529,17613,17336,129,277,"C's",1252
22,"22090",99,71,71,0,0,"C's",7
28,"28123",57078,45270,44992,215,278,"C's",9324
19,"19099",298,200,199,6,1,"C's",9
3,"3064",5015,3660,3611,11,49,"C's",503
47,"47127",137,98,97,0,1,"C's",9
5,"5220",371,309,301,0,8,"C's",39
20,"20013",5415,3602,3579,19,23,"C's",43
24,"24087",631,470,466,7,4,"C's",62
19,"19229",66,56,56,0,0,"C's",7
37,"37112",161,112,111,2,1,"C's",5
3,"3048",4847,3719,3683,20,36,"C's",469
29,"29068",7016,4300,4244,35,56,"C's",737
46,"46181",16955,12313,12148,95,165,"C's",1477
2,"2901",2200,1440,1437,7,3,"C's",166
49,"49105",150,109,108,0,1,"C's",10
35,"35006",30457,21398,21118,162,280,"C's",2664
29,"29017",6553,4744,4668,33,76,"C's",520
3,"3014",237287,167428,166445,847,983,"C's",28849
23,"23053",9531,6704,6658,37,46,"C's",221
13,"13033",1633,1328,1290,4,38,"C's",92
44,"44054",108,85,85,2,0,"C's",8
28,"28028",1755,1353,1344,6,9,"C's",175
10,"10141",263,194,194,0,0,"C's",1
45,"45026",211,167,166,2,1,"C's",8
39,"39052",18236,13537,13380,110,157,"C's",2549
37,"37067",3163,2496,2467,31,29,"C's",543
36,"36016",1143,721,711,3,10,"C's",29
46,"46206",571,453,445,2,8,"C's",38
49,"49216",162,142,142,0,0,"C's",17
13,"13055",665,487,484,2,3,"C's",34
13,"13056",11362,8288,8198,70,90,"C's",1114
36,"36059",4882,3137,3085,28,52,"C's",205
46,"46073",1092,888,884,6,4,"C's",71
37,"37296",336,259,254,2,5,"C's",6
22,"22175",197,143,142,1,1,"C's",20
42,"42016",18,14,14,0,0,"C's",1
49,"49107",126,94,93,2,1,"C's",3
16,"16140",27,16,16,0,0,"C's",0
24,"24103",283,163,157,1,6,"C's",9
9,"9034",276,228,227,2,1,"C's",31
26,"26071",8491,5834,5761,47,73,"C's",781
18,"18159",995,797,795,2,2,"C's",21
49,"49090",197,143,141,6,2,"C's",16
50,"50117",126,104,103,1,1,"C's",9
4,"4018",270,232,229,0,3,"C's",13
41,"41001",1596,1183,1159,5,24,"C's",94
9,"9269",36,26,26,1,0,"C's",1
18,"18913",813,566,559,2,7,"C's",61
40,"40179",626,503,493,2,10,"C's",58
11,"11001",4358,2816,2767,11,49,"C's",235
48,"48077",3364,2437,2431,18,6,"C's",73
21,"21033",538,373,370,3,3,"C's",29
44,"44002",47,40,40,0,0,"C's",1
34,"34196",89,68,68,1,0,"C's",10
28,"28014",33085,23626,23466,113,160,"C's",4506
18,"18179",538,376,374,6,2,"C's",23
42,"42081",145,102,100,1,2,"C's",9
12,"12027",17283,12015,11888,89,127,"C's",1834
33,"33066",42963,28564,28282,300,282,"C's",4129
20,"20905",145,100,100,1,0,"C's",0
34,"34036",211,150,150,0,0,"C's",17
22,"22206",193,129,128,1,1,"C's",17
10,"10041",1057,795,781,4,14,"C's",53
34,"34076",587,479,479,2,0,"C's",36
24,"24119",706,488,481,3,7,"C's",52
41,"41008",1059,749,739,10,10,"C's",59
15,"15031",23348,16380,16235,191,145,"C's",2012
18,"18071",5579,4044,3985,37,59,"C's",580
31,"31235",159,117,115,2,2,"C's",4
28,"28114",150,101,100,1,1,"C's",16
16,"16094",127,96,94,0,2,"C's",15
37,"37241",168,131,131,1,0,"C's",7
44,"44228",100,82,82,0,0,"C's",12
24,"24002",231,173,172,1,1,"C's",25
49,"49160",49,33,33,0,0,"C's",3
14,"14036",3740,2747,2696,24,51,"C's",254
38,"38009",4127,2915,2868,20,47,"C's",353
36,"36032",3630,2587,2535,16,52,"C's",164
49,"49008",460,332,331,5,1,"C's",19
27,"27047",1629,1106,1089,8,17,"C's",49
20,"20053",4774,2973,2953,13,20,"C's",64
50,"50298",5333,3949,3902,39,47,"C's",620
4,"4070",1584,1184,1179,3,5,"C's",102
9,"9246",620,451,444,2,7,"C's",68
6,"6113",2721,2004,1971,7,33,"C's",205
44,"44096",161,138,135,3,3,"C's",7
21,"21073",1862,1125,1109,8,16,"C's",109
32,"32046",1160,787,779,4,8,"C's",52
35,"35014",11209,6016,5917,42,99,"C's",667
16,"16061",969,771,764,14,7,"C's",67
45,"45099",3500,2390,2361,9,29,"C's",323
12,"12131",63,52,52,0,0,"C's",0
24,"24159",1806,1386,1366,6,20,"C's",154
41,"41074",3012,2282,2257,18,25,"C's",173
9,"9033",90,74,74,1,0,"C's",9
33,"33076",12258,8106,8031,63,75,"C's",1080
2,"2082",101,80,80,1,0,"C's",6
47,"47227",61,50,50,0,0,"C's",4
7,"7023",3604,2498,2470,49,28,"C's",361
18,"18086",349,274,272,0,2,"C's",14
18,"18901",511,356,355,3,1,"C's",30
23,"23079",3717,2825,2801,28,24,"C's",207
3,"3067",99,85,85,0,0,"C's",9
27,"27065",12444,8261,8056,112,205,"C's",452
16,"16189",264,206,205,4,1,"C's",25
46,"46221",352,305,304,0,1,"C's",31
37,"37151",148,125,124,2,1,"C's",12
28,"28052",3855,2626,2587,11,39,"C's",367
49,"49036",506,374,367,2,7,"C's",17
5,"5206",30,22,20,1,2,"C's",5
9,"9360",30,23,23,0,0,"C's",4
49,"49028",115,104,103,1,1,"C's",4
29,"29005",4358,2859,2817,28,42,"C's",350
34,"34225",4921,3588,3559,30,29,"C's",539
21,"21064",6522,4227,4146,48,81,"C's",427
44,"44023",17,16,16,0,0,"C's",0
6,"6089",596,469,461,1,8,"C's",30
40,"40044",145,114,113,2,1,"C's",19
45,"45168",62229,47154,46741,285,413,"C's",7147
46,"46096",274,209,209,1,0,"C's",27
28,"28070",117,91,91,0,0,"C's",13
41,"41022",4290,2889,2851,21,38,"C's",246
37,"37236",135,105,103,1,2,"C's",18
28,"28168",1237,884,880,4,4,"C's",112
6,"6058",2026,1433,1416,9,17,"C's",150
31,"31206",2090,1461,1440,22,21,"C's",70
9,"9174",794,559,552,4,7,"C's",59
15,"15018",1142,741,732,18,9,"C's",38
10,"10112",1571,1107,1081,9,26,"C's",42
10,"10051",430,308,296,0,12,"C's",2
28,"28171",4239,2848,2820,19,28,"C's",343
42,"42206",8,8,8,1,0,"C's",1
47,"47028",33,21,21,0,0,"C's",2
9,"9304",199,157,155,3,2,"C's",26
36,"36044",2541,1674,1646,7,28,"C's",140
36,"36053",5684,4099,4050,38,49,"C's",328
16,"16020",17,10,10,0,0,"C's",0
16,"16205",115,88,87,0,1,"C's",5
50,"50273",30,22,22,0,0,"C's",0
49,"49098",219,167,165,0,2,"C's",10
7,"7902",1064,685,664,15,21,"C's",49
42,"42008",57,43,43,0,0,"C's",4
34,"34124",60,50,49,0,1,"C's",4
31,"31023",6956,5310,5289,85,21,"C's",572
40,"40184",258,211,210,2,1,"C's",25
28,"28083",8939,6396,6348,38,48,"C's",1400
24,"24112",309,228,227,1,1,"C's",16
47,"47211",47,35,34,0,1,"C's",6
47,"47034",72,58,58,3,0,"C's",3
17,"17058",177,101,100,3,1,"C's",5
25,"25047",1014,675,674,8,1,"C's",29
17,"17102",571,400,400,6,0,"C's",12
43,"43095",2474,1575,1551,17,24,"C's",199
25,"25174",397,280,280,2,0,"C's",17
17,"17207",2375,1590,1579,11,11,"C's",31
17,"17106",140,103,102,0,1,"C's",2
25,"25231",486,330,330,4,0,"C's",13
25,"25245",435,289,280,5,9,"C's",26
17,"17050",652,453,453,3,0,"C's",23
17,"17055",150,110,109,0,1,"C's",1
25,"25171",2185,1416,1410,8,6,"C's",43
25,"25253",159,105,105,1,0,"C's",2
25,"25043",807,501,497,11,4,"C's",13
17,"17121",224,140,140,1,0,"C's",5
25,"25011",5243,2796,2767,23,29,"C's",199
17,"17136",178,125,124,0,1,"C's",5
17,"17152",10737,6308,6252,45,56,"C's",865
25,"25902",567,365,356,8,9,"C's",8
17,"17069",374,256,251,0,5,"C's",12
17,"17144",206,141,141,3,0,"C's",2
25,"25211",680,386,379,4,7,"C's",15
43,"43052",938,628,621,12,7,"C's",35
17,"17090",545,370,368,4,2,"C's",20
25,"25175",186,117,117,1,0,"C's",5
43,"43070",238,192,191,1,1,"C's",6
25,"25131",403,248,241,7,7,"C's",11
17,"17203",153,99,99,0,0,"C's",2
43,"43094",2143,1395,1375,13,20,"C's",68
25,"25044",188,122,120,7,2,"C's",5
17,"17226",867,549,546,8,3,"C's",102
17,"17093",891,563,560,6,3,"C's",40
17,"17233",2260,1528,1514,23,14,"C's",78
25,"25133",706,432,427,8,5,"C's",6
25,"25031",52,29,29,0,0,"C's",7
25,"25161",360,219,218,2,1,"C's",4
25,"25056",235,143,143,2,0,"C's",1
43,"43084",526,363,361,10,2,"C's",7
25,"25224",126,70,70,5,0,"C's",0
17,"17032",1721,967,961,10,6,"C's",50
43,"43018",408,325,320,3,5,"C's",5
43,"43072",105,74,72,0,2,"C's",2
43,"43046",99,68,65,1,3,"C's",1
17,"17015",12546,7832,7777,66,55,"C's",305
17,"17173",180,132,131,0,1,"C's",5
25,"25203",8931,5003,4955,72,48,"C's",361
17,"17199",6853,4147,4122,27,25,"C's",344
17,"17132",1298,884,877,12,7,"C's",62
25,"25039",277,181,180,3,1,"C's",2
25,"25129",175,83,83,2,0,"C's",4
25,"25119",2248,1449,1442,15,7,"C's",41
43,"43099",306,228,226,4,2,"C's",11
43,"43176",785,523,520,4,3,"C's",21
43,"43161",17197,10481,10400,95,81,"C's",782
25,"25217",10625,6319,6260,99,59,"C's",332
43,"43166",1584,1029,1022,6,7,"C's",89
17,"17103",4954,2877,2850,25,27,"C's",291
43,"43100",3301,2183,2172,24,11,"C's",306
17,"17018",480,327,322,2,5,"C's",11
17,"17180",8295,4958,4935,36,23,"C's",267
17,"17094",1059,602,600,4,2,"C's",53
17,"17016",731,500,496,1,4,"C's",29
43,"43134",282,191,191,4,0,"C's",16
43,"43039",99,66,66,0,0,"C's",2
43,"43130",195,127,127,1,0,"C's",3
43,"43012",3534,2559,2548,34,11,"C's",294
43,"43140",2367,1550,1532,4,18,"C's",213
43,"43109",2606,1491,1475,20,16,"C's",272
17,"17221",4153,2577,2564,27,13,"C's",325
17,"17176",124,92,92,1,0,"C's",15
17,"17006",1127,686,682,1,4,"C's",36
25,"25088",96,73,72,0,1,"C's",2
25,"25132",136,88,87,0,1,"C's",5
43,"43047",4161,2359,2341,27,18,"C's",303
25,"25009",627,444,440,8,4,"C's",15
43,"43103",880,547,545,4,2,"C's",82
17,"17126",311,236,234,0,2,"C's",9
25,"25025",1353,871,864,16,7,"C's",139
17,"17188",164,124,124,1,0,"C's",8
43,"43065",399,252,251,3,1,"C's",7
17,"17001",587,404,398,2,6,"C's",31
17,"17044",6770,4411,4376,33,35,"C's",276
43,"43074",1754,1170,1157,9,13,"C's",83
17,"17097",196,148,148,3,0,"C's",8
17,"17046",717,459,458,4,1,"C's",10
43,"43143",54,47,47,3,0,"C's",1
17,"17140",670,478,473,5,5,"C's",37
25,"25181",172,123,120,4,3,"C's",3
17,"17036",2717,1730,1716,15,14,"C's",87
17,"17038",366,234,232,6,2,"C's",4
25,"25216",226,138,136,1,2,"C's",3
17,"17116",354,228,224,3,4,"C's",8
25,"25004",571,376,373,3,3,"C's",14
43,"43003",324,217,217,3,0,"C's",15
17,"17109",696,422,419,1,3,"C's",10
25,"25230",1558,1008,993,13,15,"C's",46
17,"17149",364,248,248,0,0,"C's",5
25,"25143",84,56,55,0,1,"C's",4
17,"17009",4015,2584,2567,14,17,"C's",66
43,"43168",96,57,57,3,0,"C's",2
43,"43009",1403,918,905,14,13,"C's",61
17,"17167",2700,1765,1749,37,16,"C's",54
17,"17192",144,96,93,1,3,"C's",2
25,"25024",351,226,223,2,3,"C's",2
25,"25153",192,130,128,2,2,"C's",10
17,"17148",1515,981,972,4,9,"C's",94
43,"43149",686,447,443,8,4,"C's",26
43,"43110",259,175,175,6,0,"C's",17
17,"17048",6241,3831,3801,36,30,"C's",422
17,"17214",705,423,419,2,4,"C's",18
17,"17139",1364,884,865,8,19,"C's",18
17,"17206",146,88,86,1,2,"C's",4
25,"25094",137,98,95,1,3,"C's",1
25,"25046",422,279,275,2,4,"C's",9
25,"25907",494,266,265,6,1,"C's",4
17,"17130",325,223,222,3,1,"C's",8
17,"17025",1134,793,787,6,6,"C's",24
43,"43126",1177,782,772,4,10,"C's",78
17,"17183",277,180,179,1,1,"C's",6
43,"43079",364,248,248,0,0,"C's",4
43,"43156",3946,2524,2470,28,54,"C's",169
25,"25210",1108,685,677,3,8,"C's",33
25,"25137",8585,5143,5095,56,48,"C's",315
25,"25070",823,554,549,15,5,"C's",16
17,"17194",80,55,54,0,1,"C's",1
43,"43121",599,354,348,1,6,"C's",3
43,"43122",106,77,77,4,0,"C's",4
17,"17012",1145,703,698,9,5,"C's",62
25,"25051",1527,931,920,11,11,"C's",53
43,"43080",239,183,181,0,2,"C's",12
43,"43154",130,101,100,0,1,"C's",3
25,"25085",148,107,107,0,0,"C's",3
17,"17082",417,255,253,2,2,"C's",29
25,"25157",181,115,114,7,1,"C's",3
43,"43162",4346,2983,2958,21,25,"C's",439
43,"43023",231,170,169,0,1,"C's",9
25,"25192",743,449,436,2,13,"C's",18
25,"25242",720,456,450,2,6,"C's",18
25,"25081",308,189,189,2,0,"C's",5
25,"25212",233,154,153,6,1,"C's",12
17,"17087",225,152,149,2,3,"C's",4
25,"25127",210,136,136,2,0,"C's",1
25,"25208",331,183,182,1,1,"C's",3
25,"25049",151,110,108,1,2,"C's",7
17,"17065",331,230,230,1,0,"C's",8
17,"17010",336,224,224,3,0,"C's",2
25,"25165",285,179,176,2,3,"C's",7
17,"17217",354,265,263,2,2,"C's",3
25,"25068",556,346,341,11,5,"C's",8
25,"25209",1495,995,978,9,17,"C's",34
43,"43037",16781,10376,10265,71,111,"C's",1424
25,"25114",98,72,72,0,0,"C's",0
25,"25154",122,74,72,0,2,"C's",0
25,"25038",1545,995,986,17,9,"C's",42
25,"25240",1383,925,919,16,6,"C's",58
17,"17227",129,86,85,5,1,"C's",3
17,"17220",796,538,536,5,2,"C's",18
25,"25196",113,57,57,0,0,"C's",3
17,"17117",14353,8469,8426,49,43,"C's",751
25,"25228",3035,1933,1921,26,12,"C's",166
43,"43148",90275,59182,58757,388,425,"C's",8709
25,"25002",482,316,314,2,2,"C's",6
25,"25003",3762,2215,2195,22,20,"C's",120
17,"17177",549,332,331,1,1,"C's",12
43,"43016",3416,2335,2309,15,26,"C's",269
17,"17003",104,67,66,0,1,"C's",0
43,"43165",577,436,433,3,3,"C's",17
25,"25030",135,74,72,1,2,"C's",1
43,"43135",340,235,234,1,1,"C's",11
43,"43175",554,363,360,5,3,"C's",23
25,"25052",1555,1027,1016,14,11,"C's",28
17,"17123",354,266,263,0,3,"C's",9
25,"25913",86,67,67,3,0,"C's",2
17,"17901",987,623,620,9,3,"C's",18
43,"43085",226,180,180,1,0,"C's",5
17,"17158",476,276,274,1,2,"C's",28
25,"25113",1168,811,803,8,8,"C's",21
17,"17137",3437,2293,2275,19,18,"C's",76
17,"17174",178,99,97,2,2,"C's",3
25,"25017",236,169,167,7,2,"C's",1
25,"25168",509,354,352,7,2,"C's",26
43,"43010",322,233,227,0,6,"C's",14
43,"43096",99,81,80,1,1,"C's",1
43,"43159",81,59,59,0,0,"C's",2
25,"25123",193,134,131,2,3,"C's",5
25,"25201",112,73,72,3,1,"C's",12
43,"43177",299,231,230,6,1,"C's",13
17,"17119",74,54,54,0,0,"C's",0
17,"17129",133,101,101,1,0,"C's",9
43,"43123",70482,44051,43675,345,376,"C's",5716
17,"17159",643,413,406,3,7,"C's",16
25,"25073",582,328,324,8,4,"C's",12
17,"17189",1516,1076,1070,5,6,"C's",19
25,"25019",4572,2726,2698,34,28,"C's",235
25,"25033",1096,729,723,4,6,"C's",36
17,"17089",5543,3349,3326,22,23,"C's",213
25,"25096",902,534,525,10,9,"C's",21
43,"43169",450,370,367,10,3,"C's",7
17,"17007",1731,1191,1182,7,9,"C's",27
25,"25250",345,210,204,0,6,"C's",3
43,"43125",933,680,677,14,3,"C's",24
43,"43007",641,456,455,3,1,"C's",29
17,"17020",3592,2333,2315,20,18,"C's",104
17,"17168",380,260,258,0,2,"C's",10
43,"43061",45,30,29,0,1,"C's",0
43,"43034",477,350,342,9,8,"C's",16
43,"43075",89,61,60,1,1,"C's",5
25,"25035",398,249,247,2,2,"C's",16
25,"25008",1124,715,702,10,13,"C's",35
25,"25176",309,216,211,1,5,"C's",7
17,"17005",413,257,252,3,5,"C's",16
17,"17118",12711,7567,7515,42,52,"C's",705
25,"25097",84,65,65,3,0,"C's",1
25,"25071",49,31,31,0,0,"C's",0
43,"43131",4647,2934,2916,21,18,"C's",465
25,"25248",891,592,586,6,6,"C's",9
43,"43153",10688,6675,6615,39,60,"C's",805
17,"17204",572,355,354,4,1,"C's",26
25,"25105",125,92,92,2,0,"C's",5
25,"25048",1651,1051,1040,11,11,"C's",53
17,"17029",207,127,127,1,0,"C's",10
25,"25172",1797,1170,1146,10,24,"C's",26
43,"43118",419,311,308,5,3,"C's",14
43,"43137",1868,1254,1242,11,12,"C's",134
17,"17150",1401,962,951,6,11,"C's",45
25,"25077",463,256,253,6,3,"C's",9
17,"17213",5424,3239,3219,24,20,"C's",256
43,"43019",1381,862,846,12,16,"C's",58
17,"17105",247,147,147,1,0,"C's",8
25,"25076",145,81,81,2,0,"C's",2
25,"25205",566,382,372,8,10,"C's",24
25,"25037",375,247,246,5,1,"C's",4
25,"25124",166,106,105,1,1,"C's",9
43,"43011",1077,743,737,2,6,"C's",44
17,"17023",27269,17209,17032,122,177,"C's",1925
17,"17085",301,215,214,5,1,"C's",4
25,"25145",86,65,64,1,1,"C's",1
17,"17143",142,103,99,1,4,"C's",6
17,"17101",559,347,338,2,9,"C's",18
25,"25050",3233,1936,1912,25,24,"C's",75
43,"43107",383,238,237,7,1,"C's",16
43,"43120",441,270,267,1,3,"C's",20
25,"25151",685,425,419,7,6,"C's",22
25,"25156",783,543,537,7,6,"C's",29
43,"43030",427,288,283,1,5,"C's",25
17,"17064",322,214,211,4,3,"C's",15
43,"43174",138,102,100,1,2,"C's",2
17,"17169",2475,1619,1601,11,18,"C's",159
25,"25167",230,138,138,3,0,"C's",4
25,"25255",417,298,296,2,2,"C's",9
25,"25912",857,547,539,1,8,"C's",64
25,"25904",148,112,111,2,1,"C's",0
43,"43004",6281,3993,3929,38,64,"C's",237
25,"25197",133,89,88,1,1,"C's",2
43,"43013",4411,2750,2739,19,11,"C's",196
25,"25067",719,467,460,7,7,"C's",31
25,"25075",117,72,72,2,0,"C's",1
25,"25111",117,72,70,2,2,"C's",2
17,"17133",1255,805,796,9,9,"C's",20
25,"25057",208,141,140,0,1,"C's",22
17,"17134",228,162,161,0,1,"C's",2
17,"17047",4798,2773,2757,28,16,"C's",297
17,"17079",64395,41049,40699,342,350,"C's",3369
25,"25222",66,52,52,1,0,"C's",1
43,"43036",843,493,485,4,8,"C's",31
17,"17115",282,183,183,1,0,"C's",12
43,"43078",846,543,531,8,12,"C's",46
17,"17062",5958,3463,3441,22,22,"C's",232
43,"43064",2015,1310,1296,23,14,"C's",78
25,"25200",329,213,213,0,0,"C's",2
17,"17088",533,368,366,4,2,"C's",7
43,"43097",393,291,289,1,2,"C's",22
25,"25215",345,240,236,0,4,"C's",27
17,"17092",3509,2256,2223,18,33,"C's",202
17,"17210",551,350,349,9,1,"C's",17
17,"17049",3117,2092,2072,14,20,"C's",141
17,"17218",582,404,401,1,3,"C's",17
17,"17076",124,86,84,3,2,"C's",3
25,"25903",236,161,161,3,0,"C's",3
17,"17054",370,236,236,1,0,"C's",17
43,"43178",1350,856,844,5,12,"C's",95
43,"43139",2039,1218,1191,8,27,"C's",46
25,"25202",104,73,72,0,1,"C's",1
25,"25191",334,205,204,4,1,"C's",4
25,"25146",227,140,140,3,0,"C's",4
17,"17040",537,347,345,3,2,"C's",14
25,"25206",260,150,150,5,0,"C's",0
17,"17033",5307,3264,3241,29,23,"C's",275
17,"17186",3788,2554,2526,27,28,"C's",203
17,"17041",218,130,129,2,1,"C's",3
17,"17182",263,181,181,6,0,"C's",26
25,"25012",2334,1322,1310,8,12,"C's",126
25,"25138",569,363,360,4,3,"C's",12
25,"25130",195,113,112,2,1,"C's",3
17,"17042",419,272,272,2,0,"C's",17
17,"17056",1715,1120,1106,16,14,"C's",47
43,"43026",782,524,520,6,4,"C's",20
25,"25101",561,364,358,2,6,"C's",7
43,"43902",2743,1551,1531,23,20,"C's",63
43,"43035",254,156,155,2,1,"C's",4
43,"43127",743,528,527,2,1,"C's",37
17,"17208",995,594,590,8,4,"C's",14
25,"25905",375,249,246,3,3,"C's",13
17,"17171",165,117,116,2,1,"C's",3
43,"43164",301,205,204,2,1,"C's",11
17,"17052",125,78,78,0,0,"C's",2
25,"25177",368,226,226,0,0,"C's",7
43,"43111",2044,1291,1275,9,16,"C's",160
17,"17002",556,401,396,0,5,"C's",24
43,"43073",83,60,58,0,2,"C's",4
25,"25014",260,165,165,5,0,"C's",2
43,"43088",1996,1271,1255,7,16,"C's",100
17,"17124",1607,1027,1007,11,20,"C's",51
43,"43033",765,531,530,4,1,"C's",28
43,"43006",681,438,437,9,1,"C's",22
25,"25136",95,64,64,1,0,"C's",1
25,"25190",262,185,183,0,2,"C's",4
25,"25239",590,258,256,5,2,"C's",14
17,"17125",130,80,80,0,0,"C's",0
25,"25120",92002,55658,55214,587,444,"C's",5700
25,"25089",105,60,59,0,1,"C's",2
25,"25121",644,415,410,8,5,"C's",45
17,"17228",288,179,176,1,3,"C's",15
43,"43038",21366,13061,12943,111,118,"C's",2015
17,"17224",314,190,188,2,2,"C's",2
17,"17060",424,268,266,5,2,"C's",12
17,"17028",293,205,204,6,1,"C's",3
43,"43170",868,566,562,5,4,"C's",26
17,"17215",2087,1481,1466,7,15,"C's",91
43,"43906",2102,1364,1346,15,18,"C's",107
17,"17086",1729,1068,1059,8,9,"C's",113
25,"25908",226,144,143,3,1,"C's",2
25,"25118",346,198,189,3,9,"C's",5
17,"17098",301,192,188,2,4,"C's",16
25,"25092",130,98,95,2,3,"C's",4
25,"25135",1028,600,593,10,7,"C's",20
17,"17187",631,445,441,2,4,"C's",24
17,"17021",131,86,85,4,1,"C's",3
25,"25252",548,343,342,9,1,"C's",19
17,"17077",548,369,368,1,1,"C's",35
25,"25207",6212,3710,3680,47,30,"C's",167
25,"25086",522,346,341,2,5,"C's",8
25,"25193",759,485,480,2,5,"C's",5
17,"17142",2550,1806,1797,30,9,"C's",169
43,"43132",373,264,261,4,3,"C's",19
17,"17031",168,97,97,3,0,"C's",3
17,"17022",6910,4207,4184,58,23,"C's",182
25,"25062",750,486,482,1,4,"C's",23
25,"25219",141,102,101,0,1,"C's",3
17,"17100",194,133,131,3,2,"C's",8
17,"17075",330,205,205,1,0,"C's",13
43,"43028",2688,1659,1639,6,20,"C's",166
43,"43092",7036,4226,4185,39,41,"C's",592
43,"43106",810,526,522,7,4,"C's",17
25,"25010",211,113,113,2,0,"C's",2
25,"25249",182,99,98,1,1,"C's",6
43,"43025",600,408,404,2,4,"C's",20
43,"43083",144,109,108,0,1,"C's",12
43,"43160",1276,837,826,8,11,"C's",92
25,"25254",728,457,451,2,6,"C's",26
43,"43093",3919,2461,2434,47,27,"C's",169
25,"25125",417,250,250,5,0,"C's",8
25,"25078",998,628,627,7,1,"C's",29
25,"25082",285,186,178,5,8,"C's",6
25,"25220",1015,634,632,1,2,"C's",27
25,"25015",357,219,219,2,0,"C's",7
43,"43129",4580,2844,2805,23,39,"C's",256
25,"25155",647,421,418,0,3,"C's",8
17,"17037",104,69,69,1,0,"C's",3
25,"25020",289,206,205,3,1,"C's",8
17,"17170",171,125,123,1,2,"C's",1
25,"25180",234,143,143,1,0,"C's",6
43,"43053",191,144,143,3,1,"C's",1
43,"43066",158,100,98,5,2,"C's",9
17,"17234",182,115,114,0,1,"C's",6
43,"43108",1774,1172,1160,14,12,"C's",75
17,"17078",336,223,220,6,3,"C's",14
25,"25112",273,192,188,4,4,"C's",10
17,"17157",125,95,95,1,0,"C's",8
43,"43049",728,464,461,4,3,"C's",12
17,"17034",6931,4166,4150,29,16,"C's",366
43,"43150",1281,937,923,6,14,"C's",28
25,"25027",976,633,630,7,3,"C's",17
25,"25079",299,198,193,2,5,"C's",4
25,"25243",3646,2193,2167,33,26,"C's",314
43,"43091",132,86,86,0,0,"C's",2
25,"25098",253,151,150,0,1,"C's",1
25,"25139",467,294,291,5,3,"C's",13
43,"43050",2505,1507,1496,12,11,"C's",168
43,"43055",1975,1384,1379,21,5,"C's",48
25,"25140",788,435,430,9,5,"C's",23
17,"17019",1775,1201,1188,7,13,"C's",32
17,"17039",1759,1159,1145,14,14,"C's",35
25,"25041",568,347,344,4,3,"C's",14
25,"25128",136,75,75,0,0,"C's",5
17,"17154",92,67,66,0,1,"C's",0
25,"25042",208,123,121,1,2,"C's",7
43,"43051",8512,5418,5366,32,52,"C's",800
25,"25141",153,95,95,0,0,"C's",3
43,"43901",8737,4703,4639,62,64,"C's",178
43,"43056",854,480,470,5,10,"C's",14
25,"25115",824,489,487,7,2,"C's",20
43,"43029",310,213,211,3,2,"C's",1
17,"17165",656,439,435,3,4,"C's",14
25,"25166",181,110,109,2,1,"C's",2
25,"25007",1405,850,841,8,9,"C's",90
17,"17903",897,568,563,2,5,"C's",21
43,"43102",480,332,324,3,8,"C's",12
25,"25186",213,124,122,3,2,"C's",7
25,"25001",144,73,73,0,0,"C's",1
43,"43098",343,235,233,5,2,"C's",21
43,"43112",279,175,174,0,1,"C's",2
25,"25247",123,66,66,1,0,"C's",11
17,"17225",214,139,139,3,0,"C's",5
43,"43071",921,613,607,6,6,"C's",27
43,"43167",375,277,275,9,2,"C's",11
25,"25016",2107,1268,1259,14,9,"C's",46
17,"17061",156,104,103,1,1,"C's",4
43,"43057",38,25,25,1,0,"C's",0
17,"17128",308,205,203,3,2,"C's",19
43,"43117",146,108,105,0,3,"C's",6
43,"43142",1100,698,688,5,10,"C's",52
25,"25182",1036,660,655,9,5,"C's",52
25,"25036",184,112,111,4,1,"C's",3
43,"43077",463,272,272,5,0,"C's",23
17,"17026",544,370,367,5,3,"C's",18
17,"17070",111,76,76,2,0,"C's",7
43,"43059",252,188,188,2,0,"C's",6
17,"17146",2969,1868,1855,8,13,"C's",124
25,"25102",707,420,407,6,13,"C's",32
43,"43005",3626,2157,2138,29,19,"C's",197
25,"25909",148,93,92,2,1,"C's",1
17,"17110",1322,856,853,3,3,"C's",96
25,"25087",60,43,43,0,0,"C's",0
17,"17230",468,318,317,3,1,"C's",39
25,"25164",376,242,238,4,4,"C's",11
25,"25910",100,63,61,2,2,"C's",0
43,"43151",107,90,89,0,1,"C's",1
17,"17024",268,153,152,1,1,"C's",8
25,"25023",4531,2782,2763,30,19,"C's",288
17,"17151",174,111,110,3,1,"C's",3
17,"17202",3791,2280,2263,18,17,"C's",208
43,"43116",451,324,317,5,7,"C's",9
25,"25911",451,273,271,7,2,"C's",14
43,"43152",439,323,320,2,3,"C's",5
43,"43043",3130,2053,2036,18,17,"C's",263
17,"17071",1134,778,774,10,4,"C's",23
17,"17091",407,258,253,5,5,"C's",10
43,"43119",799,470,468,8,2,"C's",60
25,"25149",1385,963,956,6,7,"C's",26
43,"43048",805,525,513,8,12,"C's",15
43,"43008",307,156,154,6,2,"C's",11
25,"25074",178,132,128,6,4,"C's",5
43,"43171",14599,9083,9011,72,72,"C's",1694
43,"43157",353,268,264,5,4,"C's",2
25,"25251",707,443,442,2,1,"C's",27
25,"25134",623,369,366,3,3,"C's",6
17,"17004",512,335,334,4,1,"C's",16
17,"17114",23041,13985,13880,135,105,"C's",624
17,"17195",329,237,234,0,3,"C's",6
25,"25103",135,76,76,4,0,"C's",2
17,"17191",141,92,89,1,3,"C's",3
17,"17164",3982,2363,2350,11,13,"C's",81
43,"43081",593,400,395,3,5,"C's",24
25,"25040",10546,6367,6300,61,67,"C's",398
25,"25093",640,403,395,7,8,"C's",23
17,"17232",152,92,91,1,1,"C's",3
43,"43041",216,152,151,0,1,"C's",10
17,"17216",165,110,110,1,0,"C's",1
17,"17035",548,381,379,5,2,"C's",14
43,"43063",557,355,349,9,6,"C's",4
17,"17080",138,96,96,1,0,"C's",7
43,"43082",365,290,286,5,4,"C's",5
43,"43158",85,52,52,1,0,"C's",0
25,"25158",1620,1019,1012,15,7,"C's",68
17,"17166",522,374,367,1,7,"C's",3
43,"43101",145,104,102,3,2,"C's",0
25,"25110",2766,1628,1602,22,26,"C's",72
17,"17223",801,516,506,9,10,"C's",39
43,"43002",1801,1156,1128,7,28,"C's",143
43,"43133",5666,3397,3356,27,41,"C's",304
17,"17063",162,111,109,0,2,"C's",3
25,"25179",162,103,103,2,0,"C's",3
17,"17120",786,517,512,8,5,"C's",54
43,"43020",2215,1508,1497,9,11,"C's",230
17,"17111",880,590,586,7,4,"C's",37
25,"25058",4357,2624,2595,20,29,"C's",92
43,"43058",90,63,63,0,0,"C's",1
25,"25169",173,112,111,3,1,"C's",0
43,"43104",1783,1157,1142,10,15,"C's",27
43,"43905",14392,8444,8393,45,51,"C's",1536
17,"17011",637,444,439,6,5,"C's",8
25,"25225",564,356,356,1,0,"C's",14
25,"25064",108,68,68,2,0,"C's",1
17,"17081",246,163,162,2,1,"C's",5
43,"43044",3963,2671,2640,33,31,"C's",280
43,"43027",161,118,116,15,2,"C's",2
17,"17008",3639,2191,2171,16,20,"C's",78
43,"43067",552,397,393,2,4,"C's",5
25,"25244",361,223,220,5,3,"C's",7
25,"25109",231,163,162,2,1,"C's",2
17,"17066",26562,15223,15087,150,136,"C's",1676
17,"17193",4216,2555,2525,16,30,"C's",266
25,"25163",231,135,132,2,3,"C's",5
17,"17141",5887,3197,3165,34,32,"C's",340
43,"43014",14251,8737,8624,101,113,"C's",605
43,"43068",520,330,326,7,4,"C's",15
43,"43086",5249,3271,3244,37,27,"C's",182
17,"17184",1254,814,809,6,5,"C's",27
17,"17027",2821,1896,1889,17,7,"C's",87
17,"17902",1357,886,878,13,8,"C's",58
25,"25045",57,40,40,0,0,"C's",2
43,"43172",344,211,209,4,2,"C's",12
25,"25034",2326,1361,1340,15,21,"C's",45
17,"17135",362,253,253,1,0,"C's",30
17,"17112",190,127,125,2,2,"C's",3
17,"17205",208,157,155,1,2,"C's",2
17,"17201",135,87,84,0,3,"C's",2
43,"43147",524,381,373,4,8,"C's",4
43,"43024",1537,993,983,8,10,"C's",128
17,"17161",992,726,721,10,5,"C's",21
25,"25069",451,247,246,4,1,"C's",7
25,"25183",499,326,323,7,3,"C's",7
43,"43089",292,190,186,0,4,"C's",22
25,"25063",87,58,58,1,0,"C's",7
25,"25150",181,115,113,3,2,"C's",8
43,"43031",1458,1020,1014,15,6,"C's",68
17,"17043",161,122,117,1,5,"C's",3
43,"43904",2900,1602,1573,32,29,"C's",113
25,"25032",64,44,44,1,0,"C's",2
43,"43076",439,300,299,0,1,"C's",12
25,"25126",290,200,198,2,2,"C's",4
25,"25234",4279,2546,2508,23,38,"C's",127
17,"17211",830,581,580,10,1,"C's",18
25,"25021",2607,1490,1481,20,9,"C's",53
43,"43090",1076,565,558,6,7,"C's",62
17,"17162",150,86,86,1,0,"C's",1
25,"25152",140,86,86,1,0,"C's",4
17,"17160",14747,9189,9129,65,60,"C's",809
43,"43115",143,100,98,2,2,"C's",1
43,"43144",1247,842,836,6,6,"C's",98
25,"25204",1231,731,724,5,7,"C's",36
43,"43062",281,217,215,2,2,"C's",17
17,"17057",968,641,636,11,5,"C's",23
25,"25189",2110,1198,1186,10,12,"C's",102
43,"43105",162,123,122,2,1,"C's",1
25,"25238",204,140,138,4,2,"C's",5
17,"17099",81,57,57,1,0,"C's",4
25,"25232",1397,874,871,12,3,"C's",32
25,"25173",1705,1156,1143,14,13,"C's",82
17,"17095",19555,11537,11428,89,109,"C's",1554
25,"25142",364,229,225,2,4,"C's",10
25,"25233",275,178,178,4,0,"C's",10
17,"17178",1059,654,650,7,4,"C's",35
17,"17096",179,106,105,1,1,"C's",2
17,"17222",101,76,75,0,1,"C's",4
43,"43001",691,441,439,4,2,"C's",28
43,"43155",22873,14209,14082,153,127,"C's",1119
17,"17155",14515,8393,8330,65,63,"C's",703
25,"25029",1655,1042,1029,15,13,"C's",16
17,"17181",3372,2135,2112,12,23,"C's",243
25,"25059",805,527,523,7,4,"C's",67
43,"43060",2860,1950,1926,12,24,"C's",71
17,"17197",132,102,101,1,1,"C's",5
25,"25022",104,79,79,0,0,"C's",1
17,"17190",844,528,528,3,0,"C's",18
25,"25053",1055,671,661,7,10,"C's",39
43,"43069",182,136,134,1,2,"C's",12
17,"17163",2626,1764,1747,10,17,"C's",74
25,"25006",340,201,200,6,1,"C's",19
17,"17084",238,146,144,5,2,"C's",8
17,"17153",188,133,133,0,0,"C's",2
17,"17051",218,145,142,1,3,"C's",5
17,"17073",1873,1363,1356,15,7,"C's",99
43,"43113",393,279,278,5,1,"C's",12
17,"17107",264,167,165,8,2,"C's",4
25,"25221",122,81,81,0,0,"C's",0
43,"43138",2672,1629,1585,37,44,"C's",136
43,"43054",2812,1755,1739,16,16,"C's",96
25,"25100",211,125,124,1,1,"C's",3
17,"17068",245,158,156,1,2,"C's",10
43,"43128",907,587,577,5,10,"C's",38
43,"43903",2392,1324,1313,10,11,"C's",63
17,"17209",630,443,438,7,5,"C's",52
25,"25005",279,175,175,4,0,"C's",6
43,"43032",517,332,329,5,3,"C's",14
25,"25901",293,202,202,7,0,"C's",10
17,"17145",1482,967,956,8,11,"C's",30
25,"25013",2146,1240,1226,16,14,"C's",68
43,"43136",10351,6279,6218,63,61,"C's",379
25,"25185",692,400,397,6,3,"C's",19
25,"25099",1273,761,752,7,9,"C's",37
17,"17030",641,400,398,1,2,"C's",27
17,"17196",220,150,150,4,0,"C's",6
17,"17067",696,467,464,5,3,"C's",14
25,"25218",81,64,63,1,1,"C's",1
17,"17200",613,424,422,5,2,"C's",8
25,"25906",218,125,125,1,0,"C's",5
25,"25061",83,46,46,0,0,"C's",2
43,"43173",100,53,51,0,2,"C's",0
17,"17172",454,300,297,0,3,"C's",4
43,"43042",2129,1439,1437,12,2,"C's",150
25,"25055",169,105,104,4,1,"C's",5
17,"17083",2940,1895,1876,16,19,"C's",126
25,"25104",130,76,74,1,2,"C's",4
17,"17185",2265,1420,1404,15,16,"C's",59
43,"43015",112,87,86,0,1,"C's",2
25,"25148",219,124,124,0,0,"C's",5
43,"43145",4096,2795,2760,19,35,"C's",223
25,"25122",1915,1208,1197,16,11,"C's",55
17,"17175",578,321,312,5,9,"C's",26
43,"43045",149,110,110,2,0,"C's",1
17,"17014",64,48,48,1,0,"C's",5
43,"43040",330,257,255,5,2,"C's",5
43,"43021",357,232,231,6,1,"C's",18
43,"43907",4374,2793,2783,24,10,"C's",407
43,"43141",106,68,67,0,1,"C's",2
17,"17198",429,270,267,2,3,"C's",28
43,"43017",124,101,101,1,0,"C's",3
17,"17138",928,637,633,4,4,"C's",37
17,"17212",141,104,102,0,2,"C's",2
17,"17147",8053,4988,4933,52,55,"C's",276
17,"17074",510,337,335,2,2,"C's",32
43,"43163",25248,15802,15663,104,139,"C's",2171
25,"25072",5850,3493,3444,29,49,"C's",248
25,"25227",652,402,400,4,2,"C's",10
43,"43124",482,308,307,2,1,"C's",18
17,"17013",2787,1780,1762,17,18,"C's",181
25,"25060",72,46,44,1,2,"C's",0
25,"25226",253,155,152,3,3,"C's",9
43,"43114",392,271,268,2,3,"C's",0
25,"25223",922,553,543,8,10,"C's",17
25,"25170",266,169,167,1,2,"C's",7
25,"25194",423,246,244,6,2,"C's",8
43,"43022",1497,897,889,14,8,"C's",56
43,"43146",39,29,28,0,1,"C's",1
8,"8041",10343,6645,6582,57,63,"C's",970
8,"8210",4329,2624,2594,31,30,"C's",159
8,"8228",301,199,197,6,2,"C's",14
8,"8016",1831,1136,1129,19,7,"C's",63
8,"8240",9348,6512,6483,38,29,"C's",414
8,"8299",391,244,244,5,0,"C's",1
8,"8146",1286,885,881,12,4,"C's",103
8,"8010",4168,2631,2606,20,25,"C's",199
8,"8011",1756,1087,1082,16,5,"C's",28
8,"8286",2879,1802,1797,14,5,"C's",232
8,"8230",7635,5177,5121,54,56,"C's",723
8,"8117",2450,1602,1594,11,8,"C's",98
8,"8205",59828,43344,43140,367,204,"C's",5636
8,"8204",3055,2094,2082,17,12,"C's",247
8,"8903",214,166,165,0,1,"C's",1
8,"8051",17948,12140,12076,102,64,"C's",1245
8,"8296",1777,1237,1231,7,6,"C's",166
8,"8214",6872,4699,4675,47,24,"C's",459
8,"8091",5244,3611,3584,17,27,"C's",325
8,"8200",61409,41278,41024,312,254,"C's",5336
8,"8094",1559,1112,1097,14,15,"C's",54
8,"8100",2001,1395,1380,25,15,"C's",53
8,"8052",141,88,88,0,0,"C's",2
8,"8082",1139,711,708,4,3,"C's",94
8,"8064",1847,1245,1230,9,15,"C's",55
8,"8017",2762,1701,1688,9,13,"C's",129
8,"8059",347,195,195,2,0,"C's",11
8,"8132",383,213,212,4,1,"C's",5
8,"8202",12680,8341,8278,75,63,"C's",589
8,"8003",7084,4839,4803,39,36,"C's",609
8,"8060",144,87,87,0,0,"C's",1
8,"8201",442,278,278,4,0,"C's",4
8,"8233",1871,1153,1140,16,13,"C's",26
8,"8042",2231,1565,1558,17,7,"C's",173
8,"8040",10710,6845,6802,51,43,"C's",575
8,"8241",73,52,52,0,0,"C's",3
8,"8285",10224,6396,6342,52,54,"C's",331
8,"8106",7279,4871,4845,40,26,"C's",493
8,"8242",219,153,153,4,0,"C's",7
8,"8159",14096,9393,9347,76,46,"C's",1230
8,"8273",2333,1654,1637,10,17,"C's",63
8,"8036",163,105,104,1,1,"C's",0
8,"8118",17547,12183,12108,105,75,"C's",1203
8,"8304",812,562,558,3,4,"C's",37
8,"8133",128,72,72,0,0,"C's",3
8,"8294",1966,1287,1280,17,7,"C's",91
8,"8143",2682,1718,1707,17,11,"C's",132
8,"8209",6773,4410,4382,29,28,"C's",528
8,"8006",11470,7210,7132,60,78,"C's",524
8,"8297",134,85,84,0,1,"C's",1
8,"8002",201,130,124,0,6,"C's",2
8,"8104",679,432,430,3,2,"C's",7
8,"8077",34508,24070,23956,127,114,"C's",3326
8,"8215",2588,1663,1647,16,16,"C's",58
8,"8282",6578,4714,4690,45,24,"C's",476
8,"8231",20564,13037,12952,96,85,"C's",1754
8,"8295",10870,6972,6918,51,54,"C's",952
8,"8068",6718,4373,4343,33,30,"C's",516
8,"8019",1136351,768170,764030,5799,4140,"C's",86642
8,"8220",2356,1690,1683,18,7,"C's",40
8,"8065",1176,797,784,10,13,"C's",32
8,"8256",650,484,484,5,0,"C's",23
8,"8009",9180,6207,6192,50,15,"C's",652
8,"8079",343,256,255,4,1,"C's",11
8,"8264",4325,2929,2908,26,21,"C's",421
8,"8086",13582,8612,8557,75,55,"C's",1295
8,"8223",1852,1182,1171,12,11,"C's",77
8,"8140",4774,3118,3098,23,20,"C's",224
8,"8187",152377,102805,102199,805,606,"C's",11496
8,"8037",1864,1242,1230,14,12,"C's",35
8,"8189",127,90,89,3,1,"C's",1
8,"8261",2327,1499,1493,11,6,"C's",211
8,"8191",5239,3454,3438,27,16,"C's",181
8,"8157",8382,5823,5789,45,34,"C's",803
8,"8244",5851,4095,4058,36,37,"C's",573
8,"8902",3761,2570,2558,31,12,"C's",349
8,"8162",2047,1400,1392,7,8,"C's",156
8,"8113",52035,32351,32150,254,201,"C's",2363
8,"8291",4536,2975,2965,21,10,"C's",399
8,"8127",2225,1349,1334,14,15,"C's",74
8,"8058",1730,1102,1095,6,7,"C's",102
8,"8130",95,56,55,0,1,"C's",2
8,"8904",10553,6623,6579,52,44,"C's",813
8,"8302",9218,5946,5891,82,55,"C's",892
8,"8149",993,569,567,10,2,"C's",12
8,"8905",2346,1689,1681,26,8,"C's",159
8,"8197",7648,5020,5000,37,20,"C's",653
8,"8190",256,168,165,2,3,"C's",1
8,"8221",12368,8798,8763,67,35,"C's",1057
8,"8182",2811,1799,1789,22,10,"C's",235
8,"8180",26613,17585,17490,153,95,"C's",2510
8,"8167",5910,4081,4051,40,30,"C's",640
8,"8154",696,494,488,5,6,"C's",47
8,"8063",453,337,336,4,1,"C's",8
8,"8067",5739,3616,3577,47,39,"C's",183
8,"8206",728,523,515,5,8,"C's",23
8,"8029",3480,2472,2460,25,12,"C's",268
8,"8107",11502,7510,7445,67,65,"C's",1012
8,"8169",47759,32651,32439,243,212,"C's",3964
8,"8089",33850,22230,22096,170,134,"C's",3412
8,"8301",48557,32715,32533,253,182,"C's",4961
8,"8283",5963,3670,3642,24,28,"C's",160
8,"8027",687,486,485,2,1,"C's",31
8,"8135",6677,4813,4775,51,38,"C's",510
8,"8196",19233,12733,12671,94,62,"C's",1902
8,"8095",73,48,47,0,1,"C's",1
8,"8168",358,231,231,5,0,"C's",7
8,"8110",13315,8457,8368,73,89,"C's",815
8,"8307",48295,32010,31798,195,212,"C's",3493
8,"8090",128,101,101,2,0,"C's",0
8,"8303",274,193,192,2,1,"C's",8
8,"8148",2233,1491,1483,7,8,"C's",226
8,"8265",1553,1028,1018,11,10,"C's",42
8,"8103",625,395,395,2,0,"C's",26
8,"8081",339,222,221,3,1,"C's",11
8,"8181",7887,5178,5144,48,34,"C's",604
8,"8177",40,30,30,0,0,"C's",0
8,"8234",3200,2128,2114,21,14,"C's",216
8,"8005",6205,4187,4167,22,20,"C's",429
8,"8151",466,288,287,2,1,"C's",6
8,"8057",60,45,44,1,1,"C's",0
8,"8032",1981,1319,1311,11,8,"C's",128
8,"8126",8748,5927,5895,56,32,"C's",848
8,"8012",1672,1075,1061,17,14,"C's",30
8,"8109",216,162,161,0,1,"C's",1
8,"8170",450,276,274,7,2,"C's",11
8,"8008",190,110,110,5,0,"C's",3
8,"8119",6180,4155,4123,28,32,"C's",526
8,"8255",134,78,78,0,0,"C's",0
8,"8224",820,557,551,2,6,"C's",32
8,"8188",115,78,78,0,0,"C's",2
8,"8144",717,447,437,5,10,"C's",12
8,"8098",2381,1544,1534,5,10,"C's",153
8,"8015",155409,99368,98735,820,633,"C's",12395
8,"8070",266,194,191,2,3,"C's",3
8,"8247",961,637,634,4,3,"C's",13
8,"8272",151,90,90,1,0,"C's",2
8,"8128",563,375,372,2,3,"C's",6
8,"8245",78562,50821,50538,384,283,"C's",6353
8,"8207",1865,1407,1402,19,5,"C's",65
8,"8141",4563,2953,2929,34,24,"C's",124
8,"8073",61814,42275,42025,294,250,"C's",5287
8,"8172",20326,13875,13802,92,73,"C's",1589
8,"8237",1643,1105,1096,8,9,"C's",33
8,"8219",15422,10701,10619,98,82,"C's",1080
8,"8165",1649,1100,1085,9,15,"C's",89
8,"8085",1000,662,658,5,4,"C's",18
8,"8055",519,331,327,4,4,"C's",24
8,"8084",1142,773,768,14,5,"C's",42
8,"8212",488,319,316,0,3,"C's",9
8,"8278",4779,3161,3148,20,13,"C's",79
8,"8093",27,21,21,0,0,"C's",1
8,"8076",16169,10652,10563,75,89,"C's",1142
8,"8120",6835,4708,4688,44,20,"C's",422
8,"8203",2390,1466,1456,8,10,"C's",132
8,"8270",18490,12343,12274,93,69,"C's",1755
8,"8137",262,188,187,2,1,"C's",3
8,"8116",578,387,383,2,4,"C's",9
8,"8232",1775,1183,1176,6,7,"C's",56
8,"8096",42622,28797,28615,263,182,"C's",3338
8,"8072",10259,6462,6422,42,40,"C's",750
8,"8290",1507,1118,1110,12,8,"C's",76
8,"8176",156,109,107,2,2,"C's",1
8,"8122",1698,1080,1073,5,7,"C's",58
8,"8179",579,396,396,5,0,"C's",27
8,"8035",12547,7877,7828,51,49,"C's",685
8,"8254",1739,1159,1156,10,3,"C's",17
8,"8023",6734,4350,4323,35,27,"C's",480
8,"8268",1005,665,659,4,6,"C's",36
8,"8227",2326,1508,1487,20,21,"C's",123
8,"8138",4248,2638,2618,27,20,"C's",136
8,"8229",535,357,354,9,3,"C's",14
8,"8049",1293,790,779,3,11,"C's",10
8,"8269",2673,1788,1776,14,12,"C's",77
8,"8259",6637,4611,4577,39,34,"C's",291
8,"8277",157,108,107,0,1,"C's",0
8,"8211",33081,23576,23413,226,163,"C's",3225
8,"8217",24989,17765,17661,114,104,"C's",2503
8,"8216",25,15,15,1,0,"C's",0
8,"8028",1024,648,644,4,4,"C's",56
8,"8274",4665,3028,3009,26,19,"C's",254
8,"8114",18292,12102,12009,72,93,"C's",1438
8,"8193",944,601,596,12,5,"C's",44
8,"8293",219,168,167,0,1,"C's",3
8,"8239",453,304,302,3,2,"C's",27
8,"8250",7061,4480,4448,48,32,"C's",582
8,"8044",4141,2739,2726,15,13,"C's",220
8,"8129",462,319,316,3,3,"C's",12
8,"8108",5016,3501,3474,21,27,"C's",468
8,"8018",2636,1690,1675,23,15,"C's",114
8,"8238",14531,10378,10325,98,53,"C's",1280
8,"8258",830,557,551,6,6,"C's",9
8,"8056",42140,28129,27977,257,152,"C's",4823
8,"8243",162,113,113,7,0,"C's",2
8,"8160",327,208,208,1,0,"C's",4
8,"8257",107,71,71,0,0,"C's",1
8,"8171",2103,1288,1280,12,8,"C's",26
8,"8263",20972,13710,13583,149,127,"C's",1768
8,"8287",1048,736,735,2,1,"C's",26
8,"8045",73,37,35,0,2,"C's",0
8,"8139",175,132,132,2,0,"C's",2
8,"8246",1665,1086,1078,9,8,"C's",25
8,"8252",24570,17009,16901,145,108,"C's",2541
8,"8105",9630,6394,6339,49,55,"C's",856
8,"8218",8009,5105,5075,59,30,"C's",529
8,"8158",3082,2054,2041,21,13,"C's",213
8,"8145",2599,1774,1761,11,13,"C's",172
8,"8024",386,243,236,0,7,"C's",4
8,"8038",1487,959,954,15,5,"C's",52
8,"8111",218,185,184,3,1,"C's",7
8,"8092",3736,2369,2342,13,27,"C's",82
8,"8164",913,618,609,7,9,"C's",23
8,"8292",1072,730,725,6,5,"C's",45
8,"8097",1021,715,712,8,3,"C's",47
8,"8069",3169,2161,2148,32,13,"C's",230
8,"8147",16967,11220,11138,65,82,"C's",1326
8,"8124",36804,24782,24632,184,150,"C's",3134
8,"8288",1659,1004,994,7,10,"C's",84
8,"8150",255,186,186,1,0,"C's",11
8,"8901",227,148,145,1,3,"C's",5
8,"8043",3201,2056,2041,9,15,"C's",277
8,"8102",28296,18466,18367,172,99,"C's",1497
8,"8185",188,123,122,2,1,"C's",7
8,"8199",663,456,453,14,3,"C's",24
8,"8156",10891,7322,7259,43,63,"C's",984
8,"8289",4338,2912,2898,27,14,"C's",292
8,"8279",153025,101133,100621,840,512,"C's",12766
8,"8039",362,266,266,0,0,"C's",5
8,"8033",12813,8564,8509,63,55,"C's",741
8,"8284",12097,7157,7089,59,68,"C's",741
8,"8080",34,26,26,3,0,"C's",0
8,"8123",19140,13557,13484,106,73,"C's",1324
8,"8266",43030,30192,30039,229,153,"C's",3990
8,"8050",141,99,99,2,0,"C's",4
8,"8001",8907,6316,6269,46,47,"C's",899
8,"8078",219,112,111,3,1,"C's",1
8,"8236",1527,1006,999,4,7,"C's",39
8,"8062",956,619,618,4,1,"C's",58
8,"8054",8998,6172,6129,44,43,"C's",870
8,"8014",1962,1366,1359,15,7,"C's",52
8,"8267",6461,4265,4245,51,20,"C's",435
8,"8271",70,48,48,0,0,"C's",1
8,"8025",1490,981,978,4,3,"C's",90
8,"8087",152,121,121,2,0,"C's",11
8,"8226",891,648,645,6,3,"C's",25
8,"8022",12212,7210,7155,66,55,"C's",255
8,"8153",538,386,385,2,1,"C's",18
8,"8007",6483,4281,4250,33,31,"C's",304
8,"8021",70,49,46,0,3,"C's",1
8,"8300",5678,3983,3964,35,19,"C's",518
8,"8163",18641,11801,11729,68,72,"C's",1314
8,"8174",392,283,279,3,4,"C's",22
8,"8047",3899,2292,2260,16,32,"C's",176
8,"8030",5122,3482,3466,21,16,"C's",420
8,"8178",435,309,308,4,1,"C's",19
8,"8026",188,134,134,0,0,"C's",1
8,"8155",6730,4353,4320,39,33,"C's",504
8,"8251",4984,3257,3241,17,16,"C's",335
8,"8184",53822,34744,34545,264,199,"C's",4803
8,"8083",1675,1146,1144,9,2,"C's",30
8,"8175",3347,2080,2064,20,16,"C's",81
8,"8213",6319,3950,3935,37,15,"C's",283
8,"8061",1497,986,983,14,3,"C's",93
8,"8048",582,419,417,4,2,"C's",17
8,"8161",11144,6994,6938,73,56,"C's",768
8,"8248",5419,3566,3546,45,20,"C's",369
8,"8136",11450,7703,7641,84,62,"C's",1080
8,"8253",131,81,81,2,0,"C's",0
8,"8074",10611,6728,6679,52,49,"C's",975
8,"8075",3883,2479,2467,14,12,"C's",292
8,"8298",26471,16674,16591,139,83,"C's",820
8,"8276",237,165,165,2,0,"C's",8
8,"8281",4802,3343,3318,17,25,"C's",348
8,"8305",27339,17960,17809,147,151,"C's",1410
8,"8131",704,471,468,7,3,"C's",4
8,"8308",131,87,87,1,0,"C's",0
8,"8192",5678,3729,3707,35,22,"C's",223
8,"8099",749,487,485,2,2,"C's",21
8,"8198",4411,2972,2954,23,18,"C's",279
8,"8275",247,179,179,4,0,"C's",0
8,"8208",5732,3976,3952,30,24,"C's",517
8,"8134",810,541,538,7,3,"C's",22
8,"8225",92,66,66,4,0,"C's",0
8,"8046",13290,9054,9000,103,54,"C's",870
8,"8306",506,299,297,5,2,"C's",25
8,"8195",82,63,63,0,0,"C's",2
8,"8183",4550,2809,2796,20,13,"C's",103
8,"8088",11899,8149,8097,69,52,"C's",739
8,"8004",223,165,164,2,1,"C's",3
8,"8260",18335,12325,12263,106,62,"C's",1790
8,"8013",1224,802,793,9,9,"C's",59
8,"8262",6836,4175,4144,50,31,"C's",308
8,"8066",1365,926,921,8,5,"C's",104
8,"8053",2788,1605,1591,8,14,"C's",140
8,"8034",763,538,537,1,1,"C's",10
8,"8031",2322,1552,1537,6,15,"C's",69
8,"8152",114,80,79,0,1,"C's",0
8,"8121",86351,57040,56655,446,385,"C's",7122
8,"8280",97,66,66,2,0,"C's",3
8,"8112",12911,7790,7723,74,67,"C's",504
8,"8020",4926,3523,3502,33,21,"C's",443
8,"8101",174621,113632,112942,847,690,"C's",14039
8,"8194",25660,15045,14941,122,104,"C's",2069
8,"8142",133,103,101,5,2,"C's",4
8,"8249",266,211,209,2,2,"C's",6
8,"8071",240,163,162,5,1,"C's",1
8,"8125",25081,16406,16329,164,77,"C's",2112
8,"8222",1895,1358,1351,14,7,"C's",82
8,"8235",3686,2488,2470,16,18,"C's",145
8,"8115",3799,2589,2572,17,17,"C's",260
8,"8166",991,631,625,7,6,"C's",21
20,"20077",5213,3614,3591,36,23,"EAJ-PNV",1009
1,"1043",2304,1552,1532,13,20,"EAJ-PNV",180
1,"1006",175,140,140,0,0,"EAJ-PNV",11
48,"48013",79716,53419,52997,345,422,"EAJ-PNV",9618
48,"48016",5271,3694,3674,24,20,"EAJ-PNV",1126
48,"48005",115,63,61,0,2,"EAJ-PNV",18
48,"48907",348,266,266,2,0,"EAJ-PNV",132
48,"48006",290,239,239,2,0,"EAJ-PNV",94
48,"48091",1121,771,765,7,6,"EAJ-PNV",266
20,"20052",1090,779,776,8,3,"EAJ-PNV",216
20,"20048",182,100,98,2,2,"EAJ-PNV",13
20,"20075",4371,2692,2679,18,13,"EAJ-PNV",685
48,"48019",3553,2406,2397,18,9,"EAJ-PNV",685
20,"20049",4122,2677,2666,15,11,"EAJ-PNV",664
1,"1019",150,106,105,1,1,"EAJ-PNV",58
20,"20062",973,653,653,11,0,"EAJ-PNV",248
1,"1055",838,538,527,8,11,"EAJ-PNV",153
20,"20029",4281,2813,2802,19,11,"EAJ-PNV",958
48,"48914",332,272,272,1,0,"EAJ-PNV",135
1,"1046",601,432,428,3,4,"EAJ-PNV",109
20,"20022",839,473,472,4,1,"EAJ-PNV",169
20,"20030",21423,13960,13898,101,62,"EAJ-PNV",3053
20,"20053",4774,2973,2953,13,20,"EAJ-PNV",457
20,"20070",1092,748,746,5,2,"EAJ-PNV",268
1,"1059",186557,126506,125278,798,1228,"EAJ-PNV",16574
48,"48009",783,586,575,1,11,"EAJ-PNV",210
20,"20074",11592,7954,7914,45,40,"EAJ-PNV",2270
20,"20019",9986,6428,6392,48,36,"EAJ-PNV",1987
20,"20026",197,145,133,0,12,"EAJ-PNV",61
48,"48063",372,279,277,2,2,"EAJ-PNV",116
48,"48050",191,147,146,0,1,"EAJ-PNV",58
20,"20081",7470,4856,4833,40,23,"EAJ-PNV",1390
20,"20044",367,236,236,0,0,"EAJ-PNV",53
48,"48903",1835,1361,1351,7,10,"EAJ-PNV",688
1,"1052",245,184,181,0,3,"EAJ-PNV",55
1,"1004",1399,1008,995,8,13,"EAJ-PNV",301
1,"1051",3603,2259,2235,17,24,"EAJ-PNV",511
20,"20032",8797,5672,5630,40,42,"EAJ-PNV",1834
20,"20056",4082,2589,2570,27,19,"EAJ-PNV",900
1,"1042",904,653,648,6,5,"EAJ-PNV",223
48,"48910",2909,1950,1937,10,13,"EAJ-PNV",499
20,"20904",95,44,44,2,0,"EAJ-PNV",8
48,"48090",6001,4345,4295,28,50,"EAJ-PNV",1453
48,"48060",3634,2143,2134,7,9,"EAJ-PNV",941
48,"48080",9976,6820,6763,62,57,"EAJ-PNV",1585
20,"20076",6990,4666,4648,29,18,"EAJ-PNV",1183
1,"1041",149,103,100,1,3,"EAJ-PNV",29
20,"20015",1265,858,851,7,7,"EAJ-PNV",245
48,"48906",766,547,544,0,3,"EAJ-PNV",259
1,"1047",968,673,668,5,5,"EAJ-PNV",103
48,"48033",217,149,149,0,0,"EAJ-PNV",66
48,"48097",1297,900,894,8,6,"EAJ-PNV",266
48,"48913",1248,884,869,10,15,"EAJ-PNV",348
1,"1032",517,361,354,1,7,"EAJ-PNV",100
48,"48049",549,416,416,1,0,"EAJ-PNV",198
20,"20060",88,67,67,2,0,"EAJ-PNV",1
20,"20045",46626,30525,30353,197,172,"EAJ-PNV",4888
48,"48905",2553,1792,1771,12,21,"EAJ-PNV",735
1,"1002",8124,5722,5654,31,68,"EAJ-PNV",1632
20,"20012",147,99,98,5,1,"EAJ-PNV",32
20,"20903",4330,2756,2734,28,22,"EAJ-PNV",592
48,"48026",1140,830,823,5,7,"EAJ-PNV",294
20,"20011",1658,1219,1210,7,9,"EAJ-PNV",320
48,"48053",895,666,662,6,4,"EAJ-PNV",313
1,"1037",587,411,408,1,3,"EAJ-PNV",135
20,"20063",8017,5263,5231,35,32,"EAJ-PNV",1005
20,"20041",255,123,123,0,0,"EAJ-PNV",42
1,"1001",1979,1339,1318,7,21,"EAJ-PNV",244
48,"48042",1369,1068,1053,7,15,"EAJ-PNV",487
20,"20043",1739,1090,1088,9,2,"EAJ-PNV",445
1,"1036",14955,10052,9959,55,93,"EAJ-PNV",2292
48,"48062",302,237,236,4,1,"EAJ-PNV",114
48,"48065",3281,2271,2237,8,34,"EAJ-PNV",738
1,"1054",960,654,651,4,3,"EAJ-PNV",146
48,"48056",966,705,700,5,5,"EAJ-PNV",315
48,"48072",977,716,713,4,3,"EAJ-PNV",243
48,"48069",12798,8679,8612,55,67,"EAJ-PNV",3566
20,"20066",454,236,234,1,2,"EAJ-PNV",62
1,"1014",371,280,272,4,8,"EAJ-PNV",63
20,"20059",8874,5873,5855,29,18,"EAJ-PNV",1899
48,"48036",24073,16076,15971,86,105,"EAJ-PNV",4709
1,"1021",473,310,309,0,1,"EAJ-PNV",93
20,"20010",1499,992,986,9,6,"EAJ-PNV",220
20,"20071",14801,9466,9421,60,45,"EAJ-PNV",2934
48,"48064",606,447,445,4,2,"EAJ-PNV",176
20,"20038",387,261,259,0,2,"EAJ-PNV",100
20,"20080",7910,5294,5260,49,34,"EAJ-PNV",1035
20,"20902",14156,9664,9613,74,51,"EAJ-PNV",1233
20,"20014",1108,611,609,4,2,"EAJ-PNV",144
20,"20031",176,90,90,0,0,"EAJ-PNV",32
20,"20023",441,252,251,1,1,"EAJ-PNV",50
48,"48040",1281,877,869,3,8,"EAJ-PNV",405
20,"20004",252,121,121,0,0,"EAJ-PNV",57
20,"20055",17475,11073,10997,56,76,"EAJ-PNV",2655
48,"48002",7829,5490,5451,44,39,"EAJ-PNV",1371
48,"48037",673,481,478,5,3,"EAJ-PNV",217
20,"20021",200,100,100,2,0,"EAJ-PNV",37
1,"1009",1265,849,845,2,4,"EAJ-PNV",210
48,"48073",6910,4306,4271,31,35,"EAJ-PNV",1393
20,"20046",1223,739,737,5,2,"EAJ-PNV",203
48,"48044",62774,45594,45399,287,195,"EAJ-PNV",13647
48,"48017",13261,8543,8482,42,61,"EAJ-PNV",3722
48,"48046",12611,8836,8794,39,42,"EAJ-PNV",3458
1,"1013",712,454,450,0,4,"EAJ-PNV",107
48,"48093",893,653,643,7,10,"EAJ-PNV",244
48,"48066",348,258,258,1,0,"EAJ-PNV",151
48,"48012",2049,1527,1512,7,15,"EAJ-PNV",672
20,"20037",99,64,64,2,0,"EAJ-PNV",22
48,"48029",8338,5721,5683,37,38,"EAJ-PNV",1106
20,"20016",1520,826,821,2,5,"EAJ-PNV",347
48,"48911",380,276,272,1,4,"EAJ-PNV",75
48,"48908",249,181,181,0,0,"EAJ-PNV",83
48,"48083",6958,4885,4856,40,29,"EAJ-PNV",1003
1,"1018",1386,939,930,3,9,"EAJ-PNV",188
1,"1053",582,321,320,4,1,"EAJ-PNV",102
48,"48076",308,218,217,2,1,"EAJ-PNV",129
20,"20025",1143,765,760,8,5,"EAJ-PNV",282
1,"1062",313,211,210,2,1,"EAJ-PNV",38
48,"48022",2336,1444,1433,6,11,"EAJ-PNV",647
48,"48059",400,294,291,0,3,"EAJ-PNV",128
48,"48087",427,344,338,0,6,"EAJ-PNV",164
1,"1902",734,514,502,4,12,"EAJ-PNV",102
20,"20072",4728,2902,2886,21,16,"EAJ-PNV",646
48,"48096",6577,4794,4728,31,66,"EAJ-PNV",1824
48,"48089",3306,2341,2329,20,12,"EAJ-PNV",862
20,"20001",246,133,132,2,1,"EAJ-PNV",47
20,"20901",1437,908,906,2,2,"EAJ-PNV",285
20,"20069",147046,100691,100232,836,459,"EAJ-PNV",21512
1,"1039",209,155,153,0,2,"EAJ-PNV",29
48,"48010",458,318,317,0,1,"EAJ-PNV",164
48,"48067",1158,813,810,2,3,"EAJ-PNV",312
48,"48088",136,102,102,0,0,"EAJ-PNV",27
20,"20051",6877,4699,4679,34,20,"EAJ-PNV",1244
48,"48071",6087,4294,4254,32,40,"EAJ-PNV",1383
20,"20907",118,85,85,2,0,"EAJ-PNV",22
48,"48032",5743,4065,4048,29,17,"EAJ-PNV",1146
1,"1057",240,201,200,1,1,"EAJ-PNV",70
20,"20005",1260,738,736,11,2,"EAJ-PNV",206
20,"20047",469,307,304,5,3,"EAJ-PNV",72
20,"20036",13210,8518,8475,67,43,"EAJ-PNV",2819
1,"1056",219,136,135,0,1,"EAJ-PNV",55
48,"48079",427,305,304,2,1,"EAJ-PNV",126
1,"1027",416,257,254,3,3,"EAJ-PNV",78
48,"48039",239,190,188,0,2,"EAJ-PNV",96
1,"1031",1169,882,863,6,19,"EAJ-PNV",147
48,"48058",968,647,646,2,1,"EAJ-PNV",213
48,"48011",9673,6468,6423,45,45,"EAJ-PNV",1673
20,"20061",4273,2601,2590,21,11,"EAJ-PNV",919
1,"1058",1345,799,793,7,6,"EAJ-PNV",155
1,"1044",236,169,167,0,2,"EAJ-PNV",34
20,"20054",447,286,284,2,2,"EAJ-PNV",47
48,"48047",159,111,111,0,0,"EAJ-PNV",29
48,"48007",364,240,240,5,0,"EAJ-PNV",99
48,"48052",1562,1160,1150,4,10,"EAJ-PNV",379
48,"48057",5723,3988,3962,26,26,"EAJ-PNV",1558
48,"48020",273626,184710,183628,1185,1082,"EAJ-PNV",50722
20,"20007",310,218,218,3,0,"EAJ-PNV",46
48,"48035",413,293,292,1,1,"EAJ-PNV",157
20,"20040",15289,9444,9373,66,71,"EAJ-PNV",1492
20,"20006",259,143,143,3,0,"EAJ-PNV",43
20,"20033",868,600,599,1,1,"EAJ-PNV",188
48,"48024",995,757,754,7,3,"EAJ-PNV",365
1,"1901",2354,1592,1571,8,21,"EAJ-PNV",184
48,"48014",1211,806,801,7,5,"EAJ-PNV",267
1,"1061",154,127,127,1,0,"EAJ-PNV",36
20,"20002",346,203,203,4,0,"EAJ-PNV",45
1,"1010",2268,1623,1603,11,20,"EAJ-PNV",518
20,"20050",266,170,169,1,1,"EAJ-PNV",49
48,"48028",717,543,537,3,6,"EAJ-PNV",225
48,"48915",362,227,226,0,1,"EAJ-PNV",81
48,"48001",5838,3923,3898,28,25,"EAJ-PNV",852
48,"48030",606,441,439,1,2,"EAJ-PNV",229
1,"1008",786,513,509,11,4,"EAJ-PNV",123
20,"20065",3012,1985,1967,12,18,"EAJ-PNV",472
1,"1003",1190,782,774,2,8,"EAJ-PNV",222
48,"48008",606,424,414,6,10,"EAJ-PNV",214
48,"48075",1996,1364,1359,6,5,"EAJ-PNV",582
48,"48034",12866,8798,8747,43,51,"EAJ-PNV",1027
48,"48074",3312,2330,2309,6,21,"EAJ-PNV",770
48,"48004",335,222,222,0,0,"EAJ-PNV",109
48,"48901",4839,3459,3426,32,33,"EAJ-PNV",982
1,"1060",197,160,157,0,3,"EAJ-PNV",43
48,"48912",2308,1707,1679,14,28,"EAJ-PNV",581
20,"20073",4677,3014,2995,15,19,"EAJ-PNV",550
48,"48094",3161,2094,2073,12,21,"EAJ-PNV",829
48,"48904",3511,2625,2600,22,25,"EAJ-PNV",1104
48,"48055",2668,1872,1849,11,23,"EAJ-PNV",642
48,"48061",762,565,561,0,4,"EAJ-PNV",278
20,"20042",3228,1967,1958,27,9,"EAJ-PNV",466
20,"20039",2111,1480,1472,14,8,"EAJ-PNV",565
48,"48025",883,642,637,7,5,"EAJ-PNV",290
48,"48086",2050,1414,1401,5,13,"EAJ-PNV",459
20,"20079",17886,11860,11799,91,61,"EAJ-PNV",3826
48,"48909",209,161,161,0,0,"EAJ-PNV",50
1,"1023",267,187,186,1,1,"EAJ-PNV",44
48,"48070",544,362,362,4,0,"EAJ-PNV",101
20,"20008",716,362,361,6,1,"EAJ-PNV",101
20,"20067",30828,19984,19882,140,102,"EAJ-PNV",2404
20,"20078",1155,850,846,4,4,"EAJ-PNV",133
1,"1034",161,124,123,1,1,"EAJ-PNV",37
48,"48018",869,522,522,2,0,"EAJ-PNV",211
1,"1017",849,571,565,5,6,"EAJ-PNV",170
48,"48081",1868,1361,1350,4,11,"EAJ-PNV",619
48,"48078",38617,26366,26212,158,154,"EAJ-PNV",5315
48,"48068",1550,1130,1118,12,12,"EAJ-PNV",600
48,"48015",33581,22727,22528,122,199,"EAJ-PNV",5561
1,"1016",433,228,226,5,2,"EAJ-PNV",68
20,"20017",8559,5478,5435,24,43,"EAJ-PNV",2014
1,"1022",799,557,544,2,13,"EAJ-PNV",74
48,"48021",1336,908,899,1,9,"EAJ-PNV",383
48,"48084",22449,14670,14553,90,117,"EAJ-PNV",2916
48,"48038",1126,798,794,3,4,"EAJ-PNV",387
20,"20034",3145,2026,2014,14,12,"EAJ-PNV",534
20,"20009",11452,7388,7345,62,43,"EAJ-PNV",1263
48,"48085",10338,7190,7153,39,37,"EAJ-PNV",2227
20,"20018",11064,6719,6690,41,29,"EAJ-PNV",2542
48,"48031",332,233,231,1,2,"EAJ-PNV",127
1,"1049",138,109,109,1,0,"EAJ-PNV",30
48,"48077",3364,2437,2431,18,6,"EAJ-PNV",991
48,"48041",693,533,529,3,4,"EAJ-PNV",260
1,"1030",156,129,129,3,0,"EAJ-PNV",36
20,"20028",2237,1373,1365,11,8,"EAJ-PNV",296
1,"1028",1070,716,710,3,6,"EAJ-PNV",103
48,"48902",19008,12566,12447,76,119,"EAJ-PNV",3400
48,"48092",836,618,613,5,5,"EAJ-PNV",306
20,"20020",125,71,69,3,2,"EAJ-PNV",27
1,"1033",651,484,479,2,5,"EAJ-PNV",167
20,"20906",119,87,87,1,0,"EAJ-PNV",25
48,"48048",557,395,393,5,2,"EAJ-PNV",162
48,"48082",37605,25134,24938,176,196,"EAJ-PNV",5547
48,"48003",14339,9918,9838,53,80,"EAJ-PNV",3346
20,"20003",547,308,308,3,0,"EAJ-PNV",69
20,"20013",5415,3602,3579,19,23,"EAJ-PNV",1021
20,"20064",12503,7803,7755,52,48,"EAJ-PNV",1411
20,"20905",145,100,100,1,0,"EAJ-PNV",31
20,"20068",190,135,135,3,0,"EAJ-PNV",39
48,"48043",4423,3118,3108,17,10,"EAJ-PNV",1200
1,"1020",327,237,234,3,3,"EAJ-PNV",82
20,"20035",486,337,334,1,3,"EAJ-PNV",108
48,"48051",213,163,163,0,0,"EAJ-PNV",60
20,"20027",2814,1761,1750,15,11,"EAJ-PNV",562
20,"20058",755,529,525,3,4,"EAJ-PNV",141
20,"20024",386,210,209,3,1,"EAJ-PNV",58
48,"48054",24171,16797,16711,118,86,"EAJ-PNV",4672
48,"48095",2347,1555,1546,12,9,"EAJ-PNV",348
1,"1011",235,174,171,4,3,"EAJ-PNV",47
48,"48023",600,455,452,0,3,"EAJ-PNV",198
1,"1063",1798,1269,1261,19,8,"EAJ-PNV",332
48,"48027",22150,15089,14982,78,107,"EAJ-PNV",4648
48,"48045",5167,3809,3757,28,52,"EAJ-PNV",1517
20,"20057",196,122,122,0,0,"EAJ-PNV",22
38,"38005",5468,3425,3392,18,33,"EB",2
50,"50293",413,276,275,4,1,"EB",1
50,"50263",193,121,121,0,0,"EB",1
4,"4904",1777,1230,1221,12,9,"EB",2
44,"44045",366,274,269,2,5,"EB",2
33,"33001",1588,887,880,8,7,"EB",1
4,"4903",4320,2858,2825,19,33,"EB",0
44,"44230",155,123,123,2,0,"EB",2
33,"33016",19130,13666,13526,125,140,"EB",48
44,"44159",38,31,31,1,0,"EB",0
50,"50232",175,110,110,3,0,"EB",3
26,"26124",807,649,639,7,10,"EB",0
22,"22209",155,120,120,3,0,"EB",3
50,"50012",100,80,79,2,1,"EB",0
14,"14034",308,247,244,2,3,"EB",0
39,"39028",3739,2850,2817,16,33,"EB",4
44,"44152",64,46,45,0,1,"EB",0
26,"26117",2152,1625,1605,10,20,"EB",2
50,"50224",72,57,56,2,1,"EB",0
22,"22057",370,271,270,3,1,"EB",3
26,"26115",19,16,16,0,0,"EB",0
4,"4012",191,161,161,0,0,"EB",0
30,"30008",13918,9757,9645,59,112,"EB",16
4,"4015",124,96,96,2,0,"EB",3
50,"50109",103,78,78,3,0,"EB",1
26,"26058",154,116,115,0,1,"EB",0
39,"39007",417,278,275,2,3,"EB",0
44,"44161",443,314,313,2,1,"EB",2
39,"39017",569,398,391,4,7,"EB",3
22,"22137",1069,727,718,3,9,"EB",0
44,"44074",429,333,326,4,7,"EB",0
4,"4090",304,238,234,0,4,"EB",0
50,"50139",313,241,239,3,2,"EB",0
30,"30015",19171,13561,13464,61,97,"EB",10
26,"26108",266,215,213,0,2,"EB",0
22,"22094",101,74,74,1,0,"EB",0
50,"50188",28,25,25,0,0,"EB",0
30,"30006",803,691,685,2,6,"EB",0
39,"39078",1401,975,963,5,12,"EB",1
50,"50296",396,286,275,4,11,"EB",3
22,"22077",379,279,273,2,6,"EB",0
39,"39051",66,57,57,0,0,"EB",0
4,"4086",1760,1243,1234,9,9,"EB",0
39,"39030",1895,1225,1212,10,13,"EB",3
26,"26111",242,180,176,0,4,"EB",0
26,"26023",469,358,354,0,4,"EB",0
22,"22055",320,243,238,2,5,"EB",0
14,"14071",929,642,630,2,12,"EB",0
4,"4030",1119,819,812,5,7,"EB",0
44,"44027",164,123,123,1,0,"EB",1
50,"50061",202,172,172,3,0,"EB",0
14,"14012",6173,4364,4291,35,73,"EB",0
44,"44168",189,139,138,2,1,"EB",0
30,"30026",15734,10007,9901,51,106,"EB",5
50,"50191",470,310,308,1,2,"EB",4
22,"22135",189,128,127,0,1,"EB",1
50,"50290",386,283,282,1,1,"EB",3
38,"38050",2462,1624,1604,8,20,"EB",3
50,"50222",1622,1091,1071,7,20,"EB",6
44,"44146",174,153,152,2,1,"EB",2
26,"26112",236,194,190,1,4,"EB",0
39,"39089",143,104,100,1,4,"EB",0
44,"44088",29,21,21,0,0,"EB",0
26,"26092",107,92,90,0,2,"EB",0
38,"38001",20228,11032,10936,47,96,"EB",8
33,"33041",7199,4922,4877,52,45,"EB",17
50,"50131",231,167,165,0,2,"EB",2
38,"38029",1517,744,734,1,10,"EB",0
38,"38022",18450,12334,12160,62,174,"EB",9
26,"26127",212,181,176,0,5,"EB",0
22,"22181",92,61,61,2,0,"EB",1
22,"22157",192,129,128,3,1,"EB",0
50,"50053",687,513,510,2,3,"EB",0
44,"44100",185,153,151,0,2,"EB",0
4,"4041",322,240,238,6,2,"EB",0
50,"50138",46,37,37,2,0,"EB",0
44,"44052",77,56,56,0,0,"EB",0
50,"50274",71,55,55,0,0,"EB",0
26,"26076",129,107,106,0,1,"EB",0
22,"22080",280,197,194,6,3,"EB",1
44,"44092",81,59,57,0,2,"EB",0
50,"50258",54,34,34,0,0,"EB",0
39,"39008",13877,10258,10153,96,105,"EB",7
22,"22019",180,151,150,2,1,"EB",2
14,"14006",1330,1120,1101,8,19,"EB",0
4,"4022",347,249,249,7,0,"EB",1
22,"22203",83,67,67,1,0,"EB",0
39,"39021",487,381,376,2,5,"EB",0
44,"44209",833,611,602,6,9,"EB",1
44,"44048",61,52,52,0,0,"EB",0
26,"26021",2827,2098,2076,15,22,"EB",0
44,"44071",591,398,398,5,0,"EB",2
26,"26046",1581,1175,1159,4,16,"EB",1
14,"14032",423,334,330,4,4,"EB",0
50,"50096",39,27,27,0,0,"EB",1
44,"44176",158,115,114,0,1,"EB",0
50,"50288",3387,2415,2398,31,17,"EB",7
50,"50007",45,34,34,1,0,"EB",2
22,"22002",107,95,95,0,0,"EB",0
4,"4077",295,263,261,2,2,"EB",0
22,"22901",742,478,470,5,8,"EB",1
39,"39012",6687,5021,4957,51,64,"EB",6
22,"22018",327,245,244,3,1,"EB",0
39,"39010",631,480,475,7,5,"EB",1
26,"26024",228,181,181,0,0,"EB",1
4,"4096",266,209,208,0,1,"EB",0
22,"22247",33,20,20,0,0,"EB",0
14,"14049",16309,11635,11515,115,120,"EB",11
44,"44111",92,69,68,0,1,"EB",0
4,"4028",221,191,190,1,1,"EB",0
44,"44211",42,35,35,0,0,"EB",0
50,"50221",35,17,17,0,0,"EB",0
26,"26057",48,38,38,0,0,"EB",0
26,"26135",164,125,124,1,1,"EB",0
22,"22036",92,77,77,0,0,"EB",0
50,"50046",178,133,133,5,0,"EB",3
44,"44082",89,78,77,0,1,"EB",2
26,"26043",365,292,281,1,11,"EB",0
26,"26029",37,32,32,0,0,"EB",0
39,"39071",397,261,256,1,5,"EB",1
44,"44023",17,16,16,0,0,"EB",0
22,"22016",601,413,411,6,2,"EB",1
44,"44115",102,90,90,3,0,"EB",0
26,"26002",830,632,622,0,10,"EB",0
50,"50050",98,64,64,2,0,"EB",0
44,"44216",26555,18997,18737,168,260,"EB",78
30,"30012",9091,6962,6897,36,65,"EB",2
50,"50229",62,47,47,2,0,"EB",0
50,"50185",133,108,108,1,0,"EB",0
38,"38041",6821,4908,4861,40,47,"EB",4
44,"44223",72,54,54,0,0,"EB",0
50,"50125",360,248,246,3,2,"EB",1
44,"44097",142,92,92,0,0,"EB",1
38,"38002",956,702,696,21,6,"EB",0
50,"50052",90,68,68,0,0,"EB",0
50,"50209",2601,1731,1721,13,10,"EB",5
50,"50068",1982,1348,1335,8,13,"EB",2
4,"4002",1039,748,740,2,8,"EB",2
50,"50037",136,98,96,0,2,"EB",1
26,"26030",16,16,15,0,1,"EB",0
22,"22001",225,151,151,1,0,"EB",0
30,"30017",11605,8541,8451,46,90,"EB",5
50,"50284",141,107,104,0,3,"EB",0
26,"26066",251,201,194,1,7,"EB",0
30,"30039",19277,13165,13054,75,111,"EB",29
50,"50214",27,18,17,0,1,"EB",0
4,"4081",355,287,287,0,0,"EB",1
14,"14061",744,595,582,1,13,"EB",0
44,"44267",70,57,56,0,1,"EB",0
26,"26045",12,12,12,0,0,"EB",0
33,"33034",10612,6602,6536,62,66,"EB",31
50,"50024",571,437,437,6,0,"EB",1
50,"50117",126,104,103,1,1,"EB",0
22,"22139",79,64,64,1,0,"EB",1
33,"33064",234,168,167,1,1,"EB",2
26,"26087",201,153,149,3,4,"EB",0
26,"26104",13,10,10,0,0,"EB",0
33,"33023",3321,2299,2265,31,34,"EB",11
50,"50022",530,397,390,7,7,"EB",2
44,"44165",175,135,133,2,2,"EB",0
44,"44009",809,596,593,7,3,"EB",2
50,"50212",40,36,36,0,0,"EB",0
44,"44024",27,25,25,0,0,"EB",0
50,"50094",1617,1173,1159,12,14,"EB",15
50,"50161",106,75,72,0,3,"EB",0
50,"50171",106,79,79,0,0,"EB",3
39,"39047",1962,1385,1371,10,14,"EB",1
22,"22168",23,18,18,0,0,"EB",0
30,"30025",4908,3667,3630,16,37,"EB",2
50,"50257",171,134,134,2,0,"EB",0
26,"26032",51,41,39,0,2,"EB",0
50,"50043",253,171,171,0,0,"EB",0
50,"50271",252,200,197,2,3,"EB",1
30,"30007",6411,4360,4329,24,31,"EB",3
14,"14003",1248,939,930,2,9,"EB",0
39,"39069",1972,1510,1489,12,21,"EB",3
14,"14060",4868,3473,3412,41,61,"EB",1
50,"50162",146,109,105,4,4,"EB",0
44,"44036",25,21,21,0,0,"EB",0
39,"39072",344,198,196,2,2,"EB",0
14,"14063",1046,734,725,2,9,"EB",0
38,"38038",162027,104978,104035,575,943,"EB",175
44,"44050",3113,2120,2100,25,20,"EB",11
50,"50183",331,246,246,3,0,"EB",2
50,"50089",8225,6074,6043,43,31,"EB",45
4,"4024",3074,2347,2327,20,20,"EB",4
4,"4055",371,310,308,0,2,"EB",0
26,"26151",448,370,368,1,2,"EB",0
50,"50283",70,57,57,1,0,"EB",1
22,"22058",194,164,162,1,2,"EB",1
44,"44240",158,130,129,0,1,"EB",0
4,"4032",5586,3642,3623,23,19,"EB",3
26,"26074",105,86,85,1,1,"EB",0
50,"50266",122,90,90,0,0,"EB",0
22,"22083",463,394,390,5,4,"EB",0
44,"44026",90,77,76,0,1,"EB",2
33,"33057",1593,1063,1049,16,14,"EB",4
44,"44190",71,58,56,0,2,"EB",0
14,"14074",2299,1896,1866,16,30,"EB",3
22,"22003",137,110,107,1,3,"EB",0
26,"26083",284,205,205,2,0,"EB",2
26,"26061",1565,1160,1141,13,19,"EB",1
26,"26148",165,135,133,1,2,"EB",0
4,"4066",13571,8786,8724,50,62,"EB",2
38,"38018",4402,3058,3011,16,47,"EB",3
33,"33078",142,101,99,0,2,"EB",0
44,"44261",739,536,529,6,7,"EB",3
33,"33028",1276,649,641,4,8,"EB",0
50,"50110",367,256,254,0,2,"EB",0
26,"26006",1800,1419,1405,8,14,"EB",3
22,"22012",111,87,86,3,1,"EB",0
26,"26173",6,6,6,1,0,"EB",0
38,"38039",10641,7547,7459,49,88,"EB",8
44,"44227",74,63,62,0,1,"EB",0
50,"50179",249,214,213,2,1,"EB",0
4,"4016",2138,1551,1536,9,15,"EB",10
38,"38032",13237,8908,8828,52,80,"EB",14
38,"38007",1661,1114,1103,6,11,"EB",1
39,"39032",1463,1087,1081,7,6,"EB",1
50,"50196",107,87,86,0,1,"EB",2
44,"44018",19,19,19,0,0,"EB",0
14,"14054",13697,10315,10109,93,206,"EB",10
50,"50056",409,300,300,3,0,"EB",1
38,"38008",5520,3825,3766,17,59,"EB",1
22,"22172",556,372,370,6,2,"EB",1
44,"44059",544,425,412,9,13,"EB",0
33,"33006",1540,1010,1003,5,7,"EB",1
50,"50273",30,22,22,0,0,"EB",0
44,"44047",220,137,132,2,5,"EB",0
44,"44103",132,102,102,1,0,"EB",0
22,"22158",11995,8197,8126,62,71,"EB",45
26,"26168",5340,3774,3717,22,57,"EB",12
50,"50256",83,53,53,0,0,"EB",0
50,"50128",26,25,25,1,0,"EB",0
50,"50032",261,189,189,5,0,"EB",6
22,"22076",311,201,199,0,2,"EB",1
39,"39074",6902,5113,5039,40,74,"EB",10
4,"4100",8768,5390,5353,32,37,"EB",46
50,"50099",3083,2148,2132,13,16,"EB",3
22,"22131",82,63,63,0,0,"EB",0
22,"22032",110,76,74,0,2,"EB",0
39,"39088",69,52,52,0,0,"EB",0
50,"50178",293,190,187,0,3,"EB",0
22,"22177",98,75,75,0,0,"EB",1
50,"50039",491,392,390,2,2,"EB",3
50,"50146",187,145,144,3,1,"EB",0
50,"50280",332,253,250,0,3,"EB",2
14,"14027",7925,5836,5746,58,90,"EB",4
50,"50019",55,41,41,0,0,"EB",0
50,"50294",70,63,63,0,0,"EB",0
26,"26017",381,293,293,5,0,"EB",0
22,"22042",117,95,92,0,3,"EB",1
39,"39035",9502,7017,6928,57,89,"EB",20
44,"44257",166,123,119,1,4,"EB",2
22,"22020",115,86,86,1,0,"EB",2
44,"44195",88,60,60,1,0,"EB",0
26,"26134",82,68,68,2,0,"EB",0
50,"50148",316,233,229,4,4,"EB",1
44,"44053",105,78,78,0,0,"EB",0
22,"22904",815,579,575,8,4,"EB",3
50,"50254",180,118,116,1,2,"EB",0
22,"22162",130,102,102,0,0,"EB",1
44,"44262",135,108,107,2,1,"EB",0
44,"44200",39,26,26,0,0,"EB",0
44,"44135",113,88,87,0,1,"EB",0
44,"44121",60,47,47,2,0,"EB",0
4,"4001",1062,823,814,5,9,"EB",2
26,"26178",75,57,55,1,2,"EB",0
26,"26183",64,49,49,0,0,"EB",0
22,"22176",173,134,130,1,4,"EB",0
33,"33033",9873,6512,6431,68,81,"EB",28
50,"50063",61,51,51,0,0,"EB",0
22,"22202",141,119,119,0,0,"EB",1
30,"30028",6649,4797,4726,21,71,"EB",3
44,"44219",194,145,143,1,2,"EB",0
44,"44252",86,65,65,0,0,"EB",0
38,"38013",2949,1896,1867,17,29,"EB",1
44,"44066",108,79,74,0,5,"EB",0
44,"44256",38,34,34,0,0,"EB",0
22,"22052",925,712,710,8,2,"EB",1
50,"50064",437,342,339,0,3,"EB",2
22,"22136",806,588,588,5,0,"EB",1
22,"22182",250,161,158,1,3,"EB",0
22,"22212",79,64,62,0,2,"EB",0
26,"26101",44,36,35,0,1,"EB",0
26,"26136",107,85,85,0,0,"EB",0
44,"44129",39,32,32,0,0,"EB",0
38,"38051",7194,5158,5080,31,78,"EB",1
33,"33035",11284,7681,7618,70,63,"EB",26
22,"22907",1435,1059,1046,18,13,"EB",7
50,"50118",2165,1552,1540,10,12,"EB",7
26,"26102",6111,4486,4435,28,51,"EB",5
14,"14019",6464,4967,4909,49,58,"EB",14
50,"50115",3235,2128,2109,14,19,"EB",7
44,"44153",1774,1135,1121,5,14,"EB",5
50,"50003",128,92,91,1,1,"EB",1
50,"50044",230,145,145,1,0,"EB",0
50,"50223",920,712,701,4,11,"EB",0
22,"22111",154,103,102,0,1,"EB",0
44,"44113",71,52,52,0,0,"EB",0
22,"22213",3003,2169,2131,19,38,"EB",5
22,"22129",183,120,118,1,2,"EB",0
22,"22230",284,216,216,1,0,"EB",2
4,"4045",1757,1309,1288,6,21,"EB",4
22,"22204",1114,745,739,12,6,"EB",3
38,"38053",3735,2469,2435,17,34,"EB",0
50,"50160",2238,1546,1528,12,18,"EB",3
50,"50119",927,724,713,5,11,"EB",1
14,"14029",4178,3047,3009,28,38,"EB",2
26,"26091",161,146,146,0,0,"EB",0
26,"26103",796,616,610,6,6,"EB",0
44,"44229",152,112,111,3,1,"EB",0
14,"14048",1207,884,869,13,15,"EB",0
50,"50194",88,63,63,1,0,"EB",0
22,"22173",232,152,152,3,0,"EB",0
4,"4075",5196,3735,3706,23,29,"EB",1
26,"26012",23,23,23,1,0,"EB",0
50,"50045",1243,926,925,6,1,"EB",4
50,"50084",77,59,59,2,0,"EB",2
4,"4018",270,232,229,0,3,"EB",0
4,"4033",135,97,93,1,4,"EB",1
39,"39001",2102,1622,1601,18,21,"EB",3
30,"30029",11864,8125,8058,73,67,"EB",15
14,"14024",1903,1405,1376,16,29,"EB",0
50,"50025",4562,3158,3124,31,34,"EB",8
4,"4046",858,609,599,7,10,"EB",0
26,"26047",1947,1578,1563,8,15,"EB",3
22,"22060",1164,858,850,3,8,"EB",1
26,"26036",16986,11940,11816,66,124,"EB",30
26,"26153",13,12,11,0,1,"EB",0
33,"33059",4646,3075,3033,29,42,"EB",6
14,"14022",4006,2977,2949,17,28,"EB",1
26,"26018",10477,8053,7956,65,97,"EB",4
50,"50143",566,394,391,6,3,"EB",1
22,"22128",188,146,144,3,2,"EB",0
44,"44133",21,15,15,0,0,"EB",1
50,"50206",460,363,357,4,6,"EB",4
33,"33039",1655,1223,1209,12,14,"EB",9
39,"39022",980,721,713,2,8,"EB",0
33,"33066",42963,28564,28282,300,282,"EB",145
50,"50111",180,143,143,0,0,"EB",0
50,"50268",44,37,37,0,0,"EB",1
39,"39080",3542,2656,2628,20,28,"EB",1
26,"26140",253,208,206,0,2,"EB",0
50,"50173",182,132,131,1,1,"EB",0
44,"44124",77,64,64,3,0,"EB",0
14,"14004",2034,1531,1518,14,13,"EB",0
22,"22144",243,188,187,1,1,"EB",0
39,"39094",848,655,651,3,4,"EB",1
22,"22187",293,218,216,2,2,"EB",3
26,"26056",419,338,332,1,6,"EB",2
26,"26082",112,87,87,1,0,"EB",0
39,"39084",838,631,624,2,7,"EB",2
44,"44193",78,54,54,1,0,"EB",0
50,"50259",88,67,66,0,1,"EB",0
22,"22903",652,514,507,1,7,"EB",3
39,"39085",6836,5086,5032,44,54,"EB",4
44,"44226",140,98,98,2,0,"EB",0
50,"50114",116,89,88,0,1,"EB",1
26,"26027",157,112,108,0,4,"EB",1
26,"26131",35,33,33,1,0,"EB",0
44,"44194",109,78,73,3,5,"EB",0
22,"22149",305,228,228,0,0,"EB",0
50,"50009",105,80,80,0,0,"EB",0
50,"50218",113,91,91,1,0,"EB",0
4,"4059",1079,723,712,4,11,"EB",0
26,"26121",25,22,22,0,0,"EB",0
39,"39096",690,487,479,4,8,"EB",1
44,"44064",69,49,49,0,0,"EB",0
26,"26073",97,78,78,0,0,"EB",0
33,"33072",1566,1008,994,11,14,"EB",1
26,"26180",221,173,172,0,1,"EB",0
50,"50075",80,62,61,1,1,"EB",1
30,"30024",58746,42036,41731,206,305,"EB",37
22,"22088",153,110,110,2,0,"EB",0
14,"14066",5856,4150,4095,48,55,"EB",1
30,"30003",24332,16183,16040,104,143,"EB",13
26,"26181",14,14,14,0,0,"EB",0
44,"44033",269,191,190,0,1,"EB",1
50,"50248",508,387,374,2,13,"EB",0
22,"22102",179,141,138,2,3,"EB",1
50,"50059",769,549,544,8,5,"EB",0
44,"44090",78,53,53,0,0,"EB",0
22,"22085",104,86,86,0,0,"EB",0
30,"30031",492,409,401,0,8,"EB",0
44,"44141",135,97,96,1,1,"EB",0
50,"50187",69,44,44,0,0,"EB",0
4,"4051",436,360,356,1,4,"EB",1
50,"50902",87,79,79,2,0,"EB",0
33,"33003",646,355,352,9,3,"EB",2
39,"39097",697,371,368,2,3,"EB",1
22,"22197",473,354,354,1,0,"EB",0
44,"44128",68,54,54,1,0,"EB",0
50,"50149",34,24,24,0,0,"EB",2
33,"33044",178278,125469,124554,1124,915,"EB",552
22,"22044",252,198,197,0,1,"EB",0
50,"50200",511,410,403,2,7,"EB",1
4,"4008",505,423,417,5,6,"EB",0
22,"22007",792,581,581,8,0,"EB",0
39,"39058",810,559,557,2,2,"EB",0
14,"14058",7970,5491,5417,66,74,"EB",6
44,"44241",533,396,389,0,7,"EB",1
22,"22906",186,141,139,3,2,"EB",2
14,"14002",10951,7706,7620,83,86,"EB",5
50,"50264",156,115,115,0,0,"EB",1
4,"4103",1476,1018,1008,3,10,"EB",0
50,"50129",235,161,158,2,3,"EB",0
4,"4063",1096,776,768,2,8,"EB",0
44,"44068",659,509,503,3,6,"EB",0
44,"44056",501,345,342,2,3,"EB",0
26,"26138",4588,3290,3247,15,43,"EB",2
38,"38003",1439,969,952,10,17,"EB",2
44,"44228",100,82,82,0,0,"EB",0
44,"44231",38,33,33,0,0,"EB",0
26,"26055",39,32,32,0,0,"EB",0
39,"39009",3216,2366,2337,17,29,"EB",3
22,"22251",364,284,284,0,0,"EB",1
30,"30027",48176,35521,35266,153,255,"EB",63
50,"50014",147,94,94,0,0,"EB",0
4,"4044",1547,1166,1156,5,10,"EB",1
44,"44120",222,154,150,2,4,"EB",1
14,"14051",1397,1018,1000,2,18,"EB",0
38,"38016",1223,638,623,3,15,"EB",0
26,"26034",654,497,489,1,8,"EB",1
44,"44086",449,342,336,3,6,"EB",2
33,"33067",784,587,579,9,8,"EB",2
26,"26171",176,139,133,1,6,"EB",0
50,"50204",2436,1785,1770,3,15,"EB",4
14,"14023",2021,1660,1639,8,21,"EB",1
22,"22242",62,45,44,0,1,"EB",0
22,"22072",191,136,135,0,1,"EB",2
4,"4085",387,304,301,2,3,"EB",0
50,"50174",91,69,68,0,1,"EB",0
22,"22096",301,240,240,0,0,"EB",0
33,"33037",34454,22881,22586,243,295,"EB",108
39,"39020",23592,15594,15384,128,210,"EB",39
50,"50235",2339,1664,1648,11,16,"EB",4
50,"50195",54,40,40,0,0,"EB",1
44,"44179",337,229,226,1,3,"EB",0
39,"39031",1236,878,868,4,10,"EB",1
50,"50098",174,130,124,0,6,"EB",4
14,"14005",6311,4143,4084,72,59,"EB",6
14,"14033",1283,971,959,9,12,"EB",1
22,"22074",313,228,225,4,3,"EB",1
14,"14042",18891,14051,13848,190,203,"EB",31
44,"44260",137,91,89,3,2,"EB",0
50,"50016",52,40,40,0,0,"EB",0
44,"44006",248,185,183,2,2,"EB",1
22,"22114",123,81,81,0,0,"EB",0
14,"14062",1025,806,792,6,14,"EB",0
22,"22160",209,168,168,6,0,"EB",0
14,"14016",1337,1072,1060,2,12,"EB",4
4,"4054",358,285,281,2,4,"EB",0
38,"38011",20570,13831,13698,75,133,"EB",20
44,"44180",70,61,61,0,0,"EB",0
26,"26106",86,72,72,0,0,"EB",0
50,"50237",101,74,73,1,1,"EB",0
26,"26177",304,255,254,7,1,"EB",0
44,"44040",201,160,157,1,3,"EB",0
4,"4098",1516,1115,1106,11,9,"EB",1
44,"44039",221,165,159,0,6,"EB",0
44,"44213",62,50,50,0,0,"EB",1
50,"50155",103,80,78,0,2,"EB",0
30,"30001",4582,3620,3594,18,26,"EB",9
50,"50186",42,31,31,0,0,"EB",0
33,"33056",4997,3269,3244,22,25,"EB",6
14,"14026",2067,1424,1405,4,19,"EB",0
14,"14045",3052,2362,2335,11,27,"EB",1
38,"38009",4127,2915,2868,20,47,"EB",2
50,"50080",33,27,27,0,0,"EB",0
38,"38046",9113,6850,6775,40,75,"EB",5
22,"22163",425,360,355,0,5,"EB",1
38,"38045",3837,2127,2111,12,16,"EB",4
22,"22062",167,116,116,1,0,"EB",0
30,"30042",1922,1504,1491,7,13,"EB",42
50,"50070",60,36,36,0,0,"EB",0
44,"44020",24,20,19,1,1,"EB",0
39,"39024",1879,1390,1372,2,18,"EB",1
50,"50239",62,50,48,0,2,"EB",0
26,"26028",134,113,112,0,1,"EB",0
14,"14037",3318,2374,2320,22,54,"EB",1
39,"39044",3849,2765,2732,21,33,"EB",6
14,"14065",1850,1384,1377,16,7,"EB",2
22,"22063",169,133,129,1,4,"EB",3
4,"4036",226,175,175,0,0,"EB",0
30,"30002",9903,7011,6943,28,68,"EB",12
22,"22221",84,58,58,0,0,"EB",0
4,"4070",1584,1184,1179,3,5,"EB",1
44,"44077",74,60,58,0,2,"EB",0
44,"44032",16,11,11,0,0,"EB",0
50,"50230",1165,833,828,8,5,"EB",1
26,"26051",239,193,191,1,2,"EB",0
22,"22184",184,155,155,3,0,"EB",1
44,"44265",186,141,138,2,3,"EB",1
4,"4101",4266,2909,2876,26,33,"EB",5
44,"44093",80,66,66,0,0,"EB",0
26,"26062",89,72,71,2,1,"EB",0
14,"14075",572,448,428,1,20,"EB",0
38,"38023",121908,81147,80333,494,814,"EB",120
22,"22064",166,122,121,1,1,"EB",0
22,"22006",298,204,204,5,0,"EB",3
33,"33030",895,669,666,9,3,"EB",3
33,"33046",499,379,367,5,12,"EB",0
50,"50004",522,390,388,0,2,"EB",0
50,"50152",1430,1008,994,14,14,"EB",5
50,"50038",1502,1121,1111,7,10,"EB",5
33,"33043",683,446,441,2,5,"EB",1
44,"44001",68,53,52,1,1,"EB",0
44,"44044",88,72,71,2,1,"EB",0
44,"44174",428,307,304,3,3,"EB",0
44,"44151",190,151,148,0,3,"EB",0
50,"50170",371,283,280,0,3,"EB",0
22,"22029",127,100,100,0,0,"EB",1
44,"44108",320,222,222,1,0,"EB",0
38,"38037",12864,8287,8163,64,124,"EB",5
22,"22223",75,58,58,0,0,"EB",0
22,"22109",261,191,190,1,1,"EB",0
50,"50201",448,339,335,7,4,"EB",2
26,"26172",30,23,23,0,0,"EB",0
44,"44013",11244,7815,7712,82,103,"EB",26
50,"50211",249,176,173,0,3,"EB",0
44,"44012",334,263,261,5,2,"EB",0
14,"14030",8625,6248,6181,53,67,"EB",8
44,"44119",130,92,91,3,1,"EB",0
30,"30035",18671,13103,12979,54,124,"EB",19
4,"4073",330,234,233,2,1,"EB",0
33,"33055",1514,1109,1092,5,17,"EB",1
4,"4053",12320,8946,8866,70,80,"EB",10
26,"26161",8,7,7,0,0,"EB",0
22,"22156",289,220,220,2,0,"EB",5
26,"26054",320,263,260,4,3,"EB",0
50,"50085",167,126,126,1,0,"EB",0
22,"22027",329,221,218,0,3,"EB",1
26,"26125",2699,1931,1907,23,24,"EB",3
50,"50023",224,175,175,0,0,"EB",0
44,"44187",201,152,149,4,3,"EB",0
14,"14050",2391,1822,1787,14,35,"EB",1
26,"26077",22,22,21,1,1,"EB",0
44,"44210",746,554,545,3,9,"EB",3
26,"26022",198,164,163,1,1,"EB",0
26,"26044",52,46,46,0,0,"EB",0
44,"44046",49,34,34,1,0,"EB",0
50,"50100",329,246,241,1,5,"EB",2
4,"4088",2454,1660,1650,15,10,"EB",1
33,"33050",592,387,376,2,11,"EB",0
50,"50001",100,77,77,0,0,"EB",0
22,"22227",206,163,160,3,3,"EB",0
50,"50275",108,55,55,0,0,"EB",0
50,"50034",826,567,563,5,4,"EB",1
22,"22011",88,71,69,0,2,"EB",0
14,"14070",1332,986,974,10,12,"EB",1
50,"50286",77,50,50,3,0,"EB",0
22,"22112",9566,6354,6305,56,49,"EB",16
50,"50265",79,61,61,0,0,"EB",0
39,"39081",437,337,332,4,5,"EB",0
14,"14014",2557,2035,2007,9,28,"EB",5
44,"44131",25,20,20,0,0,"EB",0
22,"22127",505,374,371,3,3,"EB",0
50,"50236",102,79,77,0,2,"EB",1
50,"50067",14119,9909,9819,112,90,"EB",52
14,"14052",9379,5917,5854,68,63,"EB",6
33,"33007",1514,946,942,12,4,"EB",0
38,"38042",3802,2652,2625,14,27,"EB",0
44,"44122",1333,925,913,8,12,"EB",2
4,"4056",143,113,109,0,4,"EB",0
33,"33068",1093,645,641,4,4,"EB",2
26,"26165",358,304,299,2,5,"EB",0
14,"14015",2125,1579,1554,10,25,"EB",0
50,"50205",90,63,61,0,2,"EB",0
26,"26014",474,327,324,1,3,"EB",0
26,"26080",472,391,389,0,2,"EB",0
26,"26088",37,32,31,0,1,"EB",0
39,"39052",18236,13537,13380,110,157,"EB",27
44,"44192",355,280,278,4,2,"EB",1
4,"4047",2281,1893,1878,11,15,"EB",0
26,"26105",2205,1670,1658,12,12,"EB",5
26,"26142",787,612,606,3,6,"EB",3
39,"39073",9837,7356,7298,31,58,"EB",16
44,"44203",10,10,10,0,0,"EB",0
39,"39082",1653,1173,1157,11,16,"EB",0
26,"26004",67,50,50,0,0,"EB",0
26,"26067",22,15,15,1,0,"EB",0
22,"22214",128,106,105,3,1,"EB",0
50,"50076",78,66,65,0,1,"EB",0
14,"14069",7524,5460,5392,43,68,"EB",3
44,"44225",107,74,74,1,0,"EB",0
22,"22175",197,143,142,1,1,"EB",1
44,"44171",178,126,124,2,2,"EB",0
33,"33009",905,611,609,3,2,"EB",1
50,"50018",953,656,655,1,1,"EB",1
44,"44263",376,266,263,3,3,"EB",3
22,"22086",215,161,159,1,2,"EB",0
44,"44041",56,44,44,1,0,"EB",0
14,"14073",2891,2079,2016,13,63,"EB",2
44,"44125",61,44,44,0,0,"EB",0
44,"44008",1613,1163,1153,6,10,"EB",4
50,"50270",38,26,26,0,0,"EB",2
39,"39014",883,619,614,6,5,"EB",0
50,"50208",1774,1207,1195,10,12,"EB",3
44,"44031",97,62,62,0,0,"EB",0
14,"14046",4485,3268,3208,33,60,"EB",2
33,"33061",378,202,200,0,2,"EB",1
22,"22087",67,45,45,2,0,"EB",0
44,"44148",90,75,73,2,2,"EB",0
50,"50124",415,318,317,2,1,"EB",7
39,"39095",2266,1760,1726,14,34,"EB",1
44,"44021",107,89,88,0,1,"EB",0
33,"33010",1822,1190,1180,17,10,"EB",3
50,"50051",816,616,614,2,2,"EB",4
22,"22207",125,72,71,2,1,"EB",0
4,"4060",445,348,345,5,3,"EB",0
50,"50091",41,36,36,0,0,"EB",0
30,"30013",7396,5147,5102,32,45,"EB",3
26,"26145",246,197,197,2,0,"EB",0
30,"30023",3780,2874,2850,12,24,"EB",1
50,"50040",89,75,75,0,0,"EB",0
50,"50072",170,125,125,0,0,"EB",1
33,"33042",4306,2988,2970,35,18,"EB",15
38,"38035",9474,5616,5564,36,52,"EB",2
50,"50092",299,233,231,0,2,"EB",1
44,"44173",101,81,79,2,2,"EB",0
4,"4057",1325,894,884,5,10,"EB",0
22,"22014",243,192,188,3,4,"EB",0
50,"50048",34,29,29,0,0,"EB",0
26,"26129",967,775,766,6,9,"EB",1
30,"30004",1137,870,862,3,8,"EB",0
44,"44196",131,101,98,2,3,"EB",1
39,"39056",2286,1714,1684,8,30,"EB",2
22,"22089",302,225,223,0,2,"EB",4
44,"44127",68,51,51,0,0,"EB",0
22,"22222",530,384,379,3,5,"EB",3
50,"50083",89,75,75,1,0,"EB",0
44,"44094",113,94,94,0,0,"EB",0
26,"26123",126,108,107,2,1,"EB",0
4,"4082",297,200,200,0,0,"EB",0
22,"22151",93,64,64,1,0,"EB",0
14,"14011",578,464,462,4,2,"EB",0
26,"26031",106,83,83,0,0,"EB",0
22,"22122",64,57,57,2,0,"EB",0
22,"22225",2679,1700,1665,17,35,"EB",9
33,"33004",66857,46390,45960,426,430,"EB",156
22,"22905",281,209,209,1,0,"EB",4
14,"14021",260178,181773,180348,1872,1425,"EB",361
44,"44096",161,138,135,3,3,"EB",0
22,"22045",82,65,64,1,1,"EB",0
22,"22236",253,200,200,0,0,"EB",1
44,"44198",182,147,146,4,1,"EB",1
39,"39038",1452,997,990,8,7,"EB",1
44,"44084",54,41,41,0,0,"EB",0
50,"50182",3399,2364,2335,21,29,"EB",9
50,"50054",58,50,50,0,0,"EB",0
44,"44164",27,23,23,0,0,"EB",0
26,"26065",50,43,42,0,1,"EB",0
33,"33005",1449,936,924,11,12,"EB",5
22,"22081",254,181,181,0,0,"EB",1
14,"14013",16796,11830,11616,129,214,"EB",25
50,"50065",53,43,43,0,0,"EB",0
50,"50013",219,180,180,0,0,"EB",0
26,"26033",170,132,129,1,3,"EB",0
38,"38015",4170,2862,2836,10,26,"EB",3
33,"33026",8530,5397,5337,48,60,"EB",28
26,"26139",54,45,44,0,1,"EB",0
44,"44130",34,24,24,0,0,"EB",0
50,"50292",125,102,102,1,0,"EB",0
39,"39090",756,553,542,0,11,"EB",0
50,"50055",3611,2445,2407,22,38,"EB",15
44,"44222",131,98,98,0,0,"EB",0
50,"50108",48,38,38,0,0,"EB",1
30,"30018",7978,5866,5811,30,55,"EB",4
44,"44099",709,465,462,3,3,"EB",1
44,"44037",453,317,315,0,2,"EB",0
50,"50213",94,75,74,0,1,"EB",0
4,"4902",45437,28936,28699,214,237,"EB",18
26,"26114",79,66,65,1,1,"EB",1
44,"44232",378,284,276,6,8,"EB",0
50,"50077",221,168,167,1,1,"EB",0
50,"50015",96,67,67,0,0,"EB",0
26,"26001",195,161,157,2,4,"EB",0
30,"30019",25857,17544,17374,125,170,"EB",20
26,"26164",59,46,45,2,1,"EB",1
22,"22037",115,86,86,0,0,"EB",2
44,"44212",39,37,37,1,0,"EB",0
44,"44101",58,46,46,2,0,"EB",0
50,"50153",935,713,708,6,5,"EB",2
44,"44145",1020,719,709,9,10,"EB",0
39,"39041",1760,1370,1354,9,16,"EB",4
38,"38017",28437,16239,16075,95,164,"EB",19
4,"4011",2765,2119,2096,21,23,"EB",5
44,"44132",60,54,54,1,0,"EB",0
22,"22142",97,75,74,1,1,"EB",0
4,"4087",182,135,135,0,0,"EB",0
33,"33048",154,95,94,0,1,"EB",0
26,"26059",1125,828,812,5,16,"EB",0
30,"30020",6303,4543,4497,25,46,"EB",1
44,"44156",45,31,31,1,0,"EB",1
39,"39062",1812,1379,1366,5,13,"EB",4
39,"39011",1585,1169,1160,5,9,"EB",2
22,"22039",863,671,667,4,4,"EB",0
44,"44201",495,411,406,0,5,"EB",1
30,"30010",6869,5194,5142,21,52,"EB",7
44,"44236",63,48,47,0,1,"EB",0
50,"50165",1814,1287,1264,26,23,"EB",5
26,"26015",196,158,157,2,1,"EB",0
44,"44025",6009,4087,3997,25,90,"EB",10
38,"38020",15113,9928,9830,59,98,"EB",13
44,"44169",342,252,252,3,0,"EB",0
44,"44029",559,425,424,5,1,"EB",1
39,"39033",568,418,415,2,3,"EB",0
44,"44019",67,50,49,0,1,"EB",0
4,"4078",1078,758,746,8,12,"EB",0
50,"50090",150,113,112,0,1,"EB",0
26,"26005",2381,1598,1577,23,21,"EB",1
50,"50279",86,64,64,0,0,"EB",0
50,"50269",285,193,188,0,5,"EB",0
44,"44063",71,54,54,0,0,"EB",0
44,"44205",700,460,453,4,7,"EB",0
26,"26095",100,83,82,0,1,"EB",0
44,"44249",55,44,44,2,0,"EB",0
26,"26096",245,190,190,1,0,"EB",0
30,"30022",16913,11371,11214,93,157,"EB",17
22,"22205",438,322,320,0,2,"EB",0
44,"44136",49,43,43,1,0,"EB",0
26,"26144",188,155,155,3,0,"EB",0
39,"39004",1518,1090,1074,4,16,"EB",1
22,"22220",166,126,125,2,1,"EB",0
26,"26120",1454,1139,1126,7,13,"EB",1
50,"50167",233,183,178,1,5,"EB",0
4,"4026",66,54,51,0,3,"EB",0
22,"22008",173,137,133,3,4,"EB",1
26,"26109",81,69,69,0,0,"EB",0
22,"22233",82,57,57,3,0,"EB",0
50,"50260",33,33,32,0,1,"EB",0
44,"44042",123,91,90,0,1,"EB",0
44,"44106",155,116,114,5,2,"EB",1
38,"38047",1777,1198,1170,4,28,"EB",0
50,"50241",588,415,410,4,5,"EB",2
39,"39086",358,256,253,0,3,"EB",0
22,"22004",135,81,80,0,1,"EB",0
33,"33052",721,485,482,3,3,"EB",0
26,"26146",94,73,72,0,1,"EB",0
22,"22248",116,92,90,1,2,"EB",0
44,"44150",28,22,21,0,1,"EB",0
50,"50220",40,32,32,0,0,"EB",0
22,"22143",217,143,141,1,2,"EB",1
4,"4102",13694,8944,8865,50,79,"EB",8
22,"22165",487,364,360,6,4,"EB",1
50,"50272",12904,8880,8819,84,61,"EB",60
26,"26041",132,92,91,0,1,"EB",2
22,"22066",702,502,498,7,4,"EB",0
44,"44107",218,152,152,5,0,"EB",1
50,"50231",250,195,192,4,3,"EB",2
33,"33054",1682,1159,1149,12,10,"EB",8
4,"4062",4504,3534,3490,18,44,"EB",4
50,"50252",5138,3642,3611,24,31,"EB",7
39,"39006",1711,1307,1287,10,20,"EB",1
44,"44208",37,22,22,0,0,"EB",0
50,"50105",296,214,211,1,3,"EB",0
38,"38025",6880,4839,4761,30,78,"EB",5
50,"50011",122,95,94,1,1,"EB",1
38,"38014",1357,935,926,3,9,"EB",1
39,"39057",2330,1671,1645,7,26,"EB",0
22,"22110",738,531,527,4,4,"EB",0
38,"38026",32950,24443,24196,129,247,"EB",35
39,"39037",1987,1516,1503,8,13,"EB",2
50,"50903",2214,1602,1585,8,17,"EB",5
39,"39027",3118,2322,2295,26,27,"EB",3
50,"50042",15,15,15,1,0,"EB",0
14,"14068",538,401,398,10,3,"EB",0
22,"22253",61,52,52,0,0,"EB",0
44,"44245",248,179,176,2,3,"EB",0
30,"30036",14698,9859,9734,41,125,"EB",14
39,"39099",3114,2308,2281,12,27,"EB",1
50,"50002",143,108,104,1,4,"EB",0
22,"22239",88,72,72,0,0,"EB",0
26,"26149",57,47,46,0,1,"EB",0
4,"4019",249,196,196,1,0,"EB",1
26,"26162",121,99,99,1,0,"EB",0
39,"39049",322,229,229,0,0,"EB",1
22,"22226",767,570,562,10,8,"EB",4
44,"44243",24,20,20,0,0,"EB",0
33,"33045",4487,3057,2999,28,58,"EB",12
50,"50172",193,132,129,1,3,"EB",1
22,"22046",728,566,561,5,5,"EB",2
39,"39039",568,382,379,0,3,"EB",0
33,"33076",12258,8106,8031,63,75,"EB",33
44,"44110",49,42,42,1,0,"EB",0
26,"26011",7321,5133,5083,38,50,"EB",10
38,"38052",1273,883,875,2,8,"EB",1
22,"22021",1971,1414,1398,17,16,"EB",5
50,"50066",2621,1862,1851,9,11,"EB",9
14,"14041",3182,2296,2251,33,45,"EB",0
4,"4095",714,471,468,5,3,"EB",0
44,"44177",115,84,84,1,0,"EB",0
44,"44004",408,303,297,0,6,"EB",0
44,"44016",482,363,360,2,3,"EB",1
50,"50086",187,132,128,2,4,"EB",1
50,"50245",88,65,64,0,1,"EB",0
50,"50141",109,90,90,1,0,"EB",0
26,"26079",634,520,512,4,8,"EB",0
50,"50005",229,189,189,1,0,"EB",1
50,"50287",270,191,191,0,0,"EB",0
44,"44017",285,227,223,4,4,"EB",0
39,"39102",2277,1615,1598,9,17,"EB",5
50,"50225",1570,956,950,3,6,"EB",6
50,"50246",41,28,28,0,0,"EB",0
39,"39091",1926,1493,1476,10,17,"EB",0
33,"33017",3144,2094,2071,35,23,"EB",7
26,"26072",281,254,254,0,0,"EB",0
50,"50106",134,104,104,0,0,"EB",1
44,"44246",1543,1045,1027,12,18,"EB",3
50,"50132",751,543,536,0,7,"EB",5
22,"22215",128,96,96,1,0,"EB",1
22,"22023",421,313,309,6,4,"EB",0
50,"50078",235,177,173,0,4,"EB",0
26,"26037",128,108,108,2,0,"EB",0
44,"44123",105,71,70,1,1,"EB",0
22,"22217",385,287,281,1,6,"EB",0
50,"50267",602,433,430,8,3,"EB",2
30,"30040",732,617,607,2,10,"EB",1
33,"33018",2901,2000,1976,18,24,"EB",14
30,"30041",13621,8970,8889,46,81,"EB",15
50,"50122",68,52,52,1,0,"EB",0
50,"50144",34,29,29,2,0,"EB",0
33,"33029",350,181,174,2,7,"EB",0
26,"26154",13,10,10,0,0,"EB",0
50,"50228",268,210,208,5,2,"EB",0
22,"22075",125,83,83,1,0,"EB",0
22,"22189",185,145,144,5,1,"EB",0
50,"50217",446,342,342,1,0,"EB",0
30,"30021",9099,6095,6045,20,50,"EB",4
50,"50238",91,66,66,1,0,"EB",0
22,"22041",163,134,134,1,0,"EB",0
22,"22024",226,174,171,3,3,"EB",1
44,"44076",2203,1690,1663,18,27,"EB",2
14,"14008",2839,1905,1895,19,10,"EB",3
4,"4068",187,154,152,0,2,"EB",0
50,"50101",864,603,597,8,6,"EB",2
33,"33051",7061,4640,4587,27,53,"EB",11
4,"4069",4687,3471,3437,27,34,"EB",3
22,"22902",221,159,156,0,3,"EB",1
50,"50198",54,41,41,1,0,"EB",0
39,"39075",137376,99899,99048,718,851,"EB",201
50,"50135",91,70,70,3,0,"EB",0
50,"50298",5333,3949,3902,39,47,"EB",13
38,"38010",4008,2733,2661,19,72,"EB",2
39,"39003",297,220,215,0,5,"EB",0
22,"22124",201,144,143,1,1,"EB",0
22,"22141",117,91,90,1,1,"EB",0
22,"22164",35,28,28,0,0,"EB",0
44,"44217",29,25,25,3,0,"EB",0
44,"44172",301,218,216,4,2,"EB",0
26,"26040",70,60,60,0,0,"EB",0
22,"22117",2478,1714,1693,22,21,"EB",9
30,"30033",10188,7403,7285,68,118,"EB",9
44,"44238",2323,1603,1590,5,13,"EB",6
22,"22119",1291,942,935,5,7,"EB",4
39,"39025",8637,6486,6378,47,108,"EB",4
50,"50010",68,58,58,0,0,"EB",0
44,"44250",19,12,12,0,0,"EB",0
44,"44065",60,40,40,0,0,"EB",0
50,"50901",138,105,105,0,0,"EB",0
39,"39076",3476,2594,2559,19,35,"EB",2
39,"39016",23868,17883,17701,122,182,"EB",38
44,"44266",115,90,90,0,0,"EB",1
38,"38048",3901,2667,2637,20,30,"EB",1
26,"26170",446,330,326,2,4,"EB",1
22,"22054",1542,1091,1077,13,14,"EB",10
4,"4072",313,247,245,2,2,"EB",0
22,"22079",118,83,83,1,0,"EB",1
14,"14020",387,269,264,2,5,"EB",0
50,"50210",38,30,30,1,0,"EB",0
50,"50073",2141,1592,1577,7,15,"EB",6
30,"30902",7975,5318,5273,24,45,"EB",5
33,"33013",446,321,318,3,3,"EB",3
50,"50262",1170,896,887,15,9,"EB",0
14,"14001",3514,2837,2789,28,48,"EB",3
26,"26020",476,349,339,3,10,"EB",0
22,"22167",493,388,381,9,7,"EB",1
4,"4017",1296,857,854,5,3,"EB",0
26,"26064",2275,1659,1638,17,21,"EB",2
50,"50181",993,733,720,5,13,"EB",1
44,"44163",126,94,94,1,0,"EB",0
44,"44118",164,132,131,2,1,"EB",1
14,"14039",2604,2062,2021,12,41,"EB",1
39,"39068",646,450,445,2,5,"EB",0
26,"26009",401,325,321,4,4,"EB",0
50,"50215",24,19,19,0,0,"EB",0
33,"33021",4573,3024,2971,22,53,"EB",5
22,"22048",12598,8790,8731,91,59,"EB",20
50,"50074",6366,4230,4165,31,65,"EB",19
4,"4043",549,465,461,1,4,"EB",0
22,"22250",353,261,258,4,3,"EB",0
44,"44220",121,84,83,1,1,"EB",0
50,"50233",106,81,81,0,0,"EB",0
33,"33015",1540,998,986,8,12,"EB",4
50,"50033",66,49,48,0,1,"EB",0
4,"4009",162,123,122,2,1,"EB",0
50,"50192",236,180,180,2,0,"EB",0
33,"33025",9174,5838,5786,57,52,"EB",29
50,"50202",152,100,99,1,1,"EB",0
26,"26113",35,35,34,0,1,"EB",0
44,"44189",56,41,41,0,0,"EB",0
4,"4901",545,395,394,0,1,"EB",0
50,"50295",48,43,42,0,1,"EB",0
44,"44258",67,47,47,0,0,"EB",1
38,"38004",4456,3026,2983,23,43,"EB",3
26,"26126",31,27,27,0,0,"EB",0
38,"38040",5021,3136,3102,14,34,"EB",2
44,"44178",58,37,37,0,0,"EB",0
39,"39050",270,187,186,0,1,"EB",0
39,"39029",618,488,481,3,7,"EB",0
22,"22252",121,86,81,0,5,"EB",2
26,"26150",112,101,95,0,6,"EB",0
50,"50163",3689,2702,2680,37,22,"EB",18
39,"39070",144,96,94,2,2,"EB",1
44,"44087",80,69,67,1,2,"EB",0
14,"14017",10868,7764,7665,71,99,"EB",7
4,"4079",51383,33777,33586,257,191,"EB",33
39,"39060",6679,5196,5121,29,75,"EB",10
50,"50184",115,85,85,0,0,"EB",0
39,"39040",4292,3208,3166,14,42,"EB",10
22,"22099",483,379,377,4,2,"EB",0
33,"33027",834,506,498,4,8,"EB",2
50,"50057",1395,919,907,11,12,"EB",2
39,"39101",274,197,192,3,5,"EB",0
38,"38030",1933,1296,1290,2,6,"EB",3
44,"44002",47,40,40,0,0,"EB",0
33,"33024",226679,158750,157564,1209,1186,"EB",699
26,"26013",347,249,246,2,3,"EB",1
22,"22174",478,379,378,2,1,"EB",0
26,"26128",105,81,81,1,0,"EB",0
50,"50277",50,42,41,0,1,"EB",0
4,"4097",248,189,189,1,0,"EB",0
50,"50006",925,674,657,6,17,"EB",0
50,"50175",1002,695,688,5,7,"EB",3
50,"50227",109,79,79,0,0,"EB",0
14,"14025",2924,2466,2422,14,44,"EB",1
50,"50026",439,335,325,10,10,"EB",3
50,"50154",116,96,96,0,0,"EB",1
22,"22188",82,60,59,6,1,"EB",0
50,"50216",235,186,184,5,2,"EB",0
44,"44247",316,218,215,3,3,"EB",0
39,"39063",967,697,690,9,7,"EB",1
38,"38031",28687,21132,20858,104,274,"EB",54
44,"44235",92,62,60,0,2,"EB",0
50,"50079",249,175,174,0,1,"EB",0
50,"50176",236,165,165,3,0,"EB",0
22,"22013",288,216,210,3,6,"EB",1
50,"50047",48,36,36,0,0,"EB",0
4,"4048",1503,1090,1085,9,5,"EB",3
50,"50297",498961,362043,359558,2748,2485,"EB",2379
22,"22190",119,86,85,0,1,"EB",0
26,"26038",89,68,67,0,1,"EB",0
14,"14064",320,242,236,2,6,"EB",0
33,"33070",3351,2403,2373,26,30,"EB",11
26,"26130",203,167,167,1,0,"EB",0
14,"14067",3889,2946,2899,29,47,"EB",3
26,"26053",208,168,163,4,5,"EB",1
22,"22015",319,234,228,3,6,"EB",0
22,"22130",10092,6671,6608,59,63,"EB",27
14,"14055",18557,12950,12764,178,186,"EB",12
22,"22105",114,78,77,2,1,"EB",0
50,"50060",172,128,127,1,1,"EB",0
26,"26039",39,35,35,2,0,"EB",0
22,"22116",1430,1004,994,5,10,"EB",4
44,"44182",197,157,157,0,0,"EB",1
39,"39061",3478,2695,2677,13,18,"EB",6
30,"30009",12433,9586,9503,41,83,"EB",7
33,"33074",3484,2298,2274,24,24,"EB",3
22,"22228",514,364,360,5,4,"EB",2
26,"26132",112,82,82,0,0,"EB",0
4,"4005",556,437,431,3,6,"EB",0
26,"26157",296,241,237,4,4,"EB",0
50,"50240",1025,729,718,10,11,"EB",1
26,"26050",113,88,85,0,3,"EB",0
44,"44251",254,198,191,1,7,"EB",0
22,"22178",103,82,81,0,1,"EB",0
50,"50199",334,244,242,3,2,"EB",3
50,"50168",28,27,27,0,0,"EB",0
39,"39005",1380,1053,1046,9,7,"EB",2
44,"44149",103,78,78,3,0,"EB",0
26,"26158",251,214,210,0,4,"EB",0
14,"14028",314,253,249,1,4,"EB",0
14,"14047",1672,1187,1178,14,9,"EB",1
33,"33053",1141,742,732,6,10,"EB",0
38,"38036",6592,4518,4440,45,78,"EB",10
38,"38024",15077,9512,9356,55,156,"EB",8
39,"39067",790,513,505,1,8,"EB",0
50,"50242",93,75,75,3,0,"EB",1
39,"39026",1750,1236,1224,11,12,"EB",1
50,"50031",154,93,93,0,0,"EB",0
26,"26052",154,121,117,0,4,"EB",0
26,"26099",1264,1003,991,9,12,"EB",0
26,"26100",49,44,43,0,1,"EB",0
39,"39077",236,173,171,1,2,"EB",1
22,"22249",116,95,95,4,0,"EB",2
30,"30038",15411,10847,10767,46,80,"EB",11
4,"4004",425,329,329,0,0,"EB",0
26,"26167",59,47,46,1,1,"EB",0
30,"30005",29526,20713,20526,121,187,"EB",26
50,"50190",695,523,515,3,8,"EB",0
39,"39098",1402,1046,1036,8,10,"EB",0
33,"33014",9037,5999,5938,53,61,"EB",17
4,"4052",12274,8372,8306,93,66,"EB",16
50,"50243",331,250,246,0,4,"EB",1
30,"30016",151668,102093,101363,484,730,"EB",204
50,"50249",302,226,220,0,6,"EB",0
50,"50035",72,54,53,1,1,"EB",0
22,"22022",552,414,408,6,6,"EB",3
38,"38901",1405,900,887,3,13,"EB",1
44,"44005",50,30,30,0,0,"EB",0
22,"22199",7000,4737,4688,104,49,"EB",10
50,"50150",649,402,397,2,5,"EB",4
33,"33065",1102,722,713,7,9,"EB",2
4,"4083",1776,1345,1336,6,9,"EB",0
39,"39079",8874,6547,6478,47,69,"EB",5
22,"22049",78,64,64,0,0,"EB",0
38,"38027",5414,3618,3571,16,47,"EB",5
44,"44085",52,35,35,0,0,"EB",0
4,"4064",2771,2001,1988,13,13,"EB",1
50,"50107",947,738,733,4,5,"EB",5
30,"30037",18793,13150,13003,47,147,"EB",17
39,"39019",2079,1560,1531,10,29,"EB",1
4,"4020",288,201,197,0,4,"EB",0
22,"22908",197,142,140,3,2,"EB",1
26,"26174",146,107,105,2,2,"EB",1
22,"22069",429,333,331,2,2,"EB",0
50,"50151",636,499,499,0,0,"EB",0
22,"22126",88,64,64,0,0,"EB",0
33,"33036",11542,8062,7987,60,75,"EB",82
33,"33047",1107,852,843,9,9,"EB",0
50,"50130",383,240,238,2,2,"EB",0
22,"22201",266,188,187,3,1,"EB",0
26,"26155",160,132,132,0,0,"EB",0
33,"33077",1192,811,808,5,3,"EB",1
50,"50123",449,334,331,1,3,"EB",1
22,"22246",76,50,50,0,0,"EB",0
44,"44051",2683,1977,1946,17,31,"EB",4
4,"4010",576,444,443,3,1,"EB",0
26,"26143",220,175,173,1,2,"EB",0
44,"44234",61,51,51,1,0,"EB",0
26,"26152",33,28,28,1,0,"EB",0
44,"44060",41,32,32,0,0,"EB",0
22,"22243",45,28,28,0,0,"EB",0
26,"26176",53,44,44,1,0,"EB",0
44,"44067",114,81,81,1,0,"EB",0
26,"26042",834,635,625,5,10,"EB",0
4,"4021",185,151,148,1,3,"EB",1
26,"26147",30,28,27,0,1,"EB",0
4,"4092",2838,2127,2103,10,24,"EB",1
22,"22206",193,129,128,1,1,"EB",2
50,"50164",390,247,246,6,1,"EB",2
44,"44137",193,149,148,0,1,"EB",0
26,"26093",53,39,38,0,1,"EB",0
22,"22254",1124,801,792,11,9,"EB",1
50,"50081",511,382,378,4,4,"EB",1
4,"4034",160,99,99,2,0,"EB",0
38,"38043",18892,13089,12928,87,161,"EB",25
26,"26025",87,71,70,1,1,"EB",0
26,"26069",236,194,189,0,5,"EB",0
50,"50069",73,53,53,1,0,"EB",1
26,"26048",22,22,22,0,0,"EB",0
22,"22244",52,38,37,0,1,"EB",0
4,"4061",638,506,498,4,8,"EB",0
39,"39083",1135,679,670,8,9,"EB",0
26,"26070",183,153,153,1,0,"EB",0
39,"39002",3298,2342,2309,13,33,"EB",5
50,"50278",197,145,145,0,0,"EB",0
44,"44102",30,27,26,0,1,"EB",0
4,"4067",570,441,436,2,5,"EB",1
50,"50113",618,489,484,2,5,"EB",1
22,"22218",43,33,33,0,0,"EB",0
26,"26060",84,62,62,2,0,"EB",0
22,"22235",98,76,76,1,0,"EB",0
26,"26049",172,125,122,1,3,"EB",0
39,"39036",969,743,739,2,4,"EB",2
14,"14035",5966,4236,4177,39,59,"EB",2
22,"22115",360,257,256,3,1,"EB",0
39,"39064",1345,1031,1015,7,16,"EB",0
26,"26160",709,552,549,2,3,"EB",3
26,"26016",28,25,24,1,1,"EB",0
39,"39034",286,188,185,5,3,"EB",0
50,"50156",215,181,178,2,3,"EB",0
50,"50102",859,658,653,8,5,"EB",2
44,"44105",82,64,64,0,0,"EB",1
44,"44038",104,83,82,0,1,"EB",0
50,"50087",26,17,17,1,0,"EB",0
44,"44034",139,109,108,0,1,"EB",0
26,"26068",80,61,61,1,0,"EB",0
22,"22078",438,319,316,3,3,"EB",4
26,"26035",17,12,11,0,1,"EB",0
33,"33011",11260,6250,6163,83,87,"EB",15
22,"22068",79,60,60,0,0,"EB",0
50,"50250",52,44,44,0,0,"EB",0
50,"50157",290,220,218,3,2,"EB",0
50,"50036",104,91,90,0,1,"EB",0
26,"26084",6696,5012,4955,35,57,"EB",4
33,"33031",35120,22295,22024,271,271,"EB",86
39,"39045",367,271,268,1,3,"EB",0
44,"44183",77,50,49,0,1,"EB",0
44,"44239",22,20,20,0,0,"EB",0
22,"22106",22,14,14,0,0,"EB",0
39,"39013",511,402,399,4,3,"EB",0
22,"22125",38773,27021,26732,258,289,"EB",146
26,"26008",1860,1399,1387,5,12,"EB",0
39,"39087",41985,31178,30805,228,373,"EB",50
50,"50169",351,269,265,0,4,"EB",4
44,"44184",45,34,34,0,0,"EB",0
14,"14057",6136,4713,4631,47,82,"EB",5
26,"26110",152,131,129,0,2,"EB",1
39,"39046",1404,1001,973,6,28,"EB",2
33,"33063",415,320,318,3,2,"EB",0
4,"4007",734,524,522,1,2,"EB",0
22,"22050",88,77,77,0,0,"EB",0
14,"14038",32322,22117,21887,179,230,"EB",23
22,"22090",99,71,71,0,0,"EB",0
39,"39053",219,153,152,2,1,"EB",0
33,"33049",6322,4116,4062,43,54,"EB",6
26,"26119",197,156,155,4,1,"EB",1
30,"30032",2856,2163,2144,6,19,"EB",0
50,"50177",308,245,244,4,1,"EB",1
44,"44197",56,36,36,0,0,"EB",0
44,"44055",69,56,56,4,0,"EB",0
44,"44142",35,27,27,0,0,"EB",0
50,"50253",423,330,328,4,2,"EB",0
38,"38034",4049,2855,2807,19,48,"EB",3
26,"26071",8491,5834,5761,47,73,"EB",16
50,"50028",78,51,51,0,0,"EB",1
22,"22035",234,165,159,3,6,"EB",0
44,"44028",183,151,150,4,1,"EB",0
44,"44143",380,307,306,2,1,"EB",0
30,"30043",24967,18981,18685,101,296,"EB",22
50,"50095",12323,8628,8550,110,78,"EB",28
22,"22200",244,184,182,5,2,"EB",0
50,"50071",132,92,92,0,0,"EB",0
44,"44049",849,616,604,9,12,"EB",0
33,"33075",271,154,153,2,1,"EB",1
14,"14059",690,533,528,4,5,"EB",0
39,"39048",1716,1329,1312,12,17,"EB",4
4,"4094",207,144,144,0,0,"EB",0
50,"50017",1773,1276,1269,13,7,"EB",8
50,"50197",90,67,67,2,0,"EB",0
26,"26019",355,274,271,1,3,"EB",0
44,"44138",135,98,94,0,4,"EB",1
39,"39059",7986,5879,5806,45,73,"EB",11
22,"22009",617,444,441,6,3,"EB",2
39,"39100",860,633,629,15,4,"EB",0
26,"26078",82,70,70,0,0,"EB",0
44,"44199",44,41,41,2,0,"EB",1
50,"50255",209,163,163,5,0,"EB",1
50,"50193",651,514,501,2,13,"EB",1
44,"44154",256,192,188,3,4,"EB",0
50,"50261",213,157,157,0,0,"EB",0
22,"22067",65,50,50,1,0,"EB",2
26,"26175",51,41,41,0,0,"EB",0
50,"50121",277,216,214,1,2,"EB",2
50,"50189",705,527,519,13,8,"EB",1
44,"44204",24,21,21,0,0,"EB",0
44,"44158",1180,876,862,10,14,"EB",1
4,"4014",144,117,114,1,3,"EB",0
22,"22059",1149,807,800,3,7,"EB",9
44,"44191",764,586,583,6,3,"EB",0
44,"44112",429,290,290,2,0,"EB",3
44,"44155",1090,793,782,4,11,"EB",6
44,"44185",99,76,75,0,1,"EB",0
44,"44035",113,90,88,1,2,"EB",0
30,"30030",312993,231648,230185,1207,1463,"EB",363
14,"14056",23581,16120,15958,143,162,"EB",7
14,"14010",4027,2850,2807,19,43,"EB",1
44,"44117",340,271,268,4,3,"EB",0
26,"26086",16,15,15,1,0,"EB",0
50,"50137",1011,772,764,8,8,"EB",1
44,"44126",329,234,229,4,5,"EB",1
50,"50058",66,39,39,0,0,"EB",0
26,"26010",93,80,80,2,0,"EB",0
44,"44206",114,90,87,0,3,"EB",0
14,"14044",1604,1172,1165,7,7,"EB",1
38,"38019",13200,8123,8047,36,76,"EB",9
33,"33008",1777,1238,1229,3,9,"EB",2
44,"44244",75,47,47,1,0,"EB",0
22,"22208",188,150,145,0,5,"EB",2
4,"4031",2338,1772,1762,2,10,"EB",0
39,"39066",872,667,661,4,6,"EB",1
22,"22028",371,282,280,3,2,"EB",0
30,"30011",4697,3421,3383,15,38,"EB",10
14,"14072",1048,806,795,6,11,"EB",0
26,"26094",83,70,70,0,0,"EB",1
4,"4003",17357,11157,11075,64,82,"EB",5
39,"39042",5915,4530,4474,21,56,"EB",10
26,"26166",141,124,122,0,2,"EB",0
50,"50027",225,178,177,2,1,"EB",1
26,"26026",1321,1039,1025,6,14,"EB",0
4,"4065",363,284,282,7,2,"EB",0
50,"50276",125,104,103,2,1,"EB",1
44,"44157",64,48,48,1,0,"EB",0
26,"26081",16,14,14,0,0,"EB",0
33,"33002",9995,6765,6672,47,93,"EB",28
44,"44014",2521,1896,1867,8,29,"EB",15
14,"14036",3740,2747,2696,24,51,"EB",0
22,"22103",682,508,502,3,6,"EB",0
50,"50207",106,93,93,1,0,"EB",0
39,"39023",6330,4737,4672,25,65,"EB",14
33,"33071",595,433,430,10,3,"EB",2
38,"38021",1629,1033,1022,9,11,"EB",0
22,"22113",495,370,368,4,2,"EB",2
39,"39054",4493,3376,3334,33,42,"EB",5
14,"14031",593,469,459,3,10,"EB",0
39,"39092",894,626,620,1,6,"EB",1
26,"26141",113,87,82,0,5,"EB",0
33,"33038",2303,1584,1559,13,25,"EB",15
30,"30034",1129,858,844,7,14,"EB",0
50,"50203",1040,748,739,7,9,"EB",6
44,"44080",292,229,223,3,6,"EB",1
26,"26169",64,60,60,0,0,"EB",0
14,"14018",3709,2697,2653,26,44,"EB",2
44,"44061",70,54,51,0,3,"EB",0
44,"44264",248,191,189,1,2,"EB",2
39,"39055",1086,824,816,6,8,"EB",1
4,"4071",394,338,337,3,1,"EB",0
50,"50133",113,80,80,4,0,"EB",0
50,"50021",30,21,21,0,0,"EB",0
50,"50116",182,136,132,0,4,"EB",0
22,"22150",472,331,330,1,1,"EB",4
50,"50020",809,564,559,2,5,"EB",3
22,"22043",93,66,65,0,1,"EB",0
44,"44075",323,248,246,0,2,"EB",2
26,"26063",124,94,94,2,0,"EB",0
38,"38049",2655,1654,1627,8,27,"EB",1
44,"44010",175,130,128,1,2,"EB",0
4,"4038",3084,2140,2126,16,14,"EB",0
50,"50159",665,512,507,2,5,"EB",0
26,"26179",41,32,31,0,1,"EB",0
4,"4029",8859,5834,5790,35,44,"EB",5
50,"50120",52,40,40,1,0,"EB",0
33,"33058",1796,1232,1209,11,23,"EB",6
44,"44109",108,73,73,0,0,"EB",0
4,"4093",1882,1216,1204,11,12,"EB",3
4,"4006",7022,4792,4749,30,43,"EB",6
44,"44043",102,74,72,0,2,"EB",0
22,"22040",144,117,115,1,2,"EB",0
22,"22025",1071,676,669,18,7,"EB",4
4,"4089",742,521,518,1,3,"EB",0
44,"44175",122,85,84,1,1,"EB",1
22,"22155",76,51,51,0,0,"EB",0
50,"50247",823,588,581,3,7,"EB",6
26,"26003",413,331,329,2,2,"EB",0
22,"22193",276,225,224,2,1,"EB",1
4,"4027",250,159,159,0,0,"EB",1
44,"44144",346,248,245,2,3,"EB",0
30,"30901",10309,7821,7718,43,103,"EB",11
33,"33069",3491,2430,2390,17,40,"EB",12
44,"44160",466,304,301,2,3,"EB",1
26,"26089",110582,82972,82186,588,786,"EB",171
44,"44268",25,25,24,0,1,"EB",0
22,"22170",651,498,491,5,7,"EB",1
50,"50147",777,552,552,2,0,"EB",4
50,"50088",302,246,237,5,9,"EB",0
44,"44070",53,48,48,0,0,"EB",0
26,"26118",59,48,48,2,0,"EB",0
44,"44022",493,323,318,7,5,"EB",0
4,"4035",8364,5810,5766,28,44,"EB",8
14,"14053",6006,4285,4232,49,53,"EB",4
22,"22084",535,403,399,4,4,"EB",1
26,"26122",118,102,102,0,0,"EB",0
22,"22053",789,520,513,9,7,"EB",3
44,"44221",372,303,300,1,3,"EB",0
22,"22082",291,213,212,1,1,"EB",0
44,"44147",412,298,293,5,5,"EB",0
26,"26163",136,118,118,0,0,"EB",0
22,"22186",181,130,129,1,1,"EB",0
50,"50142",26,17,17,0,0,"EB",0
44,"44054",108,85,85,2,0,"EB",0
44,"44167",38,31,31,0,0,"EB",0
14,"14043",7574,5515,5443,81,72,"EB",2
50,"50140",166,115,115,0,0,"EB",0
39,"39043",1481,1122,1115,9,7,"EB",3
50,"50126",2371,1573,1559,19,14,"EB",7
50,"50041",12,9,9,0,0,"EB",0
22,"22107",112,74,74,0,0,"EB",0
4,"4050",800,558,553,3,5,"EB",1
50,"50219",4119,2833,2804,19,29,"EB",26
50,"50008",5097,3457,3417,31,40,"EB",10
22,"22909",315,226,225,4,1,"EB",2
22,"22195",235,182,181,3,1,"EB",0
33,"33062",400,238,233,2,5,"EB",4
4,"4076",1279,960,944,8,16,"EB",1
50,"50244",201,162,161,1,1,"EB",0
50,"50166",255,208,206,2,2,"EB",1
4,"4080",209,162,162,3,0,"EB",0
33,"33032",11395,7592,7465,90,127,"EB",36
50,"50030",215,141,140,1,1,"EB",0
44,"44116",83,60,60,1,0,"EB",0
4,"4091",334,268,267,6,1,"EB",0
39,"39093",299,229,226,4,3,"EB",1
22,"22061",6630,4555,4526,40,29,"EB",20
50,"50029",626,450,450,3,0,"EB",4
50,"50134",128,91,89,2,2,"EB",0
44,"44007",173,122,121,4,1,"EB",1
50,"50180",119,99,99,2,0,"EB",0
22,"22232",93,71,69,1,2,"EB",0
39,"39065",252,191,189,1,2,"EB",0
22,"22017",866,650,642,5,8,"EB",2
22,"22047",243,205,203,2,2,"EB",0
38,"38033",3702,2505,2464,8,41,"EB",4
38,"38044",2188,1348,1334,6,14,"EB",1
50,"50282",69,54,54,0,0,"EB",0
22,"22095",72,58,58,1,0,"EB",0
26,"26075",329,267,264,2,3,"EB",1
4,"4023",138,96,95,2,1,"EB",1
44,"44237",398,304,301,4,3,"EB",1
26,"26107",94,77,77,2,0,"EB",0
50,"50082",82,65,64,0,1,"EB",0
26,"26098",88,73,73,1,0,"EB",0
44,"44215",159,109,109,2,0,"EB",0
22,"22229",114,80,80,1,0,"EB",0
33,"33022",893,578,567,11,11,"EB",1
22,"22234",794,552,544,3,8,"EB",2
50,"50289",51,38,38,0,0,"EB",0
44,"44011",52,40,38,0,2,"EB",0
38,"38006",39766,20776,20587,139,189,"EB",28
26,"26007",511,384,375,0,9,"EB",0
50,"50285",644,436,434,2,2,"EB",2
50,"50062",1829,1304,1290,16,14,"EB",4
33,"33073",8554,4945,4884,41,61,"EB",19
14,"14009",2788,1852,1834,20,18,"EB",0
44,"44207",156,118,115,4,3,"EB",0
4,"4058",354,261,259,1,2,"EB",0
22,"22245",309,267,261,1,6,"EB",0
38,"38012",2347,1644,1630,7,14,"EB",2
38,"38028",22103,15036,14844,85,192,"EB",16
4,"4037",1314,969,955,6,14,"EB",1
4,"4049",5313,3620,3579,18,41,"EB",11
33,"33019",3072,2020,2005,18,15,"EB",10
22,"22051",100,81,81,0,0,"EB",0
33,"33060",14633,9647,9474,72,173,"EB",36
44,"44114",243,178,173,0,5,"EB",3
4,"4074",2840,2000,1979,23,21,"EB",0
44,"44062",34,25,22,0,3,"EB",0
4,"4099",4989,3636,3588,27,48,"EB",3
4,"4013",141378,94872,94288,741,584,"EB",102
50,"50093",92,66,66,1,0,"EB",0
50,"50281",73,51,50,0,1,"EB",0
14,"14040",3776,2873,2833,32,40,"EB",6
44,"44224",22,14,14,0,0,"EB",0
4,"4084",341,249,247,2,2,"EB",0
33,"33040",4549,2986,2942,35,44,"EB",11
33,"33020",13307,9011,8914,99,97,"EB",41
44,"44089",45,39,39,1,0,"EB",0
44,"44181",76,57,56,0,1,"EB",0
44,"44003",19,17,17,0,0,"EB",0
33,"33012",5201,3466,3432,25,34,"EB",9
39,"39015",839,647,642,4,5,"EB",0
50,"50291",96,74,74,0,0,"EB",0
22,"22133",115,81,80,1,1,"EB",0
30,"30014",1567,1174,1160,8,14,"EB",0
14,"14007",15207,10558,10417,82,141,"EB",9
39,"39018",4220,3264,3204,35,60,"EB",4
50,"50251",8262,5946,5872,44,74,"EB",15
50,"50234",243,189,185,6,4,"EB",2
44,"44218",35,28,28,1,0,"EB",0
50,"50136",575,414,410,2,4,"EB",0
50,"50104",348,271,269,2,2,"EB",0
36,"36036",2518,1827,1801,18,26,"EB",4
36,"36029",16077,11617,11471,100,146,"EB",9
36,"36044",2541,1674,1646,7,28,"EB",1
36,"36032",3630,2587,2535,16,52,"EB",1
36,"36010",2847,2102,2076,13,26,"EB",3
36,"36013",2344,1536,1514,11,22,"EB",1
36,"36051",14267,9638,9493,71,145,"EB",12
36,"36023",8395,5965,5884,41,81,"EB",7
36,"36027",4430,3137,3101,15,36,"EB",4
36,"36022",9011,6310,6172,49,138,"EB",5
36,"36031",558,465,459,7,6,"EB",2
36,"36019",1625,1042,1029,9,13,"EB",4
36,"36054",10993,7476,7363,67,113,"EB",5
36,"36033",12298,8968,8788,53,180,"EB",14
36,"36005",8121,5480,5400,52,80,"EB",8
36,"36012",3732,2751,2717,9,34,"EB",4
36,"36009",4503,3056,3001,15,55,"EB",2
36,"36008",21762,15447,15262,128,185,"EB",25
36,"36017",17782,12411,12240,117,171,"EB",24
36,"36045",24529,17613,17336,129,277,"EB",26
36,"36057",236673,169244,167605,1366,1639,"EB",253
36,"36011",1799,1144,1122,8,22,"EB",1
36,"36015",4153,2721,2677,23,44,"EB",7
36,"36049",6804,4960,4860,36,100,"EB",9
36,"36060",30323,21399,21162,164,237,"EB",23
36,"36026",20137,13779,13596,141,183,"EB",21
36,"36042",17891,12212,12003,93,209,"EB",24
36,"36025",2257,1360,1350,10,10,"EB",5
36,"36043",4747,3210,3162,20,48,"EB",6
36,"36016",1143,721,711,3,10,"EB",0
36,"36020",2318,1646,1620,18,26,"EB",0
36,"36040",2575,1709,1680,15,29,"EB",2
36,"36021",12073,8447,8342,89,105,"EB",7
36,"36055",13620,9580,9400,62,180,"EB",21
36,"36028",4102,2913,2868,17,45,"EB",6
36,"36004",10161,6939,6844,63,95,"EB",10
36,"36059",4882,3137,3085,28,52,"EB",3
36,"36041",13434,9297,9181,66,116,"EB",13
36,"36053",5684,4099,4050,38,49,"EB",4
36,"36006",11520,8529,8396,63,133,"EB",9
36,"36024",16455,11971,11781,109,190,"EB",14
36,"36046",4036,2971,2921,15,50,"EB",9
36,"36047",2454,1633,1621,13,12,"EB",3
36,"36050",7561,5280,5188,25,92,"EB",9
36,"36039",15401,10871,10609,71,262,"EB",14
36,"36058",4994,3292,3243,33,49,"EB",4
36,"36048",5331,3653,3603,22,50,"EB",5
36,"36037",2571,1733,1707,11,26,"EB",5
36,"36018",3240,2198,2170,10,28,"EB",3
36,"36034",3475,2403,2367,11,36,"EB",4
36,"36002",3147,2193,2169,20,24,"EB",2
36,"36035",14433,10333,10188,79,145,"EB",14
36,"36061",8606,6232,6133,41,99,"EB",9
36,"36007",1672,1119,1099,8,20,"EB",0
36,"36003",9980,7191,7110,67,81,"EB",6
36,"36014",1942,1459,1444,9,15,"EB",2
36,"36052",7292,4999,4907,45,92,"EB",7
36,"36038",66390,47750,47273,449,477,"EB",70
36,"36056",5076,3584,3515,30,69,"EB",5
36,"36001",2564,1858,1848,5,10,"EB",0
36,"36030",4175,2832,2785,27,47,"EB",2
36,"36901",4103,3153,3102,19,51,"EB",4
48,"48053",895,666,662,6,4,"EB-AZ",0
48,"48905",2553,1792,1771,12,21,"EB-AZ",1
48,"48059",400,294,291,0,3,"EB-AZ",0
48,"48070",544,362,362,4,0,"EB-AZ",0
48,"48019",3553,2406,2397,18,9,"EB-AZ",4
48,"48033",217,149,149,0,0,"EB-AZ",0
48,"48038",1126,798,794,3,4,"EB-AZ",0
48,"48054",24171,16797,16711,118,86,"EB-AZ",32
48,"48023",600,455,452,0,3,"EB-AZ",0
48,"48007",364,240,240,5,0,"EB-AZ",0
48,"48052",1562,1160,1150,4,10,"EB-AZ",4
48,"48067",1158,813,810,2,3,"EB-AZ",0
48,"48080",9976,6820,6763,62,57,"EB-AZ",2
48,"48005",115,63,61,0,2,"EB-AZ",0
48,"48069",12798,8679,8612,55,67,"EB-AZ",11
48,"48002",7829,5490,5451,44,39,"EB-AZ",4
48,"48027",22150,15089,14982,78,107,"EB-AZ",27
48,"48026",1140,830,823,5,7,"EB-AZ",0
48,"48056",966,705,700,5,5,"EB-AZ",0
48,"48020",273626,184710,183628,1185,1082,"EB-AZ",402
48,"48039",239,190,188,0,2,"EB-AZ",2
48,"48087",427,344,338,0,6,"EB-AZ",1
48,"48064",606,447,445,4,2,"EB-AZ",0
48,"48031",332,233,231,1,2,"EB-AZ",0
48,"48092",836,618,613,5,5,"EB-AZ",1
48,"48030",606,441,439,1,2,"EB-AZ",0
48,"48072",977,716,713,4,3,"EB-AZ",0
48,"48091",1121,771,765,7,6,"EB-AZ",0
48,"48904",3511,2625,2600,22,25,"EB-AZ",3
48,"48001",5838,3923,3898,28,25,"EB-AZ",2
48,"48028",717,543,537,3,6,"EB-AZ",2
48,"48060",3634,2143,2134,7,9,"EB-AZ",3
48,"48913",1248,884,869,10,15,"EB-AZ",0
48,"48915",362,227,226,0,1,"EB-AZ",0
48,"48037",673,481,478,5,3,"EB-AZ",1
48,"48090",6001,4345,4295,28,50,"EB-AZ",5
48,"48049",549,416,416,1,0,"EB-AZ",0
48,"48008",606,424,414,6,10,"EB-AZ",1
48,"48082",37605,25134,24938,176,196,"EB-AZ",30
48,"48073",6910,4306,4271,31,35,"EB-AZ",5
48,"48096",6577,4794,4728,31,66,"EB-AZ",6
48,"48055",2668,1872,1849,11,23,"EB-AZ",5
48,"48032",5743,4065,4048,29,17,"EB-AZ",8
48,"48022",2336,1444,1433,6,11,"EB-AZ",1
48,"48012",2049,1527,1512,7,15,"EB-AZ",2
48,"48907",348,266,266,2,0,"EB-AZ",0
48,"48093",893,653,643,7,10,"EB-AZ",1
48,"48062",302,237,236,4,1,"EB-AZ",1
48,"48040",1281,877,869,3,8,"EB-AZ",0
48,"48914",332,272,272,1,0,"EB-AZ",0
48,"48050",191,147,146,0,1,"EB-AZ",0
48,"48081",1868,1361,1350,4,11,"EB-AZ",0
48,"48074",3312,2330,2309,6,21,"EB-AZ",2
48,"48903",1835,1361,1351,7,10,"EB-AZ",0
48,"48029",8338,5721,5683,37,38,"EB-AZ",16
48,"48013",79716,53419,52997,345,422,"EB-AZ",75
48,"48024",995,757,754,7,3,"EB-AZ",4
48,"48051",213,163,163,0,0,"EB-AZ",0
48,"48041",693,533,529,3,4,"EB-AZ",1
48,"48004",335,222,222,0,0,"EB-AZ",0
48,"48010",458,318,317,0,1,"EB-AZ",0
48,"48071",6087,4294,4254,32,40,"EB-AZ",1
48,"48044",62774,45594,45399,287,195,"EB-AZ",81
48,"48061",762,565,561,0,4,"EB-AZ",1
48,"48065",3281,2271,2237,8,34,"EB-AZ",3
48,"48085",10338,7190,7153,39,37,"EB-AZ",17
48,"48095",2347,1555,1546,12,9,"EB-AZ",2
48,"48084",22449,14670,14553,90,117,"EB-AZ",29
48,"48025",883,642,637,7,5,"EB-AZ",1
48,"48909",209,161,161,0,0,"EB-AZ",0
48,"48042",1369,1068,1053,7,15,"EB-AZ",1
48,"48018",869,522,522,2,0,"EB-AZ",2
48,"48902",19008,12566,12447,76,119,"EB-AZ",23
48,"48075",1996,1364,1359,6,5,"EB-AZ",1
48,"48045",5167,3809,3757,28,52,"EB-AZ",3
48,"48015",33581,22727,22528,122,199,"EB-AZ",26
48,"48086",2050,1414,1401,5,13,"EB-AZ",1
48,"48906",766,547,544,0,3,"EB-AZ",1
48,"48083",6958,4885,4856,40,29,"EB-AZ",7
48,"48046",12611,8836,8794,39,42,"EB-AZ",6
48,"48021",1336,908,899,1,9,"EB-AZ",0
48,"48066",348,258,258,1,0,"EB-AZ",1
48,"48910",2909,1950,1937,10,13,"EB-AZ",2
48,"48076",308,218,217,2,1,"EB-AZ",0
48,"48036",24073,16076,15971,86,105,"EB-AZ",13
48,"48016",5271,3694,3674,24,20,"EB-AZ",5
48,"48009",783,586,575,1,11,"EB-AZ",0
48,"48094",3161,2094,2073,12,21,"EB-AZ",2
48,"48063",372,279,277,2,2,"EB-AZ",0
48,"48003",14339,9918,9838,53,80,"EB-AZ",15
48,"48043",4423,3118,3108,17,10,"EB-AZ",10
48,"48006",290,239,239,2,0,"EB-AZ",0
48,"48911",380,276,272,1,4,"EB-AZ",0
48,"48097",1297,900,894,8,6,"EB-AZ",0
48,"48901",4839,3459,3426,32,33,"EB-AZ",9
48,"48077",3364,2437,2431,18,6,"EB-AZ",2
48,"48047",159,111,111,0,0,"EB-AZ",0
48,"48017",13261,8543,8482,42,61,"EB-AZ",3
48,"48057",5723,3988,3962,26,26,"EB-AZ",1
48,"48088",136,102,102,0,0,"EB-AZ",0
48,"48014",1211,806,801,7,5,"EB-AZ",1
48,"48908",249,181,181,0,0,"EB-AZ",0
48,"48078",38617,26366,26212,158,154,"EB-AZ",43
48,"48034",12866,8798,8747,43,51,"EB-AZ",16
48,"48912",2308,1707,1679,14,28,"EB-AZ",5
48,"48011",9673,6468,6423,45,45,"EB-AZ",14
48,"48048",557,395,393,5,2,"EB-AZ",0
48,"48058",968,647,646,2,1,"EB-AZ",2
48,"48068",1550,1130,1118,12,12,"EB-AZ",3
48,"48089",3306,2341,2329,20,12,"EB-AZ",3
48,"48035",413,293,292,1,1,"EB-AZ",0
48,"48079",427,305,304,2,1,"EB-AZ",1
8,"8046",13290,9054,9000,103,54,"ECP",2209
8,"8118",17547,12183,12108,105,75,"ECP",3085
8,"8224",820,557,551,2,6,"ECP",150
8,"8007",6483,4281,4250,33,31,"ECP",777
8,"8157",8382,5823,5789,45,34,"ECP",1693
43,"43051",8512,5418,5366,32,52,"ECP",1617
43,"43021",357,232,231,6,1,"ECP",39
17,"17102",571,400,400,6,0,"ECP",47
17,"17089",5543,3349,3326,22,23,"ECP",583
17,"17050",652,453,453,3,0,"ECP",43
43,"43069",182,136,134,1,2,"ECP",24
17,"17191",141,92,89,1,3,"ECP",7
43,"43071",921,613,607,6,6,"ECP",94
25,"25051",1527,931,920,11,11,"ECP",128
43,"43160",1276,837,826,8,11,"ECP",181
8,"8082",1139,711,708,4,3,"ECP",208
8,"8095",73,48,47,0,1,"ECP",8
25,"25175",186,117,117,1,0,"ECP",23
8,"8090",128,101,101,2,0,"ECP",7
25,"25170",266,169,167,1,2,"ECP",25
43,"43028",2688,1659,1639,6,20,"ECP",500
43,"43042",2129,1439,1437,12,2,"ECP",220
8,"8059",347,195,195,2,0,"ECP",37
43,"43025",600,408,404,2,4,"ECP",74
17,"17220",796,538,536,5,2,"ECP",49
25,"25128",136,75,75,0,0,"ECP",15
8,"8101",174621,113632,112942,847,690,"ECP",32825
25,"25012",2334,1322,1310,8,12,"ECP",297
17,"17081",246,163,162,2,1,"ECP",25
8,"8006",11470,7210,7132,60,78,"ECP",1418
8,"8242",219,153,153,4,0,"ECP",24
8,"8081",339,222,221,3,1,"ECP",30
17,"17168",380,260,258,0,2,"ECP",29
25,"25191",334,205,204,4,1,"ECP",22
17,"17206",146,88,86,1,2,"ECP",12
25,"25002",482,316,314,2,2,"ECP",45
17,"17217",354,265,263,2,2,"ECP",35
25,"25165",285,179,176,2,3,"ECP",15
25,"25904",148,112,111,2,1,"ECP",15
8,"8241",73,52,52,0,0,"ECP",8
8,"8128",563,375,372,2,3,"ECP",59
43,"43013",4411,2750,2739,19,11,"ECP",615
8,"8150",255,186,186,1,0,"ECP",25
8,"8117",2450,1602,1594,11,8,"ECP",235
17,"17140",670,478,473,5,5,"ECP",53
25,"25100",211,125,124,1,1,"ECP",18
17,"17172",454,300,297,0,3,"ECP",69
17,"17155",14515,8393,8330,65,63,"ECP",1600
8,"8109",216,162,161,0,1,"ECP",28
43,"43102",480,332,324,3,8,"ECP",44
43,"43170",868,566,562,5,4,"ECP",112
8,"8005",6205,4187,4167,22,20,"ECP",818
25,"25133",706,432,427,8,5,"ECP",51
25,"25035",398,249,247,2,2,"ECP",52
17,"17088",533,368,366,4,2,"ECP",53
43,"43034",477,350,342,9,8,"ECP",45
17,"17055",150,110,109,0,1,"ECP",15
17,"17020",3592,2333,2315,20,18,"ECP",355
25,"25029",1655,1042,1029,15,13,"ECP",144
8,"8153",538,386,385,2,1,"ECP",72
8,"8106",7279,4871,4845,40,26,"ECP",1119
17,"17005",413,257,252,3,5,"ECP",44
8,"8030",5122,3482,3466,21,16,"ECP",502
8,"8243",162,113,113,7,0,"ECP",3
25,"25250",345,210,204,0,6,"ECP",29
17,"17079",64395,41049,40699,342,350,"ECP",6949
25,"25053",1055,671,661,7,10,"ECP",99
8,"8114",18292,12102,12009,72,93,"ECP",3549
17,"17228",288,179,176,1,3,"ECP",30
43,"43125",933,680,677,14,3,"ECP",192
43,"43130",195,127,127,1,0,"ECP",9
25,"25069",451,247,246,4,1,"ECP",35
25,"25156",783,543,537,7,6,"ECP",95
17,"17193",4216,2555,2525,16,30,"ECP",572
17,"17903",897,568,563,2,5,"ECP",73
25,"25023",4531,2782,2763,30,19,"ECP",452
17,"17039",1759,1159,1145,14,14,"ECP",135
8,"8245",78562,50821,50538,384,283,"ECP",15673
43,"43164",301,205,204,2,1,"ECP",58
43,"43146",39,29,28,0,1,"ECP",2
43,"43023",231,170,169,0,1,"ECP",34
8,"8027",687,486,485,2,1,"ECP",69
8,"8064",1847,1245,1230,9,15,"ECP",231
8,"8073",61814,42275,42025,294,250,"ECP",13465
25,"25064",108,68,68,2,0,"ECP",4
25,"25161",360,219,218,2,1,"ECP",42
8,"8187",152377,102805,102199,805,606,"ECP",29055
25,"25141",153,95,95,0,0,"ECP",19
43,"43116",451,324,317,5,7,"ECP",53
25,"25010",211,113,113,2,0,"ECP",22
25,"25912",857,547,539,1,8,"ECP",86
17,"17011",637,444,439,6,5,"ECP",50
43,"43038",21366,13061,12943,111,118,"ECP",2581
8,"8201",442,278,278,4,0,"ECP",45
8,"8037",1864,1242,1230,14,12,"ECP",94
8,"8100",2001,1395,1380,25,15,"ECP",105
17,"17145",1482,967,956,8,11,"ECP",135
25,"25138",569,363,360,4,3,"ECP",31
17,"17174",178,99,97,2,2,"ECP",12
43,"43020",2215,1508,1497,9,11,"ECP",370
25,"25226",253,155,152,3,3,"ECP",22
8,"8275",247,179,179,4,0,"ECP",12
8,"8189",127,90,89,3,1,"ECP",7
17,"17004",512,335,334,4,1,"ECP",63
8,"8230",7635,5177,5121,54,56,"ECP",911
43,"43081",593,400,395,3,5,"ECP",96
8,"8066",1365,926,921,8,5,"ECP",229
17,"17051",218,145,142,1,3,"ECP",23
25,"25039",277,181,180,3,1,"ECP",44
8,"8215",2588,1663,1647,16,16,"ECP",204
8,"8024",386,243,236,0,7,"ECP",35
17,"17085",301,215,214,5,1,"ECP",23
43,"43107",383,238,237,7,1,"ECP",50
43,"43093",3919,2461,2434,47,27,"ECP",441
8,"8010",4168,2631,2606,20,25,"ECP",441
17,"17002",556,401,396,0,5,"ECP",50
25,"25910",100,63,61,2,2,"ECP",11
8,"8307",48295,32010,31798,195,212,"ECP",8866
8,"8227",2326,1508,1487,20,21,"ECP",285
8,"8204",3055,2094,2082,17,12,"ECP",595
25,"25253",159,105,105,1,0,"ECP",12
17,"17035",548,381,379,5,2,"ECP",37
25,"25196",113,57,57,0,0,"ECP",10
25,"25905",375,249,246,3,3,"ECP",26
17,"17056",1715,1120,1106,16,14,"ECP",154
25,"25004",571,376,373,3,3,"ECP",44
8,"8904",10553,6623,6579,52,44,"ECP",2372
17,"17111",880,590,586,7,4,"ECP",95
43,"43147",524,381,373,4,8,"ECP",46
8,"8068",6718,4373,4343,33,30,"ECP",1187
43,"43083",144,109,108,0,1,"ECP",17
25,"25055",169,105,104,4,1,"ECP",9
8,"8163",18641,11801,11729,68,72,"ECP",2686
8,"8300",5678,3983,3964,35,19,"ECP",1112
17,"17003",104,67,66,0,1,"ECP",7
43,"43030",427,288,283,1,5,"ECP",73
17,"17117",14353,8469,8426,49,43,"ECP",1493
43,"43082",365,290,286,5,4,"ECP",34
25,"25179",162,103,103,2,0,"ECP",8
25,"25907",494,266,265,6,1,"ECP",40
17,"17224",314,190,188,2,2,"ECP",15
43,"43085",226,180,180,1,0,"ECP",35
8,"8042",2231,1565,1558,17,7,"ECP",400
25,"25153",192,130,128,2,2,"ECP",15
25,"25119",2248,1449,1442,15,7,"ECP",185
8,"8193",944,601,596,12,5,"ECP",156
8,"8092",3736,2369,2342,13,27,"ECP",327
17,"17134",228,162,161,0,1,"ECP",49
8,"8120",6835,4708,4688,44,20,"ECP",332
17,"17161",992,726,721,10,5,"ECP",85
8,"8015",155409,99368,98735,820,633,"ECP",28405
25,"25097",84,65,65,3,0,"ECP",6
25,"25085",148,107,107,0,0,"ECP",12
8,"8190",256,168,165,2,3,"ECP",23
17,"17160",14747,9189,9129,65,60,"ECP",1921
17,"17092",3509,2256,2223,18,33,"ECP",351
43,"43150",1281,937,923,6,14,"ECP",187
8,"8298",26471,16674,16591,139,83,"ECP",2104
43,"43064",2015,1310,1296,23,14,"ECP",195
43,"43123",70482,44051,43675,345,376,"ECP",8402
8,"8080",34,26,26,3,0,"ECP",0
25,"25077",463,256,253,6,3,"ECP",30
17,"17064",322,214,211,4,3,"ECP",24
43,"43086",5249,3271,3244,37,27,"ECP",625
8,"8108",5016,3501,3474,21,27,"ECP",941
25,"25111",117,72,70,2,2,"ECP",5
8,"8295",10870,6972,6918,51,54,"ECP",1997
17,"17202",3791,2280,2263,18,17,"ECP",434
25,"25174",397,280,280,2,0,"ECP",46
8,"8113",52035,32351,32150,254,201,"ECP",6220
8,"8182",2811,1799,1789,22,10,"ECP",498
25,"25007",1405,850,841,8,9,"ECP",186
25,"25089",105,60,59,0,1,"ECP",21
25,"25104",130,76,74,1,2,"ECP",6
25,"25908",226,144,143,3,1,"ECP",23
17,"17165",656,439,435,3,4,"ECP",49
17,"17157",125,95,95,1,0,"ECP",12
8,"8032",1981,1319,1311,11,8,"ECP",270
17,"17021",131,86,85,4,1,"ECP",30
8,"8083",1675,1146,1144,9,2,"ECP",91
43,"43108",1774,1172,1160,14,12,"ECP",206
43,"43090",1076,565,558,6,7,"ECP",170
25,"25143",84,56,55,0,1,"ECP",5
25,"25052",1555,1027,1016,14,11,"ECP",121
17,"17128",308,205,203,3,2,"ECP",15
8,"8151",466,288,287,2,1,"ECP",19
43,"43176",785,523,520,4,3,"ECP",69
25,"25040",10546,6367,6300,61,67,"ECP",1083
17,"17098",301,192,188,2,4,"ECP",38
43,"43007",641,456,455,3,1,"ECP",80
43,"43126",1177,782,772,4,10,"ECP",154
43,"43151",107,90,89,0,1,"ECP",13
25,"25223",922,553,543,8,10,"ECP",61
8,"8231",20564,13037,12952,96,85,"ECP",3587
43,"43010",322,233,227,0,6,"ECP",38
25,"25049",151,110,108,1,2,"ECP",11
25,"25239",590,258,256,5,2,"ECP",37
17,"17062",5958,3463,3441,22,22,"ECP",630
17,"17209",630,443,438,7,5,"ECP",69
25,"25076",145,81,81,2,0,"ECP",10
17,"17044",6770,4411,4376,33,35,"ECP",568
25,"25902",567,365,356,8,9,"ECP",42
25,"25094",137,98,95,1,3,"ECP",16
8,"8014",1962,1366,1359,15,7,"ECP",243
8,"8145",2599,1774,1761,11,13,"ECP",401
8,"8210",4329,2624,2594,31,30,"ECP",592
25,"25142",364,229,225,2,4,"ECP",37
43,"43106",810,526,522,7,4,"ECP",122
17,"17063",162,111,109,0,2,"ECP",17
8,"8144",717,447,437,5,10,"ECP",49
8,"8104",679,432,430,3,2,"ECP",54
43,"43011",1077,743,737,2,6,"ECP",104
43,"43052",938,628,621,12,7,"ECP",147
8,"8091",5244,3611,3584,17,27,"ECP",1052
8,"8172",20326,13875,13802,92,73,"ECP",3756
8,"8158",3082,2054,2041,21,13,"ECP",518
8,"8268",1005,665,659,4,6,"ECP",114
43,"43053",191,144,143,3,1,"ECP",44
25,"25225",564,356,356,1,0,"ECP",28
17,"17183",277,180,179,1,1,"ECP",22
43,"43031",1458,1020,1014,15,6,"ECP",145
8,"8174",392,283,279,3,4,"ECP",48
8,"8052",141,88,88,0,0,"ECP",11
8,"8260",18335,12325,12263,106,62,"ECP",3997
8,"8065",1176,797,784,10,13,"ECP",113
8,"8297",134,85,84,0,1,"ECP",8
25,"25139",467,294,291,5,3,"ECP",34
17,"17065",331,230,230,1,0,"ECP",26
43,"43095",2474,1575,1551,17,24,"ECP",300
17,"17090",545,370,368,4,2,"ECP",43
8,"8160",327,208,208,1,0,"ECP",21
43,"43903",2392,1324,1313,10,11,"ECP",274
43,"43168",96,57,57,3,0,"ECP",6
25,"25201",112,73,72,3,1,"ECP",5
8,"8148",2233,1491,1483,7,8,"ECP",458
8,"8217",24989,17765,17661,114,104,"ECP",5153
43,"43055",1975,1384,1379,21,5,"ECP",203
8,"8107",11502,7510,7445,67,65,"ECP",2258
43,"43024",1537,993,983,8,10,"ECP",238
43,"43124",482,308,307,2,1,"ECP",58
17,"17023",27269,17209,17032,122,177,"ECP",4663
43,"43119",799,470,468,8,2,"ECP",106
43,"43133",5666,3397,3356,27,41,"ECP",902
25,"25166",181,110,109,2,1,"ECP",9
25,"25220",1015,634,632,1,2,"ECP",81
8,"8254",1739,1159,1156,10,3,"ECP",122
25,"25073",582,328,324,8,4,"ECP",68
17,"17106",140,103,102,0,1,"ECP",8
25,"25155",647,421,418,0,3,"ECP",41
8,"8149",993,569,567,10,2,"ECP",61
43,"43138",2672,1629,1585,37,44,"ECP",362
17,"17067",696,467,464,5,3,"ECP",61
8,"8219",15422,10701,10619,98,82,"ECP",2273
25,"25003",3762,2215,2195,22,20,"ECP",267
8,"8122",1698,1080,1073,5,7,"ECP",289
8,"8029",3480,2472,2460,25,12,"ECP",370
25,"25115",824,489,487,7,2,"ECP",49
17,"17041",218,130,129,2,1,"ECP",24
43,"43112",279,175,174,0,1,"ECP",36
25,"25043",807,501,497,11,4,"ECP",103
25,"25217",10625,6319,6260,99,59,"ECP",1089
8,"8011",1756,1087,1082,16,5,"ECP",115
17,"17187",631,445,441,2,4,"ECP",91
17,"17038",366,234,232,6,2,"ECP",31
17,"17162",150,86,86,1,0,"ECP",23
8,"8124",36804,24782,24632,184,150,"ECP",7826
8,"8097",1021,715,712,8,3,"ECP",168
17,"17208",995,594,590,8,4,"ECP",77
43,"43149",686,447,443,8,4,"ECP",53
8,"8009",9180,6207,6192,50,15,"ECP",1274
25,"25182",1036,660,655,9,5,"ECP",127
17,"17902",1357,886,878,13,8,"ECP",116
17,"17095",19555,11537,11428,89,109,"ECP",2539
8,"8116",578,387,383,2,4,"ECP",34
43,"43045",149,110,110,2,0,"ECP",9
25,"25173",1705,1156,1143,14,13,"ECP",272
17,"17018",480,327,322,2,5,"ECP",47
17,"17151",174,111,110,3,1,"ECP",12
25,"25200",329,213,213,0,0,"ECP",31
8,"8276",237,165,165,2,0,"ECP",35
25,"25215",345,240,236,0,4,"ECP",46
25,"25244",361,223,220,5,3,"ECP",21
25,"25014",260,165,165,5,0,"ECP",13
8,"8076",16169,10652,10563,75,89,"ECP",3223
25,"25038",1545,995,986,17,9,"ECP",95
17,"17125",130,80,80,0,0,"ECP",5
17,"17233",2260,1528,1514,23,14,"ECP",198
8,"8250",7061,4480,4448,48,32,"ECP",1169
17,"17214",705,423,419,2,4,"ECP",50
25,"25059",805,527,523,7,4,"ECP",61
25,"25233",275,178,178,4,0,"ECP",41
8,"8181",7887,5178,5144,48,34,"ECP",1212
8,"8264",4325,2929,2908,26,21,"ECP",434
8,"8277",157,108,107,0,1,"ECP",16
43,"43062",281,217,215,2,2,"ECP",39
25,"25234",4279,2546,2508,23,38,"ECP",399
43,"43906",2102,1364,1346,15,18,"ECP",290
25,"25909",148,93,92,2,1,"ECP",26
25,"25020",289,206,205,3,1,"ECP",16
17,"17178",1059,654,650,7,4,"ECP",82
17,"17215",2087,1481,1466,7,15,"ECP",209
43,"43048",805,525,513,8,12,"ECP",117
25,"25186",213,124,122,3,2,"ECP",14
8,"8088",11899,8149,8097,69,52,"ECP",1539
8,"8238",14531,10378,10325,98,53,"ECP",2394
8,"8169",47759,32651,32439,243,212,"ECP",11393
8,"8194",25660,15045,14941,122,104,"ECP",4464
43,"43109",2606,1491,1475,20,16,"ECP",353
25,"25901",293,202,202,7,0,"ECP",16
43,"43141",106,68,67,0,1,"ECP",11
8,"8057",60,45,44,1,1,"ECP",7
25,"25127",210,136,136,2,0,"ECP",12
43,"43046",99,68,65,1,3,"ECP",11
8,"8130",95,56,55,0,1,"ECP",5
17,"17129",133,101,101,1,0,"ECP",10
8,"8199",663,456,453,14,3,"ECP",51
8,"8129",462,319,316,3,3,"ECP",70
17,"17100",194,133,131,3,2,"ECP",11
17,"17142",2550,1806,1797,30,9,"ECP",313
8,"8185",188,123,122,2,1,"ECP",22
17,"17043",161,122,117,1,5,"ECP",22
17,"17154",92,67,66,0,1,"ECP",27
8,"8062",956,619,618,4,1,"ECP",106
25,"25224",126,70,70,5,0,"ECP",15
17,"17218",582,404,401,1,3,"ECP",83
8,"8281",4802,3343,3318,17,25,"ECP",624
25,"25209",1495,995,978,9,17,"ECP",199
25,"25194",423,246,244,6,2,"ECP",22
8,"8050",141,99,99,2,0,"ECP",7
43,"43174",138,102,100,1,2,"ECP",9
17,"17036",2717,1730,1716,15,14,"ECP",321
17,"17207",2375,1590,1579,11,11,"ECP",181
8,"8023",6734,4350,4323,35,27,"ECP",1162
17,"17024",268,153,152,1,1,"ECP",15
17,"17144",206,141,141,3,0,"ECP",21
8,"8255",134,78,78,0,0,"ECP",14
25,"25078",998,628,627,7,1,"ECP",105
17,"17025",1134,793,787,6,6,"ECP",89
25,"25180",234,143,143,1,0,"ECP",25
8,"8903",214,166,165,0,1,"ECP",14
17,"17158",476,276,274,1,2,"ECP",39
25,"25112",273,192,188,4,4,"ECP",23
25,"25197",133,89,88,1,1,"ECP",9
8,"8256",650,484,484,5,0,"ECP",172
25,"25913",86,67,67,3,0,"ECP",8
8,"8229",535,357,354,9,3,"ECP",25
25,"25181",172,123,120,4,3,"ECP",14
8,"8138",4248,2638,2618,27,20,"ECP",460
43,"43080",239,183,181,0,2,"ECP",14
43,"43177",299,231,230,6,1,"ECP",30
8,"8248",5419,3566,3546,45,20,"ECP",911
8,"8165",1649,1100,1085,9,15,"ECP",233
17,"17119",74,54,54,0,0,"ECP",16
8,"8067",5739,3616,3577,47,39,"ECP",645
43,"43110",259,175,175,6,0,"ECP",23
43,"43068",520,330,326,7,4,"ECP",37
8,"8026",188,134,134,0,0,"ECP",9
25,"25013",2146,1240,1226,16,14,"ECP",246
8,"8121",86351,57040,56655,446,385,"ECP",13405
8,"8063",453,337,336,4,1,"ECP",44
43,"43041",216,152,151,0,1,"ECP",26
17,"17066",26562,15223,15087,150,136,"ECP",2522
17,"17049",3117,2092,2072,14,20,"ECP",400
17,"17101",559,347,338,2,9,"ECP",90
8,"8140",4774,3118,3098,23,20,"ECP",651
25,"25030",135,74,72,1,2,"ECP",9
43,"43070",238,192,191,1,1,"ECP",33
8,"8299",391,244,244,5,0,"ECP",21
43,"43097",393,291,289,1,2,"ECP",50
17,"17080",138,96,96,1,0,"ECP",11
17,"17040",537,347,345,3,2,"ECP",52
17,"17136",178,125,124,0,1,"ECP",24
8,"8041",10343,6645,6582,57,63,"ECP",1605
43,"43016",3416,2335,2309,15,26,"ECP",586
17,"17210",551,350,349,9,1,"ECP",43
8,"8246",1665,1086,1078,9,8,"ECP",109
25,"25202",104,73,72,0,1,"ECP",17
25,"25118",346,198,189,3,9,"ECP",20
25,"25247",123,66,66,1,0,"ECP",18
17,"17199",6853,4147,4122,27,25,"ECP",579
17,"17121",224,140,140,1,0,"ECP",15
25,"25031",52,29,29,0,0,"ECP",5
8,"8233",1871,1153,1140,16,13,"ECP",132
17,"17107",264,167,165,8,2,"ECP",15
8,"8070",266,194,191,2,3,"ECP",23
8,"8274",4665,3028,3009,26,19,"ECP",628
43,"43154",130,101,100,0,1,"ECP",12
17,"17078",336,223,220,6,3,"ECP",12
8,"8125",25081,16406,16329,164,77,"ECP",5681
25,"25168",509,354,352,7,2,"ECP",22
17,"17159",643,413,406,3,7,"ECP",73
17,"17180",8295,4958,4935,36,23,"ECP",744
43,"43059",252,188,188,2,0,"ECP",19
25,"25204",1231,731,724,5,7,"ECP",83
25,"25045",57,40,40,0,0,"ECP",3
17,"17070",111,76,76,2,0,"ECP",3
25,"25906",218,125,125,1,0,"ECP",21
25,"25088",96,73,72,0,1,"ECP",4
8,"8045",73,37,35,0,2,"ECP",11
25,"25099",1273,761,752,7,9,"ECP",103
43,"43128",907,587,577,5,10,"ECP",125
43,"43033",765,531,530,4,1,"ECP",115
25,"25154",122,74,72,0,2,"ECP",9
8,"8263",20972,13710,13583,149,127,"ECP",3824
8,"8240",9348,6512,6483,38,29,"ECP",1487
17,"17084",238,146,144,5,2,"ECP",14
8,"8001",8907,6316,6269,46,47,"ECP",2142
8,"8154",696,494,488,5,6,"ECP",101
8,"8126",8748,5927,5895,56,32,"ECP",1777
17,"17097",196,148,148,3,0,"ECP",17
25,"25121",644,415,410,8,5,"ECP",66
25,"25146",227,140,140,3,0,"ECP",9
8,"8086",13582,8612,8557,75,55,"ECP",2274
8,"8167",5910,4081,4051,40,30,"ECP",1421
17,"17086",1729,1068,1059,8,9,"ECP",183
25,"25034",2326,1361,1340,15,21,"ECP",122
25,"25163",231,135,132,2,3,"ECP",14
43,"43089",292,190,186,0,4,"ECP",57
8,"8237",1643,1105,1096,8,9,"ECP",131
8,"8016",1831,1136,1129,19,7,"ECP",211
8,"8211",33081,23576,23413,226,163,"ECP",6727
43,"43131",4647,2934,2916,21,18,"ECP",687
25,"25048",1651,1051,1040,11,11,"ECP",117
25,"25075",117,72,72,2,0,"ECP",9
8,"8034",763,538,537,1,1,"ECP",65
8,"8115",3799,2589,2572,17,17,"ECP",808
8,"8017",2762,1701,1688,9,13,"ECP",306
25,"25058",4357,2624,2595,20,29,"ECP",358
17,"17074",510,337,335,2,2,"ECP",69
8,"8289",4338,2912,2898,27,14,"ECP",836
25,"25017",236,169,167,7,2,"ECP",22
43,"43137",1868,1254,1242,11,12,"ECP",307
8,"8048",582,419,417,4,2,"ECP",46
17,"17010",336,224,224,3,0,"ECP",38
25,"25222",66,52,52,1,0,"ECP",2
8,"8089",33850,22230,22096,170,134,"ECP",6121
8,"8035",12547,7877,7828,51,49,"ECP",1545
8,"8226",891,648,645,6,3,"ECP",67
25,"25062",750,486,482,1,4,"ECP",68
8,"8022",12212,7210,7155,66,55,"ECP",1091
17,"17205",208,157,155,1,2,"ECP",16
25,"25150",181,115,113,3,2,"ECP",7
25,"25124",166,106,105,1,1,"ECP",7
43,"43173",100,53,51,0,2,"ECP",10
25,"25136",95,64,64,1,0,"ECP",7
25,"25911",451,273,271,7,2,"ECP",19
17,"17143",142,103,99,1,4,"ECP",16
17,"17130",325,223,222,3,1,"ECP",21
8,"8267",6461,4265,4245,51,20,"ECP",1221
17,"17169",2475,1619,1601,11,18,"ECP",272
43,"43079",364,248,248,0,0,"ECP",50
43,"43121",599,354,348,1,6,"ECP",86
43,"43161",17197,10481,10400,95,81,"ECP",1853
8,"8205",59828,43344,43140,367,204,"ECP",8271
25,"25255",417,298,296,2,2,"ECP",55
25,"25152",140,86,86,1,0,"ECP",8
25,"25011",5243,2796,2767,23,29,"ECP",545
25,"25167",230,138,138,3,0,"ECP",22
17,"17132",1298,884,877,12,7,"ECP",97
8,"8051",17948,12140,12076,102,64,"ECP",3234
8,"8133",128,72,72,0,0,"ECP",2
25,"25126",290,200,198,2,2,"ECP",32
17,"17901",987,623,620,9,3,"ECP",106
25,"25067",719,467,460,7,7,"ECP",71
17,"17012",1145,703,698,9,5,"ECP",166
43,"43040",330,257,255,5,2,"ECP",37
17,"17221",4153,2577,2564,27,13,"ECP",392
8,"8038",1487,959,954,15,5,"ECP",187
17,"17118",12711,7567,7515,42,52,"ECP",1290
8,"8179",579,396,396,5,0,"ECP",108
8,"8008",190,110,110,5,0,"ECP",11
17,"17027",2821,1896,1889,17,7,"ECP",311
17,"17013",2787,1780,1762,17,18,"ECP",311
8,"8161",11144,6994,6938,73,56,"ECP",2002
8,"8244",5851,4095,4058,36,37,"ECP",1338
43,"43001",691,441,439,4,2,"ECP",102
17,"17026",544,370,367,5,3,"ECP",33
17,"17014",64,48,48,1,0,"ECP",4
25,"25041",568,347,344,4,3,"ECP",52
25,"25219",141,102,101,0,1,"ECP",22
43,"43015",112,87,86,0,1,"ECP",18
25,"25082",285,186,178,5,8,"ECP",14
8,"8136",11450,7703,7641,84,62,"ECP",2518
8,"8905",2346,1689,1681,26,8,"ECP",429
25,"25216",226,138,136,1,2,"ECP",15
8,"8272",151,90,90,1,0,"ECP",10
17,"17198",429,270,267,2,3,"ECP",58
43,"43056",854,480,470,5,10,"ECP",68
17,"17227",129,86,85,5,1,"ECP",11
8,"8287",1048,736,735,2,1,"ECP",122
43,"43043",3130,2053,2036,18,17,"ECP",540
8,"8304",812,562,558,3,4,"ECP",94
8,"8177",40,30,30,0,0,"ECP",8
43,"43166",1584,1029,1022,6,7,"ECP",193
17,"17093",891,563,560,6,3,"ECP",86
17,"17015",12546,7832,7777,66,55,"ECP",1021
43,"43152",439,323,320,2,3,"ECP",42
17,"17094",1059,602,600,4,2,"ECP",81
43,"43167",375,277,275,9,2,"ECP",42
17,"17225",214,139,139,3,0,"ECP",6
8,"8137",262,188,187,2,1,"ECP",34
8,"8069",3169,2161,2148,32,13,"ECP",522
43,"43057",38,25,25,1,0,"ECP",4
8,"8288",1659,1004,994,7,10,"ECP",268
25,"25248",891,592,586,6,6,"ECP",68
25,"25203",8931,5003,4955,72,48,"ECP",807
25,"25102",707,420,407,6,13,"ECP",65
8,"8302",9218,5946,5891,82,55,"ECP",1712
17,"17133",1255,805,796,9,9,"ECP",76
8,"8013",1224,802,793,9,9,"ECP",150
8,"8235",3686,2488,2470,16,18,"ECP",431
8,"8221",12368,8798,8763,67,35,"ECP",1769
17,"17212",141,104,102,0,2,"ECP",9
25,"25044",188,122,120,7,2,"ECP",13
17,"17110",1322,856,853,3,3,"ECP",134
43,"43156",3946,2524,2470,28,54,"ECP",582
43,"43115",143,100,98,2,2,"ECP",12
25,"25205",566,382,372,8,10,"ECP",73
8,"8195",82,63,63,0,0,"ECP",8
17,"17232",152,92,91,1,1,"ECP",16
43,"43006",681,438,437,9,1,"ECP",112
17,"17164",3982,2363,2350,11,13,"ECP",307
43,"43074",1754,1170,1157,9,13,"ECP",232
43,"43129",4580,2844,2805,23,39,"ECP",374
8,"8209",6773,4410,4382,29,28,"ECP",1239
25,"25046",422,279,275,2,4,"ECP",36
8,"8072",10259,6462,6422,42,40,"ECP",1760
8,"8019",1136351,768170,764030,5799,4140,"ECP",196341
43,"43029",310,213,211,3,2,"ECP",29
43,"43060",2860,1950,1926,12,24,"ECP",371
17,"17190",844,528,528,3,0,"ECP",91
17,"17182",263,181,181,6,0,"ECP",29
25,"25148",219,124,124,0,0,"ECP",2
17,"17152",10737,6308,6252,45,56,"ECP",1043
8,"8305",27339,17960,17809,147,151,"ECP",3726
43,"43143",54,47,47,3,0,"ECP",8
8,"8087",152,121,121,2,0,"ECP",14
25,"25074",178,132,128,6,4,"ECP",10
25,"25134",623,369,366,3,3,"ECP",55
8,"8003",7084,4839,4803,39,36,"ECP",779
43,"43171",14599,9083,9011,72,72,"ECP",2113
25,"25192",743,449,436,2,13,"ECP",51
8,"8020",4926,3523,3502,33,21,"ECP",829
8,"8155",6730,4353,4320,39,33,"ECP",1356
8,"8306",506,299,297,5,2,"ECP",73
8,"8156",10891,7322,7259,43,63,"ECP",2020
25,"25252",548,343,342,9,1,"ECP",59
25,"25022",104,79,79,0,0,"ECP",9
17,"17109",696,422,419,1,3,"ECP",75
25,"25238",204,140,138,4,2,"ECP",23
8,"8294",1966,1287,1280,17,7,"ECP",334
43,"43092",7036,4226,4185,39,41,"ECP",810
25,"25208",331,183,182,1,1,"ECP",55
8,"8280",97,66,66,2,0,"ECP",12
8,"8253",131,81,81,2,0,"ECP",13
17,"17048",6241,3831,3801,36,30,"ECP",628
25,"25193",759,485,480,2,5,"ECP",28
17,"17115",282,183,183,1,0,"ECP",20
25,"25110",2766,1628,1602,22,26,"ECP",227
17,"17105",247,147,147,1,0,"ECP",31
25,"25006",340,201,200,6,1,"ECP",24
8,"8075",3883,2479,2467,14,12,"ECP",675
25,"25114",98,72,72,0,0,"ECP",3
8,"8131",704,471,468,7,3,"ECP",83
25,"25050",3233,1936,1912,25,24,"ECP",273
17,"17116",354,228,224,3,4,"ECP",40
43,"43065",399,252,251,3,1,"ECP",27
17,"17076",124,86,84,3,2,"ECP",9
8,"8236",1527,1006,999,4,7,"ECP",170
43,"43120",441,270,267,1,3,"ECP",88
25,"25125",417,250,250,5,0,"ECP",25
17,"17071",1134,778,774,10,4,"ECP",98
17,"17173",180,132,131,0,1,"ECP",17
43,"43094",2143,1395,1375,13,20,"ECP",254
8,"8077",34508,24070,23956,127,114,"ECP",6172
25,"25096",902,534,525,10,9,"ECP",75
43,"43066",158,100,98,5,2,"ECP",23
8,"8296",1777,1237,1231,7,6,"ECP",210
43,"43135",340,235,234,1,1,"ECP",31
25,"25211",680,386,379,4,7,"ECP",47
8,"8902",3761,2570,2558,31,12,"ECP",610
8,"8132",383,213,212,4,1,"ECP",15
8,"8270",18490,12343,12274,93,69,"ECP",2543
17,"17170",171,125,123,1,2,"ECP",10
8,"8105",9630,6394,6339,49,55,"ECP",2025
8,"8119",6180,4155,4123,28,32,"ECP",1290
8,"8203",2390,1466,1456,8,10,"ECP",410
25,"25087",60,43,43,0,0,"ECP",5
8,"8079",343,256,255,4,1,"ECP",14
43,"43136",10351,6279,6218,63,61,"ECP",1612
8,"8216",25,15,15,1,0,"ECP",8
17,"17146",2969,1868,1855,8,13,"ECP",574
8,"8039",362,266,266,0,0,"ECP",72
8,"8176",156,109,107,2,2,"ECP",8
43,"43096",99,81,80,1,1,"ECP",13
25,"25027",976,633,630,7,3,"ECP",67
25,"25098",253,151,150,0,1,"ECP",19
25,"25042",208,123,121,1,2,"ECP",12
17,"17213",5424,3239,3219,24,20,"ECP",693
17,"17091",407,258,253,5,5,"ECP",29
8,"8258",830,557,551,6,6,"ECP",58
8,"8166",991,631,625,7,6,"ECP",80
8,"8286",2879,1802,1797,14,5,"ECP",444
43,"43002",1801,1156,1128,7,28,"ECP",271
8,"8232",1775,1183,1176,6,7,"ECP",236
17,"17054",370,236,236,1,0,"ECP",37
8,"8162",2047,1400,1392,7,8,"ECP",381
8,"8054",8998,6172,6129,44,43,"ECP",1811
8,"8259",6637,4611,4577,39,34,"ECP",968
25,"25183",499,326,323,7,3,"ECP",59
17,"17197",132,102,101,1,1,"ECP",25
17,"17032",1721,967,961,10,6,"ECP",189
25,"25171",2185,1416,1410,8,6,"ECP",216
25,"25129",175,83,83,2,0,"ECP",7
25,"25101",561,364,358,2,6,"ECP",46
25,"25230",1558,1008,993,13,15,"ECP",110
8,"8123",19140,13557,13484,106,73,"ECP",3595
43,"43099",306,228,226,4,2,"ECP",28
8,"8012",1672,1075,1061,17,14,"ECP",105
43,"43044",3963,2671,2640,33,31,"ECP",673
8,"8056",42140,28129,27977,257,152,"ECP",7237
43,"43113",393,279,278,5,1,"ECP",48
43,"43017",124,101,101,1,0,"ECP",12
8,"8261",2327,1499,1493,11,6,"ECP",371
25,"25071",49,31,31,0,0,"ECP",3
43,"43104",1783,1157,1142,10,15,"ECP",179
25,"25057",208,141,140,0,1,"ECP",34
8,"8207",1865,1407,1402,19,5,"ECP",204
25,"25032",64,44,44,1,0,"ECP",8
25,"25086",522,346,341,2,5,"ECP",48
8,"8111",218,185,184,3,1,"ECP",17
25,"25157",181,115,114,7,1,"ECP",9
8,"8208",5732,3976,3952,30,24,"ECP",1149
17,"17057",968,641,636,11,5,"ECP",117
25,"25189",2110,1198,1186,10,12,"ECP",281
17,"17096",179,106,105,1,1,"ECP",22
8,"8249",266,211,209,2,2,"ECP",43
25,"25037",375,247,246,5,1,"ECP",24
17,"17150",1401,962,951,6,11,"ECP",121
43,"43142",1100,698,688,5,10,"ECP",122
8,"8152",114,80,79,0,1,"ECP",4
43,"43904",2900,1602,1573,32,29,"ECP",331
43,"43101",145,104,102,3,2,"ECP",17
25,"25190",262,185,183,0,2,"ECP",30
43,"43905",14392,8444,8393,45,51,"ECP",1813
43,"43169",450,370,367,10,3,"ECP",54
17,"17139",1364,884,865,8,19,"ECP",120
17,"17058",177,101,100,3,1,"ECP",22
8,"8036",163,105,104,1,1,"ECP",9
43,"43111",2044,1291,1275,9,16,"ECP",356
25,"25210",1108,685,677,3,8,"ECP",63
17,"17060",424,268,266,5,2,"ECP",31
43,"43047",4161,2359,2341,27,18,"ECP",438
8,"8002",201,130,124,0,6,"ECP",13
17,"17194",80,55,54,0,1,"ECP",5
25,"25206",260,150,150,5,0,"ECP",8
8,"8251",4984,3257,3241,17,16,"ECP",805
25,"25251",707,443,442,2,1,"ECP",87
25,"25047",1014,675,674,8,1,"ECP",66
43,"43157",353,268,264,5,4,"ECP",39
8,"8197",7648,5020,5000,37,20,"ECP",841
43,"43075",89,61,60,1,1,"ECP",9
43,"43145",4096,2795,2760,19,35,"ECP",497
17,"17203",153,99,99,0,0,"ECP",15
8,"8279",153025,101133,100621,840,512,"ECP",28602
8,"8093",27,21,21,0,0,"ECP",2
8,"8143",2682,1718,1707,17,11,"ECP",383
43,"43105",162,123,122,2,1,"ECP",21
17,"17192",144,96,93,1,3,"ECP",5
25,"25061",83,46,46,0,0,"ECP",2
8,"8049",1293,790,779,3,11,"ECP",78
25,"25009",627,444,440,8,4,"ECP",55
8,"8213",6319,3950,3935,37,15,"ECP",861
17,"17216",165,110,110,1,0,"ECP",12
43,"43132",373,264,261,4,3,"ECP",32
8,"8252",24570,17009,16901,145,108,"ECP",5827
43,"43063",557,355,349,9,6,"ECP",69
43,"43054",2812,1755,1739,16,16,"ECP",223
8,"8103",625,395,395,2,0,"ECP",63
8,"8196",19233,12733,12671,94,62,"ECP",3872
43,"43005",3626,2157,2138,29,19,"ECP",416
8,"8053",2788,1605,1591,8,14,"ECP",396
43,"43050",2505,1507,1496,12,11,"ECP",416
8,"8171",2103,1288,1280,12,8,"ECP",108
8,"8200",61409,41278,41024,312,254,"ECP",13663
43,"43078",846,543,531,8,12,"ECP",68
25,"25151",685,425,419,7,6,"ECP",48
25,"25245",435,289,280,5,9,"ECP",51
17,"17120",786,517,512,8,5,"ECP",79
25,"25903",236,161,161,3,0,"ECP",23
8,"8055",519,331,327,4,4,"ECP",66
25,"25254",728,457,451,2,6,"ECP",67
25,"25137",8585,5143,5095,56,48,"ECP",834
43,"43134",282,191,191,4,0,"ECP",55
17,"17148",1515,981,972,4,9,"ECP",160
43,"43175",554,363,360,5,3,"ECP",32
25,"25070",823,554,549,15,5,"ECP",61
8,"8202",12680,8341,8278,75,63,"ECP",1726
8,"8269",2673,1788,1776,14,12,"ECP",245
8,"8078",219,112,111,3,1,"ECP",11
43,"43067",552,397,393,2,4,"ECP",47
43,"43039",99,66,66,0,0,"ECP",5
8,"8188",115,78,78,0,0,"ECP",7
25,"25242",720,456,450,2,6,"ECP",57
25,"25025",1353,871,864,16,7,"ECP",169
17,"17082",417,255,253,2,2,"ECP",39
17,"17042",419,272,272,2,0,"ECP",58
8,"8283",5963,3670,3642,24,28,"ECP",490
43,"43163",25248,15802,15663,104,139,"ECP",4065
25,"25243",3646,2193,2167,33,26,"ECP",402
43,"43004",6281,3993,3929,38,64,"ECP",860
25,"25212",233,154,153,6,1,"ECP",16
17,"17103",4954,2877,2850,25,27,"ECP",782
8,"8271",70,48,48,0,0,"ECP",9
25,"25068",556,346,341,11,5,"ECP",34
17,"17052",125,78,78,0,0,"ECP",17
8,"8284",12097,7157,7089,59,68,"ECP",1899
17,"17006",1127,686,682,1,4,"ECP",121
17,"17019",1775,1201,1188,7,13,"ECP",128
43,"43014",14251,8737,8624,101,113,"ECP",2217
17,"17138",928,637,633,4,4,"ECP",108
25,"25132",136,88,87,0,1,"ECP",12
8,"8191",5239,3454,3438,27,16,"ECP",770
43,"43165",577,436,433,3,3,"ECP",72
8,"8040",10710,6845,6802,51,43,"ECP",1649
8,"8028",1024,648,644,4,4,"ECP",214
17,"17135",362,253,253,1,0,"ECP",45
25,"25240",1383,925,919,16,6,"ECP",159
8,"8135",6677,4813,4775,51,38,"ECP",1509
8,"8218",8009,5105,5075,59,30,"ECP",1264
17,"17147",8053,4988,4933,52,55,"ECP",781
17,"17185",2265,1420,1404,15,16,"ECP",184
8,"8223",1852,1182,1171,12,11,"ECP",206
17,"17166",522,374,367,1,7,"ECP",52
17,"17073",1873,1363,1356,15,7,"ECP",120
43,"43098",343,235,233,5,2,"ECP",38
43,"43061",45,30,29,0,1,"ECP",3
8,"8206",728,523,515,5,8,"ECP",73
8,"8247",961,637,634,4,3,"ECP",60
8,"8220",2356,1690,1683,18,7,"ECP",115
8,"8096",42622,28797,28615,263,182,"ECP",6421
8,"8110",13315,8457,8368,73,89,"ECP",2106
17,"17029",207,127,127,1,0,"ECP",18
43,"43153",10688,6675,6615,39,60,"ECP",1551
8,"8061",1497,986,983,14,3,"ECP",303
25,"25060",72,46,44,1,2,"ECP",5
8,"8031",2322,1552,1537,6,15,"ECP",257
25,"25218",81,64,63,1,1,"ECP",3
43,"43018",408,325,320,3,5,"ECP",32
43,"43127",743,528,527,2,1,"ECP",79
43,"43037",16781,10376,10265,71,111,"ECP",2835
8,"8164",913,618,609,7,9,"ECP",113
43,"43159",81,59,59,0,0,"ECP",2
8,"8044",4141,2739,2726,15,13,"ECP",539
43,"43114",392,271,268,2,3,"ECP",74
25,"25131",403,248,241,7,7,"ECP",46
25,"25103",135,76,76,4,0,"ECP",12
43,"43009",1403,918,905,14,13,"ECP",211
17,"17099",81,57,57,1,0,"ECP",9
17,"17114",23041,13985,13880,135,105,"ECP",2012
17,"17031",168,97,97,3,0,"ECP",18
8,"8262",6836,4175,4144,50,31,"ECP",1031
25,"25249",182,99,98,1,1,"ECP",5
8,"8112",12911,7790,7723,74,67,"ECP",1187
43,"43073",83,60,58,0,2,"ECP",11
25,"25033",1096,729,723,4,6,"ECP",138
8,"8085",1000,662,658,5,4,"ECP",76
25,"25228",3035,1933,1921,26,12,"ECP",312
8,"8192",5678,3729,3707,35,22,"ECP",713
43,"43103",880,547,545,4,2,"ECP",143
43,"43117",146,108,105,0,3,"ECP",21
8,"8228",301,199,197,6,2,"ECP",35
8,"8147",16967,11220,11138,65,82,"ECP",3377
43,"43162",4346,2983,2958,21,25,"ECP",574
8,"8214",6872,4699,4675,47,24,"ECP",901
8,"8266",43030,30192,30039,229,153,"ECP",9264
17,"17034",6931,4166,4150,29,16,"ECP",777
25,"25130",195,113,112,2,1,"ECP",8
17,"17007",1731,1191,1182,7,9,"ECP",116
17,"17046",717,459,458,4,1,"ECP",61
8,"8168",358,231,231,5,0,"ECP",39
8,"8127",2225,1349,1334,14,15,"ECP",300
25,"25135",1028,600,593,10,7,"ECP",77
43,"43091",132,86,86,0,0,"ECP",32
8,"8303",274,193,192,2,1,"ECP",33
25,"25016",2107,1268,1259,14,9,"ECP",193
17,"17075",330,205,205,1,0,"ECP",29
17,"17167",2700,1765,1749,37,16,"ECP",215
8,"8099",749,487,485,2,2,"ECP",113
25,"25140",788,435,430,9,5,"ECP",100
43,"43122",106,77,77,4,0,"ECP",28
8,"8170",450,276,274,7,2,"ECP",31
8,"8175",3347,2080,2064,20,16,"ECP",246
43,"43077",463,272,272,5,0,"ECP",26
25,"25164",376,242,238,4,4,"ECP",23
43,"43178",1350,856,844,5,12,"ECP",138
43,"43012",3534,2559,2548,34,11,"ECP",620
8,"8282",6578,4714,4690,45,24,"ECP",1032
43,"43172",344,211,209,4,2,"ECP",38
43,"43008",307,156,154,6,2,"ECP",21
25,"25176",309,216,211,1,5,"ECP",24
43,"43058",90,63,63,0,0,"ECP",7
17,"17211",830,581,580,10,1,"ECP",59
8,"8094",1559,1112,1097,14,15,"ECP",192
25,"25063",87,58,58,1,0,"ECP",5
17,"17181",3372,2135,2112,12,23,"ECP",398
8,"8308",131,87,87,1,0,"ECP",4
43,"43088",1996,1271,1255,7,16,"ECP",237
8,"8159",14096,9393,9347,76,46,"ECP",2917
25,"25081",308,189,189,2,0,"ECP",30
17,"17196",220,150,150,4,0,"ECP",26
8,"8234",3200,2128,2114,21,14,"ECP",570
8,"8047",3899,2292,2260,16,32,"ECP",321
8,"8301",48557,32715,32533,253,182,"ECP",10045
17,"17126",311,236,234,0,2,"ECP",21
8,"8180",26613,17585,17490,153,95,"ECP",6026
25,"25079",299,198,193,2,5,"ECP",16
43,"43100",3301,2183,2172,24,11,"ECP",613
17,"17195",329,237,234,0,3,"ECP",35
8,"8146",1286,885,881,12,4,"ECP",247
43,"43148",90275,59182,58757,388,425,"ECP",13237
17,"17171",165,117,116,2,1,"ECP",21
8,"8278",4779,3161,3148,20,13,"ECP",345
8,"8178",435,309,308,4,1,"ECP",57
8,"8139",175,132,132,2,0,"ECP",27
8,"8141",4563,2953,2929,34,24,"ECP",464
25,"25232",1397,874,871,12,3,"ECP",158
43,"43118",419,311,308,5,3,"ECP",42
43,"43022",1497,897,889,14,8,"ECP",139
25,"25019",4572,2726,2698,34,28,"ECP",563
25,"25145",86,65,64,1,1,"ECP",7
43,"43139",2039,1218,1191,8,27,"ECP",139
17,"17137",3437,2293,2275,19,18,"ECP",278
25,"25169",173,112,111,3,1,"ECP",20
8,"8285",10224,6396,6342,52,54,"ECP",1040
17,"17200",613,424,422,5,2,"ECP",87
43,"43072",105,74,72,0,2,"ECP",8
17,"17234",182,115,114,0,1,"ECP",20
17,"17175",578,321,312,5,9,"ECP",54
25,"25024",351,226,223,2,3,"ECP",31
17,"17077",548,369,368,1,1,"ECP",62
17,"17141",5887,3197,3165,34,32,"ECP",512
8,"8292",1072,730,725,6,5,"ECP",142
17,"17188",164,124,124,1,0,"ECP",29
25,"25227",652,402,400,4,2,"ECP",53
17,"17028",293,205,204,6,1,"ECP",17
8,"8273",2333,1654,1637,10,17,"ECP",307
17,"17061",156,104,103,1,1,"ECP",11
8,"8901",227,148,145,1,3,"ECP",11
8,"8293",219,168,167,0,1,"ECP",18
17,"17008",3639,2191,2171,16,20,"ECP",314
25,"25036",184,112,111,4,1,"ECP",19
17,"17068",245,158,156,1,2,"ECP",14
8,"8291",4536,2975,2965,21,10,"ECP",853
8,"8222",1895,1358,1351,14,7,"ECP",397
17,"17201",135,87,84,0,3,"ECP",13
8,"8142",133,103,101,5,2,"ECP",17
43,"43901",8737,4703,4639,62,64,"ECP",1284
25,"25056",235,143,143,2,0,"ECP",23
25,"25093",640,403,395,7,8,"ECP",53
43,"43140",2367,1550,1532,4,18,"ECP",398
25,"25177",368,226,226,0,0,"ECP",42
8,"8033",12813,8564,8509,63,55,"ECP",1906
17,"17022",6910,4207,4184,58,23,"ECP",702
43,"43026",782,524,520,6,4,"ECP",50
17,"17001",587,404,398,2,6,"ECP",76
8,"8018",2636,1690,1675,23,15,"ECP",424
17,"17112",190,127,125,2,2,"ECP",16
17,"17230",468,318,317,3,1,"ECP",26
8,"8257",107,71,71,0,0,"ECP",11
8,"8239",453,304,302,3,2,"ECP",60
43,"43076",439,300,299,0,1,"ECP",59
17,"17176",124,92,92,1,0,"ECP",10
17,"17222",101,76,75,0,1,"ECP",12
43,"43084",526,363,361,10,2,"ECP",71
43,"43027",161,118,116,15,2,"ECP",10
25,"25221",122,81,81,0,0,"ECP",17
17,"17087",225,152,149,2,3,"ECP",25
43,"43003",324,217,217,3,0,"ECP",65
8,"8212",488,319,316,0,3,"ECP",16
17,"17037",104,69,69,1,0,"ECP",4
8,"8102",28296,18466,18367,172,99,"ECP",3218
25,"25207",6212,3710,3680,47,30,"ECP",484
8,"8290",1507,1118,1110,12,8,"ECP",236
17,"17177",549,332,331,1,1,"ECP",37
17,"17223",801,516,506,9,10,"ECP",97
17,"17186",3788,2554,2526,27,28,"ECP",485
43,"43158",85,52,52,1,0,"ECP",11
25,"25231",486,330,330,4,0,"ECP",31
25,"25113",1168,811,803,8,8,"ECP",107
8,"8025",1490,981,978,4,3,"ECP",267
43,"43036",843,493,485,4,8,"ECP",137
25,"25123",193,134,131,2,3,"ECP",21
17,"17047",4798,2773,2757,28,16,"ECP",464
25,"25105",125,92,92,2,0,"ECP",13
25,"25158",1620,1019,1012,15,7,"ECP",142
25,"25005",279,175,175,4,0,"ECP",26
25,"25185",692,400,397,6,3,"ECP",58
8,"8043",3201,2056,2041,9,15,"ECP",631
25,"25109",231,163,162,2,1,"ECP",10
8,"8098",2381,1544,1534,5,10,"ECP",383
43,"43155",22873,14209,14082,153,127,"ECP",3437
17,"17009",4015,2584,2567,14,17,"ECP",404
17,"17184",1254,814,809,6,5,"ECP",102
8,"8004",223,165,164,2,1,"ECP",21
8,"8198",4411,2972,2954,23,18,"ECP",646
25,"25008",1124,715,702,10,13,"ECP",59
17,"17033",5307,3264,3241,29,23,"ECP",780
8,"8060",144,87,87,0,0,"ECP",12
8,"8058",1730,1102,1095,6,7,"ECP",325
25,"25001",144,73,73,0,0,"ECP",10
25,"25015",357,219,219,2,0,"ECP",39
17,"17189",1516,1076,1070,5,6,"ECP",108
17,"17030",641,400,398,1,2,"ECP",53
25,"25122",1915,1208,1197,16,11,"ECP",164
17,"17153",188,133,133,0,0,"ECP",27
17,"17204",572,355,354,4,1,"ECP",64
17,"17016",731,500,496,1,4,"ECP",65
43,"43144",1247,842,836,6,6,"ECP",176
43,"43049",728,464,461,4,3,"ECP",61
43,"43907",4374,2793,2783,24,10,"ECP",665
8,"8021",70,49,46,0,3,"ECP",11
17,"17069",374,256,251,0,5,"ECP",30
8,"8134",810,541,538,7,3,"ECP",115
25,"25172",1797,1170,1146,10,24,"ECP",125
8,"8184",53822,34744,34545,264,199,"ECP",10693
25,"25072",5850,3493,3444,29,49,"ECP",554
8,"8071",240,163,162,5,1,"ECP",30
25,"25021",2607,1490,1481,20,9,"ECP",273
43,"43019",1381,862,846,12,16,"ECP",173
25,"25092",130,98,95,2,3,"ECP",8
17,"17226",867,549,546,8,3,"ECP",73
17,"17149",364,248,248,0,0,"ECP",40
8,"8183",4550,2809,2796,20,13,"ECP",441
17,"17124",1607,1027,1007,11,20,"ECP",109
43,"43902",2743,1551,1531,23,20,"ECP",383
8,"8225",92,66,66,4,0,"ECP",4
17,"17083",2940,1895,1876,16,19,"ECP",479
8,"8084",1142,773,768,14,5,"ECP",158
25,"25120",92002,55658,55214,587,444,"ECP",10983
8,"8074",10611,6728,6679,52,49,"ECP",2080
17,"17163",2626,1764,1747,10,17,"ECP",241
43,"43035",254,156,155,2,1,"ECP",17
8,"8265",1553,1028,1018,11,10,"ECP",130
17,"17123",354,266,263,0,3,"ECP",28
25,"25149",1385,963,956,6,7,"ECP",109
43,"43032",517,332,329,5,3,"ECP",49
31,"31247",151,114,113,0,1,"EH Bildu",34
48,"48057",5723,3988,3962,26,26,"EH Bildu",1468
1,"1043",2304,1552,1532,13,20,"EH Bildu",136
31,"31045",508,355,350,8,5,"EH Bildu",17
1,"1046",601,432,428,3,4,"EH Bildu",35
31,"31081",338,216,212,4,4,"EH Bildu",55
20,"20005",1260,738,736,11,2,"EH Bildu",269
31,"31048",176,132,130,4,2,"EH Bildu",1
48,"48019",3553,2406,2397,18,9,"EH Bildu",452
31,"31092",662,439,435,4,4,"EH Bildu",88
48,"48034",12866,8798,8747,43,51,"EH Bildu",604
1,"1041",149,103,100,1,3,"EH Bildu",3
31,"31207",273,182,177,2,5,"EH Bildu",55
31,"31078",2429,1795,1767,15,28,"EH Bildu",33
31,"31175",71,48,48,0,0,"EH Bildu",3
20,"20078",1155,850,846,4,4,"EH Bildu",534
31,"31010",5705,3718,3680,29,38,"EH Bildu",623
31,"31192",156,129,127,3,2,"EH Bildu",7
48,"48008",606,424,414,6,10,"EH Bildu",46
1,"1003",1190,782,774,2,8,"EH Bildu",317
31,"31049",699,469,465,2,4,"EH Bildu",196
31,"31170",47,42,42,3,0,"EH Bildu",5
1,"1059",186557,126506,125278,798,1228,"EH Bildu",9794
31,"31188",235,161,161,2,0,"EH Bildu",24
31,"31144",796,445,444,6,1,"EH Bildu",145
31,"31224",893,671,662,3,9,"EH Bildu",12
31,"31255",102,79,79,1,0,"EH Bildu",4
1,"1030",156,129,129,3,0,"EH Bildu",8
48,"48003",14339,9918,9838,53,80,"EH Bildu",1895
20,"20004",252,121,121,0,0,"EH Bildu",21
48,"48028",717,543,537,3,6,"EH Bildu",238
1,"1020",327,237,234,3,3,"EH Bildu",51
31,"31037",84,66,66,1,0,"EH Bildu",27
31,"31026",144,118,117,0,1,"EH Bildu",4
31,"31070",2638,1808,1784,20,24,"EH Bildu",35
31,"31159",1107,844,833,6,11,"EH Bildu",135
31,"31085",480,350,350,2,0,"EH Bildu",101
48,"48013",79716,53419,52997,345,422,"EH Bildu",3052
31,"31055",257,175,172,2,3,"EH Bildu",40
48,"48905",2553,1792,1771,12,21,"EH Bildu",340
31,"31023",6956,5310,5289,85,21,"EH Bildu",267
31,"31046",57,39,39,1,0,"EH Bildu",2
1,"1034",161,124,123,1,1,"EH Bildu",19
31,"31146",35,30,29,1,1,"EH Bildu",2
20,"20036",13210,8518,8475,67,43,"EH Bildu",949
20,"20003",547,308,308,3,0,"EH Bildu",143
1,"1032",517,361,354,1,7,"EH Bildu",24
31,"31087",171,128,124,2,4,"EH Bildu",28
20,"20056",4082,2589,2570,27,19,"EH Bildu",717
48,"48907",348,266,266,2,0,"EH Bildu",78
20,"20019",9986,6428,6392,48,36,"EH Bildu",1145
1,"1031",1169,882,863,6,19,"EH Bildu",79
31,"31129",395,234,234,0,0,"EH Bildu",118
48,"48090",6001,4345,4295,28,50,"EH Bildu",378
31,"31148",92,69,69,5,0,"EH Bildu",3
1,"1018",1386,939,930,3,9,"EH Bildu",197
20,"20034",3145,2026,2014,14,12,"EH Bildu",500
31,"31140",117,84,84,1,0,"EH Bildu",12
48,"48065",3281,2271,2237,8,34,"EH Bildu",417
31,"31203",40,28,28,0,0,"EH Bildu",3
31,"31241",133,98,98,2,0,"EH Bildu",10
31,"31226",591,342,340,2,2,"EH Bildu",110
31,"31004",35,21,21,0,0,"EH Bildu",2
31,"31149",2305,1461,1441,8,20,"EH Bildu",635
1,"1056",219,136,135,0,1,"EH Bildu",20
48,"48078",38617,26366,26212,158,154,"EH Bildu",1643
20,"20045",46626,30525,30353,197,172,"EH Bildu",2133
31,"31068",2885,2060,2027,20,33,"EH Bildu",23
48,"48023",600,455,452,0,3,"EH Bildu",138
48,"48085",10338,7190,7153,39,37,"EH Bildu",1100
31,"31076",2417,1918,1906,9,12,"EH Bildu",109
48,"48063",372,279,277,2,2,"EH Bildu",82
31,"31100",262,170,168,1,2,"EH Bildu",17
48,"48902",19008,12566,12447,76,119,"EH Bildu",1089
31,"31054",462,255,250,4,5,"EH Bildu",69
31,"31052",96,62,61,0,1,"EH Bildu",2
31,"31125",274,194,193,6,1,"EH Bildu",16
1,"1062",313,211,210,2,1,"EH Bildu",10
31,"31225",36,27,27,0,0,"EH Bildu",1
31,"31903",6654,4402,4343,27,59,"EH Bildu",609
31,"31190",45,34,32,2,2,"EH Bildu",5
20,"20076",6990,4666,4648,29,18,"EH Bildu",1153
48,"48039",239,190,188,0,2,"EH Bildu",45
20,"20063",8017,5263,5231,35,32,"EH Bildu",2209
31,"31097",10410,7082,7002,75,80,"EH Bildu",804
31,"31212",147,102,102,4,0,"EH Bildu",1
48,"48009",783,586,575,1,11,"EH Bildu",199
48,"48914",332,272,272,1,0,"EH Bildu",92
1,"1033",651,484,479,2,5,"EH Bildu",38
31,"31096",113,82,79,0,3,"EH Bildu",13
31,"31249",1872,1290,1273,14,17,"EH Bildu",19
31,"31260",1238,794,788,12,6,"EH Bildu",112
1,"1002",8124,5722,5654,31,68,"EH Bildu",775
1,"1001",1979,1339,1318,7,21,"EH Bildu",145
48,"48012",2049,1527,1512,7,15,"EH Bildu",397
48,"48006",290,239,239,2,0,"EH Bildu",90
48,"48077",3364,2437,2431,18,6,"EH Bildu",338
31,"31166",258,181,181,1,0,"EH Bildu",10
31,"31136",447,299,298,2,1,"EH Bildu",51
31,"31093",292,188,188,2,0,"EH Bildu",43
31,"31210",196,152,152,2,0,"EH Bildu",30
31,"31252",87,61,61,0,0,"EH Bildu",16
31,"31223",985,704,698,4,6,"EH Bildu",99
1,"1023",267,187,186,1,1,"EH Bildu",15
31,"31169",2193,1472,1445,9,27,"EH Bildu",17
48,"48912",2308,1707,1679,14,28,"EH Bildu",260
48,"48072",977,716,713,4,3,"EH Bildu",282
31,"31128",359,265,263,0,2,"EH Bildu",53
48,"48088",136,102,102,0,0,"EH Bildu",51
20,"20050",266,170,169,1,1,"EH Bildu",93
31,"31024",99,42,42,0,0,"EH Bildu",16
1,"1006",175,140,140,0,0,"EH Bildu",7
48,"48005",115,63,61,0,2,"EH Bildu",18
20,"20047",469,307,304,5,3,"EH Bildu",149
48,"48038",1126,798,794,3,4,"EH Bildu",145
31,"31064",1424,1121,1104,3,17,"EH Bildu",17
31,"31017",358,242,239,0,3,"EH Bildu",44
31,"31211",27,15,15,1,0,"EH Bildu",0
20,"20012",147,99,98,5,1,"EH Bildu",45
48,"48050",191,147,146,0,1,"EH Bildu",62
31,"31230",106,82,82,1,0,"EH Bildu",5
20,"20062",973,653,653,11,0,"EH Bildu",209
31,"31069",832,637,635,3,2,"EH Bildu",52
31,"31135",106,70,66,2,4,"EH Bildu",0
31,"31090",144,77,77,1,0,"EH Bildu",6
31,"31904",1563,1029,1022,23,7,"EH Bildu",212
48,"48070",544,362,362,4,0,"EH Bildu",216
31,"31905",2843,1983,1966,15,17,"EH Bildu",68
31,"31103",42,34,34,2,0,"EH Bildu",3
20,"20074",11592,7954,7914,45,40,"EH Bildu",2261
48,"48060",3634,2143,2134,7,9,"EH Bildu",663
1,"1060",197,160,157,0,3,"EH Bildu",5
48,"48071",6087,4294,4254,32,40,"EH Bildu",353
31,"31003",122,87,87,0,0,"EH Bildu",31
48,"48047",159,111,111,0,0,"EH Bildu",60
31,"31018",393,292,285,4,7,"EH Bildu",21
1,"1053",582,321,320,4,1,"EH Bildu",66
48,"48091",1121,771,765,7,6,"EH Bildu",214
48,"48033",217,149,149,0,0,"EH Bildu",52
20,"20905",145,100,100,1,0,"EH Bildu",52
20,"20020",125,71,69,3,2,"EH Bildu",28
20,"20053",4774,2973,2953,13,20,"EH Bildu",821
31,"31067",1922,1312,1294,10,18,"EH Bildu",41
48,"48014",1211,806,801,7,5,"EH Bildu",138
31,"31030",141,100,99,0,1,"EH Bildu",20
31,"31155",256,169,167,2,2,"EH Bildu",5
31,"31062",1087,830,818,3,12,"EH Bildu",10
31,"31034",37,25,25,0,0,"EH Bildu",9
1,"1008",786,513,509,11,4,"EH Bildu",79
48,"48024",995,757,754,7,3,"EH Bildu",230
31,"31264",180,105,101,2,4,"EH Bildu",30
48,"48082",37605,25134,24938,176,196,"EH Bildu",2154
48,"48915",362,227,226,0,1,"EH Bildu",115
20,"20039",2111,1480,1472,14,8,"EH Bildu",554
31,"31208",2556,1949,1920,16,29,"EH Bildu",14
1,"1004",1399,1008,995,8,13,"EH Bildu",153
20,"20002",346,203,203,4,0,"EH Bildu",95
31,"31174",110,63,63,0,0,"EH Bildu",6
1,"1901",2354,1592,1571,8,21,"EH Bildu",103
20,"20009",11452,7388,7345,62,43,"EH Bildu",1300
20,"20051",6877,4699,4679,34,20,"EH Bildu",978
1,"1009",1265,849,845,2,4,"EH Bildu",178
31,"31061",54,49,49,0,0,"EH Bildu",0
48,"48059",400,294,291,0,3,"EH Bildu",101
31,"31124",208,148,148,2,0,"EH Bildu",11
48,"48030",606,441,439,1,2,"EH Bildu",140
31,"31180",212,154,154,5,0,"EH Bildu",11
31,"31258",7879,5707,5666,50,41,"EH Bildu",933
31,"31080",508,391,385,3,6,"EH Bildu",33
31,"31263",233,138,137,2,1,"EH Bildu",56
48,"48002",7829,5490,5451,44,39,"EH Bildu",520
1,"1019",150,106,105,1,1,"EH Bildu",6
20,"20018",11064,6719,6690,41,29,"EH Bildu",2286
20,"20071",14801,9466,9421,60,45,"EH Bildu",2271
31,"31262",228,179,178,5,1,"EH Bildu",18
31,"31256",107,59,59,0,0,"EH Bildu",20
31,"31154",224,126,126,3,0,"EH Bildu",24
20,"20067",30828,19984,19882,140,102,"EH Bildu",3247
48,"48067",1158,813,810,2,3,"EH Bildu",301
20,"20001",246,133,132,2,1,"EH Bildu",63
20,"20035",486,337,334,1,3,"EH Bildu",134
31,"31251",3115,2240,2205,15,35,"EH Bildu",102
31,"31219",84,66,66,0,0,"EH Bildu",0
20,"20038",387,261,259,0,2,"EH Bildu",109
31,"31902",4405,3092,3061,25,31,"EH Bildu",263
31,"31259",484,291,286,2,5,"EH Bildu",76
48,"48092",836,618,613,5,5,"EH Bildu",86
48,"48011",9673,6468,6423,45,45,"EH Bildu",821
48,"48064",606,447,445,4,2,"EH Bildu",149
31,"31079",73,54,53,0,1,"EH Bildu",0
48,"48058",968,647,646,2,1,"EH Bildu",203
20,"20058",755,529,525,3,4,"EH Bildu",95
31,"31031",220,131,129,0,2,"EH Bildu",56
31,"31243",306,224,221,2,3,"EH Bildu",35
48,"48069",12798,8679,8612,55,67,"EH Bildu",1122
31,"31253",129,109,109,0,0,"EH Bildu",40
31,"31254",1915,1428,1411,3,17,"EH Bildu",52
31,"31153",2159,1403,1387,12,16,"EH Bildu",370
48,"48068",1550,1130,1118,12,12,"EH Bildu",228
20,"20069",147046,100691,100232,836,459,"EH Bildu",12044
31,"31091",351,220,217,1,3,"EH Bildu",75
31,"31143",96,55,54,1,1,"EH Bildu",7
20,"20070",1092,748,746,5,2,"EH Bildu",337
31,"31150",213,156,155,1,1,"EH Bildu",34
48,"48018",869,522,522,2,0,"EH Bildu",203
20,"20030",21423,13960,13898,101,62,"EH Bildu",1913
31,"31198",37,25,25,0,0,"EH Bildu",10
31,"31014",275,194,192,4,2,"EH Bildu",28
31,"31206",2090,1461,1440,22,21,"EH Bildu",213
31,"31213",104,52,52,0,0,"EH Bildu",14
31,"31158",255,180,179,3,1,"EH Bildu",26
31,"31107",1710,1255,1243,16,12,"EH Bildu",9
31,"31217",321,226,223,1,3,"EH Bildu",12
31,"31059",186,131,131,1,0,"EH Bildu",30
48,"48910",2909,1950,1937,10,13,"EH Bildu",386
31,"31011",693,459,456,8,3,"EH Bildu",39
31,"31244",158,87,86,1,1,"EH Bildu",12
48,"48097",1297,900,894,8,6,"EH Bildu",136
1,"1014",371,280,272,4,8,"EH Bildu",16
31,"31074",387,286,286,5,0,"EH Bildu",73
31,"31177",255,169,166,2,3,"EH Bildu",7
48,"48027",22150,15089,14982,78,107,"EH Bildu",2456
48,"48037",673,481,478,5,3,"EH Bildu",88
48,"48007",364,240,240,5,0,"EH Bildu",107
20,"20023",441,252,251,1,1,"EH Bildu",100
20,"20079",17886,11860,11799,91,61,"EH Bildu",2333
48,"48044",62774,45594,45399,287,195,"EH Bildu",3857
31,"31013",642,406,401,1,5,"EH Bildu",51
31,"31012",793,563,555,6,8,"EH Bildu",18
1,"1049",138,109,109,1,0,"EH Bildu",19
31,"31108",1855,1368,1348,7,20,"EH Bildu",22
31,"31101",1373,973,966,8,7,"EH Bildu",137
31,"31246",140,111,107,1,4,"EH Bildu",9
31,"31167",826,606,596,9,10,"EH Bildu",52
1,"1013",712,454,450,0,4,"EH Bildu",104
20,"20068",190,135,135,3,0,"EH Bildu",63
31,"31047",254,191,188,2,3,"EH Bildu",20
20,"20073",4677,3014,2995,15,19,"EH Bildu",1109
31,"31113",133,87,86,0,1,"EH Bildu",7
48,"48049",549,416,416,1,0,"EH Bildu",112
31,"31109",1582,1155,1150,9,5,"EH Bildu",152
20,"20017",8559,5478,5435,24,43,"EH Bildu",1254
31,"31102",143,69,69,0,0,"EH Bildu",18
20,"20021",200,100,100,2,0,"EH Bildu",34
31,"31025",766,524,518,6,6,"EH Bildu",103
20,"20052",1090,779,776,8,3,"EH Bildu",233
20,"20904",95,44,44,2,0,"EH Bildu",24
20,"20008",716,362,361,6,1,"EH Bildu",143
48,"48903",1835,1361,1351,7,10,"EH Bildu",116
31,"31051",251,170,170,2,0,"EH Bildu",7
31,"31151",66,46,46,1,0,"EH Bildu",3
20,"20007",310,218,218,3,0,"EH Bildu",112
31,"31073",294,212,208,2,4,"EH Bildu",84
31,"31908",1004,686,682,2,4,"EH Bildu",118
31,"31063",92,75,73,2,2,"EH Bildu",11
31,"31194",311,217,216,3,1,"EH Bildu",35
20,"20060",88,67,67,2,0,"EH Bildu",64
31,"31041",1606,1114,1101,15,13,"EH Bildu",87
31,"31233",97,74,74,0,0,"EH Bildu",0
48,"48087",427,344,338,0,6,"EH Bildu",27
31,"31137",205,112,109,6,3,"EH Bildu",10
31,"31237",193,155,153,2,2,"EH Bildu",6
31,"31238",112,93,93,0,0,"EH Bildu",12
48,"48051",213,163,163,0,0,"EH Bildu",17
20,"20027",2814,1761,1750,15,11,"EH Bildu",649
31,"31200",761,517,508,3,9,"EH Bildu",76
1,"1017",849,571,565,5,6,"EH Bildu",90
31,"31214",91,64,62,1,2,"EH Bildu",12
20,"20031",176,90,90,0,0,"EH Bildu",40
31,"31053",523,372,368,1,4,"EH Bildu",29
48,"48901",4839,3459,3426,32,33,"EH Bildu",336
31,"31242",260,164,163,1,1,"EH Bildu",19
31,"31163",2013,1418,1383,13,35,"EH Bildu",26
31,"31193",1426,1024,1013,13,11,"EH Bildu",142
31,"31189",1161,720,709,6,11,"EH Bildu",202
31,"31179",502,348,345,0,3,"EH Bildu",11
48,"48045",5167,3809,3757,28,52,"EH Bildu",483
48,"48025",883,642,637,7,5,"EH Bildu",191
31,"31105",1507,1167,1142,7,25,"EH Bildu",7
20,"20043",1739,1090,1088,9,2,"EH Bildu",363
48,"48079",427,305,304,2,1,"EH Bildu",102
31,"31216",3865,2702,2671,33,31,"EH Bildu",172
20,"20907",118,85,85,2,0,"EH Bildu",36
31,"31221",1214,798,786,12,12,"EH Bildu",167
31,"31168",246,172,171,1,1,"EH Bildu",20
48,"48029",8338,5721,5683,37,38,"EH Bildu",315
48,"48026",1140,830,823,5,7,"EH Bildu",352
31,"31187",111,68,63,1,5,"EH Bildu",15
1,"1037",587,411,408,1,3,"EH Bildu",61
31,"31117",620,383,375,3,8,"EH Bildu",253
31,"31147",100,82,82,2,0,"EH Bildu",3
31,"31173",861,683,667,3,16,"EH Bildu",2
20,"20041",255,123,123,0,0,"EH Bildu",38
31,"31195",182,130,128,0,2,"EH Bildu",40
31,"31199",146,92,89,3,3,"EH Bildu",22
31,"31044",289,230,227,1,3,"EH Bildu",85
31,"31095",75,59,59,1,0,"EH Bildu",16
20,"20037",99,64,64,2,0,"EH Bildu",29
48,"48066",348,258,258,1,0,"EH Bildu",66
31,"31111",95,65,65,2,0,"EH Bildu",15
1,"1039",209,155,153,0,2,"EH Bildu",10
31,"31019",1785,1254,1238,9,16,"EH Bildu",342
1,"1010",2268,1623,1603,11,20,"EH Bildu",234
31,"31060",13744,9400,9320,72,80,"EH Bildu",942
31,"31086",13188,9713,9642,111,71,"EH Bildu",674
20,"20046",1223,739,737,5,2,"EH Bildu",201
1,"1011",235,174,171,4,3,"EH Bildu",4
48,"48074",3312,2330,2309,6,21,"EH Bildu",421
48,"48054",24171,16797,16711,118,86,"EH Bildu",1197
1,"1044",236,169,167,0,2,"EH Bildu",14
31,"31197",69,56,56,2,0,"EH Bildu",6
31,"31112",89,62,62,0,0,"EH Bildu",11
31,"31245",81,55,55,2,0,"EH Bildu",11
31,"31042",2714,1974,1942,22,32,"EH Bildu",9
31,"31141",110,71,70,1,1,"EH Bildu",0
48,"48095",2347,1555,1546,12,9,"EH Bildu",326
31,"31156",251,189,188,0,1,"EH Bildu",32
31,"31235",159,117,115,2,2,"EH Bildu",22
31,"31186",299,195,194,3,1,"EH Bildu",51
48,"48004",335,222,222,0,0,"EH Bildu",90
20,"20013",5415,3602,3579,19,23,"EH Bildu",913
1,"1055",838,538,527,8,11,"EH Bildu",49
31,"31021",62,39,38,0,1,"EH Bildu",9
31,"31057",1781,1287,1268,10,19,"EH Bildu",2
31,"31261",231,173,169,3,4,"EH Bildu",3
31,"31161",338,264,259,2,5,"EH Bildu",38
31,"31114",366,245,241,8,4,"EH Bildu",22
31,"31202",4305,2845,2803,31,42,"EH Bildu",36
31,"31036",909,636,628,7,8,"EH Bildu",38
31,"31088",5572,3897,3862,44,35,"EH Bildu",245
20,"20077",5213,3614,3591,36,23,"EH Bildu",712
20,"20049",4122,2677,2666,15,11,"EH Bildu",869
31,"31184",62,44,44,3,0,"EH Bildu",13
31,"31121",62,44,43,0,1,"EH Bildu",3
1,"1022",799,557,544,2,13,"EH Bildu",22
31,"31162",47,31,31,0,0,"EH Bildu",4
31,"31209",155,107,106,0,1,"EH Bildu",9
20,"20901",1437,908,906,2,2,"EH Bildu",169
1,"1042",904,653,648,6,5,"EH Bildu",128
31,"31119",39,26,26,0,0,"EH Bildu",3
31,"31231",117,76,73,1,3,"EH Bildu",4
1,"1047",968,673,668,5,5,"EH Bildu",20
31,"31227",8180,5885,5809,76,76,"EH Bildu",724
31,"31008",75,54,54,2,0,"EH Bildu",3
31,"31122",4773,3520,3506,26,14,"EH Bildu",440
31,"31123",647,369,361,5,8,"EH Bildu",87
20,"20016",1520,826,821,2,5,"EH Bildu",216
31,"31234",144,106,106,4,0,"EH Bildu",8
31,"31145",172,128,128,4,0,"EH Bildu",1
31,"31016",7608,5474,5413,50,61,"EH Bildu",710
1,"1016",433,228,226,5,2,"EH Bildu",24
31,"31130",312,214,213,3,1,"EH Bildu",52
20,"20029",4281,2813,2802,19,11,"EH Bildu",684
31,"31205",427,299,297,4,2,"EH Bildu",9
31,"31160",106,89,88,2,1,"EH Bildu",8
20,"20072",4728,2902,2886,21,16,"EH Bildu",444
20,"20080",7910,5294,5260,49,34,"EH Bildu",664
31,"31906",2562,1800,1779,26,21,"EH Bildu",130
20,"20040",15289,9444,9373,66,71,"EH Bildu",2879
31,"31002",414,288,287,3,1,"EH Bildu",19
20,"20065",3012,1985,1967,12,18,"EH Bildu",527
20,"20903",4330,2756,2734,28,22,"EH Bildu",625
1,"1058",1345,799,793,7,6,"EH Bildu",180
31,"31228",486,341,337,2,4,"EH Bildu",12
1,"1061",154,127,127,1,0,"EH Bildu",39
31,"31077",5352,3908,3848,41,60,"EH Bildu",44
31,"31001",88,62,62,0,0,"EH Bildu",10
1,"1028",1070,716,710,3,6,"EH Bildu",75
31,"31066",855,589,579,8,10,"EH Bildu",11
48,"48080",9976,6820,6763,62,57,"EH Bildu",592
31,"31131",901,646,638,7,8,"EH Bildu",45
20,"20022",839,473,472,4,1,"EH Bildu",181
31,"31033",49,31,31,1,0,"EH Bildu",7
48,"48084",22449,14670,14553,90,117,"EH Bildu",953
20,"20026",197,145,133,0,12,"EH Bildu",59
20,"20081",7470,4856,4833,40,23,"EH Bildu",1191
31,"31029",914,638,625,6,13,"EH Bildu",31
48,"48036",24073,16076,15971,86,105,"EH Bildu",2023
48,"48048",557,395,393,5,2,"EH Bildu",123
48,"48052",1562,1160,1150,4,10,"EH Bildu",484
31,"31035",59,45,43,0,2,"EH Bildu",2
48,"48908",249,181,181,0,0,"EH Bildu",51
48,"48094",3161,2094,2073,12,21,"EH Bildu",593
20,"20064",12503,7803,7755,52,48,"EH Bildu",1397
48,"48020",273626,184710,183628,1185,1082,"EH Bildu",13791
31,"31126",358,223,223,2,0,"EH Bildu",72
31,"31038",1339,957,942,11,15,"EH Bildu",47
20,"20906",119,87,87,1,0,"EH Bildu",38
31,"31127",138,98,95,0,3,"EH Bildu",19
31,"31020",449,228,228,3,0,"EH Bildu",103
31,"31181",145,112,112,0,0,"EH Bildu",40
31,"31142",1403,958,949,10,9,"EH Bildu",99
20,"20024",386,210,209,3,1,"EH Bildu",98
48,"48083",6958,4885,4856,40,29,"EH Bildu",361
31,"31058",208,148,144,3,4,"EH Bildu",21
31,"31220",744,583,579,8,4,"EH Bildu",7
48,"48021",1336,908,899,1,9,"EH Bildu",200
1,"1054",960,654,651,4,3,"EH Bildu",198
31,"31009",677,507,505,5,2,"EH Bildu",45
31,"31006",1927,1350,1332,13,18,"EH Bildu",16
31,"31027",836,532,530,2,2,"EH Bildu",249
31,"31907",10745,8067,8009,116,58,"EH Bildu",666
48,"48022",2336,1444,1433,6,11,"EH Bildu",107
48,"48035",413,293,292,1,1,"EH Bildu",63
31,"31110",91,61,58,1,3,"EH Bildu",3
31,"31157",3518,2298,2267,23,31,"EH Bildu",78
20,"20028",2237,1373,1365,11,8,"EH Bildu",441
31,"31178",490,345,342,3,3,"EH Bildu",2
48,"48913",1248,884,869,10,15,"EH Bildu",97
48,"48096",6577,4794,4728,31,66,"EH Bildu",403
31,"31007",131,87,86,1,1,"EH Bildu",8
48,"48906",766,547,544,0,3,"EH Bildu",155
20,"20044",367,236,236,0,0,"EH Bildu",96
31,"31099",62,47,47,2,0,"EH Bildu",9
48,"48073",6910,4306,4271,31,35,"EH Bildu",1640
48,"48043",4423,3118,3108,17,10,"EH Bildu",434
48,"48016",5271,3694,3674,24,20,"EH Bildu",466
31,"31185",494,341,341,1,0,"EH Bildu",76
1,"1052",245,184,181,0,3,"EH Bildu",29
48,"48076",308,218,217,2,1,"EH Bildu",43
31,"31065",1878,1351,1326,20,25,"EH Bildu",30
31,"31075",103,63,63,0,0,"EH Bildu",8
48,"48075",1996,1364,1359,6,5,"EH Bildu",248
48,"48089",3306,2341,2329,20,12,"EH Bildu",328
48,"48081",1868,1361,1350,4,11,"EH Bildu",247
20,"20057",196,122,122,0,0,"EH Bildu",64
1,"1063",1798,1269,1261,19,8,"EH Bildu",209
31,"31248",299,165,162,0,3,"EH Bildu",27
31,"31089",242,172,170,1,2,"EH Bildu",5
31,"31022",518,332,331,4,1,"EH Bildu",114
31,"31201",147715,105455,104658,1007,797,"EH Bildu",9576
48,"48041",693,533,529,3,4,"EH Bildu",118
20,"20061",4273,2601,2590,21,11,"EH Bildu",614
20,"20006",259,143,143,3,0,"EH Bildu",53
31,"31094",111,82,82,0,0,"EH Bildu",4
31,"31032",1713,1209,1193,24,16,"EH Bildu",14
31,"31134",176,125,124,0,1,"EH Bildu",17
48,"48086",2050,1414,1401,5,13,"EH Bildu",188
31,"31171",680,495,486,8,9,"EH Bildu",17
20,"20066",454,236,234,1,2,"EH Bildu",157
31,"31028",212,131,131,0,0,"EH Bildu",33
31,"31083",52,37,37,0,0,"EH Bildu",6
20,"20025",1143,765,760,8,5,"EH Bildu",294
48,"48053",895,666,662,6,4,"EH Bildu",91
48,"48001",5838,3923,3898,28,25,"EH Bildu",835
31,"31050",6014,3489,3450,57,39,"EH Bildu",860
20,"20055",17475,11073,10997,56,76,"EH Bildu",2630
31,"31133",43,28,28,0,0,"EH Bildu",12
31,"31056",174,121,120,0,1,"EH Bildu",14
31,"31901",15459,11119,11026,108,93,"EH Bildu",862
20,"20033",868,600,599,1,1,"EH Bildu",214
31,"31232",25155,17648,17450,196,198,"EH Bildu",333
48,"48032",5743,4065,4048,29,17,"EH Bildu",1150
31,"31084",1940,1293,1274,16,19,"EH Bildu",554
31,"31040",192,139,138,4,1,"EH Bildu",26
20,"20048",182,100,98,2,2,"EH Bildu",44
20,"20042",3228,1967,1958,27,9,"EH Bildu",546
31,"31176",2869,2010,1963,33,47,"EH Bildu",29
20,"20015",1265,858,851,7,7,"EH Bildu",460
48,"48904",3511,2625,2600,22,25,"EH Bildu",275
48,"48042",1369,1068,1053,7,15,"EH Bildu",63
48,"48056",966,705,700,5,5,"EH Bildu",154
48,"48061",762,565,561,0,4,"EH Bildu",94
48,"48046",12611,8836,8794,39,42,"EH Bildu",2023
31,"31015",1994,1412,1392,25,20,"EH Bildu",51
31,"31191",3016,2167,2147,22,20,"EH Bildu",66
48,"48017",13261,8543,8482,42,61,"EH Bildu",1884
31,"31196",38,35,35,1,0,"EH Bildu",7
31,"31104",1834,1257,1235,16,22,"EH Bildu",53
20,"20010",1499,992,986,9,6,"EH Bildu",352
48,"48911",380,276,272,1,4,"EH Bildu",153
31,"31082",617,371,365,10,6,"EH Bildu",85
20,"20014",1108,611,609,4,2,"EH Bildu",249
48,"48040",1281,877,869,3,8,"EH Bildu",165
31,"31222",62,36,34,3,2,"EH Bildu",6
48,"48015",33581,22727,22528,122,199,"EH Bildu",1657
31,"31257",875,634,625,8,9,"EH Bildu",52
31,"31236",1320,865,854,5,11,"EH Bildu",145
31,"31132",145,109,109,0,0,"EH Bildu",27
48,"48062",302,237,236,4,1,"EH Bildu",72
20,"20032",8797,5672,5630,40,42,"EH Bildu",1097
31,"31239",322,211,211,5,0,"EH Bildu",38
20,"20011",1658,1219,1210,7,9,"EH Bildu",469
31,"31039",80,61,60,0,1,"EH Bildu",14
31,"31138",932,601,599,2,2,"EH Bildu",227
1,"1051",3603,2259,2235,17,24,"EH Bildu",444
31,"31120",388,250,249,3,1,"EH Bildu",35
20,"20075",4371,2692,2679,18,13,"EH Bildu",774
31,"31182",34,28,28,0,0,"EH Bildu",2
1,"1036",14955,10052,9959,55,93,"EH Bildu",1460
31,"31265",82,53,53,2,0,"EH Bildu",7
1,"1902",734,514,502,4,12,"EH Bildu",29
31,"31098",1903,1428,1419,19,9,"EH Bildu",176
48,"48093",893,653,643,7,10,"EH Bildu",214
31,"31172",373,278,272,3,6,"EH Bildu",22
31,"31118",164,112,111,1,1,"EH Bildu",12
31,"31106",698,533,529,3,4,"EH Bildu",11
31,"31229",47,35,35,0,0,"EH Bildu",5
31,"31204",36,28,28,1,0,"EH Bildu",1
31,"31115",165,102,101,1,1,"EH Bildu",33
1,"1057",240,201,200,1,1,"EH Bildu",43
31,"31240",527,327,326,2,1,"EH Bildu",119
31,"31152",1328,924,900,11,24,"EH Bildu",32
20,"20054",447,286,284,2,2,"EH Bildu",189
48,"48031",332,233,231,1,2,"EH Bildu",67
48,"48010",458,318,317,0,1,"EH Bildu",67
31,"31071",17,16,16,0,0,"EH Bildu",0
48,"48055",2668,1872,1849,11,23,"EH Bildu",500
31,"31072",5279,3734,3679,40,55,"EH Bildu",38
31,"31165",2780,1995,1960,30,35,"EH Bildu",26
1,"1021",473,310,309,0,1,"EH Bildu",22
31,"31139",159,96,95,0,1,"EH Bildu",10
20,"20902",14156,9664,9613,74,51,"EH Bildu",1378
31,"31005",301,212,211,3,1,"EH Bildu",14
31,"31250",2810,1786,1770,19,16,"EH Bildu",379
31,"31183",691,544,542,4,2,"EH Bildu",53
31,"31215",4676,3284,3240,36,44,"EH Bildu",28
20,"20059",8874,5873,5855,29,18,"EH Bildu",1971
31,"31043",38,31,30,1,1,"EH Bildu",0
31,"31116",62,51,50,1,1,"EH Bildu",2
31,"31164",568,421,417,5,4,"EH Bildu",1
48,"48909",209,161,161,0,0,"EH Bildu",80
1,"1027",416,257,254,3,3,"EH Bildu",37
22,"22247",33,20,20,0,0,"ENTABAN",0
22,"22223",75,58,58,0,0,"ENTABAN",0
22,"22082",291,213,212,1,1,"ENTABAN",2
22,"22018",327,245,244,3,1,"ENTABAN",0
22,"22906",186,141,139,3,2,"ENTABAN",1
22,"22252",121,86,81,0,5,"ENTABAN",0
22,"22057",370,271,270,3,1,"ENTABAN",0
22,"22905",281,209,209,1,0,"ENTABAN",0
22,"22124",201,144,143,1,1,"ENTABAN",0
22,"22234",794,552,544,3,8,"ENTABAN",0
22,"22190",119,86,85,0,1,"ENTABAN",0
22,"22212",79,64,62,0,2,"ENTABAN",0
22,"22025",1071,676,669,18,7,"ENTABAN",2
22,"22084",535,403,399,4,4,"ENTABAN",2
22,"22199",7000,4737,4688,104,49,"ENTABAN",11
22,"22157",192,129,128,3,1,"ENTABAN",0
22,"22083",463,394,390,5,4,"ENTABAN",1
22,"22116",1430,1004,994,5,10,"ENTABAN",3
22,"22165",487,364,360,6,4,"ENTABAN",0
22,"22236",253,200,200,0,0,"ENTABAN",0
22,"22230",284,216,216,1,0,"ENTABAN",1
22,"22058",194,164,162,1,2,"ENTABAN",1
22,"22051",100,81,81,0,0,"ENTABAN",0
22,"22081",254,181,181,0,0,"ENTABAN",0
22,"22085",104,86,86,0,0,"ENTABAN",0
22,"22016",601,413,411,6,2,"ENTABAN",0
22,"22008",173,137,133,3,4,"ENTABAN",0
22,"22125",38773,27021,26732,258,289,"ENTABAN",100
22,"22232",93,71,69,1,2,"ENTABAN",0
22,"22032",110,76,74,0,2,"ENTABAN",0
22,"22110",738,531,527,4,4,"ENTABAN",0
22,"22206",193,129,128,1,1,"ENTABAN",0
22,"22107",112,74,74,0,0,"ENTABAN",0
22,"22248",116,92,90,1,2,"ENTABAN",0
22,"22022",552,414,408,6,6,"ENTABAN",4
22,"22901",742,478,470,5,8,"ENTABAN",4
22,"22019",180,151,150,2,1,"ENTABAN",0
22,"22094",101,74,74,1,0,"ENTABAN",0
22,"22103",682,508,502,3,6,"ENTABAN",2
22,"22014",243,192,188,3,4,"ENTABAN",1
22,"22006",298,204,204,5,0,"ENTABAN",0
22,"22172",556,372,370,6,2,"ENTABAN",0
22,"22050",88,77,77,0,0,"ENTABAN",0
22,"22064",166,122,121,1,1,"ENTABAN",0
22,"22135",189,128,127,0,1,"ENTABAN",0
22,"22044",252,198,197,0,1,"ENTABAN",2
22,"22062",167,116,116,1,0,"ENTABAN",0
22,"22087",67,45,45,2,0,"ENTABAN",0
22,"22215",128,96,96,1,0,"ENTABAN",1
22,"22177",98,75,75,0,0,"ENTABAN",0
22,"22168",23,18,18,0,0,"ENTABAN",0
22,"22096",301,240,240,0,0,"ENTABAN",0
22,"22188",82,60,59,6,1,"ENTABAN",0
22,"22130",10092,6671,6608,59,63,"ENTABAN",15
22,"22119",1291,942,935,5,7,"ENTABAN",1
22,"22028",371,282,280,3,2,"ENTABAN",0
22,"22067",65,50,50,1,0,"ENTABAN",0
22,"22226",767,570,562,10,8,"ENTABAN",3
22,"22029",127,100,100,0,0,"ENTABAN",0
22,"22218",43,33,33,0,0,"ENTABAN",0
22,"22052",925,712,710,8,2,"ENTABAN",0
22,"22213",3003,2169,2131,19,38,"ENTABAN",3
22,"22039",863,671,667,4,4,"ENTABAN",2
22,"22129",183,120,118,1,2,"ENTABAN",0
22,"22060",1164,858,850,3,8,"ENTABAN",0
22,"22113",495,370,368,4,2,"ENTABAN",0
22,"22253",61,52,52,0,0,"ENTABAN",0
22,"22163",425,360,355,0,5,"ENTABAN",0
22,"22015",319,234,228,3,6,"ENTABAN",0
22,"22207",125,72,71,2,1,"ENTABAN",0
22,"22059",1149,807,800,3,7,"ENTABAN",1
22,"22020",115,86,86,1,0,"ENTABAN",0
22,"22037",115,86,86,0,0,"ENTABAN",2
22,"22074",313,228,225,4,3,"ENTABAN",2
22,"22149",305,228,228,0,0,"ENTABAN",0
22,"22164",35,28,28,0,0,"ENTABAN",0
22,"22903",652,514,507,1,7,"ENTABAN",1
22,"22250",353,261,258,4,3,"ENTABAN",0
22,"22035",234,165,159,3,6,"ENTABAN",1
22,"22128",188,146,144,3,2,"ENTABAN",0
22,"22102",179,141,138,2,3,"ENTABAN",0
22,"22205",438,322,320,0,2,"ENTABAN",0
22,"22155",76,51,51,0,0,"ENTABAN",0
22,"22076",311,201,199,0,2,"ENTABAN",0
22,"22214",128,106,105,3,1,"ENTABAN",0
22,"22126",88,64,64,0,0,"ENTABAN",0
22,"22197",473,354,354,1,0,"ENTABAN",3
22,"22174",478,379,378,2,1,"ENTABAN",0
22,"22229",114,80,80,1,0,"ENTABAN",0
22,"22156",289,220,220,2,0,"ENTABAN",2
22,"22244",52,38,37,0,1,"ENTABAN",0
22,"22048",12598,8790,8731,91,59,"ENTABAN",137
22,"22011",88,71,69,0,2,"ENTABAN",1
22,"22902",221,159,156,0,3,"ENTABAN",0
22,"22043",93,66,65,0,1,"ENTABAN",0
22,"22078",438,319,316,3,3,"ENTABAN",0
22,"22002",107,95,95,0,0,"ENTABAN",0
22,"22175",197,143,142,1,1,"ENTABAN",1
22,"22068",79,60,60,0,0,"ENTABAN",1
22,"22181",92,61,61,2,0,"ENTABAN",0
22,"22158",11995,8197,8126,62,71,"ENTABAN",15
22,"22225",2679,1700,1665,17,35,"ENTABAN",5
22,"22042",117,95,92,0,3,"ENTABAN",0
22,"22027",329,221,218,0,3,"ENTABAN",0
22,"22111",154,103,102,0,1,"ENTABAN",0
22,"22193",276,225,224,2,1,"ENTABAN",0
22,"22141",117,91,90,1,1,"ENTABAN",1
22,"22151",93,64,64,1,0,"ENTABAN",0
22,"22235",98,76,76,1,0,"ENTABAN",0
22,"22186",181,130,129,1,1,"ENTABAN",0
22,"22115",360,257,256,3,1,"ENTABAN",1
22,"22143",217,143,141,1,2,"ENTABAN",0
22,"22907",1435,1059,1046,18,13,"ENTABAN",5
22,"22055",320,243,238,2,5,"ENTABAN",0
22,"22131",82,63,63,0,0,"ENTABAN",0
22,"22069",429,333,331,2,2,"ENTABAN",0
22,"22162",130,102,102,0,0,"ENTABAN",0
22,"22202",141,119,119,0,0,"ENTABAN",0
22,"22189",185,145,144,5,1,"ENTABAN",0
22,"22200",244,184,182,5,2,"ENTABAN",0
22,"22114",123,81,81,0,0,"ENTABAN",0
22,"22109",261,191,190,1,1,"ENTABAN",0
22,"22001",225,151,151,1,0,"ENTABAN",0
22,"22072",191,136,135,0,1,"ENTABAN",0
22,"22176",173,134,130,1,4,"ENTABAN",0
22,"22046",728,566,561,5,5,"ENTABAN",0
22,"22017",866,650,642,5,8,"ENTABAN",1
22,"22221",84,58,58,0,0,"ENTABAN",0
22,"22127",505,374,371,3,3,"ENTABAN",2
22,"22220",166,126,125,2,1,"ENTABAN",0
22,"22045",82,65,64,1,1,"ENTABAN",0
22,"22007",792,581,581,8,0,"ENTABAN",0
22,"22112",9566,6354,6305,56,49,"ENTABAN",8
22,"22150",472,331,330,1,1,"ENTABAN",2
22,"22021",1971,1414,1398,17,16,"ENTABAN",3
22,"22187",293,218,216,2,2,"ENTABAN",0
22,"22242",62,45,44,0,1,"ENTABAN",0
22,"22061",6630,4555,4526,40,29,"ENTABAN",6
22,"22170",651,498,491,5,7,"ENTABAN",0
22,"22173",232,152,152,3,0,"ENTABAN",0
22,"22054",1542,1091,1077,13,14,"ENTABAN",1
22,"22233",82,57,57,3,0,"ENTABAN",0
22,"22036",92,77,77,0,0,"ENTABAN",0
22,"22217",385,287,281,1,6,"ENTABAN",0
22,"22077",379,279,273,2,6,"ENTABAN",0
22,"22182",250,161,158,1,3,"ENTABAN",0
22,"22041",163,134,134,1,0,"ENTABAN",0
22,"22004",135,81,80,0,1,"ENTABAN",0
22,"22023",421,313,309,6,4,"ENTABAN",0
22,"22195",235,182,181,3,1,"ENTABAN",0
22,"22178",103,82,81,0,1,"ENTABAN",0
22,"22086",215,161,159,1,2,"ENTABAN",0
22,"22137",1069,727,718,3,9,"ENTABAN",0
22,"22003",137,110,107,1,3,"ENTABAN",0
22,"22012",111,87,86,3,1,"ENTABAN",0
22,"22243",45,28,28,0,0,"ENTABAN",0
22,"22122",64,57,57,2,0,"ENTABAN",0
22,"22239",88,72,72,0,0,"ENTABAN",1
22,"22117",2478,1714,1693,22,21,"ENTABAN",2
22,"22013",288,216,210,3,6,"ENTABAN",0
22,"22228",514,364,360,5,4,"ENTABAN",0
22,"22227",206,163,160,3,3,"ENTABAN",1
22,"22144",243,188,187,1,1,"ENTABAN",0
22,"22133",115,81,80,1,1,"ENTABAN",0
22,"22908",197,142,140,3,2,"ENTABAN",1
22,"22139",79,64,64,1,0,"ENTABAN",0
22,"22222",530,384,379,3,5,"ENTABAN",1
22,"22209",155,120,120,3,0,"ENTABAN",0
22,"22203",83,67,67,1,0,"ENTABAN",0
22,"22246",76,50,50,0,0,"ENTABAN",0
22,"22090",99,71,71,0,0,"ENTABAN",0
22,"22251",364,284,284,0,0,"ENTABAN",0
22,"22249",116,95,95,4,0,"ENTABAN",0
22,"22088",153,110,110,2,0,"ENTABAN",0
22,"22245",309,267,261,1,6,"ENTABAN",0
22,"22136",806,588,588,5,0,"ENTABAN",0
22,"22095",72,58,58,1,0,"ENTABAN",0
22,"22167",493,388,381,9,7,"ENTABAN",0
22,"22254",1124,801,792,11,9,"ENTABAN",0
22,"22053",789,520,513,9,7,"ENTABAN",1
22,"22099",483,379,377,4,2,"ENTABAN",0
22,"22160",209,168,168,6,0,"ENTABAN",0
22,"22024",226,174,171,3,3,"ENTABAN",1
22,"22049",78,64,64,0,0,"ENTABAN",0
22,"22201",266,188,187,3,1,"ENTABAN",0
22,"22047",243,205,203,2,2,"ENTABAN",1
22,"22080",280,197,194,6,3,"ENTABAN",0
22,"22089",302,225,223,0,2,"ENTABAN",0
22,"22105",114,78,77,2,1,"ENTABAN",0
22,"22040",144,117,115,1,2,"ENTABAN",0
22,"22904",815,579,575,8,4,"ENTABAN",0
22,"22063",169,133,129,1,4,"ENTABAN",0
22,"22009",617,444,441,6,3,"ENTABAN",0
22,"22075",125,83,83,1,0,"ENTABAN",0
22,"22066",702,502,498,7,4,"ENTABAN",1
22,"22204",1114,745,739,12,6,"ENTABAN",0
22,"22208",188,150,145,0,5,"ENTABAN",0
22,"22184",184,155,155,3,0,"ENTABAN",0
22,"22909",315,226,225,4,1,"ENTABAN",0
22,"22142",97,75,74,1,1,"ENTABAN",0
22,"22106",22,14,14,0,0,"ENTABAN",0
22,"22079",118,83,83,1,0,"ENTABAN",0
17,"17098",301,192,188,2,4,"ERC-CATSÍ",59
25,"25089",105,60,59,0,1,"ERC-CATSÍ",19
25,"25096",902,534,525,10,9,"ERC-CATSÍ",163
8,"8118",17547,12183,12108,105,75,"ERC-CATSÍ",2814
17,"17103",4954,2877,2850,25,27,"ERC-CATSÍ",488
8,"8167",5910,4081,4051,40,30,"ERC-CATSÍ",347
8,"8092",3736,2369,2342,13,27,"ERC-CATSÍ",755
17,"17109",696,422,419,1,3,"ERC-CATSÍ",153
43,"43162",4346,2983,2958,21,25,"ERC-CATSÍ",551
8,"8076",16169,10652,10563,75,89,"ERC-CATSÍ",1735
17,"17050",652,453,453,3,0,"ERC-CATSÍ",203
25,"25151",685,425,419,7,6,"ERC-CATSÍ",131
25,"25121",644,415,410,8,5,"ERC-CATSÍ",33
8,"8078",219,112,111,3,1,"ERC-CATSÍ",35
43,"43075",89,61,60,1,1,"ERC-CATSÍ",17
43,"43121",599,354,348,1,6,"ERC-CATSÍ",155
8,"8114",18292,12102,12009,72,93,"ERC-CATSÍ",1614
25,"25040",10546,6367,6300,61,67,"ERC-CATSÍ",1547
25,"25039",277,181,180,3,1,"ERC-CATSÍ",58
17,"17090",545,370,368,4,2,"ERC-CATSÍ",119
17,"17173",180,132,131,0,1,"ERC-CATSÍ",51
8,"8011",1756,1087,1082,16,5,"ERC-CATSÍ",497
43,"43007",641,456,455,3,1,"ERC-CATSÍ",141
43,"43067",552,397,393,2,4,"ERC-CATSÍ",167
25,"25226",253,155,152,3,3,"ERC-CATSÍ",35
25,"25115",824,489,487,7,2,"ERC-CATSÍ",119
17,"17182",263,181,181,6,0,"ERC-CATSÍ",15
8,"8237",1643,1105,1096,8,9,"ERC-CATSÍ",365
25,"25111",117,72,70,2,2,"ERC-CATSÍ",12
8,"8182",2811,1799,1789,22,10,"ERC-CATSÍ",237
8,"8037",1864,1242,1230,14,12,"ERC-CATSÍ",478
17,"17046",717,459,458,4,1,"ERC-CATSÍ",154
43,"43157",353,268,264,5,4,"ERC-CATSÍ",101
17,"17085",301,215,214,5,1,"ERC-CATSÍ",90
43,"43074",1754,1170,1157,9,13,"ERC-CATSÍ",360
43,"43078",846,543,531,8,12,"ERC-CATSÍ",136
8,"8148",2233,1491,1483,7,8,"ERC-CATSÍ",223
8,"8090",128,101,101,2,0,"ERC-CATSÍ",30
8,"8013",1224,802,793,9,9,"ERC-CATSÍ",199
8,"8106",7279,4871,4845,40,26,"ERC-CATSÍ",1135
43,"43112",279,175,174,0,1,"ERC-CATSÍ",65
43,"43116",451,324,317,5,7,"ERC-CATSÍ",113
25,"25220",1015,634,632,1,2,"ERC-CATSÍ",183
8,"8242",219,153,153,4,0,"ERC-CATSÍ",49
8,"8291",4536,2975,2965,21,10,"ERC-CATSÍ",601
8,"8187",152377,102805,102199,805,606,"ERC-CATSÍ",16195
43,"43147",524,381,373,4,8,"ERC-CATSÍ",139
43,"43079",364,248,248,0,0,"ERC-CATSÍ",69
8,"8255",134,78,78,0,0,"ERC-CATSÍ",28
43,"43111",2044,1291,1275,9,16,"ERC-CATSÍ",213
17,"17186",3788,2554,2526,27,28,"ERC-CATSÍ",700
25,"25154",122,74,72,0,2,"ERC-CATSÍ",27
17,"17088",533,368,366,4,2,"ERC-CATSÍ",161
17,"17225",214,139,139,3,0,"ERC-CATSÍ",70
25,"25167",230,138,138,3,0,"ERC-CATSÍ",45
8,"8188",115,78,78,0,0,"ERC-CATSÍ",34
17,"17206",146,88,86,1,2,"ERC-CATSÍ",34
25,"25245",435,289,280,5,9,"ERC-CATSÍ",69
8,"8104",679,432,430,3,2,"ERC-CATSÍ",173
43,"43170",868,566,562,5,4,"ERC-CATSÍ",171
8,"8273",2333,1654,1637,10,17,"ERC-CATSÍ",551
43,"43161",17197,10481,10400,95,81,"ERC-CATSÍ",2733
17,"17039",1759,1159,1145,14,14,"ERC-CATSÍ",335
8,"8030",5122,3482,3466,21,16,"ERC-CATSÍ",856
17,"17020",3592,2333,2315,20,18,"ERC-CATSÍ",874
43,"43021",357,232,231,6,1,"ERC-CATSÍ",67
8,"8223",1852,1182,1171,12,11,"ERC-CATSÍ",385
8,"8016",1831,1136,1129,19,7,"ERC-CATSÍ",311
43,"43906",2102,1364,1346,15,18,"ERC-CATSÍ",277
8,"8046",13290,9054,9000,103,54,"ERC-CATSÍ",2395
8,"8228",301,199,197,6,2,"ERC-CATSÍ",55
8,"8277",157,108,107,0,1,"ERC-CATSÍ",31
17,"17082",417,255,253,2,2,"ERC-CATSÍ",49
8,"8194",25660,15045,14941,122,104,"ERC-CATSÍ",1307
8,"8219",15422,10701,10619,98,82,"ERC-CATSÍ",2586
43,"43129",4580,2844,2805,23,39,"ERC-CATSÍ",625
8,"8130",95,56,55,0,1,"ERC-CATSÍ",21
8,"8189",127,90,89,3,1,"ERC-CATSÍ",30
25,"25181",172,123,120,4,3,"ERC-CATSÍ",32
25,"25027",976,633,630,7,3,"ERC-CATSÍ",233
25,"25052",1555,1027,1016,14,11,"ERC-CATSÍ",411
8,"8020",4926,3523,3502,33,21,"ERC-CATSÍ",798
25,"25912",857,547,539,1,8,"ERC-CATSÍ",70
8,"8032",1981,1319,1311,11,8,"ERC-CATSÍ",291
25,"25141",153,95,95,0,0,"ERC-CATSÍ",32
17,"17097",196,148,148,3,0,"ERC-CATSÍ",57
25,"25011",5243,2796,2767,23,29,"ERC-CATSÍ",720
8,"8154",696,494,488,5,6,"ERC-CATSÍ",104
17,"17004",512,335,334,4,1,"ERC-CATSÍ",115
17,"17058",177,101,100,3,1,"ERC-CATSÍ",30
17,"17902",1357,886,878,13,8,"ERC-CATSÍ",258
17,"17154",92,67,66,0,1,"ERC-CATSÍ",23
8,"8231",20564,13037,12952,96,85,"ERC-CATSÍ",2064
17,"17010",336,224,224,3,0,"ERC-CATSÍ",96
8,"8179",579,396,396,5,0,"ERC-CATSÍ",115
8,"8080",34,26,26,3,0,"ERC-CATSÍ",7
43,"43072",105,74,72,0,2,"ERC-CATSÍ",28
43,"43031",1458,1020,1014,15,6,"ERC-CATSÍ",293
8,"8151",466,288,287,2,1,"ERC-CATSÍ",86
43,"43003",324,217,217,3,0,"ERC-CATSÍ",40
17,"17123",354,266,263,0,3,"ERC-CATSÍ",73
8,"8023",6734,4350,4323,35,27,"ERC-CATSÍ",973
17,"17129",133,101,101,1,0,"ERC-CATSÍ",38
17,"17181",3372,2135,2112,12,23,"ERC-CATSÍ",500
43,"43039",99,66,66,0,0,"ERC-CATSÍ",34
25,"25024",351,226,223,2,3,"ERC-CATSÍ",85
43,"43052",938,628,621,12,7,"ERC-CATSÍ",196
8,"8282",6578,4714,4690,45,24,"ERC-CATSÍ",1172
17,"17077",548,369,368,1,1,"ERC-CATSÍ",94
25,"25078",998,628,627,7,1,"ERC-CATSÍ",202
8,"8028",1024,648,644,4,4,"ERC-CATSÍ",103
17,"17024",268,153,152,1,1,"ERC-CATSÍ",45
25,"25240",1383,925,919,16,6,"ERC-CATSÍ",245
25,"25055",169,105,104,4,1,"ERC-CATSÍ",16
8,"8070",266,194,191,2,3,"ERC-CATSÍ",70
43,"43134",282,191,191,4,0,"ERC-CATSÍ",36
25,"25203",8931,5003,4955,72,48,"ERC-CATSÍ",1098
43,"43004",6281,3993,3929,38,64,"ERC-CATSÍ",1339
43,"43113",393,279,278,5,1,"ERC-CATSÍ",57
17,"17226",867,549,546,8,3,"ERC-CATSÍ",70
17,"17158",476,276,274,1,2,"ERC-CATSÍ",73
17,"17073",1873,1363,1356,15,7,"ERC-CATSÍ",459
8,"8274",4665,3028,3009,26,19,"ERC-CATSÍ",573
17,"17038",366,234,232,6,2,"ERC-CATSÍ",72
8,"8202",12680,8341,8278,75,63,"ERC-CATSÍ",1913
25,"25905",375,249,246,3,3,"ERC-CATSÍ",62
25,"25124",166,106,105,1,1,"ERC-CATSÍ",31
25,"25217",10625,6319,6260,99,59,"ERC-CATSÍ",1682
8,"8180",26613,17585,17490,153,95,"ERC-CATSÍ",1475
25,"25049",151,110,108,1,2,"ERC-CATSÍ",27
25,"25200",329,213,213,0,0,"ERC-CATSÍ",104
25,"25223",922,553,543,8,10,"ERC-CATSÍ",209
17,"17159",643,413,406,3,7,"ERC-CATSÍ",114
17,"17048",6241,3831,3801,36,30,"ERC-CATSÍ",619
8,"8302",9218,5946,5891,82,55,"ERC-CATSÍ",552
17,"17125",130,80,80,0,0,"ERC-CATSÍ",33
43,"43025",600,408,404,2,4,"ERC-CATSÍ",97
8,"8192",5678,3729,3707,35,22,"ERC-CATSÍ",1170
8,"8203",2390,1466,1456,8,10,"ERC-CATSÍ",328
43,"43088",1996,1271,1255,7,16,"ERC-CATSÍ",425
25,"25201",112,73,72,3,1,"ERC-CATSÍ",17
17,"17147",8053,4988,4933,52,55,"ERC-CATSÍ",1291
25,"25155",647,421,418,0,3,"ERC-CATSÍ",123
43,"43070",238,192,191,1,1,"ERC-CATSÍ",79
25,"25085",148,107,107,0,0,"ERC-CATSÍ",31
25,"25216",226,138,136,1,2,"ERC-CATSÍ",41
25,"25129",175,83,83,2,0,"ERC-CATSÍ",30
43,"43043",3130,2053,2036,18,17,"ERC-CATSÍ",401
25,"25148",219,124,124,0,0,"ERC-CATSÍ",44
43,"43053",191,144,143,3,1,"ERC-CATSÍ",42
43,"43094",2143,1395,1375,13,20,"ERC-CATSÍ",411
43,"43152",439,323,320,2,3,"ERC-CATSÍ",98
8,"8132",383,213,212,4,1,"ERC-CATSÍ",58
8,"8025",1490,981,978,4,3,"ERC-CATSÍ",234
43,"43108",1774,1172,1160,14,12,"ERC-CATSÍ",326
43,"43058",90,63,63,0,0,"ERC-CATSÍ",28
25,"25197",133,89,88,1,1,"ERC-CATSÍ",35
17,"17196",220,150,150,4,0,"ERC-CATSÍ",55
8,"8229",535,357,354,9,3,"ERC-CATSÍ",122
25,"25248",891,592,586,6,6,"ERC-CATSÍ",209
25,"25180",234,143,143,1,0,"ERC-CATSÍ",36
43,"43163",25248,15802,15663,104,139,"ERC-CATSÍ",2263
8,"8066",1365,926,921,8,5,"ERC-CATSÍ",198
25,"25067",719,467,460,7,7,"ERC-CATSÍ",132
8,"8098",2381,1544,1534,5,10,"ERC-CATSÍ",324
17,"17057",968,641,636,11,5,"ERC-CATSÍ",231
17,"17063",162,111,109,0,2,"ERC-CATSÍ",49
8,"8005",6205,4187,4167,22,20,"ERC-CATSÍ",1047
17,"17146",2969,1868,1855,8,13,"ERC-CATSÍ",405
43,"43019",1381,862,846,12,16,"ERC-CATSÍ",203
25,"25029",1655,1042,1029,15,13,"ERC-CATSÍ",325
25,"25177",368,226,226,0,0,"ERC-CATSÍ",71
43,"43042",2129,1439,1437,12,2,"ERC-CATSÍ",424
8,"8284",12097,7157,7089,59,68,"ERC-CATSÍ",1221
8,"8268",1005,665,659,4,6,"ERC-CATSÍ",176
25,"25064",108,68,68,2,0,"ERC-CATSÍ",21
17,"17116",354,228,224,3,4,"ERC-CATSÍ",77
25,"25206",260,150,150,5,0,"ERC-CATSÍ",62
25,"25179",162,103,103,2,0,"ERC-CATSÍ",38
25,"25007",1405,850,841,8,9,"ERC-CATSÍ",208
8,"8250",7061,4480,4448,48,32,"ERC-CATSÍ",464
25,"25046",422,279,275,2,4,"ERC-CATSÍ",98
17,"17151",174,111,110,3,1,"ERC-CATSÍ",40
43,"43033",765,531,530,4,1,"ERC-CATSÍ",157
43,"43156",3946,2524,2470,28,54,"ERC-CATSÍ",505
25,"25034",2326,1361,1340,15,21,"ERC-CATSÍ",454
8,"8002",201,130,124,0,6,"ERC-CATSÍ",50
17,"17060",424,268,266,5,2,"ERC-CATSÍ",79
25,"25035",398,249,247,2,2,"ERC-CATSÍ",62
8,"8073",61814,42275,42025,294,250,"ERC-CATSÍ",3335
25,"25913",86,67,67,3,0,"ERC-CATSÍ",23
8,"8247",961,637,634,4,3,"ERC-CATSÍ",247
8,"8164",913,618,609,7,9,"ERC-CATSÍ",198
17,"17174",178,99,97,2,2,"ERC-CATSÍ",48
25,"25138",569,363,360,4,3,"ERC-CATSÍ",119
8,"8029",3480,2472,2460,25,12,"ERC-CATSÍ",578
8,"8193",944,601,596,12,5,"ERC-CATSÍ",162
25,"25157",181,115,114,7,1,"ERC-CATSÍ",35
17,"17029",207,127,127,1,0,"ERC-CATSÍ",41
25,"25901",293,202,202,7,0,"ERC-CATSÍ",76
8,"8125",25081,16406,16329,164,77,"ERC-CATSÍ",1759
25,"25230",1558,1008,993,13,15,"ERC-CATSÍ",292
17,"17200",613,424,422,5,2,"ERC-CATSÍ",140
8,"8243",162,113,113,7,0,"ERC-CATSÍ",44
8,"8142",133,103,101,5,2,"ERC-CATSÍ",25
8,"8240",9348,6512,6483,38,29,"ERC-CATSÍ",1730
43,"43105",162,123,122,2,1,"ERC-CATSÍ",55
43,"43101",145,104,102,3,2,"ERC-CATSÍ",37
43,"43169",450,370,367,10,3,"ERC-CATSÍ",174
43,"43064",2015,1310,1296,23,14,"ERC-CATSÍ",354
43,"43159",81,59,59,0,0,"ERC-CATSÍ",17
43,"43151",107,90,89,0,1,"ERC-CATSÍ",47
25,"25209",1495,995,978,9,17,"ERC-CATSÍ",297
25,"25136",95,64,64,1,0,"ERC-CATSÍ",22
43,"43107",383,238,237,7,1,"ERC-CATSÍ",96
17,"17234",182,115,114,0,1,"ERC-CATSÍ",37
17,"17218",582,404,401,1,3,"ERC-CATSÍ",139
8,"8064",1847,1245,1230,9,15,"ERC-CATSÍ",392
8,"8232",1775,1183,1176,6,7,"ERC-CATSÍ",346
8,"8254",1739,1159,1156,10,3,"ERC-CATSÍ",526
17,"17130",325,223,222,3,1,"ERC-CATSÍ",89
8,"8901",227,148,145,1,3,"ERC-CATSÍ",52
43,"43106",810,526,522,7,4,"ERC-CATSÍ",143
17,"17011",637,444,439,6,5,"ERC-CATSÍ",166
17,"17089",5543,3349,3326,22,23,"ERC-CATSÍ",859
17,"17157",125,95,95,1,0,"ERC-CATSÍ",27
8,"8214",6872,4699,4675,47,24,"ERC-CATSÍ",1237
43,"43038",21366,13061,12943,111,118,"ERC-CATSÍ",2136
17,"17169",2475,1619,1601,11,18,"ERC-CATSÍ",445
25,"25050",3233,1936,1912,25,24,"ERC-CATSÍ",600
17,"17133",1255,805,796,9,9,"ERC-CATSÍ",259
25,"25051",1527,931,920,11,11,"ERC-CATSÍ",318
8,"8038",1487,959,954,15,5,"ERC-CATSÍ",271
8,"8216",25,15,15,1,0,"ERC-CATSÍ",5
8,"8260",18335,12325,12263,106,62,"ERC-CATSÍ",1363
17,"17118",12711,7567,7515,42,52,"ERC-CATSÍ",2026
8,"8065",1176,797,784,10,13,"ERC-CATSÍ",225
8,"8269",2673,1788,1776,14,12,"ERC-CATSÍ",616
8,"8008",190,110,110,5,0,"ERC-CATSÍ",53
25,"25071",49,31,31,0,0,"ERC-CATSÍ",17
43,"43013",4411,2750,2739,19,11,"ERC-CATSÍ",877
17,"17091",407,258,253,5,5,"ERC-CATSÍ",79
8,"8266",43030,30192,30039,229,153,"ERC-CATSÍ",3863
25,"25057",208,141,140,0,1,"ERC-CATSÍ",16
17,"17208",995,594,590,8,4,"ERC-CATSÍ",201
25,"25127",210,136,136,2,0,"ERC-CATSÍ",72
25,"25017",236,169,167,7,2,"ERC-CATSÍ",52
8,"8294",1966,1287,1280,17,7,"ERC-CATSÍ",377
43,"43133",5666,3397,3356,27,41,"ERC-CATSÍ",787
17,"17066",26562,15223,15087,150,136,"ERC-CATSÍ",3134
43,"43083",144,109,108,0,1,"ERC-CATSÍ",16
25,"25037",375,247,246,5,1,"ERC-CATSÍ",89
8,"8244",5851,4095,4058,36,37,"ERC-CATSÍ",729
8,"8040",10710,6845,6802,51,43,"ERC-CATSÍ",1669
17,"17054",370,236,236,1,0,"ERC-CATSÍ",74
25,"25166",181,110,109,2,1,"ERC-CATSÍ",42
8,"8050",141,99,99,2,0,"ERC-CATSÍ",35
25,"25030",135,74,72,1,2,"ERC-CATSÍ",24
43,"43089",292,190,186,0,4,"ERC-CATSÍ",20
8,"8109",216,162,161,0,1,"ERC-CATSÍ",81
17,"17028",293,205,204,6,1,"ERC-CATSÍ",76
17,"17161",992,726,721,10,5,"ERC-CATSÍ",283
25,"25069",451,247,246,4,1,"ERC-CATSÍ",86
8,"8905",2346,1689,1681,26,8,"ERC-CATSÍ",376
25,"25903",236,161,161,3,0,"ERC-CATSÍ",59
25,"25202",104,73,72,0,1,"ERC-CATSÍ",23
17,"17003",104,67,66,0,1,"ERC-CATSÍ",24
25,"25156",783,543,537,7,6,"ERC-CATSÍ",160
43,"43071",921,613,607,6,6,"ERC-CATSÍ",135
8,"8012",1672,1075,1061,17,14,"ERC-CATSÍ",379
8,"8007",6483,4281,4250,33,31,"ERC-CATSÍ",1380
43,"43044",3963,2671,2640,33,31,"ERC-CATSÍ",413
17,"17162",150,86,86,1,0,"ERC-CATSÍ",25
43,"43080",239,183,181,0,2,"ERC-CATSÍ",66
25,"25247",123,66,66,1,0,"ERC-CATSÍ",6
25,"25101",561,364,358,2,6,"ERC-CATSÍ",157
25,"25056",235,143,143,2,0,"ERC-CATSÍ",39
25,"25004",571,376,373,3,3,"ERC-CATSÍ",121
25,"25097",84,65,65,3,0,"ERC-CATSÍ",28
43,"43005",3626,2157,2138,29,19,"ERC-CATSÍ",542
17,"17221",4153,2577,2564,27,13,"ERC-CATSÍ",555
8,"8120",6835,4708,4688,44,20,"ERC-CATSÍ",1051
25,"25172",1797,1170,1146,10,24,"ERC-CATSÍ",385
8,"8221",12368,8798,8763,67,35,"ERC-CATSÍ",1809
43,"43059",252,188,188,2,0,"ERC-CATSÍ",70
25,"25902",567,365,356,8,9,"ERC-CATSÍ",121
8,"8222",1895,1358,1351,14,7,"ERC-CATSÍ",391
25,"25145",86,65,64,1,1,"ERC-CATSÍ",20
17,"17175",578,321,312,5,9,"ERC-CATSÍ",64
25,"25169",173,112,111,3,1,"ERC-CATSÍ",34
43,"43173",100,53,51,0,2,"ERC-CATSÍ",26
17,"17205",208,157,155,1,2,"ERC-CATSÍ",55
25,"25076",145,81,81,2,0,"ERC-CATSÍ",24
17,"17197",132,102,101,1,1,"ERC-CATSÍ",29
8,"8006",11470,7210,7132,60,78,"ERC-CATSÍ",1856
8,"8036",163,105,104,1,1,"ERC-CATSÍ",30
17,"17084",238,146,144,5,2,"ERC-CATSÍ",54
25,"25133",706,432,427,8,5,"ERC-CATSÍ",99
17,"17214",705,423,419,2,4,"ERC-CATSÍ",153
25,"25059",805,527,523,7,4,"ERC-CATSÍ",30
8,"8113",52035,32351,32150,254,201,"ERC-CATSÍ",7808
25,"25074",178,132,128,6,4,"ERC-CATSÍ",52
25,"25233",275,178,178,4,0,"ERC-CATSÍ",38
17,"17032",1721,967,961,10,6,"ERC-CATSÍ",291
8,"8100",2001,1395,1380,25,15,"ERC-CATSÍ",468
25,"25020",289,206,205,3,1,"ERC-CATSÍ",65
43,"43048",805,525,513,8,12,"ERC-CATSÍ",106
8,"8210",4329,2624,2594,31,30,"ERC-CATSÍ",743
8,"8141",4563,2953,2929,34,24,"ERC-CATSÍ",916
8,"8201",442,278,278,4,0,"ERC-CATSÍ",100
25,"25225",564,356,356,1,0,"ERC-CATSÍ",136
25,"25171",2185,1416,1410,8,6,"ERC-CATSÍ",511
17,"17021",131,86,85,4,1,"ERC-CATSÍ",16
8,"8128",563,375,372,2,3,"ERC-CATSÍ",111
25,"25221",122,81,81,0,0,"ERC-CATSÍ",26
17,"17099",81,57,57,1,0,"ERC-CATSÍ",11
25,"25242",720,456,450,2,6,"ERC-CATSÍ",137
17,"17184",1254,814,809,6,5,"ERC-CATSÍ",283
8,"8062",956,619,618,4,1,"ERC-CATSÍ",178
8,"8084",1142,773,768,14,5,"ERC-CATSÍ",232
17,"17212",141,104,102,0,2,"ERC-CATSÍ",34
8,"8021",70,49,46,0,3,"ERC-CATSÍ",9
17,"17074",510,337,335,2,2,"ERC-CATSÍ",85
25,"25109",231,163,162,2,1,"ERC-CATSÍ",40
8,"8014",1962,1366,1359,15,7,"ERC-CATSÍ",409
17,"17076",124,86,84,3,2,"ERC-CATSÍ",30
8,"8103",625,395,395,2,0,"ERC-CATSÍ",138
43,"43132",373,264,261,4,3,"ERC-CATSÍ",91
8,"8089",33850,22230,22096,170,134,"ERC-CATSÍ",2244
8,"8027",687,486,485,2,1,"ERC-CATSÍ",144
8,"8190",256,168,165,2,3,"ERC-CATSÍ",63
17,"17105",247,147,147,1,0,"ERC-CATSÍ",54
43,"43092",7036,4226,4185,39,41,"ERC-CATSÍ",649
25,"25253",159,105,105,1,0,"ERC-CATSÍ",41
8,"8200",61409,41278,41024,312,254,"ERC-CATSÍ",3856
8,"8213",6319,3950,3935,37,15,"ERC-CATSÍ",922
8,"8145",2599,1774,1761,11,13,"ERC-CATSÍ",429
43,"43011",1077,743,737,2,6,"ERC-CATSÍ",256
43,"43051",8512,5418,5366,32,52,"ERC-CATSÍ",447
43,"43120",441,270,267,1,3,"ERC-CATSÍ",38
8,"8281",4802,3343,3318,17,25,"ERC-CATSÍ",873
8,"8172",20326,13875,13802,92,73,"ERC-CATSÍ",2719
8,"8241",73,52,52,0,0,"ERC-CATSÍ",13
17,"17132",1298,884,877,12,7,"ERC-CATSÍ",261
8,"8091",5244,3611,3584,17,27,"ERC-CATSÍ",799
8,"8296",1777,1237,1231,7,6,"ERC-CATSÍ",314
8,"8024",386,243,236,0,7,"ERC-CATSÍ",75
43,"43135",340,235,234,1,1,"ERC-CATSÍ",61
25,"25008",1124,715,702,10,13,"ERC-CATSÍ",171
43,"43099",306,228,226,4,2,"ERC-CATSÍ",46
25,"25048",1651,1051,1040,11,11,"ERC-CATSÍ",337
8,"8051",17948,12140,12076,102,64,"ERC-CATSÍ",2557
17,"17102",571,400,400,6,0,"ERC-CATSÍ",155
43,"43149",686,447,443,8,4,"ERC-CATSÍ",93
25,"25112",273,192,188,4,4,"ERC-CATSÍ",42
17,"17187",631,445,441,2,4,"ERC-CATSÍ",160
17,"17018",480,327,322,2,5,"ERC-CATSÍ",112
43,"43095",2474,1575,1551,17,24,"ERC-CATSÍ",330
8,"8143",2682,1718,1707,17,11,"ERC-CATSÍ",328
25,"25062",750,486,482,1,4,"ERC-CATSÍ",169
43,"43081",593,400,395,3,5,"ERC-CATSÍ",112
17,"17026",544,370,367,5,3,"ERC-CATSÍ",107
8,"8134",810,541,538,7,3,"ERC-CATSÍ",171
8,"8035",12547,7877,7828,51,49,"ERC-CATSÍ",1824
25,"25053",1055,671,661,7,10,"ERC-CATSÍ",176
8,"8175",3347,2080,2064,20,16,"ERC-CATSÍ",701
43,"43068",520,330,326,7,4,"ERC-CATSÍ",71
8,"8176",156,109,107,2,2,"ERC-CATSÍ",31
25,"25239",590,258,256,5,2,"ERC-CATSÍ",81
8,"8267",6461,4265,4245,51,20,"ERC-CATSÍ",744
25,"25910",100,63,61,2,2,"ERC-CATSÍ",25
25,"25041",568,347,344,4,3,"ERC-CATSÍ",99
17,"17209",630,443,438,7,5,"ERC-CATSÍ",144
25,"25038",1545,995,986,17,9,"ERC-CATSÍ",204
17,"17093",891,563,560,6,3,"ERC-CATSÍ",170
17,"17081",246,163,162,2,1,"ERC-CATSÍ",48
17,"17106",140,103,102,0,1,"ERC-CATSÍ",31
8,"8068",6718,4373,4343,33,30,"ERC-CATSÍ",847
8,"8177",40,30,30,0,0,"ERC-CATSÍ",9
43,"43097",393,291,289,1,2,"ERC-CATSÍ",77
17,"17067",696,467,464,5,3,"ERC-CATSÍ",150
8,"8162",2047,1400,1392,7,8,"ERC-CATSÍ",318
17,"17136",178,125,124,0,1,"ERC-CATSÍ",23
43,"43125",933,680,677,14,3,"ERC-CATSÍ",140
8,"8122",1698,1080,1073,5,7,"ERC-CATSÍ",310
17,"17199",6853,4147,4122,27,25,"ERC-CATSÍ",1237
8,"8110",13315,8457,8368,73,89,"ERC-CATSÍ",1494
17,"17121",224,140,140,1,0,"ERC-CATSÍ",42
17,"17012",1145,703,698,9,5,"ERC-CATSÍ",203
8,"8297",134,85,84,0,1,"ERC-CATSÍ",21
8,"8256",650,484,484,5,0,"ERC-CATSÍ",111
25,"25186",213,124,122,3,2,"ERC-CATSÍ",39
43,"43126",1177,782,772,4,10,"ERC-CATSÍ",208
8,"8233",1871,1153,1140,16,13,"ERC-CATSÍ",457
8,"8069",3169,2161,2148,32,13,"ERC-CATSÍ",563
17,"17203",153,99,99,0,0,"ERC-CATSÍ",38
8,"8230",7635,5177,5121,54,56,"ERC-CATSÍ",970
25,"25058",4357,2624,2595,20,29,"ERC-CATSÍ",901
8,"8283",5963,3670,3642,24,28,"ERC-CATSÍ",1181
17,"17051",218,145,142,1,3,"ERC-CATSÍ",45
8,"8262",6836,4175,4144,50,31,"ERC-CATSÍ",946
25,"25204",1231,731,724,5,7,"ERC-CATSÍ",216
8,"8235",3686,2488,2470,16,18,"ERC-CATSÍ",790
17,"17096",179,106,105,1,1,"ERC-CATSÍ",34
25,"25032",64,44,44,1,0,"ERC-CATSÍ",24
25,"25173",1705,1156,1143,14,13,"ERC-CATSÍ",182
17,"17176",124,92,92,1,0,"ERC-CATSÍ",28
17,"17150",1401,962,951,6,11,"ERC-CATSÍ",277
8,"8298",26471,16674,16591,139,83,"ERC-CATSÍ",5225
17,"17014",64,48,48,1,0,"ERC-CATSÍ",18
17,"17044",6770,4411,4376,33,35,"ERC-CATSÍ",1457
17,"17006",1127,686,682,1,4,"ERC-CATSÍ",185
25,"25002",482,316,314,2,2,"ERC-CATSÍ",116
43,"43034",477,350,342,9,8,"ERC-CATSÍ",99
25,"25073",582,328,324,8,4,"ERC-CATSÍ",113
8,"8166",991,631,625,7,6,"ERC-CATSÍ",196
17,"17164",3982,2363,2350,11,13,"ERC-CATSÍ",745
8,"8015",155409,99368,98735,820,633,"ERC-CATSÍ",11361
25,"25907",494,266,265,6,1,"ERC-CATSÍ",97
43,"43047",4161,2359,2341,27,18,"ERC-CATSÍ",334
8,"8140",4774,3118,3098,23,20,"ERC-CATSÍ",681
8,"8263",20972,13710,13583,149,127,"ERC-CATSÍ",2031
8,"8059",347,195,195,2,0,"ERC-CATSÍ",79
8,"8001",8907,6316,6269,46,47,"ERC-CATSÍ",583
8,"8197",7648,5020,5000,37,20,"ERC-CATSÍ",1017
17,"17152",10737,6308,6252,45,56,"ERC-CATSÍ",1030
8,"8019",1136351,768170,764030,5799,4140,"ERC-CATSÍ",132722
25,"25191",334,205,204,4,1,"ERC-CATSÍ",58
17,"17190",844,528,528,3,0,"ERC-CATSÍ",193
8,"8178",435,309,308,4,1,"ERC-CATSÍ",81
25,"25175",186,117,117,1,0,"ERC-CATSÍ",28
25,"25092",130,98,95,2,3,"ERC-CATSÍ",40
8,"8168",358,231,231,5,0,"ERC-CATSÍ",40
8,"8278",4779,3161,3148,20,13,"ERC-CATSÍ",1040
43,"43040",330,257,255,5,2,"ERC-CATSÍ",105
25,"25153",192,130,128,2,2,"ERC-CATSÍ",32
25,"25168",509,354,352,7,2,"ERC-CATSÍ",114
17,"17137",3437,2293,2275,19,18,"ERC-CATSÍ",868
43,"43018",408,325,320,3,5,"ERC-CATSÍ",88
8,"8184",53822,34744,34545,264,199,"ERC-CATSÍ",4173
25,"25238",204,140,138,4,2,"ERC-CATSÍ",45
8,"8279",153025,101133,100621,840,512,"ERC-CATSÍ",14924
17,"17075",330,205,205,1,0,"ERC-CATSÍ",85
25,"25022",104,79,79,0,0,"ERC-CATSÍ",28
8,"8116",578,387,383,2,4,"ERC-CATSÍ",129
17,"17193",4216,2555,2525,16,30,"ERC-CATSÍ",538
8,"8022",12212,7210,7155,66,55,"ERC-CATSÍ",2370
17,"17232",152,92,91,1,1,"ERC-CATSÍ",33
8,"8253",131,81,81,2,0,"ERC-CATSÍ",24
8,"8072",10259,6462,6422,42,40,"ERC-CATSÍ",1305
17,"17217",354,265,263,2,2,"ERC-CATSÍ",114
8,"8117",2450,1602,1594,11,8,"ERC-CATSÍ",511
17,"17023",27269,17209,17032,122,177,"ERC-CATSÍ",2456
17,"17143",142,103,99,1,4,"ERC-CATSÍ",24
17,"17036",2717,1730,1716,15,14,"ERC-CATSÍ",495
17,"17100",194,133,131,3,2,"ERC-CATSÍ",35
25,"25094",137,98,95,1,3,"ERC-CATSÍ",22
43,"43065",399,252,251,3,1,"ERC-CATSÍ",89
8,"8144",717,447,437,5,10,"ERC-CATSÍ",151
25,"25137",8585,5143,5095,56,48,"ERC-CATSÍ",1237
25,"25194",423,246,244,6,2,"ERC-CATSÍ",56
25,"25210",1108,685,677,3,8,"ERC-CATSÍ",163
25,"25254",728,457,451,2,6,"ERC-CATSÍ",124
8,"8215",2588,1663,1647,16,16,"ERC-CATSÍ",521
17,"17064",322,214,211,4,3,"ERC-CATSÍ",65
43,"43012",3534,2559,2548,34,11,"ERC-CATSÍ",570
17,"17101",559,347,338,2,9,"ERC-CATSÍ",80
43,"43066",158,100,98,5,2,"ERC-CATSÍ",20
17,"17183",277,180,179,1,1,"ERC-CATSÍ",59
17,"17207",2375,1590,1579,11,11,"ERC-CATSÍ",615
17,"17220",796,538,536,5,2,"ERC-CATSÍ",213
17,"17144",206,141,141,3,0,"ERC-CATSÍ",49
25,"25243",3646,2193,2167,33,26,"ERC-CATSÍ",196
8,"8159",14096,9393,9347,76,46,"ERC-CATSÍ",1493
8,"8206",728,523,515,5,8,"ERC-CATSÍ",159
43,"43008",307,156,154,6,2,"ERC-CATSÍ",25
8,"8097",1021,715,712,8,3,"ERC-CATSÍ",233
17,"17192",144,96,93,1,3,"ERC-CATSÍ",17
8,"8133",128,72,72,0,0,"ERC-CATSÍ",8
43,"43136",10351,6279,6218,63,61,"ERC-CATSÍ",1772
25,"25212",233,154,153,6,1,"ERC-CATSÍ",36
25,"25113",1168,811,803,8,8,"ERC-CATSÍ",269
17,"17171",165,117,116,2,1,"ERC-CATSÍ",38
17,"17222",101,76,75,0,1,"ERC-CATSÍ",24
8,"8107",11502,7510,7445,67,65,"ERC-CATSÍ",1018
43,"43110",259,175,175,6,0,"ERC-CATSÍ",42
8,"8053",2788,1605,1591,8,14,"ERC-CATSÍ",305
17,"17080",138,96,96,1,0,"ERC-CATSÍ",36
25,"25165",285,179,176,2,3,"ERC-CATSÍ",54
8,"8904",10553,6623,6579,52,44,"ERC-CATSÍ",244
8,"8094",1559,1112,1097,14,15,"ERC-CATSÍ",328
43,"43015",112,87,86,0,1,"ERC-CATSÍ",37
8,"8081",339,222,221,3,1,"ERC-CATSÍ",65
8,"8191",5239,3454,3438,27,16,"ERC-CATSÍ",775
8,"8108",5016,3501,3474,21,27,"ERC-CATSÍ",472
8,"8149",993,569,567,10,2,"ERC-CATSÍ",226
8,"8300",5678,3983,3964,35,19,"ERC-CATSÍ",739
17,"17198",429,270,267,2,3,"ERC-CATSÍ",77
17,"17160",14747,9189,9129,65,60,"ERC-CATSÍ",1915
25,"25082",285,186,178,5,8,"ERC-CATSÍ",61
25,"25215",345,240,236,0,4,"ERC-CATSÍ",66
8,"8077",34508,24070,23956,127,114,"ERC-CATSÍ",2409
43,"43165",577,436,433,3,3,"ERC-CATSÍ",136
8,"8163",18641,11801,11729,68,72,"ERC-CATSÍ",1821
25,"25003",3762,2215,2195,22,20,"ERC-CATSÍ",757
8,"8150",255,186,186,1,0,"ERC-CATSÍ",63
25,"25043",807,501,497,11,4,"ERC-CATSÍ",196
25,"25070",823,554,549,15,5,"ERC-CATSÍ",170
25,"25130",195,113,112,2,1,"ERC-CATSÍ",46
25,"25118",346,198,189,3,9,"ERC-CATSÍ",50
43,"43153",10688,6675,6615,39,60,"ERC-CATSÍ",1347
25,"25142",364,229,225,2,4,"ERC-CATSÍ",103
25,"25904",148,112,111,2,1,"ERC-CATSÍ",32
8,"8033",12813,8564,8509,63,55,"ERC-CATSÍ",2095
8,"8902",3761,2570,2558,31,12,"ERC-CATSÍ",479
25,"25079",299,198,193,2,5,"ERC-CATSÍ",57
25,"25075",117,72,72,2,0,"ERC-CATSÍ",28
17,"17065",331,230,230,1,0,"ERC-CATSÍ",78
17,"17095",19555,11537,11428,89,109,"ERC-CATSÍ",1515
8,"8043",3201,2056,2041,9,15,"ERC-CATSÍ",262
8,"8288",1659,1004,994,7,10,"ERC-CATSÍ",159
17,"17030",641,400,398,1,2,"ERC-CATSÍ",106
8,"8138",4248,2638,2618,27,20,"ERC-CATSÍ",932
8,"8124",36804,24782,24632,184,150,"ERC-CATSÍ",2782
8,"8058",1730,1102,1095,6,7,"ERC-CATSÍ",180
25,"25231",486,330,330,4,0,"ERC-CATSÍ",133
25,"25906",218,125,125,1,0,"ERC-CATSÍ",38
25,"25102",707,420,407,6,13,"ERC-CATSÍ",77
8,"8067",5739,3616,3577,47,39,"ERC-CATSÍ",1082
17,"17124",1607,1027,1007,11,20,"ERC-CATSÍ",334
25,"25120",92002,55658,55214,587,444,"ERC-CATSÍ",10054
43,"43032",517,332,329,5,3,"ERC-CATSÍ",74
8,"8290",1507,1118,1110,12,8,"ERC-CATSÍ",352
25,"25161",360,219,218,2,1,"ERC-CATSÍ",85
8,"8153",538,386,385,2,1,"ERC-CATSÍ",149
17,"17031",168,97,97,3,0,"ERC-CATSÍ",29
8,"8209",6773,4410,4382,29,28,"ERC-CATSÍ",723
25,"25190",262,185,183,0,2,"ERC-CATSÍ",77
17,"17111",880,590,586,7,4,"ERC-CATSÍ",179
43,"43102",480,332,324,3,8,"ERC-CATSÍ",112
8,"8099",749,487,485,2,2,"ERC-CATSÍ",139
17,"17223",801,516,506,9,10,"ERC-CATSÍ",137
43,"43020",2215,1508,1497,9,11,"ERC-CATSÍ",199
25,"25103",135,76,76,4,0,"ERC-CATSÍ",23
25,"25125",417,250,250,5,0,"ERC-CATSÍ",106
43,"43130",195,127,127,1,0,"ERC-CATSÍ",49
25,"25163",231,135,132,2,3,"ERC-CATSÍ",44
8,"8196",19233,12733,12671,94,62,"ERC-CATSÍ",1059
8,"8305",27339,17960,17809,147,151,"ERC-CATSÍ",4402
8,"8292",1072,730,725,6,5,"ERC-CATSÍ",223
17,"17215",2087,1481,1466,7,15,"ERC-CATSÍ",543
43,"43117",146,108,105,0,3,"ERC-CATSÍ",20
8,"8211",33081,23576,23413,226,163,"ERC-CATSÍ",2874
17,"17195",329,237,234,0,3,"ERC-CATSÍ",103
8,"8042",2231,1565,1558,17,7,"ERC-CATSÍ",278
43,"43171",14599,9083,9011,72,72,"ERC-CATSÍ",722
8,"8105",9630,6394,6339,49,55,"ERC-CATSÍ",355
43,"43100",3301,2183,2172,24,11,"ERC-CATSÍ",350
8,"8075",3883,2479,2467,14,12,"ERC-CATSÍ",479
17,"17114",23041,13985,13880,135,105,"ERC-CATSÍ",4207
17,"17230",468,318,317,3,1,"ERC-CATSÍ",76
17,"17216",165,110,110,1,0,"ERC-CATSÍ",43
8,"8004",223,165,164,2,1,"ERC-CATSÍ",54
43,"43077",463,272,272,5,0,"ERC-CATSÍ",36
17,"17167",2700,1765,1749,37,16,"ERC-CATSÍ",520
8,"8018",2636,1690,1675,23,15,"ERC-CATSÍ",383
8,"8129",462,319,316,3,3,"ERC-CATSÍ",118
17,"17142",2550,1806,1797,30,9,"ERC-CATSÍ",503
8,"8226",891,648,645,6,3,"ERC-CATSÍ",244
43,"43172",344,211,209,4,2,"ERC-CATSÍ",73
8,"8157",8382,5823,5789,45,34,"ERC-CATSÍ",830
8,"8307",48295,32010,31798,195,212,"ERC-CATSÍ",5885
43,"43037",16781,10376,10265,71,111,"ERC-CATSÍ",1305
43,"43160",1276,837,826,8,11,"ERC-CATSÍ",169
25,"25023",4531,2782,2763,30,19,"ERC-CATSÍ",605
43,"43024",1537,993,983,8,10,"ERC-CATSÍ",141
8,"8131",704,471,468,7,3,"ERC-CATSÍ",169
43,"43093",3919,2461,2434,47,27,"ERC-CATSÍ",567
25,"25077",463,256,253,6,3,"ERC-CATSÍ",111
8,"8308",131,87,87,1,0,"ERC-CATSÍ",9
43,"43056",854,480,470,5,10,"ERC-CATSÍ",209
8,"8181",7887,5178,5144,48,34,"ERC-CATSÍ",1123
43,"43174",138,102,100,1,2,"ERC-CATSÍ",51
8,"8158",3082,2054,2041,21,13,"ERC-CATSÍ",457
25,"25042",208,123,121,1,2,"ERC-CATSÍ",25
25,"25911",451,273,271,7,2,"ERC-CATSÍ",84
43,"43139",2039,1218,1191,8,27,"ERC-CATSÍ",387
43,"43175",554,363,360,5,3,"ERC-CATSÍ",103
25,"25255",417,298,296,2,2,"ERC-CATSÍ",86
8,"8146",1286,885,881,12,4,"ERC-CATSÍ",169
25,"25196",113,57,57,0,0,"ERC-CATSÍ",12
25,"25012",2334,1322,1310,8,12,"ERC-CATSÍ",313
17,"17170",171,125,123,1,2,"ERC-CATSÍ",64
43,"43057",38,25,25,1,0,"ERC-CATSÍ",9
17,"17178",1059,654,650,7,4,"ERC-CATSÍ",229
43,"43017",124,101,101,1,0,"ERC-CATSÍ",44
8,"8017",2762,1701,1688,9,13,"ERC-CATSÍ",521
8,"8119",6180,4155,4123,28,32,"ERC-CATSÍ",631
8,"8052",141,88,88,0,0,"ERC-CATSÍ",26
8,"8174",392,283,279,3,4,"ERC-CATSÍ",98
8,"8079",343,256,255,4,1,"ERC-CATSÍ",105
43,"43122",106,77,77,4,0,"ERC-CATSÍ",17
17,"17013",2787,1780,1762,17,18,"ERC-CATSÍ",420
8,"8160",327,208,208,1,0,"ERC-CATSÍ",77
17,"17079",64395,41049,40699,342,350,"ERC-CATSÍ",10415
25,"25098",253,151,150,0,1,"ERC-CATSÍ",48
43,"43054",2812,1755,1739,16,16,"ERC-CATSÍ",607
25,"25068",556,346,341,11,5,"ERC-CATSÍ",81
8,"8257",107,71,71,0,0,"ERC-CATSÍ",15
43,"43001",691,441,439,4,2,"ERC-CATSÍ",115
8,"8121",86351,57040,56655,446,385,"ERC-CATSÍ",9121
43,"43028",2688,1659,1639,6,20,"ERC-CATSÍ",211
8,"8009",9180,6207,6192,50,15,"ERC-CATSÍ",1463
25,"25244",361,223,220,5,3,"ERC-CATSÍ",66
25,"25128",136,75,75,0,0,"ERC-CATSÍ",23
25,"25170",266,169,167,1,2,"ERC-CATSÍ",56
17,"17120",786,517,512,8,5,"ERC-CATSÍ",152
8,"8272",151,90,90,1,0,"ERC-CATSÍ",37
8,"8095",73,48,47,0,1,"ERC-CATSÍ",10
8,"8041",10343,6645,6582,57,63,"ERC-CATSÍ",533
25,"25174",397,280,280,2,0,"ERC-CATSÍ",58
8,"8259",6637,4611,4577,39,34,"ERC-CATSÍ",1247
43,"43178",1350,856,844,5,12,"ERC-CATSÍ",186
17,"17135",362,253,253,1,0,"ERC-CATSÍ",78
17,"17172",454,300,297,0,3,"ERC-CATSÍ",98
43,"43029",310,213,211,3,2,"ERC-CATSÍ",121
17,"17210",551,350,349,9,1,"ERC-CATSÍ",101
8,"8055",519,331,327,4,4,"ERC-CATSÍ",117
17,"17094",1059,602,600,4,2,"ERC-CATSÍ",166
43,"43030",427,288,283,1,5,"ERC-CATSÍ",63
17,"17224",314,190,188,2,2,"ERC-CATSÍ",57
43,"43166",1584,1029,1022,6,7,"ERC-CATSÍ",271
25,"25031",52,29,29,0,0,"ERC-CATSÍ",1
43,"43076",439,300,299,0,1,"ERC-CATSÍ",143
43,"43026",782,524,520,6,4,"ERC-CATSÍ",221
17,"17126",311,236,234,0,2,"ERC-CATSÍ",105
25,"25104",130,76,74,1,2,"ERC-CATSÍ",18
43,"43091",132,86,86,0,0,"ERC-CATSÍ",26
17,"17149",364,248,248,0,0,"ERC-CATSÍ",107
8,"8252",24570,17009,16901,145,108,"ERC-CATSÍ",1357
17,"17069",374,256,251,0,5,"ERC-CATSÍ",65
8,"8261",2327,1499,1493,11,6,"ERC-CATSÍ",304
43,"43045",149,110,110,2,0,"ERC-CATSÍ",49
17,"17005",413,257,252,3,5,"ERC-CATSÍ",74
43,"43127",743,528,527,2,1,"ERC-CATSÍ",184
17,"17213",5424,3239,3219,24,20,"ERC-CATSÍ",682
17,"17138",928,637,633,4,4,"ERC-CATSÍ",132
17,"17110",1322,856,853,3,3,"ERC-CATSÍ",207
25,"25045",57,40,40,0,0,"ERC-CATSÍ",5
43,"43073",83,60,58,0,2,"ERC-CATSÍ",18
43,"43168",96,57,57,3,0,"ERC-CATSÍ",21
8,"8276",237,165,165,2,0,"ERC-CATSÍ",61
8,"8112",12911,7790,7723,74,67,"ERC-CATSÍ",2068
25,"25250",345,210,204,0,6,"ERC-CATSÍ",74
43,"43115",143,100,98,2,2,"ERC-CATSÍ",23
8,"8139",175,132,132,2,0,"ERC-CATSÍ",42
8,"8086",13582,8612,8557,75,55,"ERC-CATSÍ",1344
17,"17227",129,86,85,5,1,"ERC-CATSÍ",36
17,"17202",3791,2280,2263,18,17,"ERC-CATSÍ",513
8,"8126",8748,5927,5895,56,32,"ERC-CATSÍ",1073
17,"17115",282,183,183,1,0,"ERC-CATSÍ",75
25,"25146",227,140,140,3,0,"ERC-CATSÍ",40
8,"8135",6677,4813,4775,51,38,"ERC-CATSÍ",478
17,"17049",3117,2092,2072,14,20,"ERC-CATSÍ",806
43,"43069",182,136,134,1,2,"ERC-CATSÍ",36
43,"43002",1801,1156,1128,7,28,"ERC-CATSÍ",102
43,"43124",482,308,307,2,1,"ERC-CATSÍ",72
25,"25047",1014,675,674,8,1,"ERC-CATSÍ",239
17,"17191",141,92,89,1,3,"ERC-CATSÍ",28
8,"8087",152,121,121,2,0,"ERC-CATSÍ",36
17,"17086",1729,1068,1059,8,9,"ERC-CATSÍ",199
17,"17112",190,127,125,2,2,"ERC-CATSÍ",35
25,"25909",148,93,92,2,1,"ERC-CATSÍ",28
17,"17025",1134,793,787,6,6,"ERC-CATSÍ",290
17,"17041",218,130,129,2,1,"ERC-CATSÍ",52
17,"17211",830,581,580,10,1,"ERC-CATSÍ",210
17,"17140",670,478,473,5,5,"ERC-CATSÍ",130
25,"25025",1353,871,864,16,7,"ERC-CATSÍ",74
43,"43145",4096,2795,2760,19,35,"ERC-CATSÍ",668
43,"43148",90275,59182,58757,388,425,"ERC-CATSÍ",8596
17,"17009",4015,2584,2567,14,17,"ERC-CATSÍ",906
8,"8169",47759,32651,32439,243,212,"ERC-CATSÍ",2575
17,"17166",522,374,367,1,7,"ERC-CATSÍ",166
17,"17153",188,133,133,0,0,"ERC-CATSÍ",52
8,"8280",97,66,66,2,0,"ERC-CATSÍ",23
8,"8239",453,304,302,3,2,"ERC-CATSÍ",83
17,"17034",6931,4166,4150,29,16,"ERC-CATSÍ",1031
25,"25150",181,115,113,3,2,"ERC-CATSÍ",31
25,"25193",759,485,480,2,5,"ERC-CATSÍ",178
17,"17062",5958,3463,3441,22,22,"ERC-CATSÍ",855
8,"8102",28296,18466,18367,172,99,"ERC-CATSÍ",4591
43,"43023",231,170,169,0,1,"ERC-CATSÍ",50
43,"43082",365,290,286,5,4,"ERC-CATSÍ",88
17,"17168",380,260,258,0,2,"ERC-CATSÍ",91
8,"8161",11144,6994,6938,73,56,"ERC-CATSÍ",1089
43,"43164",301,205,204,2,1,"ERC-CATSÍ",24
17,"17155",14515,8393,8330,65,63,"ERC-CATSÍ",1837
25,"25010",211,113,113,2,0,"ERC-CATSÍ",51
25,"25063",87,58,58,1,0,"ERC-CATSÍ",6
17,"17233",2260,1528,1514,23,14,"ERC-CATSÍ",472
8,"8218",8009,5105,5075,59,30,"ERC-CATSÍ",915
8,"8286",2879,1802,1797,14,5,"ERC-CATSÍ",259
25,"25183",499,326,323,7,3,"ERC-CATSÍ",92
43,"43901",8737,4703,4639,62,64,"ERC-CATSÍ",995
8,"8299",391,244,244,5,0,"ERC-CATSÍ",93
17,"17185",2265,1420,1404,15,16,"ERC-CATSÍ",381
25,"25014",260,165,165,5,0,"ERC-CATSÍ",68
17,"17903",897,568,563,2,5,"ERC-CATSÍ",188
17,"17068",245,158,156,1,2,"ERC-CATSÍ",47
8,"8295",10870,6972,6918,51,54,"ERC-CATSÍ",989
8,"8287",1048,736,735,2,1,"ERC-CATSÍ",245
43,"43084",526,363,361,10,2,"ERC-CATSÍ",142
17,"17078",336,223,220,6,3,"ERC-CATSÍ",65
17,"17055",150,110,109,0,1,"ERC-CATSÍ",43
25,"25134",623,369,366,3,3,"ERC-CATSÍ",121
8,"8060",144,87,87,0,0,"ERC-CATSÍ",21
8,"8137",262,188,187,2,1,"ERC-CATSÍ",52
25,"25908",226,144,143,3,1,"ERC-CATSÍ",39
25,"25152",140,86,86,1,0,"ERC-CATSÍ",27
25,"25164",376,242,238,4,4,"ERC-CATSÍ",59
8,"8225",92,66,66,4,0,"ERC-CATSÍ",15
25,"25139",467,294,291,5,3,"ERC-CATSÍ",122
43,"43176",785,523,520,4,3,"ERC-CATSÍ",207
8,"8039",362,266,266,0,0,"ERC-CATSÍ",84
43,"43177",299,231,230,6,1,"ERC-CATSÍ",72
8,"8903",214,166,165,0,1,"ERC-CATSÍ",76
43,"43027",161,118,116,15,2,"ERC-CATSÍ",27
43,"43150",1281,937,923,6,14,"ERC-CATSÍ",277
25,"25140",788,435,430,9,5,"ERC-CATSÍ",114
17,"17119",74,54,54,0,0,"ERC-CATSÍ",22
8,"8147",16967,11220,11138,65,82,"ERC-CATSÍ",2034
43,"43014",14251,8737,8624,101,113,"ERC-CATSÍ",2386
17,"17083",2940,1895,1876,16,19,"ERC-CATSÍ",413
17,"17134",228,162,161,0,1,"ERC-CATSÍ",52
8,"8045",73,37,35,0,2,"ERC-CATSÍ",9
17,"17139",1364,884,865,8,19,"ERC-CATSÍ",285
25,"25099",1273,761,752,7,9,"ERC-CATSÍ",219
8,"8204",3055,2094,2082,17,12,"ERC-CATSÍ",382
17,"17015",12546,7832,7777,66,55,"ERC-CATSÍ",2866
17,"17040",537,347,345,3,2,"ERC-CATSÍ",115
8,"8304",812,562,558,3,4,"ERC-CATSÍ",196
25,"25019",4572,2726,2698,34,28,"ERC-CATSÍ",521
25,"25189",2110,1198,1186,10,12,"ERC-CATSÍ",294
8,"8054",8998,6172,6129,44,43,"ERC-CATSÍ",998
43,"43103",880,547,545,4,2,"ERC-CATSÍ",91
17,"17008",3639,2191,2171,16,20,"ERC-CATSÍ",644
17,"17037",104,69,69,1,0,"ERC-CATSÍ",17
8,"8082",1139,711,708,4,3,"ERC-CATSÍ",83
8,"8096",42622,28797,28615,263,182,"ERC-CATSÍ",4813
25,"25228",3035,1933,1921,26,12,"ERC-CATSÍ",465
25,"25234",4279,2546,2508,23,38,"ERC-CATSÍ",663
43,"43143",54,47,47,3,0,"ERC-CATSÍ",9
8,"8220",2356,1690,1683,18,7,"ERC-CATSÍ",707
8,"8264",4325,2929,2908,26,21,"ERC-CATSÍ",628
17,"17145",1482,967,956,8,11,"ERC-CATSÍ",295
17,"17117",14353,8469,8426,49,43,"ERC-CATSÍ",1911
43,"43158",85,52,52,1,0,"ERC-CATSÍ",16
8,"8303",274,193,192,2,1,"ERC-CATSÍ",65
43,"43904",2900,1602,1573,32,29,"ERC-CATSÍ",407
43,"43119",799,470,468,8,2,"ERC-CATSÍ",100
25,"25176",309,216,211,1,5,"ERC-CATSÍ",59
17,"17016",731,500,496,1,4,"ERC-CATSÍ",181
8,"8057",60,45,44,1,1,"ERC-CATSÍ",17
25,"25086",522,346,341,2,5,"ERC-CATSÍ",131
43,"43140",2367,1550,1532,4,18,"ERC-CATSÍ",215
17,"17188",164,124,124,1,0,"ERC-CATSÍ",34
8,"8234",3200,2128,2114,21,14,"ERC-CATSÍ",544
25,"25143",84,56,55,0,1,"ERC-CATSÍ",13
8,"8085",1000,662,658,5,4,"ERC-CATSÍ",195
43,"43142",1100,698,688,5,10,"ERC-CATSÍ",205
25,"25114",98,72,72,0,0,"ERC-CATSÍ",24
43,"43167",375,277,275,9,2,"ERC-CATSÍ",91
17,"17165",656,439,435,3,4,"ERC-CATSÍ",133
25,"25088",96,73,72,0,1,"ERC-CATSÍ",14
25,"25072",5850,3493,3444,29,49,"ERC-CATSÍ",903
43,"43096",99,81,80,1,1,"ERC-CATSÍ",26
25,"25205",566,382,372,8,10,"ERC-CATSÍ",86
43,"43060",2860,1950,1926,12,24,"ERC-CATSÍ",638
25,"25006",340,201,200,6,1,"ERC-CATSÍ",56
8,"8249",266,211,209,2,2,"ERC-CATSÍ",75
25,"25224",126,70,70,5,0,"ERC-CATSÍ",23
8,"8227",2326,1508,1487,20,21,"ERC-CATSÍ",360
8,"8063",453,337,336,4,1,"ERC-CATSÍ",122
17,"17148",1515,981,972,4,9,"ERC-CATSÍ",211
43,"43050",2505,1507,1496,12,11,"ERC-CATSÍ",191
25,"25222",66,52,52,1,0,"ERC-CATSÍ",11
8,"8047",3899,2292,2260,16,32,"ERC-CATSÍ",536
8,"8265",1553,1028,1018,11,10,"ERC-CATSÍ",430
25,"25061",83,46,46,0,0,"ERC-CATSÍ",6
8,"8205",59828,43344,43140,367,204,"ERC-CATSÍ",9080
17,"17194",80,55,54,0,1,"ERC-CATSÍ",27
8,"8056",42140,28129,27977,257,152,"ERC-CATSÍ",2969
8,"8088",11899,8149,8097,69,52,"ERC-CATSÍ",2295
17,"17107",264,167,165,8,2,"ERC-CATSÍ",54
25,"25016",2107,1268,1259,14,9,"ERC-CATSÍ",396
25,"25185",692,400,397,6,3,"ERC-CATSÍ",130
8,"8048",582,419,417,4,2,"ERC-CATSÍ",143
25,"25227",652,402,400,4,2,"ERC-CATSÍ",144
43,"43061",45,30,29,0,1,"ERC-CATSÍ",6
43,"43109",2606,1491,1475,20,16,"ERC-CATSÍ",142
17,"17001",587,404,398,2,6,"ERC-CATSÍ",139
25,"25081",308,189,189,2,0,"ERC-CATSÍ",44
8,"8183",4550,2809,2796,20,13,"ERC-CATSÍ",932
8,"8061",1497,986,983,14,3,"ERC-CATSÍ",154
8,"8199",663,456,453,14,3,"ERC-CATSÍ",116
17,"17061",156,104,103,1,1,"ERC-CATSÍ",41
25,"25252",548,343,342,9,1,"ERC-CATSÍ",80
17,"17128",308,205,203,3,2,"ERC-CATSÍ",75
43,"43118",419,311,308,5,3,"ERC-CATSÍ",122
17,"17002",556,401,396,0,5,"ERC-CATSÍ",127
25,"25122",1915,1208,1197,16,11,"ERC-CATSÍ",466
25,"25044",188,122,120,7,2,"ERC-CATSÍ",21
25,"25100",211,125,124,1,1,"ERC-CATSÍ",36
43,"43049",728,464,461,4,3,"ERC-CATSÍ",202
43,"43035",254,156,155,2,1,"ERC-CATSÍ",43
17,"17201",135,87,84,0,3,"ERC-CATSÍ",33
8,"8258",830,557,551,6,6,"ERC-CATSÍ",264
25,"25001",144,73,73,0,0,"ERC-CATSÍ",29
8,"8185",188,123,122,2,1,"ERC-CATSÍ",35
8,"8171",2103,1288,1280,12,8,"ERC-CATSÍ",501
8,"8285",10224,6396,6342,52,54,"ERC-CATSÍ",1929
43,"43138",2672,1629,1585,37,44,"ERC-CATSÍ",240
8,"8251",4984,3257,3241,17,16,"ERC-CATSÍ",553
8,"8026",188,134,134,0,0,"ERC-CATSÍ",51
17,"17071",1134,778,774,10,4,"ERC-CATSÍ",311
8,"8217",24989,17765,17661,114,104,"ERC-CATSÍ",1919
8,"8275",247,179,179,4,0,"ERC-CATSÍ",66
8,"8195",82,63,63,0,0,"ERC-CATSÍ",17
8,"8198",4411,2972,2954,23,18,"ERC-CATSÍ",849
8,"8246",1665,1086,1078,9,8,"ERC-CATSÍ",398
8,"8136",11450,7703,7641,84,62,"ERC-CATSÍ",586
17,"17007",1731,1191,1182,7,9,"ERC-CATSÍ",360
43,"43090",1076,565,558,6,7,"ERC-CATSÍ",41
25,"25251",707,443,442,2,1,"ERC-CATSÍ",117
43,"43041",216,152,151,0,1,"ERC-CATSÍ",32
43,"43046",99,68,65,1,3,"ERC-CATSÍ",25
25,"25218",81,64,63,1,1,"ERC-CATSÍ",27
17,"17177",549,332,331,1,1,"ERC-CATSÍ",115
8,"8003",7084,4839,4803,39,36,"ERC-CATSÍ",1158
8,"8127",2225,1349,1334,14,15,"ERC-CATSÍ",304
8,"8152",114,80,79,0,1,"ERC-CATSÍ",39
43,"43902",2743,1551,1531,23,20,"ERC-CATSÍ",270
17,"17056",1715,1120,1106,16,14,"ERC-CATSÍ",332
25,"25126",290,200,198,2,2,"ERC-CATSÍ",57
8,"8111",218,185,184,3,1,"ERC-CATSÍ",55
25,"25211",680,386,379,4,7,"ERC-CATSÍ",155
17,"17901",987,623,620,9,3,"ERC-CATSÍ",225
17,"17019",1775,1201,1188,7,13,"ERC-CATSÍ",377
25,"25015",357,219,219,2,0,"ERC-CATSÍ",70
43,"43146",39,29,28,0,1,"ERC-CATSÍ",16
17,"17022",6910,4207,4184,58,23,"ERC-CATSÍ",1421
25,"25005",279,175,175,4,0,"ERC-CATSÍ",57
8,"8212",488,319,316,0,3,"ERC-CATSÍ",107
17,"17180",8295,4958,4935,36,23,"ERC-CATSÍ",1560
8,"8031",2322,1552,1537,6,15,"ERC-CATSÍ",383
8,"8236",1527,1006,999,4,7,"ERC-CATSÍ",382
25,"25219",141,102,101,0,1,"ERC-CATSÍ",39
17,"17027",2821,1896,1889,17,7,"ERC-CATSÍ",686
43,"43098",343,235,233,5,2,"ERC-CATSÍ",64
25,"25232",1397,874,871,12,3,"ERC-CATSÍ",217
8,"8123",19140,13557,13484,106,73,"ERC-CATSÍ",2964
25,"25158",1620,1019,1012,15,7,"ERC-CATSÍ",313
8,"8156",10891,7322,7259,43,63,"ERC-CATSÍ",1186
25,"25093",640,403,395,7,8,"ERC-CATSÍ",99
8,"8093",27,21,21,0,0,"ERC-CATSÍ",10
43,"43131",4647,2934,2916,21,18,"ERC-CATSÍ",293
17,"17070",111,76,76,2,0,"ERC-CATSÍ",23
43,"43907",4374,2793,2783,24,10,"ERC-CATSÍ",214
25,"25207",6212,3710,3680,47,30,"ERC-CATSÍ",1352
8,"8155",6730,4353,4320,39,33,"ERC-CATSÍ",721
43,"43903",2392,1324,1313,10,11,"ERC-CATSÍ",408
43,"43016",3416,2335,2309,15,26,"ERC-CATSÍ",346
17,"17204",572,355,354,4,1,"ERC-CATSÍ",81
8,"8289",4338,2912,2898,27,14,"ERC-CATSÍ",800
43,"43010",322,233,227,0,6,"ERC-CATSÍ",69
8,"8207",1865,1407,1402,19,5,"ERC-CATSÍ",591
25,"25013",2146,1240,1226,16,14,"ERC-CATSÍ",214
43,"43114",392,271,268,2,3,"ERC-CATSÍ",119
17,"17047",4798,2773,2757,28,16,"ERC-CATSÍ",658
8,"8271",70,48,48,0,0,"ERC-CATSÍ",20
8,"8270",18490,12343,12274,93,69,"ERC-CATSÍ",2245
17,"17052",125,78,78,0,0,"ERC-CATSÍ",21
17,"17092",3509,2256,2223,18,33,"ERC-CATSÍ",623
8,"8293",219,168,167,0,1,"ERC-CATSÍ",63
43,"43905",14392,8444,8393,45,51,"ERC-CATSÍ",839
25,"25110",2766,1628,1602,22,26,"ERC-CATSÍ",442
8,"8115",3799,2589,2572,17,17,"ERC-CATSÍ",368
25,"25135",1028,600,593,10,7,"ERC-CATSÍ",166
8,"8083",1675,1146,1144,9,2,"ERC-CATSÍ",494
43,"43009",1403,918,905,14,13,"ERC-CATSÍ",283
8,"8248",5419,3566,3546,45,20,"ERC-CATSÍ",814
8,"8034",763,538,537,1,1,"ERC-CATSÍ",216
8,"8245",78562,50821,50538,384,283,"ERC-CATSÍ",2929
25,"25131",403,248,241,7,7,"ERC-CATSÍ",63
25,"25021",2607,1490,1481,20,9,"ERC-CATSÍ",476
8,"8306",506,299,297,5,2,"ERC-CATSÍ",72
17,"17189",1516,1076,1070,5,6,"ERC-CATSÍ",425
8,"8301",48557,32715,32533,253,182,"ERC-CATSÍ",2478
43,"43086",5249,3271,3244,37,27,"ERC-CATSÍ",1110
43,"43055",1975,1384,1379,21,5,"ERC-CATSÍ",517
43,"43128",907,587,577,5,10,"ERC-CATSÍ",134
43,"43155",22873,14209,14082,153,127,"ERC-CATSÍ",2867
25,"25149",1385,963,956,6,7,"ERC-CATSÍ",251
8,"8101",174621,113632,112942,847,690,"ERC-CATSÍ",9450
43,"43036",843,493,485,4,8,"ERC-CATSÍ",103
8,"8049",1293,790,779,3,11,"ERC-CATSÍ",299
8,"8071",240,163,162,5,1,"ERC-CATSÍ",60
43,"43154",130,101,100,0,1,"ERC-CATSÍ",52
25,"25119",2248,1449,1442,15,7,"ERC-CATSÍ",483
25,"25123",193,134,131,2,3,"ERC-CATSÍ",55
43,"43137",1868,1254,1242,11,12,"ERC-CATSÍ",276
17,"17035",548,381,379,5,2,"ERC-CATSÍ",146
17,"17087",225,152,149,2,3,"ERC-CATSÍ",42
8,"8074",10611,6728,6679,52,49,"ERC-CATSÍ",907
25,"25036",184,112,111,4,1,"ERC-CATSÍ",25
17,"17033",5307,3264,3241,29,23,"ERC-CATSÍ",796
43,"43062",281,217,215,2,2,"ERC-CATSÍ",30
43,"43141",106,68,67,0,1,"ERC-CATSÍ",22
25,"25182",1036,660,655,9,5,"ERC-CATSÍ",166
43,"43085",226,180,180,1,0,"ERC-CATSÍ",58
25,"25087",60,43,43,0,0,"ERC-CATSÍ",17
8,"8224",820,557,551,2,6,"ERC-CATSÍ",155
25,"25033",1096,729,723,4,6,"ERC-CATSÍ",242
17,"17141",5887,3197,3165,34,32,"ERC-CATSÍ",611
43,"43022",1497,897,889,14,8,"ERC-CATSÍ",196
43,"43123",70482,44051,43675,345,376,"ERC-CATSÍ",7911
43,"43006",681,438,437,9,1,"ERC-CATSÍ",90
25,"25132",136,88,87,0,1,"ERC-CATSÍ",27
8,"8165",1649,1100,1085,9,15,"ERC-CATSÍ",220
25,"25009",627,444,440,8,4,"ERC-CATSÍ",115
43,"43063",557,355,349,9,6,"ERC-CATSÍ",63
17,"17042",419,272,272,2,0,"ERC-CATSÍ",69
8,"8010",4168,2631,2606,20,25,"ERC-CATSÍ",806
8,"8208",5732,3976,3952,30,24,"ERC-CATSÍ",709
17,"17163",2626,1764,1747,10,17,"ERC-CATSÍ",649
43,"43104",1783,1157,1142,10,15,"ERC-CATSÍ",490
43,"43144",1247,842,836,6,6,"ERC-CATSÍ",245
25,"25208",331,183,182,1,1,"ERC-CATSÍ",71
25,"25105",125,92,92,2,0,"ERC-CATSÍ",24
25,"25192",743,449,436,2,13,"ERC-CATSÍ",150
17,"17043",161,122,117,1,5,"ERC-CATSÍ",28
25,"25060",72,46,44,1,2,"ERC-CATSÍ",13
8,"8170",450,276,274,7,2,"ERC-CATSÍ",83
8,"8044",4141,2739,2726,15,13,"ERC-CATSÍ",673
8,"8238",14531,10378,10325,98,53,"ERC-CATSÍ",2388
17,"17228",288,179,176,1,3,"ERC-CATSÍ",59
25,"25249",182,99,98,1,1,"ERC-CATSÍ",45
45,"45018",498,333,330,4,3,"FE",0
45,"45023",2177,1571,1556,6,15,"FE",2
45,"45066",7570,5550,5484,25,66,"FE",5
45,"45194",68,54,53,0,1,"FE",0
45,"45124",2140,1677,1641,10,36,"FE",1
45,"45019",7377,5307,5251,37,56,"FE",2
45,"45186",3061,2242,2214,11,28,"FE",2
45,"45165",62718,44420,44006,236,414,"FE",33
45,"45191",543,472,468,3,4,"FE",0
45,"45121",6796,4743,4692,22,51,"FE",7
45,"45157",2128,1456,1427,13,29,"FE",4
45,"45043",793,657,649,1,8,"FE",1
45,"45058",375,311,304,1,7,"FE",0
45,"45123",3081,2144,2131,11,13,"FE",1
45,"45170",228,176,167,0,9,"FE",0
45,"45042",187,140,140,0,0,"FE",0
45,"45068",160,126,126,0,0,"FE",0
45,"45132",2197,1645,1632,14,13,"FE",0
45,"45057",222,180,177,1,3,"FE",0
45,"45001",1835,1281,1251,3,30,"FE",3
45,"45089",1495,1102,1094,0,8,"FE",0
45,"45096",1004,807,799,1,8,"FE",0
45,"45052",2948,2321,2295,16,26,"FE",1
45,"45030",478,368,360,2,8,"FE",0
45,"45134",1581,1204,1192,6,12,"FE",0
45,"45031",2723,1835,1822,12,13,"FE",3
45,"45113",1915,1390,1366,6,24,"FE",0
45,"45128",2502,1680,1668,6,12,"FE",0
45,"45139",167,139,139,1,0,"FE",0
45,"45007",696,534,522,3,12,"FE",0
45,"45119",3330,2096,2067,15,29,"FE",0
45,"45110",1786,1403,1398,5,5,"FE",0
45,"45091",394,269,267,3,2,"FE",0
45,"45063",417,310,303,1,7,"FE",0
45,"45159",90,75,75,0,0,"FE",0
45,"45149",556,446,440,0,6,"FE",0
45,"45204",632,488,487,1,1,"FE",0
45,"45161",13688,9007,8902,32,105,"FE",11
45,"45020",1290,1037,1026,6,11,"FE",0
45,"45051",1590,1171,1152,5,19,"FE",1
45,"45129",131,92,92,0,0,"FE",0
45,"45177",2110,1679,1656,3,23,"FE",0
45,"45037",1603,1122,1111,5,11,"FE",0
45,"45009",524,344,341,2,3,"FE",1
45,"45189",599,470,462,2,8,"FE",0
45,"45183",2220,1444,1428,3,16,"FE",1
45,"45127",696,514,511,3,3,"FE",0
45,"45046",2412,1667,1654,7,13,"FE",0
45,"45199",2940,1848,1805,14,43,"FE",2
45,"45143",1170,881,874,4,7,"FE",1
45,"45192",2491,2069,2049,2,20,"FE",3
45,"45029",201,171,171,1,0,"FE",0
45,"45025",1205,831,827,2,4,"FE",1
45,"45174",301,237,233,1,4,"FE",0
45,"45045",1318,905,888,5,17,"FE",1
45,"45005",238,193,192,3,1,"FE",0
45,"45002",2564,1681,1665,17,16,"FE",2
45,"45053",8005,6211,6140,42,71,"FE",2
45,"45163",8298,5942,5855,28,87,"FE",8
45,"45154",1493,1079,1074,6,5,"FE",6
45,"45099",3500,2390,2361,9,29,"FE",5
45,"45024",1062,793,785,4,8,"FE",0
45,"45125",2305,1865,1841,8,24,"FE",1
45,"45027",346,275,272,0,3,"FE",0
45,"45086",496,351,343,2,8,"FE",0
45,"45049",433,305,304,1,1,"FE",1
45,"45147",581,450,446,1,4,"FE",3
45,"45106",7439,5613,5534,52,79,"FE",4
45,"45169",189,140,138,0,2,"FE",0
45,"45115",2552,1999,1966,8,33,"FE",0
45,"45180",2727,1966,1940,9,26,"FE",1
45,"45090",384,294,293,3,1,"FE",0
45,"45197",1906,1455,1430,8,25,"FE",0
45,"45100",188,150,150,0,0,"FE",0
45,"45011",278,239,233,1,6,"FE",0
45,"45188",2785,1960,1938,15,22,"FE",2
45,"45081",17875,12656,12533,82,123,"FE",16
45,"45080",6,6,6,0,0,"FE",0
45,"45184",200,129,129,0,0,"FE",0
45,"45014",4010,2646,2616,22,30,"FE",1
45,"45196",1400,1047,1033,5,14,"FE",0
45,"45126",260,176,175,3,1,"FE",0
45,"45047",2606,1666,1647,6,19,"FE",1
45,"45164",182,162,160,1,2,"FE",0
45,"45162",669,494,486,2,8,"FE",0
45,"45201",3447,2082,2050,9,32,"FE",3
45,"45022",391,285,281,3,4,"FE",0
45,"45160",1109,874,864,6,10,"FE",0
45,"45120",129,104,104,1,0,"FE",0
45,"45083",472,368,365,0,3,"FE",0
45,"45118",1991,1351,1339,6,12,"FE",0
45,"45155",355,291,285,0,6,"FE",0
45,"45079",369,288,286,3,2,"FE",0
45,"45071",1835,1426,1408,5,18,"FE",0
45,"45176",3706,2554,2521,22,33,"FE",1
45,"45074",414,327,323,1,4,"FE",0
45,"45048",358,278,275,1,3,"FE",0
45,"45075",143,109,108,0,1,"FE",0
45,"45078",1379,1129,1119,6,10,"FE",0
45,"45156",3410,2751,2711,13,40,"FE",1
45,"45195",2141,1635,1606,7,29,"FE",1
45,"45010",415,311,310,2,1,"FE",0
45,"45059",1712,1337,1311,1,26,"FE",1
45,"45171",1361,1035,1023,0,12,"FE",0
45,"45152",587,458,451,0,7,"FE",0
45,"45073",298,233,233,1,0,"FE",0
45,"45135",4269,3340,3288,8,52,"FE",4
45,"45036",656,471,469,2,2,"FE",0
45,"45108",509,412,411,1,1,"FE",0
45,"45026",211,167,166,2,1,"FE",0
45,"45072",671,484,483,2,1,"FE",0
45,"45095",689,513,505,0,8,"FE",1
45,"45111",65,50,50,0,0,"FE",0
45,"45193",613,504,497,1,7,"FE",1
45,"45050",457,333,328,1,5,"FE",0
45,"45182",1034,806,791,1,15,"FE",2
45,"45013",1758,1352,1329,8,23,"FE",0
45,"45181",2315,1674,1640,7,34,"FE",0
45,"45021",2500,1708,1665,12,43,"FE",3
45,"45039",224,192,190,0,2,"FE",1
45,"45064",3858,2804,2763,20,41,"FE",0
45,"45146",107,84,83,0,1,"FE",0
45,"45038",3356,2376,2350,15,26,"FE",5
45,"45103",397,331,327,3,4,"FE",0
45,"45003",562,408,402,1,6,"FE",1
45,"45133",2797,2068,2048,13,20,"FE",2
45,"45067",2318,1791,1752,19,39,"FE",1
45,"45069",1847,1391,1376,6,15,"FE",1
45,"45094",387,298,297,1,1,"FE",0
45,"45173",9520,6938,6864,30,74,"FE",7
45,"45136",5845,4091,4019,25,72,"FE",0
45,"45140",1087,833,823,3,10,"FE",0
45,"45076",553,368,364,3,4,"FE",1
45,"45901",771,547,544,3,3,"FE",8
45,"45185",7700,5771,5691,20,80,"FE",3
45,"45130",317,253,250,1,3,"FE",0
45,"45148",292,223,223,0,0,"FE",0
45,"45105",392,301,297,3,4,"FE",0
45,"45034",1353,1082,1078,6,4,"FE",0
45,"45006",1406,942,931,4,11,"FE",0
45,"45085",1500,1011,999,4,12,"FE",4
45,"45114",588,447,447,0,0,"FE",0
45,"45077",556,428,427,1,1,"FE",1
45,"45190",475,371,366,0,5,"FE",1
45,"45205",6824,4424,4362,22,62,"FE",4
45,"45055",1020,821,790,6,31,"FE",1
45,"45032",436,283,275,1,8,"FE",0
45,"45167",1440,1144,1133,6,11,"FE",0
45,"45141",884,700,689,3,11,"FE",0
45,"45061",2447,1703,1689,12,14,"FE",1
45,"45097",1046,839,834,4,5,"FE",0
45,"45054",3959,2882,2848,12,34,"FE",1
45,"45107",3257,2504,2472,15,32,"FE",0
45,"45131",282,234,230,0,4,"FE",0
45,"45033",343,249,243,2,6,"FE",0
45,"45138",1091,877,871,4,6,"FE",0
45,"45153",1615,1258,1243,7,15,"FE",0
45,"45102",3610,2506,2470,14,36,"FE",0
45,"45092",232,197,191,0,6,"FE",0
45,"45065",271,207,206,1,1,"FE",0
45,"45168",62229,47154,46741,285,413,"FE",23
45,"45041",3752,2633,2597,12,36,"FE",3
45,"45040",1349,846,838,4,8,"FE",0
45,"45187",4062,3277,3233,15,44,"FE",2
45,"45035",281,212,209,1,3,"FE",0
45,"45112",1922,1247,1211,6,36,"FE",0
45,"45166",1617,1305,1286,8,19,"FE",0
45,"45145",2565,1695,1675,12,20,"FE",0
45,"45198",1809,1475,1442,7,33,"FE",0
45,"45028",3649,2701,2673,12,28,"FE",1
45,"45084",2257,1679,1656,13,23,"FE",0
45,"45015",606,437,433,2,4,"FE",1
45,"45200",4592,3539,3476,14,63,"FE",0
45,"45150",443,356,354,0,2,"FE",0
45,"45004",567,410,406,1,4,"FE",0
45,"45179",525,391,386,3,5,"FE",0
45,"45142",7871,6007,5927,37,80,"FE",2
45,"45088",2115,1351,1338,4,13,"FE",2
45,"45104",428,324,323,1,1,"FE",0
45,"45098",2159,1632,1609,12,23,"FE",0
45,"45082",1224,1020,1011,8,9,"FE",0
45,"45172",689,530,522,2,8,"FE",0
45,"45202",3894,2776,2744,14,32,"FE",1
45,"45101",3756,3020,2984,12,36,"FE",0
45,"45016",4204,3146,3105,22,41,"FE",3
45,"45056",2201,1260,1243,12,17,"FE",4
45,"45008",139,118,118,1,0,"FE",0
45,"45122",5212,4004,3961,16,43,"FE",2
45,"45070",1427,1147,1142,1,5,"FE",0
45,"45203",2563,1801,1771,8,30,"FE",1
45,"45175",664,545,543,5,2,"FE",1
45,"45151",578,417,414,0,3,"FE",0
45,"45158",2514,1777,1760,11,17,"FE",0
45,"45087",8311,5828,5747,43,81,"FE",2
45,"45012",661,510,503,6,7,"FE",0
45,"45017",262,204,203,0,1,"FE",0
45,"45060",173,126,125,1,1,"FE",0
45,"45062",1112,878,867,4,11,"FE",0
45,"45117",747,606,601,4,5,"FE",0
45,"45137",1604,1032,1024,4,8,"FE",0
45,"45144",783,620,618,3,2,"FE",2
45,"45109",2883,2271,2214,9,57,"FE",3
45,"45093",155,129,127,1,2,"FE",0
45,"45116",687,509,505,1,4,"FE",0
47,"47232",102,77,74,1,3,"FE de las J",0
5,"5224",102,86,84,3,2,"FE de las J",0
14,"14049",16309,11635,11515,115,120,"FE de las J",11
28,"28118",57,46,45,0,1,"FE de las J",0
5,"5099",491,395,386,6,9,"FE de las J",2
4,"4066",13571,8786,8724,50,62,"FE de las J",1
5,"5179",214,178,176,1,2,"FE de las J",0
44,"44190",71,58,56,0,2,"FE de las J",0
40,"40191",215,181,179,1,2,"FE de las J",0
2,"2057",2020,1487,1461,10,26,"FE de las J",1
11,"11008",17471,10952,10812,128,140,"FE de las J",8
19,"19244",82,65,64,1,1,"FE de las J",0
4,"4093",1882,1216,1204,11,12,"FE de las J",1
45,"45155",355,291,285,0,6,"FE de las J",0
42,"42052",15,13,13,0,0,"FE de las J",0
45,"45118",1991,1351,1339,6,12,"FE de las J",3
47,"47060",258,216,214,1,2,"FE de las J",0
19,"19019",20,18,17,0,1,"FE de las J",0
42,"42098",10,7,7,1,0,"FE de las J",0
19,"19022",625,476,469,3,7,"FE de las J",2
42,"42089",54,44,44,0,0,"FE de las J",0
19,"19091",26,20,20,0,0,"FE de las J",0
19,"19303",43,35,35,0,0,"FE de las J",0
34,"34107",81,52,51,5,1,"FE de las J",0
19,"19040",52,41,39,0,2,"FE de las J",0
45,"45056",2201,1260,1243,12,17,"FE de las J",1
47,"47085",16612,11829,11706,114,123,"FE de las J",18
5,"5232",102,84,79,1,5,"FE de las J",0
5,"5216",220,171,168,0,3,"FE de las J",0
5,"5100",278,227,223,1,4,"FE de las J",0
19,"19020",44,30,30,1,0,"FE de las J",0
44,"44198",182,147,146,4,1,"FE de las J",0
19,"19252",69,60,60,0,0,"FE de las J",0
45,"45180",2727,1966,1940,9,26,"FE de las J",2
34,"34130",212,164,163,1,1,"FE de las J",0
2,"2001",656,527,523,1,4,"FE de las J",0
5,"5015",82,61,61,1,0,"FE de las J",0
5,"5060",116,95,95,0,0,"FE de las J",0
34,"34205",61,50,50,0,0,"FE de las J",0
5,"5131",99,69,69,0,0,"FE de las J",0
2,"2003",132346,95878,95217,630,661,"FE de las J",121
34,"34137",27,23,22,0,1,"FE de las J",0
42,"42189",60,46,45,0,1,"FE de las J",0
12,"12076",84,69,69,0,0,"FE de las J",0
41,"41096",6161,4553,4476,32,77,"FE de las J",5
47,"47169",68,59,59,0,0,"FE de las J",0
44,"44071",591,398,398,5,0,"FE de las J",2
47,"47066",1268,981,977,12,4,"FE de las J",4
34,"34901",1104,825,814,5,11,"FE de las J",1
5,"5094",139,116,116,1,0,"FE de las J",1
40,"40185",863,646,642,3,4,"FE de las J",1
19,"19229",66,56,56,0,0,"FE de las J",0
42,"42202",20,14,13,0,1,"FE de las J",0
34,"34904",315,234,230,2,4,"FE de las J",0
45,"45096",1004,807,799,1,8,"FE de las J",1
44,"44220",121,84,83,1,1,"FE de las J",1
12,"12111",360,305,299,3,6,"FE de las J",0
34,"34120",64214,47193,46683,331,510,"FE de las J",78
47,"47161",3918,3145,3126,12,19,"FE de las J",4
28,"28163",442,344,339,1,5,"FE de las J",0
47,"47149",42,34,34,3,0,"FE de las J",0
28,"28024",151,125,124,1,1,"FE de las J",0
28,"28178",1065,824,818,5,6,"FE de las J",0
19,"19125",41,32,32,0,0,"FE de las J",0
47,"47076",17399,13097,12972,92,125,"FE de las J",18
5,"5008",227,170,168,1,2,"FE de las J",0
41,"41027",3922,2660,2604,23,56,"FE de las J",2
40,"40017",92,75,75,0,0,"FE de las J",0
4,"4053",12320,8946,8866,70,80,"FE de las J",2
19,"19210",21,19,18,1,1,"FE de las J",0
47,"47087",381,301,297,3,4,"FE de las J",0
28,"28162",2617,2029,2016,6,13,"FE de las J",2
4,"4079",51383,33777,33586,257,191,"FE de las J",39
19,"19145",46,41,41,1,0,"FE de las J",0
34,"34221",179,144,144,3,0,"FE de las J",1
40,"40149",514,375,369,5,6,"FE de las J",0
41,"41019",4691,3089,3056,27,33,"FE de las J",5
46,"46119",780,653,647,5,6,"FE de las J",0
45,"45111",65,50,50,0,0,"FE de las J",0
45,"45133",2797,2068,2048,13,20,"FE de las J",0
28,"28104",14040,11151,11096,57,55,"FE de las J",18
41,"41056",3687,2841,2812,30,29,"FE de las J",1
4,"4015",124,96,96,2,0,"FE de las J",0
41,"41005",9068,6366,6281,58,85,"FE de las J",4
5,"5021",1914,1483,1464,5,19,"FE de las J",5
42,"42168",107,80,80,0,0,"FE de las J",0
44,"44066",108,79,74,0,5,"FE de las J",0
34,"34171",968,708,703,5,5,"FE de las J",1
45,"45021",2500,1708,1665,12,43,"FE de las J",4
44,"44268",25,25,24,0,1,"FE de las J",0
45,"45088",2115,1351,1338,4,13,"FE de las J",3
46,"46236",972,818,809,2,9,"FE de las J",0
40,"40107",100,73,73,1,0,"FE de las J",0
14,"14021",260178,181773,180348,1872,1425,"FE de las J",140
41,"41094",6288,4497,4449,38,48,"FE de las J",5
45,"45048",358,278,275,1,3,"FE de las J",1
47,"47143",118,91,90,0,1,"FE de las J",0
44,"44232",378,284,276,6,8,"FE de las J",0
40,"40207",763,599,593,3,6,"FE de las J",1
44,"44163",126,94,94,1,0,"FE de las J",0
47,"47116",416,341,339,0,2,"FE de las J",0
46,"46007",11989,8784,8711,67,73,"FE de las J",6
45,"45154",1493,1079,1074,6,5,"FE de las J",2
44,"44123",105,71,70,1,1,"FE de las J",0
5,"5154",38,33,33,0,0,"FE de las J",0
47,"47115",281,236,233,3,3,"FE de las J",0
5,"5231",165,133,133,2,0,"FE de las J",0
34,"34169",404,287,286,0,1,"FE de las J",0
44,"44020",24,20,19,1,1,"FE de las J",0
28,"28012",887,664,661,2,3,"FE de las J",2
5,"5093",408,294,292,1,2,"FE de las J",0
19,"19200",71,52,52,1,0,"FE de las J",0
40,"40109",73,59,59,1,0,"FE de las J",0
14,"14051",1397,1018,1000,2,18,"FE de las J",1
5,"5005",182,148,147,3,1,"FE de las J",0
42,"42017",140,113,112,0,1,"FE de las J",0
40,"40052",74,60,60,0,0,"FE de las J",0
12,"12100",1333,1065,1047,10,18,"FE de las J",0
45,"45151",578,417,414,0,3,"FE de las J",1
28,"28093",2096,1670,1653,10,17,"FE de las J",3
44,"44016",482,363,360,2,3,"FE de las J",2
44,"44159",38,31,31,1,0,"FE de las J",0
19,"19281",21,15,15,2,0,"FE de las J",0
34,"34048",73,59,59,1,0,"FE de las J",0
28,"28089",3677,2748,2730,10,18,"FE de las J",3
34,"34134",50,40,40,2,0,"FE de las J",0
42,"42193",14,10,10,0,0,"FE de las J",0
40,"40158",17,12,12,0,0,"FE de las J",0
45,"45035",281,212,209,1,3,"FE de las J",1
2,"2006",579,464,458,3,6,"FE de las J",0
28,"28005",134246,99236,98481,583,755,"FE de las J",174
28,"28042",1173,890,883,3,7,"FE de las J",1
19,"19304",219,173,171,3,2,"FE de las J",0
28,"28176",12491,9723,9667,37,56,"FE de las J",12
46,"46149",363,271,268,2,3,"FE de las J",0
5,"5110",711,510,505,4,5,"FE de las J",0
46,"46123",1829,1407,1388,7,19,"FE de las J",1
4,"4018",270,232,229,0,3,"FE de las J",0
19,"19152",556,390,382,1,8,"FE de las J",1
47,"47189",152,119,118,0,1,"FE de las J",0
47,"47109",179,138,138,2,0,"FE de las J",0
44,"44010",175,130,128,1,2,"FE de las J",0
19,"19044",304,245,244,0,1,"FE de las J",0
12,"12060",446,368,364,4,4,"FE de las J",0
2,"2068",337,251,246,1,5,"FE de las J",0
2,"2070",403,332,328,4,4,"FE de las J",0
40,"40046",89,75,75,1,0,"FE de las J",0
5,"5062",179,148,147,0,1,"FE de las J",2
42,"42116",45,39,38,3,1,"FE de las J",0
44,"44144",346,248,245,2,3,"FE de las J",0
12,"12063",41,29,29,1,0,"FE de las J",0
28,"28079",2362038,1743924,1733354,8859,10570,"FE de las J",1648
47,"47181",165,135,132,3,3,"FE de las J",0
28,"28002",3007,2091,2074,14,17,"FE de las J",7
47,"47231",4401,3299,3277,24,22,"FE de las J",6
40,"40180",299,246,241,1,5,"FE de las J",1
42,"42160",254,206,205,0,1,"FE de las J",0
5,"5083",140,110,105,1,5,"FE de las J",0
19,"19163",56,41,40,0,1,"FE de las J",0
28,"28035",1353,1006,998,2,8,"FE de las J",0
45,"45166",1617,1305,1286,8,19,"FE de las J",0
34,"34072",152,136,135,2,1,"FE de las J",0
5,"5116",109,89,89,1,0,"FE de las J",0
40,"40125",87,58,58,1,0,"FE de las J",0
19,"19173",45,38,36,0,2,"FE de las J",2
42,"42069",1536,1036,1019,6,17,"FE de las J",1
47,"47193",1577,1251,1241,7,10,"FE de las J",4
45,"45042",187,140,140,0,0,"FE de las J",0
47,"47112",2587,2015,1988,7,27,"FE de las J",1
28,"28026",6317,4734,4701,33,33,"FE de las J",7
2,"2023",568,486,479,3,7,"FE de las J",1
14,"14033",1283,971,959,9,12,"FE de las J",0
40,"40134",731,579,570,1,9,"FE de las J",0
34,"34184",57,46,45,0,1,"FE de las J",0
11,"11005",4583,3018,2967,25,51,"FE de las J",0
44,"44245",248,179,176,2,3,"FE de las J",0
41,"41090",3523,2576,2512,13,64,"FE de las J",1
45,"45162",669,494,486,2,8,"FE de las J",0
44,"44125",61,44,44,0,0,"FE de las J",0
5,"5063",32,28,27,0,1,"FE de las J",0
45,"45200",4592,3539,3476,14,63,"FE de las J",2
44,"44035",113,90,88,1,2,"FE de las J",0
12,"12017",161,130,128,0,2,"FE de las J",0
12,"12117",3585,2727,2677,20,50,"FE de las J",3
14,"14006",1330,1120,1101,8,19,"FE de las J",0
34,"34175",90,72,70,0,2,"FE de las J",0
19,"19319",4449,3086,3056,18,30,"FE de las J",11
4,"4032",5586,3642,3623,23,19,"FE de las J",4
45,"45066",7570,5550,5484,25,66,"FE de las J",6
44,"44178",58,37,37,0,0,"FE de las J",0
47,"47137",29,25,25,1,0,"FE de las J",0
46,"46200",1903,1561,1539,3,22,"FE de las J",1
44,"44119",130,92,91,3,1,"FE de las J",0
14,"14032",423,334,330,4,4,"FE de las J",0
46,"46075",150,130,123,1,7,"FE de las J",0
44,"44132",60,54,54,1,0,"FE de las J",0
44,"44112",429,290,290,2,0,"FE de las J",1
44,"44177",115,84,84,1,0,"FE de las J",0
44,"44210",746,554,545,3,9,"FE de las J",1
44,"44121",60,47,47,2,0,"FE de las J",0
41,"41085",4086,3058,3012,22,46,"FE de las J",2
40,"40118",51,35,34,1,1,"FE de las J",0
14,"14017",10868,7764,7665,71,99,"FE de las J",3
19,"19264",33,26,26,0,0,"FE de las J",0
4,"4030",1119,819,812,5,7,"FE de las J",0
5,"5205",74,57,55,1,2,"FE de las J",0
41,"41008",1059,749,739,10,10,"FE de las J",0
19,"19095",12,9,9,0,0,"FE de las J",0
40,"40001",702,560,554,3,6,"FE de las J",0
45,"45167",1440,1144,1133,6,11,"FE de las J",2
47,"47019",85,74,73,0,1,"FE de las J",0
2,"2010",1789,1437,1421,11,16,"FE de las J",1
14,"14009",2788,1852,1834,20,18,"FE de las J",3
44,"44250",19,12,12,0,0,"FE de las J",0
19,"19147",43,33,33,0,0,"FE de las J",0
40,"40080",59,43,41,0,2,"FE de las J",0
12,"12107",355,303,299,4,4,"FE de las J",0
45,"45098",2159,1632,1609,12,23,"FE de las J",2
42,"42144",436,353,348,2,5,"FE de las J",0
28,"28023",4775,3755,3735,12,20,"FE de las J",5
45,"45103",397,331,327,3,4,"FE de las J",0
44,"44103",132,102,102,1,0,"FE de las J",0
4,"4014",144,117,114,1,3,"FE de las J",0
46,"46227",905,711,702,1,9,"FE de las J",0
34,"34246",67,53,51,0,2,"FE de las J",0
40,"40170",1320,1030,1021,7,9,"FE de las J",2
44,"44180",70,61,61,0,0,"FE de las J",0
19,"19302",59,49,49,1,0,"FE de las J",0
14,"14074",2299,1896,1866,16,30,"FE de las J",1
4,"4083",1776,1345,1336,6,9,"FE de las J",0
44,"44021",107,89,88,0,1,"FE de las J",0
42,"42093",37,29,28,1,1,"FE de las J",0
44,"44179",337,229,226,1,3,"FE de las J",0
47,"47127",137,98,97,0,1,"FE de las J",0
46,"46114",569,461,458,1,3,"FE de las J",0
4,"4069",4687,3471,3437,27,34,"FE de las J",1
44,"44029",559,425,424,5,1,"FE de las J",0
41,"41098",5004,3665,3630,26,35,"FE de las J",4
40,"40161",36,28,28,2,0,"FE de las J",0
19,"19288",21,21,20,0,1,"FE de las J",0
40,"40051",38,34,34,0,0,"FE de las J",0
42,"42038",36,28,28,1,0,"FE de las J",0
12,"12112",99,79,78,3,1,"FE de las J",0
47,"47094",133,115,114,1,1,"FE de las J",0
19,"19032",165,126,124,1,2,"FE de las J",0
45,"45031",2723,1835,1822,12,13,"FE de las J",2
5,"5025",94,79,78,0,1,"FE de las J",0
41,"41095",41232,27076,26793,315,283,"FE de las J",19
4,"4081",355,287,287,0,0,"FE de las J",0
44,"44219",194,145,143,1,2,"FE de las J",0
41,"41048",2228,1470,1447,15,23,"FE de las J",1
28,"28096",18354,13310,13205,68,105,"FE de las J",23
46,"46195",1962,1531,1516,11,15,"FE de las J",3
5,"5197",102,85,83,1,2,"FE de las J",0
28,"28073",12549,8788,8701,54,87,"FE de las J",11
5,"5226",76,55,54,3,1,"FE de las J",0
28,"28085",3922,2972,2954,14,18,"FE de las J",2
5,"5134",48,38,38,0,0,"FE de las J",0
45,"45007",696,534,522,3,12,"FE de las J",0
2,"2064",372,325,324,1,1,"FE de las J",0
40,"40019",36,31,31,1,0,"FE de las J",0
47,"47022",59,50,49,0,1,"FE de las J",1
40,"40049",49,43,43,0,0,"FE de las J",0
47,"47176",219,139,139,1,0,"FE de las J",0
34,"34180",66,55,55,1,0,"FE de las J",3
19,"19300",772,595,591,5,4,"FE de las J",0
46,"46093",2118,1647,1624,4,23,"FE de las J",5
28,"28150",3087,2294,2277,10,17,"FE de las J",5
5,"5261",41,26,26,0,0,"FE de las J",0
5,"5054",1224,935,924,8,11,"FE de las J",0
12,"12094",847,674,665,5,9,"FE de las J",1
40,"40902",123,99,96,1,3,"FE de las J",0
45,"45018",498,333,330,4,3,"FE de las J",1
42,"42094",621,444,433,10,11,"FE de las J",2
2,"2002",470,394,389,3,5,"FE de las J",1
34,"34122",83,60,60,0,0,"FE de las J",0
19,"19262",135,100,100,0,0,"FE de las J",1
4,"4076",1279,960,944,8,16,"FE de las J",0
45,"45058",375,311,304,1,7,"FE de las J",0
40,"40013",62,49,48,0,1,"FE de las J",0
47,"47017",201,158,153,1,5,"FE de las J",0
19,"19257",3403,2430,2402,19,28,"FE de las J",7
19,"19117",1579,1135,1123,8,12,"FE de las J",2
40,"40150",69,61,61,1,0,"FE de las J",0
5,"5115",523,378,373,0,5,"FE de las J",0
42,"42097",23,14,11,0,3,"FE de las J",0
12,"12041",100,81,81,0,0,"FE de las J",0
5,"5128",354,281,271,2,10,"FE de las J",1
19,"19064",70,64,64,2,0,"FE de las J",0
4,"4903",4320,2858,2825,19,33,"FE de las J",1
46,"46085",11081,7938,7866,46,72,"FE de las J",6
45,"45025",1205,831,827,2,4,"FE de las J",1
42,"42129",681,503,495,3,8,"FE de las J",1
34,"34066",59,49,48,0,1,"FE de las J",0
42,"42041",34,25,25,0,0,"FE de las J",0
44,"44184",45,34,34,0,0,"FE de las J",0
45,"45157",2128,1456,1427,13,29,"FE de las J",1
2,"2005",559,424,416,5,8,"FE de las J",1
41,"41071",5586,3724,3661,22,63,"FE de las J",2
14,"14014",2557,2035,2007,9,28,"FE de las J",1
19,"19294",29,27,27,0,0,"FE de las J",0
19,"19211",369,289,284,0,5,"FE de las J",0
44,"44143",380,307,306,2,1,"FE de las J",2
12,"12126",24464,18533,18331,113,202,"FE de las J",20
28,"28113",34751,25832,25612,120,220,"FE de las J",32
2,"2051",1676,1177,1162,6,15,"FE de las J",1
34,"34160",139,115,114,3,1,"FE de las J",0
40,"40165",77,65,64,1,1,"FE de las J",0
28,"28153",697,499,499,1,0,"FE de las J",0
42,"42211",82,66,66,1,0,"FE de las J",0
28,"28045",33328,24620,24434,146,186,"FE de las J",39
28,"28132",11685,8130,8062,56,68,"FE de las J",16
19,"19322",31,25,25,0,0,"FE de las J",1
5,"5181",43,34,34,1,0,"FE de las J",0
41,"41024",22600,14263,14048,128,215,"FE de las J",6
19,"19188",51,35,35,0,0,"FE de las J",0
19,"19199",17,17,17,1,0,"FE de las J",0
46,"46201",64,52,51,1,1,"FE de las J",0
12,"12069",66,49,48,0,1,"FE de las J",1
45,"45196",1400,1047,1033,5,14,"FE de las J",1
42,"42184",57,43,43,0,0,"FE de las J",1
5,"5190",53,42,41,2,1,"FE de las J",0
5,"5078",115,91,89,1,2,"FE de las J",0
42,"42212",69,43,43,1,0,"FE de las J",0
40,"40058",325,277,276,4,1,"FE de las J",0
47,"47028",33,21,21,0,0,"FE de las J",0
34,"34110",88,71,71,1,0,"FE de las J",0
46,"46182",1266,929,922,6,7,"FE de las J",4
12,"12070",522,406,401,0,5,"FE de las J",0
44,"44264",248,191,189,1,2,"FE de las J",2
2,"2036",95,78,78,0,0,"FE de las J",0
12,"12130",404,340,335,0,5,"FE de las J",0
4,"4050",800,558,553,3,5,"FE de las J",0
5,"5156",256,160,159,1,1,"FE de las J",0
45,"45057",222,180,177,1,3,"FE de las J",0
34,"34051",101,88,83,0,5,"FE de las J",2
44,"44011",52,40,38,0,2,"FE de las J",1
44,"44240",158,130,129,0,1,"FE de las J",0
11,"11001",4358,2816,2767,11,49,"FE de las J",3
11,"11012",99886,70290,69673,693,617,"FE de las J",63
44,"44115",102,90,90,3,0,"FE de las J",0
2,"2045",3665,2895,2855,21,40,"FE de las J",0
42,"42073",75,58,58,0,0,"FE de las J",1
28,"28011",442,317,316,1,1,"FE de las J",4
44,"44266",115,90,90,0,0,"FE de las J",1
41,"41081",29189,20205,20015,196,190,"FE de las J",17
19,"19301",40,33,33,1,0,"FE de las J",0
4,"4041",322,240,238,6,2,"FE de las J",1
5,"5241",3063,2056,2032,15,24,"FE de las J",4
19,"19105",2334,1753,1739,8,14,"FE de las J",1
40,"40062",60,51,48,0,3,"FE de las J",0
42,"42050",31,18,18,0,0,"FE de las J",0
44,"44229",152,112,111,3,1,"FE de las J",0
40,"40060",82,61,61,0,0,"FE de las J",0
4,"4017",1296,857,854,5,3,"FE de las J",1
2,"2055",1127,679,668,6,11,"FE de las J",0
2,"2056",1718,1296,1274,6,22,"FE de las J",2
41,"41060",15242,10021,9847,86,174,"FE de las J",8
12,"12039",833,717,710,4,7,"FE de las J",0
44,"44230",155,123,123,2,0,"FE de las J",0
46,"46178",4637,3405,3381,27,24,"FE de las J",4
45,"45067",2318,1791,1752,19,39,"FE de las J",1
28,"28137",1664,1232,1220,7,12,"FE de las J",2
19,"19059",77,61,58,1,3,"FE de las J",1
5,"5260",105,90,90,0,0,"FE de las J",1
19,"19074",72,62,62,0,0,"FE de las J",0
42,"42111",303,229,227,2,2,"FE de las J",0
40,"40148",238,188,187,2,1,"FE de las J",0
44,"44065",60,40,40,0,0,"FE de las J",0
40,"40174",349,254,251,2,3,"FE de las J",1
34,"34114",207,144,144,0,0,"FE de las J",0
4,"4084",341,249,247,2,2,"FE de las J",0
40,"40024",856,651,639,6,12,"FE de las J",1
44,"44040",201,160,157,1,3,"FE de las J",0
47,"47200",85,66,66,0,0,"FE de las J",0
47,"47015",200,162,160,0,2,"FE de las J",0
44,"44200",39,26,26,0,0,"FE de las J",0
19,"19160",886,558,552,2,6,"FE de las J",1
34,"34103",98,77,76,0,1,"FE de las J",1
47,"47170",33,28,27,2,1,"FE de las J",0
45,"45008",139,118,118,1,0,"FE de las J",0
19,"19119",82,72,71,1,1,"FE de las J",0
5,"5167",254,207,202,4,5,"FE de las J",0
42,"42054",19,16,16,0,0,"FE de las J",0
11,"11018",1468,1046,1031,9,15,"FE de las J",0
19,"19267",19,13,13,0,0,"FE de las J",0
46,"46197",1942,1527,1514,5,13,"FE de las J",0
19,"19109",39,32,32,0,0,"FE de las J",0
40,"40181",4233,3260,3219,23,41,"FE de las J",2
41,"41052",3013,2116,2064,14,52,"FE de las J",0
19,"19121",246,199,194,1,5,"FE de las J",1
44,"44037",453,317,315,0,2,"FE de las J",4
19,"19321",39,30,30,1,0,"FE de las J",0
46,"46049",281,232,224,0,8,"FE de las J",0
2,"2061",637,516,511,4,5,"FE de las J",0
19,"19334",35,31,31,0,0,"FE de las J",0
19,"19120",101,88,88,1,0,"FE de las J",0
19,"19197",27,22,22,0,0,"FE de las J",1
46,"46904",792,610,603,8,7,"FE de las J",0
5,"5266",100,86,86,0,0,"FE de las J",0
19,"19268",35,24,24,1,0,"FE de las J",0
11,"11009",605,414,410,1,4,"FE de las J",0
12,"12027",17283,12015,11888,89,127,"FE de las J",25
19,"19146",41,35,32,0,3,"FE de las J",0
40,"40195",885,672,669,1,3,"FE de las J",3
45,"45204",632,488,487,1,1,"FE de las J",1
44,"44061",70,54,51,0,3,"FE de las J",0
4,"4098",1516,1115,1106,11,9,"FE de las J",4
41,"41028",2003,1524,1511,9,13,"FE de las J",1
28,"28087",3186,2503,2487,19,16,"FE de las J",4
47,"47159",822,644,636,1,8,"FE de las J",1
45,"45072",671,484,483,2,1,"FE de las J",0
28,"28082",5683,4324,4286,25,38,"FE de las J",1
46,"46902",364,306,303,0,3,"FE de las J",0
42,"42096",272,171,170,6,1,"FE de las J",0
19,"19067",70,52,51,1,1,"FE de las J",0
40,"40224",22,21,21,0,0,"FE de las J",0
4,"4048",1503,1090,1085,9,5,"FE de las J",0
45,"45901",771,547,544,3,3,"FE de las J",1
12,"12116",58,49,49,0,0,"FE de las J",1
4,"4024",3074,2347,2327,20,20,"FE de las J",5
5,"5220",371,309,301,0,8,"FE de las J",0
40,"40142",53,39,37,0,2,"FE de las J",0
5,"5253",86,70,68,0,2,"FE de las J",0
19,"19123",40,32,31,1,1,"FE de las J",0
46,"46148",1513,1160,1146,7,14,"FE de las J",3
44,"44092",81,59,57,0,2,"FE de las J",0
5,"5007",111,81,80,3,1,"FE de las J",0
28,"28123",57078,45270,44992,215,278,"FE de las J",32
40,"40057",1456,1154,1148,7,6,"FE de las J",2
42,"42156",28,16,16,1,0,"FE de las J",0
19,"19189",120,91,90,2,1,"FE de las J",2
46,"46079",318,241,232,1,9,"FE de las J",0
44,"44137",193,149,148,0,1,"FE de las J",0
28,"28083",8939,6396,6348,38,48,"FE de las J",15
45,"45074",414,327,323,1,4,"FE de las J",0
46,"46053",553,445,436,2,9,"FE de las J",1
40,"40200",40,31,31,0,0,"FE de las J",0
47,"47082",812,640,628,8,12,"FE de las J",2
47,"47227",61,50,50,0,0,"FE de las J",0
41,"41057",269,183,181,0,2,"FE de las J",0
28,"28066",7182,5422,5371,17,51,"FE de las J",5
45,"45063",417,310,303,1,7,"FE de las J",0
34,"34218",461,343,339,2,4,"FE de las J",5
5,"5001",191,148,147,2,1,"FE de las J",0
40,"40088",284,228,224,0,4,"FE de las J",0
5,"5201",523,419,418,1,1,"FE de las J",0
5,"5252",64,45,45,1,0,"FE de las J",0
34,"34084",138,109,107,0,2,"FE de las J",0
19,"19045",140,120,120,0,0,"FE de las J",0
44,"44135",113,88,87,0,1,"FE de las J",1
41,"41065",22779,14769,14636,132,133,"FE de las J",3
5,"5029",121,96,94,0,2,"FE de las J",0
2,"2081",18342,13244,13075,80,169,"FE de las J",13
45,"45009",524,344,341,2,3,"FE de las J",0
19,"19089",30,22,22,0,0,"FE de las J",0
19,"19075",64,39,39,0,0,"FE de las J",0
42,"42062",22,12,12,0,0,"FE de las J",0
47,"47166",259,204,197,2,7,"FE de las J",1
2,"2069",11490,8470,8373,41,97,"FE de las J",13
4,"4062",4504,3534,3490,18,44,"FE de las J",2
19,"19228",26,20,20,0,0,"FE de las J",1
40,"40076",6492,4768,4700,26,68,"FE de las J",4
28,"28147",963,722,720,5,2,"FE de las J",1
5,"5013",868,728,721,6,7,"FE de las J",0
47,"47101",1710,1357,1336,16,21,"FE de las J",1
47,"47131",170,134,128,2,6,"FE de las J",0
44,"44084",54,41,41,0,0,"FE de las J",0
5,"5211",459,345,343,1,2,"FE de las J",1
45,"45055",1020,821,790,6,31,"FE de las J",1
47,"47167",241,204,204,1,0,"FE de las J",1
46,"46004",1922,1565,1547,11,18,"FE de las J",0
44,"44067",114,81,81,1,0,"FE de las J",0
28,"28117",104,89,89,1,0,"FE de las J",0
11,"11027",67913,45219,44833,454,386,"FE de las J",37
46,"46056",182,167,166,1,1,"FE de las J",0
40,"40122",512,395,394,2,1,"FE de las J",0
5,"5180",86,67,63,3,4,"FE de las J",1
5,"5262",357,276,276,1,0,"FE de las J",0
47,"47210",382,282,274,3,8,"FE de las J",0
46,"46153",439,355,351,1,4,"FE de las J",1
34,"34185",63,38,37,2,1,"FE de las J",0
44,"44070",53,48,48,0,0,"FE de las J",0
42,"42132",141,114,114,0,0,"FE de las J",0
44,"44022",493,323,318,7,5,"FE de las J",1
5,"5010",152,117,116,1,1,"FE de las J",0
40,"40123",147,114,106,0,8,"FE de las J",0
47,"47194",298,239,237,2,2,"FE de las J",0
47,"47222",83,64,64,1,0,"FE de las J",0
34,"34046",41,36,35,0,1,"FE de las J",0
5,"5084",74,53,53,0,0,"FE de las J",0
5,"5036",123,101,101,1,0,"FE de las J",0
41,"41051",2180,1529,1501,2,28,"FE de las J",1
5,"5052",95,77,76,0,1,"FE de las J",0
28,"28110",1944,1478,1463,4,15,"FE de las J",0
19,"19231",10,9,9,0,0,"FE de las J",0
45,"45013",1758,1352,1329,8,23,"FE de las J",3
5,"5085",35,27,27,0,0,"FE de las J",0
42,"42206",8,8,8,1,0,"FE de las J",0
45,"45080",6,6,6,0,0,"FE de las J",0
46,"46136",2537,1952,1930,11,22,"FE de las J",1
34,"34091",123,94,93,3,1,"FE de las J",0
45,"45113",1915,1390,1366,6,24,"FE de las J",0
44,"44005",50,30,30,0,0,"FE de las J",0
2,"2901",2200,1440,1437,7,3,"FE de las J",0
12,"12128",1393,1090,1072,10,18,"FE de las J",1
46,"46120",1113,903,875,2,28,"FE de las J",1
41,"41030",514,387,373,3,14,"FE de las J",0
44,"44074",429,333,326,4,7,"FE de las J",0
46,"46163",1866,1504,1480,8,24,"FE de las J",2
4,"4033",135,97,93,1,4,"FE de las J",0
4,"4056",143,113,109,0,4,"FE de las J",0
19,"19245",1155,855,835,5,20,"FE de las J",0
46,"46033",191,156,155,0,1,"FE de las J",0
4,"4096",266,209,208,0,1,"FE de las J",0
28,"28025",420,320,315,4,5,"FE de las J",0
34,"34140",107,67,67,0,0,"FE de las J",1
42,"42056",23,20,20,0,0,"FE de las J",0
46,"46051",8347,6355,6302,24,53,"FE de las J",6
46,"46204",6681,5256,5202,32,54,"FE de las J",6
47,"47074",149,117,116,2,1,"FE de las J",0
42,"42006",163,109,107,2,2,"FE de las J",1
44,"44147",412,298,293,5,5,"FE de las J",1
12,"12093",178,137,136,2,1,"FE de las J",0
41,"41076",2183,1341,1327,19,14,"FE de las J",1
44,"44046",49,34,34,1,0,"FE de las J",0
44,"44039",221,165,159,0,6,"FE de las J",1
46,"46216",5053,4109,4090,14,19,"FE de las J",3
45,"45183",2220,1444,1428,3,16,"FE de las J",0
40,"40210",106,74,71,0,3,"FE de las J",0
44,"44007",173,122,121,4,1,"FE de las J",1
11,"11021",6764,4434,4362,52,72,"FE de las J",1
34,"34003",164,122,119,0,3,"FE de las J",0
4,"4087",182,135,135,0,0,"FE de las J",0
4,"4078",1078,758,746,8,12,"FE de las J",0
46,"46208",1112,887,881,4,6,"FE de las J",0
44,"44193",78,54,54,1,0,"FE de las J",1
19,"19001",49,42,42,0,0,"FE de las J",0
40,"40184",258,211,210,2,1,"FE de las J",0
45,"45106",7439,5613,5534,52,79,"FE de las J",7
40,"40157",47,44,44,0,0,"FE de las J",0
44,"44114",243,178,173,0,5,"FE de las J",0
19,"19285",24,21,21,1,0,"FE de las J",0
45,"45028",3649,2701,2673,12,28,"FE de las J",2
41,"41100",1013,692,673,6,19,"FE de las J",1
41,"41022",4290,2889,2851,21,38,"FE de las J",1
44,"44077",74,60,58,0,2,"FE de las J",0
42,"42088",67,47,47,1,0,"FE de las J",0
19,"19016",65,49,49,0,0,"FE de las J",0
19,"19214",75,60,58,0,2,"FE de las J",0
28,"28018",3768,2968,2945,26,23,"FE de las J",2
5,"5142",99,88,85,0,3,"FE de las J",0
46,"46010",935,729,723,4,6,"FE de las J",0
46,"46192",761,576,570,5,6,"FE de las J",1
40,"40172",39,34,34,0,0,"FE de las J",0
12,"12091",177,113,112,0,1,"FE de las J",0
42,"42034",30,22,22,0,0,"FE de las J",0
44,"44183",77,50,49,0,1,"FE de las J",0
12,"12046",191,151,150,2,1,"FE de las J",0
44,"44013",11244,7815,7712,82,103,"FE de las J",30
44,"44093",80,66,66,0,0,"FE de las J",0
5,"5061",252,186,184,3,2,"FE de las J",0
42,"42071",171,115,115,3,0,"FE de las J",0
47,"47191",108,79,79,0,0,"FE de las J",0
34,"34242",95,71,68,3,3,"FE de las J",0
4,"4061",638,506,498,4,8,"FE de las J",0
44,"44150",28,22,21,0,1,"FE de las J",0
34,"34147",166,118,117,0,1,"FE de las J",0
46,"46124",787,653,642,4,11,"FE de las J",1
47,"47039",185,141,140,0,1,"FE de las J",0
47,"47121",544,437,425,6,12,"FE de las J",3
28,"28115",60892,49705,49510,209,195,"FE de las J",23
28,"28125",3002,2180,2163,11,17,"FE de las J",2
46,"46116",13159,10193,10135,53,58,"FE de las J",2
44,"44218",35,28,28,1,0,"FE de las J",0
12,"12134",141,95,94,0,1,"FE de las J",0
34,"34101",50,41,41,0,0,"FE de las J",0
28,"28165",1794,1293,1285,3,8,"FE de las J",1
19,"19203",30,24,24,0,0,"FE de las J",0
34,"34102",205,169,168,1,1,"FE de las J",0
5,"5178",368,284,280,0,4,"FE de las J",0
4,"4103",1476,1018,1008,3,10,"FE de las J",3
42,"42173",29281,20286,20035,261,251,"FE de las J",27
5,"5242",681,559,558,8,1,"FE de las J",0
19,"19217",54,40,39,0,1,"FE de las J",0
47,"47122",2032,1563,1535,7,28,"FE de las J",1
19,"19330",71,63,63,2,0,"FE de las J",0
45,"45165",62718,44420,44006,236,414,"FE de las J",25
40,"40203",899,722,715,4,7,"FE de las J",2
46,"46151",728,550,541,0,9,"FE de las J",1
47,"47040",64,53,53,0,0,"FE de las J",1
28,"28031",2048,1500,1486,3,14,"FE de las J",3
11,"11004",88783,51500,51015,513,485,"FE de las J",44
46,"46117",495,402,399,5,3,"FE de las J",0
40,"40178",98,73,71,1,2,"FE de las J",0
47,"47014",51,45,45,0,0,"FE de las J",0
5,"5243",85,61,60,0,1,"FE de las J",0
5,"5195",220,169,169,2,0,"FE de las J",0
19,"19254",45,34,34,0,0,"FE de las J",0
42,"42022",221,173,171,5,2,"FE de las J",1
42,"42014",64,43,43,1,0,"FE de las J",0
5,"5196",50,37,36,0,1,"FE de las J",0
28,"28051",1541,1163,1149,1,14,"FE de las J",2
11,"11028",32488,21971,21672,316,299,"FE de las J",15
12,"12081",608,486,480,5,6,"FE de las J",0
45,"45101",3756,3020,2984,12,36,"FE de las J",5
19,"19107",294,239,237,0,2,"FE de las J",1
44,"44014",2521,1896,1867,8,29,"FE de las J",2
44,"44120",222,154,150,2,4,"FE de las J",0
44,"44086",449,342,336,3,6,"FE de las J",1
46,"46014",3030,2383,2350,20,33,"FE de las J",2
5,"5151",91,71,71,1,0,"FE de las J",0
47,"47151",27,24,24,0,0,"FE de las J",0
34,"34032",40,33,33,1,0,"FE de las J",0
4,"4055",371,310,308,0,2,"FE de las J",0
47,"47068",34,26,26,0,0,"FE de las J",0
46,"46171",16563,12213,12128,85,85,"FE de las J",16
14,"14041",3182,2296,2251,33,45,"FE de las J",0
5,"5103",72,52,52,0,0,"FE de las J",0
14,"14070",1332,986,974,10,12,"FE de las J",0
42,"42042",45,35,35,0,0,"FE de las J",0
44,"44223",72,54,54,0,0,"FE de las J",0
19,"19148",45,32,31,0,1,"FE de las J",1
47,"47016",69,56,55,0,1,"FE de las J",0
46,"46032",5653,4402,4361,33,41,"FE de las J",13
42,"42163",50,41,40,0,1,"FE de las J",0
12,"12031",3807,2941,2894,24,47,"FE de las J",10
28,"28015",18736,14221,14127,68,94,"FE de las J",18
34,"34077",347,244,238,4,6,"FE de las J",0
5,"5072",81,67,67,1,0,"FE de las J",0
45,"45036",656,471,469,2,2,"FE de las J",1
12,"12053",2034,1655,1633,6,22,"FE de las J",1
44,"44088",29,21,21,0,0,"FE de las J",0
34,"34019",125,107,105,0,2,"FE de las J",0
5,"5200",44,31,30,1,1,"FE de las J",0
11,"11042",1186,868,858,7,10,"FE de las J",2
47,"47206",92,80,80,0,0,"FE de las J",0
40,"40055",37,26,26,0,0,"FE de las J",0
45,"45082",1224,1020,1011,8,9,"FE de las J",0
42,"42128",42,42,41,1,1,"FE de las J",0
40,"40014",58,46,45,0,1,"FE de las J",0
45,"45060",173,126,125,1,1,"FE de las J",1
19,"19151",1064,744,726,1,18,"FE de las J",0
46,"46173",1328,1069,1057,4,12,"FE de las J",0
45,"45159",90,75,75,0,0,"FE de las J",0
14,"14044",1604,1172,1165,7,7,"FE de las J",2
19,"19187",48,43,43,0,0,"FE de las J",0
46,"46225",337,290,281,5,9,"FE de las J",0
46,"46199",5718,4314,4266,28,48,"FE de las J",3
4,"4077",295,263,261,2,2,"FE de las J",1
34,"34214",183,144,144,0,0,"FE de las J",1
45,"45116",687,509,505,1,4,"FE de las J",0
2,"2050",98,83,82,0,1,"FE de las J",0
42,"42087",49,43,42,0,1,"FE de las J",0
44,"44050",3113,2120,2100,25,20,"FE de las J",3
19,"19308",56,53,53,0,0,"FE de las J",0
42,"42105",50,45,45,0,0,"FE de las J",0
47,"47071",410,324,321,4,3,"FE de las J",0
19,"19165",47,41,41,0,0,"FE de las J",0
19,"19901",41,38,37,0,1,"FE de las J",0
2,"2037",22865,14632,14477,91,155,"FE de las J",10
44,"44051",2683,1977,1946,17,31,"FE de las J",6
45,"45160",1109,874,864,6,10,"FE de las J",0
5,"5125",55,47,47,0,0,"FE de las J",3
46,"46122",2704,2082,2063,10,19,"FE de las J",0
47,"47090",2418,1728,1699,8,29,"FE de las J",2
47,"47128",60,52,51,0,1,"FE de las J",0
46,"46062",4631,3511,3474,27,37,"FE de las J",2
28,"28065",126539,96997,96210,505,787,"FE de las J",120
11,"11011",1716,1195,1165,12,30,"FE de las J",2
42,"42033",48,45,45,1,0,"FE de las J",0
42,"42009",78,63,63,0,0,"FE de las J",0
12,"12001",1051,821,800,4,21,"FE de las J",1
34,"34112",46,38,37,0,1,"FE de las J",0
12,"12101",358,279,275,3,4,"FE de las J",1
47,"47138",241,170,164,1,6,"FE de las J",0
5,"5256",112,100,98,1,2,"FE de las J",0
34,"34024",31,21,21,1,0,"FE de las J",0
44,"44009",809,596,593,7,3,"FE de las J",1
14,"14028",314,253,249,1,4,"FE de las J",0
19,"19272",72,54,53,1,1,"FE de las J",0
40,"40032",390,289,285,2,4,"FE de las J",1
42,"42011",18,10,10,1,0,"FE de las J",0
40,"40186",42,29,29,0,0,"FE de las J",0
19,"19114",37,26,26,0,0,"FE de las J",0
34,"34069",2266,1666,1637,11,29,"FE de las J",1
14,"14066",5856,4150,4095,48,55,"FE de las J",3
45,"45097",1046,839,834,4,5,"FE de las J",1
47,"47100",138,117,117,1,0,"FE de las J",0
45,"45064",3858,2804,2763,20,41,"FE de las J",2
47,"47021",76,64,64,0,0,"FE de las J",1
12,"12071",1274,992,979,3,13,"FE de las J",1
34,"34056",1998,1452,1444,13,8,"FE de las J",1
19,"19046",21588,15689,15515,82,174,"FE de las J",38
34,"34132",114,89,86,0,3,"FE de las J",0
45,"45198",1809,1475,1442,7,33,"FE de las J",2
41,"41003",2333,1693,1671,13,22,"FE de las J",0
45,"45164",182,162,160,1,2,"FE de las J",0
40,"40188",90,72,70,0,2,"FE de las J",0
47,"47048",188,144,144,1,0,"FE de las J",1
47,"47084",1150,887,870,7,17,"FE de las J",1
19,"19143",1738,1306,1297,12,9,"FE de las J",1
47,"47075",4856,3681,3637,24,44,"FE de las J",8
40,"40189",512,401,392,2,9,"FE de las J",2
28,"28067",4063,3102,3079,3,23,"FE de las J",3
12,"12004",4170,3125,3088,19,37,"FE de las J",6
19,"19193",20,19,19,1,0,"FE de las J",0
5,"5014",5379,4009,3970,18,39,"FE de las J",4
28,"28058",139342,100637,99753,634,884,"FE de las J",167
5,"5064",103,83,82,0,1,"FE de las J",0
5,"5130",90,85,85,0,0,"FE de las J",0
45,"45132",2197,1645,1632,14,13,"FE de las J",0
41,"41059",34165,24949,24709,196,240,"FE de las J",8
2,"2015",1441,1112,1093,5,19,"FE de las J",4
28,"28040",15811,10118,10009,56,109,"FE de las J",18
42,"42013",34,28,27,0,1,"FE de las J",0
34,"34029",714,587,570,3,17,"FE de las J",0
11,"11016",14929,9426,9302,123,124,"FE de las J",8
44,"44024",27,25,25,0,0,"FE de las J",0
12,"12105",848,644,638,2,6,"FE de las J",1
46,"46152",96,68,68,0,0,"FE de las J",0
42,"42082",8,8,8,1,0,"FE de las J",0
19,"19060",146,119,118,1,1,"FE de las J",0
5,"5066",453,367,367,5,0,"FE de las J",0
47,"47086",3906,2970,2936,24,34,"FE de las J",5
41,"41050",5150,3817,3777,19,40,"FE de las J",1
28,"28022",33479,27129,27037,133,92,"FE de las J",17
45,"45068",160,126,126,0,0,"FE de las J",0
44,"44164",27,23,23,0,0,"FE de las J",0
4,"4019",249,196,196,1,0,"FE de las J",0
2,"2017",838,594,589,1,5,"FE de las J",0
19,"19078",50,44,43,0,1,"FE de las J",0
46,"46231",2421,1721,1708,14,13,"FE de las J",2
5,"5017",85,82,81,5,1,"FE de las J",1
46,"46256",6853,4951,4890,25,61,"FE de las J",7
34,"34104",246,185,182,1,3,"FE de las J",0
12,"12075",123,88,88,0,0,"FE de las J",1
45,"45202",3894,2776,2744,14,32,"FE de las J",6
5,"5018",29,22,22,0,0,"FE de las J",1
40,"40901",384,309,307,4,2,"FE de las J",0
5,"5214",38,28,28,0,0,"FE de las J",0
47,"47078",163,127,125,1,2,"FE de las J",0
47,"47104",2836,2182,2121,19,61,"FE de las J",2
44,"44100",185,153,151,0,2,"FE de las J",0
5,"5215",164,123,122,2,1,"FE de las J",0
40,"40094",374,279,276,2,3,"FE de las J",0
12,"12127",75,55,55,0,0,"FE de las J",0
19,"19009",259,200,195,6,5,"FE de las J",2
19,"19221",48,38,37,1,1,"FE de las J",0
47,"47196",34,27,27,0,0,"FE de las J",0
41,"41097",3137,2180,2134,18,46,"FE de las J",3
12,"12118",72,55,53,0,2,"FE de las J",1
40,"40069",83,66,63,0,3,"FE de las J",1
19,"19233",80,65,63,1,2,"FE de las J",0
47,"47105",183,158,156,0,2,"FE de las J",1
28,"28111",596,467,467,3,0,"FE de las J",0
45,"45070",1427,1147,1142,1,5,"FE de las J",1
47,"47187",84,61,58,0,3,"FE de las J",0
46,"46233",3860,2859,2817,10,42,"FE de las J",2
28,"28160",8256,6102,6059,31,43,"FE de las J",9
45,"45004",567,410,406,1,4,"FE de las J",1
4,"4002",1039,748,740,2,8,"FE de las J",3
44,"44089",45,39,39,1,0,"FE de las J",1
5,"5138",306,221,220,1,1,"FE de las J",0
5,"5139",74,65,65,0,0,"FE de las J",2
45,"45083",472,368,365,0,3,"FE de las J",0
5,"5186",1575,1225,1194,3,31,"FE de las J",0
45,"45138",1091,877,871,4,6,"FE de las J",2
34,"34080",5560,3723,3665,32,58,"FE de las J",5
40,"40156",322,238,235,1,3,"FE de las J",0
28,"28080",48554,38885,38691,164,194,"FE de las J",37
45,"45171",1361,1035,1023,0,12,"FE de las J",0
42,"42195",101,62,62,0,0,"FE de las J",0
44,"44235",92,62,60,0,2,"FE de las J",0
44,"44062",34,25,22,0,3,"FE de las J",0
44,"44192",355,280,278,4,2,"FE de las J",1
34,"34109",59,48,48,0,0,"FE de las J",0
19,"19122",96,68,68,1,0,"FE de las J",1
19,"19259",30,25,25,1,0,"FE de las J",0
46,"46026",1204,1015,1004,3,11,"FE de las J",0
34,"34022",1082,873,861,9,12,"FE de las J",0
46,"46156",2080,1697,1675,10,22,"FE de las J",2
19,"19043",84,72,72,0,0,"FE de las J",0
42,"42046",49,39,39,0,0,"FE de las J",0
45,"45139",167,139,139,1,0,"FE de las J",0
45,"45095",689,513,505,0,8,"FE de las J",0
19,"19071",7840,5537,5489,45,48,"FE de las J",12
5,"5158",367,290,286,6,4,"FE de las J",5
47,"47037",168,138,133,0,5,"FE de las J",0
12,"12142",158,117,117,1,0,"FE de las J",0
47,"47045",763,575,567,1,8,"FE de las J",2
46,"46027",943,780,771,5,9,"FE de las J",3
19,"19124",386,260,257,0,3,"FE de las J",1
45,"45107",3257,2504,2472,15,32,"FE de las J",1
41,"41001",1596,1183,1159,5,24,"FE de las J",1
46,"46244",58771,42137,41867,270,270,"FE de las J",52
44,"44172",301,218,216,4,2,"FE de las J",1
44,"44032",16,11,11,0,0,"FE de las J",0
5,"5904",127,88,87,1,1,"FE de las J",0
40,"40087",92,71,70,1,1,"FE de las J",0
4,"4037",1314,969,955,6,14,"FE de las J",1
34,"34100",142,108,108,1,0,"FE de las J",1
44,"44228",100,82,82,0,0,"FE de las J",0
42,"42185",26,22,22,0,0,"FE de las J",0
46,"46261",1725,1356,1337,5,19,"FE de las J",0
46,"46054",11293,8477,8409,47,68,"FE de las J",37
34,"34163",45,38,38,0,0,"FE de las J",0
19,"19167",130,101,99,0,2,"FE de las J",1
28,"28173",517,390,388,1,2,"FE de las J",2
2,"2067",1158,858,847,6,11,"FE de las J",1
28,"28084",15859,11156,11058,64,98,"FE de las J",22
47,"47083",80,59,54,1,5,"FE de las J",2
11,"11025",4398,2899,2848,51,51,"FE de las J",2
34,"34149",23,18,18,0,0,"FE de las J",0
19,"19287",148,109,108,0,1,"FE de las J",0
45,"45175",664,545,543,5,2,"FE de las J",0
46,"46064",509,412,399,1,13,"FE de las J",1
46,"46185",378,320,313,2,7,"FE de las J",0
19,"19314",51,36,36,0,0,"FE de las J",0
12,"12082",9617,7324,7231,46,93,"FE de las J",17
28,"28107",457,312,312,0,0,"FE de las J",1
42,"42142",50,35,35,1,0,"FE de las J",0
44,"44108",320,222,222,1,0,"FE de las J",2
42,"42110",59,45,45,2,0,"FE de las J",0
40,"40120",192,170,166,0,4,"FE de las J",0
5,"5033",176,144,142,1,2,"FE de las J",1
34,"34045",76,66,66,2,0,"FE de las J",0
41,"41037",3213,2376,2342,30,34,"FE de las J",2
19,"19036",263,229,229,0,0,"FE de las J",0
44,"44256",38,34,34,0,0,"FE de las J",0
14,"14040",3776,2873,2833,32,40,"FE de las J",1
40,"40077",842,632,619,3,13,"FE de las J",1
46,"46212",1620,1150,1124,9,26,"FE de las J",1
19,"19169",40,34,34,0,0,"FE de las J",0
12,"12115",219,179,177,0,2,"FE de las J",0
4,"4063",1096,776,768,2,8,"FE de las J",0
4,"4029",8859,5834,5790,35,44,"FE de las J",6
19,"19129",28,26,26,0,0,"FE de las J",0
19,"19007",459,341,336,0,5,"FE de las J",1
47,"47058",200,145,143,0,2,"FE de las J",0
5,"5034",14,13,13,0,0,"FE de las J",0
5,"5164",26,14,14,0,0,"FE de las J",0
40,"40233",417,314,310,3,4,"FE de las J",1
45,"45089",1495,1102,1094,0,8,"FE de las J",0
41,"41072",4054,2965,2933,14,32,"FE de las J",1
47,"47032",152,117,116,1,1,"FE de las J",1
44,"44025",6009,4087,3997,25,90,"FE de las J",8
34,"34135",399,293,289,0,4,"FE de las J",0
2,"2031",565,457,455,0,2,"FE de las J",0
19,"19092",409,306,300,1,6,"FE de las J",0
44,"44110",49,42,42,1,0,"FE de las J",0
19,"19242",87,65,65,1,0,"FE de las J",0
47,"47168",29,26,26,1,0,"FE de las J",0
41,"41039",31663,22062,21830,193,232,"FE de las J",9
47,"47177",105,76,73,1,3,"FE de las J",0
44,"44199",44,41,41,2,0,"FE de las J",1
12,"12029",702,557,555,4,2,"FE de las J",0
41,"41007",12341,8039,7844,103,195,"FE de las J",12
19,"19132",92,81,81,0,0,"FE de las J",0
19,"19209",40,29,29,1,0,"FE de las J",0
2,"2072",1549,1086,1070,2,16,"FE de las J",2
47,"47195",459,345,344,4,1,"FE de las J",0
46,"46006",4523,3665,3623,20,42,"FE de las J",1
46,"46214",15766,12131,12036,42,95,"FE de las J",15
44,"44211",42,35,35,0,0,"FE de las J",0
46,"46162",1189,938,929,3,9,"FE de las J",5
34,"34210",103,90,90,0,0,"FE de las J",0
42,"42131",51,37,37,1,0,"FE de las J",0
2,"2034",1382,1110,1093,7,17,"FE de las J",0
45,"45003",562,408,402,1,6,"FE de las J",0
5,"5247",241,138,138,1,0,"FE de las J",0
44,"44048",61,52,52,0,0,"FE de las J",0
44,"44145",1020,719,709,9,10,"FE de las J",0
12,"12088",62,59,59,0,0,"FE de las J",0
19,"19282",163,124,123,0,1,"FE de las J",0
47,"47144",78,64,64,1,0,"FE de las J",1
34,"34049",359,266,260,1,6,"FE de las J",1
5,"5087",134,87,85,1,2,"FE de las J",0
5,"5039",54,42,41,0,1,"FE de las J",0
5,"5170",50,43,43,0,0,"FE de las J",0
44,"44246",1543,1045,1027,12,18,"FE de las J",1
47,"47009",107,86,85,0,1,"FE de las J",1
19,"19041",163,129,129,3,0,"FE de las J",0
14,"14072",1048,806,795,6,11,"FE de las J",1
42,"42134",2627,1927,1890,19,37,"FE de las J",2
47,"47153",108,77,77,0,0,"FE de las J",0
2,"2048",1226,981,975,7,6,"FE de las J",0
19,"19052",25,21,21,1,0,"FE de las J",0
42,"42118",23,17,17,0,0,"FE de las J",0
40,"40083",77,59,59,0,0,"FE de las J",0
19,"19011",250,184,184,0,0,"FE de las J",0
2,"2076",329,237,236,1,1,"FE de las J",1
12,"12120",177,152,152,0,0,"FE de las J",0
42,"42209",140,107,106,4,1,"FE de las J",0
47,"47171",407,303,301,6,2,"FE de las J",0
12,"12056",282,236,231,1,5,"FE de las J",0
19,"19042",25,24,24,0,0,"FE de las J",0
19,"19235",93,71,71,1,0,"FE de las J",0
42,"42166",59,45,45,0,0,"FE de las J",0
47,"47001",55,46,46,0,0,"FE de las J",1
19,"19213",70,62,61,2,1,"FE de las J",0
40,"40113",425,323,316,0,7,"FE de las J",1
44,"44076",2203,1690,1663,18,27,"FE de las J",1
47,"47172",144,124,122,0,2,"FE de las J",0
4,"4004",425,329,329,0,0,"FE de las J",0
40,"40044",145,114,113,2,1,"FE de las J",0
41,"41078",2508,1823,1810,19,13,"FE de las J",0
12,"12022",344,265,262,2,3,"FE de las J",0
19,"19248",78,63,63,0,0,"FE de las J",0
5,"5206",30,22,20,1,2,"FE de las J",0
4,"4070",1584,1184,1179,3,5,"FE de las J",1
42,"42060",38,21,19,1,2,"FE de las J",0
42,"42076",216,179,174,5,5,"FE de las J",0
42,"42121",64,47,47,0,0,"FE de las J",0
46,"46036",564,383,378,5,5,"FE de las J",0
11,"11034",2334,1549,1517,14,32,"FE de las J",0
19,"19153",22,17,17,0,0,"FE de las J",0
46,"46166",8155,6320,6251,30,69,"FE de las J",4
41,"41101",5928,4209,4173,18,36,"FE de las J",0
45,"45052",2948,2321,2295,16,26,"FE de las J",2
47,"47164",378,313,311,1,2,"FE de las J",0
28,"28114",150,101,100,1,1,"FE de las J",5
40,"40145",1103,879,870,2,9,"FE de las J",1
4,"4027",250,159,159,0,0,"FE de las J",1
28,"28010",9963,7745,7688,25,57,"FE de las J",2
42,"42090",91,69,67,1,2,"FE de las J",0
42,"42171",127,80,79,0,1,"FE de las J",0
5,"5027",269,229,225,2,4,"FE de las J",2
46,"46167",364,266,264,0,2,"FE de las J",0
44,"44251",254,198,191,1,7,"FE de las J",0
12,"12059",231,189,188,2,1,"FE de las J",0
12,"12123",48,40,40,3,0,"FE de las J",0
42,"42124",64,49,49,0,0,"FE de las J",0
28,"28076",398,325,317,1,8,"FE de las J",1
5,"5129",125,88,87,2,1,"FE de las J",0
45,"45120",129,104,104,1,0,"FE de las J",0
5,"5012",133,105,102,0,3,"FE de las J",0
41,"41014",2492,1882,1852,11,30,"FE de las J",0
40,"40089",222,167,164,0,3,"FE de las J",0
40,"40230",94,68,66,0,2,"FE de las J",0
42,"42024",86,61,59,0,2,"FE de las J",0
42,"42201",22,22,21,0,1,"FE de las J",0
5,"5097",475,317,313,0,4,"FE de las J",4
2,"2082",101,80,80,1,0,"FE de las J",0
44,"44044",88,72,71,2,1,"FE de las J",0
44,"44252",86,65,65,0,0,"FE de las J",0
28,"28156",1019,742,738,3,4,"FE de las J",2
4,"4072",313,247,245,2,2,"FE de las J",0
42,"42080",157,117,115,0,2,"FE de las J",0
46,"46021",23649,17291,17153,100,138,"FE de las J",17
14,"14048",1207,884,869,13,15,"FE de las J",0
44,"44012",334,263,261,5,2,"FE de las J",0
5,"5048",118,104,104,0,0,"FE de las J",0
4,"4073",330,234,233,2,1,"FE de las J",0
46,"46143",4239,3104,3053,14,51,"FE de las J",2
28,"28003",173,141,141,0,0,"FE de las J",0
46,"46247",1006,714,710,3,4,"FE de las J",0
41,"41016",7355,5248,5175,51,73,"FE de las J",5
42,"42081",145,102,100,1,2,"FE de las J",0
5,"5244",50,39,39,1,0,"FE de las J",0
12,"12061",373,285,282,3,3,"FE de las J",0
40,"40218",92,65,64,1,1,"FE de las J",0
19,"19219",13,9,9,0,0,"FE de las J",0
12,"12040",117608,85588,84946,496,642,"FE de las J",118
11,"11039",10018,6186,6109,103,77,"FE de las J",4
19,"19265",122,97,95,2,2,"FE de las J",0
28,"28088",261,178,178,0,0,"FE de las J",0
34,"34154",74,55,53,1,2,"FE de las J",0
19,"19021",1030,759,744,7,15,"FE de las J",0
19,"19061",57,42,42,0,0,"FE de las J",0
45,"45090",384,294,293,3,1,"FE de las J",0
4,"4044",1547,1166,1156,5,10,"FE de las J",1
45,"45123",3081,2144,2131,11,13,"FE de las J",1
47,"47041",150,112,110,2,2,"FE de las J",1
28,"28032",4762,3428,3401,19,27,"FE de las J",7
40,"40179",626,503,493,2,10,"FE de las J",0
28,"28168",1237,884,880,4,4,"FE de las J",1
4,"4075",5196,3735,3706,23,29,"FE de las J",0
46,"46249",9288,6746,6676,56,70,"FE de las J",6
47,"47205",384,266,260,0,6,"FE de las J",1
34,"34060",137,111,108,0,3,"FE de las J",0
45,"45124",2140,1677,1641,10,36,"FE de las J",4
28,"28099",1748,1290,1283,7,7,"FE de las J",5
46,"46067",1753,1418,1393,1,25,"FE de las J",1
44,"44047",220,137,132,2,5,"FE de las J",0
44,"44087",80,69,67,1,2,"FE de las J",0
28,"28014",33085,23626,23466,113,160,"FE de las J",31
44,"44111",92,69,68,0,1,"FE de las J",0
44,"44260",137,91,89,3,2,"FE de las J",1
19,"19023",124,100,98,2,2,"FE de las J",0
42,"42070",34,27,26,1,1,"FE de las J",0
34,"34124",60,50,49,0,1,"FE de las J",1
12,"12065",188,169,169,2,0,"FE de las J",0
45,"45059",1712,1337,1311,1,26,"FE de las J",0
4,"4046",858,609,599,7,10,"FE de las J",1
46,"46094",20540,15378,15234,102,144,"FE de las J",26
28,"28034",361,274,269,1,5,"FE de las J",0
47,"47043",297,239,237,0,2,"FE de las J",0
40,"40095",477,377,369,0,8,"FE de las J",1
14,"14071",929,642,630,2,12,"FE de las J",1
34,"34108",542,421,417,3,4,"FE de las J",0
47,"47179",395,293,287,0,6,"FE de las J",0
2,"2075",1670,1321,1304,4,17,"FE de las J",2
47,"47070",37,27,27,0,0,"FE de las J",0
12,"12032",23525,17093,16966,104,127,"FE de las J",26
46,"46060",9369,7052,6993,42,59,"FE de las J",5
41,"41009",1222,812,805,3,7,"FE de las J",0
19,"19110",56,50,50,0,0,"FE de las J",0
5,"5056",96,76,76,0,0,"FE de las J",1
46,"46258",2652,2084,2062,16,22,"FE de las J",0
19,"19150",128,99,99,1,0,"FE de las J",0
12,"12099",539,416,403,7,13,"FE de las J",1
40,"40056",34,28,28,1,0,"FE de las J",0
28,"28131",12990,9512,9433,38,79,"FE de las J",17
47,"47180",73,61,60,4,1,"FE de las J",0
19,"19027",138,105,105,1,0,"FE de las J",1
47,"47145",603,448,441,3,7,"FE de las J",1
28,"28007",124592,94222,93521,491,701,"FE de las J",78
42,"42045",301,206,197,2,9,"FE de las J",0
40,"40015",28,26,26,1,0,"FE de las J",0
46,"46259",491,396,393,4,3,"FE de las J",0
45,"45127",696,514,511,3,3,"FE de las J",0
28,"28102",894,644,636,6,8,"FE de las J",0
44,"44263",376,266,263,3,3,"FE de las J",1
41,"41088",509,360,356,0,4,"FE de las J",1
14,"14073",2891,2079,2016,13,63,"FE de las J",0
12,"12131",63,52,52,0,0,"FE de las J",0
47,"47209",41,34,34,0,0,"FE de las J",1
5,"5188",45,39,38,0,1,"FE de las J",0
5,"5059",106,82,81,1,1,"FE de las J",0
28,"28181",20386,16155,16069,57,86,"FE de las J",11
2,"2011",632,520,516,1,4,"FE de las J",0
45,"45062",1112,878,867,4,11,"FE de las J",0
40,"40143",86,75,74,0,1,"FE de las J",0
5,"5159",252,165,164,0,1,"FE de las J",2
45,"45173",9520,6938,6864,30,74,"FE de las J",4
4,"4090",304,238,234,0,4,"FE de las J",0
34,"34161",23,16,16,0,0,"FE de las J",0
34,"34179",28,21,20,0,1,"FE de las J",0
34,"34146",51,40,39,0,1,"FE de las J",0
14,"14065",1850,1384,1377,16,7,"FE de las J",1
40,"40074",255,222,219,2,3,"FE de las J",1
44,"44116",83,60,60,1,0,"FE de las J",0
19,"19250",20,17,17,0,0,"FE de las J",0
19,"19226",43,38,38,0,0,"FE de las J",0
40,"40228",510,390,382,1,8,"FE de las J",0
46,"46141",439,351,342,2,9,"FE de las J",0
2,"2012",1835,1476,1453,7,23,"FE de las J",1
19,"19073",23,19,19,0,0,"FE de las J",0
45,"45197",1906,1455,1430,8,25,"FE de las J",1
19,"19154",68,56,54,0,2,"FE de las J",0
12,"12133",59,53,52,0,1,"FE de las J",0
12,"12103",91,69,67,0,2,"FE de las J",0
19,"19018",155,119,118,3,1,"FE de las J",0
41,"41102",14655,10183,9919,142,264,"FE de las J",6
14,"14057",6136,4713,4631,47,82,"FE de las J",3
41,"41092",7743,5358,5311,55,47,"FE de las J",5
4,"4051",436,360,356,1,4,"FE de las J",2
12,"12003",976,746,736,6,10,"FE de las J",1
44,"44094",113,94,94,0,0,"FE de las J",0
28,"28135",948,713,709,4,4,"FE de las J",1
5,"5210",87,70,69,0,1,"FE de las J",0
40,"40105",47,42,42,2,0,"FE de las J",0
34,"34220",147,126,125,3,1,"FE de las J",0
34,"34167",113,94,94,0,0,"FE de las J",0
44,"44128",68,54,54,1,0,"FE de las J",0
40,"40020",157,118,117,1,1,"FE de las J",1
46,"46073",1092,888,884,6,4,"FE de las J",0
44,"44161",443,314,313,2,1,"FE de las J",1
34,"34151",159,104,103,0,1,"FE de las J",0
19,"19170",193,135,135,0,0,"FE de las J",1
12,"12104",6933,5411,5342,25,69,"FE de las J",7
12,"12073",152,119,117,0,2,"FE de las J",0
44,"44197",56,36,36,0,0,"FE de las J",0
44,"44209",833,611,602,6,9,"FE de las J",0
46,"46082",4918,3745,3712,33,33,"FE de las J",2
34,"34222",120,87,87,3,0,"FE de las J",0
12,"12135",35719,26016,25793,196,223,"FE de las J",69
28,"28068",10955,8136,8076,49,60,"FE de las J",14
5,"5165",368,290,281,3,9,"FE de las J",1
2,"2016",569,413,410,6,3,"FE de las J",1
45,"45033",343,249,243,2,6,"FE de las J",0
34,"34073",185,149,149,0,0,"FE de las J",0
2,"2084",323,231,225,0,6,"FE de las J",0
2,"2058",337,234,231,0,3,"FE de las J",0
2,"2071",1011,831,825,5,6,"FE de las J",4
47,"47103",267,197,192,5,5,"FE de las J",0
40,"40108",112,82,82,0,0,"FE de las J",0
5,"5166",185,139,139,1,0,"FE de las J",0
47,"47050",3719,2630,2598,26,32,"FE de las J",3
5,"5213",103,84,82,0,2,"FE de las J",0
44,"44099",709,465,462,3,3,"FE de las J",1
40,"40151",46,33,33,0,0,"FE de las J",0
45,"45034",1353,1082,1078,6,4,"FE de las J",0
4,"4020",288,201,197,0,4,"FE de las J",0
2,"2085",322,253,252,2,1,"FE de las J",0
14,"14004",2034,1531,1518,14,13,"FE de las J",3
19,"19195",40,32,32,1,0,"FE de las J",0
42,"42149",381,277,273,2,4,"FE de las J",0
46,"46023",327,280,278,2,2,"FE de las J",0
41,"41029",13445,9507,9416,78,91,"FE de las J",10
45,"45146",107,84,83,0,1,"FE de las J",0
42,"42028",75,51,51,0,0,"FE de las J",0
47,"47133",2682,2033,2015,16,18,"FE de las J",7
45,"45135",4269,3340,3288,8,52,"FE de las J",2
19,"19039",61,54,54,1,0,"FE de las J",0
19,"19243",44,31,31,0,0,"FE de las J",0
46,"46041",329,253,252,5,1,"FE de las J",0
12,"12087",25,18,18,4,0,"FE de las J",0
19,"19333",115,82,82,0,0,"FE de las J",0
28,"28033",3899,2805,2788,7,17,"FE de las J",11
46,"46215",1436,1154,1143,5,11,"FE de las J",0
5,"5120",36,26,26,0,0,"FE de las J",0
5,"5169",226,187,185,1,2,"FE de las J",0
19,"19306",25,20,20,1,0,"FE de las J",0
42,"42151",34,26,26,0,0,"FE de las J",0
46,"46206",571,453,445,2,8,"FE de las J",0
19,"19196",105,84,81,0,3,"FE de las J",0
41,"41063",2695,1850,1830,13,20,"FE de las J",1
28,"28071",60,55,53,1,2,"FE de las J",0
12,"12008",222,193,192,1,1,"FE de las J",0
4,"4022",347,249,249,7,0,"FE de las J",1
46,"46155",1029,833,822,4,11,"FE de las J",0
40,"40070",149,107,105,1,2,"FE de las J",0
45,"45026",211,167,166,2,1,"FE de las J",0
19,"19066",55,48,48,0,0,"FE de las J",0
40,"40155",3518,2656,2605,18,51,"FE de las J",7
12,"12140",1143,939,930,6,9,"FE de las J",4
28,"28141",5823,4297,4262,29,35,"FE de las J",7
42,"42153",14,12,12,0,0,"FE de las J",0
5,"5073",297,253,252,2,1,"FE de las J",1
45,"45005",238,193,192,3,1,"FE de las J",0
19,"19269",102,81,80,0,1,"FE de las J",0
45,"45038",3356,2376,2350,15,26,"FE de las J",5
5,"5219",38,30,30,0,0,"FE de las J",1
45,"45061",2447,1703,1689,12,14,"FE de las J",1
5,"5902",284,236,232,0,4,"FE de las J",0
46,"46130",901,687,683,3,4,"FE de las J",0
34,"34176",133,102,101,0,1,"FE de las J",0
46,"46078",28017,20288,20143,132,145,"FE de las J",17
41,"41032",3984,2811,2725,27,86,"FE de las J",2
12,"12141",101,83,83,0,0,"FE de las J",0
47,"47054",635,507,495,9,12,"FE de las J",0
34,"34036",211,150,150,0,0,"FE de las J",0
34,"34127",93,65,64,1,1,"FE de las J",0
44,"44031",97,62,62,0,0,"FE de las J",0
45,"45073",298,233,233,1,0,"FE de las J",0
40,"40144",18,14,14,0,0,"FE de las J",0
42,"42167",251,175,172,2,3,"FE de las J",0
14,"14046",4485,3268,3208,33,60,"FE de las J",1
4,"4059",1079,723,712,4,11,"FE de las J",0
41,"41067",7093,4930,4866,37,64,"FE de las J",1
42,"42197",75,58,56,0,2,"FE de las J",0
34,"34230",15,12,12,0,0,"FE de las J",0
34,"34199",1218,918,899,10,19,"FE de las J",2
46,"46140",344,284,279,0,5,"FE de las J",0
45,"45140",1087,833,823,3,10,"FE de las J",2
40,"40086",685,561,552,4,9,"FE de las J",0
5,"5026",195,166,164,2,2,"FE de las J",1
19,"19310",9,7,7,0,0,"FE de las J",0
28,"28028",1755,1353,1344,6,9,"FE de las J",5
14,"14075",572,448,428,1,20,"FE de las J",0
40,"40059",110,95,95,1,0,"FE de las J",0
34,"34083",1769,1218,1201,10,17,"FE de las J",3
5,"5208",40,36,36,0,0,"FE de las J",0
12,"12036",581,426,421,10,5,"FE de las J",1
47,"47219",41,36,34,0,2,"FE de las J",1
46,"46080",998,803,799,7,4,"FE de las J",0
47,"47030",993,766,751,6,15,"FE de las J",1
4,"4060",445,348,345,5,3,"FE de las J",0
44,"44173",101,81,79,2,2,"FE de las J",0
46,"46002",1175,941,932,5,9,"FE de las J",2
5,"5176",235,181,174,4,7,"FE de las J",0
4,"4092",2838,2127,2103,10,24,"FE de las J",5
40,"40132",56,37,36,1,1,"FE de las J",1
19,"19142",265,182,180,3,2,"FE de las J",0
12,"12902",2158,1504,1489,14,15,"FE de las J",0
46,"46055",1262,1025,1012,5,13,"FE de las J",1
19,"19005",84,66,66,0,0,"FE de las J",0
19,"19240",51,44,42,0,2,"FE de las J",0
46,"46133",533,415,410,6,5,"FE de las J",0
44,"44174",428,307,304,3,3,"FE de las J",0
44,"44034",139,109,108,0,1,"FE de las J",0
5,"5030",45,38,38,1,0,"FE de las J",0
47,"47220",165,130,129,0,1,"FE de las J",1
45,"45110",1786,1403,1398,5,5,"FE de las J",0
47,"47192",102,83,81,1,2,"FE de las J",0
47,"47031",189,145,145,1,0,"FE de las J",0
44,"44054",108,85,85,2,0,"FE de las J",0
12,"12026",881,678,663,13,15,"FE de las J",0
19,"19090",91,73,73,1,0,"FE de las J",0
44,"44175",122,85,84,1,1,"FE de las J",0
19,"19278",28,26,26,0,0,"FE de las J",0
12,"12125",216,180,177,0,3,"FE de las J",0
5,"5194",140,119,116,1,3,"FE de las J",0
34,"34182",786,606,597,10,9,"FE de las J",0
5,"5228",174,121,120,0,1,"FE de las J",0
47,"47057",268,197,196,0,1,"FE de las J",0
40,"40162",392,303,302,1,1,"FE de las J",3
46,"46030",800,627,614,5,13,"FE de las J",0
28,"28049",58480,45136,44820,242,316,"FE de las J",45
44,"44142",35,27,27,0,0,"FE de las J",0
47,"47212",380,323,322,2,1,"FE de las J",4
44,"44189",56,41,41,0,0,"FE de las J",3
4,"4031",2338,1772,1762,2,10,"FE de las J",0
45,"45012",661,510,503,6,7,"FE de las J",1
44,"44036",25,21,21,0,0,"FE de las J",0
45,"45112",1922,1247,1211,6,36,"FE de las J",1
44,"44176",158,115,114,0,1,"FE de las J",0
4,"4064",2771,2001,1988,13,13,"FE de las J",2
42,"42113",534,409,399,1,10,"FE de las J",0
46,"46005",22918,16958,16827,102,131,"FE de las J",21
34,"34089",155,124,124,2,0,"FE de las J",0
47,"47114",4045,2787,2762,26,25,"FE de las J",3
5,"5118",79,53,53,0,0,"FE de las J",0
42,"42176",29,25,25,0,0,"FE de las J",0
4,"4095",714,471,468,5,3,"FE de las J",0
12,"12085",4976,3236,3209,16,27,"FE de las J",9
19,"19172",57,48,47,0,1,"FE de las J",0
40,"40164",177,139,138,0,1,"FE de las J",0
46,"46145",21990,16337,16187,93,150,"FE de las J",18
44,"44222",131,98,98,0,0,"FE de las J",0
47,"47007",3769,2765,2736,24,29,"FE de las J",5
46,"46084",1576,1263,1242,5,21,"FE de las J",0
5,"5182",786,538,532,2,6,"FE de las J",1
47,"47152",78,60,60,0,0,"FE de las J",1
44,"44155",1090,793,782,4,11,"FE de las J",1
34,"34061",106,82,82,1,0,"FE de las J",0
40,"40081",124,94,92,2,2,"FE de las J",0
45,"45047",2606,1666,1647,6,19,"FE de las J",3
34,"34211",178,155,152,1,3,"FE de las J",0
2,"2074",5935,4193,4139,32,54,"FE de las J",11
42,"42117",140,101,99,0,2,"FE de las J",0
45,"45114",588,447,447,0,0,"FE de las J",0
5,"5184",246,183,183,0,0,"FE de las J",0
28,"28120",1223,892,884,2,8,"FE de las J",2
5,"5038",115,83,81,0,2,"FE de las J",0
5,"5183",138,111,110,0,1,"FE de las J",0
42,"42164",1600,1150,1127,8,23,"FE de las J",2
47,"47088",103,86,85,1,1,"FE de las J",0
2,"2035",1960,1483,1465,13,18,"FE de las J",2
44,"44146",174,153,152,2,1,"FE de las J",0
28,"28170",2472,1640,1622,13,18,"FE de las J",1
34,"34228",83,74,74,1,0,"FE de las J",0
5,"5901",263,182,180,2,2,"FE de las J",0
5,"5088",30,23,23,0,0,"FE de las J",0
45,"45049",433,305,304,1,1,"FE de las J",0
19,"19246",46,36,34,2,2,"FE de las J",0
44,"44113",71,52,52,0,0,"FE de las J",1
46,"46034",1758,1390,1379,4,11,"FE de las J",2
19,"19283",30,25,25,0,0,"FE de las J",0
5,"5089",485,384,376,0,8,"FE de las J",1
47,"47035",921,717,715,3,2,"FE de las J",2
41,"41054",692,560,546,3,14,"FE de las J",2
19,"19324",176,126,125,3,1,"FE de las J",0
12,"12110",234,176,173,0,3,"FE de las J",0
14,"14035",5966,4236,4177,39,59,"FE de las J",6
42,"42031",26,21,21,0,0,"FE de las J",0
46,"46035",6822,5202,5142,43,60,"FE de las J",5
47,"47089",148,125,124,0,1,"FE de las J",0
19,"19247",139,102,100,1,2,"FE de las J",0
5,"5042",153,122,121,0,1,"FE de las J",0
34,"34196",89,68,68,1,0,"FE de las J",1
47,"47117",301,233,227,2,6,"FE de las J",1
47,"47062",163,130,130,0,0,"FE de las J",1
47,"47198",69,50,50,0,0,"FE de las J",0
42,"42075",83,62,62,0,0,"FE de las J",0
47,"47011",565,461,458,5,3,"FE de las J",0
34,"34023",5236,3685,3636,30,49,"FE de las J",6
19,"19166",156,120,119,1,1,"FE de las J",0
34,"34052",174,135,133,0,2,"FE de las J",0
19,"19325",121,83,82,0,1,"FE de las J",0
14,"14036",3740,2747,2696,24,51,"FE de las J",0
45,"45084",2257,1679,1656,13,23,"FE de las J",5
19,"19031",15,9,9,0,0,"FE de las J",0
46,"46044",4218,3222,3158,18,64,"FE de las J",5
46,"46218",1060,910,885,7,25,"FE de las J",1
40,"40045",109,85,85,2,0,"FE de las J",2
19,"19102",98,79,78,0,1,"FE de las J",0
34,"34231",229,168,167,1,1,"FE de las J",0
40,"40031",526,398,396,2,2,"FE de las J",1
41,"41035",1108,794,780,7,14,"FE de las J",1
5,"5239",214,164,162,3,2,"FE de las J",7
14,"14038",32322,22117,21887,179,230,"FE de las J",7
46,"46115",378,286,282,1,4,"FE de las J",0
19,"19139",29,19,18,0,1,"FE de las J",0
44,"44042",123,91,90,0,1,"FE de las J",0
11,"11002",4273,2835,2815,16,20,"FE de las J",0
46,"46193",8788,6925,6871,50,54,"FE de las J",6
42,"42079",26,18,18,1,0,"FE de las J",0
2,"2040",559,484,483,3,1,"FE de las J",0
5,"5095",262,225,223,1,2,"FE de las J",2
47,"47064",33,28,25,0,3,"FE de las J",0
42,"42023",63,51,51,0,0,"FE de las J",0
46,"46246",1058,835,823,5,12,"FE de las J",1
19,"19251",43,29,28,0,1,"FE de las J",0
47,"47148",442,342,338,2,4,"FE de las J",0
47,"47228",440,331,331,2,0,"FE de las J",0
46,"46253",115,82,82,0,0,"FE de las J",0
5,"5145",50,40,40,0,0,"FE de las J",0
45,"45087",8311,5828,5747,43,81,"FE de las J",1
40,"40048",38,29,27,0,2,"FE de las J",0
34,"34903",198,131,131,1,0,"FE de las J",0
14,"14039",2604,2062,2021,12,41,"FE de las J",3
45,"45188",2785,1960,1938,15,22,"FE de las J",1
40,"40007",78,63,61,0,2,"FE de las J",0
46,"46012",896,682,663,1,19,"FE de las J",1
46,"46263",251,214,212,0,2,"FE de las J",0
34,"34011",397,321,320,5,1,"FE de las J",1
5,"5147",159,128,124,5,4,"FE de las J",0
40,"40177",153,125,125,1,0,"FE de las J",0
46,"46047",532,446,437,2,9,"FE de las J",0
45,"45176",3706,2554,2521,22,33,"FE de las J",7
19,"19289",28,25,24,1,1,"FE de las J",0
46,"46254",1000,785,779,6,6,"FE de las J",0
47,"47229",210,148,147,1,1,"FE de las J",0
42,"42174",174,137,135,5,2,"FE de las J",0
19,"19182",38,34,33,0,1,"FE de las J",0
4,"4043",549,465,461,1,4,"FE de las J",11
28,"28059",4323,3171,3157,11,14,"FE de las J",2
19,"19106",89,59,59,0,0,"FE de las J",0
46,"46074",2696,2069,2038,14,31,"FE de las J",2
14,"14012",6173,4364,4291,35,73,"FE de las J",0
28,"28157",609,433,430,1,3,"FE de las J",0
41,"41083",1147,864,856,4,8,"FE de las J",1
34,"34059",426,347,342,6,5,"FE de las J",3
46,"46144",663,532,529,2,3,"FE de las J",1
28,"28060",1510,1134,1117,1,17,"FE de las J",3
46,"46092",276,192,189,0,3,"FE de las J",0
4,"4901",545,395,394,0,1,"FE de las J",0
47,"47150",274,209,205,0,4,"FE de las J",0
12,"12064",91,82,81,2,1,"FE de las J",0
19,"19255",79,63,61,1,2,"FE de las J",0
28,"28004",6234,4202,4167,16,35,"FE de las J",4
42,"42039",226,138,138,4,0,"FE de las J",0
34,"34155",129,104,103,2,1,"FE de las J",0
5,"5245",353,286,285,3,1,"FE de las J",5
11,"11040",397,307,292,1,15,"FE de las J",0
12,"12006",172,135,133,0,2,"FE de las J",0
42,"42068",82,63,60,1,3,"FE de las J",0
40,"40221",49,39,39,0,0,"FE de las J",0
19,"19185",28,21,20,0,1,"FE de las J",0
40,"40012",269,192,191,2,1,"FE de las J",0
34,"34224",47,37,37,1,0,"FE de las J",0
28,"28138",60,46,46,0,0,"FE de las J",0
2,"2086",2586,1701,1687,7,14,"FE de las J",3
45,"45024",1062,793,785,4,8,"FE de las J",0
4,"4045",1757,1309,1288,6,21,"FE de las J",3
41,"41074",3012,2282,2257,18,25,"FE de las J",0
4,"4904",1777,1230,1221,12,9,"FE de las J",2
45,"45192",2491,2069,2049,2,20,"FE de las J",0
42,"42177",69,60,60,1,0,"FE de las J",0
5,"5104",35,28,28,0,0,"FE de las J",0
19,"19222",110,82,82,0,0,"FE de las J",0
45,"45125",2305,1865,1841,8,24,"FE de las J",1
42,"42085",189,129,127,3,2,"FE de las J",0
47,"47125",58,46,46,0,0,"FE de las J",1
46,"46016",1061,870,856,5,14,"FE de las J",0
14,"14043",7574,5515,5443,81,72,"FE de las J",9
44,"44017",285,227,223,4,4,"FE de las J",2
40,"40208",766,596,589,3,7,"FE de las J",0
12,"12119",148,95,93,0,2,"FE de las J",0
11,"11032",53874,31273,31008,348,265,"FE de las J",20
5,"5057",2465,1969,1953,15,16,"FE de las J",3
47,"47207",278,215,212,3,3,"FE de las J",0
42,"42181",412,313,307,2,6,"FE de las J",0
28,"28161",48848,35503,35203,210,300,"FE de las J",53
46,"46121",105,95,94,0,1,"FE de las J",0
40,"40141",842,593,584,10,9,"FE de las J",0
28,"28062",292,231,226,1,5,"FE de las J",0
34,"34126",277,200,199,2,1,"FE de las J",0
4,"4013",141378,94872,94288,741,584,"FE de las J",101
2,"2022",351,281,279,1,2,"FE de las J",0
19,"19111",155,126,126,1,0,"FE de las J",0
46,"46069",162,124,123,0,1,"FE de las J",0
47,"47018",34,28,28,0,0,"FE de las J",0
46,"46095",610,467,459,1,8,"FE de las J",1
12,"12068",48,36,35,1,1,"FE de las J",0
44,"44019",67,50,49,0,1,"FE de las J",1
5,"5002",1963,1422,1390,3,32,"FE de las J",5
44,"44124",77,64,64,3,0,"FE de las J",0
42,"42007",113,86,86,5,0,"FE de las J",0
19,"19298",65,45,45,0,0,"FE de las J",0
19,"19297",32,24,24,1,0,"FE de las J",0
45,"45161",13688,9007,8902,32,105,"FE de las J",14
19,"19260",42,39,39,1,0,"FE de las J",0
41,"41055",14954,10068,9945,64,123,"FE de las J",10
19,"19136",18,14,14,0,0,"FE de las J",0
44,"44148",90,75,73,2,2,"FE de las J",0
40,"40225",1138,883,867,3,16,"FE de las J",1
47,"47046",118,92,90,1,2,"FE de las J",0
28,"28133",5979,4140,4098,18,42,"FE de las J",4
28,"28008",1799,1182,1174,4,8,"FE de las J",3
2,"2065",476,394,392,1,2,"FE de las J",0
5,"5174",68,53,53,2,0,"FE de las J",0
46,"46235",21579,15929,15763,113,166,"FE de las J",10
47,"47002",23,21,20,1,1,"FE de las J",0
19,"19237",47,38,38,0,0,"FE de las J",0
46,"46001",795,601,592,3,9,"FE de las J",0
34,"34201",193,158,155,1,3,"FE de las J",0
47,"47091",84,71,71,2,0,"FE de las J",0
45,"45085",1500,1011,999,4,12,"FE de las J",2
2,"2053",2998,2231,2189,16,42,"FE de las J",3
14,"14047",1672,1187,1178,14,9,"FE de las J",1
44,"44227",74,63,62,0,1,"FE de las J",0
44,"44126",329,234,229,4,5,"FE de las J",0
42,"42010",19,14,14,1,0,"FE de las J",0
47,"47047",199,157,156,2,1,"FE de las J",0
5,"5207",692,547,543,0,4,"FE de las J",0
46,"46097",963,733,728,4,5,"FE de las J",0
44,"44127",68,51,51,0,0,"FE de las J",0
44,"44160",466,304,301,2,3,"FE de las J",0
47,"47174",267,218,215,1,3,"FE de las J",1
19,"19311",82,69,67,0,2,"FE de las J",0
45,"45065",271,207,206,1,1,"FE de las J",0
4,"4082",297,200,200,0,0,"FE de las J",1
5,"5113",71,56,56,0,0,"FE de las J",0
46,"46046",892,675,668,1,7,"FE de las J",1
46,"46098",2482,1907,1889,11,18,"FE de las J",3
5,"5162",86,66,63,0,3,"FE de las J",0
12,"12037",17,16,14,0,2,"FE de las J",0
12,"12072",1101,929,911,11,18,"FE de las J",1
19,"19263",26,15,15,1,0,"FE de las J",0
34,"34027",1085,751,741,6,10,"FE de las J",1
46,"46125",847,689,684,5,5,"FE de las J",1
46,"46203",3606,2873,2844,9,29,"FE de las J",1
4,"4052",12274,8372,8306,93,66,"FE de las J",7
19,"19329",59,50,50,1,0,"FE de las J",0
47,"47183",130,106,105,0,1,"FE de las J",1
46,"46099",901,689,684,1,5,"FE de las J",0
28,"28136",647,528,518,2,10,"FE de las J",0
46,"46160",1913,1452,1436,1,16,"FE de las J",1
44,"44045",366,274,269,2,5,"FE de las J",1
47,"47141",134,111,110,0,1,"FE de las J",0
40,"40106",201,158,158,2,0,"FE de las J",0
40,"40190",53,45,44,0,1,"FE de las J",0
44,"44097",142,92,92,0,0,"FE de las J",0
34,"34121",187,148,148,3,0,"FE de las J",0
47,"47184",573,453,451,1,2,"FE de las J",1
44,"44129",39,32,32,0,0,"FE de las J",0
46,"46126",5556,4449,4405,24,44,"FE de las J",8
12,"12095",959,749,742,8,7,"FE de las J",0
42,"42145",138,108,107,2,1,"FE de las J",0
12,"12074",785,652,648,5,4,"FE de las J",2
47,"47213",109,82,82,0,0,"FE de las J",0
14,"14050",2391,1822,1787,14,35,"FE de las J",0
28,"28013",40471,28739,28490,188,249,"FE de las J",33
47,"47077",246,193,191,1,2,"FE de las J",0
5,"5263",173,129,129,1,0,"FE de las J",4
11,"11017",3212,2233,2203,39,30,"FE de las J",1
46,"46127",2692,2120,2091,18,29,"FE de las J",2
42,"42191",185,136,133,0,3,"FE de las J",0
40,"40065",493,373,373,3,0,"FE de las J",1
12,"12137",36,23,23,0,0,"FE de las J",0
41,"41062",2223,1653,1637,7,16,"FE de las J",0
14,"14023",2021,1660,1639,8,21,"FE de las J",1
19,"19049",10,10,9,0,1,"FE de las J",0
42,"42001",278,212,210,3,2,"FE de las J",1
34,"34047",1782,1397,1374,12,23,"FE de las J",6
5,"5119",32,22,22,0,0,"FE de las J",0
46,"46058",1772,1398,1373,15,25,"FE de las J",1
28,"28119",2092,1590,1582,12,8,"FE de las J",5
40,"40010",121,102,101,1,1,"FE de las J",0
42,"42029",137,104,104,2,0,"FE de las J",0
46,"46154",808,636,631,5,5,"FE de las J",0
5,"5198",73,62,62,0,0,"FE de las J",1
46,"46076",575,454,443,0,11,"FE de las J",0
5,"5019",44555,33259,32939,277,320,"FE de las J",98
44,"44234",61,51,51,1,0,"FE de las J",0
40,"40154",20,15,15,0,0,"FE de las J",0
34,"34225",4921,3588,3559,30,29,"FE de las J",8
19,"19065",127,104,104,3,0,"FE de las J",0
40,"40140",92,69,67,0,2,"FE de las J",0
34,"34125",86,65,64,0,1,"FE de las J",0
44,"44168",189,139,138,2,1,"FE de las J",0
2,"2021",1017,784,778,6,6,"FE de las J",0
41,"41064",5596,3517,3456,55,61,"FE de las J",2
40,"40111",58,49,49,0,0,"FE de las J",0
47,"47126",50,41,41,0,0,"FE de las J",0
5,"5267",101,72,70,0,2,"FE de las J",0
34,"34079",1616,1222,1205,5,17,"FE de las J",1
44,"44028",183,151,150,4,1,"FE de las J",0
45,"45037",1603,1122,1111,5,11,"FE de las J",0
5,"5122",134,102,101,0,1,"FE de las J",1
47,"47053",119,98,96,0,2,"FE de las J",0
40,"40071",43,39,38,1,1,"FE de las J",0
46,"46008",2651,2108,2089,21,19,"FE de las J",2
19,"19082",85,64,64,0,0,"FE de las J",1
34,"34094",64,45,44,0,1,"FE de las J",0
28,"28016",79,53,51,0,2,"FE de las J",0
28,"28044",5826,4445,4409,24,36,"FE de las J",17
42,"42103",575,450,445,1,5,"FE de las J",2
12,"12079",399,316,314,2,2,"FE de las J",1
4,"4058",354,261,259,1,2,"FE de las J",0
44,"44204",24,21,21,0,0,"FE de las J",0
47,"47216",115,91,87,0,4,"FE de las J",10
47,"47135",83,72,72,2,0,"FE de las J",1
40,"40072",211,162,159,1,3,"FE de las J",0
46,"46104",1940,1504,1487,7,17,"FE de las J",0
34,"34229",68,57,56,1,1,"FE de las J",0
28,"28017",1208,907,899,7,8,"FE de las J",2
2,"2024",3409,2589,2554,29,35,"FE de las J",2
42,"42196",10,7,7,0,0,"FE de las J",0
19,"19070",74,53,53,0,0,"FE de las J",0
46,"46018",608,515,511,0,4,"FE de las J",1
19,"19309",26,21,21,0,0,"FE de las J",0
44,"44136",49,43,43,1,0,"FE de las J",0
40,"40030",473,369,363,3,6,"FE de las J",1
28,"28046",4460,3447,3422,16,25,"FE de las J",1
14,"14008",2839,1905,1895,19,10,"FE de las J",0
5,"5238",782,565,563,5,2,"FE de las J",0
12,"12121",1107,924,893,4,31,"FE de las J",0
19,"19326",1841,1280,1272,1,8,"FE de las J",1
5,"5044",266,183,183,1,0,"FE de las J",1
19,"19055",52,41,41,1,0,"FE de las J",0
28,"28047",40914,30019,29788,169,231,"FE de las J",42
42,"42107",74,54,54,3,0,"FE de las J",1
19,"19033",64,52,50,1,2,"FE de las J",0
5,"5126",70,56,55,0,1,"FE de las J",0
46,"46184",26505,20428,20223,115,205,"FE de las J",25
40,"40159",142,100,99,1,1,"FE de las J",0
2,"2026",836,690,679,3,11,"FE de las J",1
19,"19274",902,660,651,7,9,"FE de las J",1
45,"45141",884,700,689,3,11,"FE de las J",0
47,"47056",87,67,67,0,0,"FE de las J",0
12,"12012",2685,2234,2202,13,32,"FE de las J",6
45,"45174",301,237,233,1,4,"FE de las J",0
5,"5127",643,519,514,3,5,"FE de las J",0
40,"40201",49,42,42,0,0,"FE de las J",0
44,"44138",135,98,94,0,4,"FE de las J",0
19,"19017",69,57,57,0,0,"FE de las J",0
2,"2027",315,248,246,2,2,"FE de las J",0
28,"28174",1795,1232,1221,7,11,"FE de las J",1
34,"34041",90,71,71,1,0,"FE de las J",1
46,"46081",10134,7771,7702,41,69,"FE de las J",4
45,"45109",2883,2271,2214,9,57,"FE de las J",3
46,"46159",22857,16840,16697,128,143,"FE de las J",23
46,"46211",1745,1387,1378,8,9,"FE de las J",1
4,"4028",221,191,190,1,1,"FE de las J",0
44,"44208",37,22,22,0,0,"FE de las J",0
28,"28086",5154,3530,3493,13,37,"FE de las J",11
34,"34086",103,89,88,0,1,"FE de las J",1
47,"47140",115,102,102,1,0,"FE de las J",0
28,"28078",38,32,32,0,0,"FE de las J",0
5,"5163",1737,1347,1340,4,7,"FE de las J",0
45,"45010",415,311,310,2,1,"FE de las J",0
46,"46134",2357,1725,1712,14,13,"FE de las J",1
19,"19047",64,55,55,0,0,"FE de las J",0
41,"41082",3415,2671,2647,16,24,"FE de las J",1
41,"41049",9299,6896,6771,98,125,"FE de las J",0
44,"44109",108,73,73,0,0,"FE de las J",0
34,"34234",71,52,50,0,2,"FE de las J",0
46,"46108",469,378,375,1,3,"FE de las J",0
5,"5082",529,432,422,1,10,"FE de las J",0
42,"42025",1189,844,833,2,11,"FE de las J",2
47,"47113",159,129,128,0,1,"FE de las J",0
44,"44003",19,17,17,0,0,"FE de las J",0
45,"45100",188,150,150,0,0,"FE de las J",1
42,"42175",21,16,16,0,0,"FE de las J",0
47,"47006",190,136,135,1,1,"FE de las J",0
45,"45145",2565,1695,1675,12,20,"FE de las J",1
46,"46187",1306,1017,1000,0,17,"FE de las J",1
46,"46057",487,321,317,1,4,"FE de las J",1
45,"45078",1379,1129,1119,6,10,"FE de las J",2
44,"44243",24,20,20,0,0,"FE de las J",0
45,"45177",2110,1679,1656,3,23,"FE de las J",0
45,"45046",2412,1667,1654,7,13,"FE de las J",3
19,"19008",37,28,27,1,1,"FE de las J",0
5,"5230",66,63,62,1,1,"FE de las J",0
42,"42162",2352,1637,1601,16,36,"FE de las J",1
42,"42115",61,47,47,1,0,"FE de las J",0
41,"41006",2740,1782,1768,14,14,"FE de las J",0
28,"28149",5759,4352,4310,25,42,"FE de las J",8
19,"19184",71,50,48,0,2,"FE de las J",0
47,"47051",335,268,263,2,5,"FE de las J",3
4,"4902",45437,28936,28699,214,237,"FE de las J",37
47,"47033",196,154,154,1,0,"FE de las J",0
40,"40206",173,135,134,0,1,"FE de las J",1
42,"42003",67,48,47,0,1,"FE de las J",1
45,"45091",394,269,267,3,2,"FE de las J",0
40,"40194",39602,29382,29042,206,340,"FE de las J",30
5,"5246",59,46,44,0,2,"FE de las J",0
40,"40053",83,66,65,0,1,"FE de las J",0
5,"5037",255,173,172,1,1,"FE de las J",0
44,"44038",104,83,82,0,1,"FE de las J",1
44,"44212",39,37,37,1,0,"FE de las J",1
19,"19133",83,72,72,0,0,"FE de las J",0
46,"46111",10930,7931,7828,44,103,"FE de las J",11
40,"40166",253,218,215,1,3,"FE de las J",0
34,"34157",2442,1792,1768,21,24,"FE de las J",4
40,"40126",79,56,54,0,2,"FE de las J",0
5,"5199",40,32,31,0,1,"FE de las J",0
34,"34139",166,107,106,1,1,"FE de las J",0
45,"45148",292,223,223,0,0,"FE de las J",1
34,"34190",56,41,40,2,1,"FE de las J",0
40,"40082",114,84,82,1,2,"FE de las J",0
28,"28053",6498,4995,4955,28,40,"FE de las J",5
42,"42057",164,104,104,2,0,"FE de las J",0
4,"4034",160,99,99,2,0,"FE de las J",0
46,"46242",333,267,266,0,1,"FE de las J",3
34,"34001",34,28,28,2,0,"FE de las J",0
28,"28090",8505,6654,6609,33,45,"FE de las J",10
12,"12089",4328,3078,3020,15,58,"FE de las J",9
19,"19175",32,28,28,0,0,"FE de las J",0
46,"46164",11771,8564,8483,64,81,"FE de las J",7
19,"19307",27,23,23,0,0,"FE de las J",0
45,"45115",2552,1999,1966,8,33,"FE de las J",2
44,"44157",64,48,48,1,0,"FE de las J",0
40,"40099",52,44,42,0,2,"FE de las J",0
2,"2049",823,573,564,1,9,"FE de las J",1
40,"40171",32,23,23,0,0,"FE de las J",0
5,"5187",1754,1323,1303,7,20,"FE de las J",5
19,"19284",10,10,9,0,1,"FE de las J",0
46,"46250",578719,442973,440154,2541,2819,"FE de las J",389
46,"46165",7129,5436,5388,25,48,"FE de las J",13
47,"47225",80,63,63,0,0,"FE de las J",0
41,"41044",7423,5273,5241,34,32,"FE de las J",10
34,"34096",55,42,42,0,0,"FE de las J",0
46,"46113",2457,1804,1782,6,22,"FE de las J",1
28,"28027",1203,872,857,3,15,"FE de las J",0
46,"46191",1937,1530,1505,5,25,"FE de las J",2
45,"45017",262,204,203,0,1,"FE de las J",0
47,"47118",168,127,127,2,0,"FE de las J",0
34,"34143",168,123,120,2,3,"FE de las J",0
28,"28055",916,693,687,5,6,"FE de las J",4
44,"44008",1613,1163,1153,6,10,"FE de las J",1
34,"34245",307,209,208,5,1,"FE de las J",3
34,"34005",851,673,658,4,15,"FE de las J",0
40,"40101",877,635,628,8,7,"FE de las J",3
5,"5109",450,352,339,4,13,"FE de las J",1
47,"47217",1910,1370,1366,1,4,"FE de las J",2
4,"4026",66,54,51,0,3,"FE de las J",0
44,"44206",114,90,87,0,3,"FE de las J",1
44,"44238",2323,1603,1590,5,13,"FE de las J",2
41,"41045",5756,3988,3924,53,64,"FE de las J",3
40,"40173",138,99,93,1,6,"FE de las J",1
5,"5222",147,127,126,1,1,"FE de las J",0
44,"44149",103,78,78,3,0,"FE de las J",0
28,"28056",863,630,617,4,13,"FE de las J",0
46,"46252",118,99,98,0,1,"FE de las J",0
5,"5191",121,106,105,1,1,"FE de las J",0
45,"45086",496,351,343,2,8,"FE de las J",0
44,"44080",292,229,223,3,6,"FE de las J",1
28,"28182",210,171,169,0,2,"FE de las J",0
42,"42123",164,117,116,4,1,"FE de las J",0
41,"41047",10117,7515,7422,74,93,"FE de las J",7
5,"5240",3374,2283,2257,7,26,"FE de las J",2
46,"46219",127,112,112,1,0,"FE de las J",0
42,"42215",773,531,520,7,11,"FE de las J",0
40,"40075",160,139,139,0,0,"FE de las J",1
4,"4102",13694,8944,8865,50,79,"FE de las J",12
40,"40215",84,60,60,0,0,"FE de las J",0
28,"28029",520,408,406,0,2,"FE de las J",0
19,"19058",6793,5258,5218,19,40,"FE de las J",5
28,"28094",865,624,622,4,2,"FE de las J",4
46,"46142",787,619,602,1,17,"FE de las J",2
41,"41901",2682,2107,2086,28,21,"FE de las J",0
12,"12025",136,104,104,0,0,"FE de las J",0
2,"2041",336,265,260,0,5,"FE de las J",1
2,"2042",837,618,611,1,7,"FE de las J",0
28,"28030",1726,1320,1299,8,21,"FE de las J",0
42,"42036",50,41,41,1,0,"FE de las J",0
14,"14067",3889,2946,2899,29,47,"FE de las J",3
12,"12124",1840,1387,1381,33,6,"FE de las J",0
4,"4007",734,524,522,1,2,"FE de las J",2
34,"34028",143,116,113,1,3,"FE de las J",0
19,"19218",50,33,33,0,0,"FE de las J",0
28,"28166",320,254,251,2,3,"FE de las J",0
2,"2029",3282,2467,2445,17,22,"FE de las J",5
19,"19241",43,34,34,1,0,"FE de las J",0
46,"46039",2130,1728,1699,8,29,"FE de las J",0
11,"11038",13737,10181,10034,99,147,"FE de las J",8
14,"14068",538,401,398,10,3,"FE de las J",0
47,"47175",6564,4781,4728,39,53,"FE de las J",6
46,"46221",352,305,304,0,1,"FE de las J",0
47,"47093",813,613,600,5,13,"FE de las J",0
45,"45122",5212,4004,3961,16,43,"FE de las J",3
44,"44187",201,152,149,4,3,"FE de las J",0
19,"19230",505,360,357,3,3,"FE de las J",2
44,"44257",166,123,119,1,4,"FE de las J",0
19,"19183",74,65,65,0,0,"FE de las J",0
34,"34012",357,269,264,5,5,"FE de las J",0
42,"42218",82,55,55,0,0,"FE de las J",0
40,"40136",112,88,87,0,1,"FE de las J",0
44,"44221",372,303,300,1,3,"FE de las J",0
46,"46118",3763,2940,2908,16,32,"FE de las J",4
41,"41017",15158,10718,10616,92,102,"FE de las J",8
44,"44258",67,47,47,0,0,"FE de las J",0
40,"40009",49,43,43,0,0,"FE de las J",0
42,"42083",26,20,20,0,0,"FE de las J",0
40,"40220",66,50,46,1,4,"FE de las J",1
45,"45190",475,371,366,0,5,"FE de las J",0
28,"28158",665,537,533,4,4,"FE de las J",0
28,"28097",119,94,94,0,0,"FE de las J",0
40,"40037",41,29,29,0,0,"FE de las J",0
4,"4065",363,284,282,7,2,"FE de las J",0
45,"45191",543,472,468,3,4,"FE de las J",0
5,"5152",678,554,551,3,3,"FE de las J",1
4,"4085",387,304,301,2,3,"FE de las J",0
2,"2046",1098,896,878,12,18,"FE de las J",0
46,"46015",7244,5615,5560,40,55,"FE de las J",10
14,"14042",18891,14051,13848,190,203,"FE de las J",14
12,"12108",456,378,371,2,7,"FE de las J",0
19,"19256",43,36,36,0,0,"FE de las J",0
19,"19305",155,116,115,0,1,"FE de las J",0
47,"47124",392,316,311,3,5,"FE de las J",0
11,"11041",9866,6477,6402,69,75,"FE de las J",1
46,"46224",159,121,121,0,0,"FE de las J",0
28,"28061",21389,16277,16135,67,142,"FE de las J",26
19,"19161",211,159,157,1,2,"FE de las J",1
40,"40139",279,202,198,1,4,"FE de las J",0
41,"41041",9706,7239,7120,36,119,"FE de las J",5
47,"47069",124,105,104,1,1,"FE de las J",0
5,"5249",105,84,82,0,2,"FE de las J",0
45,"45092",232,197,191,0,6,"FE de las J",1
46,"46042",3380,2799,2755,20,44,"FE de las J",2
40,"40054",108,90,90,0,0,"FE de las J",0
47,"47224",87,76,76,0,0,"FE de las J",0
44,"44224",22,14,14,0,0,"FE de las J",0
5,"5251",60,42,42,1,0,"FE de las J",1
2,"2008",1193,857,847,7,10,"FE de las J",0
19,"19296",30,19,18,0,1,"FE de las J",0
28,"28100",4196,2987,2955,14,32,"FE de las J",5
47,"47044",331,293,290,2,3,"FE de las J",0
40,"40182",178,133,130,2,3,"FE de las J",0
2,"2062",408,297,292,0,5,"FE de las J",1
4,"4088",2454,1660,1650,15,10,"FE de las J",0
40,"40112",2555,1932,1909,8,23,"FE de las J",2
5,"5023",168,146,145,1,1,"FE de las J",0
5,"5204",603,456,451,1,5,"FE de las J",1
47,"47208",58,38,36,1,2,"FE de las J",0
47,"47154",152,128,125,1,3,"FE de las J",1
46,"46017",32949,23913,23685,142,228,"FE de las J",32
45,"45094",387,298,297,1,1,"FE de las J",1
5,"5058",78,49,48,0,1,"FE de las J",0
28,"28101",231,187,187,0,0,"FE de las J",0
44,"44225",107,74,74,1,0,"FE de las J",0
5,"5124",102,83,81,0,2,"FE de las J",1
5,"5157",232,162,159,1,3,"FE de las J",0
46,"46226",41,36,35,0,1,"FE de las J",1
34,"34067",127,93,93,1,0,"FE de las J",0
42,"42135",72,52,52,1,0,"FE de las J",0
19,"19113",485,366,366,3,0,"FE de las J",0
46,"46070",16950,12765,12676,61,89,"FE de las J",16
4,"4049",5313,3620,3579,18,41,"FE de las J",2
42,"42183",111,82,82,2,0,"FE de las J",0
44,"44226",140,98,98,2,0,"FE de las J",0
41,"41034",23070,14805,14625,186,180,"FE de las J",17
34,"34082",83,74,73,0,1,"FE de las J",1
19,"19177",76,61,59,0,2,"FE de las J",0
46,"46251",2462,1997,1956,6,41,"FE de las J",3
45,"45185",7700,5771,5691,20,80,"FE de las J",5
44,"44041",56,44,44,1,0,"FE de las J",0
19,"19002",69,58,57,0,1,"FE de las J",0
28,"28164",2993,2183,2168,8,15,"FE de las J",5
40,"40130",130,107,106,1,1,"FE de las J",0
42,"42048",66,51,51,0,0,"FE de las J",0
5,"5257",132,101,101,0,0,"FE de las J",0
19,"19227",66,44,43,2,1,"FE de las J",0
28,"28037",1559,1177,1166,5,11,"FE de las J",0
19,"19190",2369,1760,1745,10,15,"FE de las J",0
12,"12102",522,423,418,1,5,"FE de las J",1
46,"46019",8849,7072,7004,33,68,"FE de las J",7
4,"4091",334,268,267,6,1,"FE de las J",0
46,"46028",387,330,328,3,2,"FE de las J",1
44,"44053",105,78,78,0,0,"FE de las J",1
42,"42092",56,44,42,1,2,"FE de las J",0
45,"45130",317,253,250,1,3,"FE de las J",0
19,"19104",14,12,12,1,0,"FE de las J",0
2,"2054",386,291,290,0,1,"FE de las J",0
46,"46072",3611,2871,2821,23,50,"FE de las J",5
19,"19191",14,13,12,0,1,"FE de las J",0
5,"5209",85,70,70,0,0,"FE de las J",0
46,"46020",3760,2916,2866,22,50,"FE de las J",1
12,"12048",251,185,182,0,3,"FE de las J",0
46,"46003",950,791,769,1,22,"FE de las J",1
47,"47130",96,72,72,0,0,"FE de las J",0
5,"5259",124,105,105,1,0,"FE de las J",0
19,"19156",970,704,699,4,5,"FE de las J",1
44,"44196",131,101,98,2,3,"FE de las J",0
44,"44267",70,57,56,0,1,"FE de las J",1
46,"46229",948,762,758,0,4,"FE de las J",1
46,"46177",4690,3579,3526,19,53,"FE de las J",2
46,"46238",13282,9786,9721,61,65,"FE de las J",5
42,"42051",20,14,14,1,0,"FE de las J",0
14,"14002",10951,7706,7620,83,86,"FE de las J",8
42,"42216",25,23,23,0,0,"FE de las J",0
42,"42127",38,31,31,1,0,"FE de las J",0
14,"14058",7970,5491,5417,66,74,"FE de las J",2
41,"41070",6032,4312,4258,44,54,"FE de las J",5
5,"5065",471,394,392,4,2,"FE de las J",5
46,"46186",19068,14599,14474,69,125,"FE de las J",17
47,"47049",101,68,68,0,0,"FE de las J",1
47,"47023",2995,2344,2326,18,18,"FE de las J",3
34,"34168",52,47,47,2,0,"FE de las J",0
28,"28108",3374,2482,2465,10,17,"FE de las J",8
2,"2044",1105,768,758,7,10,"FE de las J",0
40,"40022",213,164,161,2,3,"FE de las J",0
46,"46100",286,232,230,1,2,"FE de las J",0
28,"28109",1576,1103,1098,1,5,"FE de las J",4
42,"42095",1773,1269,1251,15,18,"FE de las J",2
45,"45201",3447,2082,2050,9,32,"FE de las J",7
40,"40063",7096,5184,5100,36,84,"FE de las J",14
19,"19159",93,78,77,0,1,"FE de las J",0
5,"5117",200,174,173,1,1,"FE de las J",0
44,"44056",501,345,342,2,3,"FE de las J",0
47,"47024",259,208,207,1,1,"FE de las J",0
12,"12106",1158,955,942,8,13,"FE de las J",0
34,"34123",1648,1287,1258,12,29,"FE de las J",1
2,"2059",302,234,232,1,2,"FE de las J",1
46,"46101",860,716,705,3,11,"FE de las J",0
44,"44165",175,135,133,2,2,"FE de las J",0
44,"44244",75,47,47,1,0,"FE de las J",0
19,"19220",2302,1519,1501,1,18,"FE de las J",4
42,"42219",43,31,30,0,1,"FE de las J",0
46,"46188",672,544,537,8,7,"FE de las J",0
19,"19266",236,188,188,1,0,"FE de las J",0
19,"19293",1867,1358,1342,7,16,"FE de las J",5
5,"5102",1780,1339,1317,3,22,"FE de las J",3
42,"42130",59,46,45,1,1,"FE de las J",0
5,"5053",82,57,57,0,0,"FE de las J",0
19,"19108",111,97,96,0,1,"FE de las J",0
40,"40152",760,592,584,3,8,"FE de las J",0
2,"2060",1294,997,983,2,14,"FE de las J",1
44,"44201",495,411,406,0,5,"FE de las J",1
47,"47214",1409,1087,1062,7,25,"FE de las J",3
44,"44060",41,32,32,0,0,"FE de las J",0
28,"28169",1448,1122,1113,5,9,"FE de las J",0
45,"45181",2315,1674,1640,7,34,"FE de las J",0
4,"4021",185,151,148,1,3,"FE de las J",0
42,"42084",25,22,22,1,0,"FE de las J",0
40,"40097",128,93,92,0,1,"FE de las J",0
40,"40903",86,67,67,0,0,"FE de las J",0
44,"44101",58,46,46,2,0,"FE de las J",0
34,"34034",123,95,95,1,0,"FE de las J",1
46,"46077",7496,5909,5827,45,82,"FE de las J",2
5,"5121",249,185,185,4,0,"FE de las J",0
46,"46207",6676,5106,5040,41,66,"FE de las J",5
46,"46025",2499,1953,1934,8,19,"FE de las J",1
45,"45170",228,176,167,0,9,"FE de las J",0
34,"34035",111,98,97,0,1,"FE de las J",0
44,"44203",10,10,10,0,0,"FE de las J",0
5,"5218",121,97,97,0,0,"FE de las J",0
42,"42194",170,118,114,1,4,"FE de las J",1
44,"44156",45,31,31,1,0,"FE de las J",0
45,"45149",556,446,440,0,6,"FE de las J",2
28,"28151",3142,2235,2199,8,36,"FE de las J",2
44,"44075",323,248,246,0,2,"FE de las J",0
5,"5107",62,39,39,0,0,"FE de las J",0
40,"40029",35,27,26,0,1,"FE de las J",0
5,"5074",686,564,558,5,6,"FE de las J",0
12,"12078",325,235,233,0,2,"FE de las J",0
19,"19270",20,17,17,0,0,"FE de las J",0
42,"42058",113,92,89,0,3,"FE de las J",1
5,"5123",97,73,73,1,0,"FE de las J",0
5,"5172",123,93,93,1,0,"FE de las J",0
14,"14026",2067,1424,1405,4,19,"FE de las J",0
46,"46139",4485,3617,3574,18,43,"FE de las J",4
44,"44237",398,304,301,4,3,"FE de las J",0
47,"47081",45,36,35,1,1,"FE de las J",0
4,"4089",742,521,518,1,3,"FE de las J",1
12,"12080",1932,1598,1570,10,28,"FE de las J",1
46,"46209",1933,1445,1415,5,30,"FE de las J",0
28,"28172",9077,6992,6936,31,56,"FE de las J",8
14,"14027",7925,5836,5746,58,90,"FE de las J",2
12,"12011",4565,3331,3283,20,48,"FE de las J",3
11,"11023",9348,6410,6349,64,61,"FE de las J",1
19,"19099",298,200,199,6,1,"FE de las J",0
4,"4036",226,175,175,0,0,"FE de las J",0
47,"47163",290,230,228,3,2,"FE de las J",0
42,"42106",14,10,10,0,0,"FE de las J",0
19,"19087",18,18,18,0,0,"FE de las J",0
46,"46157",2980,2321,2298,10,23,"FE de las J",3
5,"5189",449,351,349,2,2,"FE de las J",0
47,"47218",993,743,734,2,9,"FE de las J",1
19,"19238",42,28,28,0,0,"FE de las J",0
14,"14037",3318,2374,2320,22,54,"FE de las J",2
5,"5905",217,165,164,0,1,"FE de las J",2
34,"34038",277,204,203,1,1,"FE de las J",0
41,"41002",1473,1038,1014,9,24,"FE de las J",1
42,"42157",13,10,10,0,0,"FE de las J",0
41,"41068",13939,9787,9674,72,113,"FE de las J",3
34,"34131",59,52,51,0,1,"FE de las J",1
12,"12024",143,125,124,0,1,"FE de las J",0
28,"28124",74,54,54,1,0,"FE de las J",0
46,"46158",1026,811,795,6,16,"FE de las J",0
19,"19202",8,6,6,0,0,"FE de las J",0
45,"45041",3752,2633,2597,12,36,"FE de las J",5
14,"14001",3514,2837,2789,28,48,"FE de las J",0
47,"47139",1040,777,767,6,10,"FE de las J",1
28,"28146",1787,1205,1194,0,11,"FE de las J",2
47,"47111",1020,742,732,7,10,"FE de las J",0
5,"5225",372,285,281,1,4,"FE de las J",0
44,"44107",218,152,152,5,0,"FE de las J",0
46,"46029",20613,14964,14879,93,85,"FE de las J",20
40,"40006",22,18,18,0,0,"FE de las J",0
46,"46220",48410,34644,34292,279,352,"FE de las J",39
44,"44141",135,97,96,1,1,"FE de las J",0
47,"47004",1181,939,930,7,9,"FE de las J",2
12,"12013",144,121,119,0,2,"FE de las J",0
34,"34233",130,107,107,1,0,"FE de las J",1
45,"45076",553,368,364,3,4,"FE de las J",0
12,"12083",93,79,76,0,3,"FE de las J",0
34,"34087",129,103,102,1,1,"FE de las J",0
40,"40231",108,90,89,0,1,"FE de las J",0
19,"19204",148,120,120,0,0,"FE de las J",0
47,"47013",100,82,81,1,1,"FE de las J",0
41,"41026",4314,3380,3322,18,58,"FE de las J",4
46,"46262",223,162,159,2,3,"FE de las J",1
44,"44185",99,76,75,0,1,"FE de las J",0
42,"42217",31,25,24,0,1,"FE de las J",0
41,"41902",4659,2679,2646,23,33,"FE de las J",0
19,"19127",89,64,64,0,0,"FE de las J",0
45,"45143",1170,881,874,4,7,"FE de las J",2
47,"47221",111,94,94,0,0,"FE de las J",0
12,"12050",1305,1015,1000,6,15,"FE de las J",1
19,"19157",55,46,46,0,0,"FE de las J",0
42,"42065",21,18,18,0,0,"FE de las J",0
46,"46031",10535,7543,7451,66,92,"FE de las J",4
45,"45179",525,391,386,3,5,"FE de las J",0
45,"45079",369,288,286,3,2,"FE de las J",0
5,"5035",100,84,84,0,0,"FE de las J",0
28,"28050",4076,2860,2839,21,21,"FE de las J",5
45,"45011",278,239,233,1,6,"FE de las J",0
2,"2030",3065,2287,2263,6,24,"FE de las J",2
4,"4074",2840,2000,1979,23,21,"FE de las J",4
19,"19208",43,30,30,0,0,"FE de las J",0
12,"12051",471,339,335,1,4,"FE de las J",0
47,"47142",141,99,97,0,2,"FE de las J",0
44,"44004",408,303,297,0,6,"FE de las J",0
46,"46110",21228,15563,15443,86,120,"FE de las J",18
34,"34238",330,268,266,3,2,"FE de las J",0
41,"41084",2845,2124,2081,9,43,"FE de las J",4
14,"14022",4006,2977,2949,17,28,"FE de las J",3
46,"46179",2165,1760,1737,16,23,"FE de las J",0
28,"28128",444,315,314,0,1,"FE de las J",0
2,"2073",4867,3520,3474,40,46,"FE de las J",2
11,"11007",17964,10038,9856,197,182,"FE de las J",9
47,"47095",38,31,31,0,0,"FE de las J",0
12,"12096",777,587,577,6,10,"FE de las J",0
5,"5069",73,64,63,0,1,"FE de las J",0
5,"5265",82,66,66,1,0,"FE de las J",0
42,"42055",164,121,121,0,0,"FE de las J",0
46,"46180",682,553,549,0,4,"FE de las J",1
14,"14005",6311,4143,4084,72,59,"FE de las J",2
46,"46137",270,210,207,4,3,"FE de las J",0
14,"14061",744,595,582,1,13,"FE de las J",0
28,"28052",3855,2626,2587,11,39,"FE de las J",3
34,"34156",50,45,45,0,0,"FE de las J",0
12,"12018",287,246,242,1,4,"FE de las J",0
11,"11019",1826,1302,1248,7,54,"FE de las J",5
40,"40222",168,145,144,0,1,"FE de las J",0
4,"4067",570,441,436,2,5,"FE de las J",0
46,"46059",1261,1035,1019,9,16,"FE de las J",0
45,"45014",4010,2646,2616,22,30,"FE de las J",5
34,"34241",18,13,13,1,0,"FE de las J",0
4,"4097",248,189,189,1,0,"FE de las J",1
47,"47061",256,212,211,2,1,"FE de las J",0
44,"44006",248,185,183,2,2,"FE de las J",0
46,"46086",82,70,69,1,1,"FE de las J",0
45,"45015",606,437,433,2,4,"FE de las J",0
34,"34050",200,153,152,0,1,"FE de las J",0
12,"12020",118,105,105,0,0,"FE de las J",0
12,"12009",17445,12088,11999,75,89,"FE de las J",16
44,"44102",30,27,26,0,1,"FE de las J",0
45,"45182",1034,806,791,1,15,"FE de las J",0
47,"47026",46,40,40,1,0,"FE de las J",1
14,"14053",6006,4285,4232,49,53,"FE de las J",0
28,"28063",258,194,193,1,1,"FE de las J",1
19,"19098",19,17,17,0,0,"FE de las J",0
45,"45050",457,333,328,1,5,"FE de las J",0
2,"2077",55,47,47,0,0,"FE de las J",0
11,"11033",20903,12949,12771,164,178,"FE de las J",5
46,"46061",342,274,272,1,2,"FE de las J",0
42,"42120",145,91,89,2,2,"FE de las J",0
46,"46243",138,115,112,1,3,"FE de las J",1
45,"45194",68,54,53,0,1,"FE de las J",0
4,"4099",4989,3636,3588,27,48,"FE de las J",3
34,"34243",325,252,248,0,4,"FE de las J",0
28,"28152",16093,12945,12877,58,68,"FE de las J",15
5,"5141",94,80,80,1,0,"FE de las J",0
2,"2038",281,223,223,0,0,"FE de las J",0
19,"19015",84,69,68,0,1,"FE de las J",0
34,"34098",777,551,545,8,6,"FE de las J",2
5,"5237",162,130,124,2,6,"FE de las J",0
45,"45117",747,606,601,4,5,"FE de las J",0
45,"45129",131,92,92,0,0,"FE de las J",0
47,"47073",122,103,101,1,2,"FE de las J",0
12,"12058",71,63,62,1,1,"FE de las J",0
46,"46088",166,125,125,4,0,"FE de las J",0
47,"47226",156,123,123,0,0,"FE de las J",0
34,"34053",207,170,169,3,1,"FE de las J",1
34,"34037",302,218,216,1,2,"FE de las J",0
28,"28074",138947,103687,102762,620,925,"FE de las J",147
47,"47173",880,644,638,20,6,"FE de las J",1
5,"5112",97,71,70,2,1,"FE de las J",0
44,"44182",197,157,157,0,0,"FE de las J",0
19,"19286",720,547,543,2,4,"FE de las J",1
5,"5143",66,51,49,0,2,"FE de las J",0
19,"19249",32,29,29,0,0,"FE de las J",0
44,"44217",29,25,25,3,0,"FE de las J",0
41,"41046",3023,2213,2183,5,30,"FE de las J",0
44,"44052",77,56,56,0,0,"FE de las J",0
19,"19088",79,61,61,0,0,"FE de las J",0
42,"42213",27,21,21,1,0,"FE de las J",0
40,"40214",208,168,168,2,0,"FE de las J",0
19,"19103",251,208,208,2,0,"FE de las J",0
19,"19327",418,350,348,1,2,"FE de las J",1
28,"28155",506,416,411,0,5,"FE de las J",0
5,"5046",44,38,38,1,0,"FE de las J",0
5,"5096",80,60,59,0,1,"FE de las J",2
34,"34902",139,106,106,0,0,"FE de las J",0
11,"11003",1261,836,822,7,14,"FE de las J",1
14,"14010",4027,2850,2807,19,43,"FE de las J",1
2,"2013",119,92,90,0,2,"FE de las J",0
12,"12113",83,67,66,3,1,"FE de las J",0
28,"28126",39,29,29,0,0,"FE de las J",0
44,"44082",89,78,77,0,1,"FE de las J",0
4,"4038",3084,2140,2126,16,14,"FE de las J",2
34,"34057",471,339,338,1,1,"FE de las J",0
42,"42125",70,59,59,1,0,"FE de las J",0
46,"46194",15567,11156,11044,86,112,"FE de las J",13
28,"28901",799,558,554,0,4,"FE de las J",3
41,"41093",18554,13978,13874,99,104,"FE de las J",5
19,"19116",12,9,9,0,0,"FE de las J",0
19,"19192",1736,1324,1308,8,16,"FE de las J",3
44,"44002",47,40,40,0,0,"FE de las J",0
44,"44241",533,396,389,0,7,"FE de las J",0
28,"28175",863,670,668,5,2,"FE de las J",3
40,"40091",119,97,95,1,2,"FE de las J",0
40,"40135",283,236,231,2,5,"FE de las J",0
5,"5227",358,253,250,1,3,"FE de las J",0
28,"28127",64827,51776,51613,220,163,"FE de las J",43
14,"14011",578,464,462,4,2,"FE de las J",0
5,"5148",25,15,15,0,0,"FE de las J",0
46,"46013",17383,13569,13483,82,86,"FE de las J",15
19,"19037",141,115,114,1,1,"FE de las J",1
46,"46230",13960,10351,10241,54,110,"FE de las J",14
40,"40092",118,87,87,1,0,"FE de las J",0
5,"5051",179,145,139,1,6,"FE de las J",0
40,"40008",44,39,39,1,0,"FE de las J",0
44,"44085",52,35,35,0,0,"FE de las J",0
46,"46066",1263,1024,1018,9,6,"FE de las J",1
44,"44153",1774,1135,1121,5,14,"FE de las J",1
46,"46170",3417,2714,2688,10,26,"FE de las J",4
14,"14003",1248,939,930,2,9,"FE de las J",0
34,"34208",51,42,42,0,0,"FE de las J",0
14,"14069",7524,5460,5392,43,68,"FE de las J",4
14,"14013",16796,11830,11616,129,214,"FE de las J",14
2,"2004",612,479,473,5,6,"FE de las J",2
44,"44154",256,192,188,3,4,"FE de las J",0
19,"19291",1191,879,869,3,10,"FE de las J",2
47,"47132",45,36,33,1,3,"FE de las J",0
46,"46240",210,164,161,1,3,"FE de las J",0
2,"2032",276,207,202,1,5,"FE de las J",0
5,"5133",66,53,53,0,0,"FE de las J",0
40,"40138",2169,1673,1656,7,17,"FE de las J",0
41,"41040",10541,7752,7698,68,54,"FE de las J",7
14,"14060",4868,3473,3412,41,61,"FE de las J",4
4,"4094",207,144,144,0,0,"FE de las J",0
28,"28129",8030,5986,5941,42,45,"FE de las J",9
47,"47042",54,37,37,0,0,"FE de las J",0
28,"28070",117,91,91,0,0,"FE de las J",0
47,"47160",425,308,303,0,5,"FE de las J",2
34,"34076",587,479,479,2,0,"FE de las J",0
12,"12097",63,49,49,0,0,"FE de las J",0
28,"28043",5921,3803,3759,18,44,"FE de las J",3
5,"5153",103,78,77,1,1,"FE de las J",0
47,"47079",58,48,47,0,1,"FE de las J",0
2,"2047",117,88,88,2,0,"FE de las J",0
45,"45147",581,450,446,1,4,"FE de las J",0
46,"46189",467,393,390,2,3,"FE de las J",0
34,"34062",171,119,118,2,1,"FE de las J",1
46,"46068",346,276,266,6,10,"FE de las J",0
2,"2007",1030,824,818,4,6,"FE de las J",1
44,"44122",1333,925,913,8,12,"FE de las J",0
45,"45158",2514,1777,1760,11,17,"FE de las J",3
45,"45126",260,176,175,3,1,"FE de las J",0
19,"19024",8196,5613,5563,28,50,"FE de las J",9
4,"4047",2281,1893,1878,11,15,"FE de las J",6
14,"14016",1337,1072,1060,2,12,"FE de las J",1
41,"41020",12887,8210,8118,82,92,"FE de las J",6
46,"46147",16835,11920,11791,61,129,"FE de las J",16
42,"42178",115,83,83,0,0,"FE de las J",0
44,"44213",62,50,50,0,0,"FE de las J",0
5,"5040",66,50,50,1,0,"FE de las J",0
44,"44133",21,15,15,0,0,"FE de las J",0
46,"46112",536,455,450,2,5,"FE de las J",0
42,"42165",409,271,261,10,10,"FE de las J",0
5,"5171",74,52,50,1,2,"FE de las J",0
42,"42182",56,43,41,1,2,"FE de las J",0
40,"40183",130,120,119,2,1,"FE de las J",0
12,"12033",1919,1437,1404,19,33,"FE de las J",1
46,"46043",136,124,124,0,0,"FE de las J",0
45,"45027",346,275,272,0,3,"FE de las J",0
14,"14045",3052,2362,2335,11,27,"FE de las J",2
41,"41021",21294,13762,13570,145,192,"FE de las J",13
44,"44215",159,109,109,2,0,"FE de las J",0
28,"28054",11257,8349,8273,55,76,"FE de las J",10
40,"40100",270,213,211,2,2,"FE de las J",0
34,"34159",357,253,248,4,5,"FE de las J",0
44,"44158",1180,876,862,10,14,"FE de las J",4
5,"5108",47,35,35,0,0,"FE de las J",0
42,"42008",57,43,43,0,0,"FE de las J",0
46,"46096",274,209,209,1,0,"FE de las J",0
40,"40016",58,49,49,0,0,"FE de las J",0
12,"12034",1424,1065,1035,3,30,"FE de las J",0
42,"42021",83,55,55,3,0,"FE de las J",0
46,"46131",49431,36570,36227,231,343,"FE de las J",44
42,"42139",23,15,15,1,0,"FE de las J",0
44,"44064",69,49,49,0,0,"FE de las J",1
45,"45006",1406,942,931,4,11,"FE de las J",1
34,"34178",117,103,103,0,0,"FE de las J",0
40,"40003",139,107,104,0,3,"FE de las J",0
4,"4005",556,437,431,3,6,"FE de las J",4
45,"45029",201,171,171,1,0,"FE de las J",0
47,"47110",450,350,346,1,4,"FE de las J",0
34,"34068",27,22,22,0,0,"FE de las J",0
12,"12132",480,396,389,3,7,"FE de las J",1
47,"47156",162,136,133,0,3,"FE de las J",1
42,"42141",112,80,80,0,0,"FE de las J",1
45,"45030",478,368,360,2,8,"FE de las J",0
28,"28134",61008,45177,44904,263,273,"FE de las J",52
2,"2066",234,189,187,1,2,"FE de las J",0
42,"42035",769,527,516,2,11,"FE de las J",1
42,"42198",23,16,16,4,0,"FE de las J",0
28,"28075",5621,4186,4148,26,38,"FE de las J",11
40,"40104",265,198,195,0,3,"FE de las J",0
5,"5161",579,459,447,3,12,"FE de las J",0
46,"46150",1831,1341,1333,7,8,"FE de las J",0
44,"44265",186,141,138,2,3,"FE de las J",0
41,"41025",2020,1361,1320,7,41,"FE de las J",2
47,"47211",47,35,34,0,1,"FE de las J",0
45,"45131",282,234,230,0,4,"FE de las J",0
2,"2014",356,283,280,1,3,"FE de las J",1
28,"28116",704,528,523,2,5,"FE de las J",0
45,"45153",1615,1258,1243,7,15,"FE de las J",3
41,"41036",3941,2674,2642,23,32,"FE de las J",1
5,"5177",158,130,129,0,1,"FE de las J",0
46,"46237",7211,5395,5343,42,52,"FE de las J",6
5,"5114",1345,1067,1044,3,23,"FE de las J",1
28,"28039",128,98,97,2,1,"FE de las J",0
44,"44096",161,138,135,3,3,"FE de las J",1
42,"42012",35,28,28,0,0,"FE de las J",2
19,"19034",22,16,16,0,0,"FE de las J",0
5,"5081",40,36,36,1,0,"FE de las J",0
28,"28021",554,370,364,3,6,"FE de las J",0
45,"45032",436,283,275,1,8,"FE de las J",1
41,"41015",5297,3478,3405,41,73,"FE de las J",2
28,"28095",1529,1119,1106,6,13,"FE de las J",4
12,"12114",198,144,144,1,0,"FE de las J",0
46,"46169",32247,24214,24053,154,161,"FE de las J",24
34,"34152",125,96,92,1,4,"FE de las J",0
4,"4008",505,423,417,5,6,"FE de las J",0
42,"42159",37,29,29,0,0,"FE de las J",0
44,"44152",64,46,45,0,1,"FE de las J",0
44,"44055",69,56,56,4,0,"FE de las J",0
34,"34088",246,193,186,1,7,"FE de las J",2
19,"19076",27,19,19,0,0,"FE de las J",0
5,"5212",231,164,163,2,1,"FE de las J",3
42,"42190",89,65,64,0,1,"FE de las J",0
46,"46022",15365,11093,10997,59,96,"FE de las J",18
12,"12005",8062,5829,5754,64,75,"FE de las J",7
19,"19038",28,24,23,0,1,"FE de las J",0
44,"44231",38,33,33,0,0,"FE de las J",0
47,"47067",174,127,126,0,1,"FE de las J",0
34,"34074",707,540,531,9,9,"FE de las J",2
19,"19118",11,9,9,0,0,"FE de las J",0
42,"42148",10,10,10,1,0,"FE de las J",0
45,"45001",1835,1281,1251,3,30,"FE de las J",3
2,"2018",829,661,653,1,8,"FE de las J",0
28,"28167",8356,6158,6106,46,52,"FE de las J",7
11,"11029",5430,3039,3000,44,39,"FE de las J",0
45,"45023",2177,1571,1556,6,15,"FE de las J",1
4,"4010",576,444,443,3,1,"FE de las J",0
19,"19332",92,71,69,1,2,"FE de las J",1
41,"41073",1707,1055,1041,5,14,"FE de las J",1
28,"28903",33082,27065,26922,154,143,"FE de las J",22
42,"42205",89,71,71,2,0,"FE de las J",0
5,"5075",107,72,72,0,0,"FE de las J",0
28,"28159",589,468,468,5,0,"FE de las J",0
34,"34106",109,89,86,2,3,"FE de las J",0
19,"19271",46,39,39,0,0,"FE de las J",0
45,"45136",5845,4091,4019,25,72,"FE de las J",0
28,"28140",3007,2276,2256,7,20,"FE de las J",5
5,"5135",425,317,315,5,2,"FE de las J",3
46,"46102",19788,15154,15038,89,116,"FE de las J",18
47,"47223",157,122,118,2,4,"FE de las J",0
47,"47025",120,94,94,1,0,"FE de las J",0
47,"47178",172,140,140,3,0,"FE de las J",0
34,"34018",209,168,164,1,4,"FE de las J",0
4,"4011",2765,2119,2096,21,23,"FE de las J",1
34,"34213",57,45,44,1,1,"FE de las J",0
42,"42207",40,33,32,0,1,"FE de las J",0
42,"42152",78,55,55,0,0,"FE de las J",0
46,"46129",524,420,412,4,8,"FE de las J",0
45,"45104",428,324,323,1,1,"FE de las J",0
44,"44027",164,123,123,1,0,"FE de las J",0
40,"40196",30,25,25,0,0,"FE de las J",1
11,"11020",165378,109810,108830,1188,980,"FE de las J",88
12,"12077",4605,3439,3382,15,57,"FE de las J",10
40,"40026",119,109,109,0,0,"FE de las J",0
47,"47162",74,60,60,0,0,"FE de las J",0
44,"44261",739,536,529,6,7,"FE de las J",0
45,"45137",1604,1032,1024,4,8,"FE de las J",0
47,"47080",30,22,21,0,1,"FE de las J",0
45,"45071",1835,1426,1408,5,18,"FE de las J",0
40,"40041",979,725,717,5,8,"FE de las J",1
11,"11901",5648,3676,3631,67,45,"FE de las J",4
19,"19198",14,12,12,0,0,"FE de las J",0
45,"45205",6824,4424,4362,22,62,"FE de las J",4
47,"47106",50,39,39,0,0,"FE de las J",0
2,"2063",1463,1073,1060,3,13,"FE de las J",1
46,"46234",348,279,275,3,4,"FE de las J",0
12,"12010",259,213,208,2,5,"FE de las J",0
40,"40905",133,103,100,1,3,"FE de las J",0
19,"19234",43,33,33,0,0,"FE de las J",0
34,"34215",164,141,140,1,1,"FE de las J",0
40,"40176",395,306,305,2,1,"FE de las J",0
47,"47010",13729,10549,10454,81,95,"FE de las J",16
14,"14054",13697,10315,10109,93,206,"FE de las J",2
19,"19086",1473,1123,1111,7,12,"FE de las J",0
44,"44023",17,16,16,0,0,"FE de las J",0
42,"42059",21,15,14,0,1,"FE de las J",0
5,"5903",151,104,104,2,0,"FE de las J",0
5,"5076",478,386,378,4,8,"FE de las J",1
47,"47063",103,81,80,1,1,"FE de las J",0
19,"19176",237,181,181,0,0,"FE de las J",0
4,"4100",8768,5390,5353,32,37,"FE de las J",2
19,"19054",192,164,164,1,0,"FE de las J",0
44,"44063",71,54,54,0,0,"FE de las J",0
2,"2078",920,675,664,1,11,"FE de las J",2
5,"5077",158,140,139,1,1,"FE de las J",1
41,"41012",3290,2071,2030,20,41,"FE de las J",2
28,"28092",151841,110916,109954,582,962,"FE de las J",144
19,"19003",42,35,34,1,1,"FE de las J",0
2,"2025",7461,5759,5618,34,141,"FE de las J",11
47,"47003",227,180,179,3,1,"FE de las J",0
28,"28019",1233,893,885,4,8,"FE de las J",6
45,"45040",1349,846,838,4,8,"FE de las J",0
41,"41080",1274,910,892,6,18,"FE de las J",0
12,"12901",3405,2626,2598,23,28,"FE de las J",7
46,"46037",1122,936,923,4,13,"FE de las J",1
28,"28154",5408,3806,3767,16,39,"FE de las J",9
47,"47055",203,167,163,0,4,"FE de las J",0
34,"34202",29,18,18,1,0,"FE de las J",0
34,"34232",750,578,564,7,14,"FE de las J",1
19,"19168",292,204,198,1,6,"FE de las J",0
44,"44033",269,191,190,0,1,"FE de las J",1
19,"19126",1627,1155,1134,11,21,"FE de las J",1
19,"19004",67,53,53,1,0,"FE de las J",0
40,"40202",60,46,46,0,0,"FE de las J",0
4,"4071",394,338,337,3,1,"FE de las J",0
41,"41058",17395,12556,12332,111,224,"FE de las J",17
42,"42172",29,26,26,0,0,"FE de las J",0
46,"46038",327,242,242,3,0,"FE de las J",0
40,"40079",234,179,179,3,0,"FE de las J",0
12,"12049",441,322,312,1,10,"FE de las J",0
45,"45054",3959,2882,2848,12,34,"FE de las J",1
42,"42158",103,76,76,0,0,"FE de las J",0
40,"40211",74,64,64,0,0,"FE de las J",1
34,"34204",46,41,41,0,0,"FE de las J",0
14,"14020",387,269,264,2,5,"FE de las J",0
40,"40061",67,55,54,1,1,"FE de las J",0
12,"12014",184,144,143,2,1,"FE de las J",0
47,"47158",889,667,659,8,8,"FE de las J",1
19,"19317",139,110,109,1,1,"FE de las J",1
42,"42063",49,35,35,0,0,"FE de las J",0
45,"45121",6796,4743,4692,22,51,"FE de las J",5
42,"42037",33,25,25,2,0,"FE de las J",0
34,"34058",189,172,172,2,0,"FE de las J",0
46,"46091",118,94,94,0,0,"FE de las J",0
40,"40216",759,574,571,3,3,"FE de las J",1
19,"19006",769,547,540,2,7,"FE de las J",0
2,"2083",219,191,191,0,0,"FE de las J",0
47,"47102",291,230,220,1,10,"FE de las J",2
12,"12084",17615,12766,12644,105,122,"FE de las J",15
19,"19048",18,15,15,1,0,"FE de las J",0
40,"40036",515,421,410,3,11,"FE de las J",0
40,"40163",53,44,43,0,1,"FE de las J",0
42,"42161",137,102,101,0,1,"FE de las J",0
28,"28148",85454,62367,61884,370,483,"FE de las J",102
5,"5132",960,669,657,1,12,"FE de las J",1
44,"44068",659,509,503,3,6,"FE de las J",2
45,"45022",391,285,281,3,4,"FE de las J",0
40,"40093",77,65,65,1,0,"FE de las J",0
12,"12015",93,81,78,0,3,"FE de las J",0
44,"44130",34,24,24,0,0,"FE de las J",0
34,"34237",592,462,452,6,10,"FE de las J",2
12,"12016",1582,1307,1297,6,10,"FE de las J",1
40,"40219",587,455,444,5,11,"FE de las J",0
28,"28069",50,44,41,0,3,"FE de las J",0
19,"19280",3464,2469,2438,14,31,"FE de las J",3
41,"41018",9480,6523,6455,53,68,"FE de las J",3
40,"40205",261,202,198,2,4,"FE de las J",0
28,"28091",5440,3596,3558,24,38,"FE de las J",5
41,"41099",3976,2369,2347,12,22,"FE de las J",2
40,"40198",24,19,19,0,0,"FE de las J",0
46,"46223",7801,5950,5899,34,51,"FE de las J",15
11,"11014",16858,10366,10245,153,121,"FE de las J",8
28,"28180",5251,3927,3893,7,34,"FE de las J",3
2,"2019",2405,1871,1835,12,36,"FE de las J",0
40,"40039",210,156,153,3,3,"FE de las J",1
34,"34174",200,159,154,5,5,"FE de las J",0
45,"45081",17875,12656,12533,82,123,"FE de las J",16
19,"19232",71,57,57,1,0,"FE de las J",0
44,"44131",25,20,20,0,0,"FE de las J",0
34,"34189",56,44,44,1,0,"FE de las J",0
12,"12098",580,451,447,5,4,"FE de las J",0
46,"46198",839,684,674,4,10,"FE de las J",0
40,"40040",2607,1843,1828,19,15,"FE de las J",2
41,"41075",10212,6419,6295,49,124,"FE de las J",5
11,"11031",76455,49854,49405,535,449,"FE de las J",46
5,"5185",95,82,81,0,1,"FE de las J",0
28,"28179",1432,1040,1037,4,3,"FE de las J",1
19,"19097",16,10,10,0,0,"FE de las J",0
19,"19134",24,15,15,0,0,"FE de las J",0
46,"46190",48947,35638,35419,211,219,"FE de las J",42
42,"42030",94,78,78,1,0,"FE de las J",0
12,"12043",570,449,442,2,7,"FE de las J",0
46,"46138",343,275,272,1,3,"FE de las J",0
40,"40127",32,25,25,0,0,"FE de las J",0
5,"5234",49,44,44,2,0,"FE de las J",0
40,"40119",169,138,133,1,5,"FE de las J",0
45,"45105",392,301,297,3,4,"FE de las J",0
42,"42044",54,42,39,0,3,"FE de las J",0
11,"11010",6410,4189,4130,88,59,"FE de las J",0
14,"14063",1046,734,725,2,9,"FE de las J",2
41,"41043",639,436,427,5,9,"FE de las J",0
5,"5090",77,68,68,1,0,"FE de las J",0
45,"45016",4204,3146,3105,22,41,"FE de las J",5
41,"41077",8702,5983,5875,29,108,"FE de las J",3
14,"14007",15207,10558,10417,82,141,"FE de las J",12
44,"44151",190,151,148,0,3,"FE de las J",0
42,"42108",12,9,9,1,0,"FE de las J",0
44,"44118",164,132,131,2,1,"FE de las J",0
45,"45184",200,129,129,0,0,"FE de las J",0
11,"11902",3629,2275,2252,25,23,"FE de las J",1
34,"34116",62,49,49,0,0,"FE de las J",0
14,"14064",320,242,236,2,6,"FE de las J",0
45,"45150",443,356,354,0,2,"FE de las J",0
12,"12057",606,487,474,5,13,"FE de las J",0
19,"19112",60,46,46,0,0,"FE de las J",1
46,"46260",2581,2087,2068,22,19,"FE de las J",2
19,"19225",823,623,619,3,4,"FE de las J",4
47,"47155",3228,2277,2254,18,23,"FE de las J",8
45,"45039",224,192,190,0,2,"FE de las J",1
5,"5221",351,254,250,2,4,"FE de las J",0
19,"19138",255,202,201,2,1,"FE de las J",0
47,"47146",255,206,204,1,2,"FE de las J",0
45,"45051",1590,1171,1152,5,19,"FE de las J",1
5,"5049",401,272,266,1,6,"FE de las J",2
46,"46175",456,389,387,3,2,"FE de las J",0
46,"46045",1249,1028,1010,3,18,"FE de las J",0
19,"19261",37,25,24,0,1,"FE de las J",0
12,"12092",111,91,90,0,1,"FE de las J",0
11,"11035",13593,8375,8276,90,99,"FE de las J",8
45,"45119",3330,2096,2067,15,29,"FE de las J",3
12,"12002",110,99,98,1,1,"FE de las J",0
40,"40131",48,42,42,0,0,"FE de las J",1
19,"19239",92,62,62,1,0,"FE de las J",0
47,"47190",98,80,80,1,0,"FE de las J",0
19,"19216",131,98,98,0,0,"FE de las J",1
40,"40047",30,25,25,0,0,"FE de las J",0
47,"47092",110,87,87,0,0,"FE de las J",1
45,"45019",7377,5307,5251,37,56,"FE de las J",7
4,"4006",7022,4792,4749,30,43,"FE de las J",3
47,"47012",113,93,93,0,0,"FE de las J",0
44,"44043",102,74,72,0,2,"FE de las J",0
34,"34165",66,58,58,1,0,"FE de las J",0
45,"45142",7871,6007,5927,37,80,"FE de las J",6
14,"14029",4178,3047,3009,28,38,"FE de las J",5
40,"40124",237,182,177,6,5,"FE de las J",2
40,"40084",62,55,52,0,3,"FE de las J",0
4,"4068",187,154,152,0,2,"FE de las J",0
44,"44001",68,53,52,1,1,"FE de las J",1
5,"5193",193,167,164,1,3,"FE de las J",0
45,"45195",2141,1635,1606,7,29,"FE de las J",1
19,"19224",93,87,87,0,0,"FE de las J",0
28,"28020",145,94,94,0,0,"FE de las J",0
40,"40121",280,226,218,3,8,"FE de las J",0
34,"34181",448,322,319,7,3,"FE de las J",1
42,"42064",86,68,68,0,0,"FE de las J",0
45,"45199",2940,1848,1805,14,43,"FE de las J",3
11,"11015",62476,38177,37875,488,302,"FE de las J",31
2,"2028",126,98,98,0,0,"FE de las J",0
47,"47005",549,413,408,2,5,"FE de las J",1
34,"34240",89,64,64,0,0,"FE de las J",0
47,"47203",62,53,53,1,0,"FE de las J",0
11,"11037",5661,4347,4265,33,82,"FE de las J",1
47,"47096",140,110,110,0,0,"FE de las J",0
46,"46257",5571,4266,4224,25,42,"FE de las J",5
12,"12045",345,268,259,1,9,"FE de las J",0
45,"45043",793,657,649,1,8,"FE de las J",1
45,"45189",599,470,462,2,8,"FE de las J",1
5,"5149",106,77,77,1,0,"FE de las J",0
4,"4009",162,123,122,2,1,"FE de las J",0
5,"5101",292,240,236,1,4,"FE de las J",0
41,"41903",6757,4562,4504,51,58,"FE de las J",2
12,"12028",12586,9733,9676,62,57,"FE de las J",13
46,"46040",1078,888,878,7,10,"FE de las J",0
46,"46222",384,307,304,1,3,"FE de las J",0
47,"47029",57,52,52,0,0,"FE de las J",0
47,"47123",466,354,352,4,2,"FE de las J",0
45,"45156",3410,2751,2711,13,40,"FE de las J",1
34,"34017",918,744,736,9,8,"FE de las J",2
44,"44059",544,425,412,9,13,"FE de las J",0
34,"34170",61,42,42,0,0,"FE de las J",0
12,"12052",578,452,435,3,17,"FE de las J",0
5,"5067",83,68,67,0,1,"FE de las J",0
45,"45134",1581,1204,1192,6,12,"FE de las J",1
19,"19135",107,90,90,3,0,"FE de las J",0
46,"46107",1900,1516,1504,5,12,"FE de las J",0
45,"45187",4062,3277,3233,15,44,"FE de las J",3
19,"19013",125,108,108,1,0,"FE de las J",0
44,"44181",76,57,56,0,1,"FE de las J",0
19,"19181",56,42,42,0,0,"FE de las J",0
45,"45020",1290,1037,1026,6,11,"FE de las J",1
11,"11022",48675,26491,26256,270,235,"FE de las J",16
40,"40068",26,24,24,0,0,"FE de las J",0
40,"40110",349,265,263,3,2,"FE de las J",0
40,"40025",136,117,115,0,2,"FE de las J",0
2,"2033",1892,1505,1474,6,31,"FE de las J",2
46,"46024",413,314,313,2,1,"FE de las J",0
34,"34092",288,230,226,1,4,"FE de las J",0
46,"46241",392,299,291,1,8,"FE de las J",1
5,"5043",84,66,66,0,0,"FE de las J",0
4,"4001",1062,823,814,5,9,"FE de las J",0
42,"42043",3791,2727,2682,25,45,"FE de las J",3
5,"5055",568,456,451,4,5,"FE de las J",1
46,"46146",1654,1304,1278,7,26,"FE de las J",2
47,"47052",6576,4988,4944,40,44,"FE de las J",10
28,"28006",78966,59065,58698,267,367,"FE de las J",59
5,"5155",52,44,44,0,0,"FE de las J",0
5,"5106",35,25,25,0,0,"FE de las J",0
19,"19258",90,77,77,0,0,"FE de las J",0
47,"47097",325,266,265,0,1,"FE de las J",0
19,"19335",55,47,47,0,0,"FE de las J",0
42,"42208",22,13,13,2,0,"FE de las J",0
45,"45093",155,129,127,1,2,"FE de las J",0
41,"41042",5844,4424,4378,40,46,"FE de las J",3
46,"46248",4897,3596,3544,18,52,"FE de las J",4
45,"45152",587,458,451,0,7,"FE de las J",0
4,"4016",2138,1551,1536,9,15,"FE de las J",2
5,"5022",1588,1238,1222,5,16,"FE de las J",3
47,"47188",111,88,88,3,0,"FE de las J",0
44,"44262",135,108,107,2,1,"FE de las J",0
2,"2009",19660,14256,14116,127,140,"FE de las J",11
14,"14025",2924,2466,2422,14,44,"FE de las J",0
41,"41033",5075,3313,3277,34,36,"FE de las J",4
42,"42154",97,69,69,1,0,"FE de las J",0
5,"5144",76,55,54,0,1,"FE de las J",0
28,"28183",1039,743,735,2,8,"FE de las J",4
5,"5080",58,45,43,0,2,"FE de las J",0
5,"5047",4163,3198,3142,17,56,"FE de las J",10
44,"44249",55,44,44,2,0,"FE de las J",0
4,"4003",17357,11157,11075,64,82,"FE de las J",10
40,"40073",401,345,343,3,2,"FE de las J",1
46,"46174",972,764,752,2,12,"FE de las J",1
41,"41089",6493,4398,4331,43,67,"FE de las J",3
44,"44171",178,126,124,2,2,"FE de las J",0
42,"42155",167,103,102,1,1,"FE de las J",0
46,"46183",5993,4443,4381,19,62,"FE de las J",5
44,"44216",26555,18997,18737,168,260,"FE de las J",37
11,"11026",4782,3451,3378,26,73,"FE de las J",4
40,"40129",177,148,147,1,1,"FE de las J",2
40,"40212",27,23,22,2,1,"FE de las J",0
44,"44026",90,77,76,0,1,"FE de las J",2
46,"46128",1597,1290,1250,5,40,"FE de las J",0
47,"47186",246129,186191,184733,1198,1458,"FE de las J",221
14,"14018",3709,2697,2653,26,44,"FE de las J",0
41,"41023",7905,5402,5347,41,55,"FE de las J",3
28,"28106",76907,52773,52265,385,508,"FE de las J",113
45,"45163",8298,5942,5855,28,87,"FE de las J",3
34,"34113",38,36,36,0,0,"FE de las J",0
42,"42061",291,214,213,3,1,"FE de las J",0
14,"14056",23581,16120,15958,143,162,"FE de las J",13
2,"2039",984,790,786,10,4,"FE de las J",1
42,"42078",1020,717,703,7,14,"FE de las J",0
45,"45193",613,504,497,1,7,"FE de las J",1
34,"34206",866,661,654,4,7,"FE de las J",2
40,"40234",397,298,292,2,6,"FE de las J",2
45,"45075",143,109,108,0,1,"FE de las J",0
42,"42049",116,81,81,1,0,"FE de las J",0
42,"42187",62,46,45,1,1,"FE de las J",0
19,"19155",66,56,56,0,0,"FE de las J",0
5,"5258",111,95,95,0,0,"FE de las J",1
28,"28048",500,391,387,3,4,"FE de las J",1
19,"19179",69,56,56,1,0,"FE de las J",0
34,"34015",41,35,35,3,0,"FE de las J",0
34,"34136",179,110,110,1,0,"FE de las J",0
41,"41091",541987,385251,382091,3298,3160,"FE de las J",308
41,"41011",15401,10170,9986,111,184,"FE de las J",11
12,"12021",4436,3381,3332,27,49,"FE de las J",7
44,"44117",340,271,268,4,3,"FE de las J",1
46,"46090",1637,1391,1367,3,24,"FE de las J",1
47,"47098",576,464,452,4,12,"FE de las J",1
44,"44236",63,48,47,0,1,"FE de las J",0
12,"12038",167,120,118,2,2,"FE de las J",0
45,"45168",62229,47154,46741,285,413,"FE de las J",34
45,"45099",3500,2390,2361,9,29,"FE de las J",0
34,"34042",296,237,234,1,3,"FE de las J",0
40,"40034",84,70,70,0,0,"FE de las J",1
45,"45077",556,428,427,1,1,"FE de las J",0
19,"19080",65,41,41,0,0,"FE de las J",1
12,"12042",607,520,513,13,7,"FE de las J",3
46,"46065",1579,1174,1163,8,11,"FE de las J",0
5,"5070",30,27,27,0,0,"FE de las J",0
45,"45169",189,140,138,0,2,"FE de las J",0
44,"44167",38,31,31,0,0,"FE de las J",0
47,"47008",24,19,19,1,0,"FE de las J",0
14,"14052",9379,5917,5854,68,63,"FE de las J",3
41,"41038",100095,67313,66687,760,626,"FE de las J",97
46,"46135",9680,7682,7634,36,48,"FE de las J",5
40,"40021",27,27,26,0,1,"FE de las J",0
46,"46048",3452,2749,2713,14,36,"FE de las J",4
42,"42053",26,19,19,1,0,"FE de las J",0
46,"46213",15409,10924,10805,97,119,"FE de las J",8
19,"19318",25,18,18,0,0,"FE de las J",0
45,"45108",509,412,411,1,1,"FE de las J",0
41,"41013",4839,3151,3094,33,57,"FE de las J",1
46,"46210",330,277,277,2,0,"FE de las J",0
12,"12136",2635,2201,2171,18,30,"FE de las J",6
40,"40192",159,117,117,2,0,"FE de las J",0
47,"47059",97,76,76,2,0,"FE de las J",0
19,"19130",60145,45531,45085,286,446,"FE de las J",53
34,"34223",218,155,155,1,0,"FE de las J",0
42,"42027",76,61,60,0,1,"FE de las J",0
28,"28177",10270,8083,8030,36,53,"FE de las J",10
40,"40002",36,32,32,0,0,"FE de las J",0
12,"12044",468,419,412,3,7,"FE de las J",0
19,"19212",703,543,531,3,12,"FE de las J",0
46,"46168",1938,1495,1486,2,9,"FE de las J",2
34,"34070",154,123,123,2,0,"FE de las J",0
4,"4035",8364,5810,5766,28,44,"FE de las J",5
46,"46217",878,691,676,4,15,"FE de las J",0
5,"5192",101,82,79,2,3,"FE de las J",1
34,"34004",5608,4120,4063,43,57,"FE de las J",8
40,"40193",229,174,172,3,2,"FE de las J",0
34,"34177",179,149,149,2,0,"FE de las J",1
19,"19050",16,15,15,0,0,"FE de las J",0
45,"45203",2563,1801,1771,8,30,"FE de las J",2
47,"47034",72,58,58,3,0,"FE de las J",1
46,"46050",194,150,149,0,1,"FE de las J",1
28,"28064",129,106,106,2,0,"FE de las J",0
44,"44205",700,460,453,4,7,"FE de las J",0
45,"45069",1847,1391,1376,6,15,"FE de las J",2
45,"45002",2564,1681,1665,17,16,"FE de las J",4
42,"42016",18,14,14,0,0,"FE de las J",0
19,"19178",33,22,22,0,0,"FE de las J",0
5,"5168",3560,2589,2561,19,28,"FE de las J",8
46,"46105",16190,11323,11206,44,117,"FE de las J",18
34,"34227",77,61,61,2,0,"FE de las J",0
46,"46103",1264,1015,984,7,31,"FE de las J",1
5,"5217",56,44,43,0,1,"FE de las J",0
19,"19081",29,22,22,1,0,"FE de las J",0
42,"42086",36,27,26,2,1,"FE de las J",0
41,"41031",1238,825,814,11,11,"FE de las J",1
47,"47230",303,246,242,2,4,"FE de las J",0
42,"42026",24,20,20,0,0,"FE de las J",0
5,"5229",82,68,67,0,1,"FE de las J",1
34,"34010",577,440,438,5,2,"FE de las J",1
34,"34020",52,39,39,0,0,"FE de las J",0
41,"41087",10237,6923,6774,48,149,"FE de las J",3
28,"28072",5709,4356,4324,22,32,"FE de las J",5
44,"44169",342,252,252,3,0,"FE de las J",0
5,"5235",124,111,110,0,1,"FE de las J",0
34,"34141",177,149,145,2,4,"FE de las J",1
44,"44195",88,60,60,1,0,"FE de las J",0
40,"40033",58,51,51,0,0,"FE de las J",0
40,"40146",254,197,196,0,1,"FE de las J",2
40,"40160",102,71,70,1,1,"FE de las J",0
11,"11036",689,407,400,3,7,"FE de las J",0
34,"34009",31,29,29,1,0,"FE de las J",0
19,"19079",8,8,7,0,1,"FE de las J",0
12,"12090",102,86,85,1,1,"FE de las J",0
46,"46009",3121,2459,2427,8,32,"FE de las J",3
28,"28171",4239,2848,2820,19,28,"FE de las J",3
42,"42192",42,27,27,2,0,"FE de las J",0
44,"44090",78,53,53,0,0,"FE de las J",0
47,"47099",150,135,135,1,0,"FE de las J",0
45,"45128",2502,1680,1668,6,12,"FE de las J",1
5,"5254",190,160,159,0,1,"FE de las J",0
34,"34133",107,91,90,0,1,"FE de las J",0
19,"19277",19,13,13,0,0,"FE de las J",0
5,"5092",152,125,122,0,3,"FE de las J",1
14,"14034",308,247,244,2,3,"FE de las J",0
46,"46106",1535,1150,1140,10,10,"FE de las J",0
46,"46196",147,125,125,1,0,"FE de las J",0
34,"34055",270,209,207,2,2,"FE de las J",0
46,"46172",5042,3504,3477,22,27,"FE de las J",4
34,"34217",1207,937,923,8,14,"FE de las J",3
28,"28144",6010,4676,4644,22,32,"FE de las J",2
11,"11013",2312,1547,1518,15,29,"FE de las J",3
44,"44106",155,116,114,5,2,"FE de las J",1
34,"34099",60,48,48,0,0,"FE de las J",0
46,"46063",1756,1367,1345,15,22,"FE de las J",2
46,"46132",2150,1803,1784,7,19,"FE de las J",3
40,"40168",34,29,29,1,0,"FE de las J",0
46,"46202",16947,12814,12710,79,104,"FE de las J",10
40,"40018",91,72,72,1,0,"FE de las J",1
46,"46176",2017,1358,1349,5,9,"FE de las J",2
46,"46089",2132,1602,1574,9,28,"FE de las J",1
28,"28145",2431,1760,1736,6,24,"FE de las J",2
34,"34039",61,49,47,0,2,"FE de las J",0
42,"42200",81,59,58,2,1,"FE de las J",0
41,"41069",29138,18991,18683,341,308,"FE de las J",35
47,"47065",857,674,669,1,5,"FE de las J",1
42,"42019",516,363,356,3,7,"FE de las J",2
40,"40904",357,308,306,3,2,"FE de las J",0
40,"40229",36,24,24,0,0,"FE de las J",0
28,"28001",61,46,45,0,1,"FE de las J",0
19,"19096",91,72,69,0,3,"FE de las J",0
46,"46245",511,420,415,0,5,"FE de las J",0
46,"46239",442,340,338,3,2,"FE de las J",1
34,"34006",81,67,66,2,1,"FE de las J",0
44,"44247",316,218,215,3,3,"FE de las J",0
40,"40128",129,95,93,0,2,"FE de las J",0
42,"42032",146,118,118,0,0,"FE de las J",0
5,"5140",111,89,87,0,2,"FE de las J",0
14,"14030",8625,6248,6181,53,67,"FE de las J",1
34,"34071",171,132,132,1,0,"FE de las J",0
42,"42188",50,39,38,0,1,"FE de las J",0
5,"5086",80,67,67,2,0,"FE de las J",0
11,"11030",22775,15157,14958,149,199,"FE de las J",10
47,"47038",105,77,77,0,0,"FE de las J",0
14,"14019",6464,4967,4909,49,58,"FE de las J",3
47,"47157",515,424,423,1,1,"FE de las J",1
34,"34063",83,76,75,1,1,"FE de las J",0
11,"11006",24455,15750,15587,193,163,"FE de las J",10
34,"34031",30,30,29,0,1,"FE de las J",0
19,"19051",67,63,63,0,0,"FE de las J",0
34,"34093",85,70,70,0,0,"FE de las J",0
19,"19010",8,8,8,0,0,"FE de las J",0
42,"42204",54,38,38,1,0,"FE de las J",0
40,"40204",167,113,110,1,3,"FE de las J",0
19,"19171",4961,3670,3628,27,42,"FE de las J",3
47,"47204",256,204,198,0,6,"FE de las J",0
4,"4023",138,96,95,2,1,"FE de las J",0
34,"34033",17,17,17,0,0,"FE de las J",0
14,"14031",593,469,459,3,10,"FE de las J",0
40,"40115",101,86,85,1,1,"FE de las J",0
45,"45045",1318,905,888,5,17,"FE de las J",1
19,"19194",98,69,69,1,0,"FE de las J",0
46,"46205",14313,10932,10834,51,98,"FE de las J",7
47,"47185",99,73,71,0,2,"FE de las J",0
5,"5016",6335,4670,4586,41,84,"FE de las J",10
46,"46228",2348,1815,1794,7,21,"FE de las J",2
47,"47165",6955,4955,4303,66,652,"FE de las J",15
34,"34025",57,39,39,1,0,"FE de las J",1
46,"46052",499,421,417,2,4,"FE de las J",0
46,"46083",15422,11179,11049,86,130,"FE de las J",15
12,"12007",746,651,636,3,15,"FE de las J",2
46,"46071",464,383,377,0,6,"FE de las J",0
14,"14059",690,533,528,4,5,"FE de las J",0
4,"4101",4266,2909,2876,26,33,"FE de las J",4
28,"28036",2539,1899,1878,11,21,"FE de las J",7
5,"5041",1001,775,762,8,13,"FE de las J",2
41,"41066",1342,945,927,2,18,"FE de las J",0
46,"46232",895,711,696,5,15,"FE de las J",0
34,"34186",52,45,45,0,0,"FE de las J",0
40,"40906",2003,1569,1550,12,19,"FE de las J",1
46,"46181",16955,12313,12148,95,165,"FE de las J",11
44,"44239",22,20,20,0,0,"FE de las J",0
19,"19323",40,31,31,0,0,"FE de las J",0
2,"2080",528,406,400,2,6,"FE de las J",1
41,"41079",9294,6670,6580,51,90,"FE de las J",2
47,"47215",53,45,45,0,0,"FE de las J",0
47,"47027",2745,2036,2018,9,18,"FE de las J",0
42,"42004",2285,1757,1737,15,20,"FE de las J",2
40,"40223",216,163,163,1,0,"FE de las J",0
5,"5160",323,256,253,2,3,"FE de las J",0
12,"12055",104,83,82,3,1,"FE de las J",0
28,"28121",198,160,158,1,2,"FE de las J",1
19,"19174",109,80,79,0,1,"FE de las J",0
19,"19115",24,18,18,0,0,"FE de las J",0
2,"2020",432,365,364,1,1,"FE de las J",0
19,"19215",168,144,140,0,4,"FE de las J",1
45,"45172",689,530,522,2,8,"FE de las J",0
2,"2043",1239,937,927,3,10,"FE de las J",0
34,"34236",156,120,119,0,1,"FE de las J",0
46,"46255",3174,2448,2424,22,24,"FE de las J",2
47,"47199",80,63,63,0,0,"FE de las J",0
19,"19053",2008,1422,1404,10,18,"FE de las J",0
40,"40043",1802,1400,1381,8,19,"FE de las J",1
28,"28143",72,57,57,1,0,"FE de las J",0
28,"28041",4524,3508,3490,20,18,"FE de las J",7
28,"28057",1458,1097,1088,3,9,"FE de las J",3
46,"46903",6065,4790,4763,18,27,"FE de las J",2
2,"2052",459,372,369,4,3,"FE de las J",1
44,"44105",82,64,64,0,0,"FE de las J",0
12,"12129",1828,1322,1298,11,24,"FE de las J",3
11,"11024",6723,4696,4634,44,62,"FE de las J",0
4,"4057",1325,894,884,5,10,"FE de las J",1
45,"45144",783,620,618,3,2,"FE de las J",2
46,"46087",120,98,97,0,1,"FE de las J",0
34,"34192",90,75,72,0,3,"FE de las J",0
14,"14055",18557,12950,12764,178,186,"FE de las J",20
34,"34129",179,130,129,1,1,"FE de las J",0
5,"5173",60,49,49,0,0,"FE de las J",0
47,"47020",280,234,231,2,3,"FE de las J",2
40,"40199",105,84,84,0,0,"FE de las J",0
46,"46161",1483,1188,1173,7,15,"FE de las J",2
42,"42020",4263,2877,2821,35,56,"FE de las J",0
46,"46109",6150,4625,4556,25,69,"FE de las J",5
28,"28902",471,363,356,4,7,"FE de las J",0
5,"5045",91,66,66,0,0,"FE de las J",0
45,"45186",3061,2242,2214,11,28,"FE de las J",2
40,"40028",105,91,90,2,1,"FE de las J",1
4,"4080",209,162,162,3,0,"FE de las J",0
19,"19299",97,79,77,1,2,"FE de las J",0
45,"45053",8005,6211,6140,42,71,"FE de las J",2
19,"19331",2609,1872,1844,12,28,"FE de las J",0
5,"5264",61,38,37,2,1,"FE de las J",0
42,"42140",16,12,12,0,0,"FE de las J",0
19,"19279",57,55,55,0,0,"FE de las J",0
19,"19162",68,49,47,0,2,"FE de las J",0
44,"44049",849,616,604,9,12,"FE de las J",1
19,"19201",58,49,48,1,1,"FE de las J",0
28,"28112",161,136,136,1,0,"FE de las J",0
42,"42119",158,100,99,3,1,"FE de las J",0
40,"40005",30,23,23,0,0,"FE de las J",0
47,"47129",871,664,659,4,5,"FE de las J",0
47,"47147",116,92,92,0,0,"FE de las J",0
41,"41004",56640,37110,36649,440,461,"FE de las J",46
12,"12138",19061,13010,12847,129,163,"FE de las J",27
41,"41086",16170,10162,10088,73,74,"FE de las J",10
41,"41053",21259,15147,14853,132,294,"FE de las J",12
5,"5175",159,131,131,1,0,"FE de las J",0
40,"40103",159,125,123,2,2,"FE de las J",3
5,"5024",224,169,168,3,1,"FE de las J",1
45,"45102",3610,2506,2470,14,36,"FE de las J",0
19,"19290",834,561,558,5,3,"FE de las J",2
47,"47197",876,673,668,8,5,"FE de las J",0
34,"34216",66,50,50,0,0,"FE de las J",0
14,"14024",1903,1405,1376,16,29,"FE de las J",1
44,"44191",764,586,583,6,3,"FE de las J",2
19,"19186",81,68,68,0,0,"FE de las J",0
12,"12139",318,237,233,0,4,"FE de las J",1
42,"42015",30,20,19,1,1,"FE de las J",0
44,"44018",19,19,19,0,0,"FE de las J",0
40,"40004",459,356,352,2,4,"FE de las J",0
4,"4054",358,285,281,2,4,"FE de las J",0
14,"14062",1025,806,792,6,14,"FE de las J",0
40,"40078",161,125,124,2,1,"FE de las J",0
44,"44207",156,118,115,4,3,"FE de las J",0
12,"12109",649,532,524,6,8,"FE de las J",1
40,"40213",86,65,65,3,0,"FE de las J",2
41,"41010",4420,2960,2916,30,44,"FE de las J",1
5,"5233",221,191,191,1,0,"FE de las J",1
19,"19057",76,59,59,1,0,"FE de las J",0
47,"47036",228,181,181,3,0,"FE de las J",0
5,"5079",68,53,53,0,0,"FE de las J",0
41,"41061",2195,1749,1703,11,46,"FE de las J",0
34,"34081",61,53,52,0,1,"FE de las J",0
47,"47134",165,128,125,1,3,"FE de las J",0
42,"42018",152,117,116,1,1,"FE de las J",0
40,"40035",137,105,104,0,1,"FE de las J",1
12,"12067",537,435,427,0,8,"FE de las J",0
19,"19223",111,83,83,3,0,"FE de las J",0
47,"47182",1323,977,967,8,10,"FE de las J",0
46,"46011",7609,5249,5191,26,58,"FE de las J",5
28,"28122",513,375,370,2,5,"FE de las J",0
5,"5136",96,61,60,3,1,"FE de las J",0
28,"28009",14086,10611,10545,57,66,"FE de las J",25
4,"4012",191,161,161,0,0,"FE de las J",0
44,"44194",109,78,73,3,5,"FE de las J",0
42,"42100",32,30,30,0,0,"FE de las J",0
5,"5236",123,91,90,1,1,"FE de las J",1
28,"28130",28293,21253,21040,116,213,"FE de las J",24
47,"47119",92,80,79,1,1,"FE de las J",0
4,"4086",1760,1243,1234,9,9,"FE de las J",2
2,"2079",2875,2209,2181,12,28,"FE de las J",3
12,"12122",796,637,627,0,10,"FE de las J",0
14,"14015",2125,1579,1554,10,25,"FE de las J",1
5,"5105",341,249,247,7,2,"FE de las J",0
28,"28038",4952,3730,3688,34,42,"FE de las J",7
34,"34158",288,186,184,3,2,"FE de las J",0
30,"30015",19171,13561,13464,61,97,"FME",0
30,"30040",732,617,607,2,10,"FME",0
30,"30026",15734,10007,9901,51,106,"FME",0
30,"30028",6649,4797,4726,21,71,"FME",1
30,"30012",9091,6962,6897,36,65,"FME",1
30,"30042",1922,1504,1491,7,13,"FME",0
30,"30006",803,691,685,2,6,"FME",0
30,"30005",29526,20713,20526,121,187,"FME",6
30,"30016",151668,102093,101363,484,730,"FME",48
30,"30039",19277,13165,13054,75,111,"FME",1
30,"30013",7396,5147,5102,32,45,"FME",1
30,"30022",16913,11371,11214,93,157,"FME",2
30,"30043",24967,18981,18685,101,296,"FME",3
30,"30034",1129,858,844,7,14,"FME",0
30,"30001",4582,3620,3594,18,26,"FME",1
30,"30004",1137,870,862,3,8,"FME",0
30,"30036",14698,9859,9734,41,125,"FME",0
30,"30024",58746,42036,41731,206,305,"FME",9
30,"30023",3780,2874,2850,12,24,"FME",1
30,"30021",9099,6095,6045,20,50,"FME",6
30,"30025",4908,3667,3630,16,37,"FME",1
30,"30002",9903,7011,6943,28,68,"FME",1
30,"30901",10309,7821,7718,43,103,"FME",3
30,"30035",18671,13103,12979,54,124,"FME",7
30,"30030",312993,231648,230185,1207,1463,"FME",57
30,"30014",1567,1174,1160,8,14,"FME",1
30,"30003",24332,16183,16040,104,143,"FME",3
30,"30009",12433,9586,9503,41,83,"FME",4
30,"30017",11605,8541,8451,46,90,"FME",1
30,"30902",7975,5318,5273,24,45,"FME",3
30,"30038",15411,10847,10767,46,80,"FME",3
30,"30019",25857,17544,17374,125,170,"FME",6
30,"30037",18793,13150,13003,47,147,"FME",3
30,"30029",11864,8125,8058,73,67,"FME",2
30,"30033",10188,7403,7285,68,118,"FME",0
30,"30031",492,409,401,0,8,"FME",0
30,"30010",6869,5194,5142,21,52,"FME",1
30,"30032",2856,2163,2144,6,19,"FME",0
30,"30011",4697,3421,3383,15,38,"FME",1
30,"30008",13918,9757,9645,59,112,"FME",4
30,"30041",13621,8970,8889,46,81,"FME",4
30,"30007",6411,4360,4329,24,31,"FME",1
30,"30020",6303,4543,4497,25,46,"FME",0
30,"30027",48176,35521,35266,153,255,"FME",9
30,"30018",7978,5866,5811,30,55,"FME",3
31,"31177",255,169,166,2,3,"GBAI",8
31,"31089",242,172,170,1,2,"GBAI",5
31,"31085",480,350,350,2,0,"GBAI",16
31,"31111",95,65,65,2,0,"GBAI",9
31,"31173",861,683,667,3,16,"GBAI",1
31,"31192",156,129,127,3,2,"GBAI",6
31,"31213",104,52,52,0,0,"GBAI",10
31,"31140",117,84,84,1,0,"GBAI",12
31,"31074",387,286,286,5,0,"GBAI",12
31,"31030",141,100,99,0,1,"GBAI",4
31,"31208",2556,1949,1920,16,29,"GBAI",27
31,"31063",92,75,73,2,2,"GBAI",3
31,"31906",2562,1800,1779,26,21,"GBAI",50
31,"31166",258,181,181,1,0,"GBAI",6
31,"31263",233,138,137,2,1,"GBAI",17
31,"31070",2638,1808,1784,20,24,"GBAI",7
31,"31035",59,45,43,0,2,"GBAI",2
31,"31109",1582,1155,1150,9,5,"GBAI",41
31,"31197",69,56,56,2,0,"GBAI",1
31,"31012",793,563,555,6,8,"GBAI",13
31,"31056",174,121,120,0,1,"GBAI",3
31,"31902",4405,3092,3061,25,31,"GBAI",155
31,"31195",182,130,128,0,2,"GBAI",17
31,"31259",484,291,286,2,5,"GBAI",58
31,"31108",1855,1368,1348,7,20,"GBAI",10
31,"31228",486,341,337,2,4,"GBAI",11
31,"31214",91,64,62,1,2,"GBAI",10
31,"31105",1507,1167,1142,7,25,"GBAI",5
31,"31211",27,15,15,1,0,"GBAI",1
31,"31022",518,332,331,4,1,"GBAI",79
31,"31099",62,47,47,2,0,"GBAI",1
31,"31095",75,59,59,1,0,"GBAI",4
31,"31041",1606,1114,1101,15,13,"GBAI",39
31,"31240",527,327,326,2,1,"GBAI",54
31,"31241",133,98,98,2,0,"GBAI",6
31,"31231",117,76,73,1,3,"GBAI",0
31,"31107",1710,1255,1243,16,12,"GBAI",7
31,"31161",338,264,259,2,5,"GBAI",7
31,"31202",4305,2845,2803,31,42,"GBAI",27
31,"31170",47,42,42,3,0,"GBAI",3
31,"31175",71,48,48,0,0,"GBAI",3
31,"31101",1373,973,966,8,7,"GBAI",33
31,"31072",5279,3734,3679,40,55,"GBAI",24
31,"31235",159,117,115,2,2,"GBAI",3
31,"31037",84,66,66,1,0,"GBAI",15
31,"31044",289,230,227,1,3,"GBAI",43
31,"31261",231,173,169,3,4,"GBAI",6
31,"31091",351,220,217,1,3,"GBAI",35
31,"31258",7879,5707,5666,50,41,"GBAI",335
31,"31160",106,89,88,2,1,"GBAI",3
31,"31029",914,638,625,6,13,"GBAI",15
31,"31217",321,226,223,1,3,"GBAI",5
31,"31066",855,589,579,8,10,"GBAI",3
31,"31901",15459,11119,11026,108,93,"GBAI",475
31,"31136",447,299,298,2,1,"GBAI",17
31,"31219",84,66,66,0,0,"GBAI",0
31,"31155",256,169,167,2,2,"GBAI",2
31,"31171",680,495,486,8,9,"GBAI",7
31,"31210",196,152,152,2,0,"GBAI",20
31,"31092",662,439,435,4,4,"GBAI",47
31,"31199",146,92,89,3,3,"GBAI",13
31,"31008",75,54,54,2,0,"GBAI",5
31,"31128",359,265,263,0,2,"GBAI",15
31,"31093",292,188,188,2,0,"GBAI",16
31,"31238",112,93,93,0,0,"GBAI",3
31,"31097",10410,7082,7002,75,80,"GBAI",275
31,"31163",2013,1418,1383,13,35,"GBAI",16
31,"31206",2090,1461,1440,22,21,"GBAI",62
31,"31002",414,288,287,3,1,"GBAI",21
31,"31194",311,217,216,3,1,"GBAI",24
31,"31077",5352,3908,3848,41,60,"GBAI",24
31,"31187",111,68,63,1,5,"GBAI",12
31,"31226",591,342,340,2,2,"GBAI",42
31,"31905",2843,1983,1966,15,17,"GBAI",25
31,"31205",427,299,297,4,2,"GBAI",2
31,"31059",186,131,131,1,0,"GBAI",6
31,"31124",208,148,148,2,0,"GBAI",4
31,"31254",1915,1428,1411,3,17,"GBAI",22
31,"31229",47,35,35,0,0,"GBAI",1
31,"31069",832,637,635,3,2,"GBAI",16
31,"31104",1834,1257,1235,16,22,"GBAI",23
31,"31071",17,16,16,0,0,"GBAI",0
31,"31255",102,79,79,1,0,"GBAI",2
31,"31223",985,704,698,4,6,"GBAI",11
31,"31245",81,55,55,2,0,"GBAI",8
31,"31248",299,165,162,0,3,"GBAI",14
31,"31222",62,36,34,3,2,"GBAI",5
31,"31203",40,28,28,0,0,"GBAI",2
31,"31025",766,524,518,6,6,"GBAI",45
31,"31055",257,175,172,2,3,"GBAI",43
31,"31169",2193,1472,1445,9,27,"GBAI",6
31,"31264",180,105,101,2,4,"GBAI",7
31,"31158",255,180,179,3,1,"GBAI",9
31,"31103",42,34,34,2,0,"GBAI",0
31,"31168",246,172,171,1,1,"GBAI",11
31,"31134",176,125,124,0,1,"GBAI",9
31,"31135",106,70,66,2,4,"GBAI",2
31,"31239",322,211,211,5,0,"GBAI",31
31,"31121",62,44,43,0,1,"GBAI",1
31,"31113",133,87,86,0,1,"GBAI",7
31,"31084",1940,1293,1274,16,19,"GBAI",157
31,"31011",693,459,456,8,3,"GBAI",18
31,"31172",373,278,272,3,6,"GBAI",9
31,"31141",110,71,70,1,1,"GBAI",4
31,"31050",6014,3489,3450,57,39,"GBAI",372
31,"31086",13188,9713,9642,111,71,"GBAI",482
31,"31096",113,82,79,0,3,"GBAI",1
31,"31184",62,44,44,3,0,"GBAI",3
31,"31139",159,96,95,0,1,"GBAI",5
31,"31132",145,109,109,0,0,"GBAI",2
31,"31003",122,87,87,0,0,"GBAI",7
31,"31244",158,87,86,1,1,"GBAI",25
31,"31026",144,118,117,0,1,"GBAI",4
31,"31188",235,161,161,2,0,"GBAI",12
31,"31182",34,28,28,0,0,"GBAI",0
31,"31114",366,245,241,8,4,"GBAI",5
31,"31183",691,544,542,4,2,"GBAI",37
31,"31233",97,74,74,0,0,"GBAI",1
31,"31151",66,46,46,1,0,"GBAI",1
31,"31001",88,62,62,0,0,"GBAI",8
31,"31075",103,63,63,0,0,"GBAI",4
31,"31201",147715,105455,104658,1007,797,"GBAI",5045
31,"31024",99,42,42,0,0,"GBAI",9
31,"31057",1781,1287,1268,10,19,"GBAI",5
31,"31207",273,182,177,2,5,"GBAI",8
31,"31078",2429,1795,1767,15,28,"GBAI",6
31,"31125",274,194,193,6,1,"GBAI",8
31,"31048",176,132,130,4,2,"GBAI",0
31,"31204",36,28,28,1,0,"GBAI",1
31,"31225",36,27,27,0,0,"GBAI",1
31,"31130",312,214,213,3,1,"GBAI",19
31,"31156",251,189,188,0,1,"GBAI",12
31,"31061",54,49,49,0,0,"GBAI",2
31,"31190",45,34,32,2,2,"GBAI",2
31,"31146",35,30,29,1,1,"GBAI",0
31,"31102",143,69,69,0,0,"GBAI",12
31,"31040",192,139,138,4,1,"GBAI",5
31,"31013",642,406,401,1,5,"GBAI",18
31,"31179",502,348,345,0,3,"GBAI",4
31,"31907",10745,8067,8009,116,58,"GBAI",477
31,"31157",3518,2298,2267,23,31,"GBAI",27
31,"31242",260,164,163,1,1,"GBAI",8
31,"31224",893,671,662,3,9,"GBAI",11
31,"31080",508,391,385,3,6,"GBAI",18
31,"31257",875,634,625,8,9,"GBAI",20
31,"31073",294,212,208,2,4,"GBAI",15
31,"31262",228,179,178,5,1,"GBAI",12
31,"31053",523,372,368,1,4,"GBAI",8
31,"31005",301,212,211,3,1,"GBAI",4
31,"31036",909,636,628,7,8,"GBAI",24
31,"31007",131,87,86,1,1,"GBAI",2
31,"31191",3016,2167,2147,22,20,"GBAI",76
31,"31143",96,55,54,1,1,"GBAI",5
31,"31033",49,31,31,1,0,"GBAI",1
31,"31154",224,126,126,3,0,"GBAI",15
31,"31232",25155,17648,17450,196,198,"GBAI",164
31,"31180",212,154,154,5,0,"GBAI",5
31,"31004",35,21,21,0,0,"GBAI",3
31,"31174",110,63,63,0,0,"GBAI",2
31,"31123",647,369,361,5,8,"GBAI",44
31,"31098",1903,1428,1419,19,9,"GBAI",81
31,"31065",1878,1351,1326,20,25,"GBAI",5
31,"31142",1403,958,949,10,9,"GBAI",16
31,"31145",172,128,128,4,0,"GBAI",2
31,"31034",37,25,25,0,0,"GBAI",2
31,"31045",508,355,350,8,5,"GBAI",9
31,"31200",761,517,508,3,9,"GBAI",14
31,"31060",13744,9400,9320,72,80,"GBAI",366
31,"31038",1339,957,942,11,15,"GBAI",24
31,"31006",1927,1350,1332,13,18,"GBAI",11
31,"31167",826,606,596,9,10,"GBAI",24
31,"31083",52,37,37,0,0,"GBAI",6
31,"31032",1713,1209,1193,24,16,"GBAI",5
31,"31051",251,170,170,2,0,"GBAI",5
31,"31090",144,77,77,1,0,"GBAI",25
31,"31116",62,51,50,1,1,"GBAI",3
31,"31131",901,646,638,7,8,"GBAI",48
31,"31010",5705,3718,3680,29,38,"GBAI",397
31,"31094",111,82,82,0,0,"GBAI",0
31,"31246",140,111,107,1,4,"GBAI",7
31,"31903",6654,4402,4343,27,59,"GBAI",88
31,"31046",57,39,39,1,0,"GBAI",0
31,"31216",3865,2702,2671,33,31,"GBAI",63
31,"31017",358,242,239,0,3,"GBAI",28
31,"31236",1320,865,854,5,11,"GBAI",78
31,"31129",395,234,234,0,0,"GBAI",37
31,"31185",494,341,341,1,0,"GBAI",35
31,"31265",82,53,53,2,0,"GBAI",7
31,"31016",7608,5474,5413,50,61,"GBAI",228
31,"31198",37,25,25,0,0,"GBAI",1
31,"31054",462,255,250,4,5,"GBAI",17
31,"31110",91,61,58,1,3,"GBAI",0
31,"31176",2869,2010,1963,33,47,"GBAI",5
31,"31247",151,114,113,0,1,"GBAI",14
31,"31058",208,148,144,3,4,"GBAI",22
31,"31081",338,216,212,4,4,"GBAI",38
31,"31088",5572,3897,3862,44,35,"GBAI",122
31,"31152",1328,924,900,11,24,"GBAI",17
31,"31015",1994,1412,1392,25,20,"GBAI",17
31,"31117",620,383,375,3,8,"GBAI",45
31,"31115",165,102,101,1,1,"GBAI",12
31,"31196",38,35,35,1,0,"GBAI",0
31,"31082",617,371,365,10,6,"GBAI",36
31,"31068",2885,2060,2027,20,33,"GBAI",11
31,"31256",107,59,59,0,0,"GBAI",10
31,"31144",796,445,444,6,1,"GBAI",38
31,"31122",4773,3520,3506,26,14,"GBAI",186
31,"31100",262,170,168,1,2,"GBAI",7
31,"31126",358,223,223,2,0,"GBAI",16
31,"31227",8180,5885,5809,76,76,"GBAI",154
31,"31220",744,583,579,8,4,"GBAI",2
31,"31153",2159,1403,1387,12,16,"GBAI",200
31,"31052",96,62,61,0,1,"GBAI",4
31,"31252",87,61,61,0,0,"GBAI",3
31,"31039",80,61,60,0,1,"GBAI",2
31,"31215",4676,3284,3240,36,44,"GBAI",22
31,"31021",62,39,38,0,1,"GBAI",2
31,"31079",73,54,53,0,1,"GBAI",2
31,"31260",1238,794,788,12,6,"GBAI",36
31,"31018",393,292,285,4,7,"GBAI",11
31,"31127",138,98,95,0,3,"GBAI",12
31,"31149",2305,1461,1441,8,20,"GBAI",139
31,"31148",92,69,69,5,0,"GBAI",3
31,"31904",1563,1029,1022,23,7,"GBAI",43
31,"31908",1004,686,682,2,4,"GBAI",93
31,"31062",1087,830,818,3,12,"GBAI",2
31,"31106",698,533,529,3,4,"GBAI",2
31,"31251",3115,2240,2205,15,35,"GBAI",81
31,"31147",100,82,82,2,0,"GBAI",6
31,"31014",275,194,192,4,2,"GBAI",3
31,"31047",254,191,188,2,3,"GBAI",15
31,"31043",38,31,30,1,1,"GBAI",5
31,"31031",220,131,129,0,2,"GBAI",21
31,"31237",193,155,153,2,2,"GBAI",9
31,"31019",1785,1254,1238,9,16,"GBAI",54
31,"31133",43,28,28,0,0,"GBAI",4
31,"31249",1872,1290,1273,14,17,"GBAI",8
31,"31162",47,31,31,0,0,"GBAI",1
31,"31181",145,112,112,0,0,"GBAI",4
31,"31119",39,26,26,0,0,"GBAI",5
31,"31137",205,112,109,6,3,"GBAI",16
31,"31253",129,109,109,0,0,"GBAI",7
31,"31164",568,421,417,5,4,"GBAI",0
31,"31193",1426,1024,1013,13,11,"GBAI",55
31,"31209",155,107,106,0,1,"GBAI",2
31,"31120",388,250,249,3,1,"GBAI",9
31,"31212",147,102,102,4,0,"GBAI",2
31,"31250",2810,1786,1770,19,16,"GBAI",188
31,"31067",1922,1312,1294,10,18,"GBAI",19
31,"31076",2417,1918,1906,9,12,"GBAI",96
31,"31165",2780,1995,1960,30,35,"GBAI",12
31,"31118",164,112,111,1,1,"GBAI",15
31,"31221",1214,798,786,12,12,"GBAI",82
31,"31186",299,195,194,3,1,"GBAI",14
31,"31150",213,156,155,1,1,"GBAI",7
31,"31023",6956,5310,5289,85,21,"GBAI",220
31,"31064",1424,1121,1104,3,17,"GBAI",10
31,"31243",306,224,221,2,3,"GBAI",7
31,"31042",2714,1974,1942,22,32,"GBAI",6
31,"31230",106,82,82,1,0,"GBAI",5
31,"31234",144,106,106,4,0,"GBAI",3
31,"31178",490,345,342,3,3,"GBAI",6
31,"31028",212,131,131,0,0,"GBAI",12
31,"31087",171,128,124,2,4,"GBAI",12
31,"31020",449,228,228,3,0,"GBAI",28
31,"31027",836,532,530,2,2,"GBAI",102
31,"31159",1107,844,833,6,11,"GBAI",47
31,"31009",677,507,505,5,2,"GBAI",14
31,"31189",1161,720,709,6,11,"GBAI",58
31,"31049",699,469,465,2,4,"GBAI",22
31,"31112",89,62,62,0,0,"GBAI",5
31,"31138",932,601,599,2,2,"GBAI",99
26,"26100",49,44,43,0,1,"HRTS-Ln",0
26,"26082",112,87,87,1,0,"HRTS-Ln",0
26,"26157",296,241,237,4,4,"HRTS-Ln",0
26,"26107",94,77,77,2,0,"HRTS-Ln",0
26,"26101",44,36,35,0,1,"HRTS-Ln",0
26,"26009",401,325,321,4,4,"HRTS-Ln",0
26,"26144",188,155,155,3,0,"HRTS-Ln",0
26,"26018",10477,8053,7956,65,97,"HRTS-Ln",2
26,"26143",220,175,173,1,2,"HRTS-Ln",0
26,"26032",51,41,39,0,2,"HRTS-Ln",0
26,"26004",67,50,50,0,0,"HRTS-Ln",0
26,"26121",25,22,22,0,0,"HRTS-Ln",0
26,"26003",413,331,329,2,2,"HRTS-Ln",0
26,"26119",197,156,155,4,1,"HRTS-Ln",0
26,"26050",113,88,85,0,3,"HRTS-Ln",0
26,"26138",4588,3290,3247,15,43,"HRTS-Ln",3
26,"26091",161,146,146,0,0,"HRTS-Ln",0
26,"26017",381,293,293,5,0,"HRTS-Ln",0
26,"26118",59,48,48,2,0,"HRTS-Ln",0
26,"26062",89,72,71,2,1,"HRTS-Ln",0
26,"26146",94,73,72,0,1,"HRTS-Ln",0
26,"26124",807,649,639,7,10,"HRTS-Ln",0
26,"26170",446,330,326,2,4,"HRTS-Ln",0
26,"26175",51,41,41,0,0,"HRTS-Ln",0
26,"26063",124,94,94,2,0,"HRTS-Ln",0
26,"26128",105,81,81,1,0,"HRTS-Ln",0
26,"26072",281,254,254,0,0,"HRTS-Ln",0
26,"26025",87,71,70,1,1,"HRTS-Ln",0
26,"26027",157,112,108,0,4,"HRTS-Ln",0
26,"26148",165,135,133,1,2,"HRTS-Ln",0
26,"26044",52,46,46,0,0,"HRTS-Ln",0
26,"26105",2205,1670,1658,12,12,"HRTS-Ln",0
26,"26048",22,22,22,0,0,"HRTS-Ln",0
26,"26016",28,25,24,1,1,"HRTS-Ln",0
26,"26129",967,775,766,6,9,"HRTS-Ln",0
26,"26096",245,190,190,1,0,"HRTS-Ln",0
26,"26028",134,113,112,0,1,"HRTS-Ln",0
26,"26112",236,194,190,1,4,"HRTS-Ln",0
26,"26073",97,78,78,0,0,"HRTS-Ln",0
26,"26102",6111,4486,4435,28,51,"HRTS-Ln",2
26,"26171",176,139,133,1,6,"HRTS-Ln",0
26,"26132",112,82,82,0,0,"HRTS-Ln",0
26,"26152",33,28,28,1,0,"HRTS-Ln",0
26,"26014",474,327,324,1,3,"HRTS-Ln",0
26,"26015",196,158,157,2,1,"HRTS-Ln",0
26,"26054",320,263,260,4,3,"HRTS-Ln",0
26,"26150",112,101,95,0,6,"HRTS-Ln",0
26,"26164",59,46,45,2,1,"HRTS-Ln",0
26,"26169",64,60,60,0,0,"HRTS-Ln",0
26,"26051",239,193,191,1,2,"HRTS-Ln",0
26,"26023",469,358,354,0,4,"HRTS-Ln",0
26,"26181",14,14,14,0,0,"HRTS-Ln",0
26,"26126",31,27,27,0,0,"HRTS-Ln",0
26,"26167",59,47,46,1,1,"HRTS-Ln",0
26,"26076",129,107,106,0,1,"HRTS-Ln",0
26,"26033",170,132,129,1,3,"HRTS-Ln",0
26,"26061",1565,1160,1141,13,19,"HRTS-Ln",0
26,"26039",39,35,35,2,0,"HRTS-Ln",0
26,"26066",251,201,194,1,7,"HRTS-Ln",0
26,"26104",13,10,10,0,0,"HRTS-Ln",0
26,"26080",472,391,389,0,2,"HRTS-Ln",0
26,"26134",82,68,68,2,0,"HRTS-Ln",0
26,"26161",8,7,7,0,0,"HRTS-Ln",0
26,"26178",75,57,55,1,2,"HRTS-Ln",0
26,"26065",50,43,42,0,1,"HRTS-Ln",0
26,"26172",30,23,23,0,0,"HRTS-Ln",0
26,"26168",5340,3774,3717,22,57,"HRTS-Ln",4
26,"26042",834,635,625,5,10,"HRTS-Ln",0
26,"26120",1454,1139,1126,7,13,"HRTS-Ln",0
26,"26011",7321,5133,5083,38,50,"HRTS-Ln",3
26,"26071",8491,5834,5761,47,73,"HRTS-Ln",0
26,"26021",2827,2098,2076,15,22,"HRTS-Ln",0
26,"26057",48,38,38,0,0,"HRTS-Ln",0
26,"26177",304,255,254,7,1,"HRTS-Ln",0
26,"26111",242,180,176,0,4,"HRTS-Ln",0
26,"26087",201,153,149,3,4,"HRTS-Ln",0
26,"26142",787,612,606,3,6,"HRTS-Ln",3
26,"26074",105,86,85,1,1,"HRTS-Ln",0
26,"26086",16,15,15,1,0,"HRTS-Ln",0
26,"26166",141,124,122,0,2,"HRTS-Ln",0
26,"26055",39,32,32,0,0,"HRTS-Ln",0
26,"26077",22,22,21,1,1,"HRTS-Ln",0
26,"26145",246,197,197,2,0,"HRTS-Ln",0
26,"26043",365,292,281,1,11,"HRTS-Ln",0
26,"26081",16,14,14,0,0,"HRTS-Ln",0
26,"26094",83,70,70,0,0,"HRTS-Ln",0
26,"26045",12,12,12,0,0,"HRTS-Ln",0
26,"26046",1581,1175,1159,4,16,"HRTS-Ln",0
26,"26040",70,60,60,0,0,"HRTS-Ln",0
26,"26127",212,181,176,0,5,"HRTS-Ln",0
26,"26180",221,173,172,0,1,"HRTS-Ln",0
26,"26049",172,125,122,1,3,"HRTS-Ln",0
26,"26041",132,92,91,0,1,"HRTS-Ln",0
26,"26139",54,45,44,0,1,"HRTS-Ln",0
26,"26060",84,62,62,2,0,"HRTS-Ln",0
26,"26089",110582,82972,82186,588,786,"HRTS-Ln",42
26,"26155",160,132,132,0,0,"HRTS-Ln",0
26,"26079",634,520,512,4,8,"HRTS-Ln",0
26,"26058",154,116,115,0,1,"HRTS-Ln",0
26,"26013",347,249,246,2,3,"HRTS-Ln",0
26,"26154",13,10,10,0,0,"HRTS-Ln",0
26,"26115",19,16,16,0,0,"HRTS-Ln",0
26,"26012",23,23,23,1,0,"HRTS-Ln",0
26,"26183",64,49,49,0,0,"HRTS-Ln",0
26,"26095",100,83,82,0,1,"HRTS-Ln",0
26,"26052",154,121,117,0,4,"HRTS-Ln",0
26,"26088",37,32,31,0,1,"HRTS-Ln",0
26,"26173",6,6,6,1,0,"HRTS-Ln",0
26,"26136",107,85,85,0,0,"HRTS-Ln",0
26,"26114",79,66,65,1,1,"HRTS-Ln",0
26,"26113",35,35,34,0,1,"HRTS-Ln",0
26,"26106",86,72,72,0,0,"HRTS-Ln",0
26,"26026",1321,1039,1025,6,14,"HRTS-Ln",1
26,"26020",476,349,339,3,10,"HRTS-Ln",0
26,"26068",80,61,61,1,0,"HRTS-Ln",1
26,"26007",511,384,375,0,9,"HRTS-Ln",2
26,"26005",2381,1598,1577,23,21,"HRTS-Ln",0
26,"26140",253,208,206,0,2,"HRTS-Ln",0
26,"26001",195,161,157,2,4,"HRTS-Ln",0
26,"26158",251,214,210,0,4,"HRTS-Ln",0
26,"26122",118,102,102,0,0,"HRTS-Ln",0
26,"26163",136,118,118,0,0,"HRTS-Ln",0
26,"26162",121,99,99,1,0,"HRTS-Ln",0
26,"26047",1947,1578,1563,8,15,"HRTS-Ln",0
26,"26108",266,215,213,0,2,"HRTS-Ln",0
26,"26176",53,44,44,1,0,"HRTS-Ln",0
26,"26179",41,32,31,0,1,"HRTS-Ln",0
26,"26109",81,69,69,0,0,"HRTS-Ln",0
26,"26130",203,167,167,1,0,"HRTS-Ln",0
26,"26135",164,125,124,1,1,"HRTS-Ln",0
26,"26078",82,70,70,0,0,"HRTS-Ln",0
26,"26151",448,370,368,1,2,"HRTS-Ln",0
26,"26030",16,16,15,0,1,"HRTS-Ln",0
26,"26010",93,80,80,2,0,"HRTS-Ln",0
26,"26149",57,47,46,0,1,"HRTS-Ln",0
26,"26029",37,32,32,0,0,"HRTS-Ln",0
26,"26125",2699,1931,1907,23,24,"HRTS-Ln",0
26,"26160",709,552,549,2,3,"HRTS-Ln",0
26,"26034",654,497,489,1,8,"HRTS-Ln",0
26,"26070",183,153,153,1,0,"HRTS-Ln",1
26,"26123",126,108,107,2,1,"HRTS-Ln",0
26,"26131",35,33,33,1,0,"HRTS-Ln",0
26,"26064",2275,1659,1638,17,21,"HRTS-Ln",1
26,"26165",358,304,299,2,5,"HRTS-Ln",0
26,"26053",208,168,163,4,5,"HRTS-Ln",0
26,"26036",16986,11940,11816,66,124,"HRTS-Ln",9
26,"26024",228,181,181,0,0,"HRTS-Ln",0
26,"26147",30,28,27,0,1,"HRTS-Ln",0
26,"26059",1125,828,812,5,16,"HRTS-Ln",0
26,"26035",17,12,11,0,1,"HRTS-Ln",0
26,"26038",89,68,67,0,1,"HRTS-Ln",0
26,"26093",53,39,38,0,1,"HRTS-Ln",0
26,"26174",146,107,105,2,2,"HRTS-Ln",0
26,"26083",284,205,205,2,0,"HRTS-Ln",0
26,"26098",88,73,73,1,0,"HRTS-Ln",0
26,"26103",796,616,610,6,6,"HRTS-Ln",0
26,"26031",106,83,83,0,0,"HRTS-Ln",0
26,"26008",1860,1399,1387,5,12,"HRTS-Ln",1
26,"26153",13,12,11,0,1,"HRTS-Ln",0
26,"26019",355,274,271,1,3,"HRTS-Ln",0
26,"26092",107,92,90,0,2,"HRTS-Ln",0
26,"26069",236,194,189,0,5,"HRTS-Ln",0
26,"26141",113,87,82,0,5,"HRTS-Ln",0
26,"26002",830,632,622,0,10,"HRTS-Ln",1
26,"26075",329,267,264,2,3,"HRTS-Ln",0
26,"26084",6696,5012,4955,35,57,"HRTS-Ln",2
26,"26067",22,15,15,1,0,"HRTS-Ln",0
26,"26022",198,164,163,1,1,"HRTS-Ln",0
26,"26006",1800,1419,1405,8,14,"HRTS-Ln",1
26,"26117",2152,1625,1605,10,20,"HRTS-Ln",0
26,"26110",152,131,129,0,2,"HRTS-Ln",0
26,"26056",419,338,332,1,6,"HRTS-Ln",0
26,"26099",1264,1003,991,9,12,"HRTS-Ln",0
26,"26037",128,108,108,2,0,"HRTS-Ln",0
9,"9117",76,60,60,0,0,"IMC",0
9,"9115",92,68,67,0,1,"IMC",0
9,"9094",53,42,42,1,0,"IMC",0
9,"9225",83,55,54,0,1,"IMC",0
9,"9288",90,70,70,0,0,"IMC",0
9,"9276",382,251,240,3,11,"IMC",0
9,"9064",324,271,267,1,4,"IMC",0
9,"9016",85,60,59,3,1,"IMC",0
9,"9419",78,55,55,0,0,"IMC",0
9,"9445",44,32,32,3,0,"IMC",0
9,"9446",12,7,7,0,0,"IMC",0
9,"9281",145,114,109,1,5,"IMC",0
9,"9354",33,29,28,2,1,"IMC",0
9,"9248",78,59,59,1,0,"IMC",0
9,"9387",117,95,90,0,5,"IMC",0
9,"9088",66,45,45,0,0,"IMC",0
9,"9168",290,217,217,3,0,"IMC",0
9,"9268",95,68,66,0,2,"IMC",0
9,"9352",114,92,92,1,0,"IMC",0
9,"9442",375,279,277,2,2,"IMC",1
9,"9377",632,485,480,1,5,"IMC",0
9,"9050",68,56,55,1,1,"IMC",0
9,"9082",39,36,36,0,0,"IMC",0
9,"9109",1056,619,595,8,24,"IMC",1
9,"9228",160,137,136,1,1,"IMC",0
9,"9467",64,43,42,1,1,"IMC",0
9,"9382",33,28,28,0,0,"IMC",0
9,"9163",582,467,459,2,8,"IMC",0
9,"9038",119,100,100,0,0,"IMC",0
9,"9105",109,86,81,1,5,"IMC",0
9,"9232",154,119,116,0,3,"IMC",0
9,"9901",371,263,259,4,4,"IMC",0
9,"9023",1102,818,811,11,7,"IMC",3
9,"9140",124,80,79,0,1,"IMC",0
9,"9137",174,132,131,3,1,"IMC",0
9,"9122",94,67,66,1,1,"IMC",0
9,"9169",95,78,78,0,0,"IMC",1
9,"9315",378,245,243,1,2,"IMC",0
9,"9253",109,94,91,1,3,"IMC",0
9,"9251",375,277,274,4,3,"IMC",0
9,"9090",54,48,48,0,0,"IMC",0
9,"9180",142,107,102,1,5,"IMC",0
9,"9903",3221,2304,2281,27,23,"IMC",96
9,"9303",86,68,68,0,0,"IMC",0
9,"9213",307,220,218,2,2,"IMC",0
9,"9191",38,28,27,0,1,"IMC",0
9,"9024",156,112,110,1,2,"IMC",1
9,"9067",437,295,294,6,1,"IMC",0
9,"9217",351,251,249,6,2,"IMC",2
9,"9059",136488,101469,100463,907,1006,"IMC",98
9,"9258",172,141,139,5,2,"IMC",0
9,"9476",62,43,43,0,0,"IMC",0
9,"9464",35,27,27,0,0,"IMC",0
9,"9221",461,343,338,3,5,"IMC",1
9,"9208",210,136,134,3,2,"IMC",0
9,"9314",94,73,70,0,3,"IMC",1
9,"9135",41,31,31,1,0,"IMC",1
9,"9154",137,98,97,2,1,"IMC",0
9,"9353",76,57,56,1,1,"IMC",0
9,"9244",46,34,34,1,0,"IMC",1
9,"9348",148,111,110,2,1,"IMC",0
9,"9372",212,176,176,4,0,"IMC",0
9,"9433",60,48,45,1,3,"IMC",0
9,"9346",92,64,63,1,1,"IMC",0
9,"9020",259,196,188,5,8,"IMC",0
9,"9267",111,99,97,1,2,"IMC",0
9,"9084",186,136,135,4,1,"IMC",0
9,"9908",449,307,306,3,1,"IMC",5
9,"9400",317,247,245,1,2,"IMC",0
9,"9051",170,130,128,0,2,"IMC",0
9,"9070",34,26,26,0,0,"IMC",0
9,"9047",54,47,46,1,1,"IMC",0
9,"9432",182,145,138,0,7,"IMC",0
9,"9408",41,36,36,0,0,"IMC",0
9,"9229",198,146,143,0,3,"IMC",0
9,"9280",28,20,20,0,0,"IMC",0
9,"9307",109,81,80,0,1,"IMC",0
9,"9434",1227,922,909,6,13,"IMC",2
9,"9128",80,63,63,0,0,"IMC",0
9,"9033",90,74,74,1,0,"IMC",0
9,"9473",85,70,65,1,5,"IMC",0
9,"9272",282,210,206,3,4,"IMC",0
9,"9243",76,59,57,1,2,"IMC",0
9,"9055",52,42,41,1,1,"IMC",0
9,"9025",122,83,83,1,0,"IMC",0
9,"9439",1028,752,744,9,8,"IMC",0
9,"9302",112,83,83,1,0,"IMC",0
9,"9391",361,264,263,3,1,"IMC",1
9,"9098",507,369,362,5,7,"IMC",1
9,"9262",163,130,127,1,3,"IMC",0
9,"9438",538,437,433,6,4,"IMC",0
9,"9310",13,9,8,0,1,"IMC",0
9,"9416",53,35,35,0,0,"IMC",0
9,"9255",89,63,62,0,1,"IMC",0
9,"9123",40,35,35,0,0,"IMC",0
9,"9356",42,33,32,0,1,"IMC",0
9,"9184",5,4,4,0,0,"IMC",0
9,"9266",91,74,74,0,0,"IMC",0
9,"9194",2020,1472,1459,9,13,"IMC",3
9,"9366",86,62,62,2,0,"IMC",0
9,"9450",28,22,21,0,1,"IMC",0
9,"9037",111,91,91,0,0,"IMC",0
9,"9108",384,283,279,1,4,"IMC",2
9,"9337",117,92,91,0,1,"IMC",0
9,"9392",53,40,37,1,3,"IMC",0
9,"9328",76,56,56,0,0,"IMC",0
9,"9036",37,31,30,1,1,"IMC",0
9,"9201",28,18,18,1,0,"IMC",0
9,"9174",794,559,552,4,7,"IMC",0
9,"9261",469,332,329,2,3,"IMC",0
9,"9412",790,528,523,4,5,"IMC",0
9,"9086",666,462,459,2,3,"IMC",1
9,"9196",149,103,103,1,0,"IMC",0
9,"9003",194,147,146,0,1,"IMC",0
9,"9463",264,195,195,7,0,"IMC",0
9,"9124",1506,1040,1028,6,12,"IMC",6
9,"9134",221,161,156,7,5,"IMC",1
9,"9422",17,11,11,0,0,"IMC",0
9,"9149",35,24,24,2,0,"IMC",0
9,"9224",162,131,131,1,0,"IMC",0
9,"9043",192,137,133,1,4,"IMC",0
9,"9340",77,49,49,0,0,"IMC",0
9,"9071",41,35,35,1,0,"IMC",0
9,"9311",59,46,45,0,1,"IMC",0
9,"9182",80,69,67,1,2,"IMC",0
9,"9056",4919,3395,3344,20,51,"IMC",3
9,"9283",44,32,31,0,1,"IMC",0
9,"9347",143,117,115,2,2,"IMC",1
9,"9007",57,39,39,0,0,"IMC",0
9,"9289",1451,1014,1000,5,14,"IMC",0
9,"9454",43,34,33,0,1,"IMC",0
9,"9068",29,24,24,0,0,"IMC",0
9,"9361",115,90,89,0,1,"IMC",0
9,"9029",168,131,129,4,2,"IMC",0
9,"9343",93,66,65,0,1,"IMC",0
9,"9206",59,45,45,0,0,"IMC",0
9,"9223",45,37,37,0,0,"IMC",0
9,"9466",129,97,97,1,0,"IMC",0
9,"9334",50,39,37,0,2,"IMC",0
9,"9355",98,75,75,0,0,"IMC",0
9,"9052",29,23,23,0,0,"IMC",0
9,"9413",436,306,302,2,4,"IMC",5
9,"9074",794,575,569,6,6,"IMC",0
9,"9018",24668,17575,17369,111,206,"IMC",10
9,"9374",90,71,70,1,1,"IMC",0
9,"9077",34,27,27,0,0,"IMC",0
9,"9423",27,24,24,0,0,"IMC",0
9,"9312",96,78,77,0,1,"IMC",0
9,"9250",269,196,194,1,2,"IMC",0
9,"9211",1441,1056,1039,9,17,"IMC",0
9,"9176",63,47,46,2,1,"IMC",0
9,"9177",1121,757,749,9,8,"IMC",1
9,"9113",449,339,332,4,7,"IMC",0
9,"9183",51,41,41,0,0,"IMC",0
9,"9130",74,51,50,1,1,"IMC",0
9,"9075",112,91,91,3,0,"IMC",0
9,"9144",53,40,40,0,0,"IMC",0
9,"9482",33,28,28,0,0,"IMC",0
9,"9066",62,48,47,0,1,"IMC",0
9,"9306",106,82,82,1,0,"IMC",0
9,"9437",282,219,218,3,1,"IMC",0
9,"9012",89,64,63,0,1,"IMC",0
9,"9102",36,30,30,0,0,"IMC",0
9,"9905",384,279,279,2,0,"IMC",1
9,"9472",55,45,44,0,1,"IMC",0
9,"9190",86,58,56,0,2,"IMC",0
9,"9409",111,86,86,4,0,"IMC",1
9,"9396",156,121,121,0,0,"IMC",0
9,"9277",120,101,99,0,2,"IMC",0
9,"9112",109,85,85,0,0,"IMC",0
9,"9151",448,362,360,6,2,"IMC",0
9,"9421",230,166,163,3,3,"IMC",0
9,"9200",50,32,31,0,1,"IMC",0
9,"9085",475,347,342,2,5,"IMC",1
9,"9155",27,20,20,0,0,"IMC",0
9,"9485",55,43,42,0,1,"IMC",0
9,"9079",49,45,45,0,0,"IMC",0
9,"9287",208,158,156,3,2,"IMC",0
9,"9219",27509,19084,18859,146,225,"IMC",26
9,"9011",65,48,48,0,0,"IMC",0
9,"9449",86,68,66,0,2,"IMC",0
9,"9375",36,31,31,0,0,"IMC",0
9,"9239",52,40,39,0,1,"IMC",0
9,"9014",195,115,114,1,1,"IMC",1
9,"9332",140,106,106,2,0,"IMC",0
9,"9350",469,350,343,2,7,"IMC",0
9,"9358",255,194,190,3,4,"IMC",0
9,"9078",41,30,30,1,0,"IMC",0
9,"9227",119,91,89,4,2,"IMC",1
9,"9214",672,427,427,4,0,"IMC",2
9,"9129",104,83,83,0,0,"IMC",0
9,"9431",118,98,98,0,0,"IMC",0
9,"9192",55,43,43,0,0,"IMC",2
9,"9415",268,175,175,2,0,"IMC",0
9,"9321",1626,1238,1227,8,11,"IMC",0
9,"9148",87,70,68,3,2,"IMC",0
9,"9238",921,573,561,4,12,"IMC",3
9,"9172",129,103,101,1,2,"IMC",1
9,"9428",108,92,91,0,1,"IMC",0
9,"9386",54,39,38,1,1,"IMC",0
9,"9167",58,41,41,1,0,"IMC",0
9,"9143",27,19,18,0,1,"IMC",0
9,"9395",138,104,104,0,0,"IMC",0
9,"9125",584,432,430,1,2,"IMC",0
9,"9256",354,258,258,2,0,"IMC",1
9,"9458",469,343,336,5,7,"IMC",0
9,"9384",295,211,206,0,5,"IMC",0
9,"9360",30,23,23,0,0,"IMC",0
9,"9202",25,22,22,1,0,"IMC",0
9,"9138",85,72,70,0,2,"IMC",0
9,"9057",145,108,108,0,0,"IMC",0
9,"9471",149,114,114,1,0,"IMC",0
9,"9131",462,365,364,2,1,"IMC",0
9,"9076",23,17,17,1,0,"IMC",0
9,"9317",19,16,16,0,0,"IMC",0
9,"9429",56,41,41,0,0,"IMC",0
9,"9904",478,374,370,5,4,"IMC",0
9,"9456",130,97,96,0,1,"IMC",0
9,"9414",189,148,146,0,2,"IMC",0
9,"9418",82,62,61,1,1,"IMC",0
9,"9133",40,32,32,0,0,"IMC",0
9,"9295",61,44,44,0,0,"IMC",0
9,"9236",38,32,32,0,0,"IMC",0
9,"9119",46,28,28,0,0,"IMC",0
9,"9132",171,122,122,2,0,"IMC",0
9,"9022",66,57,57,1,0,"IMC",1
9,"9215",368,256,256,2,0,"IMC",1
9,"9242",80,66,66,2,0,"IMC",0
9,"9338",227,170,169,0,1,"IMC",0
9,"9063",209,168,167,2,1,"IMC",1
9,"9198",104,83,82,1,1,"IMC",0
9,"9136",192,142,137,2,5,"IMC",0
9,"9388",34,27,26,0,1,"IMC",0
9,"9159",60,52,51,2,1,"IMC",0
9,"9403",94,78,78,1,0,"IMC",0
9,"9407",28,23,23,0,0,"IMC",0
9,"9175",127,94,93,2,1,"IMC",0
9,"9309",301,224,220,0,4,"IMC",0
9,"9480",110,90,90,1,0,"IMC",0
9,"9460",176,131,131,1,0,"IMC",0
9,"9424",36,29,29,1,0,"IMC",0
9,"9365",29,19,19,0,0,"IMC",0
9,"9265",37,28,28,0,0,"IMC",0
9,"9241",202,156,154,4,2,"IMC",2
9,"9304",199,157,155,3,2,"IMC",0
9,"9045",268,181,181,4,0,"IMC",0
9,"9270",163,115,115,0,0,"IMC",0
9,"9380",78,58,58,0,0,"IMC",0
9,"9199",92,72,71,1,1,"IMC",0
9,"9216",387,270,265,1,5,"IMC",4
9,"9417",40,32,32,1,0,"IMC",0
9,"9373",425,287,285,2,2,"IMC",0
9,"9091",724,500,490,4,10,"IMC",1
9,"9368",22,17,17,2,0,"IMC",0
9,"9021",56,33,31,1,2,"IMC",0
9,"9110",80,63,63,0,0,"IMC",0
9,"9455",45,33,33,0,0,"IMC",0
9,"9170",205,162,162,1,0,"IMC",0
9,"9083",37,33,33,0,0,"IMC",0
9,"9274",1079,848,835,12,13,"IMC",0
9,"9339",128,110,110,0,0,"IMC",0
9,"9178",47,35,35,0,0,"IMC",0
9,"9197",144,111,109,1,2,"IMC",0
9,"9152",257,183,183,0,0,"IMC",0
9,"9394",715,533,521,3,12,"IMC",9
9,"9039",58,46,46,2,0,"IMC",0
9,"9257",93,81,80,4,1,"IMC",0
9,"9443",179,128,124,0,4,"IMC",0
9,"9060",145,114,113,2,1,"IMC",0
9,"9104",53,42,42,0,0,"IMC",0
9,"9044",46,35,34,1,1,"IMC",0
9,"9363",965,737,734,2,3,"IMC",0
9,"9058",390,283,279,1,4,"IMC",1
9,"9327",26,24,24,0,0,"IMC",0
9,"9301",625,473,467,2,6,"IMC",0
9,"9141",616,485,483,5,2,"IMC",1
9,"9329",121,87,87,1,0,"IMC",1
9,"9390",611,484,482,3,2,"IMC",1
9,"9335",88,68,68,0,0,"IMC",0
9,"9001",27,22,22,0,0,"IMC",0
9,"9294",108,86,82,0,4,"IMC",0
9,"9378",31,24,23,0,1,"IMC",0
9,"9041",28,27,27,0,0,"IMC",0
9,"9405",130,98,96,0,2,"IMC",0
9,"9297",323,251,250,6,1,"IMC",0
9,"9235",156,132,131,3,1,"IMC",0
9,"9032",109,75,73,0,2,"IMC",0
9,"9030",112,75,73,1,2,"IMC",0
9,"9269",36,26,26,1,0,"IMC",0
9,"9906",1219,902,898,8,4,"IMC",1
9,"9330",1507,1108,1092,10,16,"IMC",2
9,"9173",124,100,99,2,1,"IMC",0
9,"9406",251,192,191,2,1,"IMC",0
9,"9220",75,56,54,1,2,"IMC",0
9,"9902",458,331,327,3,4,"IMC",0
9,"9009",163,133,131,2,2,"IMC",0
9,"9093",154,121,119,0,2,"IMC",0
9,"9246",620,451,444,2,7,"IMC",1
9,"9389",73,60,60,1,0,"IMC",0
9,"9259",230,186,186,5,0,"IMC",0
9,"9166",97,81,81,0,0,"IMC",0
9,"9441",74,65,65,0,0,"IMC",0
9,"9226",63,54,54,0,0,"IMC",0
9,"9061",162,124,123,0,1,"IMC",0
9,"9425",517,384,378,0,6,"IMC",0
9,"9427",1419,978,959,8,19,"IMC",2
9,"9065",143,122,122,1,0,"IMC",0
9,"9273",52,40,39,2,1,"IMC",0
9,"9010",32,23,23,1,0,"IMC",0
9,"9411",151,102,101,0,1,"IMC",0
9,"9369",436,319,316,1,3,"IMC",0
9,"9048",1467,1048,1033,13,15,"IMC",1
9,"9316",105,80,80,1,0,"IMC",0
9,"9478",41,32,32,1,0,"IMC",0
9,"9218",369,275,275,1,0,"IMC",0
9,"9444",72,58,58,3,0,"IMC",0
9,"9127",56,41,39,0,2,"IMC",0
9,"9351",62,49,48,1,1,"IMC",0
9,"9072",316,242,241,0,1,"IMC",0
9,"9027",46,42,41,0,1,"IMC",0
9,"9323",61,46,46,1,0,"IMC",0
9,"9195",59,36,36,2,0,"IMC",0
9,"9034",276,228,227,2,1,"IMC",0
9,"9430",22,18,17,0,1,"IMC",0
9,"9308",67,42,42,1,0,"IMC",0
9,"9189",125,90,87,2,3,"IMC",2
9,"9298",82,70,69,1,1,"IMC",0
9,"9907",1420,1058,1041,12,17,"IMC",3
9,"9483",211,158,157,0,1,"IMC",0
9,"9160",85,64,64,0,0,"IMC",0
9,"9017",89,68,67,4,1,"IMC",0
9,"9345",123,93,91,2,2,"IMC",0
9,"9100",59,45,44,0,1,"IMC",0
9,"9279",174,131,130,3,1,"IMC",0
9,"9013",48,37,37,0,0,"IMC",0
9,"9054",101,68,66,1,2,"IMC",1
9,"9325",190,130,129,2,1,"IMC",0
9,"9026",386,301,300,0,1,"IMC",0
9,"9179",41,32,32,1,0,"IMC",0
9,"9440",91,78,78,2,0,"IMC",0
9,"9247",24,21,21,1,0,"IMC",0
9,"9249",46,33,33,0,0,"IMC",0
9,"9095",84,61,61,0,0,"IMC",0
9,"9181",300,221,221,0,0,"IMC",0
9,"9410",3040,2117,2095,16,22,"IMC",6
9,"9326",140,112,111,0,1,"IMC",0
9,"9006",59,39,39,0,0,"IMC",1
9,"9114",86,66,66,0,0,"IMC",0
9,"9073",926,691,686,4,5,"IMC",0
9,"9292",87,75,73,1,2,"IMC",2
9,"9120",38,32,32,1,0,"IMC",0
9,"9447",44,41,41,0,0,"IMC",0
9,"9162",141,101,101,0,0,"IMC",0
9,"9139",103,87,85,3,2,"IMC",0
9,"9362",208,172,171,2,1,"IMC",0
9,"9103",217,184,183,1,1,"IMC",0
9,"9164",157,127,126,0,1,"IMC",0
9,"9101",76,56,55,1,1,"IMC",0
9,"9231",69,38,38,1,0,"IMC",0
9,"9019",150,92,90,0,2,"IMC",0
9,"9230",38,32,32,0,0,"IMC",0
9,"9398",75,56,56,0,0,"IMC",0
9,"9318",61,41,41,0,0,"IMC",0
9,"9451",238,191,190,0,1,"IMC",0
9,"9381",30,24,24,1,0,"IMC",0
9,"9209",4473,3223,3192,20,31,"IMC",16
9,"9448",212,169,165,0,4,"IMC",0
9,"9062",51,40,39,0,1,"IMC",0
9,"9046",29,25,25,0,0,"IMC",0
9,"9275",192,129,129,2,0,"IMC",1
9,"9035",311,227,225,2,2,"IMC",0
50,"50032",261,189,189,5,0,"INDEPENDIEN",0
44,"44216",26555,18997,18737,168,260,"INDEPENDIEN",11
50,"50077",221,168,167,1,1,"INDEPENDIEN",0
50,"50296",396,286,275,4,11,"INDEPENDIEN",0
50,"50290",386,283,282,1,1,"INDEPENDIEN",0
50,"50163",3689,2702,2680,37,22,"INDEPENDIEN",0
44,"44108",320,222,222,1,0,"INDEPENDIEN",0
50,"50071",132,92,92,0,0,"INDEPENDIEN",0
44,"44210",746,554,545,3,9,"INDEPENDIEN",0
50,"50045",1243,926,925,6,1,"INDEPENDIEN",4
44,"44151",190,151,148,0,3,"INDEPENDIEN",0
50,"50094",1617,1173,1159,12,14,"INDEPENDIEN",1
44,"44181",76,57,56,0,1,"INDEPENDIEN",0
50,"50168",28,27,27,0,0,"INDEPENDIEN",0
44,"44250",19,12,12,0,0,"INDEPENDIEN",0
50,"50207",106,93,93,1,0,"INDEPENDIEN",0
44,"44051",2683,1977,1946,17,31,"INDEPENDIEN",1
44,"44088",29,21,21,0,0,"INDEPENDIEN",0
50,"50141",109,90,90,1,0,"INDEPENDIEN",0
50,"50236",102,79,77,0,2,"INDEPENDIEN",0
50,"50110",367,256,254,0,2,"INDEPENDIEN",0
44,"44017",285,227,223,4,4,"INDEPENDIEN",0
44,"44149",103,78,78,3,0,"INDEPENDIEN",0
50,"50267",602,433,430,8,3,"INDEPENDIEN",1
50,"50046",178,133,133,5,0,"INDEPENDIEN",0
50,"50258",54,34,34,0,0,"INDEPENDIEN",1
44,"44180",70,61,61,0,0,"INDEPENDIEN",0
44,"44243",24,20,20,0,0,"INDEPENDIEN",0
44,"44075",323,248,246,0,2,"INDEPENDIEN",0
50,"50068",1982,1348,1335,8,13,"INDEPENDIEN",2
50,"50216",235,186,184,5,2,"INDEPENDIEN",0
50,"50270",38,26,26,0,0,"INDEPENDIEN",0
50,"50135",91,70,70,3,0,"INDEPENDIEN",0
50,"50180",119,99,99,2,0,"INDEPENDIEN",0
50,"50298",5333,3949,3902,39,47,"INDEPENDIEN",4
50,"50160",2238,1546,1528,12,18,"INDEPENDIEN",1
50,"50190",695,523,515,3,8,"INDEPENDIEN",0
50,"50249",302,226,220,0,6,"INDEPENDIEN",0
44,"44148",90,75,73,2,2,"INDEPENDIEN",0
50,"50138",46,37,37,2,0,"INDEPENDIEN",0
50,"50042",15,15,15,1,0,"INDEPENDIEN",0
50,"50283",70,57,57,1,0,"INDEPENDIEN",0
50,"50245",88,65,64,0,1,"INDEPENDIEN",0
50,"50269",285,193,188,0,5,"INDEPENDIEN",0
50,"50022",530,397,390,7,7,"INDEPENDIEN",1
50,"50063",61,51,51,0,0,"INDEPENDIEN",0
44,"44071",591,398,398,5,0,"INDEPENDIEN",0
50,"50130",383,240,238,2,2,"INDEPENDIEN",0
44,"44147",412,298,293,5,5,"INDEPENDIEN",2
50,"50036",104,91,90,0,1,"INDEPENDIEN",0
50,"50099",3083,2148,2132,13,16,"INDEPENDIEN",1
44,"44020",24,20,19,1,1,"INDEPENDIEN",0
44,"44238",2323,1603,1590,5,13,"INDEPENDIEN",3
44,"44217",29,25,25,3,0,"INDEPENDIEN",0
50,"50070",60,36,36,0,0,"INDEPENDIEN",0
44,"44218",35,28,28,1,0,"INDEPENDIEN",0
44,"44122",1333,925,913,8,12,"INDEPENDIEN",0
50,"50259",88,67,66,0,1,"INDEPENDIEN",0
50,"50170",371,283,280,0,3,"INDEPENDIEN",0
50,"50297",498961,362043,359558,2748,2485,"INDEPENDIEN",393
44,"44068",659,509,503,3,6,"INDEPENDIEN",0
50,"50069",73,53,53,1,0,"INDEPENDIEN",0
50,"50044",230,145,145,1,0,"INDEPENDIEN",0
44,"44258",67,47,47,0,0,"INDEPENDIEN",0
50,"50082",82,65,64,0,1,"INDEPENDIEN",0
44,"44231",38,33,33,0,0,"INDEPENDIEN",0
50,"50282",69,54,54,0,0,"INDEPENDIEN",0
50,"50219",4119,2833,2804,19,29,"INDEPENDIEN",6
50,"50227",109,79,79,0,0,"INDEPENDIEN",0
50,"50182",3399,2364,2335,21,29,"INDEPENDIEN",4
44,"44252",86,65,65,0,0,"INDEPENDIEN",0
50,"50166",255,208,206,2,2,"INDEPENDIEN",0
50,"50221",35,17,17,0,0,"INDEPENDIEN",0
44,"44037",453,317,315,0,2,"INDEPENDIEN",0
44,"44219",194,145,143,1,2,"INDEPENDIEN",0
44,"44229",152,112,111,3,1,"INDEPENDIEN",1
44,"44144",346,248,245,2,3,"INDEPENDIEN",0
44,"44222",131,98,98,0,0,"INDEPENDIEN",0
50,"50109",103,78,78,3,0,"INDEPENDIEN",0
50,"50048",34,29,29,0,0,"INDEPENDIEN",0
50,"50253",423,330,328,4,2,"INDEPENDIEN",0
44,"44178",58,37,37,0,0,"INDEPENDIEN",0
50,"50272",12904,8880,8819,84,61,"INDEPENDIEN",10
50,"50143",566,394,391,6,3,"INDEPENDIEN",0
44,"44136",49,43,43,1,0,"INDEPENDIEN",0
44,"44074",429,333,326,4,7,"INDEPENDIEN",0
50,"50188",28,25,25,0,0,"INDEPENDIEN",0
50,"50087",26,17,17,1,0,"INDEPENDIEN",0
50,"50263",193,121,121,0,0,"INDEPENDIEN",1
44,"44048",61,52,52,0,0,"INDEPENDIEN",0
50,"50006",925,674,657,6,17,"INDEPENDIEN",0
44,"44226",140,98,98,2,0,"INDEPENDIEN",0
44,"44013",11244,7815,7712,82,103,"INDEPENDIEN",2
44,"44123",105,71,70,1,1,"INDEPENDIEN",0
50,"50058",66,39,39,0,0,"INDEPENDIEN",0
44,"44141",135,97,96,1,1,"INDEPENDIEN",0
50,"50256",83,53,53,0,0,"INDEPENDIEN",0
44,"44046",49,34,34,1,0,"INDEPENDIEN",0
50,"50065",53,43,43,0,0,"INDEPENDIEN",0
44,"44143",380,307,306,2,1,"INDEPENDIEN",0
50,"50176",236,165,165,3,0,"INDEPENDIEN",0
44,"44262",135,108,107,2,1,"INDEPENDIEN",0
50,"50003",128,92,91,1,1,"INDEPENDIEN",0
50,"50037",136,98,96,0,2,"INDEPENDIEN",0
50,"50096",39,27,27,0,0,"INDEPENDIEN",0
50,"50265",79,61,61,0,0,"INDEPENDIEN",1
44,"44047",220,137,132,2,5,"INDEPENDIEN",0
44,"44054",108,85,85,2,0,"INDEPENDIEN",0
44,"44212",39,37,37,1,0,"INDEPENDIEN",0
44,"44213",62,50,50,0,0,"INDEPENDIEN",0
50,"50200",511,410,403,2,7,"INDEPENDIEN",0
44,"44005",50,30,30,0,0,"INDEPENDIEN",0
44,"44023",17,16,16,0,0,"INDEPENDIEN",0
50,"50238",91,66,66,1,0,"INDEPENDIEN",0
44,"44167",38,31,31,0,0,"INDEPENDIEN",1
44,"44263",376,266,263,3,3,"INDEPENDIEN",1
44,"44158",1180,876,862,10,14,"INDEPENDIEN",2
50,"50101",864,603,597,8,6,"INDEPENDIEN",0
50,"50242",93,75,75,3,0,"INDEPENDIEN",0
50,"50239",62,50,48,0,2,"INDEPENDIEN",0
44,"44090",78,53,53,0,0,"INDEPENDIEN",0
44,"44018",19,19,19,0,0,"INDEPENDIEN",0
44,"44165",175,135,133,2,2,"INDEPENDIEN",0
50,"50287",270,191,191,0,0,"INDEPENDIEN",0
44,"44125",61,44,44,0,0,"INDEPENDIEN",0
50,"50012",100,80,79,2,1,"INDEPENDIEN",0
44,"44092",81,59,57,0,2,"INDEPENDIEN",0
50,"50195",54,40,40,0,0,"INDEPENDIEN",0
50,"50039",491,392,390,2,2,"INDEPENDIEN",0
44,"44159",38,31,31,1,0,"INDEPENDIEN",0
50,"50051",816,616,614,2,2,"INDEPENDIEN",0
44,"44156",45,31,31,1,0,"INDEPENDIEN",0
50,"50294",70,63,63,0,0,"INDEPENDIEN",0
44,"44116",83,60,60,1,0,"INDEPENDIEN",0
50,"50152",1430,1008,994,14,14,"INDEPENDIEN",0
50,"50243",331,250,246,0,4,"INDEPENDIEN",0
44,"44265",186,141,138,2,3,"INDEPENDIEN",0
50,"50196",107,87,86,0,1,"INDEPENDIEN",0
44,"44028",183,151,150,4,1,"INDEPENDIEN",0
50,"50248",508,387,374,2,13,"INDEPENDIEN",0
44,"44043",102,74,72,0,2,"INDEPENDIEN",0
50,"50010",68,58,58,0,0,"INDEPENDIEN",0
44,"44246",1543,1045,1027,12,18,"INDEPENDIEN",1
44,"44053",105,78,78,0,0,"INDEPENDIEN",0
50,"50116",182,136,132,0,4,"INDEPENDIEN",0
50,"50052",90,68,68,0,0,"INDEPENDIEN",0
50,"50038",1502,1121,1111,7,10,"INDEPENDIEN",0
44,"44192",355,280,278,4,2,"INDEPENDIEN",0
44,"44025",6009,4087,3997,25,90,"INDEPENDIEN",2
44,"44196",131,101,98,2,3,"INDEPENDIEN",0
44,"44200",39,26,26,0,0,"INDEPENDIEN",0
44,"44240",158,130,129,0,1,"INDEPENDIEN",0
44,"44111",92,69,68,0,1,"INDEPENDIEN",0
44,"44066",108,79,74,0,5,"INDEPENDIEN",0
44,"44204",24,21,21,0,0,"INDEPENDIEN",0
44,"44208",37,22,22,0,0,"INDEPENDIEN",0
50,"50053",687,513,510,2,3,"INDEPENDIEN",0
50,"50211",249,176,173,0,3,"INDEPENDIEN",0
50,"50177",308,245,244,4,1,"INDEPENDIEN",1
50,"50204",2436,1785,1770,3,15,"INDEPENDIEN",0
50,"50903",2214,1602,1585,8,17,"INDEPENDIEN",0
44,"44094",113,94,94,0,0,"INDEPENDIEN",0
50,"50054",58,50,50,0,0,"INDEPENDIEN",0
50,"50057",1395,919,907,11,12,"INDEPENDIEN",3
50,"50164",390,247,246,6,1,"INDEPENDIEN",0
50,"50184",115,85,85,0,0,"INDEPENDIEN",0
44,"44152",64,46,45,0,1,"INDEPENDIEN",0
44,"44264",248,191,189,1,2,"INDEPENDIEN",0
50,"50002",143,108,104,1,4,"INDEPENDIEN",0
44,"44142",35,27,27,0,0,"INDEPENDIEN",0
50,"50264",156,115,115,0,0,"INDEPENDIEN",0
50,"50129",235,161,158,2,3,"INDEPENDIEN",0
44,"44101",58,46,46,2,0,"INDEPENDIEN",0
50,"50043",253,171,171,0,0,"INDEPENDIEN",0
44,"44049",849,616,604,9,12,"INDEPENDIEN",0
44,"44146",174,153,152,2,1,"INDEPENDIEN",1
44,"44257",166,123,119,1,4,"INDEPENDIEN",0
44,"44221",372,303,300,1,3,"INDEPENDIEN",0
44,"44130",34,24,24,0,0,"INDEPENDIEN",0
44,"44150",28,22,21,0,1,"INDEPENDIEN",0
50,"50254",180,118,116,1,2,"INDEPENDIEN",0
44,"44036",25,21,21,0,0,"INDEPENDIEN",0
50,"50034",826,567,563,5,4,"INDEPENDIEN",0
44,"44189",56,41,41,0,0,"INDEPENDIEN",0
44,"44014",2521,1896,1867,8,29,"INDEPENDIEN",1
50,"50075",80,62,61,1,1,"INDEPENDIEN",0
44,"44086",449,342,336,3,6,"INDEPENDIEN",0
44,"44110",49,42,42,1,0,"INDEPENDIEN",0
50,"50108",48,38,38,0,0,"INDEPENDIEN",0
44,"44232",378,284,276,6,8,"INDEPENDIEN",1
50,"50041",12,9,9,0,0,"INDEPENDIEN",0
50,"50173",182,132,131,1,1,"INDEPENDIEN",0
50,"50902",87,79,79,2,0,"INDEPENDIEN",0
44,"44060",41,32,32,0,0,"INDEPENDIEN",0
44,"44034",139,109,108,0,1,"INDEPENDIEN",0
50,"50255",209,163,163,5,0,"INDEPENDIEN",0
50,"50076",78,66,65,0,1,"INDEPENDIEN",0
44,"44215",159,109,109,2,0,"INDEPENDIEN",0
50,"50073",2141,1592,1577,7,15,"INDEPENDIEN",2
50,"50008",5097,3457,3417,31,40,"INDEPENDIEN",3
50,"50286",77,50,50,3,0,"INDEPENDIEN",0
50,"50005",229,189,189,1,0,"INDEPENDIEN",0
44,"44190",71,58,56,0,2,"INDEPENDIEN",0
44,"44230",155,123,123,2,0,"INDEPENDIEN",0
44,"44145",1020,719,709,9,10,"INDEPENDIEN",1
50,"50233",106,81,81,0,0,"INDEPENDIEN",0
44,"44038",104,83,82,0,1,"INDEPENDIEN",0
44,"44245",248,179,176,2,3,"INDEPENDIEN",0
50,"50132",751,543,536,0,7,"INDEPENDIEN",1
44,"44223",72,54,54,0,0,"INDEPENDIEN",0
44,"44067",114,81,81,1,0,"INDEPENDIEN",0
44,"44241",533,396,389,0,7,"INDEPENDIEN",0
50,"50161",106,75,72,0,3,"INDEPENDIEN",0
50,"50237",101,74,73,1,1,"INDEPENDIEN",0
50,"50205",90,63,61,0,2,"INDEPENDIEN",1
44,"44119",130,92,91,3,1,"INDEPENDIEN",0
50,"50247",823,588,581,3,7,"INDEPENDIEN",2
50,"50206",460,363,357,4,6,"INDEPENDIEN",0
44,"44261",739,536,529,6,7,"INDEPENDIEN",0
50,"50111",180,143,143,0,0,"INDEPENDIEN",0
44,"44102",30,27,26,0,1,"INDEPENDIEN",0
44,"44133",21,15,15,0,0,"INDEPENDIEN",0
44,"44039",221,165,159,0,6,"INDEPENDIEN",0
44,"44117",340,271,268,4,3,"INDEPENDIEN",0
50,"50133",113,80,80,4,0,"INDEPENDIEN",0
50,"50122",68,52,52,1,0,"INDEPENDIEN",0
44,"44019",67,50,49,0,1,"INDEPENDIEN",0
50,"50017",1773,1276,1269,13,7,"INDEPENDIEN",2
50,"50186",42,31,31,0,0,"INDEPENDIEN",1
50,"50059",769,549,544,8,5,"INDEPENDIEN",1
44,"44004",408,303,297,0,6,"INDEPENDIEN",0
44,"44062",34,25,22,0,3,"INDEPENDIEN",0
50,"50014",147,94,94,0,0,"INDEPENDIEN",0
44,"44174",428,307,304,3,3,"INDEPENDIEN",0
50,"50224",72,57,56,2,1,"INDEPENDIEN",0
44,"44193",78,54,54,1,0,"INDEPENDIEN",0
50,"50217",446,342,342,1,0,"INDEPENDIEN",1
50,"50105",296,214,211,1,3,"INDEPENDIEN",0
50,"50080",33,27,27,0,0,"INDEPENDIEN",0
50,"50292",125,102,102,1,0,"INDEPENDIEN",0
44,"44031",97,62,62,0,0,"INDEPENDIEN",0
44,"44249",55,44,44,2,0,"INDEPENDIEN",0
50,"50167",233,183,178,1,5,"INDEPENDIEN",0
50,"50171",106,79,79,0,0,"INDEPENDIEN",0
50,"50142",26,17,17,0,0,"INDEPENDIEN",0
44,"44052",77,56,56,0,0,"INDEPENDIEN",0
44,"44115",102,90,90,3,0,"INDEPENDIEN",0
44,"44032",16,11,11,0,0,"INDEPENDIEN",0
44,"44194",109,78,73,3,5,"INDEPENDIEN",0
50,"50276",125,104,103,2,1,"INDEPENDIEN",0
50,"50081",511,382,378,4,4,"INDEPENDIEN",0
44,"44175",122,85,84,1,1,"INDEPENDIEN",0
44,"44164",27,23,23,0,0,"INDEPENDIEN",0
50,"50019",55,41,41,0,0,"INDEPENDIEN",0
44,"44113",71,52,52,0,0,"INDEPENDIEN",0
50,"50240",1025,729,718,10,11,"INDEPENDIEN",0
50,"50261",213,157,157,0,0,"INDEPENDIEN",0
44,"44195",88,60,60,1,0,"INDEPENDIEN",0
44,"44153",1774,1135,1121,5,14,"INDEPENDIEN",0
50,"50179",249,214,213,2,1,"INDEPENDIEN",0
50,"50159",665,512,507,2,5,"INDEPENDIEN",0
44,"44239",22,20,20,0,0,"INDEPENDIEN",0
50,"50223",920,712,701,4,11,"INDEPENDIEN",0
50,"50291",96,74,74,0,0,"INDEPENDIEN",0
50,"50062",1829,1304,1290,16,14,"INDEPENDIEN",0
44,"44033",269,191,190,0,1,"INDEPENDIEN",0
44,"44138",135,98,94,0,4,"INDEPENDIEN",0
50,"50169",351,269,265,0,4,"INDEPENDIEN",2
50,"50137",1011,772,764,8,8,"INDEPENDIEN",0
50,"50021",30,21,21,0,0,"INDEPENDIEN",0
44,"44184",45,34,34,0,0,"INDEPENDIEN",0
50,"50194",88,63,63,1,0,"INDEPENDIEN",0
50,"50086",187,132,128,2,4,"INDEPENDIEN",0
44,"44044",88,72,71,2,1,"INDEPENDIEN",0
50,"50149",34,24,24,0,0,"INDEPENDIEN",0
50,"50131",231,167,165,0,2,"INDEPENDIEN",0
44,"44128",68,54,54,1,0,"INDEPENDIEN",0
44,"44266",115,90,90,0,0,"INDEPENDIEN",1
44,"44260",137,91,89,3,2,"INDEPENDIEN",0
44,"44096",161,138,135,3,3,"INDEPENDIEN",0
50,"50191",470,310,308,1,2,"INDEPENDIEN",1
50,"50273",30,22,22,0,0,"INDEPENDIEN",0
50,"50150",649,402,397,2,5,"INDEPENDIEN",0
50,"50201",448,339,335,7,4,"INDEPENDIEN",0
50,"50084",77,59,59,2,0,"INDEPENDIEN",0
50,"50181",993,733,720,5,13,"INDEPENDIEN",1
44,"44256",38,34,34,0,0,"INDEPENDIEN",0
50,"50212",40,36,36,0,0,"INDEPENDIEN",0
50,"50009",105,80,80,0,0,"INDEPENDIEN",0
44,"44077",74,60,58,0,2,"INDEPENDIEN",0
44,"44209",833,611,602,6,9,"INDEPENDIEN",1
50,"50016",52,40,40,0,0,"INDEPENDIEN",0
50,"50139",313,241,239,3,2,"INDEPENDIEN",0
50,"50234",243,189,185,6,4,"INDEPENDIEN",0
44,"44003",19,17,17,0,0,"INDEPENDIEN",0
44,"44085",52,35,35,0,0,"INDEPENDIEN",0
44,"44187",201,152,149,4,3,"INDEPENDIEN",0
50,"50165",1814,1287,1264,26,23,"INDEPENDIEN",0
50,"50078",235,177,173,0,4,"INDEPENDIEN",0
50,"50192",236,180,180,2,0,"INDEPENDIEN",0
50,"50172",193,132,129,1,3,"INDEPENDIEN",0
50,"50175",1002,695,688,5,7,"INDEPENDIEN",0
50,"50055",3611,2445,2407,22,38,"INDEPENDIEN",1
50,"50244",201,162,161,1,1,"INDEPENDIEN",0
50,"50295",48,43,42,0,1,"INDEPENDIEN",0
50,"50202",152,100,99,1,1,"INDEPENDIEN",0
50,"50235",2339,1664,1648,11,16,"INDEPENDIEN",4
50,"50193",651,514,501,2,13,"INDEPENDIEN",2
50,"50285",644,436,434,2,2,"INDEPENDIEN",0
44,"44131",25,20,20,0,0,"INDEPENDIEN",0
44,"44099",709,465,462,3,3,"INDEPENDIEN",1
50,"50011",122,95,94,1,1,"INDEPENDIEN",0
44,"44135",113,88,87,0,1,"INDEPENDIEN",0
50,"50275",108,55,55,0,0,"INDEPENDIEN",0
44,"44016",482,363,360,2,3,"INDEPENDIEN",0
44,"44225",107,74,74,1,0,"INDEPENDIEN",0
50,"50262",1170,896,887,15,9,"INDEPENDIEN",1
44,"44169",342,252,252,3,0,"INDEPENDIEN",0
44,"44063",71,54,54,0,0,"INDEPENDIEN",0
50,"50098",174,130,124,0,6,"INDEPENDIEN",0
50,"50025",4562,3158,3124,31,34,"INDEPENDIEN",2
44,"44026",90,77,76,0,1,"INDEPENDIEN",0
44,"44234",61,51,51,1,0,"INDEPENDIEN",0
50,"50121",277,216,214,1,2,"INDEPENDIEN",1
50,"50215",24,19,19,0,0,"INDEPENDIEN",0
44,"44132",60,54,54,1,0,"INDEPENDIEN",0
44,"44155",1090,793,782,4,11,"INDEPENDIEN",0
50,"50067",14119,9909,9819,112,90,"INDEPENDIEN",6
50,"50064",437,342,339,0,3,"INDEPENDIEN",1
50,"50106",134,104,104,0,0,"INDEPENDIEN",0
50,"50280",332,253,250,0,3,"INDEPENDIEN",0
50,"50222",1622,1091,1071,7,20,"INDEPENDIEN",1
50,"50026",439,335,325,10,10,"INDEPENDIEN",0
44,"44061",70,54,51,0,3,"INDEPENDIEN",0
50,"50088",302,246,237,5,9,"INDEPENDIEN",0
44,"44007",173,122,121,4,1,"INDEPENDIEN",0
50,"50268",44,37,37,0,0,"INDEPENDIEN",0
44,"44227",74,63,62,0,1,"INDEPENDIEN",0
44,"44010",175,130,128,1,2,"INDEPENDIEN",0
50,"50089",8225,6074,6043,43,31,"INDEPENDIEN",3
44,"44224",22,14,14,0,0,"INDEPENDIEN",0
44,"44080",292,229,223,3,6,"INDEPENDIEN",0
44,"44127",68,51,51,0,0,"INDEPENDIEN",0
44,"44022",493,323,318,7,5,"INDEPENDIEN",0
50,"50288",3387,2415,2398,31,17,"INDEPENDIEN",1
50,"50007",45,34,34,1,0,"INDEPENDIEN",0
50,"50144",34,29,29,2,0,"INDEPENDIEN",0
50,"50134",128,91,89,2,2,"INDEPENDIEN",0
50,"50155",103,80,78,0,2,"INDEPENDIEN",0
44,"44076",2203,1690,1663,18,27,"INDEPENDIEN",0
44,"44211",42,35,35,0,0,"INDEPENDIEN",0
50,"50231",250,195,192,4,3,"INDEPENDIEN",0
50,"50279",86,64,64,0,0,"INDEPENDIEN",0
50,"50090",150,113,112,0,1,"INDEPENDIEN",0
50,"50128",26,25,25,1,0,"INDEPENDIEN",0
44,"44114",243,178,173,0,5,"INDEPENDIEN",2
50,"50901",138,105,105,0,0,"INDEPENDIEN",0
50,"50140",166,115,115,0,0,"INDEPENDIEN",0
50,"50274",71,55,55,0,0,"INDEPENDIEN",0
50,"50018",953,656,655,1,1,"INDEPENDIEN",0
50,"50113",618,489,484,2,5,"INDEPENDIEN",0
50,"50229",62,47,47,2,0,"INDEPENDIEN",0
44,"44105",82,64,64,0,0,"INDEPENDIEN",0
50,"50147",777,552,552,2,0,"INDEPENDIEN",2
50,"50114",116,89,88,0,1,"INDEPENDIEN",0
50,"50050",98,64,64,2,0,"INDEPENDIEN",0
50,"50146",187,145,144,3,1,"INDEPENDIEN",0
44,"44201",495,411,406,0,5,"INDEPENDIEN",0
50,"50246",41,28,28,0,0,"INDEPENDIEN",0
44,"44177",115,84,84,1,0,"INDEPENDIEN",0
44,"44173",101,81,79,2,2,"INDEPENDIEN",0
44,"44055",69,56,56,4,0,"INDEPENDIEN",0
50,"50092",299,233,231,0,2,"INDEPENDIEN",0
50,"50281",73,51,50,0,1,"INDEPENDIEN",0
50,"50030",215,141,140,1,1,"INDEPENDIEN",0
50,"50085",167,126,126,1,0,"INDEPENDIEN",0
44,"44198",182,147,146,4,1,"INDEPENDIEN",0
50,"50072",170,125,125,0,0,"INDEPENDIEN",0
50,"50148",316,233,229,4,4,"INDEPENDIEN",0
50,"50162",146,109,105,4,4,"INDEPENDIEN",0
50,"50107",947,738,733,4,5,"INDEPENDIEN",0
50,"50208",1774,1207,1195,10,12,"INDEPENDIEN",1
44,"44236",63,48,47,0,1,"INDEPENDIEN",0
50,"50151",636,499,499,0,0,"INDEPENDIEN",1
50,"50189",705,527,519,13,8,"INDEPENDIEN",0
44,"44093",80,66,66,0,0,"INDEPENDIEN",0
50,"50241",588,415,410,4,5,"INDEPENDIEN",0
44,"44001",68,53,52,1,1,"INDEPENDIEN",0
50,"50126",2371,1573,1559,19,14,"INDEPENDIEN",1
50,"50093",92,66,66,1,0,"INDEPENDIEN",1
44,"44154",256,192,188,3,4,"INDEPENDIEN",0
44,"44244",75,47,47,1,0,"INDEPENDIEN",0
44,"44161",443,314,313,2,1,"INDEPENDIEN",0
44,"44050",3113,2120,2100,25,20,"INDEPENDIEN",0
50,"50115",3235,2128,2109,14,19,"INDEPENDIEN",0
50,"50156",215,181,178,2,3,"INDEPENDIEN",0
50,"50209",2601,1731,1721,13,10,"INDEPENDIEN",4
44,"44120",222,154,150,2,4,"INDEPENDIEN",0
50,"50015",96,67,67,0,0,"INDEPENDIEN",0
50,"50001",100,77,77,0,0,"INDEPENDIEN",0
50,"50083",89,75,75,1,0,"INDEPENDIEN",0
44,"44267",70,57,56,0,1,"INDEPENDIEN",0
44,"44045",366,274,269,2,5,"INDEPENDIEN",0
50,"50293",413,276,275,4,1,"INDEPENDIEN",0
44,"44012",334,263,261,5,2,"INDEPENDIEN",0
44,"44118",164,132,131,2,1,"INDEPENDIEN",0
44,"44137",193,149,148,0,1,"INDEPENDIEN",0
44,"44121",60,47,47,2,0,"INDEPENDIEN",0
44,"44176",158,115,114,0,1,"INDEPENDIEN",0
50,"50154",116,96,96,0,0,"INDEPENDIEN",0
50,"50199",334,244,242,3,2,"INDEPENDIEN",0
50,"50284",141,107,104,0,3,"INDEPENDIEN",0
44,"44129",39,32,32,0,0,"INDEPENDIEN",0
44,"44268",25,25,24,0,1,"INDEPENDIEN",0
44,"44220",121,84,83,1,1,"INDEPENDIEN",0
50,"50277",50,42,41,0,1,"INDEPENDIEN",0
50,"50157",290,220,218,3,2,"INDEPENDIEN",0
44,"44160",466,304,301,2,3,"INDEPENDIEN",0
50,"50047",48,36,36,0,0,"INDEPENDIEN",1
44,"44002",47,40,40,0,0,"INDEPENDIEN",0
44,"44171",178,126,124,2,2,"INDEPENDIEN",0
44,"44029",559,425,424,5,1,"INDEPENDIEN",1
50,"50136",575,414,410,2,4,"INDEPENDIEN",0
44,"44124",77,64,64,3,0,"INDEPENDIEN",0
50,"50203",1040,748,739,7,9,"INDEPENDIEN",0
44,"44199",44,41,41,2,0,"INDEPENDIEN",0
50,"50004",522,390,388,0,2,"INDEPENDIEN",0
44,"44070",53,48,48,0,0,"INDEPENDIEN",0
44,"44059",544,425,412,9,13,"INDEPENDIEN",0
50,"50187",69,44,44,0,0,"INDEPENDIEN",0
50,"50197",90,67,67,2,0,"INDEPENDIEN",0
50,"50035",72,54,53,1,1,"INDEPENDIEN",0
50,"50104",348,271,269,2,2,"INDEPENDIEN",0
44,"44112",429,290,290,2,0,"INDEPENDIEN",0
50,"50102",859,658,653,8,5,"INDEPENDIEN",0
44,"44042",123,91,90,0,1,"INDEPENDIEN",0
44,"44011",52,40,38,0,2,"INDEPENDIEN",0
50,"50020",809,564,559,2,5,"INDEPENDIEN",1
44,"44100",185,153,151,0,2,"INDEPENDIEN",0
50,"50289",51,38,38,0,0,"INDEPENDIEN",0
50,"50266",122,90,90,0,0,"INDEPENDIEN",0
44,"44087",80,69,67,1,2,"INDEPENDIEN",0
44,"44006",248,185,183,2,2,"INDEPENDIEN",0
50,"50225",1570,956,950,3,6,"INDEPENDIEN",0
50,"50079",249,175,174,0,1,"INDEPENDIEN",0
44,"44126",329,234,229,4,5,"INDEPENDIEN",0
44,"44064",69,49,49,0,0,"INDEPENDIEN",0
44,"44247",316,218,215,3,3,"INDEPENDIEN",2
44,"44206",114,90,87,0,3,"INDEPENDIEN",0
50,"50013",219,180,180,0,0,"INDEPENDIEN",0
44,"44191",764,586,583,6,3,"INDEPENDIEN",0
50,"50257",171,134,134,2,0,"INDEPENDIEN",0
44,"44179",337,229,226,1,3,"INDEPENDIEN",0
44,"44106",155,116,114,5,2,"INDEPENDIEN",0
50,"50228",268,210,208,5,2,"INDEPENDIEN",0
44,"44024",27,25,25,0,0,"INDEPENDIEN",0
50,"50040",89,75,75,0,0,"INDEPENDIEN",0
50,"50091",41,36,36,0,0,"INDEPENDIEN",0
50,"50123",449,334,331,1,3,"INDEPENDIEN",0
50,"50124",415,318,317,2,1,"INDEPENDIEN",0
50,"50271",252,200,197,2,3,"INDEPENDIEN",0
44,"44008",1613,1163,1153,6,10,"INDEPENDIEN",0
44,"44089",45,39,39,1,0,"INDEPENDIEN",0
44,"44203",10,10,10,0,0,"INDEPENDIEN",0
44,"44107",218,152,152,5,0,"INDEPENDIEN",0
44,"44040",201,160,157,1,3,"INDEPENDIEN",0
44,"44182",197,157,157,0,0,"INDEPENDIEN",0
44,"44082",89,78,77,0,1,"INDEPENDIEN",0
50,"50031",154,93,93,0,0,"INDEPENDIEN",0
44,"44172",301,218,216,4,2,"INDEPENDIEN",0
44,"44084",54,41,41,0,0,"INDEPENDIEN",0
50,"50153",935,713,708,6,5,"INDEPENDIEN",0
50,"50210",38,30,30,1,0,"INDEPENDIEN",0
44,"44251",254,198,191,1,7,"INDEPENDIEN",0
50,"50060",172,128,127,1,1,"INDEPENDIEN",1
44,"44021",107,89,88,0,1,"INDEPENDIEN",0
50,"50218",113,91,91,1,0,"INDEPENDIEN",0
50,"50252",5138,3642,3611,24,31,"INDEPENDIEN",2
50,"50183",331,246,246,3,0,"INDEPENDIEN",0
44,"44056",501,345,342,2,3,"INDEPENDIEN",0
44,"44009",809,596,593,7,3,"INDEPENDIEN",0
44,"44041",56,44,44,1,0,"INDEPENDIEN",0
44,"44237",398,304,301,4,3,"INDEPENDIEN",0
44,"44035",113,90,88,1,2,"INDEPENDIEN",0
50,"50125",360,248,246,3,2,"INDEPENDIEN",0
50,"50250",52,44,44,0,0,"INDEPENDIEN",0
50,"50260",33,33,32,0,1,"INDEPENDIEN",0
50,"50230",1165,833,828,8,5,"INDEPENDIEN",0
50,"50251",8262,5946,5872,44,74,"INDEPENDIEN",6
50,"50095",12323,8628,8550,110,78,"INDEPENDIEN",7
50,"50061",202,172,172,3,0,"INDEPENDIEN",0
50,"50232",175,110,110,3,0,"INDEPENDIEN",0
50,"50220",40,32,32,0,0,"INDEPENDIEN",0
50,"50056",409,300,300,3,0,"INDEPENDIEN",0
50,"50119",927,724,713,5,11,"INDEPENDIEN",0
50,"50213",94,75,74,0,1,"INDEPENDIEN",0
50,"50028",78,51,51,0,0,"INDEPENDIEN",0
44,"44228",100,82,82,0,0,"INDEPENDIEN",0
44,"44183",77,50,49,0,1,"INDEPENDIEN",0
44,"44065",60,40,40,0,0,"INDEPENDIEN",0
44,"44207",156,118,115,4,3,"INDEPENDIEN",0
50,"50278",197,145,145,0,0,"INDEPENDIEN",0
50,"50074",6366,4230,4165,31,65,"INDEPENDIEN",4
50,"50066",2621,1862,1851,9,11,"INDEPENDIEN",0
44,"44103",132,102,102,1,0,"INDEPENDIEN",0
50,"50117",126,104,103,1,1,"INDEPENDIEN",0
44,"44205",700,460,453,4,7,"INDEPENDIEN",0
44,"44197",56,36,36,0,0,"INDEPENDIEN",0
50,"50178",293,190,187,0,3,"INDEPENDIEN",0
44,"44027",164,123,123,1,0,"INDEPENDIEN",0
44,"44168",189,139,138,2,1,"INDEPENDIEN",0
50,"50214",27,18,17,0,1,"INDEPENDIEN",0
50,"50198",54,41,41,1,0,"INDEPENDIEN",0
50,"50024",571,437,437,6,0,"INDEPENDIEN",0
44,"44163",126,94,94,1,0,"INDEPENDIEN",0
44,"44185",99,76,75,0,1,"INDEPENDIEN",0
50,"50174",91,69,68,0,1,"INDEPENDIEN",0
50,"50023",224,175,175,0,0,"INDEPENDIEN",0
44,"44157",64,48,48,1,0,"INDEPENDIEN",0
50,"50185",133,108,108,1,0,"INDEPENDIEN",0
50,"50100",329,246,241,1,5,"INDEPENDIEN",0
44,"44109",108,73,73,0,0,"INDEPENDIEN",0
50,"50029",626,450,450,3,0,"INDEPENDIEN",0
44,"44235",92,62,60,0,2,"INDEPENDIEN",0
50,"50118",2165,1552,1540,10,12,"INDEPENDIEN",0
50,"50120",52,40,40,1,0,"INDEPENDIEN",0
50,"50027",225,178,177,2,1,"INDEPENDIEN",0
44,"44097",142,92,92,0,0,"INDEPENDIEN",0
50,"50033",66,49,48,0,1,"INDEPENDIEN",0
4,"4002",1039,748,740,2,8,"IZAR",0
4,"4076",1279,960,944,8,16,"IZAR",1
18,"18051",1147,817,810,8,7,"IZAR",1
18,"18015",434,334,333,0,1,"IZAR",0
18,"18128",343,270,269,1,1,"IZAR",0
4,"4059",1079,723,712,4,11,"IZAR",0
29,"29002",1177,804,789,5,15,"IZAR",1
18,"18037",535,402,396,2,6,"IZAR",0
4,"4009",162,123,122,2,1,"IZAR",0
18,"18168",804,546,543,7,3,"IZAR",0
4,"4097",248,189,189,1,0,"IZAR",0
18,"18105",3782,2450,2420,17,30,"IZAR",1
18,"18145",10491,7538,7477,59,61,"IZAR",6
18,"18120",264,209,208,1,1,"IZAR",0
18,"18171",2120,1572,1551,9,21,"IZAR",0
18,"18025",288,220,220,1,0,"IZAR",0
18,"18149",5230,3903,3864,20,39,"IZAR",0
29,"29006",673,428,420,1,8,"IZAR",0
4,"4045",1757,1309,1288,6,21,"IZAR",2
18,"18103",757,579,575,4,4,"IZAR",0
18,"18150",6763,4733,4678,21,55,"IZAR",2
4,"4021",185,151,148,1,3,"IZAR",0
18,"18056",3530,2641,2614,24,27,"IZAR",1
18,"18901",511,356,355,3,1,"IZAR",0
18,"18093",2750,1793,1776,7,17,"IZAR",2
18,"18159",995,797,795,2,2,"IZAR",0
18,"18188",1653,1183,1175,5,8,"IZAR",0
4,"4062",4504,3534,3490,18,44,"IZAR",1
18,"18181",223,174,172,0,2,"IZAR",0
29,"29043",2509,1608,1576,18,32,"IZAR",2
18,"18045",1126,756,742,4,14,"IZAR",0
18,"18164",1836,1146,1126,6,20,"IZAR",0
4,"4016",2138,1551,1536,9,15,"IZAR",1
18,"18050",1710,1165,1152,3,13,"IZAR",0
29,"29064",503,348,339,8,9,"IZAR",0
18,"18057",5305,3827,3791,27,36,"IZAR",0
29,"29090",1688,1144,1134,15,10,"IZAR",1
4,"4085",387,304,301,2,3,"IZAR",0
4,"4090",304,238,234,0,4,"IZAR",0
18,"18180",633,410,410,3,0,"IZAR",0
29,"29092",570,397,390,4,7,"IZAR",1
18,"18146",965,703,685,9,18,"IZAR",0
18,"18011",4335,3037,3015,20,22,"IZAR",1
4,"4022",347,249,249,7,0,"IZAR",0
4,"4069",4687,3471,3437,27,34,"IZAR",1
29,"29001",4170,3106,3068,19,38,"IZAR",1
4,"4011",2765,2119,2096,21,23,"IZAR",0
29,"29081",261,197,197,1,0,"IZAR",0
18,"18002",553,395,393,1,2,"IZAR",1
29,"29020",3267,2408,2359,16,49,"IZAR",0
18,"18194",2128,1451,1437,9,14,"IZAR",2
4,"4084",341,249,247,2,2,"IZAR",0
29,"29010",1651,1278,1237,4,41,"IZAR",0
18,"18910",788,541,536,3,5,"IZAR",0
4,"4008",505,423,417,5,6,"IZAR",0
29,"29032",6657,5031,4977,33,54,"IZAR",1
29,"29050",421,306,302,3,4,"IZAR",0
18,"18063",1200,679,675,2,4,"IZAR",0
18,"18067",702,469,466,0,3,"IZAR",0
29,"29066",334,234,233,4,1,"IZAR",0
29,"29079",2416,1788,1764,10,24,"IZAR",0
18,"18175",11670,8200,8097,36,103,"IZAR",4
18,"18138",2486,1620,1606,13,14,"IZAR",2
29,"29080",6676,4469,4419,35,50,"IZAR",1
18,"18909",579,435,429,0,6,"IZAR",0
29,"29031",1614,1107,1094,13,13,"IZAR",0
18,"18124",381,277,277,2,0,"IZAR",0
18,"18047",5903,3893,3857,28,36,"IZAR",0
4,"4904",1777,1230,1221,12,9,"IZAR",0
18,"18189",776,581,574,4,7,"IZAR",1
29,"29033",1122,747,730,4,17,"IZAR",2
4,"4019",249,196,196,1,0,"IZAR",0
4,"4072",313,247,245,2,2,"IZAR",0
4,"4026",66,54,51,0,3,"IZAR",0
4,"4041",322,240,238,6,2,"IZAR",0
18,"18007",781,521,512,5,9,"IZAR",0
18,"18083",247,200,196,0,4,"IZAR",0
29,"29902",2567,1577,1559,11,18,"IZAR",2
18,"18137",989,761,760,7,1,"IZAR",0
18,"18115",2553,1800,1781,17,19,"IZAR",0
29,"29065",187,137,136,0,1,"IZAR",0
18,"18088",1541,1124,1117,5,7,"IZAR",0
18,"18086",349,274,272,0,2,"IZAR",0
4,"4036",226,175,175,0,0,"IZAR",0
29,"29034",467,358,356,0,2,"IZAR",0
4,"4086",1760,1243,1234,9,9,"IZAR",0
29,"29025",39665,25907,25714,192,193,"IZAR",11
18,"18135",4568,3009,2961,14,48,"IZAR",1
29,"29057",357,241,238,1,3,"IZAR",0
18,"18112",123,82,82,2,0,"IZAR",0
18,"18117",506,383,373,1,10,"IZAR",0
18,"18192",1538,1151,1123,6,28,"IZAR",0
4,"4005",556,437,431,3,6,"IZAR",0
4,"4098",1516,1115,1106,11,9,"IZAR",0
18,"18165",4123,2787,2758,18,29,"IZAR",1
18,"18005",372,262,258,0,4,"IZAR",0
4,"4071",394,338,337,3,1,"IZAR",0
4,"4095",714,471,468,5,3,"IZAR",0
4,"4007",734,524,522,1,2,"IZAR",0
18,"18006",4130,2904,2864,13,40,"IZAR",0
29,"29082",31885,22572,22400,152,172,"IZAR",5
18,"18070",288,227,226,0,1,"IZAR",0
18,"18107",943,663,655,1,8,"IZAR",0
4,"4903",4320,2858,2825,19,33,"IZAR",1
18,"18024",855,665,654,7,11,"IZAR",0
29,"29088",2714,1829,1800,12,29,"IZAR",0
4,"4053",12320,8946,8866,70,80,"IZAR",2
18,"18078",732,570,566,2,4,"IZAR",0
18,"18157",1121,815,803,3,12,"IZAR",1
18,"18087",184857,134428,133526,864,902,"IZAR",58
18,"18173",8939,5922,5849,42,73,"IZAR",1
18,"18132",3291,2524,2494,9,30,"IZAR",0
18,"18908",801,593,588,3,5,"IZAR",0
18,"18013",4218,3024,2986,15,38,"IZAR",2
18,"18098",6135,4206,4161,21,45,"IZAR",3
18,"18123",301,228,222,1,6,"IZAR",0
18,"18096",341,227,224,3,3,"IZAR",0
4,"4067",570,441,436,2,5,"IZAR",0
18,"18905",14618,9789,9682,110,107,"IZAR",3
29,"29028",1237,836,826,6,10,"IZAR",0
18,"18039",3490,2406,2378,33,28,"IZAR",0
4,"4018",270,232,229,0,3,"IZAR",0
29,"29099",950,693,685,4,8,"IZAR",0
18,"18902",816,632,620,4,12,"IZAR",0
4,"4101",4266,2909,2876,26,33,"IZAR",0
29,"29084",27359,17843,17627,176,216,"IZAR",6
4,"4079",51383,33777,33586,257,191,"IZAR",13
29,"29047",1117,885,866,1,19,"IZAR",0
29,"29087",376,270,266,1,4,"IZAR",0
18,"18099",1584,1228,1206,14,22,"IZAR",1
4,"4073",330,234,233,2,1,"IZAR",0
4,"4901",545,395,394,0,1,"IZAR",0
18,"18906",905,664,657,3,7,"IZAR",1
29,"29040",1977,1290,1278,12,12,"IZAR",1
4,"4047",2281,1893,1878,11,15,"IZAR",1
29,"29098",1253,917,895,9,22,"IZAR",2
4,"4051",436,360,356,1,4,"IZAR",0
18,"18116",2850,2059,2025,20,34,"IZAR",0
4,"4064",2771,2001,1988,13,13,"IZAR",1
18,"18121",129,98,98,1,0,"IZAR",0
29,"29059",2587,1965,1922,14,43,"IZAR",2
29,"29083",2107,1540,1512,9,28,"IZAR",0
18,"18913",813,566,559,2,7,"IZAR",0
29,"29021",161,108,107,4,1,"IZAR",0
18,"18100",7807,5452,5398,50,54,"IZAR",1
29,"29100",2433,1684,1667,5,17,"IZAR",0
4,"4015",124,96,96,2,0,"IZAR",0
18,"18184",2168,1629,1607,13,22,"IZAR",1
29,"29903",524,353,349,3,4,"IZAR",0
29,"29042",14016,9368,9192,88,176,"IZAR",6
18,"18179",538,376,374,6,2,"IZAR",0
29,"29056",1098,757,750,5,7,"IZAR",0
4,"4078",1078,758,746,8,12,"IZAR",0
4,"4096",266,209,208,0,1,"IZAR",0
4,"4046",858,609,599,7,10,"IZAR",1
18,"18182",1906,1298,1288,4,10,"IZAR",0
4,"4037",1314,969,955,6,14,"IZAR",0
4,"4043",549,465,461,1,4,"IZAR",1
29,"29035",1567,1157,1144,11,13,"IZAR",0
18,"18012",2278,1662,1641,13,21,"IZAR",0
18,"18053",1630,1082,1076,8,6,"IZAR",1
18,"18064",377,291,290,2,1,"IZAR",0
18,"18185",541,434,432,2,2,"IZAR",0
4,"4056",143,113,109,0,4,"IZAR",0
18,"18108",850,659,656,3,3,"IZAR",1
29,"29075",12934,8234,8147,69,87,"IZAR",2
4,"4070",1584,1184,1179,3,5,"IZAR",0
18,"18915",745,533,525,2,8,"IZAR",0
18,"18158",8358,5096,5031,28,65,"IZAR",3
18,"18170",330,219,217,0,2,"IZAR",0
18,"18174",446,330,324,2,6,"IZAR",0
18,"18001",251,168,167,5,1,"IZAR",0
29,"29061",1016,798,769,8,29,"IZAR",0
18,"18176",250,191,189,2,2,"IZAR",0
18,"18029",1833,1196,1190,12,6,"IZAR",0
4,"4032",5586,3642,3623,23,19,"IZAR",2
18,"18133",2168,1648,1636,6,12,"IZAR",1
18,"18072",667,424,420,0,4,"IZAR",0
29,"29014",217,141,140,4,1,"IZAR",0
4,"4038",3084,2140,2126,16,14,"IZAR",1
29,"29037",209,158,157,1,1,"IZAR",0
29,"29009",1468,1069,1045,8,24,"IZAR",0
29,"29053",1699,1105,1091,14,14,"IZAR",2
18,"18101",9265,6618,6560,59,58,"IZAR",3
4,"4094",207,144,144,0,0,"IZAR",0
4,"4063",1096,776,768,2,8,"IZAR",1
29,"29054",41997,28422,28238,189,184,"IZAR",10
18,"18111",2765,1949,1936,18,13,"IZAR",2
4,"4080",209,162,162,3,0,"IZAR",1
18,"18912",1473,994,979,3,15,"IZAR",0
4,"4028",221,191,190,1,1,"IZAR",0
18,"18904",775,565,558,1,7,"IZAR",0
18,"18119",1702,1298,1283,13,15,"IZAR",1
4,"4093",1882,1216,1204,11,12,"IZAR",0
29,"29068",7016,4300,4244,35,56,"IZAR",0
29,"29029",403,298,294,2,4,"IZAR",0
18,"18094",2359,1744,1720,14,24,"IZAR",0
29,"29901",43826,29318,29107,250,211,"IZAR",21
4,"4099",4989,3636,3588,27,48,"IZAR",0
4,"4103",1476,1018,1008,3,10,"IZAR",0
29,"29023",2081,1354,1340,4,14,"IZAR",1
18,"18085",720,507,499,3,8,"IZAR",0
18,"18038",1066,828,802,1,26,"IZAR",0
29,"29039",2666,1898,1873,22,25,"IZAR",3
18,"18084",4257,3107,3075,26,32,"IZAR",2
18,"18141",404,285,282,0,3,"IZAR",2
18,"18147",3729,2335,2304,16,31,"IZAR",2
4,"4102",13694,8944,8865,50,79,"IZAR",8
18,"18036",3851,2870,2841,17,29,"IZAR",1
18,"18177",418,258,256,0,2,"IZAR",0
4,"4081",355,287,287,0,0,"IZAR",0
29,"29026",1057,751,748,5,3,"IZAR",3
29,"29058",1450,911,894,4,17,"IZAR",0
29,"29095",3321,2376,2307,24,69,"IZAR",0
29,"29060",692,510,508,1,2,"IZAR",0
4,"4034",160,99,99,2,0,"IZAR",0
18,"18074",262,201,200,2,1,"IZAR",0
18,"18109",597,411,408,2,3,"IZAR",1
4,"4052",12274,8372,8306,93,66,"IZAR",3
4,"4902",45437,28936,28699,214,237,"IZAR",5
18,"18122",16114,11098,10945,83,153,"IZAR",6
4,"4100",8768,5390,5353,32,37,"IZAR",2
29,"29074",794,586,581,0,5,"IZAR",0
4,"4087",182,135,135,0,0,"IZAR",0
4,"4065",363,284,282,7,2,"IZAR",1
18,"18061",1057,812,804,1,8,"IZAR",0
29,"29062",654,551,545,2,6,"IZAR",0
18,"18068",1569,1189,1166,6,23,"IZAR",1
18,"18134",5828,3840,3800,36,40,"IZAR",0
4,"4082",297,200,200,0,0,"IZAR",0
18,"18042",403,324,322,2,2,"IZAR",0
18,"18071",5579,4044,3985,37,59,"IZAR",1
18,"18023",15655,10879,10774,82,105,"IZAR",10
4,"4057",1325,894,884,5,10,"IZAR",0
18,"18065",618,496,470,3,26,"IZAR",0
29,"29076",2153,1390,1360,10,30,"IZAR",0
29,"29007",27491,19071,18910,153,161,"IZAR",8
18,"18126",1483,1081,1074,15,7,"IZAR",1
29,"29027",2326,1626,1609,12,17,"IZAR",1
29,"29067",424813,286785,284689,2351,2096,"IZAR",169
4,"4001",1062,823,814,5,9,"IZAR",0
18,"18114",609,424,422,8,2,"IZAR",2
29,"29013",1610,1238,1207,9,31,"IZAR",3
18,"18161",212,175,174,3,1,"IZAR",0
29,"29089",3228,2377,2321,10,56,"IZAR",0
18,"18178",719,549,544,4,5,"IZAR",0
4,"4048",1503,1090,1085,9,5,"IZAR",0
4,"4083",1776,1345,1336,6,9,"IZAR",0
29,"29086",793,470,470,3,0,"IZAR",1
29,"29063",323,250,245,1,5,"IZAR",0
18,"18907",1843,1393,1388,4,5,"IZAR",1
4,"4031",2338,1772,1762,2,10,"IZAR",0
18,"18162",938,698,686,1,12,"IZAR",0
18,"18044",181,107,107,0,0,"IZAR",0
4,"4060",445,348,345,5,3,"IZAR",0
18,"18021",17485,11800,11669,95,131,"IZAR",2
18,"18102",8400,5592,5504,44,88,"IZAR",0
4,"4075",5196,3735,3706,23,29,"IZAR",0
18,"18043",123,80,79,1,1,"IZAR",0
4,"4077",295,263,261,2,2,"IZAR",0
18,"18059",4180,2907,2870,20,37,"IZAR",0
18,"18151",260,171,170,3,1,"IZAR",0
18,"18049",595,459,452,3,7,"IZAR",0
4,"4030",1119,819,812,5,7,"IZAR",0
29,"29011",2900,1822,1803,9,19,"IZAR",0
18,"18914",1649,1238,1213,3,25,"IZAR",1
4,"4054",358,285,281,2,4,"IZAR",0
29,"29045",1684,1178,1168,8,10,"IZAR",0
29,"29044",809,561,561,3,0,"IZAR",0
29,"29024",386,227,219,2,8,"IZAR",0
29,"29049",2962,2132,2110,5,22,"IZAR",2
18,"18903",889,669,661,5,8,"IZAR",0
29,"29097",4108,2871,2821,37,50,"IZAR",4
4,"4020",288,201,197,0,4,"IZAR",0
29,"29019",878,652,636,3,16,"IZAR",0
29,"29008",14596,9519,9407,94,112,"IZAR",2
18,"18035",1232,992,988,6,4,"IZAR",0
29,"29038",17676,11056,10970,141,86,"IZAR",3
18,"18140",43496,28038,27872,212,166,"IZAR",7
4,"4033",135,97,93,1,4,"IZAR",0
18,"18020",1028,691,686,3,5,"IZAR",0
29,"29003",983,754,743,1,11,"IZAR",1
18,"18022",13432,8491,8407,67,84,"IZAR",5
4,"4058",354,261,259,1,2,"IZAR",0
18,"18010",566,427,421,1,6,"IZAR",1
29,"29041",3175,2090,2045,24,45,"IZAR",2
18,"18127",16635,11440,11332,91,108,"IZAR",3
18,"18097",960,693,685,5,8,"IZAR",0
18,"18136",1851,1354,1337,5,17,"IZAR",0
4,"4055",371,310,308,0,2,"IZAR",0
18,"18048",2387,1683,1662,8,21,"IZAR",1
18,"18034",505,366,364,1,2,"IZAR",0
4,"4061",638,506,498,4,8,"IZAR",0
4,"4029",8859,5834,5790,35,44,"IZAR",1
18,"18089",14719,10163,10099,63,64,"IZAR",1
29,"29017",6553,4744,4668,33,76,"IZAR",4
18,"18028",928,765,758,2,7,"IZAR",0
29,"29072",3262,2382,2352,17,30,"IZAR",1
29,"29091",8957,6186,6078,56,108,"IZAR",2
18,"18187",557,383,379,0,4,"IZAR",0
18,"18163",324,235,233,2,2,"IZAR",0
29,"29094",57554,38071,37696,339,375,"IZAR",19
29,"29015",31880,22220,21952,190,268,"IZAR",10
18,"18040",231,136,133,0,3,"IZAR",0
4,"4089",742,521,518,1,3,"IZAR",2
18,"18154",1007,664,660,2,4,"IZAR",0
29,"29085",144,109,108,0,1,"IZAR",0
29,"29048",1405,1121,1110,8,11,"IZAR",0
18,"18167",1895,1258,1250,4,8,"IZAR",1
29,"29022",179,137,136,0,1,"IZAR",0
4,"4017",1296,857,854,5,3,"IZAR",0
29,"29093",2214,1643,1621,3,22,"IZAR",0
4,"4044",1547,1166,1156,5,10,"IZAR",0
18,"18106",425,293,290,0,3,"IZAR",0
18,"18066",2107,1392,1384,4,8,"IZAR",0
18,"18095",1967,1450,1430,11,20,"IZAR",1
4,"4012",191,161,161,0,0,"IZAR",0
29,"29096",2810,1944,1909,31,35,"IZAR",2
29,"29052",224,144,144,3,0,"IZAR",0
18,"18014",6581,4584,4545,37,39,"IZAR",2
18,"18076",804,551,549,1,2,"IZAR",0
29,"29030",805,620,614,4,6,"IZAR",0
29,"29046",2675,1825,1807,14,18,"IZAR",1
18,"18046",1832,1160,1140,6,20,"IZAR",1
4,"4004",425,329,329,0,0,"IZAR",0
18,"18030",576,413,409,6,4,"IZAR",0
29,"29051",40391,25780,25419,232,361,"IZAR",11
4,"4088",2454,1660,1650,15,10,"IZAR",1
18,"18032",246,175,174,2,1,"IZAR",0
18,"18143",973,742,730,5,12,"IZAR",1
18,"18054",849,606,605,7,1,"IZAR",0
4,"4066",13571,8786,8724,50,62,"IZAR",3
29,"29069",85684,54130,53621,455,509,"IZAR",18
4,"4024",3074,2347,2327,20,20,"IZAR",0
29,"29904",421,338,335,3,3,"IZAR",0
18,"18144",781,567,558,4,9,"IZAR",1
29,"29012",9755,6689,6599,71,90,"IZAR",15
18,"18062",10393,7235,7161,63,74,"IZAR",3
18,"18018",634,472,468,5,4,"IZAR",0
4,"4003",17357,11157,11075,64,82,"IZAR",2
18,"18193",14343,9951,9847,93,104,"IZAR",2
4,"4092",2838,2127,2103,10,24,"IZAR",0
29,"29036",632,423,416,2,7,"IZAR",0
18,"18079",3441,2442,2411,16,31,"IZAR",0
4,"4023",138,96,95,2,1,"IZAR",0
18,"18148",817,637,634,5,3,"IZAR",0
4,"4010",576,444,443,3,1,"IZAR",0
18,"18183",658,438,434,3,4,"IZAR",0
18,"18027",2570,1711,1700,13,11,"IZAR",3
4,"4035",8364,5810,5766,28,44,"IZAR",2
4,"4014",144,117,114,1,3,"IZAR",0
4,"4050",800,558,553,3,5,"IZAR",0
4,"4049",5313,3620,3579,18,41,"IZAR",1
18,"18004",714,518,509,2,9,"IZAR",0
4,"4006",7022,4792,4749,30,43,"IZAR",3
18,"18017",18114,11610,11510,77,100,"IZAR",4
4,"4074",2840,2000,1979,23,21,"IZAR",0
18,"18153",8597,6024,5972,40,52,"IZAR",2
29,"29004",312,236,233,2,3,"IZAR",0
4,"4068",187,154,152,0,2,"IZAR",0
18,"18033",282,201,200,5,1,"IZAR",0
29,"29073",1579,1091,1080,7,11,"IZAR",0
18,"18016",307,235,233,0,2,"IZAR",1
18,"18082",861,616,611,5,5,"IZAR",1
29,"29070",40333,25991,25728,214,263,"IZAR",15
29,"29077",199,149,146,2,3,"IZAR",0
18,"18152",944,707,703,0,4,"IZAR",0
29,"29005",4358,2859,2817,28,42,"IZAR",4
29,"29055",1796,1354,1336,11,18,"IZAR",1
18,"18069",502,362,357,0,5,"IZAR",0
18,"18003",14022,9938,9820,80,118,"IZAR",4
18,"18911",7473,5098,5035,51,63,"IZAR",3
29,"29071",934,596,588,3,8,"IZAR",0
4,"4013",141378,94872,94288,741,584,"IZAR",38
29,"29016",251,188,188,1,0,"IZAR",0
29,"29018",2010,1472,1420,9,52,"IZAR",0
4,"4027",250,159,159,0,0,"IZAR",0
4,"4091",334,268,267,6,1,"IZAR",0
35,"35010",3558,2341,2301,28,40,"JXC",1
35,"35032",3412,2473,2425,17,48,"JXC",4
38,"38008",5520,3825,3766,17,59,"JXC",1
35,"35029",4152,2530,2498,32,32,"JXC",0
38,"38022",18450,12334,12160,62,174,"JXC",12
35,"35015",9950,5139,5070,29,69,"JXC",7
38,"38047",1777,1198,1170,4,28,"JXC",0
38,"38010",4008,2733,2661,19,72,"JXC",1
38,"38034",4049,2855,2807,19,48,"JXC",3
38,"38045",3837,2127,2111,12,16,"JXC",1
35,"35031",7259,5037,4942,29,95,"JXC",6
38,"38901",1405,900,887,3,13,"JXC",1
38,"38044",2188,1348,1334,6,14,"JXC",2
35,"35013",6625,4896,4781,41,115,"JXC",3
35,"35024",13735,8545,8439,77,106,"JXC",2
35,"35019",32481,19318,19067,123,251,"JXC",23
38,"38052",1273,883,875,2,8,"JXC",2
38,"38016",1223,638,623,3,15,"JXC",2
38,"38026",32950,24443,24196,129,247,"JXC",34
38,"38020",15113,9928,9830,59,98,"JXC",21
38,"38003",1439,969,952,10,17,"JXC",0
38,"38049",2655,1654,1627,8,27,"JXC",1
38,"38004",4456,3026,2983,23,43,"JXC",7
38,"38025",6880,4839,4761,30,78,"JXC",1
38,"38041",6821,4908,4861,40,47,"JXC",7
35,"35003",5211,2949,2908,13,41,"JXC",2
35,"35014",11209,6016,5917,42,99,"JXC",3
38,"38007",1661,1114,1103,6,11,"JXC",1
35,"35007",511,316,309,2,7,"JXC",0
38,"38046",9113,6850,6775,40,75,"JXC",10
35,"35016",297736,192251,190256,1386,1995,"JXC",205
38,"38031",28687,21132,20858,104,274,"JXC",18
38,"38051",7194,5158,5080,31,78,"JXC",2
38,"38009",4127,2915,2868,20,47,"JXC",0
38,"38021",1629,1033,1022,9,11,"JXC",1
35,"35011",24002,15928,15684,95,244,"JXC",26
35,"35028",9776,5476,5401,43,75,"JXC",3
38,"38015",4170,2862,2836,10,26,"JXC",4
35,"35023",11686,8212,8076,55,136,"JXC",14
38,"38032",13237,8908,8828,52,80,"JXC",5
35,"35033",6398,4340,4266,19,74,"JXC",10
35,"35009",19905,14185,13961,89,224,"JXC",12
38,"38040",5021,3136,3102,14,34,"JXC",0
38,"38011",20570,13831,13698,75,133,"JXC",23
35,"35001",4584,3282,3222,26,60,"JXC",5
38,"38028",22103,15036,14844,85,192,"JXC",35
38,"38005",5468,3425,3392,18,33,"JXC",2
35,"35005",1048,747,737,8,10,"JXC",0
38,"38001",20228,11032,10936,47,96,"JXC",7
38,"38042",3802,2652,2625,14,27,"JXC",5
38,"38053",3735,2469,2435,17,34,"JXC",2
38,"38019",13200,8123,8047,36,76,"JXC",6
38,"38037",12864,8287,8163,64,124,"JXC",10
35,"35025",1797,1261,1245,4,16,"JXC",1
35,"35012",10382,5443,5392,17,51,"JXC",6
38,"38043",18892,13089,12928,87,161,"JXC",17
38,"38036",6592,4518,4440,45,78,"JXC",10
35,"35006",30457,21398,21118,162,280,"JXC",22
38,"38029",1517,744,734,1,10,"JXC",2
38,"38030",1933,1296,1290,2,6,"JXC",0
38,"38027",5414,3618,3571,16,47,"JXC",1
38,"38033",3702,2505,2464,8,41,"JXC",0
35,"35027",10344,7310,7216,50,94,"JXC",4
35,"35022",48603,29443,29042,160,401,"JXC",34
35,"35020",6034,3992,3934,20,58,"JXC",4
38,"38035",9474,5616,5564,36,52,"JXC",9
35,"35018",12552,7609,7547,54,62,"JXC",3
35,"35002",23328,15495,15313,94,182,"JXC",17
38,"38024",15077,9512,9356,55,156,"JXC",6
38,"38014",1357,935,926,3,9,"JXC",0
35,"35008",6131,4507,4459,34,48,"JXC",5
35,"35021",14924,10477,10370,45,107,"JXC",12
35,"35030",9250,5413,5326,34,87,"JXC",6
38,"38012",2347,1644,1630,7,14,"JXC",1
38,"38018",4402,3058,3011,16,47,"JXC",2
38,"38050",2462,1624,1604,8,20,"JXC",3
38,"38006",39766,20776,20587,139,189,"JXC",17
38,"38038",162027,104978,104035,575,943,"JXC",163
35,"35026",81091,51953,51195,407,758,"JXC",69
38,"38048",3901,2667,2637,20,30,"JXC",1
35,"35004",39299,20523,20294,140,229,"JXC",11
35,"35017",25676,15038,14716,94,322,"JXC",8
38,"38013",2949,1896,1867,17,29,"JXC",1
38,"38039",10641,7547,7459,49,88,"JXC",12
38,"38017",28437,16239,16075,95,164,"JXC",18
38,"38023",121908,81147,80333,494,814,"JXC",161
35,"35034",7873,3975,3943,27,32,"JXC",5
38,"38002",956,702,696,21,6,"JXC",0
31,"31044",289,230,227,1,3,"Ln",1
31,"31192",156,129,127,3,2,"Ln",0
31,"31255",102,79,79,1,0,"Ln",0
31,"31202",4305,2845,2803,31,42,"Ln",1
31,"31248",299,165,162,0,3,"Ln",0
31,"31247",151,114,113,0,1,"Ln",0
31,"31033",49,31,31,1,0,"Ln",0
31,"31040",192,139,138,4,1,"Ln",0
31,"31180",212,154,154,5,0,"Ln",2
31,"31222",62,36,34,3,2,"Ln",0
31,"31184",62,44,44,3,0,"Ln",0
31,"31059",186,131,131,1,0,"Ln",1
31,"31217",321,226,223,1,3,"Ln",1
31,"31055",257,175,172,2,3,"Ln",3
31,"31078",2429,1795,1767,15,28,"Ln",3
31,"31188",235,161,161,2,0,"Ln",1
31,"31066",855,589,579,8,10,"Ln",0
31,"31251",3115,2240,2205,15,35,"Ln",3
31,"31147",100,82,82,2,0,"Ln",0
1,"1047",968,673,668,5,5,"Ln",1
31,"31018",393,292,285,4,7,"Ln",0
31,"31122",4773,3520,3506,26,14,"Ln",22
31,"31003",122,87,87,0,0,"Ln",0
31,"31225",36,27,27,0,0,"Ln",0
31,"31088",5572,3897,3862,44,35,"Ln",8
1,"1001",1979,1339,1318,7,21,"Ln",1
31,"31151",66,46,46,1,0,"Ln",0
31,"31233",97,74,74,0,0,"Ln",0
31,"31047",254,191,188,2,3,"Ln",0
31,"31161",338,264,259,2,5,"Ln",2
31,"31240",527,327,326,2,1,"Ln",0
31,"31081",338,216,212,4,4,"Ln",6
1,"1032",517,361,354,1,7,"Ln",0
31,"31139",159,96,95,0,1,"Ln",0
31,"31025",766,524,518,6,6,"Ln",1
31,"31026",144,118,117,0,1,"Ln",0
31,"31236",1320,865,854,5,11,"Ln",2
1,"1044",236,169,167,0,2,"Ln",0
31,"31154",224,126,126,3,0,"Ln",1
31,"31214",91,64,62,1,2,"Ln",0
31,"31004",35,21,21,0,0,"Ln",0
31,"31132",145,109,109,0,0,"Ln",0
31,"31187",111,68,63,1,5,"Ln",0
31,"31043",38,31,30,1,1,"Ln",1
1,"1018",1386,939,930,3,9,"Ln",0
31,"31143",96,55,54,1,1,"Ln",0
1,"1010",2268,1623,1603,11,20,"Ln",0
31,"31022",518,332,331,4,1,"Ln",0
31,"31084",1940,1293,1274,16,19,"Ln",3
31,"31058",208,148,144,3,4,"Ln",2
1,"1051",3603,2259,2235,17,24,"Ln",1
31,"31253",129,109,109,0,0,"Ln",0
1,"1017",849,571,565,5,6,"Ln",0
31,"31029",914,638,625,6,13,"Ln",1
31,"31237",193,155,153,2,2,"Ln",1
31,"31219",84,66,66,0,0,"Ln",0
31,"31121",62,44,43,0,1,"Ln",0
31,"31114",366,245,241,8,4,"Ln",0
31,"31172",373,278,272,3,6,"Ln",1
31,"31150",213,156,155,1,1,"Ln",0
31,"31177",255,169,166,2,3,"Ln",1
31,"31191",3016,2167,2147,22,20,"Ln",3
31,"31901",15459,11119,11026,108,93,"Ln",20
31,"31245",81,55,55,2,0,"Ln",2
1,"1036",14955,10052,9959,55,93,"Ln",2
31,"31006",1927,1350,1332,13,18,"Ln",0
1,"1039",209,155,153,0,2,"Ln",0
1,"1019",150,106,105,1,1,"Ln",0
1,"1037",587,411,408,1,3,"Ln",0
1,"1042",904,653,648,6,5,"Ln",0
31,"31073",294,212,208,2,4,"Ln",2
31,"31096",113,82,79,0,3,"Ln",2
31,"31213",104,52,52,0,0,"Ln",0
31,"31051",251,170,170,2,0,"Ln",0
31,"31169",2193,1472,1445,9,27,"Ln",2
31,"31200",761,517,508,3,9,"Ln",0
1,"1052",245,184,181,0,3,"Ln",0
31,"31141",110,71,70,1,1,"Ln",0
31,"31144",796,445,444,6,1,"Ln",0
31,"31250",2810,1786,1770,19,16,"Ln",3
31,"31194",311,217,216,3,1,"Ln",0
31,"31140",117,84,84,1,0,"Ln",0
31,"31106",698,533,529,3,4,"Ln",0
31,"31007",131,87,86,1,1,"Ln",1
1,"1056",219,136,135,0,1,"Ln",0
31,"31092",662,439,435,4,4,"Ln",1
31,"31102",143,69,69,0,0,"Ln",0
31,"31149",2305,1461,1441,8,20,"Ln",1
31,"31117",620,383,375,3,8,"Ln",0
31,"31069",832,637,635,3,2,"Ln",0
1,"1021",473,310,309,0,1,"Ln",0
31,"31028",212,131,131,0,0,"Ln",0
31,"31118",164,112,111,1,1,"Ln",0
1,"1055",838,538,527,8,11,"Ln",0
31,"31129",395,234,234,0,0,"Ln",0
31,"31229",47,35,35,0,0,"Ln",0
31,"31243",306,224,221,2,3,"Ln",0
31,"31077",5352,3908,3848,41,60,"Ln",4
31,"31080",508,391,385,3,6,"Ln",1
31,"31125",274,194,193,6,1,"Ln",2
31,"31015",1994,1412,1392,25,20,"Ln",1
31,"31905",2843,1983,1966,15,17,"Ln",1
31,"31185",494,341,341,1,0,"Ln",4
31,"31258",7879,5707,5666,50,41,"Ln",13
31,"31023",6956,5310,5289,85,21,"Ln",7
31,"31021",62,39,38,0,1,"Ln",0
31,"31256",107,59,59,0,0,"Ln",0
31,"31254",1915,1428,1411,3,17,"Ln",2
31,"31198",37,25,25,0,0,"Ln",0
31,"31168",246,172,171,1,1,"Ln",0
1,"1043",2304,1552,1532,13,20,"Ln",1
31,"31011",693,459,456,8,3,"Ln",0
31,"31216",3865,2702,2671,33,31,"Ln",9
1,"1009",1265,849,845,2,4,"Ln",2
31,"31210",196,152,152,2,0,"Ln",0
31,"31228",486,341,337,2,4,"Ln",0
31,"31223",985,704,698,4,6,"Ln",0
31,"31221",1214,798,786,12,12,"Ln",1
31,"31012",793,563,555,6,8,"Ln",2
31,"31120",388,250,249,3,1,"Ln",0
31,"31205",427,299,297,4,2,"Ln",0
31,"31232",25155,17648,17450,196,198,"Ln",14
31,"31095",75,59,59,1,0,"Ln",1
1,"1061",154,127,127,1,0,"Ln",0
31,"31239",322,211,211,5,0,"Ln",0
31,"31103",42,34,34,2,0,"Ln",0
31,"31124",208,148,148,2,0,"Ln",0
31,"31032",1713,1209,1193,24,16,"Ln",2
1,"1053",582,321,320,4,1,"Ln",0
1,"1041",149,103,100,1,3,"Ln",0
1,"1016",433,228,226,5,2,"Ln",0
31,"31128",359,265,263,0,2,"Ln",2
1,"1002",8124,5722,5654,31,68,"Ln",1
31,"31085",480,350,350,2,0,"Ln",1
31,"31083",52,37,37,0,0,"Ln",0
31,"31079",73,54,53,0,1,"Ln",0
31,"31193",1426,1024,1013,13,11,"Ln",1
31,"31262",228,179,178,5,1,"Ln",1
1,"1059",186557,126506,125278,798,1228,"Ln",59
31,"31045",508,355,350,8,5,"Ln",2
31,"31036",909,636,628,7,8,"Ln",0
31,"31138",932,601,599,2,2,"Ln",1
31,"31156",251,189,188,0,1,"Ln",1
31,"31261",231,173,169,3,4,"Ln",0
31,"31019",1785,1254,1238,9,16,"Ln",2
31,"31190",45,34,32,2,2,"Ln",0
31,"31906",2562,1800,1779,26,21,"Ln",6
31,"31902",4405,3092,3061,25,31,"Ln",0
1,"1062",313,211,210,2,1,"Ln",0
31,"31142",1403,958,949,10,9,"Ln",2
1,"1902",734,514,502,4,12,"Ln",0
1,"1028",1070,716,710,3,6,"Ln",0
31,"31209",155,107,106,0,1,"Ln",0
31,"31111",95,65,65,2,0,"Ln",0
31,"31136",447,299,298,2,1,"Ln",0
31,"31227",8180,5885,5809,76,76,"Ln",12
31,"31241",133,98,98,2,0,"Ln",0
31,"31061",54,49,49,0,0,"Ln",0
31,"31100",262,170,168,1,2,"Ln",2
1,"1020",327,237,234,3,3,"Ln",0
31,"31207",273,182,177,2,5,"Ln",0
31,"31115",165,102,101,1,1,"Ln",0
31,"31171",680,495,486,8,9,"Ln",0
31,"31135",106,70,66,2,4,"Ln",0
31,"31010",5705,3718,3680,29,38,"Ln",3
31,"31039",80,61,60,0,1,"Ln",0
31,"31110",91,61,58,1,3,"Ln",1
31,"31116",62,51,50,1,1,"Ln",0
31,"31091",351,220,217,1,3,"Ln",2
31,"31098",1903,1428,1419,19,9,"Ln",3
31,"31089",242,172,170,1,2,"Ln",0
31,"31175",71,48,48,0,0,"Ln",0
31,"31127",138,98,95,0,3,"Ln",0
31,"31027",836,532,530,2,2,"Ln",0
1,"1014",371,280,272,4,8,"Ln",0
31,"31131",901,646,638,7,8,"Ln",1
1,"1008",786,513,509,11,4,"Ln",0
31,"31206",2090,1461,1440,22,21,"Ln",3
31,"31068",2885,2060,2027,20,33,"Ln",0
31,"31176",2869,2010,1963,33,47,"Ln",1
31,"31183",691,544,542,4,2,"Ln",1
31,"31057",1781,1287,1268,10,19,"Ln",14
31,"31178",490,345,342,3,3,"Ln",0
31,"31053",523,372,368,1,4,"Ln",0
31,"31145",172,128,128,4,0,"Ln",0
31,"31195",182,130,128,0,2,"Ln",0
31,"31009",677,507,505,5,2,"Ln",0
31,"31060",13744,9400,9320,72,80,"Ln",33
31,"31126",358,223,223,2,0,"Ln",0
31,"31054",462,255,250,4,5,"Ln",0
31,"31134",176,125,124,0,1,"Ln",0
31,"31908",1004,686,682,2,4,"Ln",1
31,"31002",414,288,287,3,1,"Ln",1
31,"31215",4676,3284,3240,36,44,"Ln",3
31,"31146",35,30,29,1,1,"Ln",0
31,"31086",13188,9713,9642,111,71,"Ln",13
31,"31090",144,77,77,1,0,"Ln",0
31,"31042",2714,1974,1942,22,32,"Ln",2
31,"31260",1238,794,788,12,6,"Ln",0
31,"31063",92,75,73,2,2,"Ln",0
31,"31257",875,634,625,8,9,"Ln",1
31,"31265",82,53,53,2,0,"Ln",0
31,"31204",36,28,28,1,0,"Ln",0
31,"31179",502,348,345,0,3,"Ln",0
31,"31024",99,42,42,0,0,"Ln",0
31,"31099",62,47,47,2,0,"Ln",0
31,"31062",1087,830,818,3,12,"Ln",0
31,"31158",255,180,179,3,1,"Ln",0
31,"31046",57,39,39,1,0,"Ln",0
31,"31104",1834,1257,1235,16,22,"Ln",1
31,"31242",260,164,163,1,1,"Ln",0
31,"31152",1328,924,900,11,24,"Ln",4
31,"31108",1855,1368,1348,7,20,"Ln",3
31,"31056",174,121,120,0,1,"Ln",0
31,"31199",146,92,89,3,3,"Ln",0
1,"1027",416,257,254,3,3,"Ln",0
31,"31075",103,63,63,0,0,"Ln",0
31,"31170",47,42,42,3,0,"Ln",0
31,"31119",39,26,26,0,0,"Ln",0
31,"31235",159,117,115,2,2,"Ln",1
31,"31087",171,128,124,2,4,"Ln",0
31,"31203",40,28,28,0,0,"Ln",0
31,"31212",147,102,102,4,0,"Ln",0
31,"31907",10745,8067,8009,116,58,"Ln",10
31,"31211",27,15,15,1,0,"Ln",0
31,"31234",144,106,106,4,0,"Ln",0
31,"31112",89,62,62,0,0,"Ln",0
31,"31017",358,242,239,0,3,"Ln",0
31,"31181",145,112,112,0,0,"Ln",1
1,"1054",960,654,651,4,3,"Ln",1
31,"31071",17,16,16,0,0,"Ln",0
31,"31157",3518,2298,2267,23,31,"Ln",5
1,"1013",712,454,450,0,4,"Ln",0
31,"31904",1563,1029,1022,23,7,"Ln",1
31,"31246",140,111,107,1,4,"Ln",0
31,"31037",84,66,66,1,0,"Ln",0
31,"31174",110,63,63,0,0,"Ln",0
31,"31008",75,54,54,2,0,"Ln",0
31,"31109",1582,1155,1150,9,5,"Ln",1
31,"31133",43,28,28,0,0,"Ln",0
31,"31259",484,291,286,2,5,"Ln",0
31,"31224",893,671,662,3,9,"Ln",1
31,"31049",699,469,465,2,4,"Ln",0
31,"31020",449,228,228,3,0,"Ln",1
31,"31038",1339,957,942,11,15,"Ln",5
31,"31097",10410,7082,7002,75,80,"Ln",9
31,"31072",5279,3734,3679,40,55,"Ln",2
31,"31016",7608,5474,5413,50,61,"Ln",7
31,"31031",220,131,129,0,2,"Ln",0
31,"31153",2159,1403,1387,12,16,"Ln",4
31,"31231",117,76,73,1,3,"Ln",2
31,"31167",826,606,596,9,10,"Ln",2
31,"31094",111,82,82,0,0,"Ln",0
31,"31903",6654,4402,4343,27,59,"Ln",7
31,"31048",176,132,130,4,2,"Ln",0
31,"31065",1878,1351,1326,20,25,"Ln",6
31,"31093",292,188,188,2,0,"Ln",0
31,"31035",59,45,43,0,2,"Ln",2
31,"31113",133,87,86,0,1,"Ln",2
1,"1046",601,432,428,3,4,"Ln",0
31,"31014",275,194,192,4,2,"Ln",0
31,"31013",642,406,401,1,5,"Ln",1
1,"1031",1169,882,863,6,19,"Ln",1
1,"1033",651,484,479,2,5,"Ln",0
31,"31160",106,89,88,2,1,"Ln",0
1,"1022",799,557,544,2,13,"Ln",0
31,"31252",87,61,61,0,0,"Ln",0
31,"31208",2556,1949,1920,16,29,"Ln",1
31,"31159",1107,844,833,6,11,"Ln",3
1,"1004",1399,1008,995,8,13,"Ln",0
31,"31082",617,371,365,10,6,"Ln",0
31,"31226",591,342,340,2,2,"Ln",1
31,"31249",1872,1290,1273,14,17,"Ln",2
31,"31238",112,93,93,0,0,"Ln",1
1,"1034",161,124,123,1,1,"Ln",0
31,"31005",301,212,211,3,1,"Ln",2
31,"31186",299,195,194,3,1,"Ln",1
1,"1030",156,129,129,3,0,"Ln",2
31,"31130",312,214,213,3,1,"Ln",1
31,"31076",2417,1918,1906,9,12,"Ln",1
31,"31162",47,31,31,0,0,"Ln",0
31,"31123",647,369,361,5,8,"Ln",1
1,"1060",197,160,157,0,3,"Ln",0
31,"31165",2780,1995,1960,30,35,"Ln",0
1,"1003",1190,782,774,2,8,"Ln",0
31,"31189",1161,720,709,6,11,"Ln",0
31,"31050",6014,3489,3450,57,39,"Ln",3
31,"31052",96,62,61,0,1,"Ln",0
31,"31105",1507,1167,1142,7,25,"Ln",1
31,"31137",205,112,109,6,3,"Ln",0
31,"31034",37,25,25,0,0,"Ln",0
1,"1057",240,201,200,1,1,"Ln",0
31,"31001",88,62,62,0,0,"Ln",0
1,"1901",2354,1592,1571,8,21,"Ln",0
31,"31148",92,69,69,5,0,"Ln",0
31,"31230",106,82,82,1,0,"Ln",0
1,"1049",138,109,109,1,0,"Ln",0
31,"31163",2013,1418,1383,13,35,"Ln",1
1,"1006",175,140,140,0,0,"Ln",0
1,"1058",1345,799,793,7,6,"Ln",0
1,"1023",267,187,186,1,1,"Ln",1
31,"31101",1373,973,966,8,7,"Ln",1
31,"31264",180,105,101,2,4,"Ln",0
31,"31107",1710,1255,1243,16,12,"Ln",2
31,"31201",147715,105455,104658,1007,797,"Ln",149
31,"31067",1922,1312,1294,10,18,"Ln",1
31,"31196",38,35,35,1,0,"Ln",0
31,"31182",34,28,28,0,0,"Ln",0
31,"31244",158,87,86,1,1,"Ln",1
31,"31070",2638,1808,1784,20,24,"Ln",1
31,"31030",141,100,99,0,1,"Ln",0
31,"31155",256,169,167,2,2,"Ln",0
31,"31164",568,421,417,5,4,"Ln",0
1,"1011",235,174,171,4,3,"Ln",0
31,"31197",69,56,56,2,0,"Ln",0
31,"31074",387,286,286,5,0,"Ln",0
31,"31263",233,138,137,2,1,"Ln",0
31,"31166",258,181,181,1,0,"Ln",0
31,"31173",861,683,667,3,16,"Ln",0
1,"1063",1798,1269,1261,19,8,"Ln",1
31,"31064",1424,1121,1104,3,17,"Ln",1
31,"31041",1606,1114,1101,15,13,"Ln",2
31,"31220",744,583,579,8,4,"Ln",2
44,"44023",17,16,16,0,0,"MAS",0
50,"50039",491,392,390,2,2,"MAS",0
50,"50102",859,658,653,8,5,"MAS",0
22,"22252",121,86,81,0,5,"MAS",0
50,"50175",1002,695,688,5,7,"MAS",0
44,"44089",45,39,39,1,0,"MAS",0
44,"44187",201,152,149,4,3,"MAS",0
22,"22081",254,181,181,0,0,"MAS",0
44,"44189",56,41,41,0,0,"MAS",0
22,"22143",217,143,141,1,2,"MAS",0
22,"22209",155,120,120,3,0,"MAS",0
50,"50078",235,177,173,0,4,"MAS",0
44,"44216",26555,18997,18737,168,260,"MAS",13
22,"22220",166,126,125,2,1,"MAS",0
44,"44049",849,616,604,9,12,"MAS",0
22,"22247",33,20,20,0,0,"MAS",0
50,"50134",128,91,89,2,2,"MAS",0
50,"50186",42,31,31,0,0,"MAS",1
44,"44163",126,94,94,1,0,"MAS",0
44,"44175",122,85,84,1,1,"MAS",0
44,"44029",559,425,424,5,1,"MAS",0
44,"44135",113,88,87,0,1,"MAS",0
22,"22172",556,372,370,6,2,"MAS",0
22,"22217",385,287,281,1,6,"MAS",0
50,"50069",73,53,53,1,0,"MAS",0
50,"50089",8225,6074,6043,43,31,"MAS",9
50,"50146",187,145,144,3,1,"MAS",0
50,"50267",602,433,430,8,3,"MAS",1
50,"50294",70,63,63,0,0,"MAS",0
50,"50177",308,245,244,4,1,"MAS",0
44,"44012",334,263,261,5,2,"MAS",0
50,"50141",109,90,90,1,0,"MAS",0
50,"50050",98,64,64,2,0,"MAS",0
50,"50110",367,256,254,0,2,"MAS",0
44,"44074",429,333,326,4,7,"MAS",0
22,"22029",127,100,100,0,0,"MAS",0
22,"22127",505,374,371,3,3,"MAS",0
44,"44067",114,81,81,1,0,"MAS",0
22,"22019",180,151,150,2,1,"MAS",0
50,"50002",143,108,104,1,4,"MAS",0
50,"50170",371,283,280,0,3,"MAS",0
50,"50173",182,132,131,1,1,"MAS",0
22,"22244",52,38,37,0,1,"MAS",0
44,"44153",1774,1135,1121,5,14,"MAS",3
44,"44046",49,34,34,1,0,"MAS",0
44,"44045",366,274,269,2,5,"MAS",1
22,"22080",280,197,194,6,3,"MAS",0
44,"44038",104,83,82,0,1,"MAS",0
22,"22136",806,588,588,5,0,"MAS",2
50,"50010",68,58,58,0,0,"MAS",0
50,"50133",113,80,80,4,0,"MAS",0
44,"44018",19,19,19,0,0,"MAS",0
44,"44039",221,165,159,0,6,"MAS",0
50,"50026",439,335,325,10,10,"MAS",0
50,"50048",34,29,29,0,0,"MAS",0
50,"50045",1243,926,925,6,1,"MAS",0
44,"44014",2521,1896,1867,8,29,"MAS",7
22,"22175",197,143,142,1,1,"MAS",0
22,"22222",530,384,379,3,5,"MAS",0
22,"22189",185,145,144,5,1,"MAS",0
44,"44075",323,248,246,0,2,"MAS",0
22,"22212",79,64,62,0,2,"MAS",0
44,"44084",54,41,41,0,0,"MAS",0
50,"50205",90,63,61,0,2,"MAS",0
22,"22012",111,87,86,3,1,"MAS",0
44,"44062",34,25,22,0,3,"MAS",0
22,"22014",243,192,188,3,4,"MAS",0
50,"50232",175,110,110,3,0,"MAS",0
44,"44090",78,53,53,0,0,"MAS",0
22,"22116",1430,1004,994,5,10,"MAS",1
44,"44249",55,44,44,2,0,"MAS",0
50,"50114",116,89,88,0,1,"MAS",0
44,"44205",700,460,453,4,7,"MAS",0
50,"50147",777,552,552,2,0,"MAS",0
22,"22103",682,508,502,3,6,"MAS",0
44,"44192",355,280,278,4,2,"MAS",1
22,"22035",234,165,159,3,6,"MAS",0
44,"44053",105,78,78,0,0,"MAS",1
22,"22902",221,159,156,0,3,"MAS",0
50,"50015",96,67,67,0,0,"MAS",0
44,"44052",77,56,56,0,0,"MAS",0
44,"44042",123,91,90,0,1,"MAS",0
44,"44159",38,31,31,1,0,"MAS",0
44,"44221",372,303,300,1,3,"MAS",0
44,"44120",222,154,150,2,4,"MAS",0
44,"44009",809,596,593,7,3,"MAS",0
44,"44124",77,64,64,3,0,"MAS",0
44,"44238",2323,1603,1590,5,13,"MAS",5
22,"22052",925,712,710,8,2,"MAS",0
22,"22253",61,52,52,0,0,"MAS",0
50,"50239",62,50,48,0,2,"MAS",0
22,"22177",98,75,75,0,0,"MAS",0
50,"50270",38,26,26,0,0,"MAS",0
50,"50285",644,436,434,2,2,"MAS",2
22,"22201",266,188,187,3,1,"MAS",0
22,"22061",6630,4555,4526,40,29,"MAS",5
50,"50079",249,175,174,0,1,"MAS",0
22,"22079",118,83,83,1,0,"MAS",0
44,"44047",220,137,132,2,5,"MAS",0
50,"50033",66,49,48,0,1,"MAS",0
22,"22901",742,478,470,5,8,"MAS",0
22,"22040",144,117,115,1,2,"MAS",0
44,"44169",342,252,252,3,0,"MAS",0
44,"44113",71,52,52,0,0,"MAS",1
44,"44177",115,84,84,1,0,"MAS",0
22,"22075",125,83,83,1,0,"MAS",0
50,"50269",285,193,188,0,5,"MAS",0
22,"22232",93,71,69,1,2,"MAS",0
44,"44002",47,40,40,0,0,"MAS",0
50,"50201",448,339,335,7,4,"MAS",0
22,"22109",261,191,190,1,1,"MAS",0
44,"44118",164,132,131,2,1,"MAS",0
44,"44094",113,94,94,0,0,"MAS",1
44,"44125",61,44,44,0,0,"MAS",0
50,"50160",2238,1546,1528,12,18,"MAS",0
50,"50240",1025,729,718,10,11,"MAS",0
50,"50081",511,382,378,4,4,"MAS",0
22,"22110",738,531,527,4,4,"MAS",0
22,"22158",11995,8197,8126,62,71,"MAS",6
22,"22200",244,184,182,5,2,"MAS",1
44,"44055",69,56,56,4,0,"MAS",0
22,"22199",7000,4737,4688,104,49,"MAS",6
44,"44198",182,147,146,4,1,"MAS",0
50,"50172",193,132,129,1,3,"MAS",0
50,"50075",80,62,61,1,1,"MAS",0
50,"50032",261,189,189,5,0,"MAS",0
50,"50144",34,29,29,2,0,"MAS",0
50,"50070",60,36,36,0,0,"MAS",0
44,"44243",24,20,20,0,0,"MAS",0
50,"50007",45,34,34,1,0,"MAS",0
50,"50193",651,514,501,2,13,"MAS",0
22,"22124",201,144,143,1,1,"MAS",0
50,"50278",197,145,145,0,0,"MAS",0
44,"44224",22,14,14,0,0,"MAS",0
22,"22204",1114,745,739,12,6,"MAS",0
44,"44165",175,135,133,2,2,"MAS",0
50,"50231",250,195,192,4,3,"MAS",0
22,"22009",617,444,441,6,3,"MAS",0
50,"50265",79,61,61,0,0,"MAS",0
44,"44228",100,82,82,0,0,"MAS",0
50,"50242",93,75,75,3,0,"MAS",0
44,"44161",443,314,313,2,1,"MAS",0
44,"44044",88,72,71,2,1,"MAS",0
22,"22208",188,150,145,0,5,"MAS",1
44,"44236",63,48,47,0,1,"MAS",1
22,"22044",252,198,197,0,1,"MAS",0
22,"22167",493,388,381,9,7,"MAS",0
50,"50262",1170,896,887,15,9,"MAS",1
22,"22126",88,64,64,0,0,"MAS",0
44,"44131",25,20,20,0,0,"MAS",0
44,"44017",285,227,223,4,4,"MAS",0
22,"22083",463,394,390,5,4,"MAS",0
50,"50142",26,17,17,0,0,"MAS",0
44,"44024",27,25,25,0,0,"MAS",0
22,"22906",186,141,139,3,2,"MAS",0
50,"50253",423,330,328,4,2,"MAS",0
50,"50243",331,250,246,0,4,"MAS",0
50,"50099",3083,2148,2132,13,16,"MAS",0
44,"44006",248,185,183,2,2,"MAS",0
22,"22074",313,228,225,4,3,"MAS",0
22,"22174",478,379,378,2,1,"MAS",0
50,"50287",270,191,191,0,0,"MAS",0
50,"50121",277,216,214,1,2,"MAS",0
44,"44261",739,536,529,6,7,"MAS",0
22,"22125",38773,27021,26732,258,289,"MAS",20
22,"22046",728,566,561,5,5,"MAS",0
50,"50202",152,100,99,1,1,"MAS",0
44,"44102",30,27,26,0,1,"MAS",0
50,"50162",146,109,105,4,4,"MAS",0
50,"50248",508,387,374,2,13,"MAS",0
44,"44007",173,122,121,4,1,"MAS",0
22,"22239",88,72,72,0,0,"MAS",0
22,"22028",371,282,280,3,2,"MAS",0
44,"44117",340,271,268,4,3,"MAS",0
22,"22111",154,103,102,0,1,"MAS",0
44,"44262",135,108,107,2,1,"MAS",0
44,"44059",544,425,412,9,13,"MAS",0
50,"50176",236,165,165,3,0,"MAS",0
50,"50017",1773,1276,1269,13,7,"MAS",2
44,"44232",378,284,276,6,8,"MAS",0
44,"44151",190,151,148,0,3,"MAS",0
44,"44016",482,363,360,2,3,"MAS",0
44,"44218",35,28,28,1,0,"MAS",0
44,"44252",86,65,65,0,0,"MAS",0
44,"44207",156,118,115,4,3,"MAS",0
50,"50098",174,130,124,0,6,"MAS",0
22,"22157",192,129,128,3,1,"MAS",2
22,"22242",62,45,44,0,1,"MAS",0
50,"50197",90,67,67,2,0,"MAS",0
50,"50080",33,27,27,0,0,"MAS",0
44,"44181",76,57,56,0,1,"MAS",0
44,"44158",1180,876,862,10,14,"MAS",1
50,"50218",113,91,91,1,0,"MAS",0
50,"50018",953,656,655,1,1,"MAS",0
22,"22206",193,129,128,1,1,"MAS",0
44,"44230",155,123,123,2,0,"MAS",0
50,"50061",202,172,172,3,0,"MAS",0
50,"50260",33,33,32,0,1,"MAS",0
50,"50157",290,220,218,3,2,"MAS",1
22,"22193",276,225,224,2,1,"MAS",0
50,"50280",332,253,250,0,3,"MAS",0
50,"50009",105,80,80,0,0,"MAS",0
50,"50198",54,41,41,1,0,"MAS",0
44,"44077",74,60,58,0,2,"MAS",0
22,"22904",815,579,575,8,4,"MAS",0
50,"50043",253,171,171,0,0,"MAS",0
44,"44160",466,304,301,2,3,"MAS",0
50,"50065",53,43,43,0,0,"MAS",0
22,"22042",117,95,92,0,3,"MAS",0
50,"50288",3387,2415,2398,31,17,"MAS",2
44,"44210",746,554,545,3,9,"MAS",0
22,"22162",130,102,102,0,0,"MAS",0
22,"22057",370,271,270,3,1,"MAS",2
50,"50130",383,240,238,2,2,"MAS",0
50,"50247",823,588,581,3,7,"MAS",1
22,"22050",88,77,77,0,0,"MAS",0
22,"22089",302,225,223,0,2,"MAS",0
44,"44173",101,81,79,2,2,"MAS",0
50,"50083",89,75,75,1,0,"MAS",0
44,"44054",108,85,85,2,0,"MAS",0
22,"22017",866,650,642,5,8,"MAS",0
50,"50275",108,55,55,0,0,"MAS",0
44,"44005",50,30,30,0,0,"MAS",0
50,"50131",231,167,165,0,2,"MAS",0
44,"44011",52,40,38,0,2,"MAS",0
44,"44229",152,112,111,3,1,"MAS",0
44,"44031",97,62,62,0,0,"MAS",0
50,"50128",26,25,25,1,0,"MAS",0
22,"22223",75,58,58,0,0,"MAS",1
50,"50221",35,17,17,0,0,"MAS",0
44,"44219",194,145,143,1,2,"MAS",0
50,"50149",34,24,24,0,0,"MAS",0
22,"22250",353,261,258,4,3,"MAS",0
50,"50283",70,57,57,1,0,"MAS",0
44,"44226",140,98,98,2,0,"MAS",0
44,"44142",35,27,27,0,0,"MAS",0
22,"22236",253,200,200,0,0,"MAS",0
50,"50161",106,75,72,0,3,"MAS",0
50,"50233",106,81,81,0,0,"MAS",0
50,"50263",193,121,121,0,0,"MAS",0
44,"44109",108,73,73,0,0,"MAS",0
50,"50150",649,402,397,2,5,"MAS",0
50,"50118",2165,1552,1540,10,12,"MAS",0
44,"44013",11244,7815,7712,82,103,"MAS",6
44,"44257",166,123,119,1,4,"MAS",0
50,"50274",71,55,55,0,0,"MAS",0
44,"44085",52,35,35,0,0,"MAS",0
22,"22020",115,86,86,1,0,"MAS",0
50,"50223",920,712,701,4,11,"MAS",0
50,"50055",3611,2445,2407,22,38,"MAS",2
50,"50068",1982,1348,1335,8,13,"MAS",2
50,"50268",44,37,37,0,0,"MAS",0
44,"44265",186,141,138,2,3,"MAS",0
44,"44068",659,509,503,3,6,"MAS",0
50,"50295",48,43,42,0,1,"MAS",0
50,"50254",180,118,116,1,2,"MAS",0
50,"50014",147,94,94,0,0,"MAS",1
44,"44258",67,47,47,0,0,"MAS",0
50,"50140",166,115,115,0,0,"MAS",0
50,"50024",571,437,437,6,0,"MAS",0
50,"50200",511,410,403,2,7,"MAS",0
50,"50252",5138,3642,3611,24,31,"MAS",2
22,"22249",116,95,95,4,0,"MAS",0
50,"50292",125,102,102,1,0,"MAS",1
44,"44145",1020,719,709,9,10,"MAS",0
50,"50210",38,30,30,1,0,"MAS",0
22,"22227",206,163,160,3,3,"MAS",0
22,"22059",1149,807,800,3,7,"MAS",2
50,"50076",78,66,65,0,1,"MAS",0
44,"44245",248,179,176,2,3,"MAS",0
22,"22243",45,28,28,0,0,"MAS",0
44,"44178",58,37,37,0,0,"MAS",0
44,"44132",60,54,54,1,0,"MAS",0
22,"22067",65,50,50,1,0,"MAS",0
44,"44260",137,91,89,3,2,"MAS",0
50,"50185",133,108,108,1,0,"MAS",0
50,"50236",102,79,77,0,2,"MAS",0
50,"50277",50,42,41,0,1,"MAS",0
44,"44088",29,21,21,0,0,"MAS",0
22,"22113",495,370,368,4,2,"MAS",0
44,"44223",72,54,54,0,0,"MAS",0
50,"50088",302,246,237,5,9,"MAS",0
50,"50016",52,40,40,0,0,"MAS",0
22,"22254",1124,801,792,11,9,"MAS",0
44,"44268",25,25,24,0,1,"MAS",0
22,"22088",153,110,110,2,0,"MAS",0
44,"44227",74,63,62,0,1,"MAS",0
22,"22137",1069,727,718,3,9,"MAS",0
50,"50037",136,98,96,0,2,"MAS",0
50,"50006",925,674,657,6,17,"MAS",0
44,"44130",34,24,24,0,0,"MAS",0
22,"22178",103,82,81,0,1,"MAS",0
50,"50151",636,499,499,0,0,"MAS",0
22,"22001",225,151,151,1,0,"MAS",0
50,"50122",68,52,52,1,0,"MAS",0
50,"50126",2371,1573,1559,19,14,"MAS",1
50,"50111",180,143,143,0,0,"MAS",0
22,"22043",93,66,65,0,1,"MAS",0
22,"22024",226,174,171,3,3,"MAS",0
22,"22230",284,216,216,1,0,"MAS",1
50,"50245",88,65,64,0,1,"MAS",1
44,"44199",44,41,41,2,0,"MAS",0
50,"50214",27,18,17,0,1,"MAS",0
22,"22908",197,142,140,3,2,"MAS",0
50,"50113",618,489,484,2,5,"MAS",0
22,"22909",315,226,225,4,1,"MAS",1
50,"50228",268,210,208,5,2,"MAS",0
50,"50249",302,226,220,0,6,"MAS",1
22,"22246",76,50,50,0,0,"MAS",0
44,"44263",376,266,263,3,3,"MAS",2
22,"22062",167,116,116,1,0,"MAS",0
44,"44041",56,44,44,1,0,"MAS",0
44,"44148",90,75,73,2,2,"MAS",0
50,"50156",215,181,178,2,3,"MAS",1
22,"22015",319,234,228,3,6,"MAS",0
22,"22130",10092,6671,6608,59,63,"MAS",3
50,"50091",41,36,36,0,0,"MAS",0
44,"44182",197,157,157,0,0,"MAS",0
50,"50250",52,44,44,0,0,"MAS",0
22,"22164",35,28,28,0,0,"MAS",0
44,"44264",248,191,189,1,2,"MAS",0
50,"50019",55,41,41,0,0,"MAS",0
50,"50074",6366,4230,4165,31,65,"MAS",5
50,"50135",91,70,70,3,0,"MAS",0
22,"22903",652,514,507,1,7,"MAS",1
50,"50264",156,115,115,0,0,"MAS",0
44,"44056",501,345,342,2,3,"MAS",0
50,"50082",82,65,64,0,1,"MAS",0
44,"44183",77,50,49,0,1,"MAS",0
50,"50179",249,214,213,2,1,"MAS",0
44,"44123",105,71,70,1,1,"MAS",0
50,"50096",39,27,27,0,0,"MAS",0
22,"22039",863,671,667,4,4,"MAS",0
22,"22107",112,74,74,0,0,"MAS",0
44,"44065",60,40,40,0,0,"MAS",0
44,"44176",158,115,114,0,1,"MAS",0
50,"50148",316,233,229,4,4,"MAS",0
22,"22058",194,164,162,1,2,"MAS",0
22,"22905",281,209,209,1,0,"MAS",0
22,"22006",298,204,204,5,0,"MAS",0
22,"22133",115,81,80,1,1,"MAS",0
22,"22135",189,128,127,0,1,"MAS",0
44,"44103",132,102,102,1,0,"MAS",0
50,"50902",87,79,79,2,0,"MAS",0
50,"50105",296,214,211,1,3,"MAS",2
50,"50063",61,51,51,0,0,"MAS",0
50,"50903",2214,1602,1585,8,17,"MAS",2
22,"22007",792,581,581,8,0,"MAS",0
44,"44034",139,109,108,0,1,"MAS",0
22,"22054",1542,1091,1077,13,14,"MAS",0
44,"44240",158,130,129,0,1,"MAS",0
50,"50180",119,99,99,2,0,"MAS",0
50,"50293",413,276,275,4,1,"MAS",0
44,"44185",99,76,75,0,1,"MAS",0
22,"22122",64,57,57,2,0,"MAS",0
50,"50084",77,59,59,2,0,"MAS",0
44,"44035",113,90,88,1,2,"MAS",1
50,"50284",141,107,104,0,3,"MAS",0
44,"44241",533,396,389,0,7,"MAS",1
44,"44220",121,84,83,1,1,"MAS",0
44,"44256",38,34,34,0,0,"MAS",0
50,"50290",386,283,282,1,1,"MAS",0
22,"22168",23,18,18,0,0,"MAS",0
44,"44119",130,92,91,3,1,"MAS",1
44,"44164",27,23,23,0,0,"MAS",0
44,"44217",29,25,25,3,0,"MAS",0
22,"22184",184,155,155,3,0,"MAS",0
50,"50139",313,241,239,3,2,"MAS",0
22,"22907",1435,1059,1046,18,13,"MAS",0
44,"44097",142,92,92,0,0,"MAS",1
22,"22085",104,86,86,0,0,"MAS",0
44,"44251",254,198,191,1,7,"MAS",0
50,"50034",826,567,563,5,4,"MAS",0
22,"22068",79,60,60,0,0,"MAS",1
50,"50227",109,79,79,0,0,"MAS",0
22,"22053",789,520,513,9,7,"MAS",0
50,"50220",40,32,32,0,0,"MAS",0
44,"44004",408,303,297,0,6,"MAS",2
44,"44070",53,48,48,0,0,"MAS",0
50,"50203",1040,748,739,7,9,"MAS",3
50,"50056",409,300,300,3,0,"MAS",0
44,"44144",346,248,245,2,3,"MAS",0
22,"22021",1971,1414,1398,17,16,"MAS",2
50,"50066",2621,1862,1851,9,11,"MAS",2
50,"50224",72,57,56,2,1,"MAS",0
44,"44071",591,398,398,5,0,"MAS",1
50,"50004",522,390,388,0,2,"MAS",0
50,"50077",221,168,167,1,1,"MAS",0
22,"22096",301,240,240,0,0,"MAS",0
44,"44222",131,98,98,0,0,"MAS",0
50,"50266",122,90,90,0,0,"MAS",0
50,"50296",396,286,275,4,11,"MAS",1
44,"44027",164,123,123,1,0,"MAS",0
50,"50276",125,104,103,2,1,"MAS",0
50,"50215",24,19,19,0,0,"MAS",0
22,"22048",12598,8790,8731,91,59,"MAS",7
50,"50036",104,91,90,0,1,"MAS",0
22,"22037",115,86,86,0,0,"MAS",0
44,"44087",80,69,67,1,2,"MAS",0
50,"50153",935,713,708,6,5,"MAS",0
22,"22094",101,74,74,1,0,"MAS",0
44,"44197",56,36,36,0,0,"MAS",0
22,"22160",209,168,168,6,0,"MAS",0
50,"50054",58,50,50,0,0,"MAS",0
44,"44150",28,22,21,0,1,"MAS",0
50,"50143",566,394,391,6,3,"MAS",0
50,"50047",48,36,36,0,0,"MAS",0
44,"44050",3113,2120,2100,25,20,"MAS",0
44,"44036",25,21,21,0,0,"MAS",0
22,"22082",291,213,212,1,1,"MAS",1
44,"44235",92,62,60,0,2,"MAS",0
50,"50027",225,178,177,2,1,"MAS",0
50,"50020",809,564,559,2,5,"MAS",1
50,"50095",12323,8628,8550,110,78,"MAS",7
44,"44206",114,90,87,0,3,"MAS",0
50,"50052",90,68,68,0,0,"MAS",0
22,"22248",116,92,90,1,2,"MAS",0
44,"44022",493,323,318,7,5,"MAS",0
50,"50090",150,113,112,0,1,"MAS",0
50,"50073",2141,1592,1577,7,15,"MAS",1
22,"22144",243,188,187,1,1,"MAS",0
44,"44008",1613,1163,1153,6,10,"MAS",1
22,"22003",137,110,107,1,3,"MAS",0
22,"22041",163,134,134,1,0,"MAS",0
44,"44204",24,21,21,0,0,"MAS",0
22,"22163",425,360,355,0,5,"MAS",0
50,"50297",498961,362043,359558,2748,2485,"MAS",424
22,"22190",119,86,85,0,1,"MAS",0
44,"44136",49,43,43,1,0,"MAS",0
22,"22176",173,134,130,1,4,"MAS",0
50,"50060",172,128,127,1,1,"MAS",0
44,"44267",70,57,56,0,1,"MAS",0
44,"44115",102,90,90,3,0,"MAS",0
44,"44237",398,304,301,4,3,"MAS",0
44,"44020",24,20,19,1,1,"MAS",0
22,"22087",67,45,45,2,0,"MAS",0
50,"50178",293,190,187,0,3,"MAS",0
50,"50208",1774,1207,1195,10,12,"MAS",1
44,"44172",301,218,216,4,2,"MAS",0
44,"44152",64,46,45,0,1,"MAS",0
50,"50023",224,175,175,0,0,"MAS",0
44,"44032",16,11,11,0,0,"MAS",0
50,"50051",816,616,614,2,2,"MAS",0
50,"50107",947,738,733,4,5,"MAS",5
44,"44126",329,234,229,4,5,"MAS",0
50,"50901",138,105,105,0,0,"MAS",0
22,"22078",438,319,316,3,3,"MAS",0
50,"50058",66,39,39,0,0,"MAS",0
50,"50165",1814,1287,1264,26,23,"MAS",2
50,"50241",588,415,410,4,5,"MAS",0
50,"50159",665,512,507,2,5,"MAS",0
22,"22188",82,60,59,6,1,"MAS",0
22,"22102",179,141,138,2,3,"MAS",0
50,"50062",1829,1304,1290,16,14,"MAS",5
44,"44121",60,47,47,2,0,"MAS",0
50,"50044",230,145,145,1,0,"MAS",0
22,"22213",3003,2169,2131,19,38,"MAS",0
50,"50169",351,269,265,0,4,"MAS",0
22,"22095",72,58,58,1,0,"MAS",0
22,"22226",767,570,562,10,8,"MAS",0
22,"22119",1291,942,935,5,7,"MAS",0
44,"44107",218,152,152,5,0,"MAS",1
44,"44082",89,78,77,0,1,"MAS",0
22,"22151",93,64,64,1,0,"MAS",0
44,"44001",68,53,52,1,1,"MAS",0
44,"44108",320,222,222,1,0,"MAS",0
50,"50001",100,77,77,0,0,"MAS",0
22,"22235",98,76,76,1,0,"MAS",0
50,"50021",30,21,21,0,0,"MAS",0
22,"22181",92,61,61,2,0,"MAS",0
50,"50120",52,40,40,1,0,"MAS",0
44,"44266",115,90,90,0,0,"MAS",0
50,"50273",30,22,22,0,0,"MAS",0
50,"50211",249,176,173,0,3,"MAS",0
22,"22182",250,161,158,1,3,"MAS",0
22,"22155",76,51,51,0,0,"MAS",0
22,"22008",173,137,133,3,4,"MAS",0
22,"22032",110,76,74,0,2,"MAS",0
50,"50138",46,37,37,2,0,"MAS",0
44,"44208",37,22,22,0,0,"MAS",0
50,"50171",106,79,79,0,0,"MAS",0
22,"22170",651,498,491,5,7,"MAS",1
50,"50181",993,733,720,5,13,"MAS",0
44,"44021",107,89,88,0,1,"MAS",0
50,"50182",3399,2364,2335,21,29,"MAS",4
50,"50244",201,162,161,1,1,"MAS",0
44,"44146",174,153,152,2,1,"MAS",0
44,"44180",70,61,61,0,0,"MAS",0
50,"50154",116,96,96,0,0,"MAS",0
50,"50213",94,75,74,0,1,"MAS",0
22,"22156",289,220,220,2,0,"MAS",0
22,"22165",487,364,360,6,4,"MAS",0
50,"50251",8262,5946,5872,44,74,"MAS",6
50,"50222",1622,1091,1071,7,20,"MAS",1
50,"50189",705,527,519,13,8,"MAS",0
50,"50209",2601,1731,1721,13,10,"MAS",0
50,"50137",1011,772,764,8,8,"MAS",0
50,"50234",243,189,185,6,4,"MAS",0
44,"44040",201,160,157,1,3,"MAS",0
44,"44171",178,126,124,2,2,"MAS",0
50,"50255",209,163,163,5,0,"MAS",0
44,"44211",42,35,35,0,0,"MAS",0
22,"22186",181,130,129,1,1,"MAS",0
44,"44026",90,77,76,0,1,"MAS",1
44,"44200",39,26,26,0,0,"MAS",0
50,"50059",769,549,544,8,5,"MAS",0
44,"44190",71,58,56,0,2,"MAS",0
44,"44100",185,153,151,0,2,"MAS",0
44,"44060",41,32,32,0,0,"MAS",0
50,"50229",62,47,47,2,0,"MAS",0
50,"50184",115,85,85,0,0,"MAS",0
22,"22099",483,379,377,4,2,"MAS",0
50,"50025",4562,3158,3124,31,34,"MAS",1
44,"44122",1333,925,913,8,12,"MAS",0
50,"50005",229,189,189,1,0,"MAS",0
22,"22027",329,221,218,0,3,"MAS",0
50,"50064",437,342,339,0,3,"MAS",0
50,"50117",126,104,103,1,1,"MAS",0
50,"50094",1617,1173,1159,12,14,"MAS",0
22,"22045",82,65,64,1,1,"MAS",0
44,"44129",39,32,32,0,0,"MAS",0
50,"50022",530,397,390,7,7,"MAS",0
50,"50085",167,126,126,1,0,"MAS",0
44,"44157",64,48,48,1,0,"MAS",0
22,"22128",188,146,144,3,2,"MAS",0
22,"22207",125,72,71,2,1,"MAS",1
44,"44093",80,66,66,0,0,"MAS",0
22,"22117",2478,1714,1693,22,21,"MAS",0
44,"44156",45,31,31,1,0,"MAS",0
50,"50196",107,87,86,0,1,"MAS",0
22,"22251",364,284,284,0,0,"MAS",0
44,"44138",135,98,94,0,4,"MAS",0
50,"50168",28,27,27,0,0,"MAS",0
22,"22106",22,14,14,0,0,"MAS",0
50,"50192",236,180,180,2,0,"MAS",0
50,"50013",219,180,180,0,0,"MAS",0
44,"44154",256,192,188,3,4,"MAS",0
44,"44127",68,51,51,0,0,"MAS",0
22,"22018",327,245,244,3,1,"MAS",0
44,"44063",71,54,54,0,0,"MAS",0
50,"50187",69,44,44,0,0,"MAS",0
44,"44019",67,50,49,0,1,"MAS",0
22,"22051",100,81,81,0,0,"MAS",0
44,"44114",243,178,173,0,5,"MAS",0
22,"22214",128,106,105,3,1,"MAS",0
50,"50008",5097,3457,3417,31,40,"MAS",7
50,"50289",51,38,38,0,0,"MAS",0
50,"50116",182,136,132,0,4,"MAS",0
50,"50028",78,51,51,0,0,"MAS",0
50,"50190",695,523,515,3,8,"MAS",0
44,"44128",68,54,54,1,0,"MAS",0
50,"50053",687,513,510,2,3,"MAS",0
44,"44212",39,37,37,1,0,"MAS",0
50,"50279",86,64,64,0,0,"MAS",0
50,"50029",626,450,450,3,0,"MAS",0
50,"50191",470,310,308,1,2,"MAS",0
44,"44105",82,64,64,0,0,"MAS",0
50,"50194",88,63,63,1,0,"MAS",0
50,"50132",751,543,536,0,7,"MAS",0
50,"50106",134,104,104,0,0,"MAS",0
50,"50129",235,161,158,2,3,"MAS",0
50,"50291",96,74,74,0,0,"MAS",1
50,"50219",4119,2833,2804,19,29,"MAS",8
44,"44010",175,130,128,1,2,"MAS",0
22,"22004",135,81,80,0,1,"MAS",0
22,"22055",320,243,238,2,5,"MAS",0
44,"44191",764,586,583,6,3,"MAS",0
44,"44213",62,50,50,0,0,"MAS",0
50,"50072",170,125,125,0,0,"MAS",0
22,"22234",794,552,544,3,8,"MAS",2
44,"44028",183,151,150,4,1,"MAS",0
44,"44143",380,307,306,2,1,"MAS",0
44,"44116",83,60,60,1,0,"MAS",0
50,"50030",215,141,140,1,1,"MAS",0
22,"22047",243,205,203,2,2,"MAS",0
22,"22233",82,57,57,3,0,"MAS",0
50,"50115",3235,2128,2109,14,19,"MAS",1
50,"50183",331,246,246,3,0,"MAS",0
50,"50041",12,9,9,0,0,"MAS",0
50,"50086",187,132,128,2,4,"MAS",0
22,"22066",702,502,498,7,4,"MAS",2
44,"44025",6009,4087,3997,25,90,"MAS",2
50,"50031",154,93,93,0,0,"MAS",0
50,"50011",122,95,94,1,1,"MAS",0
22,"22076",311,201,199,0,2,"MAS",0
44,"44066",108,79,74,0,5,"MAS",0
22,"22197",473,354,354,1,0,"MAS",0
50,"50104",348,271,269,2,2,"MAS",0
44,"44174",428,307,304,3,3,"MAS",0
50,"50035",72,54,53,1,1,"MAS",0
22,"22105",114,78,77,2,1,"MAS",0
50,"50046",178,133,133,5,0,"MAS",0
44,"44112",429,290,290,2,0,"MAS",0
50,"50012",100,80,79,2,1,"MAS",0
44,"44096",161,138,135,3,3,"MAS",0
50,"50204",2436,1785,1770,3,15,"MAS",4
50,"50042",15,15,15,1,0,"MAS",0
50,"50124",415,318,317,2,1,"MAS",0
44,"44167",38,31,31,0,0,"MAS",0
22,"22022",552,414,408,6,6,"MAS",1
22,"22025",1071,676,669,18,7,"MAS",0
50,"50261",213,157,157,0,0,"MAS",0
22,"22150",472,331,330,1,1,"MAS",0
22,"22023",421,313,309,6,4,"MAS",2
50,"50212",40,36,36,0,0,"MAS",0
44,"44246",1543,1045,1027,12,18,"MAS",0
50,"50271",252,200,197,2,3,"MAS",0
50,"50136",575,414,410,2,4,"MAS",0
22,"22049",78,64,64,0,0,"MAS",0
50,"50003",128,92,91,1,1,"MAS",0
44,"44043",102,74,72,0,2,"MAS",0
50,"50216",235,186,184,5,2,"MAS",0
44,"44247",316,218,215,3,3,"MAS",0
22,"22072",191,136,135,0,1,"MAS",0
44,"44193",78,54,54,1,0,"MAS",0
22,"22173",232,152,152,3,0,"MAS",0
44,"44086",449,342,336,3,6,"MAS",0
50,"50092",299,233,231,0,2,"MAS",0
50,"50108",48,38,38,0,0,"MAS",0
50,"50038",1502,1121,1111,7,10,"MAS",1
50,"50152",1430,1008,994,14,14,"MAS",0
22,"22218",43,33,33,0,0,"MAS",0
22,"22202",141,119,119,0,0,"MAS",0
44,"44037",453,317,315,0,2,"MAS",0
22,"22011",88,71,69,0,2,"MAS",0
22,"22064",166,122,121,1,1,"MAS",0
44,"44133",21,15,15,0,0,"MAS",0
44,"44225",107,74,74,1,0,"MAS",0
44,"44080",292,229,223,3,6,"MAS",0
50,"50093",92,66,66,1,0,"MAS",0
50,"50109",103,78,78,3,0,"MAS",0
50,"50272",12904,8880,8819,84,61,"MAS",16
44,"44234",61,51,51,1,0,"MAS",0
50,"50225",1570,956,950,3,6,"MAS",0
44,"44194",109,78,73,3,5,"MAS",0
50,"50256",83,53,53,0,0,"MAS",0
22,"22141",117,91,90,1,1,"MAS",0
44,"44147",412,298,293,5,5,"MAS",0
50,"50163",3689,2702,2680,37,22,"MAS",3
22,"22086",215,161,159,1,2,"MAS",0
44,"44239",22,20,20,0,0,"MAS",0
22,"22063",169,133,129,1,4,"MAS",0
22,"22084",535,403,399,4,4,"MAS",0
44,"44155",1090,793,782,4,11,"MAS",0
22,"22013",288,216,210,3,6,"MAS",0
50,"50237",101,74,73,1,1,"MAS",0
50,"50125",360,248,246,3,2,"MAS",0
44,"44203",10,10,10,0,0,"MAS",0
44,"44209",833,611,602,6,9,"MAS",0
50,"50246",41,28,28,0,0,"MAS",0
50,"50040",89,75,75,0,0,"MAS",0
50,"50230",1165,833,828,8,5,"MAS",2
50,"50259",88,67,66,0,1,"MAS",0
44,"44141",135,97,96,1,1,"MAS",0
44,"44033",269,191,190,0,1,"MAS",0
44,"44076",2203,1690,1663,18,27,"MAS",2
22,"22221",84,58,58,0,0,"MAS",0
50,"50282",69,54,54,0,0,"MAS",0
50,"50166",255,208,206,2,2,"MAS",0
44,"44111",92,69,68,0,1,"MAS",0
50,"50217",446,342,342,1,0,"MAS",0
44,"44215",159,109,109,2,0,"MAS",0
50,"50167",233,183,178,1,5,"MAS",1
22,"22205",438,322,320,0,2,"MAS",0
22,"22112",9566,6354,6305,56,49,"MAS",7
50,"50207",106,93,93,1,0,"MAS",0
44,"44048",61,52,52,0,0,"MAS",0
44,"44244",75,47,47,1,0,"MAS",0
50,"50101",864,603,597,8,6,"MAS",0
22,"22225",2679,1700,1665,17,35,"MAS",2
22,"22228",514,364,360,5,4,"MAS",0
22,"22077",379,279,273,2,6,"MAS",0
50,"50174",91,69,68,0,1,"MAS",0
50,"50298",5333,3949,3902,39,47,"MAS",5
50,"50235",2339,1664,1648,11,16,"MAS",1
44,"44101",58,46,46,2,0,"MAS",0
50,"50281",73,51,50,0,1,"MAS",0
44,"44137",193,149,148,0,1,"MAS",0
22,"22187",293,218,216,2,2,"MAS",1
22,"22036",92,77,77,0,0,"MAS",0
50,"50206",460,363,357,4,6,"MAS",0
44,"44195",88,60,60,1,0,"MAS",0
44,"44250",19,12,12,0,0,"MAS",0
22,"22195",235,182,181,3,1,"MAS",0
44,"44099",709,465,462,3,3,"MAS",0
44,"44110",49,42,42,1,0,"MAS",0
50,"50164",390,247,246,6,1,"MAS",1
44,"44149",103,78,78,3,0,"MAS",0
22,"22129",183,120,118,1,2,"MAS",0
44,"44051",2683,1977,1946,17,31,"MAS",1
50,"50238",91,66,66,1,0,"MAS",0
50,"50258",54,34,34,0,0,"MAS",0
22,"22139",79,64,64,1,0,"MAS",0
22,"22114",123,81,81,0,0,"MAS",0
22,"22069",429,333,331,2,2,"MAS",2
22,"22142",97,75,74,1,1,"MAS",0
50,"50123",449,334,331,1,3,"MAS",0
50,"50087",26,17,17,1,0,"MAS",0
22,"22203",83,67,67,1,0,"MAS",0
22,"22229",114,80,80,1,0,"MAS",0
50,"50155",103,80,78,0,2,"MAS",0
50,"50199",334,244,242,3,2,"MAS",1
22,"22090",99,71,71,0,0,"MAS",0
44,"44106",155,116,114,5,2,"MAS",0
50,"50100",329,246,241,1,5,"MAS",0
50,"50119",927,724,713,5,11,"MAS",0
22,"22245",309,267,261,1,6,"MAS",1
22,"22215",128,96,96,1,0,"MAS",0
50,"50188",28,25,25,0,0,"MAS",0
50,"50286",77,50,50,3,0,"MAS",0
44,"44003",19,17,17,0,0,"MAS",1
22,"22002",107,95,95,0,0,"MAS",0
50,"50071",132,92,92,0,0,"MAS",0
44,"44064",69,49,49,0,0,"MAS",0
44,"44061",70,54,51,0,3,"MAS",0
50,"50195",54,40,40,0,0,"MAS",0
44,"44184",45,34,34,0,0,"MAS",0
22,"22115",360,257,256,3,1,"MAS",0
22,"22060",1164,858,850,3,8,"MAS",2
50,"50057",1395,919,907,11,12,"MAS",0
44,"44201",495,411,406,0,5,"MAS",0
44,"44092",81,59,57,0,2,"MAS",0
44,"44231",38,33,33,0,0,"MAS",0
22,"22131",82,63,63,0,0,"MAS",0
50,"50257",171,134,134,2,0,"MAS",0
50,"50067",14119,9909,9819,112,90,"MAS",10
22,"22149",305,228,228,0,0,"MAS",1
44,"44168",189,139,138,2,1,"MAS",0
44,"44196",131,101,98,2,3,"MAS",0
44,"44179",337,229,226,1,3,"MAS",1
22,"22016",601,413,411,6,2,"MAS",0
24,"24219",516,387,386,4,1,"PACMA",1
12,"12009",17445,12088,11999,75,89,"PACMA",127
19,"19105",2334,1753,1739,8,14,"PACMA",16
16,"16056",457,306,305,3,1,"PACMA",0
12,"12075",123,88,88,0,0,"PACMA",0
50,"50138",46,37,37,2,0,"PACMA",0
24,"24226",199,139,137,0,2,"PACMA",0
25,"25042",208,123,121,1,2,"PACMA",1
47,"47194",298,239,237,2,2,"PACMA",2
37,"37077",261,226,223,1,3,"PACMA",0
23,"23024",12435,9058,8833,55,225,"PACMA",104
46,"46081",10134,7771,7702,41,69,"PACMA",101
50,"50066",2621,1862,1851,9,11,"PACMA",32
6,"6155",1874,1218,1202,16,16,"PACMA",7
31,"31247",151,114,113,0,1,"PACMA",1
48,"48022",2336,1444,1433,6,11,"PACMA",4
28,"28095",1529,1119,1106,6,13,"PACMA",17
9,"9102",36,30,30,0,0,"PACMA",0
37,"37249",43,29,29,0,0,"PACMA",0
31,"31219",84,66,66,0,0,"PACMA",1
16,"16185",43,37,37,0,0,"PACMA",1
10,"10005",540,377,362,3,15,"PACMA",3
31,"31199",146,92,89,3,3,"PACMA",0
41,"41016",7355,5248,5175,51,73,"PACMA",68
14,"14030",8625,6248,6181,53,67,"PACMA",38
29,"29904",421,338,335,3,3,"PACMA",2
28,"28089",3677,2748,2730,10,18,"PACMA",37
44,"44041",56,44,44,1,0,"PACMA",1
46,"46127",2692,2120,2091,18,29,"PACMA",24
49,"49138",234,184,184,3,0,"PACMA",0
20,"20905",145,100,100,1,0,"PACMA",0
37,"37374",1166,935,919,9,16,"PACMA",1
10,"10024",695,525,520,3,5,"PACMA",1
16,"16099",203,153,147,0,6,"PACMA",0
28,"28024",151,125,124,1,1,"PACMA",0
9,"9314",94,73,70,0,3,"PACMA",0
18,"18159",995,797,795,2,2,"PACMA",4
44,"44226",140,98,98,2,0,"PACMA",0
5,"5081",40,36,36,1,0,"PACMA",0
28,"28083",8939,6396,6348,38,48,"PACMA",93
44,"44024",27,25,25,0,0,"PACMA",0
31,"31022",518,332,331,4,1,"PACMA",0
47,"47013",100,82,81,1,1,"PACMA",0
9,"9430",22,18,17,0,1,"PACMA",0
46,"46126",5556,4449,4405,24,44,"PACMA",52
44,"44263",376,266,263,3,3,"PACMA",1
14,"14002",10951,7706,7620,83,86,"PACMA",46
13,"13024",898,633,627,3,6,"PACMA",2
9,"9407",28,23,23,0,0,"PACMA",0
10,"10098",378,289,287,1,2,"PACMA",1
34,"34107",81,52,51,5,1,"PACMA",0
48,"48097",1297,900,894,8,6,"PACMA",11
19,"19092",409,306,300,1,6,"PACMA",0
25,"25189",2110,1198,1186,10,12,"PACMA",17
34,"34161",23,16,16,0,0,"PACMA",0
18,"18162",938,698,686,1,12,"PACMA",4
34,"34151",159,104,103,0,1,"PACMA",0
13,"13045",674,508,499,1,9,"PACMA",1
22,"22007",792,581,581,8,0,"PACMA",5
6,"6053",602,454,444,3,10,"PACMA",2
46,"46198",839,684,674,4,10,"PACMA",14
20,"20072",4728,2902,2886,21,16,"PACMA",25
3,"3120",2406,1753,1720,11,33,"PACMA",22
5,"5157",232,162,159,1,3,"PACMA",0
13,"13087",23137,15677,15480,133,197,"PACMA",185
37,"37206",94,73,73,3,0,"PACMA",0
44,"44163",126,94,94,1,0,"PACMA",0
25,"25901",293,202,202,7,0,"PACMA",3
23,"23047",1629,1258,1250,10,8,"PACMA",12
28,"28088",261,178,178,0,0,"PACMA",0
49,"49007",370,255,249,1,6,"PACMA",0
12,"12107",355,303,299,4,4,"PACMA",0
44,"44023",17,16,16,0,0,"PACMA",0
9,"9339",128,110,110,0,0,"PACMA",0
28,"28147",963,722,720,5,2,"PACMA",10
22,"22011",88,71,69,0,2,"PACMA",0
23,"23075",3298,2564,2541,18,23,"PACMA",13
23,"23085",2252,1655,1644,6,11,"PACMA",9
4,"4053",12320,8946,8866,70,80,"PACMA",42
45,"45183",2220,1444,1428,3,16,"PACMA",21
45,"45087",8311,5828,5747,43,81,"PACMA",38
31,"31169",2193,1472,1445,9,27,"PACMA",3
25,"25170",266,169,167,1,2,"PACMA",1
6,"6113",2721,2004,1971,7,33,"PACMA",14
16,"16053",426,351,347,5,4,"PACMA",2
28,"28070",117,91,91,0,0,"PACMA",0
22,"22242",62,45,44,0,1,"PACMA",1
46,"46064",509,412,399,1,13,"PACMA",2
40,"40080",59,43,41,0,2,"PACMA",1
50,"50262",1170,896,887,15,9,"PACMA",4
9,"9334",50,39,37,0,2,"PACMA",0
50,"50183",331,246,246,3,0,"PACMA",2
5,"5024",224,169,168,3,1,"PACMA",1
45,"45162",669,494,486,2,8,"PACMA",2
49,"49077",183,103,103,0,0,"PACMA",0
37,"37185",591,423,417,2,6,"PACMA",4
9,"9094",53,42,42,1,0,"PACMA",0
9,"9448",212,169,165,0,4,"PACMA",0
2,"2033",1892,1505,1474,6,31,"PACMA",15
16,"16218",191,150,150,3,0,"PACMA",0
47,"47172",144,124,122,0,2,"PACMA",0
22,"22052",925,712,710,8,2,"PACMA",6
9,"9302",112,83,83,1,0,"PACMA",0
42,"42089",54,44,44,0,0,"PACMA",0
37,"37183",414,306,304,0,2,"PACMA",1
37,"37067",3163,2496,2467,31,29,"PACMA",26
31,"31154",224,126,126,3,0,"PACMA",0
48,"48002",7829,5490,5451,44,39,"PACMA",28
50,"50285",644,436,434,2,2,"PACMA",9
24,"24189",5865,3933,3885,31,48,"PACMA",58
42,"42044",54,42,39,0,3,"PACMA",0
31,"31233",97,74,74,0,0,"PACMA",0
44,"44219",194,145,143,1,2,"PACMA",0
25,"25209",1495,995,978,9,17,"PACMA",10
45,"45091",394,269,267,3,2,"PACMA",2
12,"12090",102,86,85,1,1,"PACMA",0
28,"28011",442,317,316,1,1,"PACMA",3
25,"25180",234,143,143,1,0,"PACMA",0
5,"5161",579,459,447,3,12,"PACMA",5
41,"41901",2682,2107,2086,28,21,"PACMA",17
37,"37092",1758,1225,1215,8,10,"PACMA",14
25,"25119",2248,1449,1442,15,7,"PACMA",9
20,"20001",246,133,132,2,1,"PACMA",0
50,"50239",62,50,48,0,2,"PACMA",0
46,"46121",105,95,94,0,1,"PACMA",1
31,"31145",172,128,128,4,0,"PACMA",2
13,"13083",2423,1693,1653,10,40,"PACMA",8
16,"16150",97,72,72,0,0,"PACMA",2
5,"5116",109,89,89,1,0,"PACMA",0
4,"4090",304,238,234,0,4,"PACMA",0
47,"47010",13729,10549,10454,81,95,"PACMA",120
35,"35017",25676,15038,14716,94,322,"PACMA",177
50,"50129",235,161,158,2,3,"PACMA",4
21,"21075",349,275,270,4,5,"PACMA",5
28,"28114",150,101,100,1,1,"PACMA",1
28,"28040",15811,10118,10009,56,109,"PACMA",146
44,"44227",74,63,62,0,1,"PACMA",0
50,"50080",33,27,27,0,0,"PACMA",1
48,"48050",191,147,146,0,1,"PACMA",0
38,"38041",6821,4908,4861,40,47,"PACMA",58
48,"48087",427,344,338,0,6,"PACMA",1
13,"13081",636,480,472,9,8,"PACMA",2
24,"24076",1277,956,947,4,9,"PACMA",8
6,"6090",869,617,602,3,15,"PACMA",6
25,"25143",84,56,55,0,1,"PACMA",0
10,"10111",1325,970,949,2,21,"PACMA",5
20,"20070",1092,748,746,5,2,"PACMA",1
26,"26106",86,72,72,0,0,"PACMA",0
6,"6123",4627,3182,3120,18,62,"PACMA",41
10,"10029",414,339,333,0,6,"PACMA",0
22,"22083",463,394,390,5,4,"PACMA",1
22,"22215",128,96,96,1,0,"PACMA",0
25,"25068",556,346,341,11,5,"PACMA",3
3,"3100",503,440,437,0,3,"PACMA",3
24,"24137",1099,783,778,7,5,"PACMA",5
49,"49193",467,313,308,4,5,"PACMA",3
25,"25071",49,31,31,0,0,"PACMA",0
34,"34136",179,110,110,1,0,"PACMA",0
35,"35028",9776,5476,5401,43,75,"PACMA",63
9,"9440",91,78,78,2,0,"PACMA",0
37,"37355",178,142,142,1,0,"PACMA",0
19,"19251",43,29,28,0,1,"PACMA",0
33,"33034",10612,6602,6536,62,66,"PACMA",53
50,"50282",69,54,54,0,0,"PACMA",0
25,"25173",1705,1156,1143,14,13,"PACMA",12
3,"3068",47,44,44,0,0,"PACMA",0
50,"50224",72,57,56,2,1,"PACMA",0
28,"28101",231,187,187,0,0,"PACMA",0
50,"50204",2436,1785,1770,3,15,"PACMA",7
49,"49245",262,176,173,2,3,"PACMA",1
37,"37106",258,165,162,0,3,"PACMA",0
14,"14006",1330,1120,1101,8,19,"PACMA",2
20,"20057",196,122,122,0,0,"PACMA",0
40,"40233",417,314,310,3,4,"PACMA",1
34,"34038",277,204,203,1,1,"PACMA",5
16,"16161",57,48,46,0,2,"PACMA",0
7,"7004",3854,2574,2547,30,27,"PACMA",16
3,"3089",9571,6775,6639,47,136,"PACMA",87
3,"3060",109,91,91,0,0,"PACMA",3
45,"45100",188,150,150,0,0,"PACMA",3
31,"31177",255,169,166,2,3,"PACMA",2
2,"2016",569,413,410,6,3,"PACMA",6
3,"3111",5436,3918,3883,18,35,"PACMA",35
22,"22245",309,267,261,1,6,"PACMA",1
2,"2008",1193,857,847,7,10,"PACMA",1
14,"14063",1046,734,725,2,9,"PACMA",8
40,"40192",159,117,117,2,0,"PACMA",1
3,"3076",8467,6238,6157,30,81,"PACMA",52
7,"7035",1524,1078,1055,8,23,"PACMA",1
40,"40052",74,60,60,0,0,"PACMA",0
4,"4054",358,285,281,2,4,"PACMA",3
37,"37263",342,237,229,0,8,"PACMA",0
24,"24172",418,255,250,2,5,"PACMA",0
21,"21070",6258,4165,4092,48,73,"PACMA",30
26,"26089",110582,82972,82186,588,786,"PACMA",703
25,"25204",1231,731,724,5,7,"PACMA",6
25,"25177",368,226,226,0,0,"PACMA",0
9,"9247",24,21,21,1,0,"PACMA",0
35,"35031",7259,5037,4942,29,95,"PACMA",50
24,"24006",472,353,347,0,6,"PACMA",5
22,"22021",1971,1414,1398,17,16,"PACMA",3
28,"28138",60,46,46,0,0,"PACMA",1
31,"31048",176,132,130,4,2,"PACMA",0
33,"33007",1514,946,942,12,4,"PACMA",2
22,"22020",115,86,86,1,0,"PACMA",0
25,"25137",8585,5143,5095,56,48,"PACMA",48
5,"5114",1345,1067,1044,3,23,"PACMA",1
37,"37304",169,124,124,0,0,"PACMA",0
19,"19046",21588,15689,15515,82,174,"PACMA",244
37,"37116",69,50,50,0,0,"PACMA",0
48,"48065",3281,2271,2237,8,34,"PACMA",5
49,"49112",126,75,75,0,0,"PACMA",1
26,"26136",107,85,85,0,0,"PACMA",0
49,"49037",185,153,151,0,2,"PACMA",2
19,"19036",263,229,229,0,0,"PACMA",0
34,"34179",28,21,20,0,1,"PACMA",0
31,"31175",71,48,48,0,0,"PACMA",0
13,"13093",4103,2963,2929,21,34,"PACMA",25
9,"9010",32,23,23,1,0,"PACMA",0
47,"47069",124,105,104,1,1,"PACMA",0
24,"24142",25119,17336,17141,154,195,"PACMA",186
16,"16067",123,87,87,0,0,"PACMA",0
16,"16107",109,86,85,1,1,"PACMA",0
47,"47089",148,125,124,0,1,"PACMA",0
19,"19284",10,10,9,0,1,"PACMA",0
5,"5029",121,96,94,0,2,"PACMA",0
10,"10101",185,145,141,1,4,"PACMA",2
40,"40108",112,82,82,0,0,"PACMA",0
5,"5139",74,65,65,0,0,"PACMA",0
40,"40223",216,163,163,1,0,"PACMA",1
34,"34080",5560,3723,3665,32,58,"PACMA",29
24,"24028",388,292,288,2,4,"PACMA",2
19,"19122",96,68,68,1,0,"PACMA",0
38,"38003",1439,969,952,10,17,"PACMA",7
46,"46190",48947,35638,35419,211,219,"PACMA",556
50,"50256",83,53,53,0,0,"PACMA",0
4,"4085",387,304,301,2,3,"PACMA",2
25,"25062",750,486,482,1,4,"PACMA",1
12,"12025",136,104,104,0,0,"PACMA",0
19,"19079",8,8,7,0,1,"PACMA",0
24,"24203",95,69,68,0,1,"PACMA",0
25,"25906",218,125,125,1,0,"PACMA",0
40,"40113",425,323,316,0,7,"PACMA",1
39,"39064",1345,1031,1015,7,16,"PACMA",12
37,"37363",118,88,87,0,1,"PACMA",0
28,"28042",1173,890,883,3,7,"PACMA",14
45,"45038",3356,2376,2350,15,26,"PACMA",47
46,"46253",115,82,82,0,0,"PACMA",3
2,"2065",476,394,392,1,2,"PACMA",1
25,"25225",564,356,356,1,0,"PACMA",2
31,"31112",89,62,62,0,0,"PACMA",0
23,"23090",1312,1041,1018,5,23,"PACMA",5
47,"47008",24,19,19,1,0,"PACMA",0
22,"22130",10092,6671,6608,59,63,"PACMA",49
3,"3096",5786,4358,4289,17,69,"PACMA",53
20,"20017",8559,5478,5435,24,43,"PACMA",38
9,"9253",109,94,91,1,3,"PACMA",0
26,"26108",266,215,213,0,2,"PACMA",3
22,"22128",188,146,144,3,2,"PACMA",0
28,"28058",139342,100637,99753,634,884,"PACMA",1812
5,"5228",174,121,120,0,1,"PACMA",0
31,"31102",143,69,69,0,0,"PACMA",0
18,"18044",181,107,107,0,0,"PACMA",0
37,"37224",206,183,175,3,8,"PACMA",0
34,"34050",200,153,152,0,1,"PACMA",0
4,"4068",187,154,152,0,2,"PACMA",1
5,"5062",179,148,147,0,1,"PACMA",0
7,"7901",610,462,459,7,3,"PACMA",5
40,"40145",1103,879,870,2,9,"PACMA",1
50,"50092",299,233,231,0,2,"PACMA",0
13,"13085",2342,1921,1855,10,66,"PACMA",4
31,"31043",38,31,30,1,1,"PACMA",0
39,"39097",697,371,368,2,3,"PACMA",0
28,"28122",513,375,370,2,5,"PACMA",2
9,"9209",4473,3223,3192,20,31,"PACMA",30
37,"37314",82,65,65,0,0,"PACMA",1
49,"49008",460,332,331,5,1,"PACMA",0
44,"44144",346,248,245,2,3,"PACMA",2
31,"31236",1320,865,854,5,11,"PACMA",3
49,"49233",93,58,55,0,3,"PACMA",0
44,"44174",428,307,304,3,3,"PACMA",0
44,"44141",135,97,96,1,1,"PACMA",2
5,"5210",87,70,69,0,1,"PACMA",0
50,"50283",70,57,57,1,0,"PACMA",0
12,"12114",198,144,144,1,0,"PACMA",0
31,"31088",5572,3897,3862,44,35,"PACMA",53
31,"31110",91,61,58,1,3,"PACMA",1
38,"38005",5468,3425,3392,18,33,"PACMA",41
39,"39020",23592,15594,15384,128,210,"PACMA",181
37,"37198",207,160,157,3,3,"PACMA",0
24,"24102",652,470,467,2,3,"PACMA",2
21,"21043",1871,1310,1285,9,25,"PACMA",17
19,"19153",22,17,17,0,0,"PACMA",0
22,"22155",76,51,51,0,0,"PACMA",0
28,"28175",863,670,668,5,2,"PACMA",7
5,"5008",227,170,168,1,2,"PACMA",0
31,"31174",110,63,63,0,0,"PACMA",0
34,"34169",404,287,286,0,1,"PACMA",0
24,"24202",8008,5367,5276,53,91,"PACMA",17
46,"46154",808,636,631,5,5,"PACMA",10
42,"42175",21,16,16,0,0,"PACMA",0
28,"28128",444,315,314,0,1,"PACMA",2
9,"9273",52,40,39,2,1,"PACMA",0
44,"44203",10,10,10,0,0,"PACMA",0
18,"18151",260,171,170,3,1,"PACMA",3
31,"31006",1927,1350,1332,13,18,"PACMA",4
2,"2054",386,291,290,0,1,"PACMA",1
7,"7021",230,177,174,2,3,"PACMA",2
49,"49022",288,229,225,3,4,"PACMA",0
49,"49063",338,272,266,4,6,"PACMA",0
42,"42115",61,47,47,1,0,"PACMA",0
41,"41039",31663,22062,21830,193,232,"PACMA",232
22,"22137",1069,727,718,3,9,"PACMA",4
37,"37239",217,185,183,3,2,"PACMA",0
24,"24182",416,294,290,2,4,"PACMA",2
6,"6023",4302,3041,3007,16,34,"PACMA",15
31,"31151",66,46,46,1,0,"PACMA",0
4,"4024",3074,2347,2327,20,20,"PACMA",21
16,"16112",1497,1031,1021,9,10,"PACMA",3
31,"31191",3016,2167,2147,22,20,"PACMA",17
31,"31259",484,291,286,2,5,"PACMA",3
9,"9039",58,46,46,2,0,"PACMA",0
19,"19210",21,19,18,1,1,"PACMA",0
47,"47033",196,154,154,1,0,"PACMA",0
5,"5086",80,67,67,2,0,"PACMA",0
50,"50117",126,104,103,1,1,"PACMA",0
45,"45021",2500,1708,1665,12,43,"PACMA",27
42,"42127",38,31,31,1,0,"PACMA",1
31,"31067",1922,1312,1294,10,18,"PACMA",5
5,"5165",368,290,281,3,9,"PACMA",1
23,"23037",502,404,400,6,4,"PACMA",3
16,"16160",60,44,42,1,2,"PACMA",0
12,"12031",3807,2941,2894,24,47,"PACMA",21
19,"19322",31,25,25,0,0,"PACMA",0
37,"37330",339,248,246,0,2,"PACMA",1
21,"21021",12254,7339,7244,78,95,"PACMA",60
31,"31075",103,63,63,0,0,"PACMA",1
28,"28104",14040,11151,11096,57,55,"PACMA",128
44,"44028",183,151,150,4,1,"PACMA",0
16,"16148",573,504,500,4,4,"PACMA",0
42,"42082",8,8,8,1,0,"PACMA",0
27,"27027",1929,1369,1342,11,27,"PACMA",10
50,"50234",243,189,185,6,4,"PACMA",0
25,"25040",10546,6367,6300,61,67,"PACMA",48
47,"47018",34,28,28,0,0,"PACMA",0
37,"37208",76,56,54,1,2,"PACMA",0
19,"19110",56,50,50,0,0,"PACMA",0
37,"37350",420,318,314,5,4,"PACMA",2
35,"35030",9250,5413,5326,34,87,"PACMA",37
48,"48906",766,547,544,0,3,"PACMA",2
42,"42031",26,21,21,0,0,"PACMA",0
5,"5089",485,384,376,0,8,"PACMA",1
26,"26048",22,22,22,0,0,"PACMA",0
49,"49244",43,29,29,0,0,"PACMA",0
2,"2015",1441,1112,1093,5,19,"PACMA",1
16,"16906",80,67,67,1,0,"PACMA",0
16,"16212",247,203,202,0,1,"PACMA",1
30,"30004",1137,870,862,3,8,"PACMA",2
1,"1047",968,673,668,5,5,"PACMA",12
7,"7027",20769,13097,12987,100,110,"PACMA",212
49,"49271",194,145,141,1,4,"PACMA",0
50,"50187",69,44,44,0,0,"PACMA",0
13,"13011",4792,3112,3077,14,35,"PACMA",18
10,"10133",1206,956,945,5,11,"PACMA",4
22,"22116",1430,1004,994,5,10,"PACMA",5
44,"44111",92,69,68,0,1,"PACMA",0
26,"26068",80,61,61,1,0,"PACMA",0
44,"44190",71,58,56,0,2,"PACMA",1
25,"25202",104,73,72,0,1,"PACMA",0
4,"4015",124,96,96,2,0,"PACMA",0
5,"5087",134,87,85,1,2,"PACMA",1
24,"24217",135,109,108,1,1,"PACMA",0
5,"5077",158,140,139,1,1,"PACMA",1
30,"30033",10188,7403,7285,68,118,"PACMA",73
26,"26006",1800,1419,1405,8,14,"PACMA",13
37,"37357",262,205,203,1,2,"PACMA",0
5,"5065",471,394,392,4,2,"PACMA",1
37,"37331",212,137,135,0,2,"PACMA",0
41,"41020",12887,8210,8118,82,92,"PACMA",39
1,"1034",161,124,123,1,1,"PACMA",2
4,"4043",549,465,461,1,4,"PACMA",0
3,"3115",255,222,220,2,2,"PACMA",1
12,"12089",4328,3078,3020,15,58,"PACMA",29
46,"46147",16835,11920,11791,61,129,"PACMA",152
10,"10157",263,204,201,0,3,"PACMA",0
40,"40046",89,75,75,1,0,"PACMA",0
19,"19089",30,22,22,0,0,"PACMA",0
19,"19311",82,69,67,0,2,"PACMA",0
19,"19327",418,350,348,1,2,"PACMA",0
12,"12113",83,67,66,3,1,"PACMA",0
25,"25022",104,79,79,0,0,"PACMA",0
14,"14001",3514,2837,2789,28,48,"PACMA",9
37,"37327",185,149,146,3,3,"PACMA",1
31,"31229",47,35,35,0,0,"PACMA",0
42,"42201",22,22,21,0,1,"PACMA",0
4,"4055",371,310,308,0,2,"PACMA",0
21,"21077",1711,1224,1202,3,22,"PACMA",7
21,"21001",637,462,455,6,7,"PACMA",3
45,"45142",7871,6007,5927,37,80,"PACMA",57
9,"9312",96,78,77,0,1,"PACMA",2
20,"20026",197,145,133,0,12,"PACMA",0
45,"45054",3959,2882,2848,12,34,"PACMA",16
16,"16006",120,98,96,3,2,"PACMA",0
40,"40089",222,167,164,0,3,"PACMA",2
44,"44012",334,263,261,5,2,"PACMA",1
25,"25239",590,258,256,5,2,"PACMA",1
14,"14036",3740,2747,2696,24,51,"PACMA",14
27,"27019",8111,5773,5680,53,93,"PACMA",87
19,"19299",97,79,77,1,2,"PACMA",1
11,"11016",14929,9426,9302,123,124,"PACMA",133
37,"37268",112,76,76,0,0,"PACMA",0
46,"46134",2357,1725,1712,14,13,"PACMA",32
9,"9315",378,245,243,1,2,"PACMA",3
39,"39078",1401,975,963,5,12,"PACMA",5
37,"37343",60,47,47,0,0,"PACMA",0
28,"28144",6010,4676,4644,22,32,"PACMA",53
40,"40159",142,100,99,1,1,"PACMA",0
22,"22102",179,141,138,2,3,"PACMA",0
19,"19113",485,366,366,3,0,"PACMA",1
16,"16022",78,67,66,0,1,"PACMA",1
16,"16245",419,327,323,7,4,"PACMA",5
26,"26122",118,102,102,0,0,"PACMA",2
22,"22078",438,319,316,3,3,"PACMA",4
4,"4074",2840,2000,1979,23,21,"PACMA",15
25,"25016",2107,1268,1259,14,9,"PACMA",4
34,"34170",61,42,42,0,0,"PACMA",0
46,"46205",14313,10932,10834,51,98,"PACMA",111
42,"42130",59,46,45,1,1,"PACMA",0
19,"19078",50,44,43,0,1,"PACMA",0
31,"31157",3518,2298,2267,23,31,"PACMA",17
46,"46066",1263,1024,1018,9,6,"PACMA",13
33,"33026",8530,5397,5337,48,60,"PACMA",27
23,"23026",3586,2620,2585,16,35,"PACMA",10
29,"29063",323,250,245,1,5,"PACMA",0
20,"20081",7470,4856,4833,40,23,"PACMA",22
16,"16251",1849,1381,1366,7,15,"PACMA",3
37,"37215",136,104,103,1,1,"PACMA",0
25,"25029",1655,1042,1029,15,13,"PACMA",10
29,"29034",467,358,356,0,2,"PACMA",4
44,"44222",131,98,98,0,0,"PACMA",0
25,"25169",173,112,111,3,1,"PACMA",1
50,"50235",2339,1664,1648,11,16,"PACMA",19
31,"31037",84,66,66,1,0,"PACMA",1
46,"46041",329,253,252,5,1,"PACMA",1
24,"24098",1193,842,831,11,11,"PACMA",3
26,"26020",476,349,339,3,10,"PACMA",1
47,"47016",69,56,55,0,1,"PACMA",1
12,"12125",216,180,177,0,3,"PACMA",0
31,"31203",40,28,28,0,0,"PACMA",0
18,"18180",633,410,410,3,0,"PACMA",2
24,"24055",708,516,512,0,4,"PACMA",2
24,"24166",1407,1013,993,8,20,"PACMA",6
39,"39041",1760,1370,1354,9,16,"PACMA",5
48,"48078",38617,26366,26212,158,154,"PACMA",225
25,"25111",117,72,70,2,2,"PACMA",2
10,"10195",7709,5572,5481,37,91,"PACMA",46
5,"5212",231,164,163,2,1,"PACMA",1
9,"9382",33,28,28,0,0,"PACMA",0
4,"4094",207,144,144,0,0,"PACMA",0
21,"21008",2658,1660,1636,10,24,"PACMA",7
29,"29066",334,234,233,4,1,"PACMA",3
25,"25130",195,113,112,2,1,"PACMA",1
49,"49201",302,270,268,3,2,"PACMA",1
49,"49014",112,91,91,2,0,"PACMA",0
29,"29070",40333,25991,25728,214,263,"PACMA",484
44,"44102",30,27,26,0,1,"PACMA",0
5,"5041",1001,775,762,8,13,"PACMA",4
37,"37336",52,50,50,1,0,"PACMA",0
40,"40014",58,46,45,0,1,"PACMA",0
5,"5106",35,25,25,0,0,"PACMA",0
37,"37006",138,103,103,2,0,"PACMA",0
9,"9189",125,90,87,2,3,"PACMA",1
40,"40183",130,120,119,2,1,"PACMA",0
45,"45113",1915,1390,1366,6,24,"PACMA",6
4,"4096",266,209,208,0,1,"PACMA",0
31,"31147",100,82,82,2,0,"PACMA",2
5,"5172",123,93,93,1,0,"PACMA",0
31,"31041",1606,1114,1101,15,13,"PACMA",14
19,"19152",556,390,382,1,8,"PACMA",0
49,"49039",338,245,239,3,6,"PACMA",1
25,"25219",141,102,101,0,1,"PACMA",0
39,"39053",219,153,152,2,1,"PACMA",0
10,"10010",2290,1362,1341,7,21,"PACMA",2
3,"3033",117,96,95,0,1,"PACMA",2
18,"18103",757,579,575,4,4,"PACMA",1
23,"23057",766,625,619,4,6,"PACMA",3
10,"10051",430,308,296,0,12,"PACMA",0
9,"9101",76,56,55,1,1,"PACMA",0
5,"5043",84,66,66,0,0,"PACMA",0
11,"11001",4358,2816,2767,11,49,"PACMA",9
19,"19055",52,41,41,1,0,"PACMA",0
5,"5189",449,351,349,2,2,"PACMA",0
47,"47118",168,127,127,2,0,"PACMA",2
24,"24160",684,483,474,6,9,"PACMA",4
19,"19138",255,202,201,2,1,"PACMA",0
44,"44176",158,115,114,0,1,"PACMA",0
25,"25003",3762,2215,2195,22,20,"PACMA",21
19,"19310",9,7,7,0,0,"PACMA",0
18,"18120",264,209,208,1,1,"PACMA",1
42,"42194",170,118,114,1,4,"PACMA",0
5,"5201",523,419,418,1,1,"PACMA",2
37,"37381",147,114,107,2,7,"PACMA",0
9,"9177",1121,757,749,9,8,"PACMA",2
19,"19088",79,61,61,0,0,"PACMA",0
22,"22107",112,74,74,0,0,"PACMA",0
14,"14019",6464,4967,4909,49,58,"PACMA",29
12,"12133",59,53,52,0,1,"PACMA",1
5,"5010",152,117,116,1,1,"PACMA",0
41,"41024",22600,14263,14048,128,215,"PACMA",170
47,"47129",871,664,659,4,5,"PACMA",3
19,"19114",37,26,26,0,0,"PACMA",0
37,"37187",572,427,423,1,4,"PACMA",1
24,"24151",478,353,352,1,1,"PACMA",1
22,"22167",493,388,381,9,7,"PACMA",0
28,"28045",33328,24620,24434,146,186,"PACMA",278
13,"13051",346,264,264,1,0,"PACMA",0
38,"38024",15077,9512,9356,55,156,"PACMA",144
24,"24162",1683,1257,1246,13,11,"PACMA",17
24,"24209",2769,1888,1865,12,23,"PACMA",8
10,"10198",1143,981,964,6,17,"PACMA",4
48,"48006",290,239,239,2,0,"PACMA",1
26,"26031",106,83,83,0,0,"PACMA",2
41,"41059",34165,24949,24709,196,240,"PACMA",417
45,"45065",271,207,206,1,1,"PACMA",0
23,"23060",19003,12924,12812,102,112,"PACMA",69
22,"22223",75,58,58,0,0,"PACMA",0
47,"47229",210,148,147,1,1,"PACMA",0
41,"41048",2228,1470,1447,15,23,"PACMA",22
23,"23061",7560,5303,5234,29,69,"PACMA",36
16,"16085",138,113,112,0,1,"PACMA",3
39,"39017",569,398,391,4,7,"PACMA",3
44,"44267",70,57,56,0,1,"PACMA",0
6,"6126",2170,1523,1507,1,16,"PACMA",7
9,"9281",145,114,109,1,5,"PACMA",0
9,"9377",632,485,480,1,5,"PACMA",5
45,"45063",417,310,303,1,7,"PACMA",2
13,"13031",2452,1919,1909,11,10,"PACMA",34
16,"16038",38,31,31,0,0,"PACMA",0
44,"44243",24,20,20,0,0,"PACMA",0
48,"48088",136,102,102,0,0,"PACMA",0
1,"1902",734,514,502,4,12,"PACMA",8
44,"44268",25,25,24,0,1,"PACMA",0
35,"35001",4584,3282,3222,26,60,"PACMA",30
9,"9316",105,80,80,1,0,"PACMA",0
1,"1004",1399,1008,995,8,13,"PACMA",8
12,"12106",1158,955,942,8,13,"PACMA",10
46,"46902",364,306,303,0,3,"PACMA",3
34,"34135",399,293,289,0,4,"PACMA",2
19,"19118",11,9,9,0,0,"PACMA",0
44,"44231",38,33,33,0,0,"PACMA",0
37,"37275",118,70,69,0,1,"PACMA",0
41,"41061",2195,1749,1703,11,46,"PACMA",3
26,"26139",54,45,44,0,1,"PACMA",0
7,"7017",851,582,571,7,11,"PACMA",3
16,"16082",291,213,212,0,1,"PACMA",0
22,"22187",293,218,216,2,2,"PACMA",2
31,"31026",144,118,117,0,1,"PACMA",1
26,"26023",469,358,354,0,4,"PACMA",3
42,"42097",23,14,11,0,3,"PACMA",0
9,"9026",386,301,300,0,1,"PACMA",7
25,"25013",2146,1240,1226,16,14,"PACMA",20
44,"44026",90,77,76,0,1,"PACMA",2
9,"9154",137,98,97,2,1,"PACMA",1
49,"49107",126,94,93,2,1,"PACMA",0
50,"50087",26,17,17,1,0,"PACMA",0
50,"50276",125,104,103,2,1,"PACMA",0
28,"28110",1944,1478,1463,4,15,"PACMA",6
45,"45136",5845,4091,4019,25,72,"PACMA",25
19,"19185",28,21,20,0,1,"PACMA",0
31,"31260",1238,794,788,12,6,"PACMA",5
19,"19051",67,63,63,0,0,"PACMA",0
31,"31170",47,42,42,3,0,"PACMA",0
35,"35012",10382,5443,5392,17,51,"PACMA",55
3,"3011",7753,5464,5415,27,49,"PACMA",84
7,"7065",2083,1346,1328,9,18,"PACMA",15
21,"21061",5084,3223,3177,28,46,"PACMA",10
44,"44129",39,32,32,0,0,"PACMA",1
12,"12067",537,435,427,0,8,"PACMA",4
41,"41086",16170,10162,10088,73,74,"PACMA",159
26,"26025",87,71,70,1,1,"PACMA",1
16,"16255",140,122,121,0,1,"PACMA",0
44,"44180",70,61,61,0,0,"PACMA",0
3,"3136",441,338,334,0,4,"PACMA",1
12,"12032",23525,17093,16966,104,127,"PACMA",209
24,"24023",263,188,188,1,0,"PACMA",0
1,"1021",473,310,309,0,1,"PACMA",8
50,"50133",113,80,80,4,0,"PACMA",1
31,"31039",80,61,60,0,1,"PACMA",0
45,"45061",2447,1703,1689,12,14,"PACMA",17
34,"34228",83,74,74,1,0,"PACMA",3
9,"9338",227,170,169,0,1,"PACMA",4
50,"50248",508,387,374,2,13,"PACMA",1
37,"37155",65,57,57,0,0,"PACMA",0
5,"5901",263,182,180,2,2,"PACMA",0
23,"23081",1513,1103,1084,10,19,"PACMA",6
19,"19235",93,71,71,1,0,"PACMA",0
19,"19086",1473,1123,1111,7,12,"PACMA",5
27,"27011",2452,1494,1467,19,27,"PACMA",6
24,"24014",7425,5124,5053,32,71,"PACMA",32
42,"42105",50,45,45,0,0,"PACMA",0
49,"49135",626,434,430,1,4,"PACMA",3
21,"21028",375,277,271,2,6,"PACMA",0
4,"4089",742,521,518,1,3,"PACMA",9
19,"19309",26,21,21,0,0,"PACMA",0
12,"12079",399,316,314,2,2,"PACMA",1
48,"48013",79716,53419,52997,345,422,"PACMA",523
5,"5007",111,81,80,3,1,"PACMA",0
25,"25034",2326,1361,1340,15,21,"PACMA",9
49,"49163",219,158,154,5,4,"PACMA",0
2,"2052",459,372,369,4,3,"PACMA",2
46,"46260",2581,2087,2068,22,19,"PACMA",24
24,"24205",945,694,685,11,9,"PACMA",7
9,"9454",43,34,33,0,1,"PACMA",1
12,"12070",522,406,401,0,5,"PACMA",2
37,"37008",4266,3216,3197,19,19,"PACMA",20
16,"16109",44,38,38,1,0,"PACMA",0
10,"10119",620,460,452,1,8,"PACMA",2
28,"28172",9077,6992,6936,31,56,"PACMA",90
20,"20035",486,337,334,1,3,"PACMA",2
22,"22221",84,58,58,0,0,"PACMA",1
9,"9449",86,68,66,0,2,"PACMA",0
31,"31197",69,56,56,2,0,"PACMA",0
46,"46252",118,99,98,0,1,"PACMA",0
34,"34099",60,48,48,0,0,"PACMA",0
46,"46245",511,420,415,0,5,"PACMA",9
37,"37256",218,156,152,1,4,"PACMA",0
39,"39045",367,271,268,1,3,"PACMA",0
18,"18035",1232,992,988,6,4,"PACMA",2
41,"41069",29138,18991,18683,341,308,"PACMA",217
10,"10212",1684,1233,1203,7,30,"PACMA",7
29,"29018",2010,1472,1420,9,52,"PACMA",11
31,"31054",462,255,250,4,5,"PACMA",1
5,"5225",372,285,281,1,4,"PACMA",0
37,"37313",550,386,384,2,2,"PACMA",0
19,"19216",131,98,98,0,0,"PACMA",2
34,"34056",1998,1452,1444,13,8,"PACMA",8
2,"2001",656,527,523,1,4,"PACMA",4
49,"49165",59,51,51,0,0,"PACMA",0
14,"14048",1207,884,869,13,15,"PACMA",11
11,"11025",4398,2899,2848,51,51,"PACMA",28
46,"46133",533,415,410,6,5,"PACMA",2
3,"3047",9207,6309,6226,25,83,"PACMA",86
31,"31122",4773,3520,3506,26,14,"PACMA",26
39,"39037",1987,1516,1503,8,13,"PACMA",11
44,"44034",139,109,108,0,1,"PACMA",0
47,"47084",1150,887,870,7,17,"PACMA",3
34,"34234",71,52,50,0,2,"PACMA",1
31,"31100",262,170,168,1,2,"PACMA",0
39,"39098",1402,1046,1036,8,10,"PACMA",6
49,"49021",14330,9878,9758,95,120,"PACMA",35
50,"50054",58,50,50,0,0,"PACMA",0
5,"5164",26,14,14,0,0,"PACMA",0
34,"34134",50,40,40,2,0,"PACMA",0
47,"47167",241,204,204,1,0,"PACMA",0
46,"46160",1913,1452,1436,1,16,"PACMA",12
44,"44108",320,222,222,1,0,"PACMA",2
37,"37026",189,146,146,0,0,"PACMA",0
9,"9432",182,145,138,0,7,"PACMA",0
34,"34121",187,148,148,3,0,"PACMA",1
46,"46204",6681,5256,5202,32,54,"PACMA",30
20,"20039",2111,1480,1472,14,8,"PACMA",10
31,"31146",35,30,29,1,1,"PACMA",0
48,"48018",869,522,522,2,0,"PACMA",3
50,"50172",193,132,129,1,3,"PACMA",0
16,"16052",547,418,416,2,2,"PACMA",7
12,"12016",1582,1307,1297,6,10,"PACMA",3
19,"19304",219,173,171,3,2,"PACMA",4
42,"42096",272,171,170,6,1,"PACMA",0
31,"31003",122,87,87,0,0,"PACMA",0
20,"20903",4330,2756,2734,28,22,"PACMA",14
22,"22035",234,165,159,3,6,"PACMA",1
27,"27057",11169,7551,7386,79,165,"PACMA",50
22,"22239",88,72,72,0,0,"PACMA",0
41,"41006",2740,1782,1768,14,14,"PACMA",8
13,"13039",14366,10282,10185,81,97,"PACMA",78
40,"40081",124,94,92,2,2,"PACMA",1
16,"16102",1205,912,905,12,7,"PACMA",0
18,"18194",2128,1451,1437,9,14,"PACMA",8
34,"34171",968,708,703,5,5,"PACMA",6
29,"29079",2416,1788,1764,10,24,"PACMA",11
42,"42068",82,63,60,1,3,"PACMA",1
3,"3020",99,79,79,0,0,"PACMA",2
9,"9077",34,27,27,0,0,"PACMA",0
21,"21078",2726,1793,1768,17,25,"PACMA",12
24,"24087",631,470,466,7,4,"PACMA",2
40,"40206",173,135,134,0,1,"PACMA",1
5,"5135",425,317,315,5,2,"PACMA",1
19,"19173",45,38,36,0,2,"PACMA",2
12,"12053",2034,1655,1633,6,22,"PACMA",6
24,"24065",2138,1503,1472,15,31,"PACMA",13
46,"46172",5042,3504,3477,22,27,"PACMA",61
41,"41074",3012,2282,2257,18,25,"PACMA",7
37,"37278",732,532,528,3,4,"PACMA",6
46,"46215",1436,1154,1143,5,11,"PACMA",15
6,"6100",935,780,774,1,6,"PACMA",0
48,"48915",362,227,226,0,1,"PACMA",2
6,"6056",479,407,399,1,8,"PACMA",2
49,"49257",291,190,184,1,6,"PACMA",0
10,"10022",427,349,341,0,8,"PACMA",0
16,"16121",258,202,202,3,0,"PACMA",0
28,"28016",79,53,51,0,2,"PACMA",0
19,"19081",29,22,22,1,0,"PACMA",0
46,"46077",7496,5909,5827,45,82,"PACMA",41
42,"42071",171,115,115,3,0,"PACMA",0
49,"49159",271,209,205,4,4,"PACMA",0
50,"50017",1773,1276,1269,13,7,"PACMA",7
14,"14016",1337,1072,1060,2,12,"PACMA",8
25,"25043",807,501,497,11,4,"PACMA",3
22,"22061",6630,4555,4526,40,29,"PACMA",32
6,"6087",2110,1583,1561,8,22,"PACMA",3
20,"20055",17475,11073,10997,56,76,"PACMA",62
16,"16137",54,32,31,1,1,"PACMA",0
44,"44247",316,218,215,3,3,"PACMA",2
31,"31228",486,341,337,2,4,"PACMA",2
45,"45083",472,368,365,0,3,"PACMA",4
28,"28091",5440,3596,3558,24,38,"PACMA",25
46,"46061",342,274,272,1,2,"PACMA",5
9,"9006",59,39,39,0,0,"PACMA",2
1,"1010",2268,1623,1603,11,20,"PACMA",13
50,"50008",5097,3457,3417,31,40,"PACMA",37
45,"45117",747,606,601,4,5,"PACMA",1
42,"42195",101,62,62,0,0,"PACMA",0
37,"37378",111,77,75,2,2,"PACMA",0
41,"41077",8702,5983,5875,29,108,"PACMA",49
46,"46217",878,691,676,4,15,"PACMA",7
13,"13063",3706,2539,2514,33,25,"PACMA",15
2,"2037",22865,14632,14477,91,155,"PACMA",180
46,"46053",553,445,436,2,9,"PACMA",7
41,"41012",3290,2071,2030,20,41,"PACMA",24
9,"9310",13,9,8,0,1,"PACMA",0
28,"28055",916,693,687,5,6,"PACMA",7
33,"33051",7061,4640,4587,27,53,"PACMA",37
16,"16191",899,675,671,2,4,"PACMA",2
5,"5026",195,166,164,2,2,"PACMA",0
2,"2025",7461,5759,5618,34,141,"PACMA",83
19,"19044",304,245,244,0,1,"PACMA",0
22,"22232",93,71,69,1,2,"PACMA",0
37,"37296",336,259,254,2,5,"PACMA",0
49,"49041",432,326,322,5,4,"PACMA",1
42,"42197",75,58,56,0,2,"PACMA",0
5,"5126",70,56,55,0,1,"PACMA",0
25,"25035",398,249,247,2,2,"PACMA",3
42,"42048",66,51,51,0,0,"PACMA",0
6,"6107",1581,999,995,8,4,"PACMA",4
40,"40087",92,71,70,1,1,"PACMA",0
12,"12059",231,189,188,2,1,"PACMA",1
31,"31220",744,583,579,8,4,"PACMA",2
47,"47165",6955,4955,4303,66,652,"PACMA",12
24,"24093",360,249,248,2,1,"PACMA",1
19,"19017",69,57,57,0,0,"PACMA",0
33,"33053",1141,742,732,6,10,"PACMA",2
2,"2040",559,484,483,3,1,"PACMA",2
16,"16143",16,14,14,2,0,"PACMA",0
19,"19287",148,109,108,0,1,"PACMA",0
10,"10076",832,556,541,1,15,"PACMA",0
3,"3109",2850,2181,2164,8,17,"PACMA",18
20,"20015",1265,858,851,7,7,"PACMA",1
37,"37160",615,434,429,8,5,"PACMA",2
19,"19314",51,36,36,0,0,"PACMA",0
48,"48016",5271,3694,3674,24,20,"PACMA",35
46,"46142",787,619,602,1,17,"PACMA",3
12,"12093",178,137,136,2,1,"PACMA",0
3,"3057",182,147,147,1,0,"PACMA",2
50,"50073",2141,1592,1577,7,15,"PACMA",10
5,"5147",159,128,124,5,4,"PACMA",0
19,"19018",155,119,118,3,1,"PACMA",0
28,"28030",1726,1320,1299,8,21,"PACMA",12
6,"6018",753,535,529,3,6,"PACMA",9
16,"16146",83,57,57,0,0,"PACMA",0
10,"10138",555,448,446,2,2,"PACMA",2
5,"5049",401,272,266,1,6,"PACMA",3
18,"18115",2553,1800,1781,17,19,"PACMA",8
13,"13053",14328,10164,10041,72,123,"PACMA",98
37,"37217",58,45,44,0,1,"PACMA",0
9,"9408",41,36,36,0,0,"PACMA",0
4,"4041",322,240,238,6,2,"PACMA",2
49,"49208",394,248,244,2,4,"PACMA",1
41,"41049",9299,6896,6771,98,125,"PACMA",54
11,"11004",88783,51500,51015,513,485,"PACMA",726
25,"25152",140,86,86,1,0,"PACMA",1
13,"13002",1483,1012,998,3,14,"PACMA",2
5,"5131",99,69,69,0,0,"PACMA",0
37,"37203",158,117,117,0,0,"PACMA",0
41,"41083",1147,864,856,4,8,"PACMA",2
18,"18012",2278,1662,1641,13,21,"PACMA",7
28,"28059",4323,3171,3157,11,14,"PACMA",35
50,"50013",219,180,180,0,0,"PACMA",1
19,"19319",4449,3086,3056,18,30,"PACMA",58
24,"24118",126,88,88,1,0,"PACMA",0
29,"29044",809,561,561,3,0,"PACMA",2
50,"50140",166,115,115,0,0,"PACMA",1
48,"48089",3306,2341,2329,20,12,"PACMA",19
26,"26022",198,164,163,1,1,"PACMA",0
44,"44014",2521,1896,1867,8,29,"PACMA",12
13,"13074",974,835,828,3,7,"PACMA",0
5,"5052",95,77,76,0,1,"PACMA",0
6,"6054",5446,3920,3833,32,87,"PACMA",21
38,"38004",4456,3026,2983,23,43,"PACMA",49
10,"10065",206,156,155,1,1,"PACMA",1
10,"10035",1920,1343,1315,5,28,"PACMA",11
9,"9226",63,54,54,0,0,"PACMA",1
47,"47231",4401,3299,3277,24,22,"PACMA",35
20,"20063",8017,5263,5231,35,32,"PACMA",30
11,"11040",397,307,292,1,15,"PACMA",1
12,"12097",63,49,49,0,0,"PACMA",1
26,"26164",59,46,45,2,1,"PACMA",0
34,"34018",209,168,164,1,4,"PACMA",0
18,"18014",6581,4584,4545,37,39,"PACMA",61
49,"49214",698,525,512,3,13,"PACMA",2
45,"45158",2514,1777,1760,11,17,"PACMA",13
37,"37003",115,93,93,0,0,"PACMA",0
49,"49050",507,342,338,1,4,"PACMA",0
12,"12065",188,169,169,2,0,"PACMA",0
45,"45114",588,447,447,0,0,"PACMA",4
42,"42178",115,83,83,0,0,"PACMA",0
18,"18150",6763,4733,4678,21,55,"PACMA",45
2,"2047",117,88,88,2,0,"PACMA",1
4,"4033",135,97,93,1,4,"PACMA",1
47,"47079",58,48,47,0,1,"PACMA",0
34,"34049",359,266,260,1,6,"PACMA",4
48,"48031",332,233,231,1,2,"PACMA",1
27,"27008",1379,1000,982,9,18,"PACMA",7
6,"6162",2934,2182,2162,14,20,"PACMA",5
37,"37180",75,56,56,0,0,"PACMA",0
47,"47097",325,266,265,0,1,"PACMA",0
7,"7038",2010,1424,1412,18,12,"PACMA",5
37,"37167",173,143,140,2,3,"PACMA",0
20,"20021",200,100,100,2,0,"PACMA",0
50,"50122",68,52,52,1,0,"PACMA",2
47,"47088",103,86,85,1,1,"PACMA",0
9,"9398",75,56,56,0,0,"PACMA",0
16,"16013",27,24,24,0,0,"PACMA",0
6,"6118",192,145,144,1,1,"PACMA",0
2,"2049",823,573,564,1,9,"PACMA",4
39,"39083",1135,679,670,8,9,"PACMA",3
44,"44050",3113,2120,2100,25,20,"PACMA",8
10,"10147",1278,961,925,7,36,"PACMA",2
9,"9451",238,191,190,0,1,"PACMA",3
25,"25132",136,88,87,0,1,"PACMA",2
42,"42008",57,43,43,0,0,"PACMA",0
22,"22051",100,81,81,0,0,"PACMA",0
23,"23069",5353,4310,4212,27,98,"PACMA",28
4,"4048",1503,1090,1085,9,5,"PACMA",4
10,"10056",586,457,452,4,5,"PACMA",3
3,"3003",450,378,376,2,2,"PACMA",1
40,"40101",877,635,628,8,7,"PACMA",5
29,"29094",57554,38071,37696,339,375,"PACMA",493
39,"39084",838,631,624,2,7,"PACMA",3
31,"31008",75,54,54,2,0,"PACMA",0
28,"28163",442,344,339,1,5,"PACMA",4
9,"9175",127,94,93,2,1,"PACMA",1
40,"40172",39,34,34,0,0,"PACMA",0
40,"40086",685,561,552,4,9,"PACMA",3
22,"22903",652,514,507,1,7,"PACMA",2
24,"24059",880,536,535,4,1,"PACMA",1
37,"37255",49,34,34,1,0,"PACMA",0
18,"18096",341,227,224,3,3,"PACMA",0
16,"16003",125,105,104,0,1,"PACMA",0
18,"18020",1028,691,686,3,5,"PACMA",3
16,"16016",224,171,168,0,3,"PACMA",0
25,"25089",105,60,59,0,1,"PACMA",0
49,"49164",155,119,115,2,4,"PACMA",1
2,"2012",1835,1476,1453,7,23,"PACMA",8
22,"22016",601,413,411,6,2,"PACMA",4
4,"4016",2138,1551,1536,9,15,"PACMA",6
9,"9455",45,33,33,0,0,"PACMA",0
35,"35033",6398,4340,4266,19,74,"PACMA",42
46,"46141",439,351,342,2,9,"PACMA",4
5,"5143",66,51,49,0,2,"PACMA",0
6,"6077",341,256,249,0,7,"PACMA",0
48,"48066",348,258,258,1,0,"PACMA",2
31,"31076",2417,1918,1906,9,12,"PACMA",11
22,"22904",815,579,575,8,4,"PACMA",4
42,"42049",116,81,81,1,0,"PACMA",0
12,"12071",1274,992,979,3,13,"PACMA",4
14,"14075",572,448,428,1,20,"PACMA",1
18,"18049",595,459,452,3,7,"PACMA",0
34,"34149",23,18,18,0,0,"PACMA",0
30,"30014",1567,1174,1160,8,14,"PACMA",24
14,"14010",4027,2850,2807,19,43,"PACMA",22
5,"5096",80,60,59,0,1,"PACMA",0
9,"9279",174,131,130,3,1,"PACMA",0
3,"3131",175,154,147,0,7,"PACMA",0
50,"50149",34,24,24,0,0,"PACMA",0
10,"10015",675,483,473,3,10,"PACMA",1
45,"45098",2159,1632,1609,12,23,"PACMA",2
26,"26064",2275,1659,1638,17,21,"PACMA",8
16,"16019",214,156,152,0,4,"PACMA",1
46,"46151",728,550,541,0,9,"PACMA",6
9,"9375",36,31,31,0,0,"PACMA",0
42,"42188",50,39,38,0,1,"PACMA",0
31,"31133",43,28,28,0,0,"PACMA",0
18,"18051",1147,817,810,8,7,"PACMA",5
19,"19019",20,18,17,0,1,"PACMA",0
49,"49264",578,383,377,5,6,"PACMA",3
49,"49225",147,91,90,0,1,"PACMA",0
42,"42094",621,444,433,10,11,"PACMA",5
49,"49226",255,198,195,0,3,"PACMA",0
6,"6080",1924,1412,1392,9,20,"PACMA",11
26,"26172",30,23,23,0,0,"PACMA",0
9,"9238",921,573,561,4,12,"PACMA",4
24,"24008",9282,6685,6603,52,82,"PACMA",40
29,"29099",950,693,685,4,8,"PACMA",5
10,"10002",364,272,270,0,2,"PACMA",0
47,"47102",291,230,220,1,10,"PACMA",2
7,"7007",421,296,293,2,3,"PACMA",5
44,"44085",52,35,35,0,0,"PACMA",0
37,"37001",192,151,148,0,3,"PACMA",0
9,"9052",29,23,23,0,0,"PACMA",0
46,"46153",439,355,351,1,4,"PACMA",6
46,"46196",147,125,125,1,0,"PACMA",2
18,"18116",2850,2059,2025,20,34,"PACMA",12
40,"40065",493,373,373,3,0,"PACMA",0
45,"45101",3756,3020,2984,12,36,"PACMA",15
22,"22139",79,64,64,1,0,"PACMA",0
31,"31047",254,191,188,2,3,"PACMA",2
37,"37191",114,78,75,1,3,"PACMA",0
37,"37262",78,64,63,0,1,"PACMA",0
34,"34076",587,479,479,2,0,"PACMA",2
42,"42028",75,51,51,0,0,"PACMA",0
25,"25001",144,73,73,0,0,"PACMA",0
48,"48039",239,190,188,0,2,"PACMA",1
21,"21023",2124,1298,1264,7,34,"PACMA",7
18,"18027",2570,1711,1700,13,11,"PACMA",11
26,"26034",654,497,489,1,8,"PACMA",2
9,"9242",80,66,66,2,0,"PACMA",0
9,"9198",104,83,82,1,1,"PACMA",0
37,"37192",356,231,227,2,4,"PACMA",2
14,"14051",1397,1018,1000,2,18,"PACMA",1
24,"24176",316,247,244,1,3,"PACMA",1
31,"31015",1994,1412,1392,25,20,"PACMA",14
37,"37060",243,187,187,1,0,"PACMA",3
10,"10143",154,112,112,0,0,"PACMA",1
44,"44122",1333,925,913,8,12,"PACMA",3
20,"20064",12503,7803,7755,52,48,"PACMA",97
18,"18029",1833,1196,1190,12,6,"PACMA",1
45,"45003",562,408,402,1,6,"PACMA",6
21,"21065",273,186,184,0,2,"PACMA",0
34,"34174",200,159,154,5,5,"PACMA",0
21,"21038",1095,705,693,4,12,"PACMA",7
19,"19306",25,20,20,1,0,"PACMA",0
20,"20076",6990,4666,4648,29,18,"PACMA",16
37,"37139",205,169,168,2,1,"PACMA",0
37,"37320",95,72,72,0,0,"PACMA",0
5,"5267",101,72,70,0,2,"PACMA",0
48,"48905",2553,1792,1771,12,21,"PACMA",3
48,"48011",9673,6468,6423,45,45,"PACMA",53
31,"31205",427,299,297,4,2,"PACMA",3
31,"31907",10745,8067,8009,116,58,"PACMA",91
5,"5234",49,44,44,2,0,"PACMA",1
25,"25086",522,346,341,2,5,"PACMA",2
49,"49133",304,214,213,1,1,"PACMA",1
40,"40905",133,103,100,1,3,"PACMA",0
11,"11021",6764,4434,4362,52,72,"PACMA",23
22,"22143",217,143,141,1,2,"PACMA",0
49,"49026",226,179,176,0,3,"PACMA",0
34,"34035",111,98,97,0,1,"PACMA",0
44,"44062",34,25,22,0,3,"PACMA",0
6,"6042",1011,698,687,2,11,"PACMA",2
50,"50027",225,178,177,2,1,"PACMA",1
47,"47217",1910,1370,1366,1,4,"PACMA",15
10,"10025",400,327,318,1,9,"PACMA",2
26,"26071",8491,5834,5761,47,73,"PACMA",68
10,"10117",255,135,134,0,1,"PACMA",0
18,"18032",246,175,174,2,1,"PACMA",0
33,"33010",1822,1190,1180,17,10,"PACMA",11
50,"50279",86,64,64,0,0,"PACMA",1
28,"28082",5683,4324,4286,25,38,"PACMA",52
31,"31217",321,226,223,1,3,"PACMA",1
5,"5076",478,386,378,4,8,"PACMA",1
24,"24036",288,184,184,2,0,"PACMA",0
48,"48084",22449,14670,14553,90,117,"PACMA",129
46,"46140",344,284,279,0,5,"PACMA",2
11,"11012",99886,70290,69673,693,617,"PACMA",1747
31,"31230",106,82,82,1,0,"PACMA",3
4,"4079",51383,33777,33586,257,191,"PACMA",349
42,"42088",67,47,47,1,0,"PACMA",0
26,"26168",5340,3774,3717,22,57,"PACMA",45
47,"47181",165,135,132,3,3,"PACMA",0
16,"16032",278,224,221,1,3,"PACMA",0
16,"16171",1800,1469,1443,8,26,"PACMA",5
25,"25233",275,178,178,4,0,"PACMA",2
10,"10150",346,285,279,3,6,"PACMA",1
37,"37051",85,66,66,0,0,"PACMA",0
46,"46236",972,818,809,2,9,"PACMA",7
9,"9311",59,46,45,0,1,"PACMA",0
42,"42123",164,117,116,4,1,"PACMA",2
9,"9176",63,47,46,2,1,"PACMA",0
5,"5257",132,101,101,0,0,"PACMA",6
29,"29073",1579,1091,1080,7,11,"PACMA",8
39,"39035",9502,7017,6928,57,89,"PACMA",86
16,"16173",205,157,156,0,1,"PACMA",0
41,"41091",541987,385251,382091,3298,3160,"PACMA",5382
12,"12081",608,486,480,5,6,"PACMA",4
25,"25149",1385,963,956,6,7,"PACMA",3
29,"29052",224,144,144,3,0,"PACMA",2
10,"10121",7978,5517,5429,35,88,"PACMA",24
12,"12103",91,69,67,0,2,"PACMA",1
49,"49031",148,120,119,6,1,"PACMA",1
29,"29019",878,652,636,3,16,"PACMA",2
46,"46003",950,791,769,1,22,"PACMA",3
31,"31254",1915,1428,1411,3,17,"PACMA",8
22,"22151",93,64,64,1,0,"PACMA",0
10,"10030",465,309,309,1,0,"PACMA",2
24,"24218",451,330,325,2,5,"PACMA",3
42,"42110",59,45,45,2,0,"PACMA",0
33,"33074",3484,2298,2274,24,24,"PACMA",16
12,"12082",9617,7324,7231,46,93,"PACMA",74
19,"19090",91,73,73,1,0,"PACMA",0
48,"48047",159,111,111,0,0,"PACMA",0
4,"4028",221,191,190,1,1,"PACMA",1
33,"33044",178278,125469,124554,1124,915,"PACMA",1393
19,"19317",139,110,109,1,1,"PACMA",0
45,"45099",3500,2390,2361,9,29,"PACMA",22
47,"47022",59,50,49,0,1,"PACMA",0
4,"4029",8859,5834,5790,35,44,"PACMA",35
38,"38026",32950,24443,24196,129,247,"PACMA",342
3,"3048",4847,3719,3683,20,36,"PACMA",50
44,"44109",108,73,73,0,0,"PACMA",0
16,"16908",186,152,152,1,0,"PACMA",0
9,"9251",375,277,274,4,3,"PACMA",2
16,"16130",571,450,448,1,2,"PACMA",2
10,"10032",1681,1257,1237,5,20,"PACMA",1
31,"31156",251,189,188,0,1,"PACMA",0
10,"10017",825,620,611,3,9,"PACMA",2
19,"19279",57,55,55,0,0,"PACMA",0
10,"10170",267,210,206,3,4,"PACMA",0
49,"49266",76,63,61,2,2,"PACMA",0
47,"47067",174,127,126,0,1,"PACMA",0
16,"16100",670,564,559,0,5,"PACMA",1
2,"2085",322,253,252,2,1,"PACMA",0
23,"23039",2204,1596,1558,11,38,"PACMA",9
45,"45112",1922,1247,1211,6,36,"PACMA",3
30,"30037",18793,13150,13003,47,147,"PACMA",159
23,"23010",14347,9669,9560,86,109,"PACMA",81
9,"9076",23,17,17,1,0,"PACMA",0
29,"29022",179,137,136,0,1,"PACMA",1
25,"25112",273,192,188,4,4,"PACMA",2
16,"16116",77,68,68,0,0,"PACMA",0
13,"13004",1025,807,800,4,7,"PACMA",0
18,"18149",5230,3903,3864,20,39,"PACMA",49
20,"20041",255,123,123,0,0,"PACMA",0
41,"41040",10541,7752,7698,68,54,"PACMA",109
34,"34238",330,268,266,3,2,"PACMA",0
19,"19243",44,31,31,0,0,"PACMA",0
10,"10127",4703,3183,3132,21,51,"PACMA",23
31,"31158",255,180,179,3,1,"PACMA",0
40,"40124",237,182,177,6,5,"PACMA",0
25,"25244",361,223,220,5,3,"PACMA",2
25,"25114",98,72,72,0,0,"PACMA",2
37,"37333",224,142,142,1,0,"PACMA",0
27,"27006",2564,1659,1637,17,22,"PACMA",15
9,"9125",584,432,430,1,2,"PACMA",0
1,"1006",175,140,140,0,0,"PACMA",1
16,"16026",82,62,61,2,1,"PACMA",1
10,"10159",320,251,250,0,1,"PACMA",0
46,"46137",270,210,207,4,3,"PACMA",3
44,"44071",591,398,398,5,0,"PACMA",0
48,"48020",273626,184710,183628,1185,1082,"PACMA",1534
41,"41097",3137,2180,2134,18,46,"PACMA",6
29,"29013",1610,1238,1207,9,31,"PACMA",8
9,"9395",138,104,104,0,0,"PACMA",0
10,"10175",1416,1006,980,4,26,"PACMA",7
7,"7011",27721,17817,17720,139,97,"PACMA",271
50,"50195",54,40,40,0,0,"PACMA",0
19,"19211",369,289,284,0,5,"PACMA",2
29,"29081",261,197,197,1,0,"PACMA",0
41,"41075",10212,6419,6295,49,124,"PACMA",69
13,"13009",1439,1115,1098,9,17,"PACMA",5
46,"46086",82,70,69,1,1,"PACMA",0
3,"3094",9080,6440,6396,34,44,"PACMA",97
44,"44236",63,48,47,0,1,"PACMA",0
19,"19041",163,129,129,3,0,"PACMA",1
24,"24225",1014,752,739,10,13,"PACMA",5
45,"45116",687,509,505,1,4,"PACMA",3
39,"39012",6687,5021,4957,51,64,"PACMA",41
7,"7025",472,355,351,1,4,"PACMA",2
19,"19324",176,126,125,3,1,"PACMA",0
13,"13062",574,453,448,3,5,"PACMA",1
9,"9353",76,57,56,1,1,"PACMA",0
2,"2036",95,78,78,0,0,"PACMA",0
37,"37211",224,172,172,4,0,"PACMA",0
12,"12120",177,152,152,0,0,"PACMA",1
1,"1062",313,211,210,2,1,"PACMA",4
25,"25158",1620,1019,1012,15,7,"PACMA",5
22,"22163",425,360,355,0,5,"PACMA",7
9,"9354",33,29,28,2,1,"PACMA",1
29,"29027",2326,1626,1609,12,17,"PACMA",9
47,"47117",301,233,227,2,6,"PACMA",2
16,"16140",27,16,16,0,0,"PACMA",0
19,"19054",192,164,164,1,0,"PACMA",1
31,"31019",1785,1254,1238,9,16,"PACMA",6
14,"14073",2891,2079,2016,13,63,"PACMA",7
22,"22246",76,50,50,0,0,"PACMA",0
41,"41100",1013,692,673,6,19,"PACMA",5
25,"25174",397,280,280,2,0,"PACMA",2
22,"22027",329,221,218,0,3,"PACMA",0
19,"19166",156,120,119,1,1,"PACMA",0
31,"31052",96,62,61,0,1,"PACMA",0
29,"29017",6553,4744,4668,33,76,"PACMA",33
37,"37083",182,156,155,0,1,"PACMA",0
12,"12122",796,637,627,0,10,"PACMA",1
48,"48024",995,757,754,7,3,"PACMA",5
50,"50280",332,253,250,0,3,"PACMA",1
47,"47029",57,52,52,0,0,"PACMA",0
18,"18048",2387,1683,1662,8,21,"PACMA",25
49,"49017",251,180,177,1,3,"PACMA",0
26,"26029",37,32,32,0,0,"PACMA",0
9,"9373",425,287,285,2,2,"PACMA",0
44,"44043",102,74,72,0,2,"PACMA",0
45,"45119",3330,2096,2067,15,29,"PACMA",38
24,"24026",1177,864,849,7,15,"PACMA",8
1,"1027",416,257,254,3,3,"PACMA",3
33,"33052",721,485,482,3,3,"PACMA",1
31,"31265",82,53,53,2,0,"PACMA",0
7,"7030",1551,1127,1101,13,26,"PACMA",18
38,"38036",6592,4518,4440,45,78,"PACMA",76
41,"41080",1274,910,892,6,18,"PACMA",8
40,"40119",169,138,133,1,5,"PACMA",1
6,"6017",272,222,221,1,1,"PACMA",0
44,"44184",45,34,34,0,0,"PACMA",1
44,"44252",86,65,65,0,0,"PACMA",0
22,"22119",1291,942,935,5,7,"PACMA",5
23,"23020",1590,1370,1349,9,21,"PACMA",10
25,"25252",548,343,342,9,1,"PACMA",5
7,"7031",23833,14836,14707,124,129,"PACMA",243
9,"9133",40,32,32,0,0,"PACMA",0
19,"19217",54,40,39,0,1,"PACMA",0
18,"18050",1710,1165,1152,3,13,"PACMA",13
12,"12094",847,674,665,5,9,"PACMA",5
25,"25076",145,81,81,2,0,"PACMA",2
40,"40176",395,306,305,2,1,"PACMA",0
12,"12124",1840,1387,1381,33,6,"PACMA",1
47,"47122",2032,1563,1535,7,28,"PACMA",5
24,"24163",3962,2950,2933,24,17,"PACMA",30
42,"42202",20,14,13,0,1,"PACMA",0
14,"14011",578,464,462,4,2,"PACMA",2
37,"37259",44,28,28,0,0,"PACMA",1
14,"14040",3776,2873,2833,32,40,"PACMA",13
42,"42174",174,137,135,5,2,"PACMA",1
19,"19289",28,25,24,1,1,"PACMA",0
34,"34058",189,172,172,2,0,"PACMA",0
19,"19182",38,34,33,0,1,"PACMA",0
24,"24096",117,80,79,1,1,"PACMA",1
6,"6157",443,321,316,1,5,"PACMA",0
25,"25242",720,456,450,2,6,"PACMA",5
25,"25210",1108,685,677,3,8,"PACMA",4
13,"13020",4781,3198,3161,31,37,"PACMA",44
22,"22081",254,181,181,0,0,"PACMA",0
37,"37135",1207,905,899,15,6,"PACMA",5
12,"12136",2635,2201,2171,18,30,"PACMA",10
50,"50193",651,514,501,2,13,"PACMA",8
1,"1017",849,571,565,5,6,"PACMA",5
33,"33025",9174,5838,5786,57,52,"PACMA",50
41,"41084",2845,2124,2081,9,43,"PACMA",16
25,"25212",233,154,153,6,1,"PACMA",4
50,"50014",147,94,94,0,0,"PACMA",0
48,"48029",8338,5721,5683,37,38,"PACMA",67
48,"48059",400,294,291,0,3,"PACMA",1
37,"37219",173,109,108,0,1,"PACMA",0
42,"42001",278,212,210,3,2,"PACMA",1
16,"16163",74,62,62,0,0,"PACMA",0
22,"22072",191,136,135,0,1,"PACMA",0
39,"39080",3542,2656,2628,20,28,"PACMA",20
37,"37091",177,117,116,1,1,"PACMA",0
10,"10050",1053,846,837,6,9,"PACMA",0
25,"25902",567,365,356,8,9,"PACMA",0
19,"19221",48,38,37,1,1,"PACMA",0
30,"30018",7978,5866,5811,30,55,"PACMA",80
23,"23027",723,576,572,3,4,"PACMA",2
27,"27023",2579,1891,1865,23,26,"PACMA",7
7,"7036",26955,18578,18433,148,145,"PACMA",322
47,"47096",140,110,110,0,0,"PACMA",0
46,"46067",1753,1418,1393,1,25,"PACMA",8
6,"6115",1261,841,832,5,9,"PACMA",6
3,"3093",19683,14633,14484,70,149,"PACMA",227
5,"5054",1224,935,924,8,11,"PACMA",6
27,"27024",1598,1173,1158,8,15,"PACMA",5
9,"9272",282,210,206,3,4,"PACMA",0
16,"16199",30,25,25,1,0,"PACMA",1
41,"41019",4691,3089,3056,27,33,"PACMA",38
50,"50005",229,189,189,1,0,"PACMA",0
26,"26165",358,304,299,2,5,"PACMA",1
13,"13025",302,244,244,1,0,"PACMA",0
50,"50205",90,63,61,0,2,"PACMA",1
28,"28100",4196,2987,2955,14,32,"PACMA",55
19,"19222",110,82,82,0,0,"PACMA",0
9,"9138",85,72,70,0,2,"PACMA",0
10,"10052",182,130,129,0,1,"PACMA",5
12,"12099",539,416,403,7,13,"PACMA",2
44,"44049",849,616,604,9,12,"PACMA",4
9,"9001",27,22,22,0,0,"PACMA",0
12,"12020",118,105,105,0,0,"PACMA",0
29,"29025",39665,25907,25714,192,193,"PACMA",442
6,"6072",2307,1696,1681,12,15,"PACMA",11
3,"3002",3605,2583,2557,15,26,"PACMA",37
38,"38044",2188,1348,1334,6,14,"PACMA",5
23,"23029",843,628,624,2,4,"PACMA",1
7,"7039",4839,3136,3060,31,76,"PACMA",18
49,"49173",375,230,221,3,9,"PACMA",2
44,"44192",355,280,278,4,2,"PACMA",0
5,"5204",603,456,451,1,5,"PACMA",2
19,"19111",155,126,126,1,0,"PACMA",1
37,"37266",82,63,63,2,0,"PACMA",1
47,"47208",58,38,36,1,2,"PACMA",0
44,"44124",77,64,64,3,0,"PACMA",1
5,"5205",74,57,55,1,2,"PACMA",0
49,"49097",85,52,51,0,1,"PACMA",0
16,"16060",744,565,554,7,11,"PACMA",1
28,"28132",11685,8130,8062,56,68,"PACMA",121
48,"48063",372,279,277,2,2,"PACMA",2
24,"24003",648,460,453,7,7,"PACMA",0
47,"47209",41,34,34,0,0,"PACMA",0
16,"16205",115,88,87,0,1,"PACMA",0
48,"48003",14339,9918,9838,53,80,"PACMA",77
24,"24227",1607,1127,1116,22,11,"PACMA",17
34,"34053",207,170,169,3,1,"PACMA",0
50,"50102",859,658,653,8,5,"PACMA",2
18,"18047",5903,3893,3857,28,36,"PACMA",65
28,"28093",2096,1670,1653,10,17,"PACMA",16
18,"18905",14618,9789,9682,110,107,"PACMA",200
28,"28065",126539,96997,96210,505,787,"PACMA",1203
37,"37228",360,297,295,2,2,"PACMA",0
7,"7042",10666,6680,6613,64,67,"PACMA",179
10,"10134",567,401,396,2,5,"PACMA",3
46,"46175",456,389,387,3,2,"PACMA",0
1,"1041",149,103,100,1,3,"PACMA",1
19,"19249",32,29,29,0,0,"PACMA",0
13,"13014",492,398,397,1,1,"PACMA",0
41,"41057",269,183,181,0,2,"PACMA",1
33,"33002",9995,6765,6672,47,93,"PACMA",53
26,"26062",89,72,71,2,1,"PACMA",0
10,"10105",2512,1644,1620,12,24,"PACMA",10
42,"42141",112,80,80,0,0,"PACMA",0
9,"9327",26,24,24,0,0,"PACMA",1
22,"22178",103,82,81,0,1,"PACMA",0
42,"42010",19,14,14,1,0,"PACMA",0
18,"18065",618,496,470,3,26,"PACMA",5
49,"49262",392,279,274,1,5,"PACMA",0
44,"44196",131,101,98,2,3,"PACMA",0
37,"37010",939,708,702,0,6,"PACMA",2
9,"9192",55,43,43,0,0,"PACMA",1
31,"31176",2869,2010,1963,33,47,"PACMA",25
49,"49101",153,102,99,0,3,"PACMA",0
31,"31011",693,459,456,8,3,"PACMA",4
31,"31077",5352,3908,3848,41,60,"PACMA",22
47,"47183",130,106,105,0,1,"PACMA",0
12,"12134",141,95,94,0,1,"PACMA",0
7,"7045",1295,947,936,5,11,"PACMA",13
24,"24039",2063,1597,1596,41,1,"PACMA",5
41,"41026",4314,3380,3322,18,58,"PACMA",16
3,"3099",42319,31083,30801,165,282,"PACMA",299
3,"3007",166,139,137,0,2,"PACMA",2
42,"42144",436,353,348,2,5,"PACMA",0
10,"10046",203,168,168,1,0,"PACMA",0
12,"12026",881,678,663,13,15,"PACMA",0
9,"9280",28,20,20,0,0,"PACMA",0
49,"49139",171,135,135,0,0,"PACMA",1
38,"38050",2462,1624,1604,8,20,"PACMA",20
38,"38051",7194,5158,5080,31,78,"PACMA",43
5,"5261",41,26,26,0,0,"PACMA",0
33,"33035",11284,7681,7618,70,63,"PACMA",98
16,"16066",2325,1788,1745,19,43,"PACMA",8
18,"18067",702,469,466,0,3,"PACMA",1
40,"40149",514,375,369,5,6,"PACMA",3
47,"47184",573,453,451,1,2,"PACMA",2
49,"49265",128,91,91,1,0,"PACMA",0
9,"9378",31,24,23,0,1,"PACMA",0
37,"37177",289,220,219,2,1,"PACMA",0
9,"9362",208,172,171,2,1,"PACMA",1
50,"50202",152,100,99,1,1,"PACMA",0
14,"14022",4006,2977,2949,17,28,"PACMA",16
31,"31079",73,54,53,0,1,"PACMA",2
26,"26066",251,201,194,1,7,"PACMA",3
22,"22057",370,271,270,3,1,"PACMA",1
3,"3101",4808,3627,3580,22,47,"PACMA",28
22,"22095",72,58,58,1,0,"PACMA",0
1,"1046",601,432,428,3,4,"PACMA",3
44,"44056",501,345,342,2,3,"PACMA",3
42,"42054",19,16,16,0,0,"PACMA",0
6,"6129",577,438,429,0,9,"PACMA",1
11,"11018",1468,1046,1031,9,15,"PACMA",9
19,"19160",886,558,552,2,6,"PACMA",13
26,"26067",22,15,15,1,0,"PACMA",0
30,"30028",6649,4797,4726,21,71,"PACMA",23
49,"49145",236,162,157,0,5,"PACMA",0
27,"27041",2341,1718,1705,16,13,"PACMA",10
20,"20008",716,362,361,6,1,"PACMA",0
44,"44200",39,26,26,0,0,"PACMA",0
12,"12138",19061,13010,12847,129,163,"PACMA",144
50,"50120",52,40,40,1,0,"PACMA",1
45,"45203",2563,1801,1771,8,30,"PACMA",33
5,"5216",220,171,168,0,3,"PACMA",0
24,"24010",8386,5708,5632,60,76,"PACMA",62
10,"10021",5147,3744,3648,31,96,"PACMA",17
25,"25228",3035,1933,1921,26,12,"PACMA",26
42,"42017",140,113,112,0,1,"PACMA",0
6,"6039",1840,1469,1437,9,32,"PACMA",3
37,"37193",390,279,275,4,4,"PACMA",0
50,"50121",277,216,214,1,2,"PACMA",1
42,"42152",78,55,55,0,0,"PACMA",1
21,"21025",4026,2433,2396,30,37,"PACMA",26
39,"39092",894,626,620,1,6,"PACMA",4
13,"13095",85,66,66,0,0,"PACMA",0
9,"9337",117,92,91,0,1,"PACMA",0
26,"26176",53,44,44,1,0,"PACMA",0
31,"31149",2305,1461,1441,8,20,"PACMA",2
46,"46155",1029,833,822,4,11,"PACMA",5
12,"12077",4605,3439,3382,15,57,"PACMA",27
6,"6071",245,206,200,0,6,"PACMA",4
31,"31139",159,96,95,0,1,"PACMA",0
19,"19223",111,83,83,3,0,"PACMA",0
14,"14025",2924,2466,2422,14,44,"PACMA",21
16,"16073",185,164,164,1,0,"PACMA",1
48,"48042",1369,1068,1053,7,15,"PACMA",13
12,"12140",1143,939,930,6,9,"PACMA",2
5,"5074",686,564,558,5,6,"PACMA",1
46,"46104",1940,1504,1487,7,17,"PACMA",17
20,"20011",1658,1219,1210,7,9,"PACMA",3
1,"1052",245,184,181,0,3,"PACMA",0
45,"45138",1091,877,871,4,6,"PACMA",11
23,"23043",546,398,396,3,2,"PACMA",0
9,"9114",86,66,66,0,0,"PACMA",0
35,"35013",6625,4896,4781,41,115,"PACMA",44
19,"19308",56,53,53,0,0,"PACMA",0
37,"37114",84,70,69,2,1,"PACMA",0
9,"9160",85,64,64,0,0,"PACMA",0
25,"25019",4572,2726,2698,34,28,"PACMA",28
9,"9246",620,451,444,2,7,"PACMA",1
13,"13098",2092,1503,1461,8,42,"PACMA",12
9,"9202",25,22,22,1,0,"PACMA",0
16,"16170",692,501,493,4,8,"PACMA",6
44,"44031",97,62,62,0,0,"PACMA",0
7,"7014",7320,4163,4116,45,47,"PACMA",52
4,"4049",5313,3620,3579,18,41,"PACMA",24
3,"3065",167284,123032,122305,711,727,"PACMA",1550
20,"20067",30828,19984,19882,140,102,"PACMA",198
30,"30022",16913,11371,11214,93,157,"PACMA",91
5,"5060",116,95,95,0,0,"PACMA",0
10,"10072",859,617,615,5,2,"PACMA",3
49,"49069",367,258,254,5,4,"PACMA",1
6,"6091",3774,2709,2666,23,43,"PACMA",10
44,"44205",700,460,453,4,7,"PACMA",0
40,"40017",92,75,75,0,0,"PACMA",0
10,"10073",747,524,516,4,8,"PACMA",1
47,"47110",450,350,346,1,4,"PACMA",0
49,"49176",667,433,431,1,2,"PACMA",0
19,"19033",64,52,50,1,2,"PACMA",0
9,"9343",93,66,65,0,1,"PACMA",0
4,"4091",334,268,267,6,1,"PACMA",1
5,"5127",643,519,514,3,5,"PACMA",1
20,"20047",469,307,304,5,3,"PACMA",0
39,"39066",872,667,661,4,6,"PACMA",1
19,"19045",140,120,120,0,0,"PACMA",0
42,"42108",12,9,9,1,0,"PACMA",0
5,"5176",235,181,174,4,7,"PACMA",1
18,"18174",446,330,324,2,6,"PACMA",1
25,"25105",125,92,92,2,0,"PACMA",1
6,"6092",577,415,405,3,10,"PACMA",1
37,"37069",968,695,689,7,6,"PACMA",4
50,"50126",2371,1573,1559,19,14,"PACMA",3
47,"47139",1040,777,767,6,10,"PACMA",0
31,"31187",111,68,63,1,5,"PACMA",0
6,"6093",4447,3254,3204,15,50,"PACMA",12
9,"9166",97,81,81,0,0,"PACMA",1
16,"16083",52,33,33,0,0,"PACMA",0
37,"37244",131,98,98,0,0,"PACMA",0
21,"21032",1800,1286,1259,10,27,"PACMA",6
30,"30035",18671,13103,12979,54,124,"PACMA",179
31,"31089",242,172,170,1,2,"PACMA",4
25,"25023",4531,2782,2763,30,19,"PACMA",34
10,"10031",165,135,134,1,1,"PACMA",0
20,"20901",1437,908,906,2,2,"PACMA",2
10,"10169",531,420,409,2,11,"PACMA",0
45,"45010",415,311,310,2,1,"PACMA",1
25,"25194",423,246,244,6,2,"PACMA",2
5,"5033",176,144,142,1,2,"PACMA",0
1,"1016",433,228,226,5,2,"PACMA",1
46,"46212",1620,1150,1124,9,26,"PACMA",12
27,"27002",1633,1137,1108,9,29,"PACMA",10
5,"5082",529,432,422,1,10,"PACMA",3
4,"4063",1096,776,768,2,8,"PACMA",7
47,"47221",111,94,94,0,0,"PACMA",0
7,"7060",2568,1677,1653,16,24,"PACMA",21
31,"31189",1161,720,709,6,11,"PACMA",5
31,"31257",875,634,625,8,9,"PACMA",11
14,"14031",593,469,459,3,10,"PACMA",0
31,"31057",1781,1287,1268,10,19,"PACMA",3
28,"28031",2048,1500,1486,3,14,"PACMA",5
21,"21022",171,107,105,0,2,"PACMA",0
38,"38015",4170,2862,2836,10,26,"PACMA",23
48,"48049",549,416,416,1,0,"PACMA",2
42,"42065",21,18,18,0,0,"PACMA",0
19,"19208",43,30,30,0,0,"PACMA",0
45,"45179",525,391,386,3,5,"PACMA",0
10,"10171",344,245,244,0,1,"PACMA",0
5,"5230",66,63,62,1,1,"PACMA",2
44,"44210",746,554,545,3,9,"PACMA",1
2,"2072",1549,1086,1070,2,16,"PACMA",10
28,"28051",1541,1163,1149,1,14,"PACMA",20
34,"34091",123,94,93,3,1,"PACMA",2
21,"21036",200,141,139,0,2,"PACMA",1
16,"16181",64,52,52,2,0,"PACMA",0
46,"46240",210,164,161,1,3,"PACMA",4
22,"22112",9566,6354,6305,56,49,"PACMA",49
7,"7063",1418,1043,1033,6,10,"PACMA",10
13,"13005",23298,17250,17070,140,180,"PACMA",140
9,"9170",205,162,162,1,0,"PACMA",1
16,"16087",208,179,177,5,2,"PACMA",0
50,"50131",231,167,165,0,2,"PACMA",1
30,"30038",15411,10847,10767,46,80,"PACMA",105
22,"22202",141,119,119,0,0,"PACMA",0
13,"13006",597,456,447,4,9,"PACMA",1
40,"40165",77,65,64,1,1,"PACMA",0
9,"9257",93,81,80,4,1,"PACMA",0
50,"50067",14119,9909,9819,112,90,"PACMA",89
23,"23014",2559,1971,1942,13,29,"PACMA",14
45,"45081",17875,12656,12533,82,123,"PACMA",229
24,"24120",341,246,244,1,2,"PACMA",0
46,"46189",467,393,390,2,3,"PACMA",8
40,"40166",253,218,215,1,3,"PACMA",1
19,"19010",8,8,8,0,0,"PACMA",0
50,"50225",1570,956,950,3,6,"PACMA",5
16,"16186",456,375,371,0,4,"PACMA",3
30,"30040",732,617,607,2,10,"PACMA",6
6,"6055",2051,1453,1422,8,31,"PACMA",2
3,"3083",5586,3971,3928,33,43,"PACMA",35
50,"50099",3083,2148,2132,13,16,"PACMA",12
44,"44146",174,153,152,2,1,"PACMA",3
25,"25156",783,543,537,7,6,"PACMA",5
40,"40040",2607,1843,1828,19,15,"PACMA",9
18,"18072",667,424,420,0,4,"PACMA",2
40,"40041",979,725,717,5,8,"PACMA",1
46,"46034",1758,1390,1379,4,11,"PACMA",21
19,"19134",24,15,15,0,0,"PACMA",0
45,"45050",457,333,328,1,5,"PACMA",5
9,"9173",124,100,99,2,1,"PACMA",0
41,"41043",639,436,427,5,9,"PACMA",2
16,"16246",482,361,355,3,6,"PACMA",1
30,"30041",13621,8970,8889,46,81,"PACMA",106
28,"28026",6317,4734,4701,33,33,"PACMA",64
39,"39073",9837,7356,7298,31,58,"PACMA",86
31,"31195",182,130,128,0,2,"PACMA",0
16,"16189",264,206,205,4,1,"PACMA",1
46,"46009",3121,2459,2427,8,32,"PACMA",27
40,"40128",129,95,93,0,2,"PACMA",5
9,"9400",317,247,245,1,2,"PACMA",0
22,"22076",311,201,199,0,2,"PACMA",2
10,"10904",745,507,504,8,3,"PACMA",2
37,"37128",260,202,196,0,6,"PACMA",0
37,"37034",85,65,65,0,0,"PACMA",0
10,"10088",204,131,128,1,3,"PACMA",0
6,"6105",624,418,417,1,1,"PACMA",0
40,"40003",139,107,104,0,3,"PACMA",0
37,"37379",174,133,131,1,2,"PACMA",1
22,"22077",379,279,273,2,6,"PACMA",0
9,"9295",61,44,44,0,0,"PACMA",0
44,"44064",69,49,49,0,0,"PACMA",2
3,"3075",147,128,128,0,0,"PACMA",6
29,"29028",1237,836,826,6,10,"PACMA",9
46,"46036",564,383,378,5,5,"PACMA",0
13,"13013",7068,5147,5063,25,84,"PACMA",24
50,"50230",1165,833,828,8,5,"PACMA",1
26,"26109",81,69,69,0,0,"PACMA",1
16,"16047",232,175,175,2,0,"PACMA",2
25,"25122",1915,1208,1197,16,11,"PACMA",5
16,"16904",472,378,373,4,5,"PACMA",3
40,"40131",48,42,42,0,0,"PACMA",0
50,"50071",132,92,92,0,0,"PACMA",0
46,"46167",364,266,264,0,2,"PACMA",0
1,"1901",2354,1592,1571,8,21,"PACMA",34
25,"25163",231,135,132,2,3,"PACMA",1
37,"37130",172,151,150,0,1,"PACMA",1
5,"5239",214,164,162,3,2,"PACMA",2
46,"46037",1122,936,923,4,13,"PACMA",9
45,"45053",8005,6211,6140,42,71,"PACMA",35
10,"10136",302,218,215,4,3,"PACMA",1
28,"28029",520,408,406,0,2,"PACMA",4
26,"26052",154,121,117,0,4,"PACMA",0
50,"50169",351,269,265,0,4,"PACMA",1
48,"48086",2050,1414,1401,5,13,"PACMA",12
24,"24027",1211,863,847,8,16,"PACMA",10
9,"9266",91,74,74,0,0,"PACMA",0
19,"19250",20,17,17,0,0,"PACMA",0
39,"39046",1404,1001,973,6,28,"PACMA",6
34,"34101",50,41,41,0,0,"PACMA",0
9,"9444",72,58,58,3,0,"PACMA",0
44,"44117",340,271,268,4,3,"PACMA",1
46,"46116",13159,10193,10135,53,58,"PACMA",172
42,"42037",33,25,25,2,0,"PACMA",0
22,"22209",155,120,120,3,0,"PACMA",0
22,"22249",116,95,95,4,0,"PACMA",3
18,"18099",1584,1228,1206,14,22,"PACMA",8
5,"5242",681,559,558,8,1,"PACMA",1
42,"42173",29281,20286,20035,261,251,"PACMA",123
9,"9178",47,35,35,0,0,"PACMA",0
21,"21047",1917,1111,1065,15,46,"PACMA",4
7,"7032",20034,12824,12710,110,114,"PACMA",168
26,"26088",37,32,31,0,1,"PACMA",0
49,"49046",268,203,203,0,0,"PACMA",0
34,"34205",61,50,50,0,0,"PACMA",0
19,"19252",69,60,60,0,0,"PACMA",0
37,"37134",230,168,165,0,3,"PACMA",1
49,"49251",163,127,121,1,6,"PACMA",0
2,"2043",1239,937,927,3,10,"PACMA",1
6,"6021",926,645,636,8,9,"PACMA",2
25,"25039",277,181,180,3,1,"PACMA",1
47,"47094",133,115,114,1,1,"PACMA",3
38,"38039",10641,7547,7459,49,88,"PACMA",115
22,"22124",201,144,143,1,1,"PACMA",1
49,"49168",93,74,74,0,0,"PACMA",0
5,"5036",123,101,101,1,0,"PACMA",0
34,"34103",98,77,76,0,1,"PACMA",0
18,"18101",9265,6618,6560,59,58,"PACMA",100
5,"5051",179,145,139,1,6,"PACMA",0
49,"49209",505,342,341,2,1,"PACMA",0
9,"9180",142,107,102,1,5,"PACMA",0
19,"19021",1030,759,744,7,15,"PACMA",5
33,"33056",4997,3269,3244,22,25,"PACMA",19
31,"31002",414,288,287,3,1,"PACMA",3
37,"37345",163,128,128,3,0,"PACMA",0
2,"2086",2586,1701,1687,7,14,"PACMA",4
22,"22047",243,205,203,2,2,"PACMA",2
3,"3091",252,217,215,2,2,"PACMA",3
47,"47068",34,26,26,0,0,"PACMA",0
13,"13022",348,260,258,4,2,"PACMA",0
42,"42041",34,25,25,0,0,"PACMA",0
24,"24165",354,240,238,2,2,"PACMA",0
11,"11007",17964,10038,9856,197,182,"PACMA",111
19,"19256",43,36,36,0,0,"PACMA",0
2,"2005",559,424,416,5,8,"PACMA",1
44,"44121",60,47,47,2,0,"PACMA",0
9,"9317",19,16,16,0,0,"PACMA",0
39,"39050",270,187,186,0,1,"PACMA",0
37,"37045",26,23,21,0,2,"PACMA",0
42,"42177",69,60,60,1,0,"PACMA",0
10,"10097",101,75,74,0,1,"PACMA",0
2,"2006",579,464,458,3,6,"PACMA",0
16,"16103",261,222,222,0,0,"PACMA",0
4,"4076",1279,960,944,8,16,"PACMA",5
21,"21052",4583,2734,2663,22,71,"PACMA",45
37,"37264",65,40,40,0,0,"PACMA",0
31,"31171",680,495,486,8,9,"PACMA",0
25,"25216",226,138,136,1,2,"PACMA",0
44,"44223",72,54,54,0,0,"PACMA",0
26,"26093",53,39,38,0,1,"PACMA",0
48,"48092",836,618,613,5,5,"PACMA",6
23,"23065",1597,1170,1149,2,21,"PACMA",3
10,"10099",583,378,374,2,4,"PACMA",0
5,"5200",44,31,30,1,1,"PACMA",0
1,"1036",14955,10052,9959,55,93,"PACMA",64
48,"48001",5838,3923,3898,28,25,"PACMA",40
40,"40170",1320,1030,1021,7,9,"PACMA",2
9,"9321",1626,1238,1227,8,11,"PACMA",8
6,"6117",1424,960,938,4,22,"PACMA",4
19,"19296",30,19,18,0,1,"PACMA",0
39,"39022",980,721,713,2,8,"PACMA",1
22,"22217",385,287,281,1,6,"PACMA",1
25,"25044",188,122,120,7,2,"PACMA",0
22,"22085",104,86,86,0,0,"PACMA",1
19,"19024",8196,5613,5563,28,50,"PACMA",92
9,"9323",61,46,46,1,0,"PACMA",0
50,"50238",91,66,66,1,0,"PACMA",0
37,"37309",44,30,30,1,0,"PACMA",0
31,"31173",861,683,667,3,16,"PACMA",5
9,"9414",189,148,146,0,2,"PACMA",1
44,"44193",78,54,54,1,0,"PACMA",0
6,"6119",689,501,499,4,2,"PACMA",3
18,"18062",10393,7235,7161,63,74,"PACMA",104
4,"4078",1078,758,746,8,12,"PACMA",2
33,"33061",378,202,200,0,2,"PACMA",1
40,"40057",1456,1154,1148,7,6,"PACMA",7
46,"46200",1903,1561,1539,3,22,"PACMA",12
37,"37142",586,430,429,1,1,"PACMA",4
19,"19260",42,39,39,1,0,"PACMA",0
49,"49260",755,590,586,8,4,"PACMA",3
37,"37100",80,61,61,1,0,"PACMA",0
1,"1063",1798,1269,1261,19,8,"PACMA",9
25,"25161",360,219,218,2,1,"PACMA",1
42,"42033",48,45,45,1,0,"PACMA",0
39,"39054",4493,3376,3334,33,42,"PACMA",51
23,"23070",3914,2433,2407,14,26,"PACMA",9
50,"50050",98,64,64,2,0,"PACMA",1
2,"2011",632,520,516,1,4,"PACMA",0
28,"28009",14086,10611,10545,57,66,"PACMA",141
46,"46201",64,52,51,1,1,"PACMA",0
37,"37009",213,172,171,3,1,"PACMA",1
9,"9191",38,28,27,0,1,"PACMA",0
5,"5110",711,510,505,4,5,"PACMA",3
4,"4080",209,162,162,3,0,"PACMA",0
12,"12002",110,99,98,1,1,"PACMA",0
37,"37269",447,326,324,1,2,"PACMA",0
49,"49223",752,608,600,4,8,"PACMA",3
42,"42090",91,69,67,1,2,"PACMA",0
22,"22088",153,110,110,2,0,"PACMA",2
16,"16110",93,70,70,0,0,"PACMA",0
40,"40059",110,95,95,1,0,"PACMA",0
18,"18111",2765,1949,1936,18,13,"PACMA",21
16,"16111",171,123,123,1,0,"PACMA",0
49,"49177",278,179,177,1,2,"PACMA",2
13,"13033",1633,1328,1290,4,38,"PACMA",9
46,"46228",2348,1815,1794,7,21,"PACMA",15
26,"26063",124,94,94,2,0,"PACMA",1
5,"5012",133,105,102,0,3,"PACMA",0
28,"28067",4063,3102,3079,3,23,"PACMA",45
13,"13086",175,137,134,0,3,"PACMA",0
42,"42187",62,46,45,1,1,"PACMA",0
24,"24038",3089,2312,2273,17,39,"PACMA",8
4,"4082",297,200,200,0,0,"PACMA",0
50,"50053",687,513,510,2,3,"PACMA",7
13,"13034",58191,42423,42027,291,396,"PACMA",487
46,"46125",847,689,684,5,5,"PACMA",3
24,"24071",1006,745,734,10,11,"PACMA",5
18,"18112",123,82,82,2,0,"PACMA",0
46,"46262",223,162,159,2,3,"PACMA",0
24,"24105",1459,1042,1025,16,17,"PACMA",11
31,"31245",81,55,55,2,0,"PACMA",0
6,"6125",1743,1285,1269,7,16,"PACMA",1
46,"46021",23649,17291,17153,100,138,"PACMA",231
34,"34120",64214,47193,46683,331,510,"PACMA",393
12,"12104",6933,5411,5342,25,69,"PACMA",31
12,"12073",152,119,117,0,2,"PACMA",2
18,"18024",855,665,654,7,11,"PACMA",4
41,"41060",15242,10021,9847,86,174,"PACMA",112
50,"50243",331,250,246,0,4,"PACMA",0
37,"37273",107,71,71,1,0,"PACMA",0
42,"42052",15,13,13,0,0,"PACMA",0
22,"22094",101,74,74,1,0,"PACMA",2
10,"10109",1762,1149,1125,14,24,"PACMA",5
24,"24106",248,167,166,1,1,"PACMA",0
37,"37218",67,42,41,0,1,"PACMA",0
28,"28003",173,141,141,0,0,"PACMA",2
4,"4019",249,196,196,1,0,"PACMA",1
47,"47077",246,193,191,1,2,"PACMA",0
23,"23076",827,640,630,1,10,"PACMA",6
27,"27039",4358,3143,3085,40,58,"PACMA",19
45,"45068",160,126,126,0,0,"PACMA",4
31,"31013",642,406,401,1,5,"PACMA",0
5,"5166",185,139,139,1,0,"PACMA",0
34,"34122",83,60,60,0,0,"PACMA",0
31,"31113",133,87,86,0,1,"PACMA",0
6,"6037",1748,1148,1134,9,14,"PACMA",4
20,"20073",4677,3014,2995,15,19,"PACMA",17
49,"49228",54,44,43,0,1,"PACMA",0
25,"25098",253,151,150,0,1,"PACMA",2
22,"22186",181,130,129,1,1,"PACMA",0
9,"9464",35,27,27,0,0,"PACMA",1
3,"3102",7229,5492,5414,52,78,"PACMA",38
45,"45168",62229,47154,46741,285,413,"PACMA",440
19,"19267",19,13,13,0,0,"PACMA",0
29,"29067",424813,286785,284689,2351,2096,"PACMA",5491
47,"47078",163,127,125,1,2,"PACMA",0
24,"24077",225,190,187,2,3,"PACMA",0
31,"31214",91,64,62,1,2,"PACMA",1
39,"39060",6679,5196,5121,29,75,"PACMA",45
10,"10066",160,122,122,0,0,"PACMA",2
46,"46180",682,553,549,0,4,"PACMA",16
25,"25141",153,95,95,0,0,"PACMA",0
14,"14052",9379,5917,5854,68,63,"PACMA",44
34,"34077",347,244,238,4,6,"PACMA",0
47,"47052",6576,4988,4944,40,44,"PACMA",56
48,"48010",458,318,317,0,1,"PACMA",2
50,"50057",1395,919,907,11,12,"PACMA",3
28,"28079",2362038,1743924,1733354,8859,10570,"PACMA",17028
44,"44027",164,123,123,1,0,"PACMA",1
4,"4022",347,249,249,7,0,"PACMA",1
48,"48041",693,533,529,3,4,"PACMA",6
9,"9029",168,131,129,4,2,"PACMA",5
2,"2021",1017,784,778,6,6,"PACMA",3
20,"20043",1739,1090,1088,9,2,"PACMA",3
31,"31050",6014,3489,3450,57,39,"PACMA",23
3,"3104",27103,19953,19787,131,166,"PACMA",248
45,"45126",260,176,175,3,1,"PACMA",1
47,"47080",30,22,21,0,1,"PACMA",0
5,"5122",134,102,101,0,1,"PACMA",0
6,"6133",1775,1324,1312,15,12,"PACMA",0
37,"37113",433,334,333,3,1,"PACMA",1
26,"26037",128,108,108,2,0,"PACMA",0
37,"37279",750,522,513,4,9,"PACMA",4
40,"40071",43,39,38,1,1,"PACMA",0
44,"44135",113,88,87,0,1,"PACMA",0
39,"39063",967,697,690,9,7,"PACMA",3
34,"34126",277,200,199,2,1,"PACMA",2
16,"16123",82,61,61,3,0,"PACMA",0
34,"34081",61,53,52,0,1,"PACMA",2
3,"3074",1707,1397,1389,4,8,"PACMA",7
26,"26143",220,175,173,1,2,"PACMA",1
50,"50059",769,549,544,8,5,"PACMA",0
19,"19270",20,17,17,0,0,"PACMA",0
25,"25058",4357,2624,2595,20,29,"PACMA",29
2,"2023",568,486,479,3,7,"PACMA",1
28,"28017",1208,907,899,7,8,"PACMA",11
44,"44171",178,126,124,2,2,"PACMA",4
22,"22190",119,86,85,0,1,"PACMA",2
9,"9070",34,26,26,0,0,"PACMA",0
5,"5124",102,83,81,0,2,"PACMA",0
37,"37281",36,33,31,0,2,"PACMA",0
12,"12131",63,52,52,0,0,"PACMA",0
21,"21015",680,398,393,8,5,"PACMA",2
19,"19031",15,9,9,0,0,"PACMA",0
16,"16079",30,19,18,0,1,"PACMA",0
12,"12080",1932,1598,1570,10,28,"PACMA",3
9,"9340",77,49,49,0,0,"PACMA",0
16,"16903",1070,777,765,4,12,"PACMA",3
29,"29072",3262,2382,2352,17,30,"PACMA",23
39,"39065",252,191,189,1,2,"PACMA",1
41,"41067",7093,4930,4866,37,64,"PACMA",47
31,"31119",39,26,26,0,0,"PACMA",0
30,"30003",24332,16183,16040,104,143,"PACMA",133
16,"16905",1224,920,910,4,10,"PACMA",3
46,"46002",1175,941,932,5,9,"PACMA",8
23,"23086",11511,7997,7874,91,123,"PACMA",108
24,"24150",243,172,172,6,0,"PACMA",2
47,"47138",241,170,164,1,6,"PACMA",1
24,"24082",858,629,614,8,15,"PACMA",3
45,"45008",139,118,118,1,0,"PACMA",0
19,"19274",902,660,651,7,9,"PACMA",9
22,"22064",166,122,121,1,1,"PACMA",1
44,"44206",114,90,87,0,3,"PACMA",3
27,"27051",8108,5503,5424,62,79,"PACMA",63
42,"42061",291,214,213,3,1,"PACMA",2
10,"10075",253,167,166,1,1,"PACMA",1
46,"46055",1262,1025,1012,5,13,"PACMA",20
2,"2027",315,248,246,2,2,"PACMA",0
16,"16128",63,50,50,0,0,"PACMA",0
14,"14057",6136,4713,4631,47,82,"PACMA",31
22,"22234",794,552,544,3,8,"PACMA",2
25,"25193",759,485,480,2,5,"PACMA",0
6,"6002",4322,2819,2762,22,57,"PACMA",26
6,"6003",823,627,616,1,11,"PACMA",2
41,"41070",6032,4312,4258,44,54,"PACMA",71
21,"21073",1862,1125,1109,8,16,"PACMA",5
49,"49114",43,34,33,0,1,"PACMA",0
26,"26042",834,635,625,5,10,"PACMA",3
21,"21033",538,373,370,3,3,"PACMA",2
16,"16237",110,87,87,0,0,"PACMA",0
37,"37202",978,734,727,10,7,"PACMA",9
49,"49116",383,276,269,3,7,"PACMA",1
19,"19204",148,120,120,0,0,"PACMA",1
44,"44142",35,27,27,0,0,"PACMA",1
3,"3902",10254,6996,6930,34,66,"PACMA",65
24,"24117",434,334,331,1,3,"PACMA",0
47,"47141",134,111,110,0,1,"PACMA",0
48,"48911",380,276,272,1,4,"PACMA",0
9,"9075",112,91,91,3,0,"PACMA",1
21,"21074",2649,1755,1733,13,22,"PACMA",6
22,"22110",738,531,527,4,4,"PACMA",2
37,"37287",310,213,210,2,3,"PACMA",1
25,"25196",113,57,57,0,0,"PACMA",0
28,"28087",3186,2503,2487,19,16,"PACMA",11
16,"16909",699,535,532,0,3,"PACMA",5
37,"37058",58,45,45,0,0,"PACMA",0
42,"42148",10,10,10,1,0,"PACMA",0
16,"16177",78,64,64,0,0,"PACMA",0
45,"45011",278,239,233,1,6,"PACMA",0
5,"5035",100,84,84,0,0,"PACMA",0
25,"25025",1353,871,864,16,7,"PACMA",7
46,"46005",22918,16958,16827,102,131,"PACMA",260
2,"2031",565,457,455,0,2,"PACMA",1
38,"38028",22103,15036,14844,85,192,"PACMA",243
6,"6143",3360,2353,2321,12,32,"PACMA",11
30,"30007",6411,4360,4329,24,31,"PACMA",55
28,"28023",4775,3755,3735,12,20,"PACMA",45
9,"9394",715,533,521,3,12,"PACMA",3
45,"45012",661,510,503,6,7,"PACMA",2
44,"44110",49,42,42,1,0,"PACMA",0
24,"24155",471,388,384,6,4,"PACMA",2
16,"16040",80,62,62,0,0,"PACMA",1
5,"5134",48,38,38,0,0,"PACMA",0
4,"4095",714,471,468,5,3,"PACMA",0
31,"31125",274,194,193,6,1,"PACMA",0
18,"18134",5828,3840,3800,36,40,"PACMA",46
44,"44037",453,317,315,0,2,"PACMA",1
42,"42069",1536,1036,1019,6,17,"PACMA",7
6,"6145",922,696,694,5,2,"PACMA",0
29,"29080",6676,4469,4419,35,50,"PACMA",58
44,"44245",248,179,176,2,3,"PACMA",0
14,"14033",1283,971,959,9,12,"PACMA",9
33,"33078",142,101,99,0,2,"PACMA",1
30,"30039",19277,13165,13054,75,111,"PACMA",146
34,"34189",56,44,44,1,0,"PACMA",0
45,"45181",2315,1674,1640,7,34,"PACMA",2
28,"28178",1065,824,818,5,6,"PACMA",16
25,"25201",112,73,72,3,1,"PACMA",0
5,"5136",96,61,60,3,1,"PACMA",0
3,"3051",348,296,294,0,2,"PACMA",0
7,"7064",5315,3475,3434,31,41,"PACMA",57
34,"34139",166,107,106,1,1,"PACMA",1
50,"50257",171,134,134,2,0,"PACMA",1
5,"5039",54,42,41,0,1,"PACMA",0
10,"10902",721,548,540,4,8,"PACMA",1
19,"19282",163,124,123,0,1,"PACMA",0
6,"6147",354,268,268,0,0,"PACMA",0
49,"49243",111,94,93,0,1,"PACMA",0
42,"42165",409,271,261,10,10,"PACMA",0
50,"50068",1982,1348,1335,8,13,"PACMA",2
4,"4097",248,189,189,1,0,"PACMA",2
5,"5138",306,221,220,1,1,"PACMA",0
38,"38032",13237,8908,8828,52,80,"PACMA",146
40,"40083",77,59,59,0,0,"PACMA",0
6,"6011",24723,16883,16718,137,165,"PACMA",140
34,"34003",164,122,119,0,3,"PACMA",0
41,"41076",2183,1341,1327,19,14,"PACMA",1
31,"31028",212,131,131,0,0,"PACMA",0
46,"46139",4485,3617,3574,18,43,"PACMA",35
50,"50197",90,67,67,2,0,"PACMA",0
3,"3023",1398,1184,1167,7,17,"PACMA",11
31,"31095",75,59,59,1,0,"PACMA",1
6,"6058",2026,1433,1416,9,17,"PACMA",7
16,"16247",67,58,58,0,0,"PACMA",0
31,"31129",395,234,234,0,0,"PACMA",1
44,"44040",201,160,157,1,3,"PACMA",1
37,"37169",176,127,126,0,1,"PACMA",0
11,"11033",20903,12949,12771,164,178,"PACMA",160
3,"3054",343,277,275,3,2,"PACMA",0
10,"10178",769,565,553,3,12,"PACMA",4
9,"9904",478,374,370,5,4,"PACMA",1
28,"28027",1203,872,857,3,15,"PACMA",5
5,"5141",94,80,80,1,0,"PACMA",0
10,"10118",286,251,249,1,2,"PACMA",0
39,"39034",286,188,185,5,3,"PACMA",2
41,"41078",2508,1823,1810,19,13,"PACMA",5
27,"27066",12696,8704,8537,98,167,"PACMA",116
19,"19177",76,61,59,0,2,"PACMA",0
18,"18141",404,285,282,0,3,"PACMA",0
24,"24191",108,79,79,0,0,"PACMA",1
2,"2079",2875,2209,2181,12,28,"PACMA",21
37,"37380",56,47,45,0,2,"PACMA",0
14,"14065",1850,1384,1377,16,7,"PACMA",9
41,"41046",3023,2213,2183,5,30,"PACMA",13
18,"18143",973,742,730,5,12,"PACMA",7
37,"37085",4712,3366,3333,27,33,"PACMA",44
26,"26018",10477,8053,7956,65,97,"PACMA",44
19,"19057",76,59,59,1,0,"PACMA",0
10,"10135",1302,981,969,3,12,"PACMA",3
44,"44042",123,91,90,0,1,"PACMA",0
39,"39075",137376,99899,99048,718,851,"PACMA",1034
39,"39076",3476,2594,2559,19,35,"PACMA",22
31,"31232",25155,17648,17450,196,198,"PACMA",204
24,"24161",285,203,201,3,2,"PACMA",0
5,"5095",262,225,223,1,2,"PACMA",2
37,"37341",53,39,39,0,0,"PACMA",2
45,"45019",7377,5307,5251,37,56,"PACMA",63
18,"18006",4130,2904,2864,13,40,"PACMA",11
13,"13016",664,517,509,4,8,"PACMA",5
4,"4071",394,338,337,3,1,"PACMA",1
14,"14066",5856,4150,4095,48,55,"PACMA",31
29,"29086",793,470,470,3,0,"PACMA",3
9,"9086",666,462,459,2,3,"PACMA",5
42,"42079",26,18,18,1,0,"PACMA",0
44,"44151",190,151,148,0,3,"PACMA",2
35,"35025",1797,1261,1245,4,16,"PACMA",6
19,"19058",6793,5258,5218,19,40,"PACMA",66
9,"9088",66,45,45,0,0,"PACMA",1
50,"50232",175,110,110,3,0,"PACMA",0
2,"2041",336,265,260,0,5,"PACMA",0
37,"37300",566,398,395,0,3,"PACMA",3
2,"2042",837,618,611,1,7,"PACMA",1
18,"18145",10491,7538,7477,59,61,"PACMA",101
29,"29087",376,270,266,1,4,"PACMA",2
45,"45154",1493,1079,1074,6,5,"PACMA",11
22,"22080",280,197,194,6,3,"PACMA",1
13,"13018",822,642,640,6,2,"PACMA",4
37,"37133",111,78,73,1,5,"PACMA",0
6,"6156",1175,869,865,8,4,"PACMA",2
50,"50263",193,121,121,0,0,"PACMA",2
31,"31200",761,517,508,3,9,"PACMA",2
18,"18100",7807,5452,5398,50,54,"PACMA",46
19,"19290",834,561,558,5,3,"PACMA",9
10,"10140",1106,820,808,4,12,"PACMA",5
19,"19218",50,33,33,0,0,"PACMA",0
42,"42038",36,28,28,1,0,"PACMA",0
24,"24164",370,218,217,0,1,"PACMA",2
12,"12063",41,29,29,1,0,"PACMA",1
26,"26162",121,99,99,1,0,"PACMA",1
11,"11038",13737,10181,10034,99,147,"PACMA",113
40,"40093",77,65,65,1,0,"PACMA",0
46,"46255",3174,2448,2424,22,24,"PACMA",28
37,"37303",190,142,139,1,3,"PACMA",1
35,"35027",10344,7310,7216,50,94,"PACMA",64
34,"34155",129,104,103,2,1,"PACMA",0
22,"22251",364,284,284,0,0,"PACMA",2
49,"49252",320,254,252,5,2,"PACMA",1
50,"50141",109,90,90,1,0,"PACMA",1
10,"10049",3819,3031,2950,18,81,"PACMA",26
50,"50045",1243,926,925,6,1,"PACMA",3
9,"9447",44,41,41,0,0,"PACMA",0
6,"6022",2651,2089,2054,10,35,"PACMA",19
6,"6159",2329,1351,1318,16,33,"PACMA",7
9,"9363",965,737,734,2,3,"PACMA",0
42,"42083",26,20,20,0,0,"PACMA",0
9,"9093",154,121,119,0,2,"PACMA",3
19,"19064",70,64,64,2,0,"PACMA",0
4,"4902",45437,28936,28699,214,237,"PACMA",252
22,"22126",88,64,64,0,0,"PACMA",0
41,"41085",4086,3058,3012,22,46,"PACMA",37
47,"47095",38,31,31,0,0,"PACMA",0
45,"45058",375,311,304,1,7,"PACMA",1
29,"29091",8957,6186,6078,56,108,"PACMA",63
49,"49255",418,319,316,1,3,"PACMA",0
40,"40221",49,39,39,0,0,"PACMA",0
49,"49256",256,204,204,0,0,"PACMA",0
46,"46224",159,121,121,0,0,"PACMA",0
48,"48030",606,441,439,1,2,"PACMA",0
4,"4903",4320,2858,2825,19,33,"PACMA",10
24,"24066",494,368,366,4,2,"PACMA",3
14,"14071",929,642,630,2,12,"PACMA",1
10,"10007",629,459,454,5,5,"PACMA",0
19,"19148",45,32,31,0,1,"PACMA",0
31,"31238",112,93,93,0,0,"PACMA",0
6,"6161",302,236,235,1,1,"PACMA",1
40,"40097",128,93,92,0,1,"PACMA",1
46,"46068",346,276,266,6,10,"PACMA",2
49,"49013",246,182,181,2,1,"PACMA",0
22,"22254",1124,801,792,11,9,"PACMA",1
25,"25171",2185,1416,1410,8,6,"PACMA",11
28,"28035",1353,1006,998,2,8,"PACMA",14
45,"45194",68,54,53,0,1,"PACMA",0
37,"37307",159,104,103,1,1,"PACMA",0
22,"22901",742,478,470,5,8,"PACMA",1
50,"50268",44,37,37,0,0,"PACMA",0
19,"19066",55,48,48,0,0,"PACMA",2
18,"18016",307,235,233,0,2,"PACMA",0
5,"5001",191,148,147,2,1,"PACMA",0
41,"41088",509,360,356,0,4,"PACMA",0
40,"40224",22,21,21,0,0,"PACMA",0
19,"19297",32,24,24,1,0,"PACMA",1
23,"23067",2460,1831,1805,11,26,"PACMA",8
2,"2050",98,83,82,0,1,"PACMA",0
48,"48093",893,653,643,7,10,"PACMA",3
29,"29038",17676,11056,10970,141,86,"PACMA",180
10,"10102",529,411,405,5,6,"PACMA",2
38,"38045",3837,2127,2111,12,16,"PACMA",17
4,"4014",144,117,114,1,3,"PACMA",1
26,"26060",84,62,62,2,0,"PACMA",1
28,"28102",894,644,636,6,8,"PACMA",6
48,"48033",217,149,149,0,0,"PACMA",1
6,"6903",2021,1377,1360,12,17,"PACMA",13
2,"2051",1676,1177,1162,6,15,"PACMA",1
22,"22220",166,126,125,2,1,"PACMA",2
16,"16002",187,158,158,1,0,"PACMA",2
9,"9355",98,75,75,0,0,"PACMA",0
19,"19189",120,91,90,2,1,"PACMA",0
44,"44158",1180,876,862,10,14,"PACMA",2
31,"31241",133,98,98,2,0,"PACMA",2
9,"9372",212,176,176,4,0,"PACMA",3
35,"35032",3412,2473,2425,17,48,"PACMA",22
5,"5159",252,165,164,0,1,"PACMA",0
22,"22131",82,63,63,0,0,"PACMA",1
31,"31242",260,164,163,1,1,"PACMA",1
12,"12101",358,279,275,3,4,"PACMA",3
39,"39085",6836,5086,5032,44,54,"PACMA",46
24,"24206",1700,1253,1240,12,13,"PACMA",6
23,"23033",1352,1045,1034,12,11,"PACMA",6
49,"49137",176,139,138,0,1,"PACMA",1
19,"19190",2369,1760,1745,10,15,"PACMA",9
19,"19226",43,38,38,0,0,"PACMA",0
37,"37312",258,201,200,2,1,"PACMA",0
19,"19300",772,595,591,5,4,"PACMA",6
2,"2053",2998,2231,2189,16,42,"PACMA",21
48,"48035",413,293,292,1,1,"PACMA",1
31,"31142",1403,958,949,10,9,"PACMA",3
28,"28010",9963,7745,7688,25,57,"PACMA",92
47,"47021",76,64,64,0,0,"PACMA",0
39,"39086",358,256,253,0,3,"PACMA",2
31,"31209",155,107,106,0,1,"PACMA",3
2,"2014",356,283,280,1,3,"PACMA",0
44,"44127",68,51,51,0,0,"PACMA",1
40,"40146",254,197,196,0,1,"PACMA",1
28,"28039",128,98,97,2,1,"PACMA",0
47,"47157",515,424,423,1,1,"PACMA",2
19,"19191",14,13,12,0,1,"PACMA",0
16,"16158",535,416,413,5,3,"PACMA",1
24,"24207",294,241,238,3,3,"PACMA",0
1,"1001",1979,1339,1318,7,21,"PACMA",17
9,"9236",38,32,32,0,0,"PACMA",0
31,"31144",796,445,444,6,1,"PACMA",1
44,"44054",108,85,85,2,0,"PACMA",0
25,"25179",162,103,103,2,0,"PACMA",0
25,"25094",137,98,95,1,3,"PACMA",0
5,"5014",5379,4009,3970,18,39,"PACMA",33
37,"37188",181,129,129,3,0,"PACMA",0
22,"22018",327,245,244,3,1,"PACMA",1
48,"48901",4839,3459,3426,32,33,"PACMA",32
7,"7006",5178,3366,3329,52,37,"PACMA",33
41,"41027",3922,2660,2604,23,56,"PACMA",41
28,"28108",3374,2482,2465,10,17,"PACMA",26
5,"5015",82,61,61,1,0,"PACMA",0
39,"39088",69,52,52,0,0,"PACMA",0
22,"22136",806,588,588,5,0,"PACMA",0
10,"10154",181,131,129,0,2,"PACMA",0
46,"46230",13960,10351,10241,54,110,"PACMA",139
44,"44055",69,56,56,4,0,"PACMA",0
26,"26065",50,43,42,0,1,"PACMA",0
7,"7047",2246,1517,1482,18,35,"PACMA",18
28,"28137",1664,1232,1220,7,12,"PACMA",18
2,"2017",838,594,589,1,5,"PACMA",0
37,"37317",304,238,234,1,4,"PACMA",0
19,"19265",122,97,95,2,2,"PACMA",0
26,"26174",146,107,105,2,2,"PACMA",0
40,"40234",397,298,292,2,6,"PACMA",1
10,"10201",173,142,142,2,0,"PACMA",1
24,"24009",322,153,152,2,1,"PACMA",0
49,"49143",225,163,162,0,1,"PACMA",1
6,"6128",4447,2975,2935,26,40,"PACMA",7
24,"24175",1832,1314,1297,14,17,"PACMA",8
25,"25226",253,155,152,3,3,"PACMA",0
16,"16117",1040,787,777,4,10,"PACMA",1
44,"44232",378,284,276,6,8,"PACMA",0
34,"34032",40,33,33,1,0,"PACMA",0
39,"39090",756,553,542,0,11,"PACMA",5
3,"3070",2051,1455,1437,7,18,"PACMA",19
9,"9380",78,58,58,0,0,"PACMA",0
33,"33006",1540,1010,1003,5,7,"PACMA",8
9,"9109",1056,619,595,8,24,"PACMA",14
16,"16025",26,23,23,0,0,"PACMA",0
44,"44060",41,32,32,0,0,"PACMA",0
12,"12007",746,651,636,3,15,"PACMA",0
18,"18164",1836,1146,1126,6,20,"PACMA",3
19,"19305",155,116,115,0,1,"PACMA",0
31,"31248",299,165,162,0,3,"PACMA",2
2,"2060",1294,997,983,2,14,"PACMA",7
38,"38018",4402,3058,3011,16,47,"PACMA",51
26,"26141",113,87,82,0,5,"PACMA",0
25,"25100",211,125,124,1,1,"PACMA",1
44,"44168",189,139,138,2,1,"PACMA",0
6,"6040",1009,648,645,1,3,"PACMA",3
31,"31249",1872,1290,1273,14,17,"PACMA",3
3,"3072",348,289,285,0,4,"PACMA",3
2,"2061",637,516,511,4,5,"PACMA",2
6,"6131",1076,843,837,2,6,"PACMA",2
18,"18167",1895,1258,1250,4,8,"PACMA",9
22,"22142",97,75,74,1,1,"PACMA",1
45,"45071",1835,1426,1408,5,18,"PACMA",3
9,"9200",50,32,31,0,1,"PACMA",0
29,"29048",1405,1121,1110,8,11,"PACMA",2
4,"4057",1325,894,884,5,10,"PACMA",1
50,"50216",235,186,184,5,2,"PACMA",0
18,"18168",804,546,543,7,3,"PACMA",4
6,"6132",855,587,582,3,5,"PACMA",3
7,"7012",1876,1369,1353,13,16,"PACMA",12
19,"19198",14,12,12,0,0,"PACMA",0
44,"44169",342,252,252,3,0,"PACMA",0
19,"19082",85,64,64,0,0,"PACMA",0
46,"46078",28017,20288,20143,132,145,"PACMA",328
13,"13096",7652,5480,5415,19,65,"PACMA",35
31,"31250",2810,1786,1770,19,16,"PACMA",4
5,"5075",107,72,72,0,0,"PACMA",1
9,"9292",87,75,73,1,2,"PACMA",1
12,"12010",259,213,208,2,5,"PACMA",3
28,"28113",34751,25832,25612,120,220,"PACMA",395
37,"37196",75,64,64,0,0,"PACMA",0
19,"19199",17,17,17,1,0,"PACMA",0
49,"49148",260,137,134,1,3,"PACMA",4
2,"2064",372,325,324,1,1,"PACMA",3
50,"50060",172,128,127,1,1,"PACMA",1
35,"35014",11209,6016,5917,42,99,"PACMA",78
34,"34177",179,149,149,2,0,"PACMA",0
40,"40906",2003,1569,1550,12,19,"PACMA",13
19,"19200",71,52,52,1,0,"PACMA",1
13,"13030",139,98,96,0,2,"PACMA",3
47,"47155",3228,2277,2254,18,23,"PACMA",45
13,"13047",5760,4295,4224,23,71,"PACMA",30
2,"2024",3409,2589,2554,29,35,"PACMA",23
48,"48044",62774,45594,45399,287,195,"PACMA",283
34,"34178",117,103,103,0,0,"PACMA",0
30,"30002",9903,7011,6943,28,68,"PACMA",62
49,"49273",187,112,112,0,0,"PACMA",0
33,"33011",11260,6250,6163,83,87,"PACMA",26
41,"41001",1596,1183,1159,5,24,"PACMA",9
5,"5174",68,53,53,2,0,"PACMA",0
28,"28084",15859,11156,11058,64,98,"PACMA",182
1,"1013",712,454,450,0,4,"PACMA",6
16,"16231",46,37,37,0,0,"PACMA",0
2,"2026",836,690,679,3,11,"PACMA",1
48,"48015",33581,22727,22528,122,199,"PACMA",199
14,"14056",23581,16120,15958,143,162,"PACMA",120
26,"26007",511,384,375,0,9,"PACMA",1
42,"42022",221,173,171,5,2,"PACMA",1
49,"49275",52210,36205,35754,356,451,"PACMA",272
34,"34131",59,52,51,0,1,"PACMA",0
22,"22028",371,282,280,3,2,"PACMA",3
10,"10028",90,73,73,0,0,"PACMA",0
25,"25238",204,140,138,4,2,"PACMA",0
19,"19202",8,6,6,0,0,"PACMA",0
9,"9389",73,60,60,1,0,"PACMA",0
47,"47111",1020,742,732,7,10,"PACMA",4
22,"22150",472,331,330,1,1,"PACMA",3
37,"37070",529,399,392,1,7,"PACMA",1
39,"39006",1711,1307,1287,10,20,"PACMA",4
50,"50190",695,523,515,3,8,"PACMA",2
46,"46237",7211,5395,5343,42,52,"PACMA",76
1,"1014",371,280,272,4,8,"PACMA",4
46,"46159",22857,16840,16697,128,143,"PACMA",272
5,"5178",368,284,280,0,4,"PACMA",0
37,"37328",186,135,131,1,4,"PACMA",0
50,"50093",92,66,66,1,0,"PACMA",1
37,"37201",262,187,186,1,1,"PACMA",0
3,"3077",1371,1071,1060,13,11,"PACMA",6
41,"41093",18554,13978,13874,99,104,"PACMA",177
30,"30005",29526,20713,20526,121,187,"PACMA",282
2,"2029",3282,2467,2445,17,22,"PACMA",33
31,"31255",102,79,79,1,0,"PACMA",1
18,"18038",1066,828,802,1,26,"PACMA",6
10,"10123",578,481,475,1,6,"PACMA",0
4,"4093",1882,1216,1204,11,12,"PACMA",5
12,"12014",184,144,143,2,1,"PACMA",0
18,"18176",250,191,189,2,2,"PACMA",1
34,"34045",76,66,66,2,0,"PACMA",0
47,"47193",1577,1251,1241,7,10,"PACMA",13
18,"18177",418,258,256,0,2,"PACMA",2
23,"23009",12861,9649,9543,72,106,"PACMA",60
20,"20902",14156,9664,9613,74,51,"PACMA",83
5,"5034",14,13,13,0,0,"PACMA",0
39,"39069",1972,1510,1489,12,21,"PACMA",27
38,"38027",5414,3618,3571,16,47,"PACMA",42
49,"49155",79,61,60,3,1,"PACMA",0
39,"39039",568,382,379,0,3,"PACMA",1
47,"47114",4045,2787,2762,26,25,"PACMA",6
18,"18133",2168,1648,1636,6,12,"PACMA",5
19,"19130",60145,45531,45085,286,446,"PACMA",363
18,"18178",719,549,544,4,5,"PACMA",1
50,"50095",12323,8628,8550,110,78,"PACMA",43
16,"16039",392,261,254,1,7,"PACMA",1
5,"5084",74,53,53,0,0,"PACMA",0
24,"24020",456,314,307,4,7,"PACMA",2
2,"2032",276,207,202,1,5,"PACMA",1
31,"31091",351,220,217,1,3,"PACMA",0
22,"22157",192,129,128,3,1,"PACMA",3
34,"34185",63,38,37,2,1,"PACMA",0
5,"5085",35,27,27,0,0,"PACMA",0
9,"9255",89,63,62,0,1,"PACMA",0
34,"34047",1782,1397,1374,12,23,"PACMA",5
26,"26078",82,70,70,0,0,"PACMA",0
47,"47195",459,345,344,4,1,"PACMA",3
39,"39100",860,633,629,15,4,"PACMA",8
7,"7022",11545,7385,7306,88,79,"PACMA",90
4,"4032",5586,3642,3623,23,19,"PACMA",25
19,"19095",12,9,9,0,0,"PACMA",0
18,"18042",403,324,322,2,2,"PACMA",0
23,"23012",4162,2907,2889,14,18,"PACMA",8
39,"39071",397,261,256,1,5,"PACMA",0
16,"16134",4371,3288,3254,20,34,"PACMA",35
9,"9078",41,30,30,1,0,"PACMA",0
30,"30009",12433,9586,9503,41,83,"PACMA",101
47,"47034",72,58,58,3,0,"PACMA",0
46,"46163",1866,1504,1480,8,24,"PACMA",10
24,"24224",616,454,451,4,3,"PACMA",2
44,"44178",58,37,37,0,0,"PACMA",0
37,"37078",829,674,664,8,10,"PACMA",4
28,"28052",3855,2626,2587,11,39,"PACMA",29
2,"2074",5935,4193,4139,32,54,"PACMA",33
25,"25247",123,66,66,1,0,"PACMA",0
37,"37335",406,296,290,0,6,"PACMA",1
41,"41009",1222,812,805,3,7,"PACMA",2
28,"28121",198,160,158,1,2,"PACMA",2
16,"16042",1157,933,921,4,12,"PACMA",4
31,"31160",106,89,88,2,1,"PACMA",1
9,"9258",172,141,139,5,2,"PACMA",1
30,"30010",6869,5194,5142,21,52,"PACMA",61
16,"16187",74,55,55,1,0,"PACMA",0
27,"27010",4327,2899,2837,53,62,"PACMA",23
5,"5040",66,50,50,1,0,"PACMA",0
9,"9128",80,63,63,0,0,"PACMA",2
25,"25118",346,198,189,3,9,"PACMA",0
5,"5186",1575,1225,1194,3,31,"PACMA",4
25,"25248",891,592,586,6,6,"PACMA",2
37,"37293",115,84,84,1,0,"PACMA",0
19,"19176",237,181,181,0,0,"PACMA",2
4,"4035",8364,5810,5766,28,44,"PACMA",23
29,"29083",2107,1540,1512,9,28,"PACMA",10
22,"22205",438,322,320,0,2,"PACMA",3
6,"6149",10295,7651,7536,56,115,"PACMA",66
37,"37337",139,124,124,0,0,"PACMA",0
25,"25249",182,99,98,1,1,"PACMA",1
12,"12021",4436,3381,3332,27,49,"PACMA",26
39,"39013",511,402,399,4,3,"PACMA",0
37,"37170",1449,994,971,3,23,"PACMA",2
14,"14064",320,242,236,2,6,"PACMA",0
47,"47198",69,50,50,0,0,"PACMA",0
21,"21002",15478,10597,10507,94,90,"PACMA",168
33,"33020",13307,9011,8914,99,97,"PACMA",108
31,"31152",1328,924,900,11,24,"PACMA",3
5,"5188",45,39,38,0,1,"PACMA",0
10,"10179",294,231,229,2,2,"PACMA",1
37,"37212",104,78,74,0,4,"PACMA",0
46,"46088",166,125,125,4,0,"PACMA",1
50,"50290",386,283,282,1,1,"PACMA",1
41,"41101",5928,4209,4173,18,36,"PACMA",24
42,"42076",216,179,174,5,5,"PACMA",1
44,"44250",19,12,12,0,0,"PACMA",0
22,"22164",35,28,28,0,0,"PACMA",0
22,"22042",117,95,92,0,3,"PACMA",1
44,"44080",292,229,223,3,6,"PACMA",0
11,"11035",13593,8375,8276,90,99,"PACMA",97
25,"25074",178,132,128,6,4,"PACMA",0
19,"19326",1841,1280,1272,1,8,"PACMA",20
22,"22165",487,364,360,6,4,"PACMA",1
4,"4037",1314,969,955,6,14,"PACMA",4
28,"28056",863,630,617,4,13,"PACMA",7
19,"19103",251,208,208,2,0,"PACMA",0
31,"31164",568,421,417,5,4,"PACMA",3
37,"37340",151,106,106,1,0,"PACMA",0
12,"12123",48,40,40,3,0,"PACMA",0
16,"16005",255,180,178,2,2,"PACMA",0
28,"28094",865,624,622,4,2,"PACMA",12
9,"9406",251,192,191,2,1,"PACMA",1
37,"37173",1504,1129,1114,4,15,"PACMA",0
24,"24094",1385,983,968,11,15,"PACMA",16
37,"37086",101,72,71,1,1,"PACMA",0
27,"27017",1003,674,670,4,4,"PACMA",2
46,"46246",1058,835,823,5,12,"PACMA",2
5,"5192",101,82,79,2,3,"PACMA",0
5,"5047",4163,3198,3142,17,56,"PACMA",9
28,"28057",1458,1097,1088,3,9,"PACMA",15
25,"25253",159,105,105,1,0,"PACMA",0
16,"16049",149,111,110,0,1,"PACMA",1
41,"41081",29189,20205,20015,196,190,"PACMA",326
34,"34057",471,339,338,1,1,"PACMA",6
50,"50201",448,339,335,7,4,"PACMA",0
46,"46012",896,682,663,1,19,"PACMA",9
9,"9267",111,99,97,1,2,"PACMA",0
48,"48057",5723,3988,3962,26,26,"PACMA",9
24,"24127",296,226,215,4,11,"PACMA",0
9,"9134",221,161,156,7,5,"PACMA",2
16,"16007",1177,888,880,7,8,"PACMA",1
25,"25254",728,457,451,2,6,"PACMA",5
37,"37088",207,163,162,3,1,"PACMA",0
31,"31902",4405,3092,3061,25,31,"PACMA",38
34,"34152",125,96,92,1,4,"PACMA",0
18,"18011",4335,3037,3015,20,22,"PACMA",40
13,"13071",39454,26316,26107,183,209,"PACMA",236
19,"19254",45,34,34,0,0,"PACMA",0
5,"5243",85,61,60,0,1,"PACMA",1
44,"44257",166,123,119,1,4,"PACMA",0
48,"48028",717,543,537,3,6,"PACMA",1
16,"16008",89,69,69,0,0,"PACMA",0
48,"48058",968,647,646,2,1,"PACMA",1
24,"24902",347,270,269,2,1,"PACMA",2
46,"46170",3417,2714,2688,10,26,"PACMA",23
9,"9268",95,68,66,0,2,"PACMA",0
31,"31068",2885,2060,2027,20,33,"PACMA",12
47,"47041",150,112,110,2,2,"PACMA",1
47,"47204",256,204,198,0,6,"PACMA",2
12,"12028",12586,9733,9676,62,57,"PACMA",120
46,"46014",3030,2383,2350,20,33,"PACMA",30
21,"21009",857,532,523,4,9,"PACMA",1
23,"23025",2802,2056,2037,9,19,"PACMA",13
47,"47042",54,37,37,0,0,"PACMA",0
49,"49048",124,97,95,0,2,"PACMA",0
1,"1032",517,361,354,1,7,"PACMA",1
37,"37346",273,212,211,1,1,"PACMA",0
34,"34060",137,111,108,0,3,"PACMA",2
45,"45023",2177,1571,1556,6,15,"PACMA",16
34,"34210",103,90,90,0,0,"PACMA",0
5,"5198",73,62,62,0,0,"PACMA",0
1,"1033",651,484,479,2,5,"PACMA",0
5,"5053",82,57,57,0,0,"PACMA",0
28,"28129",8030,5986,5941,42,45,"PACMA",60
19,"19108",111,97,96,0,1,"PACMA",2
40,"40094",374,279,276,2,3,"PACMA",1
14,"14014",2557,2035,2007,9,28,"PACMA",18
33,"33027",834,506,498,4,8,"PACMA",5
6,"6069",3065,2053,2035,14,18,"PACMA",10
16,"16055",691,466,463,2,3,"PACMA",0
50,"50015",96,67,67,0,0,"PACMA",0
18,"18901",511,356,355,3,1,"PACMA",3
9,"9016",85,60,59,3,1,"PACMA",1
34,"34157",2442,1792,1768,21,24,"PACMA",6
34,"34211",178,155,152,1,3,"PACMA",0
27,"27026",2397,1503,1471,9,32,"PACMA",8
29,"29002",1177,804,789,5,15,"PACMA",4
21,"21012",316,235,233,2,2,"PACMA",0
45,"45125",2305,1865,1841,8,24,"PACMA",10
18,"18059",4180,2907,2870,20,37,"PACMA",20
39,"39021",487,381,376,2,5,"PACMA",1
34,"34063",83,76,75,1,1,"PACMA",0
37,"37349",117,88,88,0,0,"PACMA",0
4,"4047",2281,1893,1878,11,15,"PACMA",13
10,"10191",527,405,397,2,8,"PACMA",4
34,"34213",57,45,44,1,1,"PACMA",0
45,"45026",211,167,166,2,1,"PACMA",0
16,"16203",9972,7094,7007,34,87,"PACMA",186
9,"9018",24668,17575,17369,111,206,"PACMA",139
42,"42134",2627,1927,1890,19,37,"PACMA",8
49,"49053",931,709,699,8,10,"PACMA",0
18,"18903",889,669,661,5,8,"PACMA",5
48,"48062",302,237,236,4,1,"PACMA",1
26,"26094",83,70,70,0,0,"PACMA",0
49,"49134",172,121,119,0,2,"PACMA",1
40,"40015",28,26,26,1,0,"PACMA",0
3,"3095",4579,3489,3459,25,30,"PACMA",44
24,"24169",2969,2140,2118,13,22,"PACMA",12
28,"28064",129,106,106,2,0,"PACMA",0
40,"40142",53,39,37,0,2,"PACMA",0
25,"25005",279,175,175,4,0,"PACMA",2
22,"22176",173,134,130,1,4,"PACMA",1
19,"19112",60,46,46,0,0,"PACMA",0
14,"14017",10868,7764,7665,71,99,"PACMA",63
19,"19224",93,87,87,0,0,"PACMA",0
5,"5059",106,82,81,1,1,"PACMA",1
46,"46070",16950,12765,12676,61,89,"PACMA",186
22,"22041",163,134,134,1,0,"PACMA",2
34,"34023",5236,3685,3636,30,49,"PACMA",35
26,"26096",245,190,190,1,0,"PACMA",0
25,"25006",340,201,200,6,1,"PACMA",3
34,"34216",66,50,50,0,0,"PACMA",0
21,"21016",1023,746,723,4,23,"PACMA",4
50,"50114",116,89,88,0,1,"PACMA",0
5,"5206",30,22,20,1,2,"PACMA",0
16,"16062",24,23,23,0,0,"PACMA",0
41,"41023",7905,5402,5347,41,55,"PACMA",36
23,"23032",566,450,448,4,2,"PACMA",1
30,"30023",3780,2874,2850,12,24,"PACMA",32
34,"34217",1207,937,923,8,14,"PACMA",13
31,"31009",677,507,505,5,2,"PACMA",2
46,"46019",8849,7072,7004,33,68,"PACMA",62
26,"26098",88,73,73,1,0,"PACMA",1
38,"38047",1777,1198,1170,4,28,"PACMA",11
47,"47047",199,157,156,2,1,"PACMA",0
27,"27032",3275,2128,2096,22,32,"PACMA",20
50,"50209",2601,1731,1721,13,10,"PACMA",25
21,"21018",1769,1120,1095,11,25,"PACMA",5
33,"33032",11395,7592,7465,90,127,"PACMA",54
44,"44093",80,66,66,0,0,"PACMA",0
45,"45130",317,253,250,1,3,"PACMA",0
50,"50020",809,564,559,2,5,"PACMA",6
24,"24103",283,163,157,1,6,"PACMA",0
38,"38048",3901,2667,2637,20,30,"PACMA",38
48,"48005",115,63,61,0,2,"PACMA",0
19,"19262",135,100,100,0,0,"PACMA",0
10,"10060",967,648,640,2,8,"PACMA",1
34,"34070",154,123,123,2,0,"PACMA",0
22,"22054",1542,1091,1077,13,14,"PACMA",9
45,"45031",2723,1835,1822,12,13,"PACMA",18
25,"25009",627,444,440,8,4,"PACMA",0
48,"48067",1158,813,810,2,3,"PACMA",1
25,"25910",100,63,61,2,2,"PACMA",0
24,"24141",95,85,84,0,1,"PACMA",0
27,"27035",187,122,121,1,1,"PACMA",0
37,"37231",250,196,193,4,3,"PACMA",1
46,"46073",1092,888,884,6,4,"PACMA",5
45,"45032",436,283,275,1,8,"PACMA",0
44,"44197",56,36,36,0,0,"PACMA",0
28,"28068",10955,8136,8076,49,60,"PACMA",91
31,"31045",508,355,350,8,5,"PACMA",3
31,"31012",793,563,555,6,8,"PACMA",6
14,"14049",16309,11635,11515,115,120,"PACMA",100
19,"19117",1579,1135,1123,8,12,"PACMA",7
50,"50211",249,176,173,0,3,"PACMA",0
1,"1043",2304,1552,1532,13,20,"PACMA",11
18,"18910",788,541,536,3,5,"PACMA",2
14,"14021",260178,181773,180348,1872,1425,"PACMA",2296
42,"42145",138,108,107,2,1,"PACMA",1
26,"26101",44,36,35,0,1,"PACMA",1
1,"1044",236,169,167,0,2,"PACMA",1
34,"34029",714,587,570,3,17,"PACMA",1
10,"10063",173,139,137,0,2,"PACMA",0
19,"19303",43,35,35,0,0,"PACMA",0
5,"5016",6335,4670,4586,41,84,"PACMA",15
49,"49181",362,277,276,2,1,"PACMA",0
9,"9241",202,156,154,4,2,"PACMA",4
9,"9025",122,83,83,1,0,"PACMA",1
37,"37234",345,247,247,1,0,"PACMA",0
44,"44130",34,24,24,0,0,"PACMA",0
21,"21062",1392,887,879,6,8,"PACMA",5
30,"30027",48176,35521,35266,153,255,"PACMA",489
38,"38052",1273,883,875,2,8,"PACMA",5
47,"47024",259,208,207,1,1,"PACMA",0
46,"46101",860,716,705,3,11,"PACMA",7
5,"5214",38,28,28,0,0,"PACMA",0
4,"4020",288,201,197,0,4,"PACMA",1
9,"9152",257,183,183,0,0,"PACMA",0
18,"18912",1473,994,979,3,15,"PACMA",2
10,"10203",4558,3120,3079,20,41,"PACMA",23
33,"33036",11542,8062,7987,60,75,"PACMA",76
5,"5069",73,64,63,0,1,"PACMA",0
42,"42016",18,14,14,0,0,"PACMA",0
34,"34224",47,37,37,1,0,"PACMA",0
50,"50025",4562,3158,3124,31,34,"PACMA",20
47,"47133",2682,2033,2015,16,18,"PACMA",17
24,"24145",654,463,461,2,2,"PACMA",0
10,"10204",429,331,329,6,2,"PACMA",1
20,"20075",4371,2692,2679,18,13,"PACMA",17
3,"3071",3982,3048,3012,26,36,"PACMA",40
24,"24109",977,633,624,3,9,"PACMA",1
46,"46024",413,314,313,2,1,"PACMA",1
44,"44201",495,411,406,0,5,"PACMA",1
41,"41030",514,387,373,3,14,"PACMA",5
19,"19233",80,65,63,1,2,"PACMA",1
9,"9155",27,20,20,0,0,"PACMA",0
44,"44101",58,46,46,2,0,"PACMA",1
24,"24213",150,122,122,1,0,"PACMA",0
34,"34227",77,61,61,2,0,"PACMA",0
42,"42018",152,117,116,1,1,"PACMA",0
42,"42100",32,30,30,0,0,"PACMA",0
5,"5021",1914,1483,1464,5,19,"PACMA",11
1,"1051",3603,2259,2235,17,24,"PACMA",11
25,"25186",213,124,122,3,2,"PACMA",0
49,"49109",619,483,483,11,0,"PACMA",1
9,"9289",1451,1014,1000,5,14,"PACMA",8
5,"5171",74,52,50,1,2,"PACMA",0
20,"20010",1499,992,986,9,6,"PACMA",10
10,"10206",215,157,157,3,0,"PACMA",0
9,"9159",60,52,51,2,1,"PACMA",0
9,"9425",517,384,378,0,6,"PACMA",0
40,"40156",322,238,235,1,3,"PACMA",3
12,"12044",468,419,412,3,7,"PACMA",0
24,"24148",1672,1249,1241,23,8,"PACMA",11
40,"40029",35,27,26,0,1,"PACMA",0
19,"19165",47,41,41,0,0,"PACMA",0
27,"27047",1629,1106,1089,8,17,"PACMA",8
39,"39033",568,418,415,2,3,"PACMA",2
47,"47137",29,25,25,1,0,"PACMA",0
37,"37364",820,607,598,6,9,"PACMA",2
5,"5220",371,309,301,0,8,"PACMA",1
42,"42154",97,69,69,1,0,"PACMA",2
48,"48043",4423,3118,3108,17,10,"PACMA",31
18,"18170",330,219,217,0,2,"PACMA",0
1,"1053",582,321,320,4,1,"PACMA",0
28,"28143",72,57,57,1,0,"PACMA",0
12,"12141",101,83,83,0,0,"PACMA",0
10,"10194",542,415,407,2,8,"PACMA",3
30,"30032",2856,2163,2144,6,19,"PACMA",17
23,"23005",30465,20878,20630,177,248,"PACMA",194
18,"18034",505,366,364,1,2,"PACMA",0
4,"4059",1079,723,712,4,11,"PACMA",2
29,"29050",421,306,302,3,4,"PACMA",3
22,"22063",169,133,129,1,4,"PACMA",0
9,"9033",90,74,74,1,0,"PACMA",0
50,"50298",5333,3949,3902,39,47,"PACMA",36
12,"12142",158,117,117,1,0,"PACMA",0
41,"41034",23070,14805,14625,186,180,"PACMA",197
50,"50091",41,36,36,0,0,"PACMA",0
31,"31020",449,228,228,3,0,"PACMA",1
7,"7015",20991,12552,12433,184,119,"PACMA",180
49,"49151",619,459,456,2,3,"PACMA",0
47,"47190",98,80,80,1,0,"PACMA",0
10,"10211",444,337,336,0,1,"PACMA",5
21,"21071",203,157,153,4,4,"PACMA",0
48,"48908",249,181,181,0,0,"PACMA",0
14,"14028",314,253,249,1,4,"PACMA",3
7,"7016",2809,1865,1836,23,29,"PACMA",27
20,"20014",1108,611,609,4,2,"PACMA",5
16,"16234",25,18,18,0,0,"PACMA",0
40,"40033",58,51,51,0,0,"PACMA",0
21,"21031",1199,852,837,6,15,"PACMA",2
37,"37118",123,92,90,0,2,"PACMA",0
19,"19126",1627,1155,1134,11,21,"PACMA",24
16,"16236",910,656,651,4,5,"PACMA",5
22,"22197",473,354,354,1,0,"PACMA",1
28,"28076",398,325,317,1,8,"PACMA",0
46,"46107",1900,1516,1504,5,12,"PACMA",18
44,"44207",156,118,115,4,3,"PACMA",0
12,"12902",2158,1504,1489,14,15,"PACMA",11
10,"10213",566,469,463,0,6,"PACMA",1
24,"24152",464,295,291,1,4,"PACMA",4
5,"5080",58,45,43,0,2,"PACMA",0
41,"41037",3213,2376,2342,30,34,"PACMA",14
37,"37119",107,84,82,0,2,"PACMA",0
50,"50032",261,189,189,5,0,"PACMA",2
16,"16175",5095,3980,3914,35,66,"PACMA",13
31,"31056",174,121,120,0,1,"PACMA",5
46,"46004",1922,1565,1547,11,18,"PACMA",26
18,"18084",4257,3107,3075,26,32,"PACMA",33
45,"45144",783,620,618,3,2,"PACMA",2
34,"34182",786,606,597,10,9,"PACMA",4
44,"44067",114,81,81,1,0,"PACMA",0
10,"10078",406,321,314,6,7,"PACMA",2
37,"37370",328,258,254,1,4,"PACMA",0
44,"44002",47,40,40,0,0,"PACMA",0
3,"3018",12240,8853,8777,47,76,"PACMA",107
27,"27055",1293,826,809,6,17,"PACMA",2
34,"34236",156,120,119,0,1,"PACMA",0
28,"28148",85454,62367,61884,370,483,"PACMA",928
37,"37246",5304,3993,3949,26,44,"PACMA",22
27,"27003",1876,1344,1320,12,24,"PACMA",5
5,"5180",86,67,63,3,4,"PACMA",0
16,"16086",890,740,735,6,5,"PACMA",1
46,"46057",487,321,317,1,4,"PACMA",4
44,"44068",659,509,503,3,6,"PACMA",2
18,"18039",3490,2406,2378,33,28,"PACMA",13
46,"46083",15422,11179,11049,86,130,"PACMA",210
37,"37122",201,154,153,5,1,"PACMA",0
3,"3019",15269,11520,11398,72,122,"PACMA",129
19,"19242",87,65,65,1,0,"PACMA",1
9,"9214",672,427,427,4,0,"PACMA",0
24,"24053",442,286,280,1,6,"PACMA",0
10,"10034",353,260,257,2,3,"PACMA",0
31,"31258",7879,5707,5666,50,41,"PACMA",48
6,"6098",549,385,381,7,4,"PACMA",2
4,"4031",2338,1772,1762,2,10,"PACMA",5
40,"40037",41,29,29,0,0,"PACMA",0
9,"9169",95,78,78,0,0,"PACMA",0
9,"9434",1227,922,909,6,13,"PACMA",10
46,"46032",5653,4402,4361,33,41,"PACMA",56
47,"47222",83,64,64,1,0,"PACMA",0
16,"16088",108,88,87,0,1,"PACMA",0
31,"31192",156,129,127,3,2,"PACMA",0
19,"19132",92,81,81,0,0,"PACMA",0
50,"50035",72,54,53,1,1,"PACMA",1
44,"44005",50,30,30,0,0,"PACMA",0
9,"9256",354,258,258,2,0,"PACMA",2
16,"16243",407,338,334,3,4,"PACMA",1
50,"50287",270,191,191,0,0,"PACMA",1
1,"1060",197,160,157,0,3,"PACMA",0
19,"19245",1155,855,835,5,20,"PACMA",6
10,"10901",1174,752,741,4,11,"PACMA",8
4,"4066",13571,8786,8724,50,62,"PACMA",56
41,"41041",9706,7239,7120,36,119,"PACMA",54
42,"42029",137,104,104,2,0,"PACMA",0
9,"9043",192,137,133,1,4,"PACMA",1
42,"42030",94,78,78,1,0,"PACMA",0
1,"1061",154,127,127,1,0,"PACMA",0
24,"24056",2883,2040,2003,11,37,"PACMA",9
31,"31094",111,82,82,0,0,"PACMA",2
27,"27062",605,447,444,1,3,"PACMA",1
45,"45148",292,223,223,0,0,"PACMA",0
10,"10084",1345,888,875,4,13,"PACMA",2
47,"47144",78,64,64,1,0,"PACMA",2
12,"12055",104,83,82,3,1,"PACMA",0
45,"45049",433,305,304,1,1,"PACMA",0
9,"9044",46,35,34,1,1,"PACMA",0
39,"39042",5915,4530,4474,21,56,"PACMA",36
10,"10085",323,235,233,0,2,"PACMA",1
24,"24158",320,207,203,2,4,"PACMA",0
24,"24057",1373,1045,1023,11,22,"PACMA",2
3,"3022",145,125,125,0,0,"PACMA",0
50,"50258",54,34,34,0,0,"PACMA",1
22,"22115",360,257,256,3,1,"PACMA",1
18,"18183",658,438,434,3,4,"PACMA",2
18,"18045",1126,756,742,4,14,"PACMA",3
37,"37081",930,728,722,3,6,"PACMA",3
46,"46035",6822,5202,5142,43,60,"PACMA",66
7,"7902",1064,685,664,15,21,"PACMA",5
5,"5090",77,68,68,1,0,"PACMA",3
34,"34243",325,252,248,0,4,"PACMA",0
48,"48023",600,455,452,0,3,"PACMA",1
39,"39044",3849,2765,2732,21,33,"PACMA",33
37,"37254",181,142,141,0,1,"PACMA",0
9,"9309",301,224,220,0,4,"PACMA",3
10,"10905",656,446,439,2,7,"PACMA",3
12,"12057",606,487,474,5,13,"PACMA",2
34,"34245",307,209,208,5,1,"PACMA",0
5,"5093",408,294,292,1,2,"PACMA",4
41,"41045",5756,3988,3924,53,64,"PACMA",44
44,"44009",809,596,593,7,3,"PACMA",3
49,"49203",313,240,232,0,8,"PACMA",0
46,"46251",2462,1997,1956,6,41,"PACMA",11
46,"46114",569,461,458,1,3,"PACMA",2
30,"30043",24967,18981,18685,101,296,"PACMA",152
26,"26121",25,22,22,0,0,"PACMA",0
24,"24228",660,430,422,6,8,"PACMA",2
37,"37213",89,74,73,0,1,"PACMA",1
10,"10180",4134,2643,2601,25,42,"PACMA",8
50,"50291",96,74,74,0,0,"PACMA",0
3,"3118",2437,1659,1642,4,17,"PACMA",13
5,"5094",139,116,116,1,0,"PACMA",0
20,"20024",386,210,209,3,1,"PACMA",0
50,"50040",89,75,75,0,0,"PACMA",0
49,"49205",382,293,291,2,2,"PACMA",0
20,"20025",1143,765,760,8,5,"PACMA",3
46,"46193",8788,6925,6871,50,54,"PACMA",113
22,"22207",125,72,71,2,1,"PACMA",0
40,"40088",284,228,224,0,4,"PACMA",3
26,"26086",16,15,15,1,0,"PACMA",0
9,"9358",255,194,190,3,4,"PACMA",0
27,"27016",7172,4910,4846,51,64,"PACMA",56
24,"24125",462,290,286,4,4,"PACMA",1
49,"49206",840,614,604,9,10,"PACMA",1
28,"28155",506,416,411,0,5,"PACMA",2
40,"40174",349,254,251,2,3,"PACMA",0
3,"3119",16636,12281,12194,57,87,"PACMA",162
34,"34902",139,106,106,0,0,"PACMA",0
37,"37132",351,256,253,2,3,"PACMA",0
37,"37382",173,137,137,0,0,"PACMA",0
26,"26123",126,108,107,2,1,"PACMA",0
25,"25165",285,179,176,2,3,"PACMA",0
20,"20027",2814,1761,1750,15,11,"PACMA",4
39,"39047",1962,1385,1371,10,14,"PACMA",23
28,"28156",1019,742,738,3,4,"PACMA",8
29,"29064",503,348,339,8,9,"PACMA",4
34,"34102",205,169,168,1,1,"PACMA",0
31,"31001",88,62,62,0,0,"PACMA",1
27,"27018",3467,2086,2059,20,27,"PACMA",12
40,"40049",49,43,43,0,0,"PACMA",0
47,"47066",1268,981,977,12,4,"PACMA",5
10,"10093",398,317,312,4,5,"PACMA",3
26,"26021",2827,2098,2076,15,22,"PACMA",14
12,"12061",373,285,282,3,3,"PACMA",0
28,"28902",471,363,356,4,7,"PACMA",4
41,"41082",3415,2671,2647,16,24,"PACMA",24
44,"44256",38,34,34,0,0,"PACMA",0
31,"31167",826,606,596,9,10,"PACMA",6
45,"45155",355,291,285,0,6,"PACMA",2
25,"25255",417,298,296,2,2,"PACMA",3
47,"47230",303,246,242,2,4,"PACMA",0
19,"19145",46,41,41,1,0,"PACMA",0
5,"5100",278,227,223,1,4,"PACMA",0
20,"20028",2237,1373,1365,11,8,"PACMA",8
3,"3029",245,185,183,1,2,"PACMA",2
46,"46118",3763,2940,2908,16,32,"PACMA",26
50,"50044",230,145,145,1,0,"PACMA",1
9,"9446",12,7,7,0,0,"PACMA",0
21,"21049",3361,2049,1984,17,65,"PACMA",17
5,"5245",353,286,285,3,1,"PACMA",3
28,"28004",6234,4202,4167,16,35,"PACMA",41
39,"39019",2079,1560,1531,10,29,"PACMA",14
37,"37136",652,440,435,3,5,"PACMA",0
22,"22213",3003,2169,2131,19,38,"PACMA",16
20,"20029",4281,2813,2802,19,11,"PACMA",16
3,"3123",7476,5557,5501,29,56,"PACMA",53
31,"31103",42,34,34,2,0,"PACMA",0
37,"37002",139,87,86,0,1,"PACMA",0
31,"31202",4305,2845,2803,31,42,"PACMA",14
37,"37137",105,66,66,0,0,"PACMA",0
34,"34106",109,89,86,2,3,"PACMA",1
5,"5247",241,138,138,1,0,"PACMA",0
40,"40053",83,66,65,0,1,"PACMA",0
46,"46119",780,653,647,5,6,"PACMA",7
35,"35002",23328,15495,15313,94,182,"PACMA",180
22,"22253",61,52,52,0,0,"PACMA",0
40,"40095",477,377,369,0,8,"PACMA",0
50,"50046",178,133,133,5,0,"PACMA",1
37,"37138",203,149,148,2,1,"PACMA",0
3,"3031",41499,27031,26813,128,218,"PACMA",297
45,"45059",1712,1337,1311,1,26,"PACMA",6
39,"39051",66,57,57,0,0,"PACMA",1
31,"31906",2562,1800,1779,26,21,"PACMA",18
50,"50236",102,79,77,0,2,"PACMA",0
9,"9183",51,41,41,0,0,"PACMA",0
20,"20032",8797,5672,5630,40,42,"PACMA",37
5,"5104",35,28,28,0,0,"PACMA",0
9,"9056",4919,3395,3344,20,51,"PACMA",24
19,"19257",3403,2430,2402,19,28,"PACMA",16
5,"5105",341,249,247,7,2,"PACMA",0
50,"50237",101,74,73,1,1,"PACMA",0
37,"37265",220,181,181,0,0,"PACMA",0
25,"25172",1797,1170,1146,10,24,"PACMA",12
19,"19258",90,77,77,0,0,"PACMA",1
28,"28007",124592,94222,93521,491,701,"PACMA",1096
44,"44018",19,19,19,0,0,"PACMA",0
35,"35004",39299,20523,20294,140,229,"PACMA",313
28,"28161",48848,35503,35203,210,300,"PACMA",521
42,"42182",56,43,41,1,2,"PACMA",0
49,"49220",135,110,109,0,1,"PACMA",0
5,"5107",62,39,39,0,0,"PACMA",0
34,"34110",88,71,71,1,0,"PACMA",0
22,"22218",43,33,33,0,0,"PACMA",0
24,"24134",3416,2470,2417,19,53,"PACMA",9
24,"24067",623,388,384,0,4,"PACMA",1
26,"26027",157,112,108,0,4,"PACMA",0
40,"40184",258,211,210,2,1,"PACMA",1
14,"14045",3052,2362,2335,11,27,"PACMA",11
28,"28008",1799,1182,1174,4,8,"PACMA",19
16,"16266",368,264,259,1,5,"PACMA",1
44,"44019",67,50,49,0,1,"PACMA",0
37,"37267",200,156,147,2,9,"PACMA",0
16,"16269",419,336,332,2,4,"PACMA",1
31,"31206",2090,1461,1440,22,21,"PACMA",14
44,"44194",109,78,73,3,5,"PACMA",0
26,"26131",35,33,33,1,0,"PACMA",0
44,"44125",61,44,44,0,0,"PACMA",0
6,"6120",3389,2502,2478,12,24,"PACMA",16
34,"34112",46,38,37,0,1,"PACMA",0
3,"3128",4092,2861,2840,10,21,"PACMA",27
47,"47073",122,103,101,1,2,"PACMA",0
40,"40185",863,646,642,3,4,"PACMA",0
5,"5109",450,352,339,4,13,"PACMA",0
19,"19032",165,126,124,1,2,"PACMA",0
46,"46123",1829,1407,1388,7,19,"PACMA",29
18,"18109",597,411,408,2,3,"PACMA",4
24,"24069",41,35,35,0,0,"PACMA",0
20,"20036",13210,8518,8475,67,43,"PACMA",63
48,"48004",335,222,222,0,0,"PACMA",0
40,"40058",325,277,276,4,1,"PACMA",0
3,"3129",1194,957,938,0,19,"PACMA",5
19,"19154",68,56,54,0,2,"PACMA",0
4,"4081",355,287,287,0,0,"PACMA",0
13,"13032",1137,841,835,2,6,"PACMA",10
14,"14047",1672,1187,1178,14,9,"PACMA",11
24,"24171",356,197,196,0,1,"PACMA",0
26,"26030",16,16,15,0,1,"PACMA",0
16,"16211",370,263,263,3,0,"PACMA",1
47,"47074",149,117,116,2,1,"PACMA",0
19,"19074",72,62,62,0,0,"PACMA",0
39,"39087",41985,31178,30805,228,373,"PACMA",300
9,"9061",162,124,123,0,1,"PACMA",0
5,"5113",71,56,56,0,0,"PACMA",0
37,"37271",368,297,296,0,1,"PACMA",5
9,"9458",469,343,336,5,7,"PACMA",4
39,"39056",2286,1714,1684,8,30,"PACMA",11
16,"16273",321,242,236,3,6,"PACMA",2
6,"6124",1708,1202,1165,8,37,"PACMA",4
40,"40061",67,55,54,1,1,"PACMA",0
42,"42050",31,18,18,0,0,"PACMA",0
31,"31111",95,65,65,2,0,"PACMA",3
10,"10107",1031,801,792,3,9,"PACMA",3
39,"39058",810,559,557,2,2,"PACMA",0
37,"37147",193,134,132,1,2,"PACMA",0
16,"16274",121,92,92,0,0,"PACMA",0
22,"22090",99,71,71,0,0,"PACMA",0
10,"10016",330,237,235,0,2,"PACMA",4
40,"40106",201,158,158,2,0,"PACMA",0
3,"3038",355,288,285,3,3,"PACMA",4
26,"26032",51,41,39,0,2,"PACMA",1
16,"16115",44,35,34,0,1,"PACMA",0
37,"37013",119,79,76,0,3,"PACMA",0
40,"40191",215,181,179,1,2,"PACMA",3
45,"45166",1617,1305,1286,8,19,"PACMA",5
22,"22225",2679,1700,1665,17,35,"PACMA",10
5,"5262",357,276,276,1,0,"PACMA",0
25,"25096",902,534,525,10,9,"PACMA",2
31,"31246",140,111,107,1,4,"PACMA",2
6,"6081",1074,806,792,7,14,"PACMA",1
25,"25138",569,363,360,4,3,"PACMA",4
42,"42053",26,19,19,1,0,"PACMA",0
50,"50119",927,724,713,5,11,"PACMA",3
11,"11017",3212,2233,2203,39,30,"PACMA",12
33,"33066",42963,28564,28282,300,282,"PACMA",335
50,"50085",167,126,126,1,0,"PACMA",2
24,"24107",236,175,173,0,2,"PACMA",0
16,"16276",21,16,16,1,0,"PACMA",0
47,"47103",267,197,192,5,5,"PACMA",1
22,"22226",767,570,562,10,8,"PACMA",2
9,"9197",144,111,109,1,2,"PACMA",0
25,"25052",1555,1027,1016,14,11,"PACMA",8
41,"41062",2223,1653,1637,7,16,"PACMA",3
31,"31213",104,52,52,0,0,"PACMA",0
21,"21064",6522,4227,4146,48,81,"PACMA",48
5,"5118",79,53,53,0,0,"PACMA",0
19,"19038",28,24,23,0,1,"PACMA",0
9,"9065",143,122,122,1,0,"PACMA",0
9,"9466",129,97,97,1,0,"PACMA",0
5,"5265",82,66,66,1,0,"PACMA",0
5,"5119",32,22,22,0,0,"PACMA",0
37,"37276",143,104,103,1,1,"PACMA",0
22,"22227",206,163,160,3,3,"PACMA",1
5,"5120",36,26,26,0,0,"PACMA",0
35,"35011",24002,15928,15684,95,244,"PACMA",204
9,"9288",90,70,70,0,0,"PACMA",0
22,"22059",1149,807,800,3,7,"PACMA",6
22,"22188",82,60,59,6,1,"PACMA",0
25,"25183",499,326,323,7,3,"PACMA",9
39,"39061",3478,2695,2677,13,18,"PACMA",33
31,"31016",7608,5474,5413,50,61,"PACMA",55
5,"5121",249,185,185,4,0,"PACMA",2
37,"37277",75,58,58,0,0,"PACMA",0
26,"26036",16986,11940,11816,66,124,"PACMA",89
19,"19268",35,24,24,1,0,"PACMA",0
9,"9467",64,43,42,1,1,"PACMA",1
10,"10114",953,665,660,3,5,"PACMA",2
33,"33069",3491,2430,2390,17,40,"PACMA",17
37,"37018",107,79,79,0,0,"PACMA",0
46,"46051",8347,6355,6302,24,53,"PACMA",60
19,"19234",43,33,33,0,0,"PACMA",1
23,"23042",292,217,213,1,4,"PACMA",6
29,"29069",85684,54130,53621,455,509,"PACMA",740
12,"12043",570,449,442,2,7,"PACMA",4
31,"31017",358,242,239,0,3,"PACMA",3
14,"14053",6006,4285,4232,49,53,"PACMA",40
39,"39062",1812,1379,1366,5,13,"PACMA",8
19,"19163",56,41,40,0,1,"PACMA",0
50,"50058",66,39,39,0,0,"PACMA",1
13,"13044",2671,1960,1936,13,24,"PACMA",14
20,"20044",367,236,236,0,0,"PACMA",2
5,"5123",97,73,73,1,0,"PACMA",1
16,"16074",37,30,30,1,0,"PACMA",0
19,"19042",25,24,24,0,0,"PACMA",0
3,"3137",651,492,489,5,3,"PACMA",4
28,"28171",4239,2848,2820,19,28,"PACMA",27
50,"50155",103,80,78,0,2,"PACMA",1
18,"18122",16114,11098,10945,83,153,"PACMA",122
24,"24080",213,164,161,3,3,"PACMA",0
3,"3043",2911,2431,2399,13,32,"PACMA",10
23,"23044",4816,3663,3569,27,94,"PACMA",34
50,"50156",215,181,178,2,3,"PACMA",0
38,"38021",1629,1033,1022,9,11,"PACMA",12
23,"23084",935,658,653,7,5,"PACMA",2
6,"6135",1092,846,828,0,18,"PACMA",2
5,"5125",55,47,47,0,0,"PACMA",0
49,"49111",127,98,96,4,2,"PACMA",0
7,"7055",7442,4604,4553,42,51,"PACMA",48
9,"9071",41,35,35,1,0,"PACMA",1
14,"14055",18557,12950,12764,178,186,"PACMA",99
37,"37282",204,149,148,1,1,"PACMA",0
13,"13048",504,390,387,2,3,"PACMA",1
24,"24180",1134,812,800,9,12,"PACMA",5
42,"42060",38,21,19,1,2,"PACMA",0
45,"45074",414,327,323,1,4,"PACMA",1
22,"22233",82,57,57,3,0,"PACMA",0
24,"24114",3061,2025,1994,9,31,"PACMA",14
12,"12046",191,151,150,2,1,"PACMA",1
50,"50901",138,105,105,0,0,"PACMA",1
50,"50250",52,44,44,0,0,"PACMA",0
44,"44239",22,20,20,0,0,"PACMA",0
20,"20013",5415,3602,3579,19,23,"PACMA",18
25,"25148",219,124,124,0,0,"PACMA",0
6,"6001",686,522,515,0,7,"PACMA",1
33,"33073",8554,4945,4884,41,61,"PACMA",20
50,"50062",1829,1304,1290,16,14,"PACMA",17
18,"18126",1483,1081,1074,15,7,"PACMA",7
28,"28085",3922,2972,2954,14,18,"PACMA",31
29,"29074",794,586,581,0,5,"PACMA",2
37,"37284",316,246,238,4,8,"PACMA",0
44,"44033",269,191,190,0,1,"PACMA",0
31,"31121",62,44,43,0,1,"PACMA",2
48,"48910",2909,1950,1937,10,13,"PACMA",14
34,"34132",114,89,86,0,3,"PACMA",0
21,"21072",10262,7442,7307,85,135,"PACMA",77
5,"5128",354,281,271,2,10,"PACMA",3
22,"22235",98,76,76,1,0,"PACMA",0
6,"6139",553,420,419,1,1,"PACMA",0
5,"5129",125,88,87,2,1,"PACMA",0
42,"42062",22,12,12,0,0,"PACMA",0
46,"46211",1745,1387,1378,8,9,"PACMA",18
50,"50160",2238,1546,1528,12,18,"PACMA",7
40,"40076",6492,4768,4700,26,68,"PACMA",41
7,"7059",2996,2053,2013,17,40,"PACMA",30
31,"31188",235,161,161,2,0,"PACMA",4
19,"19278",28,26,26,0,0,"PACMA",0
19,"19169",40,34,34,0,0,"PACMA",0
31,"31223",985,704,698,4,6,"PACMA",7
50,"50253",423,330,328,4,2,"PACMA",2
20,"20016",1520,826,821,2,5,"PACMA",9
20,"20049",4122,2677,2666,15,11,"PACMA",23
50,"50161",106,75,72,0,3,"PACMA",0
9,"9074",794,575,569,6,6,"PACMA",4
11,"11027",67913,45219,44833,454,386,"PACMA",692
26,"26148",165,135,133,1,2,"PACMA",0
40,"40204",167,113,110,1,3,"PACMA",1
22,"22236",253,200,200,0,0,"PACMA",2
40,"40078",161,125,124,2,1,"PACMA",0
37,"37027",228,172,171,0,1,"PACMA",0
14,"14059",690,533,528,4,5,"PACMA",4
31,"31123",647,369,361,5,8,"PACMA",2
2,"2030",3065,2287,2263,6,24,"PACMA",21
46,"46031",10535,7543,7451,66,92,"PACMA",80
37,"37247",196,163,162,3,1,"PACMA",0
18,"18086",349,274,272,0,2,"PACMA",1
28,"28022",33479,27129,27037,133,92,"PACMA",204
44,"44036",25,21,21,0,0,"PACMA",0
31,"31224",893,671,662,3,9,"PACMA",1
49,"49034",432,327,325,2,2,"PACMA",1
37,"37288",262,182,181,4,1,"PACMA",2
16,"16132",35,27,26,0,1,"PACMA",0
21,"21076",2121,1458,1437,17,21,"PACMA",5
14,"14060",4868,3473,3412,41,61,"PACMA",20
46,"46058",1772,1398,1373,15,25,"PACMA",21
34,"34089",155,124,124,2,0,"PACMA",1
20,"20052",1090,779,776,8,3,"PACMA",2
6,"6008",632,525,519,2,6,"PACMA",0
16,"16133",4389,3358,3316,24,42,"PACMA",19
9,"9350",469,350,343,2,7,"PACMA",0
49,"49118",203,161,160,1,1,"PACMA",4
50,"50163",3689,2702,2680,37,22,"PACMA",23
37,"37029",209,137,135,1,2,"PACMA",1
37,"37289",232,167,166,3,1,"PACMA",0
37,"37290",141,113,113,0,0,"PACMA",0
37,"37030",85,66,66,0,0,"PACMA",0
9,"9041",28,27,27,0,0,"PACMA",0
23,"23093",3226,2302,2273,19,29,"PACMA",14
10,"10082",1868,1451,1412,11,39,"PACMA",5
10,"10128",5697,3958,3891,32,67,"PACMA",25
19,"19281",21,15,15,2,0,"PACMA",0
9,"9351",62,49,48,1,1,"PACMA",0
9,"9901",371,263,259,4,4,"PACMA",2
10,"10036",329,241,238,1,3,"PACMA",0
14,"14061",744,595,582,1,13,"PACMA",1
6,"6146",1084,838,830,1,8,"PACMA",0
35,"35020",6034,3992,3934,20,58,"PACMA",31
49,"49120",74,53,52,0,1,"PACMA",0
48,"48021",1336,908,899,1,9,"PACMA",7
24,"24089",102747,74428,73688,631,740,"PACMA",660
12,"12088",62,59,59,0,0,"PACMA",0
22,"22244",52,38,37,0,1,"PACMA",0
37,"37292",104,77,77,1,0,"PACMA",0
46,"46138",343,275,272,1,3,"PACMA",3
45,"45182",1034,806,791,1,15,"PACMA",3
10,"10130",1761,1300,1277,6,23,"PACMA",7
19,"19052",25,21,21,1,0,"PACMA",0
45,"45082",1224,1020,1011,8,9,"PACMA",1
19,"19175",32,28,28,0,0,"PACMA",0
9,"9082",39,36,36,0,0,"PACMA",0
19,"19283",30,25,25,0,0,"PACMA",0
37,"37033",95,68,68,5,0,"PACMA",1
11,"11032",53874,31273,31008,348,265,"PACMA",512
18,"18138",2486,1620,1606,13,14,"PACMA",2
46,"46087",120,98,97,0,1,"PACMA",2
46,"46191",1937,1530,1505,5,25,"PACMA",12
18,"18094",2359,1744,1720,14,24,"PACMA",13
19,"19135",107,90,90,3,0,"PACMA",1
37,"37294",11692,8317,8221,71,96,"PACMA",89
40,"40211",74,64,64,0,0,"PACMA",0
34,"34004",5608,4120,4063,43,57,"PACMA",37
5,"5140",111,89,87,0,2,"PACMA",0
34,"34141",177,149,145,2,4,"PACMA",0
20,"20056",4082,2589,2570,27,19,"PACMA",8
40,"40212",27,23,22,2,1,"PACMA",0
28,"28092",151841,110916,109954,582,962,"PACMA",1586
42,"42075",83,62,62,0,0,"PACMA",0
39,"39074",6902,5113,5039,40,74,"PACMA",45
19,"19285",24,21,21,1,0,"PACMA",0
49,"49003",900,612,599,5,13,"PACMA",5
50,"50070",60,36,36,0,0,"PACMA",1
46,"46062",4631,3511,3474,27,37,"PACMA",25
11,"11034",2334,1549,1517,14,32,"PACMA",4
5,"5142",99,88,85,0,3,"PACMA",1
6,"6151",1070,770,766,3,4,"PACMA",2
6,"6015",116758,77960,77205,583,755,"PACMA",885
46,"46218",1060,910,885,7,25,"PACMA",10
45,"45085",1500,1011,999,4,12,"PACMA",10
6,"6152",1319,945,932,4,13,"PACMA",7
19,"19286",720,547,543,2,4,"PACMA",4
13,"13066",2506,1971,1947,11,24,"PACMA",16
26,"26157",296,241,237,4,4,"PACMA",1
35,"35024",13735,8545,8439,77,106,"PACMA",82
9,"9356",42,33,32,0,1,"PACMA",0
38,"38035",9474,5616,5564,36,52,"PACMA",91
31,"31031",220,131,129,0,2,"PACMA",0
4,"4006",7022,4792,4749,30,43,"PACMA",19
25,"25207",6212,3710,3680,47,30,"PACMA",27
47,"47012",113,93,93,0,0,"PACMA",1
24,"24060",602,363,361,3,2,"PACMA",0
44,"44251",254,198,191,1,7,"PACMA",0
49,"49042",244,178,176,1,2,"PACMA",0
16,"16004",259,198,197,2,1,"PACMA",0
40,"40047",30,25,25,0,0,"PACMA",0
22,"22006",298,204,204,5,0,"PACMA",0
45,"45187",4062,3277,3233,15,44,"PACMA",20
37,"37038",788,595,583,4,12,"PACMA",6
25,"25208",331,183,182,1,1,"PACMA",3
9,"9907",1420,1058,1041,12,17,"PACMA",15
48,"48026",1140,830,823,5,7,"PACMA",0
13,"13069",660,508,499,7,9,"PACMA",0
19,"19181",56,42,42,0,0,"PACMA",0
45,"45188",2785,1960,1938,15,22,"PACMA",18
28,"28901",799,558,554,0,4,"PACMA",5
9,"9908",449,307,306,3,1,"PACMA",3
20,"20059",8874,5873,5855,29,18,"PACMA",17
34,"34011",397,321,320,5,1,"PACMA",1
49,"49127",2367,1668,1650,16,18,"PACMA",10
40,"40091",119,97,95,1,2,"PACMA",0
45,"45088",2115,1351,1338,4,13,"PACMA",20
3,"3027",157,138,135,0,3,"PACMA",4
3,"3058",4951,3897,3851,30,46,"PACMA",26
14,"14068",538,401,398,10,3,"PACMA",2
40,"40218",92,65,64,1,1,"PACMA",0
47,"47014",51,45,45,0,0,"PACMA",0
25,"25078",998,628,627,7,1,"PACMA",11
50,"50043",253,171,171,0,0,"PACMA",3
25,"25167",230,138,138,3,0,"PACMA",0
2,"2003",132346,95878,95217,630,661,"PACMA",1055
16,"16254",214,174,170,2,4,"PACMA",0
12,"12095",959,749,742,8,7,"PACMA",4
10,"10094",234,196,196,1,0,"PACMA",2
45,"45189",599,470,462,2,8,"PACMA",10
9,"9225",83,55,54,0,1,"PACMA",0
31,"31134",176,125,124,0,1,"PACMA",0
46,"46144",663,532,529,2,3,"PACMA",2
2,"2044",1105,768,758,7,10,"PACMA",2
25,"25211",680,386,379,4,7,"PACMA",6
39,"39079",8874,6547,6478,47,69,"PACMA",81
9,"9091",724,500,490,4,10,"PACMA",0
40,"40219",587,455,444,5,11,"PACMA",3
6,"6158",13314,9654,9507,67,147,"PACMA",77
23,"23903",3540,2662,2634,13,28,"PACMA",7
19,"19184",71,50,48,0,2,"PACMA",0
44,"44258",67,47,47,0,0,"PACMA",0
24,"24097",218,140,139,3,1,"PACMA",0
47,"47177",105,76,73,1,3,"PACMA",1
23,"23904",2796,1825,1798,8,27,"PACMA",6
26,"26163",136,118,118,0,0,"PACMA",0
18,"18013",4218,3024,2986,15,38,"PACMA",12
37,"37178",100,76,75,0,1,"PACMA",0
10,"10004",704,492,482,9,10,"PACMA",0
28,"28099",1748,1290,1283,7,7,"PACMA",8
5,"5152",678,554,551,3,3,"PACMA",1
49,"49011",232,168,165,6,3,"PACMA",1
31,"31136",447,299,298,2,1,"PACMA",2
14,"14070",1332,986,974,10,12,"PACMA",0
13,"13075",211,164,161,1,3,"PACMA",0
25,"25128",136,75,75,0,0,"PACMA",2
46,"46015",7244,5615,5560,40,55,"PACMA",62
16,"16011",27,22,22,1,0,"PACMA",0
37,"37305",216,171,170,0,1,"PACMA",3
31,"31237",193,155,153,2,2,"PACMA",2
11,"11041",9866,6477,6402,69,75,"PACMA",43
16,"16151",64,61,59,0,2,"PACMA",0
25,"25085",148,107,107,0,0,"PACMA",0
50,"50267",602,433,430,8,3,"PACMA",1
3,"3061",1056,776,768,4,8,"PACMA",10
16,"16012",84,72,71,0,1,"PACMA",0
5,"5154",38,33,33,0,0,"PACMA",0
19,"19294",29,27,27,0,0,"PACMA",0
4,"4012",191,161,161,0,0,"PACMA",5
9,"9229",198,146,143,0,3,"PACMA",0
44,"44261",739,536,529,6,7,"PACMA",0
37,"37306",259,186,183,1,3,"PACMA",1
2,"2048",1226,981,975,7,6,"PACMA",7
25,"25217",10625,6319,6260,99,59,"PACMA",72
34,"34020",52,39,39,0,0,"PACMA",0
13,"13078",9041,6325,6266,47,59,"PACMA",44
19,"19187",48,43,43,0,0,"PACMA",0
11,"11901",5648,3676,3631,67,45,"PACMA",26
26,"26059",1125,828,812,5,16,"PACMA",3
24,"24002",231,173,172,1,1,"PACMA",2
6,"6027",676,561,552,2,9,"PACMA",3
46,"46069",162,124,123,0,1,"PACMA",0
37,"37049",137,96,96,1,0,"PACMA",0
5,"5002",1963,1422,1390,3,32,"PACMA",9
42,"42087",49,43,42,0,1,"PACMA",0
21,"21055",6975,5293,5241,48,52,"PACMA",56
13,"13080",351,266,266,2,0,"PACMA",0
31,"31240",527,327,326,2,1,"PACMA",0
16,"16154",4871,3547,3509,24,38,"PACMA",31
31,"31140",117,84,84,1,0,"PACMA",0
6,"6028",4233,3588,3499,30,89,"PACMA",12
45,"45195",2141,1635,1606,7,29,"PACMA",6
3,"3064",5015,3660,3611,11,49,"PACMA",21
40,"40100",270,213,211,2,2,"PACMA",0
37,"37310",178,123,123,1,0,"PACMA",0
19,"19298",65,45,45,0,0,"PACMA",0
46,"46044",4218,3222,3158,18,64,"PACMA",22
50,"50270",38,26,26,0,0,"PACMA",0
29,"29095",3321,2376,2307,24,69,"PACMA",26
24,"24004",463,350,348,4,2,"PACMA",0
48,"48034",12866,8798,8747,43,51,"PACMA",70
49,"49016",247,176,174,5,2,"PACMA",1
44,"44159",38,31,31,1,0,"PACMA",0
38,"38046",9113,6850,6775,40,75,"PACMA",115
45,"45096",1004,807,799,1,8,"PACMA",4
31,"31141",110,71,70,1,1,"PACMA",0
26,"26169",64,60,60,0,0,"PACMA",0
12,"12102",522,423,418,1,5,"PACMA",6
46,"46071",464,383,377,0,6,"PACMA",2
16,"16017",366,294,294,2,0,"PACMA",4
29,"29096",2810,1944,1909,31,35,"PACMA",16
18,"18157",1121,815,803,3,12,"PACMA",7
49,"49261",1537,1048,1033,8,15,"PACMA",5
5,"5160",323,256,253,2,3,"PACMA",0
10,"10013",276,207,200,0,7,"PACMA",0
37,"37186",104,85,85,2,0,"PACMA",0
3,"3066",42121,29655,29419,214,236,"PACMA",378
50,"50271",252,200,197,2,3,"PACMA",0
37,"37054",250,195,192,1,3,"PACMA",1
44,"44053",105,78,78,0,0,"PACMA",0
40,"40104",265,198,195,0,3,"PACMA",4
49,"49018",329,261,256,2,5,"PACMA",0
46,"46124",787,653,642,4,11,"PACMA",5
11,"11014",16858,10366,10245,153,121,"PACMA",96
22,"22135",189,128,127,0,1,"PACMA",0
5,"5162",86,66,63,0,3,"PACMA",0
10,"10014",1852,1370,1346,6,24,"PACMA",1
34,"34165",66,58,58,1,0,"PACMA",0
25,"25093",640,403,395,7,8,"PACMA",2
25,"25223",922,553,543,8,10,"PACMA",7
6,"6033",1327,1011,1006,10,5,"PACMA",3
2,"2055",1127,679,668,6,11,"PACMA",1
38,"38049",2655,1654,1627,8,27,"PACMA",17
16,"16159",220,159,159,0,0,"PACMA",0
19,"19301",40,33,33,1,0,"PACMA",0
6,"6034",171,121,120,4,1,"PACMA",1
40,"40231",108,90,89,0,1,"PACMA",0
5,"5163",1737,1347,1340,4,7,"PACMA",6
25,"25050",3233,1936,1912,25,24,"PACMA",12
45,"45165",62718,44420,44006,236,414,"PACMA",450
20,"20071",14801,9466,9421,60,45,"PACMA",46
48,"48037",673,481,478,5,3,"PACMA",4
37,"37315",96,70,70,0,0,"PACMA",0
24,"24007",773,550,548,4,2,"PACMA",2
6,"6035",937,696,681,5,15,"PACMA",1
2,"2056",1718,1296,1274,6,22,"PACMA",9
34,"34168",52,47,47,2,0,"PACMA",0
12,"12005",8062,5829,5754,64,75,"PACMA",51
9,"9239",52,40,39,0,1,"PACMA",0
34,"34073",185,149,149,0,0,"PACMA",0
25,"25097",84,65,65,3,0,"PACMA",0
24,"24210",503,358,356,3,2,"PACMA",0
1,"1003",1190,782,774,2,8,"PACMA",4
26,"26138",4588,3290,3247,15,43,"PACMA",16
28,"28041",4524,3508,3490,20,18,"PACMA",57
9,"9108",384,283,279,1,4,"PACMA",3
50,"50213",94,75,74,0,1,"PACMA",0
37,"37107",10764,7379,7264,56,115,"PACMA",36
18,"18163",324,235,233,2,2,"PACMA",2
3,"3069",3076,2123,2102,17,21,"PACMA",23
12,"12006",172,135,133,0,2,"PACMA",1
18,"18025",288,220,220,1,0,"PACMA",0
44,"44165",175,135,133,2,2,"PACMA",0
13,"13092",1846,1477,1462,5,15,"PACMA",1
45,"45001",1835,1281,1251,3,30,"PACMA",8
5,"5167",254,207,202,4,5,"PACMA",0
46,"46075",150,130,123,1,7,"PACMA",1
47,"47104",2836,2182,2121,19,61,"PACMA",4
18,"18028",928,765,758,2,7,"PACMA",1
47,"47186",246129,186191,184733,1198,1458,"PACMA",1370
24,"24212",1032,773,760,4,13,"PACMA",5
50,"50184",115,85,85,0,0,"PACMA",0
29,"29012",9755,6689,6599,71,90,"PACMA",53
7,"7009",738,521,510,12,11,"PACMA",7
4,"4021",185,151,148,1,3,"PACMA",0
37,"37319",114,78,74,0,4,"PACMA",1
46,"46232",895,711,696,5,15,"PACMA",6
44,"44234",61,51,51,1,0,"PACMA",0
9,"9243",76,59,57,1,2,"PACMA",0
5,"5019",44555,33259,32939,277,320,"PACMA",319
28,"28043",5921,3803,3759,18,44,"PACMA",28
29,"29902",2567,1577,1559,11,18,"PACMA",10
47,"47187",84,61,58,0,3,"PACMA",0
13,"13094",304,249,247,1,2,"PACMA",0
50,"50088",302,246,237,5,9,"PACMA",0
39,"39001",2102,1622,1601,18,21,"PACMA",9
49,"49025",173,133,133,1,0,"PACMA",0
1,"1008",786,513,509,11,4,"PACMA",2
45,"45204",632,488,487,1,1,"PACMA",5
24,"24214",656,490,485,3,5,"PACMA",1
45,"45170",228,176,167,0,9,"PACMA",0
21,"21067",414,288,287,1,1,"PACMA",1
7,"7052",4667,2908,2886,29,22,"PACMA",55
40,"40070",149,107,105,1,2,"PACMA",1
40,"40904",357,308,306,3,2,"PACMA",2
33,"33008",1777,1238,1229,3,9,"PACMA",3
19,"19307",27,23,23,0,0,"PACMA",1
37,"37195",46,36,36,1,0,"PACMA",0
12,"12109",649,532,524,6,8,"PACMA",15
31,"31150",213,156,155,1,1,"PACMA",0
49,"49270",133,99,99,1,0,"PACMA",1
26,"26070",183,153,153,1,0,"PACMA",0
38,"38020",15113,9928,9830,59,98,"PACMA",139
31,"31251",3115,2240,2205,15,35,"PACMA",22
34,"34036",211,150,150,0,0,"PACMA",0
9,"9384",295,211,206,0,5,"PACMA",2
31,"31051",251,170,170,2,0,"PACMA",1
49,"49027",140,112,108,1,4,"PACMA",0
2,"2063",1463,1073,1060,3,13,"PACMA",10
22,"22024",226,174,171,3,3,"PACMA",1
24,"24179",290,197,192,4,5,"PACMA",0
34,"34037",302,218,216,1,2,"PACMA",0
12,"12111",360,305,299,3,6,"PACMA",1
37,"37323",516,376,372,5,4,"PACMA",0
24,"24216",723,522,518,1,4,"PACMA",6
47,"47028",33,21,21,0,0,"PACMA",0
12,"12011",4565,3331,3283,20,48,"PACMA",35
9,"9473",85,70,65,1,5,"PACMA",0
9,"9387",117,95,90,0,5,"PACMA",0
39,"39095",2266,1760,1726,14,34,"PACMA",9
19,"19087",18,18,18,0,0,"PACMA",0
23,"23004",436,364,358,1,6,"PACMA",3
37,"37324",360,276,275,2,1,"PACMA",1
9,"9248",78,59,59,1,0,"PACMA",0
46,"46157",2980,2321,2298,10,23,"PACMA",29
26,"26180",221,173,172,0,1,"PACMA",1
26,"26039",39,35,35,2,0,"PACMA",0
40,"40073",401,345,343,3,2,"PACMA",1
6,"6137",972,744,737,1,7,"PACMA",1
31,"31253",129,109,109,0,0,"PACMA",0
13,"13903",524,419,415,3,4,"PACMA",0
44,"44238",2323,1603,1590,5,13,"PACMA",27
11,"11024",6723,4696,4634,44,62,"PACMA",18
12,"12012",2685,2234,2202,13,32,"PACMA",16
23,"23006",4660,3687,3647,24,40,"PACMA",19
31,"31153",2159,1403,1387,12,16,"PACMA",4
5,"5027",269,229,225,2,4,"PACMA",0
28,"28047",40914,30019,29788,169,231,"PACMA",449
10,"10166",308,206,204,0,2,"PACMA",0
26,"26074",105,86,85,1,1,"PACMA",1
28,"28116",704,528,523,2,5,"PACMA",7
6,"6047",849,639,628,2,11,"PACMA",1
13,"13904",531,400,392,4,8,"PACMA",8
28,"28048",500,391,387,3,4,"PACMA",5
34,"34180",66,55,55,1,0,"PACMA",0
48,"48046",12611,8836,8794,39,42,"PACMA",42
24,"24017",577,426,418,1,8,"PACMA",1
6,"6048",849,691,677,7,14,"PACMA",2
10,"10168",312,213,208,0,5,"PACMA",1
25,"25109",231,163,162,2,1,"PACMA",3
19,"19203",30,24,24,0,0,"PACMA",0
5,"5177",158,130,129,0,1,"PACMA",0
41,"41092",7743,5358,5311,55,47,"PACMA",40
41,"41004",56640,37110,36649,440,461,"PACMA",729
31,"31055",257,175,172,2,3,"PACMA",2
27,"27001",2370,1281,1256,13,25,"PACMA",11
16,"16035",261,203,198,4,5,"PACMA",2
24,"24018",174,143,141,0,2,"PACMA",1
37,"37071",78,65,64,0,1,"PACMA",0
6,"6004",1600,1212,1207,2,5,"PACMA",4
50,"50191",470,310,308,1,2,"PACMA",2
26,"26076",129,107,106,0,1,"PACMA",0
16,"16036",126,109,106,0,3,"PACMA",1
3,"3078",478,389,389,5,0,"PACMA",2
47,"47113",159,129,128,0,1,"PACMA",0
45,"45111",65,50,50,0,0,"PACMA",1
2,"2070",403,332,328,4,4,"PACMA",1
50,"50284",141,107,104,0,3,"PACMA",0
40,"40122",512,395,394,2,1,"PACMA",9
12,"12015",93,81,78,0,3,"PACMA",1
24,"24221",795,543,538,7,5,"PACMA",1
12,"12084",17615,12766,12644,105,122,"PACMA",133
26,"26044",52,46,46,0,0,"PACMA",1
25,"25197",133,89,88,1,1,"PACMA",0
37,"37163",41,34,34,0,0,"PACMA",0
5,"5181",43,34,34,1,0,"PACMA",0
9,"9123",40,35,35,0,0,"PACMA",0
10,"10033",423,320,320,0,0,"PACMA",0
26,"26011",7321,5133,5083,38,50,"PACMA",33
26,"26113",35,35,34,0,1,"PACMA",0
40,"40164",177,139,138,0,1,"PACMA",0
6,"6052",4030,2735,2688,20,47,"PACMA",11
25,"25243",3646,2193,2167,33,26,"PACMA",23
24,"24223",2610,1917,1908,39,9,"PACMA",13
27,"27005",2595,1846,1816,13,30,"PACMA",18
46,"46084",1576,1263,1242,5,21,"PACMA",11
12,"12117",3585,2727,2677,20,50,"PACMA",21
20,"20904",95,44,44,2,0,"PACMA",1
19,"19321",39,30,30,1,0,"PACMA",0
5,"5037",255,173,172,1,1,"PACMA",0
41,"41007",12341,8039,7844,103,195,"PACMA",97
33,"33017",3144,2094,2071,35,23,"PACMA",9
30,"30008",13918,9757,9645,59,112,"PACMA",84
24,"24119",706,488,481,3,7,"PACMA",4
47,"47115",281,236,233,3,3,"PACMA",0
14,"14005",6311,4143,4084,72,59,"PACMA",34
5,"5038",115,83,81,0,2,"PACMA",0
34,"34137",27,23,22,0,1,"PACMA",0
48,"48051",213,163,163,0,0,"PACMA",3
12,"12018",287,246,242,1,4,"PACMA",2
5,"5184",246,183,183,0,0,"PACMA",2
10,"10174",174,135,132,0,3,"PACMA",5
27,"27060",2598,1690,1665,19,25,"PACMA",7
29,"29024",386,227,219,2,8,"PACMA",2
37,"37207",287,195,193,1,2,"PACMA",1
25,"25115",824,489,487,7,2,"PACMA",5
49,"49158",215,170,166,2,4,"PACMA",0
42,"42118",23,17,17,0,0,"PACMA",0
25,"25245",435,289,280,5,9,"PACMA",0
28,"28053",6498,4995,4955,28,40,"PACMA",47
44,"44074",429,333,326,4,7,"PACMA",0
39,"39011",1585,1169,1160,5,9,"PACMA",9
12,"12119",148,95,93,0,2,"PACMA",0
37,"37079",77,73,73,1,0,"PACMA",2
31,"31061",54,49,49,0,0,"PACMA",2
9,"9396",156,121,121,0,0,"PACMA",1
2,"2075",1670,1321,1304,4,17,"PACMA",12
26,"26081",16,14,14,0,0,"PACMA",0
49,"49038",99,71,65,1,6,"PACMA",0
9,"9003",194,147,146,0,1,"PACMA",2
45,"45015",606,437,433,2,4,"PACMA",7
40,"40127",32,25,25,0,0,"PACMA",0
22,"22162",130,102,102,0,0,"PACMA",1
37,"37168",439,316,311,0,5,"PACMA",0
35,"35022",48603,29443,29042,160,401,"PACMA",445
50,"50166",255,208,206,2,2,"PACMA",0
40,"40002",36,32,32,0,0,"PACMA",0
42,"42120",145,91,89,2,2,"PACMA",1
30,"30011",4697,3421,3383,15,38,"PACMA",31
10,"10040",441,313,307,4,6,"PACMA",1
50,"50101",864,603,597,8,6,"PACMA",5
26,"26082",112,87,87,1,0,"PACMA",0
9,"9083",37,33,33,0,0,"PACMA",0
25,"25120",92002,55658,55214,587,444,"PACMA",768
28,"28123",57078,45270,44992,215,278,"PACMA",581
18,"18046",1832,1160,1140,6,20,"PACMA",7
34,"34196",89,68,68,1,0,"PACMA",0
10,"10041",1057,795,781,4,14,"PACMA",6
34,"34052",174,135,133,0,2,"PACMA",1
9,"9403",94,78,78,1,0,"PACMA",2
46,"46166",8155,6320,6251,30,69,"PACMA",84
44,"44182",197,157,157,0,0,"PACMA",0
3,"3085",272,217,213,0,4,"PACMA",0
23,"23018",2325,1668,1653,10,15,"PACMA",8
45,"45118",1991,1351,1339,6,12,"PACMA",15
19,"19102",98,79,78,0,1,"PACMA",1
10,"10042",84,63,63,0,0,"PACMA",0
12,"12022",344,265,262,2,3,"PACMA",2
40,"40130",130,107,106,1,1,"PACMA",1
6,"6061",1084,853,837,4,16,"PACMA",6
50,"50199",334,244,242,3,2,"PACMA",6
31,"31064",1424,1121,1104,3,17,"PACMA",7
50,"50104",348,271,269,2,2,"PACMA",1
9,"9009",163,133,131,2,2,"PACMA",2
10,"10043",800,562,553,3,9,"PACMA",0
34,"34055",270,209,207,2,2,"PACMA",0
25,"25251",707,443,442,2,1,"PACMA",6
9,"9265",37,28,28,0,0,"PACMA",0
30,"30013",7396,5147,5102,32,45,"PACMA",25
9,"9132",171,122,122,2,0,"PACMA",0
40,"40214",208,168,168,2,0,"PACMA",1
10,"10182",136,95,95,0,0,"PACMA",0
50,"50072",170,125,125,0,0,"PACMA",2
31,"31165",2780,1995,1960,30,35,"PACMA",11
50,"50292",125,102,102,1,0,"PACMA",0
48,"48056",966,705,700,5,5,"PACMA",4
50,"50200",511,410,403,2,7,"PACMA",3
6,"6063",3015,2268,2246,16,22,"PACMA",7
40,"40006",22,18,18,0,0,"PACMA",0
19,"19104",14,12,12,1,0,"PACMA",0
40,"40132",56,37,36,1,1,"PACMA",0
42,"42125",70,59,59,1,0,"PACMA",0
29,"29031",1614,1107,1094,13,13,"PACMA",9
34,"34204",46,41,41,0,0,"PACMA",0
10,"10183",980,733,728,1,5,"PACMA",3
47,"47039",185,141,140,0,1,"PACMA",0
21,"21006",3368,2182,2146,13,36,"PACMA",14
44,"44084",54,41,41,0,0,"PACMA",0
16,"16050",245,201,195,1,6,"PACMA",0
1,"1030",156,129,129,3,0,"PACMA",1
30,"30015",19171,13561,13464,61,97,"PACMA",99
40,"40135",283,236,231,2,5,"PACMA",0
50,"50012",100,80,79,2,1,"PACMA",0
10,"10184",756,613,604,10,9,"PACMA",1
16,"16051",142,120,119,0,1,"PACMA",0
24,"24095",320,234,232,0,2,"PACMA",2
22,"22008",173,137,133,3,4,"PACMA",1
37,"37301",74,63,63,0,0,"PACMA",0
40,"40092",118,87,87,1,0,"PACMA",0
18,"18192",1538,1151,1123,6,28,"PACMA",3
47,"47176",219,139,139,1,0,"PACMA",0
19,"19331",2609,1872,1844,12,28,"PACMA",28
34,"34206",866,661,654,4,7,"PACMA",1
14,"14012",6173,4364,4291,35,73,"PACMA",15
10,"10186",977,795,778,1,17,"PACMA",4
3,"3090",17182,12487,12385,74,102,"PACMA",163
50,"50107",947,738,733,4,5,"PACMA",5
30,"30017",11605,8541,8451,46,90,"PACMA",81
31,"31903",6654,4402,4343,27,59,"PACMA",69
50,"50203",1040,748,739,7,9,"PACMA",8
9,"9409",111,86,86,4,0,"PACMA",1
28,"28060",1510,1134,1117,1,17,"PACMA",22
31,"31168",246,172,171,1,1,"PACMA",2
24,"24130",438,323,321,4,2,"PACMA",3
44,"44189",56,41,41,0,0,"PACMA",1
50,"50295",48,43,42,0,1,"PACMA",0
42,"42129",681,503,495,3,8,"PACMA",0
5,"5197",102,85,83,1,2,"PACMA",0
24,"24030",4277,3038,3007,11,31,"PACMA",18
34,"34208",51,42,42,0,0,"PACMA",1
9,"9270",163,115,115,0,0,"PACMA",0
19,"19333",115,82,82,0,0,"PACMA",0
49,"49170",102,72,71,0,1,"PACMA",0
16,"16198",1348,981,971,10,10,"PACMA",6
9,"9014",195,115,114,1,1,"PACMA",4
37,"37347",468,348,346,2,2,"PACMA",4
40,"40139",279,202,198,1,4,"PACMA",0
23,"23064",1655,1363,1353,1,10,"PACMA",3
4,"4011",2765,2119,2096,21,23,"PACMA",16
31,"31905",2843,1983,1966,15,17,"PACMA",38
22,"22048",12598,8790,8731,91,59,"PACMA",70
19,"19109",39,32,32,0,0,"PACMA",0
26,"26092",107,92,90,0,2,"PACMA",0
25,"25903",236,161,161,3,0,"PACMA",0
5,"5199",40,32,31,0,1,"PACMA",0
3,"3001",337,269,268,0,1,"PACMA",1
37,"37348",115,96,95,0,1,"PACMA",0
40,"40013",62,49,48,0,1,"PACMA",0
25,"25904",148,112,111,2,1,"PACMA",1
22,"22174",478,379,378,2,1,"PACMA",3
5,"5055",568,456,451,4,5,"PACMA",1
40,"40140",92,69,67,0,2,"PACMA",1
44,"44191",764,586,583,6,3,"PACMA",1
12,"12129",1828,1322,1298,11,24,"PACMA",4
25,"25004",571,376,373,3,3,"PACMA",1
50,"50111",180,143,143,0,0,"PACMA",1
29,"29036",632,423,416,2,7,"PACMA",1
9,"9139",103,87,85,3,2,"PACMA",1
10,"10054",547,431,421,1,10,"PACMA",1
22,"22050",88,77,77,0,0,"PACMA",0
40,"40141",842,593,584,10,9,"PACMA",2
41,"41021",21294,13762,13570,145,192,"PACMA",229
16,"16058",103,77,77,0,0,"PACMA",0
23,"23030",1238,968,960,3,8,"PACMA",1
47,"47126",50,41,41,0,0,"PACMA",1
1,"1037",587,411,408,1,3,"PACMA",1
25,"25131",403,248,241,7,7,"PACMA",3
31,"31172",373,278,272,3,6,"PACMA",4
42,"42135",72,52,52,1,0,"PACMA",0
9,"9140",124,80,79,0,1,"PACMA",1
37,"37225",103,89,86,0,3,"PACMA",0
45,"45127",696,514,511,3,3,"PACMA",6
31,"31073",294,212,208,2,4,"PACMA",2
34,"34215",164,141,140,1,1,"PACMA",1
24,"24136",540,387,383,4,4,"PACMA",0
40,"40016",58,49,49,0,0,"PACMA",0
26,"26095",100,83,82,0,1,"PACMA",1
39,"39024",1879,1390,1372,2,18,"PACMA",9
16,"16061",969,771,764,14,7,"PACMA",6
31,"31074",387,286,286,5,0,"PACMA",4
47,"47127",137,98,97,0,1,"PACMA",0
7,"7041",2044,1486,1451,13,35,"PACMA",10
45,"45129",131,92,92,0,0,"PACMA",0
42,"42139",23,15,15,1,0,"PACMA",0
20,"20002",346,203,203,4,0,"PACMA",0
22,"22177",98,75,75,0,0,"PACMA",0
3,"3004",581,438,437,2,1,"PACMA",7
27,"27031",15570,10606,10420,118,186,"PACMA",111
12,"12132",480,396,389,3,7,"PACMA",4
44,"44092",81,59,57,0,2,"PACMA",0
3,"3097",993,822,812,6,10,"PACMA",3
21,"21017",3600,2187,2164,26,23,"PACMA",12
9,"9277",120,101,99,0,2,"PACMA",0
18,"18907",1843,1393,1388,4,5,"PACMA",2
40,"40018",91,72,72,1,0,"PACMA",0
28,"28066",7182,5422,5371,17,51,"PACMA",40
9,"9143",27,19,18,0,1,"PACMA",0
5,"5208",40,36,36,0,0,"PACMA",0
47,"47210",382,282,274,3,8,"PACMA",0
37,"37102",404,307,305,2,2,"PACMA",1
49,"49100",295,212,208,5,4,"PACMA",0
50,"50115",3235,2128,2109,14,19,"PACMA",9
25,"25909",148,93,92,2,1,"PACMA",1
50,"50179",249,214,213,2,1,"PACMA",0
47,"47100",138,117,117,1,0,"PACMA",0
6,"6078",507,409,404,1,5,"PACMA",1
46,"46176",2017,1358,1349,5,9,"PACMA",22
9,"9022",66,57,57,1,0,"PACMA",0
42,"42011",18,10,10,1,0,"PACMA",0
46,"46020",3760,2916,2866,22,50,"PACMA",19
40,"40019",36,31,31,1,0,"PACMA",0
50,"50116",182,136,132,0,4,"PACMA",1
9,"9148",87,70,68,3,2,"PACMA",0
23,"23035",1106,873,855,1,18,"PACMA",5
5,"5063",32,28,27,0,1,"PACMA",0
16,"16065",388,320,314,2,6,"PACMA",1
47,"47130",96,72,72,0,0,"PACMA",0
5,"5211",459,345,343,1,2,"PACMA",1
50,"50022",530,397,390,7,7,"PACMA",3
31,"31078",2429,1795,1767,15,28,"PACMA",6
29,"29009",1468,1069,1045,8,24,"PACMA",8
42,"42093",37,29,28,1,1,"PACMA",0
31,"31178",490,345,342,3,3,"PACMA",1
47,"47049",101,68,68,0,0,"PACMA",0
34,"34072",152,136,135,2,1,"PACMA",2
28,"28136",647,528,518,2,10,"PACMA",3
44,"44096",161,138,135,3,3,"PACMA",2
45,"45133",2797,2068,2048,13,20,"PACMA",9
48,"48068",1550,1130,1118,12,12,"PACMA",4
49,"49061",150,114,112,2,2,"PACMA",0
46,"46178",4637,3405,3381,27,24,"PACMA",54
50,"50084",77,59,59,2,0,"PACMA",0
50,"50023",224,175,175,0,0,"PACMA",0
49,"49062",122,90,89,0,1,"PACMA",0
30,"30026",15734,10007,9901,51,106,"PACMA",74
47,"47185",99,73,71,0,2,"PACMA",0
44,"44199",44,41,41,2,0,"PACMA",0
25,"25012",2334,1322,1310,8,12,"PACMA",30
39,"39059",7986,5879,5806,45,73,"PACMA",47
37,"37274",118913,85506,84764,566,742,"PACMA",665
31,"31212",147,102,102,4,0,"PACMA",1
24,"24174",486,343,342,4,1,"PACMA",2
22,"22058",194,164,162,1,2,"PACMA",2
10,"10202",606,473,463,4,10,"PACMA",3
6,"6083",46149,31049,30739,234,310,"PACMA",276
40,"40024",856,651,639,6,12,"PACMA",2
48,"48069",12798,8679,8612,55,67,"PACMA",52
34,"34074",707,540,531,9,9,"PACMA",0
42,"42149",381,277,273,2,4,"PACMA",2
20,"20007",310,218,218,3,0,"PACMA",3
19,"19119",82,72,71,1,1,"PACMA",1
18,"18070",288,227,226,0,1,"PACMA",0
24,"24042",63,56,56,1,0,"PACMA",0
12,"12137",36,23,23,0,0,"PACMA",1
23,"23040",1480,1199,1192,2,7,"PACMA",7
31,"31181",145,112,112,0,0,"PACMA",0
37,"37360",225,174,173,1,1,"PACMA",0
33,"33037",34454,22881,22586,243,295,"PACMA",248
42,"42151",34,26,26,0,0,"PACMA",0
16,"16071",20,20,20,0,0,"PACMA",0
46,"46076",575,454,443,0,11,"PACMA",2
37,"37110",113,86,86,1,0,"PACMA",0
30,"30029",11864,8125,8058,73,67,"PACMA",67
26,"26002",830,632,622,0,10,"PACMA",3
7,"7050",3348,2156,2139,19,17,"PACMA",21
3,"3103",272,235,234,1,1,"PACMA",2
14,"14024",1903,1405,1376,16,29,"PACMA",17
16,"16219",89,71,71,0,0,"PACMA",0
27,"27044",2879,1705,1662,27,43,"PACMA",9
28,"28140",3007,2276,2256,7,20,"PACMA",44
5,"5217",56,44,43,0,1,"PACMA",0
27,"27045",1038,613,603,10,10,"PACMA",3
34,"34079",1616,1222,1205,5,17,"PACMA",13
37,"37362",4632,3389,3351,25,38,"PACMA",25
16,"16280",192,164,161,1,3,"PACMA",0
10,"10068",735,570,557,2,13,"PACMA",4
42,"42153",14,12,12,0,0,"PACMA",0
31,"31083",52,37,37,0,0,"PACMA",2
5,"5218",121,97,97,0,0,"PACMA",0
40,"40028",105,91,90,2,1,"PACMA",0
50,"50154",116,96,96,0,0,"PACMA",3
18,"18915",745,533,525,2,8,"PACMA",4
5,"5219",38,30,30,0,0,"PACMA",0
10,"10070",718,546,542,1,4,"PACMA",1
47,"47135",83,72,72,2,0,"PACMA",1
44,"44204",24,21,21,0,0,"PACMA",0
30,"30031",492,409,401,0,8,"PACMA",4
46,"46182",1266,929,922,6,7,"PACMA",15
50,"50028",78,51,51,0,0,"PACMA",1
47,"47054",635,507,495,9,12,"PACMA",0
19,"19123",40,32,31,1,1,"PACMA",0
26,"26178",75,57,55,1,2,"PACMA",0
9,"9427",1419,978,959,8,19,"PACMA",8
3,"3013",1113,839,836,4,3,"PACMA",9
24,"24149",152,120,116,3,4,"PACMA",0
25,"25145",86,65,64,1,1,"PACMA",0
50,"50124",415,318,317,2,1,"PACMA",1
5,"5221",351,254,250,2,4,"PACMA",0
26,"26179",41,32,31,0,1,"PACMA",0
42,"42155",167,103,102,1,1,"PACMA",0
16,"16228",172,137,137,4,0,"PACMA",0
19,"19002",69,58,57,0,1,"PACMA",0
20,"20012",147,99,98,5,1,"PACMA",0
34,"34231",229,168,167,1,1,"PACMA",0
31,"31185",494,341,341,1,0,"PACMA",0
27,"27049",1409,921,909,7,12,"PACMA",7
19,"19124",386,260,257,0,3,"PACMA",2
24,"24015",2265,1649,1635,18,14,"PACMA",6
26,"26073",97,78,78,0,0,"PACMA",0
45,"45007",696,534,522,3,12,"PACMA",7
21,"21030",1830,1452,1430,13,22,"PACMA",8
5,"5224",102,86,84,3,2,"PACMA",0
19,"19125",41,32,32,0,0,"PACMA",0
18,"18079",3441,2442,2411,16,31,"PACMA",18
3,"3107",2508,1755,1744,7,11,"PACMA",21
34,"34232",750,578,564,7,14,"PACMA",3
3,"3015",12566,9257,9177,39,80,"PACMA",99
9,"9164",157,127,126,0,1,"PACMA",0
40,"40160",102,71,70,1,1,"PACMA",0
42,"42157",13,10,10,0,0,"PACMA",0
29,"29051",40391,25780,25419,232,361,"PACMA",327
44,"44106",155,116,114,5,2,"PACMA",0
12,"12048",251,185,182,0,3,"PACMA",0
30,"30034",1129,858,844,7,14,"PACMA",5
28,"28146",1787,1205,1194,0,11,"PACMA",5
34,"34084",138,109,107,0,2,"PACMA",0
33,"33043",683,446,441,2,5,"PACMA",1
37,"37369",137,95,94,0,1,"PACMA",0
47,"47220",165,130,129,0,1,"PACMA",0
3,"3016",93,75,75,0,0,"PACMA",0
42,"42024",86,61,59,0,2,"PACMA",0
1,"1056",219,136,135,0,1,"PACMA",2
5,"5226",76,55,54,3,1,"PACMA",0
7,"7058",2791,2060,2034,13,26,"PACMA",33
23,"23048",870,619,613,1,6,"PACMA",2
50,"50128",26,25,25,1,0,"PACMA",0
10,"10214",214,181,177,2,4,"PACMA",2
22,"22067",65,50,50,1,0,"PACMA",1
6,"6095",9504,6621,6475,96,146,"PACMA",55
9,"9431",118,98,98,0,0,"PACMA",0
46,"46238",13282,9786,9721,61,65,"PACMA",130
37,"37120",99,82,78,0,4,"PACMA",0
19,"19006",769,547,540,2,7,"PACMA",6
51,"51001",59125,31093,30737,316,356,"PACMA",327
21,"21034",1188,798,786,8,12,"PACMA",7
41,"41038",100095,67313,66687,760,626,"PACMA",1179
46,"46108",469,378,375,1,3,"PACMA",5
25,"25151",685,425,419,7,6,"PACMA",8
26,"26112",236,194,190,1,4,"PACMA",0
25,"25024",351,226,223,2,3,"PACMA",0
9,"9168",290,217,217,3,0,"PACMA",0
27,"27056",1248,848,836,9,12,"PACMA",16
22,"22200",244,184,182,5,2,"PACMA",0
31,"31190",45,34,32,2,2,"PACMA",0
42,"42026",24,20,20,0,0,"PACMA",0
34,"34184",57,46,45,0,1,"PACMA",0
19,"19007",459,341,336,0,5,"PACMA",0
7,"7061",9819,6351,6280,53,71,"PACMA",69
47,"47142",141,99,97,0,2,"PACMA",0
50,"50162",146,109,105,4,4,"PACMA",1
49,"49239",663,458,448,3,10,"PACMA",0
19,"19049",10,10,9,0,1,"PACMA",0
14,"14032",423,334,330,4,4,"PACMA",1
46,"46188",672,544,537,8,7,"PACMA",8
1,"1058",1345,799,793,7,6,"PACMA",6
23,"23051",2758,2171,2144,9,27,"PACMA",20
7,"7062",7513,4273,4219,52,54,"PACMA",55
27,"27058",3495,2510,2480,30,30,"PACMA",11
44,"44004",408,303,297,0,6,"PACMA",1
42,"42162",2352,1637,1601,16,36,"PACMA",4
26,"26012",23,23,23,1,0,"PACMA",0
46,"46110",21228,15563,15443,86,120,"PACMA",252
49,"49197",175,123,123,1,0,"PACMA",0
49,"49080",685,520,514,2,6,"PACMA",2
19,"19009",259,200,195,6,5,"PACMA",2
45,"45047",2606,1666,1647,6,19,"PACMA",32
21,"21037",472,341,336,2,5,"PACMA",0
23,"23052",1125,936,922,4,14,"PACMA",4
9,"9304",199,157,155,3,2,"PACMA",0
9,"9306",106,82,82,1,0,"PACMA",0
16,"16089",375,303,303,6,0,"PACMA",0
25,"25030",135,74,72,1,2,"PACMA",1
23,"23053",9531,6704,6658,37,46,"PACMA",43
26,"26151",448,370,368,1,2,"PACMA",3
24,"24156",239,159,158,1,1,"PACMA",0
42,"42164",1600,1150,1127,8,23,"PACMA",5
33,"33048",154,95,94,0,1,"PACMA",0
37,"37375",700,578,570,4,8,"PACMA",0
16,"16091",65,53,53,0,0,"PACMA",0
31,"31093",292,188,188,2,0,"PACMA",0
14,"14034",308,247,244,2,3,"PACMA",1
18,"18089",14719,10163,10099,63,64,"PACMA",67
29,"29058",1450,911,894,4,17,"PACMA",4
9,"9307",109,81,80,0,1,"PACMA",1
5,"5088",30,23,23,0,0,"PACMA",0
28,"28151",3142,2235,2199,8,36,"PACMA",17
25,"25031",52,29,29,0,0,"PACMA",0
4,"4067",570,441,436,2,5,"PACMA",2
27,"27063",1737,1226,1186,14,40,"PACMA",8
22,"22204",1114,745,739,12,6,"PACMA",9
31,"31194",311,217,216,3,1,"PACMA",0
18,"18093",2750,1793,1776,7,17,"PACMA",8
50,"50037",136,98,96,0,2,"PACMA",0
20,"20022",839,473,472,4,1,"PACMA",2
26,"26015",196,158,157,2,1,"PACMA",2
24,"24122",1342,930,924,8,6,"PACMA",3
48,"48053",895,666,662,6,4,"PACMA",5
47,"47145",603,448,441,3,7,"PACMA",1
19,"19247",139,102,100,1,2,"PACMA",1
45,"45150",443,356,354,0,2,"PACMA",0
37,"37127",214,154,151,1,3,"PACMA",1
25,"25033",1096,729,723,4,6,"PACMA",6
21,"21041",113337,72318,71637,748,681,"PACMA",1188
27,"27012",1355,736,729,5,7,"PACMA",4
27,"27065",12444,8261,8056,112,205,"PACMA",62
28,"28153",697,499,499,1,0,"PACMA",5
5,"5237",162,130,124,2,6,"PACMA",0
49,"49085",996,684,680,2,4,"PACMA",1
19,"19136",18,14,14,0,0,"PACMA",0
26,"26120",1454,1139,1126,7,13,"PACMA",5
19,"19248",78,63,63,0,0,"PACMA",0
42,"42167",251,175,172,2,3,"PACMA",0
44,"44115",102,90,90,3,0,"PACMA",0
45,"45051",1590,1171,1152,5,19,"PACMA",4
24,"24159",1806,1386,1366,6,20,"PACMA",2
46,"46192",761,576,570,5,6,"PACMA",6
16,"16248",859,654,636,5,18,"PACMA",4
34,"34098",777,551,545,8,6,"PACMA",3
42,"42168",107,80,80,0,0,"PACMA",0
34,"34246",67,53,51,0,2,"PACMA",0
16,"16249",1995,1519,1499,6,20,"PACMA",3
4,"4070",1584,1184,1179,3,5,"PACMA",4
6,"6106",423,274,272,5,2,"PACMA",1
9,"9046",29,25,25,0,0,"PACMA",0
10,"10089",1359,882,868,3,14,"PACMA",3
42,"42171",127,80,79,0,1,"PACMA",0
3,"3025",1270,950,941,2,9,"PACMA",4
23,"23058",8678,6532,6461,37,71,"PACMA",57
48,"48085",10338,7190,7153,39,37,"PACMA",77
21,"21044",17591,10679,10558,118,121,"PACMA",123
47,"47147",116,92,92,0,0,"PACMA",0
49,"49043",289,217,213,1,4,"PACMA",0
42,"42035",769,527,516,2,11,"PACMA",2
2,"2080",528,406,400,2,6,"PACMA",0
5,"5240",3374,2283,2257,7,26,"PACMA",14
23,"23059",5837,4387,4310,40,77,"PACMA",47
6,"6108",2275,1567,1527,11,40,"PACMA",15
50,"50137",1011,772,764,8,8,"PACMA",1
12,"12060",446,368,364,4,4,"PACMA",1
46,"46194",15567,11156,11044,86,112,"PACMA",180
42,"42036",50,41,41,1,0,"PACMA",0
31,"31099",62,47,47,2,0,"PACMA",0
42,"42172",29,26,26,0,0,"PACMA",0
47,"47148",442,342,338,2,4,"PACMA",0
37,"37258",172,116,115,3,1,"PACMA",1
21,"21046",1705,1099,996,16,103,"PACMA",5
34,"34903",198,131,131,1,0,"PACMA",0
10,"10092",292,236,235,1,1,"PACMA",2
19,"19143",1738,1306,1297,12,9,"PACMA",10
25,"25037",375,247,246,5,1,"PACMA",0
38,"38001",20228,11032,10936,47,96,"PACMA",161
47,"47149",42,34,34,3,0,"PACMA",0
5,"5099",491,395,386,6,9,"PACMA",0
3,"3121",21273,14569,14468,62,101,"PACMA",261
46,"46117",495,402,399,5,3,"PACMA",11
2,"2002",470,394,389,3,5,"PACMA",0
46,"46195",1962,1531,1516,11,15,"PACMA",15
6,"6110",148,108,108,1,0,"PACMA",1
44,"44220",121,84,83,1,1,"PACMA",0
6,"6111",500,337,337,1,0,"PACMA",0
25,"25038",1545,995,986,17,9,"PACMA",4
13,"13019",5181,3621,3579,18,42,"PACMA",22
9,"9051",170,130,128,0,2,"PACMA",2
37,"37176",133,110,110,0,0,"PACMA",0
31,"31101",1373,973,966,8,7,"PACMA",17
23,"23062",1454,1141,1128,1,13,"PACMA",0
47,"47150",274,209,205,0,4,"PACMA",0
21,"21048",305,214,210,4,4,"PACMA",4
19,"19146",41,35,32,0,3,"PACMA",0
25,"25168",509,354,352,7,2,"PACMA",2
34,"34104",246,185,182,1,3,"PACMA",0
2,"2004",612,479,473,5,6,"PACMA",2
23,"23063",3829,2560,2522,21,38,"PACMA",6
19,"19147",43,33,33,0,0,"PACMA",0
24,"24064",1523,1101,1087,3,14,"PACMA",7
42,"42039",226,138,138,4,0,"PACMA",1
5,"5101",292,240,236,1,4,"PACMA",0
26,"26126",31,27,27,0,0,"PACMA",0
49,"49210",471,370,365,1,5,"PACMA",1
4,"4075",5196,3735,3706,23,29,"PACMA",26
3,"3030",524,448,440,5,8,"PACMA",4
5,"5102",1780,1339,1317,3,22,"PACMA",3
19,"19022",625,476,469,3,7,"PACMA",1
48,"48090",6001,4345,4295,28,50,"PACMA",24
14,"14042",18891,14051,13848,190,203,"PACMA",143
41,"41051",2180,1529,1501,2,28,"PACMA",14
19,"19293",1867,1358,1342,7,16,"PACMA",19
2,"2901",2200,1440,1437,7,3,"PACMA",4
6,"6024",1172,905,883,4,22,"PACMA",1
13,"13076",484,400,394,1,6,"PACMA",0
20,"20030",21423,13960,13898,101,62,"PACMA",100
21,"21051",239,174,170,1,4,"PACMA",0
47,"47152",78,60,60,0,0,"PACMA",0
40,"40181",4233,3260,3219,23,41,"PACMA",11
38,"38006",39766,20776,20587,139,189,"PACMA",355
4,"4077",295,263,261,2,2,"PACMA",0
40,"40054",108,90,90,0,0,"PACMA",0
6,"6116",1587,1171,1160,10,11,"PACMA",4
14,"14043",7574,5515,5443,81,72,"PACMA",28
34,"34108",542,421,417,3,4,"PACMA",3
18,"18105",3782,2450,2420,17,30,"PACMA",9
11,"11009",605,414,410,1,4,"PACMA",3
5,"5251",60,42,42,1,0,"PACMA",0
23,"23066",4347,3465,3410,15,55,"PACMA",27
13,"13026",438,345,343,2,2,"PACMA",0
19,"19150",128,99,99,1,0,"PACMA",0
46,"46199",5718,4314,4266,28,48,"PACMA",50
9,"9057",145,108,108,0,0,"PACMA",0
26,"26026",1321,1039,1025,6,14,"PACMA",7
33,"33059",4646,3075,3033,29,42,"PACMA",14
26,"26129",967,775,766,6,9,"PACMA",1
10,"10100",799,578,574,4,4,"PACMA",4
50,"50047",48,36,36,0,0,"PACMA",0
34,"34109",59,48,48,0,0,"PACMA",0
50,"50144",34,29,29,2,0,"PACMA",0
20,"20033",868,600,599,1,1,"PACMA",4
19,"19027",138,105,105,1,0,"PACMA",0
2,"2009",19660,14256,14116,127,140,"PACMA",111
26,"26130",203,167,167,1,0,"PACMA",0
11,"11010",6410,4189,4130,88,59,"PACMA",22
45,"45161",13688,9007,8902,32,105,"PACMA",201
47,"47154",152,128,125,1,3,"PACMA",0
31,"31107",1710,1255,1243,16,12,"PACMA",6
35,"35005",1048,747,737,8,10,"PACMA",5
45,"45062",1112,878,867,4,11,"PACMA",3
9,"9190",86,58,56,0,2,"PACMA",2
9,"9058",390,283,279,1,4,"PACMA",5
49,"49221",245,129,127,1,2,"PACMA",0
22,"22087",67,45,45,2,0,"PACMA",0
42,"42046",49,39,39,0,0,"PACMA",1
18,"18108",850,659,656,3,3,"PACMA",8
24,"24170",1908,1365,1345,8,20,"PACMA",15
3,"3034",1376,1067,1052,5,15,"PACMA",7
31,"31108",1855,1368,1348,7,20,"PACMA",10
25,"25046",422,279,275,2,4,"PACMA",4
16,"16270",162,137,137,0,0,"PACMA",0
42,"42184",57,43,43,0,0,"PACMA",1
25,"25175",186,117,117,1,0,"PACMA",0
26,"26028",134,113,112,0,1,"PACMA",0
44,"44126",329,234,229,4,5,"PACMA",1
50,"50147",777,552,552,2,0,"PACMA",2
11,"11013",2312,1547,1518,15,29,"PACMA",11
21,"21057",1041,661,657,12,4,"PACMA",2
21,"21058",2609,1883,1856,23,27,"PACMA",6
22,"22089",302,225,223,0,2,"PACMA",1
5,"5112",97,71,70,2,1,"PACMA",0
25,"25092",130,98,95,2,3,"PACMA",5
40,"40060",82,61,61,0,0,"PACMA",0
5,"5259",124,105,105,1,0,"PACMA",0
47,"47156",162,136,133,0,3,"PACMA",0
25,"25048",1651,1051,1040,11,11,"PACMA",3
50,"50148",316,233,229,4,4,"PACMA",0
38,"38012",2347,1644,1630,7,14,"PACMA",20
25,"25049",151,110,108,1,2,"PACMA",2
40,"40189",512,401,392,2,9,"PACMA",3
37,"37011",121,91,91,3,0,"PACMA",0
44,"44022",493,323,318,7,5,"PACMA",2
35,"35008",6131,4507,4459,34,48,"PACMA",39
23,"23073",4507,3229,3200,13,29,"PACMA",23
44,"44128",68,54,54,1,0,"PACMA",0
13,"13035",984,747,730,7,17,"PACMA",4
26,"26135",164,125,124,1,1,"PACMA",0
5,"5260",105,90,90,0,0,"PACMA",1
23,"23074",3021,2317,2295,11,22,"PACMA",9
44,"44230",155,123,123,2,0,"PACMA",1
42,"42189",60,46,45,0,1,"PACMA",0
9,"9329",121,87,87,1,0,"PACMA",1
5,"5115",523,378,373,0,5,"PACMA",0
47,"47158",889,667,659,8,8,"PACMA",1
37,"37272",141,107,104,0,3,"PACMA",0
19,"19264",33,26,26,0,0,"PACMA",0
4,"4083",1776,1345,1336,6,9,"PACMA",13
19,"19157",55,46,46,0,0,"PACMA",0
46,"46263",251,214,212,0,2,"PACMA",1
28,"28166",320,254,251,2,3,"PACMA",3
46,"46152",96,68,68,0,0,"PACMA",1
12,"12074",785,652,648,5,4,"PACMA",1
26,"26033",170,132,129,1,3,"PACMA",2
40,"40063",7096,5184,5100,36,84,"PACMA",25
9,"9064",324,271,267,1,4,"PACMA",4
46,"46022",15365,11093,10997,59,96,"PACMA",175
16,"16275",11,11,11,1,0,"PACMA",0
3,"3133",41576,25849,25639,127,210,"PACMA",369
10,"10018",1689,1101,1081,6,20,"PACMA",7
22,"22907",1435,1059,1046,18,13,"PACMA",2
10,"10156",97,73,72,1,1,"PACMA",1
39,"39089",143,104,100,1,4,"PACMA",0
13,"13090",1094,843,828,4,15,"PACMA",3
45,"45167",1440,1144,1133,6,11,"PACMA",7
10,"10110",2300,1623,1574,11,49,"PACMA",14
44,"44025",6009,4087,3997,25,90,"PACMA",34
28,"28168",1237,884,880,4,4,"PACMA",6
14,"14050",2391,1822,1787,14,35,"PACMA",17
37,"37015",224,144,144,1,0,"PACMA",1
5,"5264",61,38,37,2,1,"PACMA",0
38,"38016",1223,638,623,3,15,"PACMA",5
3,"3134",143,112,111,0,1,"PACMA",2
37,"37150",41,34,34,0,0,"PACMA",0
48,"48009",783,586,575,1,11,"PACMA",4
37,"37016",569,406,401,2,5,"PACMA",5
50,"50152",1430,1008,994,14,14,"PACMA",1
31,"31114",366,245,241,8,4,"PACMA",1
3,"3040",254,216,213,2,3,"PACMA",0
9,"9066",62,48,47,0,1,"PACMA",0
42,"42193",14,10,10,0,0,"PACMA",0
19,"19232",71,57,57,1,0,"PACMA",0
16,"16119",169,127,127,0,0,"PACMA",0
40,"40194",39602,29382,29042,206,340,"PACMA",258
42,"42055",164,121,121,0,0,"PACMA",1
13,"13042",920,652,648,2,4,"PACMA",4
5,"5266",100,86,86,0,0,"PACMA",0
40,"40195",885,672,669,1,3,"PACMA",1
25,"25185",692,400,397,6,3,"PACMA",3
11,"11020",165378,109810,108830,1188,980,"PACMA",1569
47,"47161",3918,3145,3126,12,19,"PACMA",16
34,"34125",86,65,64,0,1,"PACMA",0
46,"46904",792,610,603,8,7,"PACMA",6
49,"49230",97,72,72,0,0,"PACMA",0
46,"46129",524,420,412,4,8,"PACMA",4
44,"44133",21,15,15,0,0,"PACMA",0
49,"49066",492,336,332,4,4,"PACMA",2
3,"3042",1393,1010,996,7,14,"PACMA",6
37,"37019",150,123,120,0,3,"PACMA",0
13,"13043",231,180,179,1,1,"PACMA",2
25,"25056",235,143,143,2,0,"PACMA",2
9,"9471",149,114,114,1,0,"PACMA",0
45,"45105",392,301,297,3,4,"PACMA",0
38,"38019",13200,8123,8047,36,76,"PACMA",70
26,"26142",787,612,606,3,6,"PACMA",7
31,"31117",620,383,375,3,8,"PACMA",1
16,"16122",249,188,187,0,1,"PACMA",0
5,"5902",284,236,232,0,4,"PACMA",4
33,"33070",3351,2403,2373,26,30,"PACMA",17
45,"45171",1361,1035,1023,0,12,"PACMA",12
46,"46130",901,687,683,3,4,"PACMA",6
14,"14054",13697,10315,10109,93,206,"PACMA",66
22,"22103",682,508,502,3,6,"PACMA",5
48,"48012",2049,1527,1512,7,15,"PACMA",4
9,"9201",28,18,18,1,0,"PACMA",0
37,"37156",4292,2996,2966,24,30,"PACMA",22
26,"26038",89,68,67,0,1,"PACMA",0
49,"49110",348,231,229,0,2,"PACMA",0
40,"40198",24,19,19,0,0,"PACMA",0
20,"20045",46626,30525,30353,197,172,"PACMA",351
47,"47163",290,230,228,3,2,"PACMA",0
50,"50249",302,226,220,0,6,"PACMA",0
5,"5903",151,104,104,2,0,"PACMA",0
26,"26144",188,155,155,3,0,"PACMA",1
3,"3138",3145,2310,2275,9,35,"PACMA",15
16,"16124",1858,1476,1459,12,17,"PACMA",4
25,"25190",262,185,183,0,2,"PACMA",3
24,"24081",140,98,92,0,6,"PACMA",0
5,"5904",127,88,87,1,1,"PACMA",1
3,"3139",22437,15315,15170,100,145,"PACMA",174
16,"16125",1667,1249,1231,3,18,"PACMA",8
19,"19272",72,54,53,1,1,"PACMA",0
37,"37366",43,32,32,0,0,"PACMA",0
50,"50061",202,172,172,3,0,"PACMA",1
9,"9476",62,43,43,0,0,"PACMA",0
9,"9206",59,45,45,0,0,"PACMA",0
5,"5905",217,165,164,0,1,"PACMA",1
28,"28173",517,390,388,1,2,"PACMA",4
49,"49235",443,301,292,0,9,"PACMA",3
42,"42198",23,16,16,4,0,"PACMA",0
3,"3140",26070,18999,18742,174,257,"PACMA",211
37,"37283",123,92,90,0,2,"PACMA",1
49,"49113",167,137,135,1,2,"PACMA",0
9,"9073",926,691,686,4,5,"PACMA",6
13,"13050",493,378,375,3,3,"PACMA",3
9,"9208",210,136,134,3,2,"PACMA",0
37,"37159",90,70,70,1,0,"PACMA",0
44,"44138",135,98,94,0,4,"PACMA",0
28,"28019",1233,893,885,4,8,"PACMA",11
49,"49236",75,58,58,0,0,"PACMA",1
40,"40202",60,46,46,0,0,"PACMA",1
40,"40075",160,139,139,0,0,"PACMA",0
37,"37285",403,310,308,2,2,"PACMA",1
23,"23087",11292,8222,8084,59,138,"PACMA",97
3,"3901",1135,822,817,8,5,"PACMA",6
49,"49237",165,119,117,2,2,"PACMA",0
6,"6140",630,506,499,3,7,"PACMA",1
34,"34133",107,91,90,0,1,"PACMA",0
44,"44240",158,130,129,0,1,"PACMA",0
39,"39067",790,513,505,1,8,"PACMA",6
9,"9346",92,64,63,1,1,"PACMA",0
44,"44241",533,396,389,0,7,"PACMA",4
25,"25063",87,58,58,1,0,"PACMA",2
31,"31023",6956,5310,5289,85,21,"PACMA",59
48,"48017",13261,8543,8482,42,61,"PACMA",47
5,"5130",90,85,85,0,0,"PACMA",0
19,"19047",64,55,55,0,0,"PACMA",0
50,"50002",143,108,104,1,4,"PACMA",0
39,"39007",417,278,275,2,3,"PACMA",1
12,"12083",93,79,76,0,3,"PACMA",0
37,"37162",204,152,151,0,1,"PACMA",2
6,"6005",1696,1197,1178,1,19,"PACMA",10
10,"10124",852,665,655,2,10,"PACMA",2
9,"9347",143,117,115,2,2,"PACMA",1
24,"24086",270,223,218,0,5,"PACMA",0
42,"42064",86,68,68,0,0,"PACMA",0
45,"45078",1379,1129,1119,6,10,"PACMA",10
19,"19170",193,135,135,0,0,"PACMA",1
5,"5229",82,68,67,0,1,"PACMA",1
35,"35018",12552,7609,7547,54,62,"PACMA",105
26,"26149",57,47,46,0,1,"PACMA",1
10,"10125",888,635,622,4,13,"PACMA",3
28,"28050",4076,2860,2839,21,21,"PACMA",42
46,"46161",1483,1188,1173,7,15,"PACMA",16
25,"25153",192,130,128,2,2,"PACMA",1
31,"31025",766,524,518,6,6,"PACMA",4
6,"6007",1475,1038,1032,1,6,"PACMA",4
31,"31225",36,27,27,0,0,"PACMA",0
48,"48019",3553,2406,2397,18,9,"PACMA",13
50,"50255",209,163,163,5,0,"PACMA",0
40,"40079",234,179,179,3,0,"PACMA",1
47,"47086",3906,2970,2936,24,34,"PACMA",14
3,"3050",18652,13325,13234,57,91,"PACMA",155
9,"9485",55,43,42,0,1,"PACMA",1
6,"6144",556,431,425,0,6,"PACMA",3
46,"46214",15766,12131,12036,42,95,"PACMA",194
39,"39010",631,480,475,7,5,"PACMA",7
47,"47087",381,301,297,3,4,"PACMA",0
24,"24088",1029,791,789,10,2,"PACMA",1
39,"39070",144,96,94,2,2,"PACMA",6
44,"44145",1020,719,709,9,10,"PACMA",1
31,"31226",591,342,340,2,2,"PACMA",1
9,"9215",368,256,256,2,0,"PACMA",2
38,"38030",1933,1296,1290,2,6,"PACMA",14
6,"6009",204,153,153,0,0,"PACMA",0
22,"22243",45,28,28,0,0,"PACMA",0
47,"47223",157,122,118,2,4,"PACMA",1
1,"1019",150,106,105,1,1,"PACMA",2
49,"49242",447,360,357,5,3,"PACMA",0
16,"16135",134,92,92,2,0,"PACMA",0
21,"21079",722,494,490,5,4,"PACMA",2
28,"28025",420,320,315,4,5,"PACMA",1
2,"2034",1382,1110,1093,7,17,"PACMA",7
50,"50165",1814,1287,1264,26,23,"PACMA",4
4,"4002",1039,748,740,2,8,"PACMA",3
13,"13060",263,200,194,0,6,"PACMA",0
46,"46060",9369,7052,6993,42,59,"PACMA",104
9,"9903",3221,2304,2281,27,23,"PACMA",13
44,"44039",221,165,159,0,6,"PACMA",0
9,"9217",351,251,249,6,2,"PACMA",1
13,"13061",5702,3867,3822,28,45,"PACMA",29
39,"39072",344,198,196,2,2,"PACMA",1
4,"4003",17357,11157,11075,64,82,"PACMA",85
35,"35021",14924,10477,10370,45,107,"PACMA",120
10,"10131",12861,8813,8721,52,92,"PACMA",91
47,"47171",407,303,301,6,2,"PACMA",0
25,"25203",8931,5003,4955,72,48,"PACMA",62
41,"41010",4420,2960,2916,30,44,"PACMA",57
33,"33050",592,387,376,2,11,"PACMA",2
19,"19098",19,17,17,0,0,"PACMA",0
24,"24091",645,454,451,1,3,"PACMA",0
3,"3053",7226,5651,5584,32,67,"PACMA",49
4,"4098",1516,1115,1106,11,9,"PACMA",3
24,"24190",165,123,121,1,2,"PACMA",0
28,"28181",20386,16155,16069,57,86,"PACMA",142
38,"38033",3702,2505,2464,8,41,"PACMA",23
6,"6013",265,212,209,3,3,"PACMA",0
25,"25205",566,382,372,8,10,"PACMA",7
6,"6059",1851,1268,1258,7,10,"PACMA",9
50,"50259",88,67,66,0,1,"PACMA",0
40,"40084",62,55,52,0,3,"PACMA",0
45,"45084",2257,1679,1656,13,23,"PACMA",10
18,"18140",43496,28038,27872,212,166,"PACMA",307
6,"6150",802,602,596,4,6,"PACMA",1
47,"47011",565,461,458,5,3,"PACMA",0
4,"4004",425,329,329,0,0,"PACMA",1
26,"26155",160,132,132,0,0,"PACMA",1
12,"12091",177,113,112,0,1,"PACMA",1
22,"22247",33,20,20,0,0,"PACMA",0
24,"24092",798,606,602,1,4,"PACMA",2
50,"50168",28,27,27,0,0,"PACMA",1
13,"13065",2854,1901,1888,9,13,"PACMA",6
16,"16142",136,101,101,1,0,"PACMA",0
22,"22117",2478,1714,1693,22,21,"PACMA",13
49,"49247",443,283,279,2,4,"PACMA",0
47,"47173",880,644,638,20,6,"PACMA",3
37,"37297",425,328,322,2,6,"PACMA",2
31,"31231",117,76,73,1,3,"PACMA",0
2,"2039",984,790,786,10,4,"PACMA",4
16,"16192",48,31,30,1,1,"PACMA",0
9,"9085",475,347,342,2,5,"PACMA",3
9,"9221",461,343,338,3,5,"PACMA",0
4,"4101",4266,2909,2876,26,33,"PACMA",18
24,"24193",378,268,265,2,3,"PACMA",2
48,"48025",883,642,637,7,5,"PACMA",4
25,"25075",117,72,72,2,0,"PACMA",0
26,"26158",251,214,210,0,4,"PACMA",0
44,"44150",28,22,21,0,1,"PACMA",0
18,"18144",781,567,558,4,9,"PACMA",3
50,"50261",213,157,157,0,0,"PACMA",0
37,"37299",219,166,163,4,3,"PACMA",1
49,"49126",235,155,154,2,1,"PACMA",0
13,"13068",1061,747,740,4,7,"PACMA",3
9,"9223",45,37,37,0,0,"PACMA",0
5,"5145",50,40,40,0,0,"PACMA",0
19,"19288",21,21,20,0,1,"PACMA",0
6,"6154",2802,1923,1894,23,29,"PACMA",10
9,"9360",30,23,23,0,0,"PACMA",0
2,"2082",101,80,80,1,0,"PACMA",0
5,"5193",193,167,164,1,3,"PACMA",0
49,"49249",69,58,58,1,0,"PACMA",0
18,"18010",566,427,421,1,6,"PACMA",8
38,"38037",12864,8287,8163,64,124,"PACMA",140
46,"46143",4239,3104,3053,14,51,"PACMA",34
4,"4008",505,423,417,5,6,"PACMA",2
10,"10001",282,225,223,3,2,"PACMA",1
24,"24196",2057,1502,1485,9,17,"PACMA",3
11,"11037",5661,4347,4265,33,82,"PACMA",22
31,"31034",37,25,25,0,0,"PACMA",0
5,"5148",25,15,15,0,0,"PACMA",0
49,"49009",393,293,288,2,5,"PACMA",1
49,"49128",552,423,414,3,9,"PACMA",2
34,"34012",357,269,264,5,5,"PACMA",1
37,"37040",391,299,297,2,2,"PACMA",0
18,"18146",965,703,685,9,18,"PACMA",3
4,"4901",545,395,394,0,1,"PACMA",1
5,"5195",220,169,169,2,0,"PACMA",1
37,"37041",78,52,52,0,0,"PACMA",0
34,"34015",41,35,35,3,0,"PACMA",0
37,"37302",290,196,195,2,1,"PACMA",1
31,"31035",59,45,43,0,2,"PACMA",1
19,"19061",57,42,42,0,0,"PACMA",0
16,"16009",62,51,50,0,1,"PACMA",0
19,"19291",1191,879,869,3,10,"PACMA",5
50,"50265",79,61,61,0,0,"PACMA",0
11,"11039",10018,6186,6109,103,77,"PACMA",65
49,"49130",180,143,141,5,2,"PACMA",0
5,"5151",91,71,71,1,0,"PACMA",0
12,"12096",777,587,577,6,10,"PACMA",4
20,"20062",973,653,653,11,0,"PACMA",6
47,"47015",200,162,160,0,2,"PACMA",1
42,"42219",43,31,30,0,1,"PACMA",0
44,"44047",220,137,132,2,5,"PACMA",3
31,"31036",909,636,628,7,8,"PACMA",3
46,"46223",7801,5950,5899,34,51,"PACMA",74
25,"25081",308,189,189,2,0,"PACMA",2
34,"34017",918,744,736,9,8,"PACMA",1
37,"37044",466,362,360,2,2,"PACMA",2
50,"50076",78,66,65,0,1,"PACMA",1
9,"9411",151,102,101,0,1,"PACMA",2
47,"47205",384,266,260,0,6,"PACMA",0
6,"6160",3153,2176,2146,16,30,"PACMA",4
46,"46093",2118,1647,1624,4,23,"PACMA",14
44,"44260",137,91,89,3,2,"PACMA",0
31,"31137",205,112,109,6,3,"PACMA",0
44,"44048",61,52,52,0,0,"PACMA",0
12,"12098",580,451,447,5,4,"PACMA",0
39,"39081",437,337,332,4,5,"PACMA",2
46,"46146",1654,1304,1278,7,26,"PACMA",23
19,"19065",127,104,104,3,0,"PACMA",1
24,"24201",1090,762,759,10,3,"PACMA",5
13,"13077",3489,2205,2152,18,53,"PACMA",12
10,"10006",1263,978,970,2,8,"PACMA",0
31,"31038",1339,957,942,11,15,"PACMA",3
28,"28034",361,274,269,1,5,"PACMA",1
11,"11042",1186,868,858,7,10,"PACMA",8
3,"3062",212,169,165,0,4,"PACMA",1
42,"42086",36,27,26,2,1,"PACMA",0
50,"50078",235,177,173,0,4,"PACMA",0
10,"10145",127,97,95,0,2,"PACMA",0
24,"24099",171,132,132,0,0,"PACMA",0
45,"45093",155,129,127,1,2,"PACMA",1
41,"41087",10237,6923,6774,48,149,"PACMA",100
46,"46225",337,290,281,5,9,"PACMA",5
37,"37181",286,210,207,4,3,"PACMA",0
29,"29093",2214,1643,1621,3,22,"PACMA",15
44,"44262",135,108,107,2,1,"PACMA",0
16,"16153",949,778,772,7,6,"PACMA",2
18,"18017",18114,11610,11510,77,100,"PACMA",138
9,"9230",38,32,32,0,0,"PACMA",0
16,"16014",602,485,483,0,2,"PACMA",0
47,"47098",576,464,452,4,12,"PACMA",5
25,"25218",81,64,63,1,1,"PACMA",1
22,"22014",243,192,188,3,4,"PACMA",1
34,"34160",139,115,114,3,1,"PACMA",0
49,"49259",89,66,65,1,1,"PACMA",0
28,"28036",2539,1899,1878,11,21,"PACMA",40
21,"21014",4016,3025,2991,21,34,"PACMA",17
49,"49055",102,82,82,2,0,"PACMA",1
5,"5005",182,148,147,3,1,"PACMA",0
18,"18018",634,472,468,5,4,"PACMA",2
40,"40225",1138,883,867,3,16,"PACMA",6
18,"18153",8597,6024,5972,40,52,"PACMA",101
24,"24101",397,258,257,3,1,"PACMA",1
16,"16015",374,263,262,4,1,"PACMA",1
44,"44051",2683,1977,1946,17,31,"PACMA",17
13,"13082",25805,16871,16706,120,165,"PACMA",183
6,"6029",1195,855,841,3,14,"PACMA",3
37,"37184",327,255,252,2,3,"PACMA",0
29,"29006",673,428,420,1,8,"PACMA",1
9,"9232",154,119,116,0,3,"PACMA",0
7,"7001",3573,2531,2497,21,34,"PACMA",18
41,"41089",6493,4398,4331,43,67,"PACMA",56
10,"10149",421,283,280,1,3,"PACMA",1
50,"50178",293,190,187,0,3,"PACMA",1
31,"31042",2714,1974,1942,22,32,"PACMA",10
16,"16156",97,78,77,0,1,"PACMA",2
20,"20069",147046,100691,100232,836,459,"PACMA",913
44,"44160",466,304,301,2,3,"PACMA",0
44,"44265",186,141,138,2,3,"PACMA",0
26,"26170",446,330,326,2,4,"PACMA",1
50,"50082",82,65,64,0,1,"PACMA",0
34,"34163",45,38,38,0,0,"PACMA",0
19,"19073",23,19,19,0,0,"PACMA",0
12,"12036",581,426,421,10,5,"PACMA",1
9,"9235",156,132,131,3,1,"PACMA",0
29,"29007",27491,19071,18910,153,161,"PACMA",366
10,"10151",207,165,162,0,3,"PACMA",0
41,"41025",2020,1361,1320,7,41,"PACMA",9
27,"27034",1120,681,672,4,9,"PACMA",4
42,"42092",56,44,42,1,2,"PACMA",1
31,"31044",289,230,227,1,3,"PACMA",0
18,"18022",13432,8491,8407,67,84,"PACMA",117
29,"29008",14596,9519,9407,94,112,"PACMA",111
22,"22017",866,650,642,5,8,"PACMA",3
18,"18158",8358,5096,5031,28,65,"PACMA",40
3,"3067",99,85,85,0,0,"PACMA",1
44,"44266",115,90,90,0,0,"PACMA",0
18,"18023",15655,10879,10774,82,105,"PACMA",105
31,"31244",158,87,86,1,1,"PACMA",0
50,"50272",12904,8880,8819,84,61,"PACMA",117
34,"34028",143,116,113,1,3,"PACMA",2
29,"29098",1253,917,895,9,22,"PACMA",5
7,"7005",6710,4127,4090,25,37,"PACMA",64
10,"10153",309,222,218,0,4,"PACMA",2
35,"35034",7873,3975,3943,27,32,"PACMA",68
28,"28107",457,312,312,0,0,"PACMA",0
49,"49020",289,214,214,2,0,"PACMA",1
19,"19075",64,39,39,0,0,"PACMA",0
4,"4018",270,232,229,0,3,"PACMA",0
25,"25224",126,70,70,5,0,"PACMA",0
12,"12004",4170,3125,3088,19,37,"PACMA",23
50,"50181",993,733,720,5,13,"PACMA",6
37,"37316",744,563,558,3,5,"PACMA",2
47,"47023",2995,2344,2326,18,18,"PACMA",14
12,"12105",848,644,638,2,6,"PACMA",2
33,"33004",66857,46390,45960,426,430,"PACMA",619
50,"50274",71,55,55,0,0,"PACMA",0
37,"37057",215,172,171,1,1,"PACMA",0
29,"29100",2433,1684,1667,5,17,"PACMA",10
37,"37190",215,171,171,1,0,"PACMA",0
6,"6036",5075,3575,3535,35,40,"PACMA",10
18,"18069",502,362,357,0,5,"PACMA",0
42,"42014",64,43,43,1,0,"PACMA",0
47,"47050",3719,2630,2598,26,32,"PACMA",24
40,"40150",69,61,61,1,0,"PACMA",0
50,"50151",636,499,499,0,0,"PACMA",0
40,"40901",384,309,307,4,2,"PACMA",1
19,"19194",98,69,69,1,0,"PACMA",0
50,"50275",108,55,55,0,0,"PACMA",0
27,"27040",3200,2351,2310,21,41,"PACMA",11
50,"50086",187,132,128,2,4,"PACMA",1
13,"13091",538,450,446,0,4,"PACMA",0
45,"45202",3894,2776,2744,14,32,"PACMA",11
10,"10019",1498,1063,1054,3,9,"PACMA",16
19,"19195",40,32,32,1,0,"PACMA",0
10,"10158",330,269,267,0,2,"PACMA",0
45,"45002",2564,1681,1665,17,16,"PACMA",12
5,"5018",29,22,22,0,0,"PACMA",1
44,"44167",38,31,31,0,0,"PACMA",0
39,"39091",1926,1493,1476,10,17,"PACMA",3
10,"10020",1604,1185,1169,9,16,"PACMA",4
22,"22141",117,91,90,1,1,"PACMA",0
6,"6084",1093,828,818,8,10,"PACMA",4
49,"49267",88,73,69,2,4,"PACMA",0
48,"48040",1281,877,869,3,8,"PACMA",4
49,"49268",403,313,309,1,4,"PACMA",0
24,"24011",203,133,132,0,1,"PACMA",0
18,"18165",4123,2787,2758,18,29,"PACMA",55
31,"31148",92,69,69,5,0,"PACMA",0
50,"50277",50,42,41,0,1,"PACMA",2
40,"40903",86,67,67,0,0,"PACMA",0
29,"29903",524,353,349,3,4,"PACMA",4
7,"7010",4880,3395,3361,32,34,"PACMA",58
37,"37194",251,196,195,1,1,"PACMA",0
47,"47026",46,40,40,1,0,"PACMA",0
12,"12008",222,193,192,1,1,"PACMA",0
45,"45104",428,324,323,1,1,"PACMA",3
21,"21066",498,392,389,3,3,"PACMA",1
26,"26177",304,255,254,7,1,"PACMA",0
49,"49147",263,190,186,0,4,"PACMA",0
44,"44061",70,54,51,0,3,"PACMA",2
6,"6041",460,372,367,0,5,"PACMA",0
9,"9244",46,34,34,1,0,"PACMA",0
19,"19269",102,81,80,0,1,"PACMA",0
45,"45205",6824,4424,4362,22,62,"PACMA",62
37,"37062",83,65,64,1,1,"PACMA",1
37,"37063",69,59,58,0,1,"PACMA",0
42,"42103",575,450,445,1,5,"PACMA",1
39,"39093",299,229,226,4,3,"PACMA",0
45,"45005",238,193,192,3,1,"PACMA",1
12,"12110",234,176,173,0,3,"PACMA",1
1,"1009",1265,849,845,2,4,"PACMA",6
39,"39002",3298,2342,2309,13,33,"PACMA",14
46,"46156",2080,1697,1675,10,22,"PACMA",14
39,"39094",848,655,651,3,4,"PACMA",5
29,"29015",31880,22220,21952,190,268,"PACMA",215
26,"26107",94,77,77,2,0,"PACMA",0
49,"49149",390,273,268,3,5,"PACMA",1
18,"18033",282,201,200,5,1,"PACMA",0
25,"25103",135,76,76,4,0,"PACMA",0
5,"5025",94,79,78,0,1,"PACMA",0
31,"31252",87,61,61,0,0,"PACMA",1
18,"18171",2120,1572,1551,9,21,"PACMA",7
6,"6044",28875,19791,19616,145,175,"PACMA",134
26,"26072",281,254,254,0,0,"PACMA",0
28,"28046",4460,3447,3422,16,25,"PACMA",33
40,"40115",101,86,85,1,1,"PACMA",0
4,"4026",66,54,51,0,3,"PACMA",0
42,"42106",14,10,10,0,0,"PACMA",0
45,"45040",1349,846,838,4,8,"PACMA",4
24,"24113",366,293,287,5,6,"PACMA",1
9,"9115",92,68,67,0,1,"PACMA",0
44,"44137",193,149,148,0,1,"PACMA",0
10,"10027",77,69,69,1,0,"PACMA",1
12,"12112",99,79,78,3,1,"PACMA",1
24,"24016",466,270,269,1,1,"PACMA",0
37,"37068",365,267,267,1,0,"PACMA",0
9,"9388",34,27,26,0,1,"PACMA",0
20,"20080",7910,5294,5260,49,34,"PACMA",43
33,"33012",5201,3466,3432,25,34,"PACMA",22
25,"25234",4279,2546,2508,23,38,"PACMA",24
45,"45108",509,412,411,1,1,"PACMA",0
34,"34039",61,49,47,0,2,"PACMA",0
9,"9297",323,251,250,6,1,"PACMA",3
26,"26181",14,14,14,0,0,"PACMA",0
2,"2067",1158,858,847,6,11,"PACMA",3
40,"40201",49,42,42,0,0,"PACMA",3
37,"37368",17,17,17,0,0,"PACMA",0
10,"10167",314,239,239,1,0,"PACMA",0
49,"49152",525,339,334,2,5,"PACMA",1
37,"37200",187,136,136,0,0,"PACMA",0
23,"23007",3087,2205,2187,6,18,"PACMA",19
16,"16034",180,146,144,2,2,"PACMA",0
18,"18036",3851,2870,2841,17,29,"PACMA",42
47,"47030",993,766,751,6,15,"PACMA",2
44,"44066",108,79,74,0,5,"PACMA",1
16,"16174",185,145,143,0,2,"PACMA",2
5,"5030",45,38,38,1,0,"PACMA",4
50,"50001",100,77,77,0,0,"PACMA",0
24,"24116",417,314,309,1,5,"PACMA",0
18,"18037",535,402,396,2,6,"PACMA",5
6,"6049",1015,725,707,3,18,"PACMA",2
9,"9390",611,484,482,3,2,"PACMA",2
46,"46082",4918,3745,3712,33,33,"PACMA",34
19,"19127",89,64,64,0,0,"PACMA",1
29,"29020",3267,2408,2359,16,49,"PACMA",18
34,"34042",296,237,234,1,3,"PACMA",7
46,"46186",19068,14599,14474,69,125,"PACMA",209
16,"16238",501,428,422,3,6,"PACMA",1
44,"44175",122,85,84,1,1,"PACMA",0
49,"49154",127,78,77,0,1,"PACMA",0
24,"24019",354,272,267,3,5,"PACMA",2
19,"19091",26,20,20,0,0,"PACMA",0
31,"31256",107,59,59,0,0,"PACMA",0
42,"42113",534,409,399,1,10,"PACMA",1
6,"6051",1571,1192,1178,7,14,"PACMA",1
3,"3903",2494,1880,1865,7,15,"PACMA",20
34,"34046",41,36,35,0,1,"PACMA",0
46,"46135",9680,7682,7634,36,48,"PACMA",88
24,"24222",14256,9996,9884,101,112,"PACMA",126
4,"4030",1119,819,812,5,7,"PACMA",11
37,"37204",276,198,195,1,3,"PACMA",1
49,"49194",368,218,216,1,2,"PACMA",0
9,"9303",86,68,68,0,0,"PACMA",0
50,"50065",53,43,43,0,0,"PACMA",1
22,"22069",429,333,331,2,2,"PACMA",1
50,"50004",522,390,388,0,2,"PACMA",1
33,"33016",19130,13666,13526,125,140,"PACMA",158
37,"37332",68,51,50,0,1,"PACMA",0
31,"31058",208,148,144,3,4,"PACMA",0
5,"5182",786,538,532,2,6,"PACMA",1
19,"19209",40,29,29,1,0,"PACMA",0
9,"9124",1506,1040,1028,6,12,"PACMA",5
22,"22036",92,77,77,0,0,"PACMA",0
46,"46162",1189,938,929,3,9,"PACMA",4
41,"41095",41232,27076,26793,315,283,"PACMA",338
19,"19008",37,28,27,1,1,"PACMA",0
34,"34048",73,59,59,1,0,"PACMA",0
29,"29023",2081,1354,1340,4,14,"PACMA",23
40,"40125",87,58,58,1,0,"PACMA",0
31,"31059",186,131,131,1,0,"PACMA",0
26,"26079",634,520,512,4,8,"PACMA",2
10,"10173",577,400,399,5,1,"PACMA",1
39,"39101",274,197,192,3,5,"PACMA",4
27,"27007",2805,2133,2078,38,55,"PACMA",11
19,"19096",91,72,69,0,3,"PACMA",0
31,"31126",358,223,223,2,0,"PACMA",0
45,"45048",358,278,275,1,3,"PACMA",0
46,"46007",11989,8784,8711,67,73,"PACMA",129
47,"47196",34,27,27,0,0,"PACMA",0
1,"1020",327,237,234,3,3,"PACMA",0
41,"41008",1059,749,739,10,10,"PACMA",5
12,"12118",72,55,53,0,2,"PACMA",0
10,"10037",76232,55104,54464,418,640,"PACMA",604
45,"45014",4010,2646,2616,22,30,"PACMA",22
19,"19097",16,10,10,0,0,"PACMA",0
24,"24121",645,492,487,1,5,"PACMA",0
22,"22039",863,671,667,4,4,"PACMA",4
47,"47116",416,341,339,0,2,"PACMA",0
44,"44179",337,229,226,1,3,"PACMA",1
47,"47035",921,717,715,3,2,"PACMA",0
20,"20906",119,87,87,1,0,"PACMA",1
27,"27009",2097,1533,1507,12,26,"PACMA",1
10,"10176",371,262,261,0,1,"PACMA",0
10,"10039",417,291,291,0,0,"PACMA",1
4,"4034",160,99,99,2,0,"PACMA",1
22,"22040",144,117,115,1,2,"PACMA",1
31,"31062",1087,830,818,3,12,"PACMA",5
10,"10086",320,238,233,1,5,"PACMA",1
9,"9218",369,275,275,1,0,"PACMA",4
5,"5236",123,91,90,1,1,"PACMA",0
46,"46165",7129,5436,5388,25,48,"PACMA",98
42,"42119",158,100,99,3,1,"PACMA",1
44,"44075",323,248,246,0,2,"PACMA",1
28,"28054",11257,8349,8273,55,76,"PACMA",87
10,"10132",396,278,275,0,3,"PACMA",0
27,"27064",1581,1097,1068,12,29,"PACMA",11
34,"34051",101,88,83,0,5,"PACMA",1
49,"49162",186,142,140,1,2,"PACMA",0
44,"44216",26555,18997,18737,168,260,"PACMA",99
5,"5042",153,122,121,0,1,"PACMA",0
31,"31063",92,75,73,2,2,"PACMA",0
47,"47037",168,138,133,0,5,"PACMA",0
37,"37338",79,65,64,0,1,"PACMA",0
19,"19099",298,200,199,6,1,"PACMA",0
37,"37082",796,551,544,4,7,"PACMA",1
19,"19325",121,83,82,0,1,"PACMA",0
16,"16190",5105,3945,3887,17,58,"PACMA",20
31,"31163",2013,1418,1383,13,35,"PACMA",19
48,"48054",24171,16797,16711,118,86,"PACMA",178
26,"26083",284,205,205,2,0,"PACMA",0
27,"27013",3766,2900,2851,25,49,"PACMA",24
33,"33021",4573,3024,2971,22,53,"PACMA",32
14,"14009",2788,1852,1834,20,18,"PACMA",7
9,"9262",163,130,127,1,3,"PACMA",0
9,"9405",130,98,96,0,2,"PACMA",0
50,"50009",105,80,80,0,0,"PACMA",0
5,"5190",53,42,41,2,1,"PACMA",0
40,"40004",459,356,352,2,4,"PACMA",0
22,"22043",93,66,65,0,1,"PACMA",0
44,"44217",29,25,25,3,0,"PACMA",0
33,"33022",893,578,567,11,11,"PACMA",2
7,"7029",4166,2949,2913,37,36,"PACMA",36
12,"12024",143,125,124,0,1,"PACMA",0
21,"21004",1631,1045,1028,13,17,"PACMA",15
5,"5191",121,106,105,1,1,"PACMA",0
2,"2081",18342,13244,13075,80,169,"PACMA",102
24,"24229",418,322,319,2,3,"PACMA",2
16,"16048",408,313,312,1,1,"PACMA",2
1,"1028",1070,716,710,3,6,"PACMA",7
16,"16193",66,49,48,0,1,"PACMA",1
34,"34202",29,18,18,1,0,"PACMA",0
6,"6062",594,441,437,5,4,"PACMA",3
31,"31066",855,589,579,8,10,"PACMA",3
18,"18188",1653,1183,1175,5,8,"PACMA",6
50,"50011",122,95,94,1,1,"PACMA",1
46,"46168",1938,1495,1486,2,9,"PACMA",19
44,"44082",89,78,77,0,1,"PACMA",1
16,"16194",242,185,179,1,6,"PACMA",0
14,"14039",2604,2062,2021,12,41,"PACMA",12
33,"33054",1682,1159,1149,12,10,"PACMA",6
37,"37087",862,639,635,2,4,"PACMA",9
49,"49166",1227,946,933,6,13,"PACMA",4
31,"31166",258,181,181,1,0,"PACMA",0
37,"37216",302,252,248,3,4,"PACMA",0
5,"5194",140,119,116,1,3,"PACMA",0
44,"44185",99,76,75,0,1,"PACMA",0
46,"46169",32247,24214,24053,154,161,"PACMA",367
50,"50293",413,276,275,4,1,"PACMA",0
22,"22168",23,18,18,0,0,"PACMA",0
6,"6065",311,236,228,1,8,"PACMA",1
22,"22045",82,65,64,1,1,"PACMA",4
47,"47123",466,354,352,4,2,"PACMA",1
18,"18053",1630,1082,1076,8,6,"PACMA",8
24,"24029",735,539,535,3,4,"PACMA",2
29,"29032",6657,5031,4977,33,54,"PACMA",45
2,"2084",323,231,225,0,6,"PACMA",0
49,"49091",260,193,193,0,0,"PACMA",0
40,"40008",44,39,39,1,0,"PACMA",0
10,"10048",233,168,168,0,0,"PACMA",0
39,"39018",4220,3264,3204,35,60,"PACMA",32
49,"49047",107,75,75,0,0,"PACMA",0
9,"9135",41,31,31,1,0,"PACMA",0
44,"44187",201,152,149,4,3,"PACMA",0
19,"19219",13,9,9,0,0,"PACMA",0
34,"34059",426,347,342,6,5,"PACMA",0
27,"27021",1753,1090,1056,12,34,"PACMA",8
7,"7034",1008,743,734,7,9,"PACMA",7
19,"19107",294,239,237,0,2,"PACMA",1
40,"40138",2169,1673,1656,7,17,"PACMA",6
9,"9013",48,37,37,0,0,"PACMA",1
10,"10187",438,308,305,1,3,"PACMA",3
19,"19220",2302,1519,1501,1,18,"PACMA",42
18,"18054",849,606,605,7,1,"PACMA",3
9,"9269",36,26,26,1,0,"PACMA",0
28,"28158",665,537,533,4,4,"PACMA",3
24,"24031",215,172,168,0,4,"PACMA",0
45,"45124",2140,1677,1641,10,36,"PACMA",14
50,"50296",396,286,275,4,11,"PACMA",1
14,"14013",16796,11830,11616,129,214,"PACMA",153
44,"44016",482,363,360,2,3,"PACMA",2
28,"28159",589,468,468,5,0,"PACMA",11
24,"24131",724,511,507,3,4,"PACMA",3
25,"25215",345,240,236,0,4,"PACMA",1
9,"9137",174,132,131,3,1,"PACMA",0
9,"9365",29,19,19,0,0,"PACMA",0
34,"34061",106,82,82,1,0,"PACMA",0
10,"10189",2630,1880,1851,4,29,"PACMA",11
24,"24032",109,91,89,0,2,"PACMA",1
25,"25129",175,83,83,2,0,"PACMA",0
48,"48061",762,565,561,0,4,"PACMA",1
12,"12128",1393,1090,1072,10,18,"PACMA",3
47,"47125",58,46,46,0,0,"PACMA",0
45,"45025",1205,831,827,2,4,"PACMA",12
22,"22049",78,64,64,0,0,"PACMA",0
46,"46016",1061,870,856,5,14,"PACMA",8
50,"50110",367,256,254,0,2,"PACMA",1
9,"9017",89,68,67,4,1,"PACMA",0
14,"14015",2125,1579,1554,10,25,"PACMA",11
28,"28062",292,231,226,1,5,"PACMA",2
18,"18902",816,632,620,4,12,"PACMA",4
16,"16057",75,63,63,0,0,"PACMA",0
30,"30020",6303,4543,4497,25,46,"PACMA",13
47,"47044",331,293,290,2,3,"PACMA",3
49,"49096",170,131,124,2,7,"PACMA",1
29,"29037",209,158,157,1,1,"PACMA",0
37,"37098",333,247,247,1,0,"PACMA",1
9,"9274",1079,848,835,12,13,"PACMA",4
33,"33029",350,181,174,2,7,"PACMA",0
46,"46017",32949,23913,23685,142,228,"PACMA",365
10,"10055",710,505,497,1,8,"PACMA",3
27,"27028",79049,54057,53355,559,702,"PACMA",719
16,"16204",261,199,199,1,0,"PACMA",0
33,"33030",895,669,666,9,3,"PACMA",6
42,"42007",113,86,86,5,0,"PACMA",0
34,"34067",127,93,93,1,0,"PACMA",0
47,"47071",410,324,321,4,3,"PACMA",3
5,"5254",190,160,159,0,1,"PACMA",0
37,"37351",281,229,227,0,2,"PACMA",0
50,"50018",953,656,655,1,1,"PACMA",3
6,"6074",4791,3513,3449,18,64,"PACMA",35
18,"18063",1200,679,675,2,4,"PACMA",0
1,"1039",209,155,153,0,2,"PACMA",0
46,"46018",608,515,511,0,4,"PACMA",3
45,"45128",2502,1680,1668,6,12,"PACMA",13
9,"9415",268,175,175,2,0,"PACMA",0
25,"25907",494,266,265,6,1,"PACMA",6
37,"37352",207,153,152,1,1,"PACMA",0
47,"47128",60,52,51,0,1,"PACMA",0
33,"33031",35120,22295,22024,271,271,"PACMA",254
37,"37353",126,97,97,1,0,"PACMA",0
40,"40144",18,14,14,0,0,"PACMA",0
49,"49056",300,211,208,2,3,"PACMA",1
24,"24037",360,254,250,2,4,"PACMA",0
18,"18064",377,291,290,2,1,"PACMA",0
5,"5061",252,186,184,3,2,"PACMA",1
5,"5207",692,547,543,0,4,"PACMA",3
28,"28134",61008,45177,44904,263,273,"PACMA",554
42,"42140",16,12,12,0,0,"PACMA",0
25,"25008",1124,715,702,10,13,"PACMA",4
44,"44195",88,60,60,1,0,"PACMA",0
20,"20003",547,308,308,3,0,"PACMA",1
3,"3130",48,25,25,0,0,"PACMA",0
38,"38011",20570,13831,13698,75,133,"PACMA",261
29,"29040",1977,1290,1278,12,12,"PACMA",10
19,"19227",66,44,43,2,1,"PACMA",0
25,"25176",309,216,211,1,5,"PACMA",0
5,"5209",85,70,70,0,0,"PACMA",0
29,"29041",3175,2090,2045,24,45,"PACMA",17
19,"19115",24,18,18,0,0,"PACMA",0
3,"3098",505,393,386,0,7,"PACMA",5
30,"30024",58746,42036,41731,206,305,"PACMA",301
25,"25135",1028,600,593,10,7,"PACMA",9
9,"9417",40,32,32,1,0,"PACMA",0
18,"18908",801,593,588,3,5,"PACMA",3
39,"39026",1750,1236,1224,11,12,"PACMA",8
25,"25010",211,113,113,2,0,"PACMA",0
4,"4052",12274,8372,8306,93,66,"PACMA",112
37,"37356",87,67,65,0,2,"PACMA",2
14,"14020",387,269,264,2,5,"PACMA",0
49,"49059",94,64,64,0,0,"PACMA",0
34,"34071",171,132,132,1,0,"PACMA",0
34,"34221",179,144,144,3,0,"PACMA",5
22,"22182",250,161,158,1,3,"PACMA",0
7,"7046",15797,9127,9043,86,84,"PACMA",137
19,"19229",66,56,56,0,0,"PACMA",0
49,"49179",371,238,237,0,1,"PACMA",3
16,"16213",36,34,34,0,0,"PACMA",0
25,"25011",5243,2796,2767,23,29,"PACMA",39
48,"48007",364,240,240,5,0,"PACMA",1
10,"10062",406,337,331,0,6,"PACMA",0
22,"22055",320,243,238,2,5,"PACMA",1
25,"25912",857,547,539,1,8,"PACMA",6
27,"27038",935,679,671,7,8,"PACMA",3
9,"9151",448,362,360,6,2,"PACMA",3
29,"29043",2509,1608,1576,18,32,"PACMA",18
23,"23038",3587,2794,2770,16,24,"PACMA",33
3,"3008",168,130,129,0,1,"PACMA",3
5,"5213",103,84,82,0,2,"PACMA",1
48,"48008",606,424,414,6,10,"PACMA",2
9,"9330",1507,1108,1092,10,16,"PACMA",6
5,"5263",173,129,129,1,0,"PACMA",1
28,"28013",40471,28739,28490,188,249,"PACMA",329
33,"33005",1449,936,924,11,12,"PACMA",3
16,"16216",315,268,265,1,3,"PACMA",0
19,"19231",10,9,9,0,0,"PACMA",0
16,"16068",137,98,97,1,1,"PACMA",0
3,"3039",81,62,61,1,1,"PACMA",0
31,"31080",508,391,385,3,6,"PACMA",3
37,"37108",99,79,78,0,1,"PACMA",0
50,"50214",27,18,17,0,1,"PACMA",0
45,"45135",4269,3340,3288,8,52,"PACMA",29
40,"40151",46,33,33,0,0,"PACMA",1
16,"16070",30,26,26,1,0,"PACMA",0
28,"28014",33085,23626,23466,113,160,"PACMA",313
47,"47051",335,268,263,2,5,"PACMA",0
27,"27042",1740,1235,1218,12,17,"PACMA",1
3,"3010",325,277,275,1,2,"PACMA",1
37,"37109",183,129,127,0,2,"PACMA",0
39,"39030",1895,1225,1212,10,13,"PACMA",11
41,"41063",2695,1850,1830,13,20,"PACMA",12
46,"46102",19788,15154,15038,89,116,"PACMA",240
12,"12042",607,520,513,13,7,"PACMA",1
27,"27043",1295,805,793,9,12,"PACMA",9
50,"50215",24,19,19,0,0,"PACMA",1
9,"9335",88,68,68,0,0,"PACMA",0
37,"37361",86,66,66,0,0,"PACMA",0
10,"10067",10422,7113,7014,62,99,"PACMA",38
39,"39031",1236,878,868,4,10,"PACMA",3
5,"5072",81,67,67,1,0,"PACMA",0
24,"24043",134,75,75,1,0,"PACMA",0
6,"6086",1221,814,799,2,15,"PACMA",4
16,"16072",146,104,103,2,1,"PACMA",1
49,"49185",157,123,122,2,1,"PACMA",1
28,"28141",5823,4297,4262,29,35,"PACMA",65
41,"41031",1238,825,814,11,11,"PACMA",2
25,"25142",364,229,225,2,4,"PACMA",2
26,"26003",413,331,329,2,2,"PACMA",1
3,"3012",1085,852,841,3,11,"PACMA",9
12,"12139",318,237,233,0,4,"PACMA",0
25,"25230",1558,1008,993,13,15,"PACMA",6
37,"37154",140,113,110,3,3,"PACMA",0
48,"48072",977,716,713,4,3,"PACMA",1
4,"4058",354,261,259,1,2,"PACMA",0
39,"39032",1463,1087,1081,7,6,"PACMA",10
22,"22189",185,145,144,5,1,"PACMA",2
25,"25017",236,169,167,7,2,"PACMA",0
14,"14026",2067,1424,1405,4,19,"PACMA",4
42,"42020",4263,2877,2821,35,56,"PACMA",18
21,"21027",48,36,35,1,1,"PACMA",0
3,"3105",5373,3911,3828,15,83,"PACMA",35
48,"48073",6910,4306,4271,31,35,"PACMA",15
28,"28073",12549,8788,8701,54,87,"PACMA",146
34,"34127",93,65,64,1,1,"PACMA",0
45,"45139",167,139,139,1,0,"PACMA",1
12,"12045",345,268,259,1,9,"PACMA",1
46,"46105",16190,11323,11206,44,117,"PACMA",107
16,"16078",41429,30053,29775,235,278,"PACMA",229
9,"9294",108,86,82,0,4,"PACMA",0
9,"9162",141,101,101,0,0,"PACMA",2
19,"19237",47,38,38,0,0,"PACMA",0
50,"50218",113,91,91,1,0,"PACMA",0
24,"24047",783,545,540,2,5,"PACMA",2
45,"45140",1087,833,823,3,10,"PACMA",0
46,"46183",5993,4443,4381,19,62,"PACMA",46
42,"42021",83,55,55,3,0,"PACMA",0
22,"22105",114,78,77,2,1,"PACMA",0
40,"40031",526,398,396,2,2,"PACMA",12
31,"31086",13188,9713,9642,111,71,"PACMA",98
1,"1011",235,174,171,4,3,"PACMA",0
19,"19238",42,28,28,0,0,"PACMA",1
34,"34083",1769,1218,1201,10,17,"PACMA",9
37,"37117",1494,1067,1048,3,19,"PACMA",16
27,"27050",2975,2190,2154,16,36,"PACMA",15
7,"7056",5026,3410,3375,32,35,"PACMA",59
1,"1054",960,654,651,4,3,"PACMA",5
41,"41035",1108,794,780,7,14,"PACMA",2
45,"45141",884,700,689,3,11,"PACMA",1
40,"40032",390,289,285,2,4,"PACMA",1
18,"18082",861,616,611,5,5,"PACMA",2
19,"19167",130,101,99,0,2,"PACMA",1
42,"42023",63,51,51,0,0,"PACMA",1
50,"50902",87,79,79,2,0,"PACMA",0
47,"47219",41,36,34,0,2,"PACMA",0
31,"31120",388,250,249,3,1,"PACMA",1
22,"22066",702,502,498,7,4,"PACMA",9
9,"9035",311,227,225,2,2,"PACMA",0
46,"46029",20613,14964,14879,93,85,"PACMA",121
4,"4061",638,506,498,4,8,"PACMA",2
42,"42158",103,76,76,0,0,"PACMA",0
46,"46185",378,320,313,2,7,"PACMA",3
50,"50031",154,93,93,0,0,"PACMA",0
47,"47056",87,67,67,0,0,"PACMA",0
26,"26009",401,325,321,4,4,"PACMA",1
45,"45143",1170,881,874,4,7,"PACMA",9
10,"10077",677,479,472,1,7,"PACMA",4
12,"12049",441,322,312,1,10,"PACMA",1
48,"48077",3364,2437,2431,18,6,"PACMA",24
25,"25150",181,115,113,3,2,"PACMA",0
45,"45043",793,657,649,1,8,"PACMA",0
34,"34087",129,103,102,1,1,"PACMA",1
47,"47166",259,204,197,2,7,"PACMA",1
23,"23049",1813,1238,1222,9,16,"PACMA",4
13,"13001",1254,934,925,6,9,"PACMA",2
37,"37025",257,220,220,4,0,"PACMA",0
42,"42111",303,229,227,2,2,"PACMA",1
44,"44208",37,22,22,0,0,"PACMA",0
6,"6141",1719,1201,1189,8,12,"PACMA",1
26,"26010",93,80,80,2,0,"PACMA",0
10,"10215",431,311,308,2,3,"PACMA",0
34,"34088",246,193,186,1,7,"PACMA",1
1,"1057",240,201,200,1,1,"PACMA",2
10,"10216",1538,1175,1162,4,13,"PACMA",3
6,"6096",220,176,171,2,5,"PACMA",1
46,"46109",6150,4625,4556,25,69,"PACMA",42
13,"13003",480,382,380,1,2,"PACMA",1
18,"18085",720,507,499,3,8,"PACMA",1
29,"29055",1796,1354,1336,11,18,"PACMA",20
3,"3112",628,511,507,2,4,"PACMA",4
3,"3049",12088,9121,9027,52,94,"PACMA",65
16,"16910",91,69,69,1,0,"PACMA",0
9,"9038",119,100,100,0,0,"PACMA",0
31,"31024",99,42,42,0,0,"PACMA",0
42,"42027",76,61,60,0,1,"PACMA",0
45,"45145",2565,1695,1675,12,20,"PACMA",25
47,"47059",97,76,76,2,0,"PACMA",0
16,"16240",102,78,78,0,0,"PACMA",0
12,"12052",578,452,435,3,17,"PACMA",3
22,"22201",266,188,187,3,1,"PACMA",2
37,"37248",152,126,125,1,1,"PACMA",1
6,"6099",1145,655,638,6,17,"PACMA",3
45,"45146",107,84,83,0,1,"PACMA",1
25,"25027",976,633,630,7,3,"PACMA",1
37,"37165",33,26,25,0,1,"PACMA",0
5,"5231",165,133,133,2,0,"PACMA",1
33,"33047",1107,852,843,9,9,"PACMA",2
47,"47143",118,91,90,0,1,"PACMA",0
39,"39040",4292,3208,3166,14,42,"PACMA",23
48,"48080",9976,6820,6763,62,57,"PACMA",57
34,"34240",89,64,64,0,0,"PACMA",0
37,"37250",356,229,228,0,1,"PACMA",2
48,"48081",1868,1361,1350,4,11,"PACMA",9
49,"49199",254,193,189,3,4,"PACMA",0
24,"24021",1675,1162,1144,8,18,"PACMA",9
12,"12087",25,18,18,4,0,"PACMA",0
45,"45147",581,450,446,1,4,"PACMA",4
3,"3021",5613,4570,4500,26,70,"PACMA",28
29,"29057",357,241,238,1,3,"PACMA",1
47,"47224",87,76,76,0,0,"PACMA",0
44,"44006",248,185,183,2,2,"PACMA",1
13,"13008",438,299,295,0,4,"PACMA",1
48,"48082",37605,25134,24938,176,196,"PACMA",186
49,"49200",949,720,715,10,5,"PACMA",3
37,"37376",2233,1539,1515,6,24,"PACMA",0
34,"34241",18,13,13,1,0,"PACMA",0
37,"37125",228,161,156,0,5,"PACMA",1
21,"21039",311,225,223,1,2,"PACMA",3
23,"23054",382,282,281,1,1,"PACMA",1
40,"40168",34,29,29,1,0,"PACMA",0
46,"46112",536,455,450,2,5,"PACMA",0
37,"37252",112,79,79,0,0,"PACMA",2
9,"9439",1028,752,744,9,8,"PACMA",10
37,"37126",29,24,24,0,0,"PACMA",0
6,"6103",4796,3265,3220,20,45,"PACMA",29
25,"25157",181,115,114,7,1,"PACMA",4
18,"18182",1906,1298,1288,4,10,"PACMA",5
23,"23016",387,321,320,0,1,"PACMA",0
31,"31161",338,264,259,2,5,"PACMA",4
19,"19013",125,108,108,1,0,"PACMA",0
46,"46250",578719,442973,440154,2541,2819,"PACMA",6210
47,"47225",80,63,63,0,0,"PACMA",1
47,"47062",163,130,130,0,0,"PACMA",0
9,"9129",104,83,83,0,0,"PACMA",0
16,"16001",76,61,61,0,0,"PACMA",0
29,"29060",692,510,508,1,2,"PACMA",1
30,"30042",1922,1504,1491,7,13,"PACMA",18
31,"31128",359,265,263,0,2,"PACMA",1
6,"6104",674,491,487,3,4,"PACMA",3
24,"24058",208,155,154,3,1,"PACMA",1
18,"18095",1967,1450,1430,11,20,"PACMA",18
44,"44008",1613,1163,1153,6,10,"PACMA",1
50,"50039",491,392,390,2,2,"PACMA",6
29,"29061",1016,798,769,8,29,"PACMA",7
45,"45151",578,417,414,0,3,"PACMA",3
50,"50135",91,70,70,3,0,"PACMA",0
3,"3117",362,318,313,2,5,"PACMA",2
12,"12058",71,63,62,1,1,"PACMA",0
45,"45052",2948,2321,2295,16,26,"PACMA",36
28,"28028",1755,1353,1344,6,9,"PACMA",14
19,"19016",65,49,49,0,0,"PACMA",0
27,"27902",7205,4829,4754,53,75,"PACMA",95
14,"14037",3318,2374,2320,22,54,"PACMA",18
27,"27901",2386,1596,1569,25,27,"PACMA",10
20,"20058",755,529,525,3,4,"PACMA",9
11,"11002",4273,2835,2815,16,20,"PACMA",6
29,"29062",654,551,545,2,6,"PACMA",0
40,"40213",86,65,65,3,0,"PACMA",0
40,"40173",138,99,93,1,6,"PACMA",2
45,"45152",587,458,451,0,7,"PACMA",5
10,"10090",513,362,353,2,9,"PACMA",0
23,"23099",4769,3359,3309,16,50,"PACMA",35
9,"9443",179,128,124,0,4,"PACMA",0
13,"13015",5431,3993,3950,17,43,"PACMA",10
10,"10091",371,287,284,0,3,"PACMA",2
44,"44218",35,28,28,1,0,"PACMA",0
22,"22208",188,150,145,0,5,"PACMA",1
11,"11003",1261,836,822,7,14,"PACMA",5
34,"34100",142,108,108,1,0,"PACMA",1
41,"41047",10117,7515,7422,74,93,"PACMA",121
3,"3026",1224,949,936,5,13,"PACMA",7
19,"19142",265,182,180,3,2,"PACMA",6
49,"49088",87,61,60,0,1,"PACMA",0
25,"25036",184,112,111,4,1,"PACMA",0
47,"47228",440,331,331,2,0,"PACMA",0
46,"46038",327,242,242,3,0,"PACMA",2
4,"4102",13694,8944,8865,50,79,"PACMA",73
6,"6064",841,666,656,2,10,"PACMA",3
22,"22079",118,83,83,1,0,"PACMA",1
16,"16253",337,264,263,2,1,"PACMA",0
28,"28002",3007,2091,2074,14,17,"PACMA",24
24,"24061",1704,1213,1204,9,9,"PACMA",13
40,"40048",38,29,27,0,2,"PACMA",0
50,"50042",15,15,15,1,0,"PACMA",0
49,"49207",239,150,146,0,4,"PACMA",0
40,"40177",153,125,125,1,0,"PACMA",0
46,"46221",352,305,304,0,1,"PACMA",2
4,"4073",330,234,233,2,1,"PACMA",0
24,"24062",139,98,98,1,0,"PACMA",0
46,"46254",1000,785,779,6,6,"PACMA",5
9,"9179",41,32,32,1,0,"PACMA",0
29,"29065",187,137,136,0,1,"PACMA",1
50,"50233",106,81,81,0,0,"PACMA",1
26,"26124",807,649,639,7,10,"PACMA",3
50,"50171",106,79,79,0,0,"PACMA",0
25,"25126",290,200,198,2,2,"PACMA",1
39,"39048",1716,1329,1312,12,17,"PACMA",4
6,"6112",393,323,321,2,2,"PACMA",1
31,"31201",147715,105455,104658,1007,797,"PACMA",814
44,"44221",372,303,300,1,3,"PACMA",1
40,"40051",38,34,34,0,0,"PACMA",0
44,"44013",11244,7815,7712,82,103,"PACMA",65
22,"22082",291,213,212,1,1,"PACMA",3
44,"44120",222,154,150,2,4,"PACMA",0
14,"14041",3182,2296,2251,33,45,"PACMA",12
46,"46040",1078,888,878,7,10,"PACMA",5
45,"45057",222,180,177,1,3,"PACMA",1
5,"5246",59,46,44,0,2,"PACMA",0
49,"49092",129,90,89,1,1,"PACMA",0
12,"12064",91,82,81,2,1,"PACMA",0
9,"9181",300,221,221,0,0,"PACMA",1
33,"33057",1593,1063,1049,16,14,"PACMA",17
40,"40220",66,50,46,1,4,"PACMA",1
47,"47151",27,24,24,0,0,"PACMA",0
6,"6114",137,112,112,0,0,"PACMA",0
13,"13023",8973,6291,6242,44,49,"PACMA",41
26,"26127",212,181,176,0,5,"PACMA",0
46,"46171",16563,12213,12128,85,85,"PACMA",178
3,"3092",6743,5254,5178,37,76,"PACMA",67
40,"40010",121,102,101,1,1,"PACMA",1
12,"12029",702,557,555,4,2,"PACMA",4
2,"2046",1098,896,878,12,18,"PACMA",4
25,"25082",285,186,178,5,8,"PACMA",4
24,"24199",424,302,301,0,1,"PACMA",1
11,"11008",17471,10952,10812,128,140,"PACMA",134
19,"19023",124,100,98,2,2,"PACMA",0
47,"47232",102,77,74,1,3,"PACMA",0
44,"44017",285,227,223,4,4,"PACMA",0
46,"46042",3380,2799,2755,20,44,"PACMA",13
31,"31104",1834,1257,1235,16,22,"PACMA",7
46,"46257",5571,4266,4224,25,42,"PACMA",50
37,"37004",30,21,21,0,0,"PACMA",0
18,"18015",434,334,333,0,1,"PACMA",0
26,"26058",154,116,115,0,1,"PACMA",0
31,"31005",301,212,211,3,1,"PACMA",2
44,"44224",22,14,14,0,0,"PACMA",0
40,"40055",37,26,26,0,0,"PACMA",0
42,"42043",3791,2727,2682,25,45,"PACMA",19
9,"9450",28,22,21,0,1,"PACMA",0
49,"49219",7464,4988,4914,53,74,"PACMA",20
9,"9184",5,4,4,0,0,"PACMA",0
13,"13027",3415,2380,2354,4,26,"PACMA",15
46,"46258",2652,2084,2062,16,22,"PACMA",17
29,"29092",570,397,390,4,7,"PACMA",4
14,"14072",1048,806,795,6,11,"PACMA",8
50,"50143",566,394,391,6,3,"PACMA",1
45,"45060",173,126,125,1,1,"PACMA",0
42,"42045",301,206,197,2,9,"PACMA",0
45,"45160",1109,874,864,6,10,"PACMA",5
13,"13028",10418,8075,7976,52,99,"PACMA",54
31,"31007",131,87,86,1,1,"PACMA",1
14,"14044",1604,1172,1165,7,7,"PACMA",10
38,"38008",5520,3825,3766,17,59,"PACMA",40
22,"22086",215,161,159,1,2,"PACMA",1
47,"47180",73,61,60,4,1,"PACMA",0
12,"12033",1919,1437,1404,19,33,"PACMA",14
41,"41055",14954,10068,9945,64,123,"PACMA",62
24,"24068",457,344,340,0,4,"PACMA",0
2,"2010",1789,1437,1421,11,16,"PACMA",6
9,"9325",190,130,129,2,1,"PACMA",0
13,"13029",84,71,71,0,0,"PACMA",2
5,"5108",47,35,35,0,0,"PACMA",1
10,"10103",450,322,318,1,4,"PACMA",2
48,"48094",3161,2094,2073,12,21,"PACMA",9
50,"50146",187,145,144,3,1,"PACMA",0
12,"12001",1051,821,800,4,21,"PACMA",1
16,"16155",508,398,391,2,7,"PACMA",0
18,"18154",1007,664,660,2,4,"PACMA",1
5,"5256",112,100,98,1,2,"PACMA",0
9,"9326",140,112,111,0,1,"PACMA",0
19,"19261",37,25,24,0,1,"PACMA",0
31,"31207",273,182,177,2,5,"PACMA",1
46,"46045",1249,1028,1010,3,18,"PACMA",9
3,"3035",652,547,541,1,6,"PACMA",2
39,"39055",1086,824,816,6,8,"PACMA",3
31,"31208",2556,1949,1920,16,29,"PACMA",7
49,"49136",318,220,218,1,2,"PACMA",1
42,"42185",26,22,22,0,0,"PACMA",0
6,"6122",6634,4427,4321,26,106,"PACMA",39
37,"37144",363,277,276,1,1,"PACMA",1
44,"44021",107,89,88,0,1,"PACMA",0
25,"25221",122,81,81,0,0,"PACMA",1
28,"28038",4952,3730,3688,34,42,"PACMA",43
24,"24070",4124,3024,2981,20,43,"PACMA",27
37,"37270",189,152,151,2,1,"PACMA",1
9,"9374",90,71,70,1,1,"PACMA",0
9,"9328",76,56,56,0,0,"PACMA",1
44,"44228",100,82,82,0,0,"PACMA",0
46,"46046",892,675,668,1,7,"PACMA",1
21,"21059",221,166,163,5,3,"PACMA",0
16,"16272",221,176,175,0,1,"PACMA",0
33,"33063",415,320,318,3,2,"PACMA",1
12,"12072",1101,929,911,11,18,"PACMA",3
19,"19155",66,56,56,0,0,"PACMA",0
37,"37146",117,96,95,1,1,"PACMA",0
3,"3037",346,282,278,3,4,"PACMA",2
19,"19192",1736,1324,1308,8,16,"PACMA",5
9,"9194",2020,1472,1459,9,13,"PACMA",9
50,"50242",93,75,75,3,0,"PACMA",0
19,"19263",26,15,15,1,0,"PACMA",0
31,"31211",27,15,15,1,0,"PACMA",0
24,"24073",478,332,328,2,4,"PACMA",1
9,"9460",176,131,131,1,0,"PACMA",0
19,"19156",970,704,699,4,5,"PACMA",3
47,"47076",17399,13097,12972,92,125,"PACMA",116
3,"3132",534,436,435,3,1,"PACMA",2
35,"35009",19905,14185,13961,89,224,"PACMA",163
10,"10108",219,148,146,0,2,"PACMA",0
19,"19193",20,19,19,1,0,"PACMA",0
40,"40062",60,51,48,0,3,"PACMA",0
38,"38014",1357,935,926,3,9,"PACMA",7
37,"37189",121,88,88,0,0,"PACMA",0
13,"13037",842,661,652,1,9,"PACMA",2
19,"19037",141,115,114,1,1,"PACMA",0
42,"42190",89,65,64,0,1,"PACMA",0
6,"6127",2863,2112,2088,10,24,"PACMA",5
9,"9463",264,195,195,7,0,"PACMA",0
28,"28109",1576,1103,1098,1,5,"PACMA",24
10,"10155",1126,773,763,5,10,"PACMA",3
31,"31046",57,39,39,1,0,"PACMA",0
13,"13089",1706,1368,1332,8,36,"PACMA",2
47,"47213",109,82,82,0,0,"PACMA",0
2,"2058",337,234,231,0,3,"PACMA",1
13,"13038",1630,1230,1207,7,23,"PACMA",6
50,"50024",571,437,437,6,0,"PACMA",1
44,"44164",27,23,23,0,0,"PACMA",0
2,"2018",829,661,653,1,8,"PACMA",1
42,"42191",185,136,133,0,3,"PACMA",0
46,"46049",281,232,224,0,8,"PACMA",3
21,"21063",2615,2001,1957,22,44,"PACMA",9
33,"33067",784,587,579,9,8,"PACMA",2
37,"37318",208,159,158,1,1,"PACMA",0
20,"20074",11592,7954,7914,45,40,"PACMA",26
48,"48903",1835,1361,1351,7,10,"PACMA",6
19,"19039",61,54,54,1,0,"PACMA",0
16,"16277",113,84,83,1,1,"PACMA",0
46,"46903",6065,4790,4763,18,27,"PACMA",95
6,"6130",195,164,158,0,6,"PACMA",0
25,"25227",652,402,400,4,2,"PACMA",0
45,"45069",1847,1391,1376,6,15,"PACMA",7
2,"2020",432,365,364,1,1,"PACMA",2
28,"28015",18736,14221,14127,68,94,"PACMA",206
46,"46050",194,150,149,0,1,"PACMA",4
16,"16118",1375,1106,1086,13,20,"PACMA",5
49,"49024",672,459,454,5,5,"PACMA",1
29,"29068",7016,4300,4244,35,56,"PACMA",37
4,"4086",1760,1243,1234,9,9,"PACMA",7
22,"22228",514,364,360,5,4,"PACMA",7
50,"50153",935,713,708,6,5,"PACMA",4
16,"16279",203,128,127,1,1,"PACMA",0
49,"49108",466,346,344,0,2,"PACMA",2
31,"31049",699,469,465,2,4,"PACMA",0
37,"37061",225,168,168,1,0,"PACMA",1
42,"42056",23,20,20,0,0,"PACMA",0
9,"9067",437,295,294,6,1,"PACMA",1
47,"47105",183,158,156,0,2,"PACMA",1
19,"19162",68,49,47,0,2,"PACMA",1
31,"31216",3865,2702,2671,33,31,"PACMA",27
41,"41065",22779,14769,14636,132,133,"PACMA",106
4,"4087",182,135,135,0,0,"PACMA",0
22,"22229",114,80,80,1,0,"PACMA",0
4,"4023",138,96,95,2,1,"PACMA",1
31,"31116",62,51,50,1,1,"PACMA",0
9,"9068",29,24,24,0,0,"PACMA",1
16,"16901",675,506,501,6,5,"PACMA",0
50,"50278",197,145,145,0,0,"PACMA",1
46,"46052",499,421,417,2,4,"PACMA",0
2,"2022",351,281,279,1,2,"PACMA",0
47,"47001",55,46,46,0,0,"PACMA",0
46,"46208",1112,887,881,4,6,"PACMA",9
42,"42058",113,92,89,0,3,"PACMA",1
29,"29071",934,596,588,3,8,"PACMA",4
6,"6134",547,335,332,1,3,"PACMA",2
49,"49232",96,74,74,1,0,"PACMA",0
30,"30001",4582,3620,3594,18,26,"PACMA",25
21,"21069",1702,1167,1149,6,18,"PACMA",6
9,"9472",55,45,44,0,1,"PACMA",0
22,"22230",284,216,216,1,0,"PACMA",0
40,"40072",211,162,159,1,3,"PACMA",5
45,"45173",9520,6938,6864,30,74,"PACMA",65
19,"19043",84,72,72,0,0,"PACMA",0
49,"49234",412,328,324,0,4,"PACMA",0
37,"37157",78,63,62,0,1,"PACMA",0
16,"16902",137,107,107,0,0,"PACMA",0
11,"11022",48675,26491,26256,270,235,"PACMA",490
3,"3044",4521,3510,3465,21,45,"PACMA",33
40,"40200",40,31,31,0,0,"PACMA",0
50,"50029",626,450,450,3,0,"PACMA",4
28,"28018",3768,2968,2945,26,23,"PACMA",20
3,"3045",210,176,172,0,4,"PACMA",0
20,"20046",1223,739,737,5,2,"PACMA",7
25,"25191",334,205,204,4,1,"PACMA",2
25,"25060",72,46,44,1,2,"PACMA",0
26,"26145",246,197,197,2,0,"PACMA",0
34,"34130",212,164,163,1,1,"PACMA",0
33,"33072",1566,1008,994,11,14,"PACMA",5
26,"26040",70,60,60,0,0,"PACMA",1
46,"46132",2150,1803,1784,7,19,"PACMA",14
48,"48909",209,161,161,0,0,"PACMA",1
41,"41068",13939,9787,9674,72,113,"PACMA",59
50,"50159",665,512,507,2,5,"PACMA",0
48,"48045",5167,3809,3757,28,52,"PACMA",34
24,"24181",1493,1054,1045,5,9,"PACMA",0
3,"3046",1599,1153,1143,8,10,"PACMA",10
31,"31021",62,39,38,0,1,"PACMA",0
26,"26041",132,92,91,0,1,"PACMA",1
31,"31221",1214,798,786,12,12,"PACMA",5
26,"26146",94,73,72,0,1,"PACMA",0
9,"9478",41,32,32,1,0,"PACMA",0
35,"35016",297736,192251,190256,1386,1995,"PACMA",2892
19,"19168",292,204,198,1,6,"PACMA",1
37,"37024",89,67,67,0,0,"PACMA",0
4,"4092",2838,2127,2103,10,24,"PACMA",21
9,"9345",123,93,91,2,2,"PACMA",1
45,"45175",664,545,543,5,2,"PACMA",1
18,"18127",16635,11440,11332,91,108,"PACMA",191
47,"47004",1181,939,930,7,9,"PACMA",0
28,"28020",145,94,94,0,0,"PACMA",0
45,"45077",556,428,427,1,1,"PACMA",5
28,"28086",5154,3530,3493,13,37,"PACMA",29
49,"49238",254,194,193,1,1,"PACMA",1
14,"14058",7970,5491,5417,66,74,"PACMA",48
26,"26075",329,267,264,2,3,"PACMA",0
50,"50064",437,342,339,0,3,"PACMA",3
42,"42063",49,35,35,0,0,"PACMA",0
45,"45110",1786,1403,1398,5,5,"PACMA",0
9,"9301",625,473,467,2,6,"PACMA",5
7,"7019",187,133,129,2,4,"PACMA",0
47,"47031",189,145,145,1,0,"PACMA",0
33,"33075",271,154,153,2,1,"PACMA",0
24,"24184",198,118,117,0,1,"PACMA",1
20,"20050",266,170,169,1,1,"PACMA",0
40,"40077",842,632,619,3,13,"PACMA",7
13,"13054",4944,3729,3678,27,51,"PACMA",16
16,"16176",38,30,30,0,0,"PACMA",0
46,"46213",15409,10924,10805,97,119,"PACMA",120
5,"5132",960,669,657,1,12,"PACMA",4
48,"48912",2308,1707,1679,14,28,"PACMA",5
11,"11028",32488,21971,21672,316,299,"PACMA",464
50,"50254",180,118,116,1,2,"PACMA",0
12,"12116",58,49,49,0,0,"PACMA",0
40,"40123",147,114,106,0,8,"PACMA",0
24,"24185",474,357,350,3,7,"PACMA",1
21,"21035",9617,6033,5943,76,90,"PACMA",47
37,"37164",256,191,189,5,2,"PACMA",0
10,"10126",1548,1120,1102,8,18,"PACMA",1
11,"11029",5430,3039,3000,44,39,"PACMA",20
25,"25200",329,213,213,0,0,"PACMA",1
45,"45079",369,288,286,3,2,"PACMA",1
25,"25067",719,467,460,7,7,"PACMA",1
33,"33077",1192,811,808,5,3,"PACMA",4
26,"26045",12,12,12,0,0,"PACMA",0
28,"28177",10270,8083,8030,36,53,"PACMA",95
46,"46136",2537,1952,1930,11,22,"PACMA",22
37,"37205",231,189,182,0,7,"PACMA",0
50,"50096",39,27,27,0,0,"PACMA",0
38,"38029",1517,744,734,1,10,"PACMA",13
48,"48914",332,272,272,1,0,"PACMA",0
45,"45080",6,6,6,0,0,"PACMA",0
49,"49241",248,177,177,0,0,"PACMA",0
11,"11030",22775,15157,14958,149,199,"PACMA",237
18,"18135",4568,3009,2961,14,48,"PACMA",34
37,"37166",214,152,151,2,1,"PACMA",0
46,"46059",1261,1035,1019,9,16,"PACMA",8
3,"3114",1562,1198,1188,9,10,"PACMA",11
26,"26117",2152,1625,1605,10,20,"PACMA",9
19,"19244",82,65,64,1,1,"PACMA",0
13,"13007",1271,993,977,8,16,"PACMA",8
13,"13059",202,160,156,0,4,"PACMA",0
40,"40208",766,596,589,3,7,"PACMA",2
22,"22113",495,370,368,4,2,"PACMA",1
40,"40082",114,84,82,1,2,"PACMA",0
11,"11031",76455,49854,49405,535,449,"PACMA",1069
28,"28179",1432,1040,1037,4,3,"PACMA",16
24,"24188",3822,2850,2817,19,33,"PACMA",22
9,"9902",458,331,327,3,4,"PACMA",6
31,"31227",8180,5885,5809,76,76,"PACMA",38
26,"26047",1947,1578,1563,8,15,"PACMA",4
47,"47170",33,28,27,2,1,"PACMA",0
38,"38031",28687,21132,20858,104,274,"PACMA",365
14,"14062",1025,806,792,6,14,"PACMA",1
19,"19174",109,80,79,0,1,"PACMA",0
49,"49002",63,51,49,0,2,"PACMA",0
22,"22001",225,151,151,1,0,"PACMA",0
24,"24090",343,235,233,1,2,"PACMA",2
31,"31127",138,98,95,0,3,"PACMA",2
28,"28152",16093,12945,12877,58,68,"PACMA",131
40,"40001",702,560,554,3,6,"PACMA",0
44,"44007",173,122,121,4,1,"PACMA",0
31,"31162",47,31,31,0,0,"PACMA",0
44,"44147",412,298,293,5,5,"PACMA",5
25,"25072",5850,3493,3444,29,49,"PACMA",48
31,"31029",914,638,625,6,13,"PACMA",1
12,"12056",282,236,231,1,5,"PACMA",1
23,"23096",2642,2164,2138,9,26,"PACMA",10
26,"26049",172,125,122,1,3,"PACMA",0
44,"44249",55,44,44,2,0,"PACMA",0
31,"31262",228,179,178,5,1,"PACMA",2
9,"9261",469,332,329,2,3,"PACMA",2
47,"47090",2418,1728,1699,8,29,"PACMA",9
4,"4099",4989,3636,3588,27,48,"PACMA",13
13,"13064",1696,1231,1225,9,6,"PACMA",17
6,"6014",6682,4479,4409,14,70,"PACMA",13
16,"16141",143,102,102,0,0,"PACMA",0
29,"29084",27359,17843,17627,176,216,"PACMA",167
38,"38034",4049,2855,2807,19,48,"PACMA",32
9,"9219",27509,19084,18859,146,225,"PACMA",194
4,"4005",556,437,431,3,6,"PACMA",1
9,"9220",75,56,54,1,2,"PACMA",0
23,"23098",867,713,701,1,12,"PACMA",5
34,"34199",1218,918,899,10,19,"PACMA",15
49,"49246",227,190,183,2,7,"PACMA",0
37,"37171",409,317,310,2,7,"PACMA",1
47,"47091",84,71,71,2,0,"PACMA",0
45,"45186",3061,2242,2214,11,28,"PACMA",13
1,"1023",267,187,186,1,1,"PACMA",1
31,"31131",901,646,638,7,8,"PACMA",10
49,"49005",149,91,91,2,0,"PACMA",0
44,"44077",74,60,58,0,2,"PACMA",0
48,"48055",2668,1872,1849,11,23,"PACMA",12
41,"41079",9294,6670,6580,51,90,"PACMA",72
37,"37172",888,572,566,3,6,"PACMA",0
34,"34201",193,158,155,1,3,"PACMA",0
34,"34009",31,29,29,1,0,"PACMA",0
37,"37298",179,127,126,0,1,"PACMA",1
49,"49125",1391,933,918,10,15,"PACMA",8
6,"6153",20377,14329,14163,103,166,"PACMA",134
49,"49248",186,151,150,1,1,"PACMA",0
5,"5144",76,55,54,0,1,"PACMA",0
24,"24194",290,212,212,3,0,"PACMA",0
40,"40215",84,60,60,0,0,"PACMA",0
47,"47092",110,87,87,0,0,"PACMA",0
49,"49006",154,99,95,0,4,"PACMA",1
18,"18007",781,521,512,5,9,"PACMA",3
16,"16145",450,363,361,5,2,"PACMA",3
10,"10137",397,320,317,3,3,"PACMA",0
46,"46220",48410,34644,34292,279,352,"PACMA",420
39,"39016",23868,17883,17701,122,182,"PACMA",186
30,"30902",7975,5318,5273,24,45,"PACMA",43
22,"22044",252,198,197,0,1,"PACMA",1
42,"42216",25,23,23,0,0,"PACMA",1
39,"39077",236,173,171,1,2,"PACMA",0
14,"14067",3889,2946,2899,29,47,"PACMA",17
48,"48027",22150,15089,14982,78,107,"PACMA",100
44,"44044",88,72,71,2,1,"PACMA",3
25,"25077",463,256,253,6,3,"PACMA",2
46,"46065",1579,1174,1163,8,11,"PACMA",12
41,"41015",5297,3478,3405,41,73,"PACMA",34
49,"49250",1245,935,920,7,15,"PACMA",2
22,"22122",64,57,57,2,0,"PACMA",0
19,"19059",77,61,58,1,3,"PACMA",0
47,"47093",813,613,600,5,13,"PACMA",4
9,"9361",115,90,89,0,1,"PACMA",1
35,"35026",81091,51953,51195,407,758,"PACMA",656
22,"22250",353,261,258,4,3,"PACMA",3
46,"46013",17383,13569,13483,82,86,"PACMA",190
9,"9445",44,32,32,3,0,"PACMA",1
6,"6020",1815,1366,1345,10,21,"PACMA",6
29,"29088",2714,1829,1800,12,29,"PACMA",9
18,"18147",3729,2335,2304,16,31,"PACMA",18
22,"22125",38773,27021,26732,258,289,"PACMA",254
13,"13073",531,399,391,3,8,"PACMA",1
29,"29089",3228,2377,2321,10,56,"PACMA",14
28,"28097",119,94,94,0,0,"PACMA",1
50,"50075",80,62,61,1,1,"PACMA",0
14,"14069",7524,5460,5392,43,68,"PACMA",25
34,"34154",74,55,53,1,2,"PACMA",0
37,"37042",44,28,27,0,1,"PACMA",0
4,"4010",576,444,443,3,1,"PACMA",2
38,"38040",5021,3136,3102,14,34,"PACMA",27
44,"44154",256,192,188,3,4,"PACMA",1
29,"29090",1688,1144,1134,15,10,"PACMA",9
28,"28032",4762,3428,3401,19,27,"PACMA",41
26,"26056",419,338,332,1,6,"PACMA",1
45,"45090",384,294,293,3,1,"PACMA",0
10,"10142",832,627,621,5,6,"PACMA",0
4,"4045",1757,1309,1288,6,21,"PACMA",8
46,"46145",21990,16337,16187,93,150,"PACMA",266
46,"46256",6853,4951,4890,25,61,"PACMA",58
40,"40180",299,246,241,1,5,"PACMA",0
16,"16258",194,150,150,1,0,"PACMA",0
25,"25002",482,316,314,2,2,"PACMA",4
21,"21010",14687,8293,8220,92,73,"PACMA",115
47,"47124",392,316,311,3,5,"PACMA",2
42,"42084",25,22,22,1,0,"PACMA",0
47,"47178",172,140,140,3,0,"PACMA",2
28,"28033",3899,2805,2788,7,17,"PACMA",43
49,"49012",73,43,43,0,0,"PACMA",0
35,"35029",4152,2530,2498,32,32,"PACMA",15
9,"9366",86,62,62,2,0,"PACMA",0
10,"10144",975,746,735,3,11,"PACMA",1
26,"26057",48,38,38,0,0,"PACMA",0
37,"37046",11225,7824,7697,53,127,"PACMA",57
4,"4046",858,609,599,7,10,"PACMA",3
16,"16202",769,564,558,0,6,"PACMA",2
42,"42085",189,129,127,3,2,"PACMA",0
6,"6025",5106,3571,3523,44,48,"PACMA",27
44,"44156",45,31,31,1,0,"PACMA",0
19,"19186",81,68,68,0,0,"PACMA",0
4,"4904",1777,1230,1221,12,9,"PACMA",12
31,"31138",932,601,599,2,2,"PACMA",7
37,"37047",180,84,84,0,0,"PACMA",1
40,"40099",52,44,42,0,2,"PACMA",0
39,"39082",1653,1173,1157,11,16,"PACMA",8
24,"24168",460,361,359,0,2,"PACMA",1
47,"47179",395,293,287,0,6,"PACMA",0
50,"50079",249,175,174,0,1,"PACMA",0
31,"31239",322,211,211,5,0,"PACMA",0
6,"6902",1667,1121,1113,13,8,"PACMA",8
49,"49258",114,93,91,2,2,"PACMA",0
26,"26167",59,47,46,1,1,"PACMA",0
5,"5156",256,160,159,1,1,"PACMA",2
19,"19067",70,52,51,1,1,"PACMA",0
9,"9100",59,45,44,0,1,"PACMA",0
19,"19188",51,35,35,0,0,"PACMA",0
12,"12100",1333,1065,1047,10,18,"PACMA",11
49,"49054",894,617,601,13,16,"PACMA",1
5,"5253",86,70,68,0,2,"PACMA",1
44,"44090",78,53,53,0,0,"PACMA",0
22,"22902",221,159,156,0,3,"PACMA",2
49,"49015",227,179,177,0,2,"PACMA",0
47,"47019",85,74,73,0,1,"PACMA",0
50,"50269",285,193,188,0,5,"PACMA",1
10,"10011",560,458,448,5,10,"PACMA",3
19,"19070",74,53,53,0,0,"PACMA",0
37,"37050",66,52,52,0,0,"PACMA",1
46,"46148",1513,1160,1146,7,14,"PACMA",15
42,"42009",78,63,63,0,0,"PACMA",0
14,"14018",3709,2697,2653,26,44,"PACMA",16
50,"50019",55,41,41,0,0,"PACMA",0
44,"44264",248,191,189,1,2,"PACMA",1
50,"50081",511,382,378,4,4,"PACMA",1
22,"22015",319,234,228,3,6,"PACMA",0
16,"16206",204,158,157,6,1,"PACMA",1
41,"41090",3523,2576,2512,13,64,"PACMA",20
28,"28037",1559,1177,1166,5,11,"PACMA",8
7,"7002",6341,4295,4255,39,40,"PACMA",60
14,"14074",2299,1896,1866,16,30,"PACMA",4
39,"39025",8637,6486,6378,47,108,"PACMA",57
6,"6030",169,137,135,0,2,"PACMA",1
40,"40103",159,125,123,2,2,"PACMA",0
13,"13084",892,701,685,6,16,"PACMA",2
40,"40229",36,24,24,0,0,"PACMA",0
16,"16063",97,85,84,1,1,"PACMA",1
7,"7043",3389,2290,2252,26,38,"PACMA",25
6,"6031",469,277,272,2,5,"PACMA",2
16,"16018",394,318,315,1,3,"PACMA",1
3,"3005",7769,5917,5866,19,51,"PACMA",78
45,"45064",3858,2804,2763,20,41,"PACMA",30
44,"44094",113,94,94,0,0,"PACMA",1
31,"31243",306,224,221,2,3,"PACMA",1
7,"7003",11761,6631,6541,55,90,"PACMA",111
48,"48036",24073,16076,15971,86,105,"PACMA",135
25,"25222",66,52,52,1,0,"PACMA",0
22,"22905",281,209,209,1,0,"PACMA",4
49,"49019",243,188,182,2,6,"PACMA",0
4,"4051",436,360,356,1,4,"PACMA",2
40,"40105",47,42,42,2,0,"PACMA",0
5,"5013",868,728,721,6,7,"PACMA",2
50,"50021",30,21,21,0,0,"PACMA",2
37,"37055",123,98,94,0,4,"PACMA",0
46,"46229",948,762,758,0,4,"PACMA",1
22,"22906",186,141,139,3,2,"PACMA",0
16,"16020",17,10,10,0,0,"PACMA",0
9,"9104",53,42,42,0,0,"PACMA",1
50,"50083",89,75,75,1,0,"PACMA",1
12,"12135",35719,26016,25793,196,223,"PACMA",314
46,"46099",901,689,684,1,5,"PACMA",6
19,"19302",59,49,49,1,0,"PACMA",0
1,"1002",8124,5722,5654,31,68,"PACMA",31
28,"28012",887,664,661,2,3,"PACMA",4
18,"18161",212,175,174,3,1,"PACMA",0
40,"40107",100,73,73,1,0,"PACMA",0
50,"50273",30,22,22,0,0,"PACMA",0
10,"10200",392,306,302,1,4,"PACMA",2
45,"45200",4592,3539,3476,14,63,"PACMA",17
2,"2057",2020,1487,1461,10,26,"PACMA",10
48,"48038",1126,798,794,3,4,"PACMA",1
34,"34031",30,30,29,0,1,"PACMA",0
12,"12040",117608,85588,84946,496,642,"PACMA",1011
9,"9421",230,166,163,3,3,"PACMA",0
26,"26102",6111,4486,4435,28,51,"PACMA",32
18,"18068",1569,1189,1166,6,23,"PACMA",10
35,"35010",3558,2341,2301,28,40,"PACMA",13
50,"50055",3611,2445,2407,22,38,"PACMA",32
49,"49104",343,234,232,0,2,"PACMA",2
33,"33046",499,379,367,5,12,"PACMA",2
6,"6082",383,287,286,2,1,"PACMA",1
9,"9422",17,11,11,0,0,"PACMA",0
37,"37059",124,94,93,1,1,"PACMA",0
5,"5017",85,82,81,5,1,"PACMA",1
7,"7008",5692,3956,3913,26,43,"PACMA",45
24,"24211",272,205,205,2,0,"PACMA",0
37,"37235",224,153,148,2,5,"PACMA",0
47,"47132",45,36,33,1,3,"PACMA",0
38,"38053",3735,2469,2435,17,34,"PACMA",23
26,"26175",51,41,41,0,0,"PACMA",0
47,"47025",120,94,94,1,0,"PACMA",0
9,"9110",80,63,63,0,0,"PACMA",0
34,"34033",17,17,17,0,0,"PACMA",0
37,"37236",135,105,103,1,2,"PACMA",1
5,"5070",30,27,27,0,0,"PACMA",0
44,"44100",185,153,151,0,2,"PACMA",2
19,"19120",101,88,88,1,0,"PACMA",0
19,"19196",105,84,81,0,3,"PACMA",0
22,"22022",552,414,408,6,6,"PACMA",3
49,"49064",515,346,338,6,8,"PACMA",0
40,"40902",123,99,96,1,3,"PACMA",0
5,"5169",226,187,185,1,2,"PACMA",0
25,"25099",1273,761,752,7,9,"PACMA",6
9,"9381",30,24,24,1,0,"PACMA",0
22,"22909",315,226,225,4,1,"PACMA",2
9,"9112",109,85,85,0,0,"PACMA",1
28,"28071",60,55,53,1,2,"PACMA",0
29,"29046",2675,1825,1807,14,18,"PACMA",10
16,"16224",83,66,65,1,1,"PACMA",0
49,"49269",229,165,162,1,3,"PACMA",1
21,"21026",266,166,159,3,7,"PACMA",2
16,"16167",316,249,244,1,5,"PACMA",2
5,"5022",1588,1238,1222,5,16,"PACMA",1
10,"10160",229,190,189,2,1,"PACMA",1
34,"34175",90,72,70,0,2,"PACMA",0
16,"16027",710,542,538,5,4,"PACMA",6
50,"50247",823,588,581,3,7,"PACMA",3
28,"28112",161,136,136,1,0,"PACMA",0
16,"16029",99,72,70,0,2,"PACMA",0
37,"37322",2465,1592,1564,8,28,"PACMA",20
7,"7053",1188,926,918,16,8,"PACMA",15
24,"24215",152,113,113,0,0,"PACMA",0
13,"13097",2270,1687,1671,7,16,"PACMA",7
16,"16169",58,37,37,3,0,"PACMA",0
23,"23003",8688,6326,6257,52,69,"PACMA",41
34,"34176",133,102,101,0,1,"PACMA",0
25,"25102",707,420,407,6,13,"PACMA",3
25,"25231",486,330,330,4,0,"PACMA",4
31,"31084",1940,1293,1274,16,19,"PACMA",3
6,"6089",596,469,461,1,8,"PACMA",1
10,"10208",123,94,93,1,1,"PACMA",0
24,"24112",309,228,227,1,1,"PACMA",0
9,"9386",54,39,38,1,1,"PACMA",0
22,"22025",1071,676,669,18,7,"PACMA",4
46,"46001",795,601,592,3,9,"PACMA",2
49,"49272",88,70,69,1,1,"PACMA",1
20,"20079",17886,11860,11799,91,61,"PACMA",67
44,"44172",301,218,216,4,2,"PACMA",0
44,"44063",71,54,54,0,0,"PACMA",0
20,"20078",1155,850,846,4,4,"PACMA",2
45,"45107",3257,2504,2472,15,32,"PACMA",29
18,"18123",301,228,222,1,6,"PACMA",4
34,"34082",83,74,73,0,1,"PACMA",0
25,"25146",227,140,140,3,0,"PACMA",3
49,"49150",139,112,111,1,1,"PACMA",0
40,"40118",51,35,34,1,1,"PACMA",0
46,"46080",998,803,799,7,4,"PACMA",3
41,"41002",1473,1038,1014,9,24,"PACMA",8
42,"42107",74,54,54,3,0,"PACMA",1
31,"31053",523,372,368,1,4,"PACMA",0
37,"37325",89,62,62,0,0,"PACMA",1
9,"9249",46,33,33,0,0,"PACMA",1
6,"6046",1255,1004,995,8,9,"PACMA",0
46,"46158",1026,811,795,6,16,"PACMA",3
19,"19201",58,49,48,1,1,"PACMA",0
48,"48075",1996,1364,1359,6,5,"PACMA",4
12,"12901",3405,2626,2598,23,28,"PACMA",20
25,"25021",2607,1490,1481,20,9,"PACMA",11
49,"49190",63,47,45,0,2,"PACMA",0
19,"19004",67,53,53,1,0,"PACMA",0
50,"50220",40,32,32,0,0,"PACMA",0
50,"50189",705,527,519,13,8,"PACMA",0
24,"24115",54058,37780,37357,308,423,"PACMA",313
41,"41003",2333,1693,1671,13,22,"PACMA",19
9,"9119",46,28,28,0,0,"PACMA",0
18,"18083",247,200,196,0,4,"PACMA",0
33,"33013",446,321,318,3,3,"PACMA",0
45,"45109",2883,2271,2214,9,57,"PACMA",16
47,"47192",102,83,81,1,2,"PACMA",0
45,"45009",524,344,341,2,3,"PACMA",1
7,"7018",382,272,269,1,3,"PACMA",3
31,"31155",256,169,167,2,2,"PACMA",1
26,"26183",64,49,49,0,0,"PACMA",2
47,"47112",2587,2015,1988,7,27,"PACMA",8
37,"37329",42,34,34,0,0,"PACMA",0
28,"28117",104,89,89,1,0,"PACMA",1
40,"40034",84,70,70,0,0,"PACMA",1
37,"37245",346,261,259,2,2,"PACMA",0
9,"9122",94,67,66,1,1,"PACMA",1
19,"19241",43,34,34,1,0,"PACMA",0
23,"23008",1502,1144,1131,9,13,"PACMA",5
9,"9036",37,31,30,1,1,"PACMA",1
5,"5179",214,178,176,1,2,"PACMA",0
9,"9391",361,264,263,3,1,"PACMA",2
2,"2069",11490,8470,8373,41,97,"PACMA",52
30,"30006",803,691,685,2,6,"PACMA",5
49,"49033",714,508,505,1,3,"PACMA",2
30,"30036",14698,9859,9734,41,125,"PACMA",104
39,"39038",1452,997,990,8,7,"PACMA",9
6,"6050",4106,3134,3075,25,59,"PACMA",8
39,"39099",3114,2308,2281,12,27,"PACMA",22
27,"27004",1227,760,749,7,11,"PACMA",3
50,"50003",128,92,91,1,1,"PACMA",1
7,"7020",3581,2542,2502,43,40,"PACMA",28
22,"22068",79,60,60,0,0,"PACMA",1
9,"9433",60,48,45,1,3,"PACMA",0
49,"49078",170,141,140,1,1,"PACMA",0
49,"49117",465,330,324,6,6,"PACMA",0
50,"50130",383,240,238,2,2,"PACMA",2
31,"31069",832,637,635,3,2,"PACMA",3
4,"4064",2771,2001,1988,13,13,"PACMA",16
39,"39009",3216,2366,2337,17,29,"PACMA",20
44,"44070",53,48,48,0,0,"PACMA",0
1,"1018",1386,939,930,3,9,"PACMA",3
3,"3080",1300,1035,1025,3,10,"PACMA",2
37,"37074",150,123,120,0,3,"PACMA",0
23,"23011",2170,1515,1496,7,19,"PACMA",10
34,"34186",52,45,45,0,0,"PACMA",0
10,"10218",1126,803,795,3,8,"PACMA",3
28,"28149",5759,4352,4310,25,42,"PACMA",69
18,"18179",538,376,374,6,2,"PACMA",0
4,"4065",363,284,282,7,2,"PACMA",0
40,"40039",210,156,153,3,3,"PACMA",0
3,"3081",1436,1084,1075,5,9,"PACMA",10
49,"49157",206,163,160,2,3,"PACMA",0
22,"22158",11995,8197,8126,62,71,"PACMA",79
46,"46085",11081,7938,7866,46,72,"PACMA",78
50,"50286",77,50,50,3,0,"PACMA",0
44,"44038",104,83,82,0,1,"PACMA",0
24,"24187",857,603,593,7,10,"PACMA",6
4,"4001",1062,823,814,5,9,"PACMA",4
18,"18088",1541,1124,1117,5,7,"PACMA",3
22,"22037",115,86,86,0,0,"PACMA",1
18,"18043",123,80,79,1,1,"PACMA",2
24,"24022",330,230,229,0,1,"PACMA",4
50,"50194",88,63,63,1,0,"PACMA",0
27,"27061",1027,753,732,6,21,"PACMA",7
31,"31060",13744,9400,9320,72,80,"PACMA",122
34,"34190",56,41,40,2,1,"PACMA",0
10,"10038",87,68,68,0,0,"PACMA",0
40,"40126",79,56,54,0,2,"PACMA",0
20,"20054",447,286,284,2,2,"PACMA",0
18,"18181",223,174,172,0,2,"PACMA",2
46,"46242",333,267,266,0,1,"PACMA",0
50,"50196",107,87,86,0,1,"PACMA",0
5,"5185",95,82,81,0,1,"PACMA",0
48,"48052",1562,1160,1150,4,10,"PACMA",1
34,"34192",90,75,72,0,3,"PACMA",0
2,"2076",329,237,236,1,1,"PACMA",1
41,"41098",5004,3665,3630,26,35,"PACMA",57
47,"47009",107,86,85,0,1,"PACMA",0
44,"44213",62,50,50,0,0,"PACMA",0
50,"50100",329,246,241,1,5,"PACMA",1
23,"23055",47167,31479,31198,264,281,"PACMA",313
37,"37209",412,272,270,7,2,"PACMA",1
47,"47197",876,673,668,8,5,"PACMA",1
7,"7026",31074,18280,18135,168,145,"PACMA",330
22,"22002",107,95,95,0,0,"PACMA",0
37,"37377",241,201,199,1,2,"PACMA",0
16,"16093",60,49,47,0,2,"PACMA",0
34,"34096",55,42,42,0,0,"PACMA",0
41,"41044",7423,5273,5241,34,32,"PACMA",87
26,"26016",28,25,24,1,1,"PACMA",0
23,"23017",1572,1269,1257,4,12,"PACMA",3
3,"3084",539,454,446,3,8,"PACMA",2
44,"44076",2203,1690,1663,18,27,"PACMA",3
49,"49040",114,101,101,0,0,"PACMA",0
49,"49084",287,229,228,4,1,"PACMA",0
9,"9007",57,39,39,0,0,"PACMA",0
22,"22206",193,129,128,1,1,"PACMA",1
25,"25250",345,210,204,0,6,"PACMA",1
31,"31263",233,138,137,2,1,"PACMA",0
46,"46244",58771,42137,41867,270,270,"PACMA",651
5,"5044",266,183,183,1,0,"PACMA",1
4,"4069",4687,3471,3437,27,34,"PACMA",19
37,"37339",315,251,251,4,0,"PACMA",1
24,"24025",297,228,227,0,1,"PACMA",1
45,"45018",498,333,330,4,3,"PACMA",4
44,"44183",77,50,49,0,1,"PACMA",0
31,"31097",10410,7082,7002,75,80,"PACMA",48
9,"9131",462,365,364,2,1,"PACMA",3
26,"26084",6696,5012,4955,35,57,"PACMA",70
9,"9047",54,47,46,1,1,"PACMA",0
49,"49204",63,51,51,0,0,"PACMA",0
31,"31264",180,105,101,2,4,"PACMA",0
50,"50010",68,58,58,0,0,"PACMA",0
34,"34147",166,118,117,0,1,"PACMA",0
10,"10044",1428,1040,1025,5,15,"PACMA",7
31,"31065",1878,1351,1326,20,25,"PACMA",4
3,"3086",151,135,134,1,1,"PACMA",3
5,"5046",44,38,38,1,0,"PACMA",0
41,"41102",14655,10183,9919,142,264,"PACMA",88
18,"18187",557,383,379,0,4,"PACMA",3
25,"25123",193,134,131,2,3,"PACMA",0
29,"29030",805,620,614,4,6,"PACMA",3
22,"22248",116,92,90,1,2,"PACMA",0
41,"41014",2492,1882,1852,11,30,"PACMA",5
50,"50105",296,214,211,1,3,"PACMA",1
33,"33023",3321,2299,2265,31,34,"PACMA",14
10,"10045",1019,762,755,3,7,"PACMA",1
45,"45120",129,104,104,1,0,"PACMA",0
9,"9050",68,56,55,1,1,"PACMA",1
45,"45020",1290,1037,1026,6,11,"PACMA",3
4,"4072",313,247,245,2,2,"PACMA",0
23,"23021",524,431,429,0,2,"PACMA",0
9,"9011",65,48,48,0,0,"PACMA",0
5,"5048",118,104,104,0,0,"PACMA",0
50,"50106",134,104,104,0,0,"PACMA",1
16,"16195",497,392,390,1,2,"PACMA",2
40,"40134",731,579,570,1,9,"PACMA",4
46,"46247",1006,714,710,3,4,"PACMA",5
9,"9090",54,48,48,0,0,"PACMA",0
40,"40007",78,63,61,0,2,"PACMA",0
21,"21007",6225,4080,3999,52,81,"PACMA",27
47,"47203",62,53,53,1,0,"PACMA",0
37,"37344",241,175,174,2,1,"PACMA",1
24,"24901",889,636,623,5,13,"PACMA",2
45,"45022",391,285,281,3,4,"PACMA",3
37,"37089",67,56,56,0,0,"PACMA",2
37,"37260",150,116,116,1,0,"PACMA",0
10,"10185",571,409,405,2,4,"PACMA",1
40,"40136",112,88,87,0,1,"PACMA",1
27,"27020",3524,2816,2761,28,55,"PACMA",20
45,"45122",5212,4004,3961,16,43,"PACMA",42
3,"3122",42425,30153,29954,154,199,"PACMA",486
19,"19020",44,30,30,1,0,"PACMA",1
50,"50294",70,63,63,0,0,"PACMA",1
22,"22170",651,498,491,5,7,"PACMA",6
18,"18193",14343,9951,9847,93,104,"PACMA",172
46,"46092",276,192,189,0,3,"PACMA",3
49,"49180",148,103,102,2,1,"PACMA",0
40,"40009",49,43,43,0,0,"PACMA",0
25,"25127",210,136,136,2,0,"PACMA",0
4,"4044",1547,1166,1156,5,10,"PACMA",7
19,"19332",92,71,69,1,2,"PACMA",0
22,"22172",556,372,370,6,2,"PACMA",0
45,"45156",3410,2751,2711,13,40,"PACMA",14
2,"2045",3665,2895,2855,21,40,"PACMA",21
19,"19255",79,63,61,1,2,"PACMA",1
12,"12127",75,55,55,0,0,"PACMA",0
45,"45157",2128,1456,1427,13,29,"PACMA",9
44,"44086",449,342,336,3,6,"PACMA",1
41,"41018",9480,6523,6455,53,68,"PACMA",61
6,"6068",446,347,345,5,2,"PACMA",2
9,"9136",192,142,137,2,5,"PACMA",2
18,"18056",3530,2641,2614,24,27,"PACMA",16
48,"48060",3634,2143,2134,7,9,"PACMA",2
22,"22173",232,152,152,3,0,"PACMA",5
37,"37179",209,180,180,0,0,"PACMA",0
7,"7037",3197,1934,1917,26,17,"PACMA",17
24,"24132",615,379,375,1,4,"PACMA",1
19,"19334",35,31,31,0,0,"PACMA",0
49,"49052",187,133,132,1,1,"PACMA",0
42,"42132",141,114,114,0,0,"PACMA",1
49,"49172",527,347,343,1,4,"PACMA",0
18,"18057",5305,3827,3791,27,36,"PACMA",53
23,"23028",6220,4409,4369,23,40,"PACMA",41
50,"50174",91,69,68,0,1,"PACMA",0
46,"46094",20540,15378,15234,102,144,"PACMA",223
37,"37223",110,85,83,0,2,"PACMA",0
47,"47043",297,239,237,0,2,"PACMA",0
9,"9412",790,528,523,4,5,"PACMA",1
44,"44088",29,21,21,0,0,"PACMA",0
5,"5056",96,76,76,0,0,"PACMA",0
50,"50016",52,40,40,0,0,"PACMA",0
37,"37097",39,27,27,1,0,"PACMA",0
31,"31072",5279,3734,3679,40,55,"PACMA",33
9,"9098",507,369,362,5,7,"PACMA",1
31,"31105",1507,1167,1142,7,25,"PACMA",6
16,"16264",435,366,364,2,2,"PACMA",1
28,"28131",12990,9512,9433,38,79,"PACMA",104
9,"9413",436,306,302,2,4,"PACMA",2
12,"12130",404,340,335,0,5,"PACMA",1
34,"34066",59,49,48,0,1,"PACMA",0
28,"28063",258,194,193,1,1,"PACMA",3
19,"19901",41,38,37,0,1,"PACMA",0
5,"5058",78,49,48,0,1,"PACMA",0
49,"49174",125,95,92,1,3,"PACMA",0
25,"25905",375,249,246,3,3,"PACMA",9
3,"3127",350,278,273,1,5,"PACMA",2
37,"37182",75,56,55,0,1,"PACMA",1
11,"11011",1716,1195,1165,12,30,"PACMA",14
40,"40143",86,75,74,0,1,"PACMA",0
41,"41022",4290,2889,2851,21,38,"PACMA",11
9,"9019",150,92,90,0,2,"PACMA",1
27,"27030",3327,2207,2159,31,48,"PACMA",28
45,"45028",3649,2701,2673,12,28,"PACMA",17
12,"12034",1424,1065,1035,3,30,"PACMA",4
9,"9141",616,485,483,5,2,"PACMA",4
23,"23031",747,637,619,0,18,"PACMA",4
31,"31085",480,350,350,2,0,"PACMA",1
9,"9231",69,38,38,1,0,"PACMA",0
46,"46096",274,209,209,1,0,"PACMA",1
19,"19225",823,623,619,3,4,"PACMA",8
49,"49175",230,172,171,1,1,"PACMA",0
50,"50208",1774,1207,1195,10,12,"PACMA",9
44,"44052",77,56,56,0,0,"PACMA",0
10,"10057",143,117,117,1,0,"PACMA",0
25,"25908",226,144,143,3,1,"PACMA",1
25,"25007",1405,850,841,8,9,"PACMA",18
4,"4050",800,558,553,3,5,"PACMA",1
45,"45163",8298,5942,5855,28,87,"PACMA",40
25,"25134",623,369,366,3,3,"PACMA",0
9,"9416",53,35,35,0,0,"PACMA",1
34,"34069",2266,1666,1637,11,29,"PACMA",8
10,"10058",1021,718,708,2,10,"PACMA",4
49,"49099",115,87,87,0,0,"PACMA",0
50,"50051",816,616,614,2,2,"PACMA",1
50,"50240",1025,729,718,10,11,"PACMA",1
35,"35007",511,316,309,2,7,"PACMA",2
46,"46261",1725,1356,1337,5,19,"PACMA",9
28,"28106",76907,52773,52265,385,508,"PACMA",1018
48,"48096",6577,4794,4728,31,66,"PACMA",39
49,"49058",307,237,233,0,4,"PACMA",0
7,"7044",8439,5681,5543,48,138,"PACMA",61
45,"45131",282,234,230,0,4,"PACMA",1
34,"34220",147,126,125,3,1,"PACMA",1
23,"23034",2540,1957,1934,14,23,"PACMA",6
37,"37230",221,159,159,2,0,"PACMA",1
23,"23072",1986,1542,1530,7,12,"PACMA",6
10,"10197",123,90,89,0,1,"PACMA",0
47,"47075",4856,3681,3637,24,44,"PACMA",12
47,"47048",188,144,144,1,0,"PACMA",0
3,"3006",497,384,380,1,4,"PACMA",3
19,"19116",12,9,9,0,0,"PACMA",0
19,"19228",26,20,20,0,0,"PACMA",1
20,"20005",1260,738,736,11,2,"PACMA",9
39,"39027",3118,2322,2295,26,27,"PACMA",13
27,"27037",1065,750,740,11,10,"PACMA",1
18,"18114",609,424,422,8,2,"PACMA",1
50,"50150",649,402,397,2,5,"PACMA",3
42,"42012",35,28,28,0,0,"PACMA",0
37,"37012",154,116,115,1,1,"PACMA",0
37,"37056",37,30,29,0,1,"PACMA",0
49,"49102",196,143,139,2,4,"PACMA",0
11,"11015",62476,38177,37875,488,302,"PACMA",700
21,"21020",365,223,222,1,1,"PACMA",0
47,"47131",170,134,128,2,6,"PACMA",0
19,"19076",27,19,19,0,0,"PACMA",0
16,"16215",242,172,169,2,3,"PACMA",0
20,"20006",259,143,143,3,0,"PACMA",4
19,"19230",505,360,357,3,3,"PACMA",10
50,"50212",40,36,36,0,0,"PACMA",1
25,"25181",172,123,120,4,3,"PACMA",1
37,"37148",427,298,295,3,3,"PACMA",1
4,"4084",341,249,247,2,2,"PACMA",3
25,"25051",1527,931,920,11,11,"PACMA",7
34,"34223",218,155,155,1,0,"PACMA",0
16,"16023",469,335,335,2,0,"PACMA",2
16,"16131",130,100,97,2,3,"PACMA",0
47,"47168",29,26,26,1,0,"PACMA",1
47,"47006",190,136,135,1,1,"PACMA",0
47,"47159",822,644,636,1,8,"PACMA",0
31,"31180",212,154,154,5,0,"PACMA",0
10,"10064",1476,1092,1072,7,20,"PACMA",3
12,"12041",100,81,81,0,0,"PACMA",1
46,"46023",327,280,278,2,2,"PACMA",11
44,"44059",544,425,412,9,13,"PACMA",1
7,"7049",1480,1003,993,14,10,"PACMA",15
18,"18117",506,383,373,1,10,"PACMA",1
34,"34123",1648,1287,1258,12,29,"PACMA",2
31,"31081",338,216,212,4,4,"PACMA",0
24,"24144",695,470,465,2,5,"PACMA",4
33,"33068",1093,645,641,4,4,"PACMA",3
48,"48904",3511,2625,2600,22,25,"PACMA",22
11,"11019",1826,1302,1248,7,54,"PACMA",11
44,"44132",60,54,54,1,0,"PACMA",0
47,"47214",1409,1087,1062,7,25,"PACMA",1
45,"45036",656,471,469,2,2,"PACMA",2
28,"28169",1448,1122,1113,5,9,"PACMA",6
16,"16278",70,55,55,0,0,"PACMA",0
37,"37151",148,125,124,2,1,"PACMA",0
18,"18914",1649,1238,1213,3,25,"PACMA",12
31,"31082",617,371,365,10,6,"PACMA",0
40,"40154",20,15,15,0,0,"PACMA",0
9,"9424",36,29,29,1,0,"PACMA",0
37,"37152",418,290,286,2,4,"PACMA",3
28,"28111",596,467,467,3,0,"PACMA",3
26,"26069",236,194,189,0,5,"PACMA",1
1,"1049",138,109,109,1,0,"PACMA",0
3,"3041",5954,4218,4194,22,24,"PACMA",36
5,"5073",297,253,252,2,1,"PACMA",2
24,"24146",265,210,207,1,3,"PACMA",0
46,"46025",2499,1953,1934,8,19,"PACMA",38
19,"19121",246,199,194,1,5,"PACMA",0
46,"46103",1264,1015,984,7,31,"PACMA",3
49,"49231",330,232,232,2,0,"PACMA",0
22,"22023",421,313,309,6,4,"PACMA",1
24,"24012",290,207,205,1,2,"PACMA",0
9,"9113",449,339,332,4,7,"PACMA",0
40,"40196",30,25,25,0,0,"PACMA",0
9,"9030",112,75,73,1,2,"PACMA",1
33,"33039",1655,1223,1209,12,14,"PACMA",5
10,"10069",838,626,615,2,11,"PACMA",2
42,"42019",516,363,356,3,7,"PACMA",2
44,"44103",132,102,102,1,0,"PACMA",0
50,"50123",449,334,331,1,3,"PACMA",1
50,"50217",446,342,342,1,0,"PACMA",1
33,"33009",905,611,609,3,2,"PACMA",5
4,"4088",2454,1660,1650,15,10,"PACMA",6
47,"47027",2745,2036,2018,9,18,"PACMA",13
45,"45184",200,129,129,0,0,"PACMA",6
10,"10209",282,179,177,1,2,"PACMA",1
26,"26005",2381,1598,1577,23,21,"PACMA",13
34,"34230",15,12,12,0,0,"PACMA",0
7,"7054",22334,12814,12708,99,106,"PACMA",205
48,"48074",3312,2330,2309,6,21,"PACMA",10
37,"37241",168,131,131,1,0,"PACMA",2
34,"34143",168,123,120,2,3,"PACMA",0
46,"46131",49431,36570,36227,231,343,"PACMA",510
22,"22193",276,225,224,2,1,"PACMA",2
23,"23045",2132,1260,1247,5,13,"PACMA",7
6,"6136",1565,1131,1102,11,29,"PACMA",6
47,"47082",812,640,628,8,12,"PACMA",0
18,"18078",732,570,566,2,4,"PACMA",2
5,"5078",115,91,89,1,2,"PACMA",0
28,"28075",5621,4186,4148,26,38,"PACMA",90
50,"50125",360,248,246,3,2,"PACMA",0
5,"5222",147,127,126,1,1,"PACMA",0
33,"33042",4306,2988,2970,35,18,"PACMA",29
42,"42156",28,16,16,1,0,"PACMA",0
50,"50030",215,141,140,1,1,"PACMA",0
47,"47055",203,167,163,0,4,"PACMA",1
31,"31087",171,128,124,2,4,"PACMA",0
50,"50251",8262,5946,5872,44,74,"PACMA",33
46,"46210",330,277,277,2,0,"PACMA",6
37,"37023",1413,1072,1060,5,12,"PACMA",9
38,"38023",121908,81147,80333,494,814,"PACMA",1716
46,"46184",26505,20428,20223,115,205,"PACMA",250
25,"25061",83,46,46,0,0,"PACMA",1
26,"26110",152,131,129,0,2,"PACMA",0
39,"39036",969,743,739,2,4,"PACMA",6
7,"7057",7169,4719,4659,47,60,"PACMA",58
34,"34233",130,107,107,1,0,"PACMA",1
20,"20048",182,100,98,2,2,"PACMA",3
27,"27052",915,676,667,6,9,"PACMA",2
9,"9480",110,90,90,1,0,"PACMA",1
50,"50063",61,51,51,0,0,"PACMA",0
45,"45042",187,140,140,0,0,"PACMA",1
6,"6094",1485,929,926,2,3,"PACMA",2
4,"4062",4504,3534,3490,18,44,"PACMA",12
47,"47140",115,102,102,1,0,"PACMA",0
49,"49191",272,213,206,2,7,"PACMA",0
28,"28078",38,32,32,0,0,"PACMA",1
27,"27054",1190,881,860,9,21,"PACMA",2
2,"2028",126,98,98,0,0,"PACMA",0
46,"46056",182,167,166,1,1,"PACMA",0
40,"40162",392,303,302,1,1,"PACMA",1
49,"49115",184,136,135,0,1,"PACMA",0
26,"26111",242,180,176,0,4,"PACMA",4
50,"50221",35,17,17,0,0,"PACMA",0
9,"9167",58,41,41,1,0,"PACMA",0
40,"40121",280,226,218,3,8,"PACMA",1
29,"29054",41997,28422,28238,189,184,"PACMA",420
50,"50033",66,49,48,0,1,"PACMA",0
45,"45177",2110,1679,1656,3,23,"PACMA",10
47,"47085",16612,11829,11706,114,123,"PACMA",76
26,"26043",365,292,281,1,11,"PACMA",2
44,"44209",833,611,602,6,9,"PACMA",1
48,"48079",427,305,304,2,1,"PACMA",3
24,"24154",1005,673,666,4,7,"PACMA",0
45,"45045",1318,905,888,5,17,"PACMA",7
40,"40163",53,44,43,0,1,"PACMA",0
6,"6142",273,205,197,2,8,"PACMA",2
9,"9213",307,220,218,2,2,"PACMA",1
23,"23091",729,555,553,5,2,"PACMA",0
37,"37372",144,111,108,0,3,"PACMA",0
39,"39049",322,229,229,0,0,"PACMA",1
16,"16101",154,132,132,0,0,"PACMA",0
11,"11006",24455,15750,15587,193,163,"PACMA",150
50,"50034",826,567,563,5,4,"PACMA",2
37,"37028",147,116,112,0,4,"PACMA",0
33,"33076",12258,8106,8031,63,75,"PACMA",63
12,"12085",4976,3236,3209,16,27,"PACMA",35
20,"20019",9986,6428,6392,48,36,"PACMA",45
3,"3113",4243,3091,3046,10,45,"PACMA",26
19,"19172",57,48,47,0,1,"PACMA",0
45,"45180",2727,1966,1940,9,26,"PACMA",17
37,"37123",177,126,126,0,0,"PACMA",0
50,"50098",174,130,124,0,6,"PACMA",0
18,"18087",184857,134428,133526,864,902,"PACMA",1505
47,"47060",258,216,214,1,2,"PACMA",1
29,"29056",1098,757,750,5,7,"PACMA",6
31,"31092",662,439,435,4,4,"PACMA",0
10,"10219",1276,796,790,7,6,"PACMA",1
27,"27059",2163,1570,1543,17,27,"PACMA",9
37,"37334",76,48,48,1,0,"PACMA",0
16,"16041",358,275,271,0,4,"PACMA",0
9,"9437",282,219,218,3,1,"PACMA",1
28,"28150",3087,2294,2277,10,17,"PACMA",19
10,"10083",90,59,59,2,0,"PACMA",1
20,"20020",125,71,69,3,2,"PACMA",0
22,"22203",83,67,67,1,0,"PACMA",0
37,"37251",124,93,92,1,1,"PACMA",0
6,"6010",1105,819,801,5,18,"PACMA",6
44,"44112",429,290,290,2,0,"PACMA",0
6,"6101",463,381,378,2,3,"PACMA",1
22,"22074",313,228,225,4,3,"PACMA",1
9,"9172",129,103,101,1,2,"PACMA",1
9,"9438",538,437,433,6,4,"PACMA",2
26,"26014",474,327,324,1,3,"PACMA",1
25,"25070",823,554,549,15,5,"PACMA",2
3,"3052",970,769,755,8,14,"PACMA",9
42,"42208",22,13,13,2,0,"PACMA",0
49,"49082",359,304,301,6,3,"PACMA",0
34,"34094",64,45,44,0,1,"PACMA",0
34,"34242",95,71,68,3,3,"PACMA",0
41,"41042",5844,4424,4378,40,46,"PACMA",21
16,"16043",95,73,73,1,0,"PACMA",0
37,"37080",225,171,167,0,4,"PACMA",0
40,"40043",1802,1400,1381,8,19,"PACMA",5
16,"16188",91,65,65,0,0,"PACMA",1
42,"42032",146,118,118,0,0,"PACMA",0
39,"39043",1481,1122,1115,9,7,"PACMA",15
48,"48083",6958,4885,4856,40,29,"PACMA",47
50,"50069",73,53,53,1,0,"PACMA",0
42,"42211",82,66,66,1,0,"PACMA",0
16,"16139",335,256,255,2,1,"PACMA",0
46,"46259",491,396,393,4,3,"PACMA",3
1,"1022",799,557,544,2,13,"PACMA",5
10,"10087",1687,1218,1212,6,6,"PACMA",4
47,"47063",103,81,80,1,1,"PACMA",1
9,"9045",268,181,181,4,0,"PACMA",0
5,"5092",152,125,122,0,3,"PACMA",0
16,"16045",222,172,171,1,1,"PACMA",0
37,"37129",251,204,201,3,3,"PACMA",0
49,"49098",219,167,165,0,2,"PACMA",0
47,"47226",156,123,123,0,0,"PACMA",0
25,"25073",582,328,324,8,4,"PACMA",3
34,"34005",851,673,658,4,15,"PACMA",6
9,"9084",186,136,135,4,1,"PACMA",0
49,"49004",126,100,100,4,0,"PACMA",1
25,"25206",260,150,150,5,0,"PACMA",0
16,"16095",83,64,63,0,1,"PACMA",0
9,"9442",375,279,277,2,2,"PACMA",1
40,"40045",109,85,85,2,0,"PACMA",3
50,"50260",33,33,32,0,1,"PACMA",0
18,"18005",372,262,258,0,4,"PACMA",1
44,"44149",103,78,78,3,0,"PACMA",0
31,"31130",312,214,213,3,1,"PACMA",0
10,"10181",686,533,523,1,10,"PACMA",0
28,"28154",5408,3806,3767,16,39,"PACMA",46
23,"23019",1536,1196,1174,2,22,"PACMA",1
12,"12092",111,91,90,0,1,"PACMA",1
49,"49086",115,96,91,0,5,"PACMA",0
25,"25164",376,242,238,4,4,"PACMA",1
49,"49087",521,322,318,0,4,"PACMA",0
30,"30901",10309,7821,7718,43,103,"PACMA",79
45,"45153",1615,1258,1243,7,15,"PACMA",5
26,"26019",355,274,271,1,3,"PACMA",3
50,"50231",250,195,192,4,3,"PACMA",1
37,"37257",52,46,46,0,0,"PACMA",0
47,"47064",33,28,25,0,3,"PACMA",0
47,"47227",61,50,50,0,0,"PACMA",2
47,"47174",267,218,215,1,3,"PACMA",3
31,"31033",49,31,31,1,0,"PACMA",0
21,"21045",249,180,178,3,2,"PACMA",0
23,"23101",378,276,271,1,5,"PACMA",1
5,"5241",3063,2056,2032,15,24,"PACMA",27
19,"19329",59,50,50,1,0,"PACMA",1
47,"47065",857,674,669,1,5,"PACMA",1
44,"44118",164,132,131,2,1,"PACMA",0
6,"6109",3919,3139,3012,24,127,"PACMA",10
34,"34010",577,440,438,5,2,"PACMA",1
47,"47175",6564,4781,4728,39,53,"PACMA",38
49,"49090",197,143,141,6,2,"PACMA",1
13,"13070",760,583,574,11,9,"PACMA",2
26,"26053",208,168,163,4,5,"PACMA",0
31,"31234",144,106,106,4,0,"PACMA",0
3,"3028",998,818,812,2,6,"PACMA",6
26,"26161",8,7,7,0,0,"PACMA",0
45,"45055",1020,821,790,6,31,"PACMA",3
28,"28157",609,433,430,1,3,"PACMA",7
34,"34904",315,234,230,2,4,"PACMA",1
22,"22212",79,64,62,0,2,"PACMA",1
10,"10139",114,82,78,1,4,"PACMA",0
1,"1031",1169,882,863,6,19,"PACMA",7
7,"7033",27104,15524,15337,174,187,"PACMA",217
40,"40178",98,73,71,1,2,"PACMA",0
5,"5244",50,39,39,1,0,"PACMA",0
44,"44153",1774,1135,1121,5,14,"PACMA",3
19,"19060",146,119,118,1,1,"PACMA",4
41,"41050",5150,3817,3777,19,40,"PACMA",31
26,"26125",2699,1931,1907,23,24,"PACMA",6
45,"45056",2201,1260,1243,12,17,"PACMA",17
18,"18911",7473,5098,5035,51,63,"PACMA",67
29,"29077",199,149,146,2,3,"PACMA",0
50,"50223",920,712,701,4,11,"PACMA",0
40,"40179",626,503,493,2,10,"PACMA",3
3,"3059",20583,15125,15018,63,107,"PACMA",197
10,"10096",3408,2440,2391,12,49,"PACMA",14
42,"42176",29,25,25,0,0,"PACMA",0
16,"16149",148,124,122,2,2,"PACMA",3
25,"25182",1036,660,655,9,5,"PACMA",5
16,"16010",152,115,112,0,3,"PACMA",0
49,"49093",280,223,222,1,1,"PACMA",0
46,"46249",9288,6746,6676,56,70,"PACMA",53
16,"16259",29,22,21,0,1,"PACMA",0
9,"9054",101,68,66,1,2,"PACMA",1
31,"31004",35,21,21,0,0,"PACMA",1
9,"9182",80,69,67,1,2,"PACMA",0
5,"5103",72,52,52,0,0,"PACMA",0
25,"25041",568,347,344,4,3,"PACMA",10
18,"18102",8400,5592,5504,44,88,"PACMA",48
45,"45024",1062,793,785,4,8,"PACMA",3
29,"29001",4170,3106,3068,19,38,"PACMA",26
45,"45192",2491,2069,2049,2,20,"PACMA",11
49,"49094",224,149,149,2,0,"PACMA",0
9,"9055",52,42,41,1,1,"PACMA",0
42,"42042",45,35,35,0,0,"PACMA",0
40,"40182",178,133,130,2,3,"PACMA",2
41,"41053",21259,15147,14853,132,294,"PACMA",129
16,"16104",51,41,41,0,0,"PACMA",0
49,"49216",162,142,142,0,0,"PACMA",0
37,"37096",214,166,163,2,3,"PACMA",0
22,"22012",111,87,86,3,1,"PACMA",1
31,"31204",36,28,28,1,0,"PACMA",0
26,"26128",105,81,81,1,0,"PACMA",1
45,"45159",90,75,75,0,0,"PACMA",0
47,"47153",108,77,77,0,0,"PACMA",0
3,"3125",343,254,251,0,3,"PACMA",1
24,"24167",750,505,499,4,6,"PACMA",2
40,"40056",34,28,28,1,0,"PACMA",0
16,"16265",20,19,19,0,0,"PACMA",0
19,"19151",1064,744,726,1,18,"PACMA",6
10,"10008",1319,1019,1008,6,11,"PACMA",2
18,"18106",425,293,290,0,3,"PACMA",1
3,"3032",108,91,90,1,1,"PACMA",0
29,"29004",312,236,233,2,3,"PACMA",4
39,"39052",18236,13537,13380,110,157,"PACMA",166
21,"21054",8100,5656,5571,46,85,"PACMA",58
41,"41054",692,560,546,3,14,"PACMA",4
12,"12068",48,36,35,1,1,"PACMA",0
33,"33060",14633,9647,9474,72,173,"PACMA",80
18,"18107",943,663,655,1,8,"PACMA",3
37,"37141",154,122,122,2,0,"PACMA",1
34,"34022",1082,873,861,9,12,"PACMA",5
30,"30021",9099,6095,6045,20,50,"PACMA",33
19,"19001",49,42,42,0,0,"PACMA",0
38,"38009",4127,2915,2868,20,47,"PACMA",40
6,"6073",733,496,484,8,12,"PACMA",4
12,"12069",66,49,48,0,1,"PACMA",0
46,"46122",2704,2082,2063,10,19,"PACMA",25
28,"28162",2617,2029,2016,6,13,"PACMA",25
21,"21056",2895,1990,1906,18,84,"PACMA",14
25,"25045",57,40,40,0,0,"PACMA",1
47,"47081",45,36,35,1,1,"PACMA",0
48,"48907",348,266,266,2,0,"PACMA",0
10,"10164",737,484,475,3,9,"PACMA",0
46,"46209",1933,1445,1415,5,30,"PACMA",12
28,"28133",5979,4140,4098,18,42,"PACMA",44
35,"35006",30457,21398,21118,162,280,"PACMA",297
40,"40186",42,29,29,0,0,"PACMA",0
25,"25133",706,432,427,8,5,"PACMA",0
34,"34113",38,36,36,0,0,"PACMA",0
49,"49222",380,279,272,0,7,"PACMA",0
9,"9059",136488,101469,100463,907,1006,"PACMA",956
48,"48095",2347,1555,1546,12,9,"PACMA",8
45,"45197",1906,1455,1430,8,25,"PACMA",10
46,"46097",963,733,728,4,5,"PACMA",10
10,"10104",5119,3633,3585,15,48,"PACMA",36
28,"28164",2993,2183,2168,8,15,"PACMA",23
6,"6076",831,611,607,2,4,"PACMA",4
24,"24005",378,260,257,2,3,"PACMA",2
47,"47182",1323,977,967,8,10,"PACMA",7
16,"16157",211,179,179,2,0,"PACMA",1
18,"18021",17485,11800,11669,95,131,"PACMA",179
3,"3036",87,81,78,0,3,"PACMA",1
16,"16064",684,568,562,4,6,"PACMA",4
5,"5258",111,95,95,0,0,"PACMA",0
22,"22222",530,384,379,3,5,"PACMA",4
31,"31010",5705,3718,3680,29,38,"PACMA",30
41,"41058",17395,12556,12332,111,224,"PACMA",188
9,"9456",130,97,96,0,1,"PACMA",0
34,"34116",62,49,49,0,0,"PACMA",0
31,"31143",96,55,54,1,1,"PACMA",0
49,"49224",162,112,112,1,0,"PACMA",3
19,"19034",22,16,16,0,0,"PACMA",0
50,"50180",119,99,99,2,0,"PACMA",1
29,"29097",4108,2871,2821,37,50,"PACMA",17
34,"34167",113,94,94,0,0,"PACMA",0
24,"24104",259,169,169,0,0,"PACMA",1
21,"21060",11957,7356,7279,88,77,"PACMA",117
46,"46047",532,446,437,2,9,"PACMA",8
20,"20038",387,261,259,0,2,"PACMA",1
13,"13036",799,601,595,2,6,"PACMA",6
5,"5064",103,83,82,0,1,"PACMA",0
18,"18909",579,435,429,0,6,"PACMA",0
24,"24173",951,679,674,9,5,"PACMA",3
10,"10199",165,112,111,1,1,"PACMA",0
26,"26100",49,44,43,0,1,"PACMA",0
13,"13088",610,458,453,6,5,"PACMA",0
39,"39068",646,450,445,2,5,"PACMA",7
49,"49103",414,330,328,5,2,"PACMA",3
9,"9105",109,86,81,1,5,"PACMA",1
25,"25240",1383,925,919,16,6,"PACMA",10
9,"9196",149,103,103,1,0,"PACMA",0
45,"45067",2318,1791,1752,19,39,"PACMA",6
9,"9063",209,168,167,2,1,"PACMA",3
5,"5117",200,174,173,1,1,"PACMA",0
42,"42095",1773,1269,1251,15,18,"PACMA",7
45,"45201",3447,2082,2050,9,32,"PACMA",29
49,"49142",249,180,179,0,1,"PACMA",1
39,"39028",3739,2850,2817,16,33,"PACMA",30
28,"28167",8356,6158,6106,46,52,"PACMA",121
19,"19171",4961,3670,3628,27,42,"PACMA",45
5,"5149",106,77,77,1,0,"PACMA",0
42,"42218",82,55,55,0,0,"PACMA",0
10,"10217",526,404,402,1,2,"PACMA",0
42,"42015",30,20,19,1,1,"PACMA",0
20,"20040",15289,9444,9373,66,71,"PACMA",62
19,"19266",236,188,188,1,0,"PACMA",0
50,"50245",88,65,64,0,1,"PACMA",0
10,"10172",709,466,465,0,1,"PACMA",2
3,"3009",46657,35143,34801,223,342,"PACMA",494
44,"44099",709,465,462,3,3,"PACMA",4
46,"46179",2165,1760,1737,16,23,"PACMA",15
49,"49035",226,200,196,3,4,"PACMA",0
2,"2059",302,234,232,1,2,"PACMA",0
49,"49105",150,109,108,0,1,"PACMA",0
44,"44131",25,20,20,0,0,"PACMA",2
45,"45102",3610,2506,2470,14,36,"PACMA",12
40,"40110",349,265,263,3,2,"PACMA",1
25,"25014",260,165,165,5,0,"PACMA",0
21,"21024",492,338,326,6,12,"PACMA",0
46,"46128",1597,1290,1250,5,40,"PACMA",7
13,"13041",244,170,165,1,5,"PACMA",0
16,"16165",61,54,53,0,1,"PACMA",1
38,"38901",1405,900,887,3,13,"PACMA",4
12,"12076",84,69,69,0,0,"PACMA",1
24,"24177",476,325,322,3,3,"PACMA",3
23,"23079",3717,2825,2801,28,24,"PACMA",10
31,"31215",4676,3284,3240,36,44,"PACMA",30
24,"24078",380,289,277,0,12,"PACMA",2
50,"50185",133,108,108,1,0,"PACMA",0
37,"37237",324,244,240,1,4,"PACMA",2
19,"19197",27,22,22,0,0,"PACMA",0
23,"23080",1762,1332,1322,4,10,"PACMA",4
47,"47215",53,45,45,0,0,"PACMA",0
25,"25101",561,364,358,2,6,"PACMA",4
46,"46207",6676,5106,5040,41,66,"PACMA",75
24,"24178",70,59,58,0,1,"PACMA",0
28,"28080",48554,38885,38691,164,194,"PACMA",325
18,"18121",129,98,98,1,0,"PACMA",0
18,"18030",576,413,409,6,4,"PACMA",1
10,"10023",835,616,607,2,9,"PACMA",1
34,"34034",123,95,95,1,0,"PACMA",1
28,"28180",5251,3927,3893,7,34,"PACMA",33
23,"23002",17428,12820,12644,70,176,"PACMA",108
40,"40112",2555,1932,1909,8,23,"PACMA",20
45,"45072",671,484,483,2,1,"PACMA",5
12,"12078",325,235,233,0,2,"PACMA",2
31,"31018",393,292,285,4,7,"PACMA",3
41,"41066",1342,945,927,2,18,"PACMA",3
23,"23082",1921,1425,1416,8,9,"PACMA",4
44,"44029",559,425,424,5,1,"PACMA",1
24,"24046",942,637,633,5,4,"PACMA",3
47,"47106",50,39,39,0,0,"PACMA",0
26,"26154",13,10,10,0,0,"PACMA",0
3,"3116",1155,877,875,6,2,"PACMA",4
50,"50297",498961,362043,359558,2748,2485,"PACMA",3854
16,"16030",24,19,19,0,0,"PACMA",0
21,"21068",998,605,592,11,13,"PACMA",4
6,"6043",665,490,484,2,6,"PACMA",8
25,"25059",805,527,523,7,4,"PACMA",2
33,"33071",595,433,430,10,3,"PACMA",3
37,"37035",190,150,150,2,0,"PACMA",0
24,"24123",746,488,485,2,3,"PACMA",2
22,"22003",137,110,107,1,3,"PACMA",3
18,"18184",2168,1629,1607,13,22,"PACMA",12
46,"46235",21579,15929,15763,113,166,"PACMA",192
9,"9032",109,75,73,0,2,"PACMA",0
37,"37365",172,134,133,1,1,"PACMA",0
37,"37022",268,215,215,2,0,"PACMA",0
50,"50157",290,220,218,3,2,"PACMA",2
13,"13902",469,367,363,0,4,"PACMA",0
38,"38022",18450,12334,12160,62,174,"PACMA",136
22,"22106",22,14,14,0,0,"PACMA",0
46,"46054",11293,8477,8409,47,68,"PACMA",108
37,"37158",246,183,183,0,0,"PACMA",0
35,"35015",9950,5139,5070,29,69,"PACMA",58
9,"9072",316,242,241,0,1,"PACMA",3
2,"2066",234,189,187,1,2,"PACMA",0
10,"10120",171,121,117,1,4,"PACMA",1
39,"39096",690,487,479,4,8,"PACMA",1
16,"16081",48,34,34,0,0,"PACMA",0
31,"31186",299,195,194,3,1,"PACMA",2
23,"23046",2391,1916,1895,6,21,"PACMA",12
3,"3056",8676,6638,6541,34,97,"PACMA",75
42,"42200",81,59,58,2,1,"PACMA",0
25,"25192",743,449,436,2,13,"PACMA",1
1,"1055",838,538,527,8,11,"PACMA",2
44,"44065",60,40,40,0,0,"PACMA",0
6,"6138",1047,727,715,5,12,"PACMA",4
49,"49075",137,120,119,0,1,"PACMA",0
45,"45076",553,368,364,3,4,"PACMA",2
44,"44107",218,152,152,5,0,"PACMA",2
40,"40120",192,170,166,0,4,"PACMA",1
47,"47083",80,59,54,1,5,"PACMA",1
28,"28174",1795,1232,1221,7,11,"PACMA",14
2,"2068",337,251,246,1,5,"PACMA",1
34,"34181",448,322,319,7,3,"PACMA",4
19,"19277",19,13,13,0,0,"PACMA",0
31,"31222",62,36,34,3,2,"PACMA",0
18,"18128",343,270,269,1,1,"PACMA",3
49,"49032",326,259,259,1,0,"PACMA",0
24,"24051",423,309,307,0,2,"PACMA",6
9,"9211",1441,1056,1039,9,17,"PACMA",1
22,"22199",7000,4737,4688,104,49,"PACMA",41
5,"5227",358,253,250,1,3,"PACMA",1
12,"12050",1305,1015,1000,6,15,"PACMA",5
42,"42025",1189,844,833,2,11,"PACMA",3
42,"42080",157,117,115,0,2,"PACMA",1
47,"47005",549,413,408,2,5,"PACMA",4
37,"37072",168,140,138,0,2,"PACMA",1
23,"23902",2320,1867,1847,4,20,"PACMA",7
19,"19129",28,26,26,0,0,"PACMA",0
33,"33015",1540,998,986,8,12,"PACMA",1
50,"50094",1617,1173,1159,12,14,"PACMA",11
42,"42204",54,38,38,1,0,"PACMA",0
28,"28176",12491,9723,9667,37,56,"PACMA",118
13,"13055",665,487,484,2,3,"PACMA",1
3,"3079",18224,13904,13709,80,195,"PACMA",168
37,"37073",586,448,438,2,10,"PACMA",2
48,"48048",557,395,393,5,2,"PACMA",2
46,"46222",384,307,304,1,3,"PACMA",1
37,"37014",1155,817,808,7,9,"PACMA",1
44,"44143",380,307,306,2,1,"PACMA",5
29,"29033",1122,747,730,4,17,"PACMA",8
6,"6006",4572,3088,3049,26,39,"PACMA",14
5,"5133",66,53,53,0,0,"PACMA",1
28,"28119",2092,1590,1582,12,8,"PACMA",20
14,"14004",2034,1531,1518,14,13,"PACMA",8
49,"49169",35,26,26,0,0,"PACMA",0
13,"13057",1147,961,954,1,7,"PACMA",3
49,"49240",206,162,161,2,1,"PACMA",0
42,"42116",45,39,38,3,1,"PACMA",0
1,"1059",186557,126506,125278,798,1228,"PACMA",1328
16,"16242",317,272,270,1,2,"PACMA",3
25,"25154",122,74,72,0,2,"PACMA",1
37,"37221",430,293,290,0,3,"PACMA",0
19,"19050",16,15,15,0,0,"PACMA",0
24,"24054",430,314,313,1,1,"PACMA",0
25,"25069",451,247,246,4,1,"PACMA",3
47,"47169",68,59,59,0,0,"PACMA",1
13,"13058",4100,2986,2954,25,32,"PACMA",17
49,"49119",227,169,168,0,1,"PACMA",0
34,"34092",288,230,226,1,4,"PACMA",2
50,"50164",390,247,246,6,1,"PACMA",1
37,"37124",212,146,144,1,2,"PACMA",0
44,"44212",39,37,37,1,0,"PACMA",0
42,"42163",50,41,40,0,1,"PACMA",0
9,"9216",387,270,265,1,5,"PACMA",4
20,"20053",4774,2973,2953,13,20,"PACMA",16
46,"46241",392,299,291,1,8,"PACMA",4
37,"37031",361,269,266,2,3,"PACMA",0
42,"42070",34,27,26,1,1,"PACMA",1
37,"37291",272,207,206,0,1,"PACMA",0
10,"10129",365,275,271,0,4,"PACMA",0
28,"28090",8505,6654,6609,33,45,"PACMA",67
23,"23094",3839,3009,2954,14,55,"PACMA",26
9,"9079",49,45,45,0,0,"PACMA",1
24,"24001",189,124,122,0,2,"PACMA",0
50,"50006",925,674,657,6,17,"PACMA",5
34,"34140",107,67,67,0,0,"PACMA",0
23,"23095",8735,6347,6310,14,37,"PACMA",41
6,"6148",966,691,678,8,13,"PACMA",5
16,"16106",2727,2009,1989,12,20,"PACMA",6
22,"22114",123,81,81,0,0,"PACMA",0
2,"2035",1960,1483,1465,13,18,"PACMA",10
31,"31261",231,173,169,3,4,"PACMA",2
16,"16092",158,125,125,1,0,"PACMA",0
2,"2077",55,47,47,0,0,"PACMA",0
16,"16044",39,30,30,0,0,"PACMA",0
42,"42073",75,58,58,0,0,"PACMA",0
49,"49122",782,526,520,5,6,"PACMA",7
9,"9174",794,559,552,4,7,"PACMA",1
19,"19053",2008,1422,1404,10,18,"PACMA",6
19,"19259",30,25,25,1,0,"PACMA",0
25,"25087",60,43,43,0,0,"PACMA",0
44,"44215",159,109,109,2,0,"PACMA",1
44,"44181",76,57,56,0,1,"PACMA",0
41,"41011",15401,10170,9986,111,184,"PACMA",69
24,"24024",692,496,491,4,5,"PACMA",6
50,"50289",51,38,38,0,0,"PACMA",0
23,"23056",3088,2243,2203,15,40,"PACMA",17
45,"45196",1400,1047,1033,5,14,"PACMA",2
5,"5173",60,49,49,0,0,"PACMA",1
14,"14027",7925,5836,5746,58,90,"PACMA",52
45,"45017",262,204,203,0,1,"PACMA",3
16,"16046",245,180,180,1,0,"PACMA",1
14,"14008",2839,1905,1895,19,10,"PACMA",10
28,"28124",74,54,54,1,0,"PACMA",1
2,"2038",281,223,223,0,0,"PACMA",2
26,"26051",239,193,191,1,2,"PACMA",1
28,"28182",210,171,169,0,2,"PACMA",5
30,"30012",9091,6962,6897,36,65,"PACMA",71
19,"19215",168,144,140,0,4,"PACMA",0
19,"19178",33,22,22,0,0,"PACMA",0
21,"21003",690,471,458,6,13,"PACMA",5
9,"9906",1219,902,898,8,4,"PACMA",6
49,"49124",253,174,169,1,5,"PACMA",0
27,"27015",4270,2832,2769,33,63,"PACMA",17
24,"24124",367,244,233,3,11,"PACMA",0
47,"47119",92,80,79,1,1,"PACMA",0
45,"45086",496,351,343,2,8,"PACMA",5
13,"13067",351,281,279,0,2,"PACMA",1
9,"9429",56,41,41,0,0,"PACMA",0
42,"42078",1020,717,703,7,14,"PACMA",2
28,"28183",1039,743,735,2,8,"PACMA",15
11,"11036",689,407,400,3,7,"PACMA",2
47,"47038",105,77,77,0,0,"PACMA",0
46,"46011",7609,5249,5191,26,58,"PACMA",77
47,"47101",1710,1357,1336,16,21,"PACMA",5
6,"6032",68,53,53,1,0,"PACMA",1
44,"44161",443,314,313,2,1,"PACMA",0
4,"4007",734,524,522,1,2,"PACMA",1
31,"31132",145,109,109,0,0,"PACMA",1
45,"45164",182,162,160,1,2,"PACMA",0
18,"18098",6135,4206,4161,21,45,"PACMA",24
37,"37342",259,189,186,0,3,"PACMA",1
31,"31901",15459,11119,11026,108,93,"PACMA",110
40,"40216",759,574,571,3,3,"PACMA",6
33,"33024",226679,158750,157564,1209,1186,"PACMA",1937
46,"46090",1637,1391,1367,3,24,"PACMA",9
37,"37039",301,217,213,0,4,"PACMA",0
25,"25124",166,106,105,1,1,"PACMA",2
49,"49044",80,60,58,0,2,"PACMA",0
47,"47040",64,53,53,0,0,"PACMA",0
42,"42081",145,102,100,1,2,"PACMA",0
46,"46091",118,94,94,0,0,"PACMA",1
42,"42051",20,14,14,1,0,"PACMA",0
44,"44152",64,46,45,0,1,"PACMA",0
28,"28096",18354,13310,13205,68,105,"PACMA",139
46,"46030",800,627,614,5,13,"PACMA",1
9,"9012",89,64,63,0,1,"PACMA",2
26,"26054",320,263,260,4,3,"PACMA",1
38,"38002",956,702,696,21,6,"PACMA",5
19,"19106",89,59,59,0,0,"PACMA",0
49,"49129",853,592,574,9,18,"PACMA",2
6,"6066",1762,1189,1182,2,7,"PACMA",2
44,"44119",130,92,91,3,1,"PACMA",0
24,"24197",763,538,533,1,5,"PACMA",3
24,"24198",592,412,407,2,5,"PACMA",3
37,"37233",61,48,47,1,1,"PACMA",0
42,"42161",137,102,101,0,1,"PACMA",0
5,"5196",50,37,36,0,1,"PACMA",1
9,"9483",211,158,157,0,1,"PACMA",0
28,"28903",33082,27065,26922,154,143,"PACMA",250
22,"22009",617,444,441,6,3,"PACMA",1
18,"18148",817,637,634,5,3,"PACMA",5
26,"26055",39,32,32,0,0,"PACMA",0
46,"46231",2421,1721,1708,14,13,"PACMA",24
16,"16024",129,98,97,0,1,"PACMA",1
10,"10141",263,194,194,0,0,"PACMA",0
49,"49010",345,279,273,5,6,"PACMA",1
9,"9283",44,32,31,0,1,"PACMA",1
9,"9410",3040,2117,2095,16,22,"PACMA",27
26,"26091",161,146,146,0,0,"PACMA",0
5,"5168",3560,2589,2561,19,28,"PACMA",13
31,"31070",2638,1808,1784,20,24,"PACMA",13
28,"28005",134246,99236,98481,583,755,"PACMA",1217
22,"22214",128,106,105,3,1,"PACMA",0
25,"25053",1055,671,661,7,10,"PACMA",4
21,"21050",12427,8036,7969,80,67,"PACMA",56
9,"9227",119,91,89,4,2,"PACMA",1
10,"10188",499,382,374,4,8,"PACMA",2
5,"5153",103,78,77,1,1,"PACMA",0
38,"38042",3802,2652,2625,14,27,"PACMA",13
34,"34156",50,45,45,0,0,"PACMA",0
34,"34019",125,107,105,0,2,"PACMA",1
50,"50077",221,168,167,1,1,"PACMA",0
42,"42004",2285,1757,1737,15,20,"PACMA",3
29,"29035",1567,1157,1144,11,13,"PACMA",3
22,"22084",535,403,399,4,4,"PACMA",4
33,"33058",1796,1232,1209,11,23,"PACMA",7
47,"47206",92,80,80,0,0,"PACMA",0
47,"47017",201,158,153,1,5,"PACMA",2
9,"9228",160,137,136,1,1,"PACMA",0
9,"9095",84,61,61,0,0,"PACMA",0
6,"6026",837,598,591,0,7,"PACMA",0
10,"10161",76,53,53,0,0,"PACMA",0
22,"22013",288,216,210,3,6,"PACMA",0
5,"5155",52,44,44,0,0,"PACMA",0
28,"28006",78966,59065,58698,267,367,"PACMA",631
44,"44123",105,71,70,1,1,"PACMA",0
23,"23015",1374,1029,1019,5,10,"PACMA",5
49,"49160",49,33,33,0,0,"PACMA",0
50,"50206",460,363,357,4,6,"PACMA",3
13,"13079",12244,8582,8450,72,132,"PACMA",74
44,"44157",64,48,48,1,0,"PACMA",0
34,"34159",357,253,248,4,5,"PACMA",0
18,"18152",944,707,703,0,4,"PACMA",3
3,"3063",26462,18591,18492,91,99,"PACMA",184
45,"45094",387,298,297,1,1,"PACMA",1
9,"9369",436,319,316,1,3,"PACMA",3
10,"10009",266,201,194,0,7,"PACMA",1
20,"20077",5213,3614,3591,36,23,"PACMA",25
44,"44113",71,52,52,0,0,"PACMA",0
10,"10193",1412,1090,1078,6,12,"PACMA",8
45,"45027",346,275,272,0,3,"PACMA",2
31,"31184",62,44,44,3,0,"PACMA",0
25,"25088",96,73,72,0,1,"PACMA",0
11,"11902",3629,2275,2252,25,23,"PACMA",9
5,"5158",367,290,286,6,4,"PACMA",0
22,"22144",243,188,187,1,1,"PACMA",0
29,"29016",251,188,188,1,0,"PACMA",0
50,"50038",1502,1121,1111,7,10,"PACMA",3
3,"3024",3901,3067,3024,11,43,"PACMA",22
10,"10026",648,500,492,7,8,"PACMA",3
13,"13901",893,665,655,5,10,"PACMA",4
48,"48064",606,447,445,4,2,"PACMA",2
34,"34068",27,22,22,0,0,"PACMA",0
44,"44020",24,20,19,1,1,"PACMA",0
29,"29039",2666,1898,1873,22,25,"PACMA",19
33,"33001",1588,887,880,8,7,"PACMA",1
19,"19071",7840,5537,5489,45,48,"PACMA",73
20,"20068",190,135,135,3,0,"PACMA",0
49,"49057",109,85,83,1,2,"PACMA",0
23,"23071",1715,1290,1278,7,12,"PACMA",7
37,"37101",160,128,125,0,3,"PACMA",0
22,"22053",789,520,513,9,7,"PACMA",4
45,"45097",1046,839,834,4,5,"PACMA",1
10,"10012",595,466,459,0,7,"PACMA",0
34,"34218",461,343,339,2,4,"PACMA",2
16,"16271",633,517,516,4,1,"PACMA",0
9,"9163",582,467,459,2,8,"PACMA",1
42,"42124",64,49,49,0,0,"PACMA",0
28,"28125",3002,2180,2163,11,17,"PACMA",37
26,"26134",82,68,68,2,0,"PACMA",1
45,"45030",478,368,360,2,8,"PACMA",1
1,"1042",904,653,648,6,5,"PACMA",7
45,"45198",1809,1475,1442,7,33,"PACMA",9
46,"46072",3611,2871,2821,23,50,"PACMA",22
19,"19239",92,62,62,1,0,"PACMA",0
40,"40161",36,28,28,2,0,"PACMA",0
45,"45075",143,109,108,0,1,"PACMA",4
12,"12003",976,746,736,6,10,"PACMA",3
20,"20037",99,64,64,2,0,"PACMA",1
49,"49153",174,136,132,0,4,"PACMA",0
18,"18066",2107,1392,1384,4,8,"PACMA",3
10,"10061",1628,1055,1035,8,20,"PACMA",3
28,"28135",948,713,709,4,4,"PACMA",4
33,"33003",646,355,352,9,3,"PACMA",1
25,"25911",451,273,271,7,2,"PACMA",2
25,"25136",95,64,64,1,0,"PACMA",0
40,"40020",157,118,117,1,1,"PACMA",0
39,"39057",2330,1671,1645,7,26,"PACMA",16
16,"16113",3077,2225,2202,10,23,"PACMA",16
9,"9149",35,24,24,2,0,"PACMA",0
37,"37232",390,341,339,1,2,"PACMA",1
20,"20060",88,67,67,2,0,"PACMA",0
42,"42159",37,29,29,0,0,"PACMA",0
12,"12115",219,179,177,0,2,"PACMA",0
49,"49141",340,248,246,0,2,"PACMA",1
30,"30016",151668,102093,101363,484,730,"PACMA",1406
44,"44035",113,90,88,1,2,"PACMA",1
44,"44097",142,92,92,0,0,"PACMA",0
46,"46100",286,232,230,1,2,"PACMA",4
29,"29010",1651,1278,1237,4,41,"PACMA",4
22,"22019",180,151,150,2,1,"PACMA",1
28,"28069",50,44,41,0,3,"PACMA",0
45,"45033",343,249,243,2,6,"PACMA",2
45,"45134",1581,1204,1192,6,12,"PACMA",5
50,"50244",201,162,161,1,1,"PACMA",0
33,"33045",4487,3057,2999,28,58,"PACMA",19
37,"37090",52,43,43,0,0,"PACMA",0
44,"44198",182,147,146,4,1,"PACMA",0
12,"12126",24464,18533,18331,113,202,"PACMA",135
31,"31124",208,148,148,2,0,"PACMA",7
45,"45046",2412,1667,1654,7,13,"PACMA",5
31,"31179",502,348,345,0,3,"PACMA",0
7,"7048",17252,10055,9984,105,71,"PACMA",157
19,"19280",3464,2469,2438,14,31,"PACMA",38
47,"47007",3769,2765,2736,24,29,"PACMA",32
31,"31014",275,194,192,4,2,"PACMA",1
37,"37359",184,130,129,0,1,"PACMA",0
26,"26114",79,66,65,1,1,"PACMA",0
10,"10081",182,142,135,2,7,"PACMA",0
3,"3904",1396,1033,1026,4,7,"PACMA",9
44,"44211",42,35,35,0,0,"PACMA",0
6,"6038",805,543,541,2,2,"PACMA",1
25,"25140",788,435,430,9,5,"PACMA",1
5,"5215",164,123,122,2,1,"PACMA",2
5,"5183",138,111,110,0,1,"PACMA",0
50,"50056",409,300,300,3,0,"PACMA",1
18,"18119",1702,1298,1283,13,15,"PACMA",5
45,"45035",281,212,209,1,3,"PACMA",2
40,"40152",760,592,584,3,8,"PACMA",2
49,"49184",172,115,112,0,3,"PACMA",0
9,"9027",46,42,41,0,1,"PACMA",0
20,"20042",3228,1967,1958,27,9,"PACMA",11
49,"49146",295,216,213,3,3,"PACMA",0
23,"23001",963,801,799,1,2,"PACMA",5
40,"40111",58,49,49,0,0,"PACMA",1
31,"31182",34,28,28,0,0,"PACMA",0
9,"9199",92,72,71,1,1,"PACMA",1
50,"50026",439,335,325,10,10,"PACMA",0
48,"48071",6087,4294,4254,32,40,"PACMA",33
22,"22099",483,379,377,4,2,"PACMA",0
37,"37112",161,112,111,2,1,"PACMA",0
24,"24110",1247,899,892,6,7,"PACMA",2
19,"19335",55,47,47,0,0,"PACMA",0
45,"45004",567,410,406,1,4,"PACMA",3
47,"47188",111,88,88,3,0,"PACMA",0
30,"30030",312993,231648,230185,1207,1463,"PACMA",2978
41,"41064",5596,3517,3456,55,61,"PACMA",30
37,"37140",674,443,439,5,4,"PACMA",4
28,"28160",8256,6102,6059,31,43,"PACMA",87
29,"29014",217,141,140,4,1,"PACMA",0
49,"49067",367,250,249,0,1,"PACMA",1
50,"50186",42,31,31,0,0,"PACMA",1
10,"10207",504,357,350,6,7,"PACMA",3
16,"16225",73,57,57,3,0,"PACMA",1
7,"7013",6881,4693,4587,39,106,"PACMA",64
5,"5023",168,146,145,1,1,"PACMA",0
3,"3073",236,200,199,1,1,"PACMA",0
45,"45901",771,547,544,3,3,"PACMA",7
18,"18003",14022,9938,9820,80,118,"PACMA",125
9,"9368",22,17,17,2,0,"PACMA",0
6,"6012",3267,2300,2277,15,23,"PACMA",16
42,"42209",140,107,106,4,1,"PACMA",1
50,"50134",128,91,89,2,2,"PACMA",1
45,"45106",7439,5613,5534,52,79,"PACMA",33
37,"37240",945,623,619,5,4,"PACMA",4
50,"50090",150,113,112,0,1,"PACMA",0
9,"9275",192,129,129,2,0,"PACMA",0
50,"50229",62,47,47,2,0,"PACMA",0
46,"46226",41,36,35,0,1,"PACMA",0
9,"9428",108,92,91,0,1,"PACMA",0
19,"19015",84,69,68,0,1,"PACMA",0
40,"40044",145,114,113,2,1,"PACMA",1
42,"42059",21,15,14,0,1,"PACMA",0
44,"44148",90,75,73,2,2,"PACMA",0
19,"19271",46,39,39,0,0,"PACMA",0
25,"25020",289,206,205,3,1,"PACMA",0
22,"22195",235,182,181,3,1,"PACMA",3
6,"6045",506,379,374,3,5,"PACMA",1
5,"5175",159,131,131,1,0,"PACMA",1
16,"16172",325,268,267,1,1,"PACMA",0
50,"50188",28,25,25,0,0,"PACMA",0
10,"10165",257,208,207,0,1,"PACMA",0
28,"28115",60892,49705,49510,209,195,"PACMA",370
45,"45174",301,237,233,1,4,"PACMA",2
47,"47191",108,79,79,0,0,"PACMA",1
9,"9034",276,228,227,2,1,"PACMA",0
13,"13049",799,540,531,0,9,"PACMA",2
40,"40005",30,23,23,0,0,"PACMA",0
6,"6016",2986,2114,2078,14,36,"PACMA",8
4,"4060",445,348,345,5,3,"PACMA",3
16,"16097",156,124,121,0,3,"PACMA",0
16,"16126",770,634,624,3,10,"PACMA",0
41,"41036",3941,2674,2642,23,32,"PACMA",21
44,"44173",101,81,79,2,2,"PACMA",0
24,"24139",2183,1548,1525,16,23,"PACMA",7
42,"42142",50,35,35,1,0,"PACMA",0
20,"20004",252,121,121,0,0,"PACMA",1
10,"10122",218,156,153,3,3,"PACMA",0
34,"34041",90,71,71,1,0,"PACMA",0
4,"4017",1296,857,854,5,3,"PACMA",2
27,"27053",537,316,308,3,8,"PACMA",0
49,"49076",321,217,217,2,0,"PACMA",1
18,"18175",11670,8200,8097,36,103,"PACMA",65
9,"9250",269,196,194,1,2,"PACMA",3
25,"25110",2766,1628,1602,22,26,"PACMA",18
24,"24183",805,555,549,6,6,"PACMA",0
37,"37286",207,152,145,4,7,"PACMA",1
29,"29053",1699,1105,1091,14,14,"PACMA",21
9,"9482",33,28,28,0,0,"PACMA",0
45,"45176",3706,2554,2521,22,33,"PACMA",49
26,"26147",30,28,27,0,1,"PACMA",0
47,"47212",380,323,322,2,1,"PACMA",3
46,"46039",2130,1728,1699,8,29,"PACMA",13
42,"42013",34,28,27,0,1,"PACMA",0
33,"33014",9037,5999,5938,53,61,"PACMA",67
47,"47057",268,197,196,0,1,"PACMA",2
28,"28127",64827,51776,51613,220,163,"PACMA",486
18,"18132",3291,2524,2494,9,30,"PACMA",29
24,"24153",232,179,177,2,2,"PACMA",4
10,"10079",894,662,648,7,14,"PACMA",0
14,"14003",1248,939,930,2,9,"PACMA",4
41,"41094",6288,4497,4449,38,48,"PACMA",60
26,"26077",22,22,21,1,1,"PACMA",0
6,"6097",2362,1750,1727,7,23,"PACMA",6
16,"16239",135,110,105,0,5,"PACMA",0
50,"50139",313,241,239,3,2,"PACMA",0
50,"50192",236,180,180,2,0,"PACMA",3
47,"47032",152,117,116,1,1,"PACMA",1
10,"10003",569,414,408,1,6,"PACMA",1
24,"24063",374,254,252,2,2,"PACMA",0
45,"45123",3081,2144,2131,11,13,"PACMA",29
49,"49079",106,93,92,1,1,"PACMA",0
34,"34237",592,462,452,6,10,"PACMA",2
27,"27022",4833,3022,2954,30,68,"PACMA",22
13,"13021",434,365,363,4,2,"PACMA",1
44,"44177",115,84,84,1,0,"PACMA",0
18,"18040",231,136,133,0,3,"PACMA",1
26,"26103",796,616,610,6,6,"PACMA",10
41,"41072",4054,2965,2933,14,32,"PACMA",12
46,"46197",1942,1527,1514,5,13,"PACMA",19
46,"46006",4523,3665,3623,20,42,"PACMA",26
49,"49156",237,184,175,0,9,"PACMA",0
37,"37373",748,503,499,1,4,"PACMA",2
23,"23077",620,501,494,3,7,"PACMA",0
34,"34124",60,50,49,0,1,"PACMA",0
28,"28120",1223,892,884,2,8,"PACMA",2
49,"49036",506,374,367,2,7,"PACMA",2
41,"41096",6161,4553,4476,32,77,"PACMA",50
40,"40207",763,599,593,3,6,"PACMA",6
12,"12017",161,130,128,0,2,"PACMA",1
45,"45013",1758,1352,1329,8,23,"PACMA",7
5,"5232",102,84,79,1,5,"PACMA",1
26,"26115",19,16,16,0,0,"PACMA",0
5,"5233",221,191,191,1,0,"PACMA",0
31,"31159",1107,844,833,6,11,"PACMA",3
49,"49081",1382,1016,1003,9,13,"PACMA",1
25,"25155",647,421,418,0,3,"PACMA",4
7,"7024",6843,3657,3612,38,45,"PACMA",58
26,"26080",472,391,389,0,2,"PACMA",0
33,"33018",2901,2000,1976,18,24,"PACMA",16
39,"39102",2277,1615,1598,9,17,"PACMA",8
34,"34001",34,28,28,2,0,"PACMA",0
45,"45137",1604,1032,1024,4,8,"PACMA",3
10,"10053",287,215,210,1,5,"PACMA",0
40,"40210",106,74,71,0,3,"PACMA",0
46,"46164",11771,8564,8483,64,81,"PACMA",88
6,"6102",1048,843,825,6,18,"PACMA",2
18,"18002",553,395,393,1,2,"PACMA",0
34,"34093",85,70,70,0,0,"PACMA",1
50,"50288",3387,2415,2398,31,17,"PACMA",20
6,"6057",576,479,471,0,8,"PACMA",0
29,"29082",31885,22572,22400,152,172,"PACMA",359
19,"19212",703,543,531,3,12,"PACMA",1
14,"14035",5966,4236,4177,39,59,"PACMA",14
13,"13010",883,646,634,3,12,"PACMA",1
33,"33019",3072,2020,2005,18,15,"PACMA",11
29,"29026",1057,751,748,5,3,"PACMA",4
41,"41099",3976,2369,2347,12,22,"PACMA",25
7,"7040",280477,173945,172463,1359,1482,"PACMA",2964
50,"50089",8225,6074,6043,43,31,"PACMA",85
4,"4013",141378,94872,94288,741,584,"PACMA",1096
37,"37007",437,314,306,3,8,"PACMA",1
44,"44225",107,74,74,1,0,"PACMA",0
50,"50228",268,210,208,5,2,"PACMA",0
13,"13012",413,274,273,1,1,"PACMA",1
16,"16094",127,96,94,0,2,"PACMA",0
40,"40157",47,44,44,0,0,"PACMA",2
46,"46174",972,764,752,2,12,"PACMA",8
10,"10071",139,96,94,0,2,"PACMA",1
44,"44114",243,178,173,0,5,"PACMA",0
42,"42196",10,7,7,0,0,"PACMA",0
40,"40199",105,84,84,0,0,"PACMA",0
23,"23097",6443,4117,4063,21,54,"PACMA",22
6,"6075",465,383,372,0,11,"PACMA",1
21,"21042",15350,7643,7530,124,113,"PACMA",92
50,"50198",54,41,41,1,0,"PACMA",0
12,"12121",1107,924,893,4,31,"PACMA",1
25,"25121",644,415,410,8,5,"PACMA",3
9,"9441",74,65,65,0,0,"PACMA",0
26,"26017",381,293,293,5,0,"PACMA",1
6,"6060",5786,4146,4071,24,75,"PACMA",18
42,"42034",30,22,22,0,0,"PACMA",0
40,"40228",510,390,382,1,8,"PACMA",0
18,"18906",905,664,657,3,7,"PACMA",3
9,"9276",382,251,240,3,11,"PACMA",4
25,"25047",1014,675,674,8,1,"PACMA",4
29,"29085",144,109,108,0,1,"PACMA",0
10,"10196",301,225,225,1,0,"PACMA",4
46,"46063",1756,1367,1345,15,22,"PACMA",8
49,"49029",623,495,488,3,7,"PACMA",4
47,"47199",80,63,63,0,0,"PACMA",0
34,"34025",57,39,39,1,0,"PACMA",0
28,"28001",61,46,45,0,1,"PACMA",0
37,"37131",185,139,139,0,0,"PACMA",0
44,"44116",83,60,60,1,0,"PACMA",1
14,"14029",4178,3047,3009,28,38,"PACMA",17
50,"50241",588,415,410,4,5,"PACMA",2
24,"24083",1042,727,715,6,12,"PACMA",2
12,"12037",17,16,14,0,2,"PACMA",0
26,"26160",709,552,549,2,3,"PACMA",10
34,"34027",1085,751,741,6,10,"PACMA",3
22,"22133",115,81,80,1,1,"PACMA",0
49,"49263",51,36,36,0,0,"PACMA",0
50,"50041",12,9,9,0,0,"PACMA",0
13,"13017",256,200,197,0,3,"PACMA",0
28,"28126",39,29,29,0,0,"PACMA",0
16,"16098",561,456,454,3,2,"PACMA",6
3,"3088",5498,4041,3989,29,52,"PACMA",50
45,"45121",6796,4743,4692,22,51,"PACMA",39
37,"37175",403,314,312,6,2,"PACMA",2
50,"50170",371,283,280,0,3,"PACMA",0
23,"23901",1154,970,964,3,6,"PACMA",1
29,"29075",12934,8234,8147,69,87,"PACMA",80
42,"42217",31,25,24,0,1,"PACMA",0
6,"6019",2079,1451,1417,8,34,"PACMA",7
25,"25125",417,250,250,5,0,"PACMA",1
25,"25166",181,110,109,2,1,"PACMA",0
29,"29076",2153,1390,1360,10,30,"PACMA",16
38,"38038",162027,104978,104035,575,943,"PACMA",2263
10,"10047",955,732,727,1,5,"PACMA",6
2,"2083",219,191,191,0,0,"PACMA",0
12,"12027",17283,12015,11888,89,127,"PACMA",160
18,"18189",776,581,574,4,7,"PACMA",7
9,"9332",140,106,106,2,0,"PACMA",2
13,"13072",768,579,572,5,7,"PACMA",1
11,"11005",4583,3018,2967,25,51,"PACMA",23
19,"19318",25,18,18,0,0,"PACMA",0
45,"45089",1495,1102,1094,0,8,"PACMA",4
37,"37261",221,163,160,1,3,"PACMA",0
42,"42160",254,206,205,0,1,"PACMA",1
25,"25064",108,68,68,2,0,"PACMA",1
22,"22046",728,566,561,5,5,"PACMA",2
46,"46248",4897,3596,3544,18,52,"PACMA",42
50,"50108",48,38,38,0,0,"PACMA",0
37,"37149",68,64,64,0,0,"PACMA",1
24,"24041",538,367,366,3,1,"PACMA",3
41,"41029",13445,9507,9416,78,91,"PACMA",180
16,"16162",43,35,34,0,1,"PACMA",0
25,"25113",1168,811,803,8,8,"PACMA",5
40,"40022",213,164,161,2,3,"PACMA",0
23,"23092",27775,19734,19541,175,193,"PACMA",180
45,"45149",556,446,440,0,6,"PACMA",2
9,"9348",148,111,110,2,1,"PACMA",0
24,"24108",376,280,277,2,3,"PACMA",2
46,"46243",138,115,112,1,3,"PACMA",2
40,"40109",73,59,59,1,0,"PACMA",1
22,"22908",197,142,140,3,2,"PACMA",1
49,"49183",100,77,77,2,0,"PACMA",0
48,"48070",544,362,362,4,0,"PACMA",0
50,"50266",122,90,90,0,0,"PACMA",0
42,"42131",51,37,37,1,0,"PACMA",0
50,"50109",103,78,78,3,0,"PACMA",1
34,"34062",171,119,118,2,1,"PACMA",1
21,"21011",3453,2441,2419,15,22,"PACMA",23
6,"6070",7743,5438,5317,39,121,"PACMA",30
35,"35003",5211,2949,2908,13,41,"PACMA",22
16,"16263",959,722,715,4,7,"PACMA",5
48,"48091",1121,771,765,7,6,"PACMA",4
5,"5249",105,84,82,0,2,"PACMA",0
26,"26013",347,249,246,2,3,"PACMA",8
10,"10190",545,406,395,2,11,"PACMA",3
2,"2007",1030,824,818,4,6,"PACMA",3
28,"28130",28293,21253,21040,116,213,"PACMA",371
31,"31193",1426,1024,1013,13,11,"PACMA",3
47,"47134",165,128,125,1,3,"PACMA",0
24,"24033",205,158,157,0,1,"PACMA",0
49,"49095",291,221,220,0,1,"PACMA",1
49,"49132",316,235,232,1,3,"PACMA",0
46,"46233",3860,2859,2817,10,42,"PACMA",37
38,"38007",1661,1114,1103,6,11,"PACMA",15
29,"29059",2587,1965,1922,14,43,"PACMA",7
44,"44246",1543,1045,1027,12,18,"PACMA",6
46,"46173",1328,1069,1057,4,12,"PACMA",7
47,"47207",278,215,212,3,3,"PACMA",1
34,"34214",183,144,144,0,0,"PACMA",3
10,"10192",828,590,584,1,6,"PACMA",1
18,"18904",775,565,558,1,7,"PACMA",0
50,"50207",106,93,93,1,0,"PACMA",0
31,"31908",1004,686,682,2,4,"PACMA",4
46,"46026",1204,1015,1004,3,11,"PACMA",5
10,"10903",826,578,569,3,9,"PACMA",4
22,"22181",92,61,61,2,0,"PACMA",0
50,"50007",45,34,34,1,0,"PACMA",0
26,"26004",67,50,50,0,0,"PACMA",0
9,"9418",82,62,61,1,1,"PACMA",0
50,"50113",618,489,484,2,5,"PACMA",1
47,"47045",763,575,567,1,8,"PACMA",0
47,"47146",255,206,204,1,2,"PACMA",5
33,"33041",7199,4922,4877,52,45,"PACMA",48
20,"20023",441,252,251,1,1,"PACMA",2
27,"27029",1463,1023,1002,11,21,"PACMA",5
45,"45185",7700,5771,5691,20,80,"PACMA",32
49,"49123",546,391,384,1,7,"PACMA",1
16,"16031",46,28,28,1,0,"PACMA",0
49,"49028",115,104,103,1,1,"PACMA",1
47,"47046",118,92,90,1,2,"PACMA",0
9,"9020",259,196,188,5,8,"PACMA",0
48,"48014",1211,806,801,7,5,"PACMA",5
47,"47002",23,21,20,1,1,"PACMA",0
14,"14046",4485,3268,3208,33,60,"PACMA",33
26,"26132",112,82,82,0,0,"PACMA",0
26,"26061",1565,1160,1141,13,19,"PACMA",9
44,"44105",82,64,64,0,0,"PACMA",0
46,"46028",387,330,328,3,2,"PACMA",0
22,"22149",305,228,228,0,0,"PACMA",1
37,"37243",98,70,70,1,0,"PACMA",0
16,"16209",116,101,101,2,0,"PACMA",0
4,"4027",250,159,159,0,0,"PACMA",1
37,"37199",142,105,105,1,0,"PACMA",0
5,"5045",91,66,66,0,0,"PACMA",0
44,"44010",175,130,128,1,2,"PACMA",0
9,"9048",1467,1048,1033,13,15,"PACMA",6
46,"46202",16947,12814,12710,79,104,"PACMA",189
9,"9021",56,33,31,1,2,"PACMA",2
10,"10059",364,253,248,1,5,"PACMA",0
16,"16250",76,59,59,0,0,"PACMA",0
39,"39005",1380,1053,1046,9,7,"PACMA",18
34,"34114",207,144,144,0,0,"PACMA",1
26,"26008",1860,1399,1387,5,12,"PACMA",2
40,"40230",94,68,66,0,2,"PACMA",0
35,"35019",32481,19318,19067,123,251,"PACMA",266
37,"37354",5240,3823,3771,39,52,"PACMA",50
49,"49186",261,188,185,0,3,"PACMA",0
26,"26171",176,139,133,1,6,"PACMA",0
21,"21019",612,400,391,2,9,"PACMA",2
45,"45199",2940,1848,1805,14,43,"PACMA",39
40,"40190",53,45,44,0,1,"PACMA",0
9,"9195",59,36,36,2,0,"PACMA",0
31,"31210",196,152,152,2,0,"PACMA",1
45,"45066",7570,5550,5484,25,66,"PACMA",55
44,"44229",152,112,111,3,1,"PACMA",0
38,"38025",6880,4839,4761,30,78,"PACMA",71
9,"9062",51,40,39,0,1,"PACMA",0
33,"33064",234,168,167,1,1,"PACMA",1
41,"41005",9068,6366,6281,58,85,"PACMA",76
3,"3110",291,241,241,1,0,"PACMA",4
50,"50074",6366,4230,4165,31,65,"PACMA",41
49,"49192",130,110,109,2,1,"PACMA",0
28,"28049",58480,45136,44820,242,316,"PACMA",615
12,"12039",833,717,710,4,7,"PACMA",4
24,"24040",449,329,325,2,4,"PACMA",5
37,"37358",159,135,133,0,2,"PACMA",0
50,"50222",1622,1091,1071,7,20,"PACMA",4
49,"49227",315,230,228,2,2,"PACMA",1
19,"19159",93,78,77,0,1,"PACMA",0
31,"31235",159,117,115,2,2,"PACMA",0
5,"5083",140,110,105,1,5,"PACMA",0
31,"31090",144,77,77,1,0,"PACMA",0
31,"31135",106,70,66,2,4,"PACMA",0
44,"44046",49,34,34,1,0,"PACMA",0
16,"16197",59,42,42,0,0,"PACMA",0
40,"40205",261,202,198,2,4,"PACMA",3
16,"16217",74,62,62,0,0,"PACMA",0
41,"41073",1707,1055,1041,5,14,"PACMA",8
20,"20051",6877,4699,4679,34,20,"PACMA",17
42,"42205",89,71,71,2,0,"PACMA",0
44,"44244",75,47,47,1,0,"PACMA",1
45,"45034",1353,1082,1078,6,4,"PACMA",8
48,"48913",1248,884,869,10,15,"PACMA",7
46,"46095",610,467,459,1,8,"PACMA",5
5,"5235",124,111,110,0,1,"PACMA",0
25,"25057",208,141,140,0,1,"PACMA",2
31,"31183",691,544,542,4,2,"PACMA",5
2,"2013",119,92,90,0,2,"PACMA",0
33,"33040",4549,2986,2942,35,44,"PACMA",36
49,"49023",967,673,662,10,11,"PACMA",1
2,"2073",4867,3520,3474,40,46,"PACMA",18
42,"42206",8,8,8,1,0,"PACMA",0
25,"25055",169,105,104,4,1,"PACMA",1
3,"3135",211,170,166,2,4,"PACMA",4
47,"47160",425,308,303,0,5,"PACMA",0
18,"18913",813,566,559,2,7,"PACMA",3
37,"37017",245,182,177,1,5,"PACMA",2
26,"26105",2205,1670,1658,12,12,"PACMA",12
4,"4056",143,113,109,0,4,"PACMA",1
18,"18071",5579,4044,3985,37,59,"PACMA",44
31,"31115",165,102,101,1,1,"PACMA",0
31,"31071",17,16,16,0,0,"PACMA",0
26,"26152",33,28,28,1,0,"PACMA",0
47,"47061",256,212,211,2,1,"PACMA",0
28,"28170",2472,1640,1622,13,18,"PACMA",11
21,"21053",3316,2141,2107,17,34,"PACMA",12
28,"28072",5709,4356,4324,22,32,"PACMA",63
40,"40026",119,109,109,0,0,"PACMA",0
42,"42057",164,104,104,2,0,"PACMA",3
42,"42181",412,313,307,2,6,"PACMA",0
19,"19323",40,31,31,0,0,"PACMA",0
9,"9352",114,92,92,1,0,"PACMA",0
37,"37032",548,401,399,0,2,"PACMA",3
10,"10115",3544,2705,2647,11,58,"PACMA",24
45,"45115",2552,1999,1966,8,33,"PACMA",8
47,"47162",74,60,60,0,0,"PACMA",1
47,"47053",119,98,96,0,2,"PACMA",0
18,"18074",262,201,200,2,1,"PACMA",0
47,"47216",115,91,87,0,4,"PACMA",0
27,"27046",1530,1022,1007,9,15,"PACMA",5
42,"42166",59,45,45,0,0,"PACMA",0
46,"46150",1831,1341,1333,7,8,"PACMA",16
50,"50052",90,68,68,0,0,"PACMA",1
5,"5057",2465,1969,1953,15,16,"PACMA",4
24,"24143",510,358,349,0,9,"PACMA",0
33,"33049",6322,4116,4062,43,54,"PACMA",41
44,"44001",68,53,52,1,1,"PACMA",1
16,"16227",113,93,93,0,0,"PACMA",0
50,"50177",308,245,244,4,1,"PACMA",2
42,"42183",111,82,82,2,0,"PACMA",0
45,"45073",298,233,233,1,0,"PACMA",1
44,"44136",49,43,43,1,0,"PACMA",0
37,"37065",312,223,222,3,1,"PACMA",0
37,"37115",123,89,87,0,2,"PACMA",0
40,"40030",473,369,363,3,6,"PACMA",1
18,"18004",714,518,509,2,9,"PACMA",1
26,"26050",113,88,85,0,3,"PACMA",1
31,"31030",141,100,99,0,1,"PACMA",0
31,"31196",38,35,35,1,0,"PACMA",0
49,"49071",765,495,490,2,5,"PACMA",1
46,"46106",1535,1150,1140,10,10,"PACMA",10
3,"3014",237287,167428,166445,847,983,"PACMA",2159
50,"50219",4119,2833,2804,19,29,"PACMA",56
42,"42213",27,21,21,1,0,"PACMA",0
6,"6121",3355,2279,2248,8,31,"PACMA",14
47,"47099",150,135,135,1,0,"PACMA",1
38,"38010",4008,2733,2661,19,72,"PACMA",33
40,"40074",255,222,219,2,3,"PACMA",2
29,"29029",403,298,294,2,4,"PACMA",2
47,"47218",993,743,734,2,9,"PACMA",7
49,"49030",86,69,69,0,0,"PACMA",0
37,"37214",129,93,91,0,2,"PACMA",1
31,"31032",1713,1209,1193,24,16,"PACMA",3
19,"19179",69,56,56,1,0,"PACMA",0
31,"31198",37,25,25,0,0,"PACMA",0
5,"5079",68,53,53,0,0,"PACMA",0
31,"31109",1582,1155,1150,9,5,"PACMA",6
18,"18097",960,693,685,5,8,"PACMA",1
9,"9144",53,40,40,0,0,"PACMA",0
10,"10106",130,109,108,2,1,"PACMA",0
39,"39029",618,488,481,3,7,"PACMA",2
41,"41028",2003,1524,1511,9,13,"PACMA",28
22,"22111",154,103,102,0,1,"PACMA",2
31,"31040",192,139,138,4,1,"PACMA",0
25,"25913",86,67,67,3,0,"PACMA",0
24,"24079",906,664,658,9,6,"PACMA",5
22,"22109",261,191,190,1,1,"PACMA",1
50,"50903",2214,1602,1585,8,17,"PACMA",19
9,"9120",38,32,32,1,0,"PACMA",0
22,"22029",127,100,100,0,0,"PACMA",0
23,"23088",6089,4558,4472,34,86,"PACMA",36
16,"16084",48,38,37,1,1,"PACMA",0
3,"3017",374,314,307,1,7,"PACMA",4
50,"50142",26,17,17,0,0,"PACMA",0
3,"3124",460,388,384,3,4,"PACMA",1
4,"4103",1476,1018,1008,3,10,"PACMA",6
50,"50132",751,543,536,0,7,"PACMA",8
28,"28021",554,370,364,3,6,"PACMA",6
33,"33055",1514,1109,1092,5,17,"PACMA",3
49,"49167",197,147,145,0,2,"PACMA",3
41,"41071",5586,3724,3661,22,63,"PACMA",27
19,"19330",71,63,63,2,0,"PACMA",0
37,"37121",575,418,413,3,5,"PACMA",2
24,"24074",97,75,75,1,0,"PACMA",0
46,"46187",1306,1017,1000,0,17,"PACMA",10
39,"39008",13877,10258,10153,96,105,"PACMA",136
50,"50182",3399,2364,2335,21,29,"PACMA",35
46,"46048",3452,2749,2713,14,36,"PACMA",25
10,"10095",338,259,251,1,8,"PACMA",3
28,"28118",57,46,45,0,1,"PACMA",0
4,"4009",162,123,122,2,1,"PACMA",0
40,"40035",137,105,104,0,1,"PACMA",0
31,"31904",1563,1029,1022,23,7,"PACMA",13
26,"26150",112,101,95,0,6,"PACMA",1
19,"19183",74,65,65,0,0,"PACMA",1
22,"22252",121,86,81,0,5,"PACMA",0
50,"50173",182,132,131,1,1,"PACMA",0
29,"29011",2900,1822,1803,9,19,"PACMA",9
25,"25139",467,294,291,5,3,"PACMA",1
46,"46043",136,124,124,0,0,"PACMA",1
6,"6088",12616,8436,8313,70,123,"PACMA",78
5,"5187",1754,1323,1303,7,20,"PACMA",9
26,"26099",1264,1003,991,9,12,"PACMA",4
10,"10162",575,437,433,2,4,"PACMA",0
49,"49083",52,44,44,2,0,"PACMA",0
46,"46113",2457,1804,1782,6,22,"PACMA",18
40,"40129",177,148,147,1,1,"PACMA",0
26,"26001",195,161,157,2,4,"PACMA",1
50,"50246",41,28,28,0,0,"PACMA",0
2,"2019",2405,1871,1835,12,36,"PACMA",5
7,"7023",3604,2498,2470,49,28,"PACMA",43
10,"10113",2338,1679,1638,9,41,"PACMA",16
41,"41052",3013,2116,2064,14,52,"PACMA",17
40,"40171",32,23,23,0,0,"PACMA",0
31,"31118",164,112,111,1,1,"PACMA",0
9,"9318",61,41,41,0,0,"PACMA",0
47,"47109",179,138,138,2,0,"PACMA",0
18,"18001",251,168,167,5,1,"PACMA",0
18,"18136",1851,1354,1337,5,17,"PACMA",2
7,"7051",5215,3171,3134,39,37,"PACMA",52
50,"50036",104,91,90,0,1,"PACMA",0
49,"49171",646,514,508,10,6,"PACMA",3
42,"42207",40,33,32,0,1,"PACMA",0
46,"46181",16955,12313,12148,95,165,"PACMA",170
25,"25015",357,219,219,2,0,"PACMA",2
47,"47070",37,27,27,0,0,"PACMA",0
37,"37005",74,54,54,2,0,"PACMA",0
22,"22160",209,168,168,6,0,"PACMA",1
37,"37238",110,87,85,0,2,"PACMA",0
49,"49065",1103,836,818,2,18,"PACMA",4
46,"46008",2651,2108,2089,21,19,"PACMA",10
19,"19011",250,184,184,0,0,"PACMA",1
49,"49121",365,273,273,2,0,"PACMA",1
42,"42215",773,531,520,7,11,"PACMA",2
9,"9308",67,42,42,1,0,"PACMA",0
47,"47036",228,181,181,3,0,"PACMA",0
20,"20907",118,85,85,2,0,"PACMA",0
25,"25032",64,44,44,1,0,"PACMA",1
37,"37253",135,109,109,2,0,"PACMA",1
24,"24050",102,77,76,0,1,"PACMA",0
48,"48076",308,218,217,2,1,"PACMA",0
10,"10152",468,340,332,1,8,"PACMA",0
24,"24100",761,561,555,7,6,"PACMA",0
27,"27033",623,415,409,8,6,"PACMA",0
19,"19246",46,36,34,2,2,"PACMA",0
4,"4038",3084,2140,2126,16,14,"PACMA",12
26,"26087",201,153,149,3,4,"PACMA",0
49,"49202",187,130,130,4,0,"PACMA",0
45,"45172",689,530,522,2,8,"PACMA",1
45,"45095",689,513,505,0,8,"PACMA",2
31,"31096",113,82,79,0,3,"PACMA",0
26,"26119",197,156,155,4,1,"PACMA",0
14,"14023",2021,1660,1639,8,21,"PACMA",11
38,"38017",28437,16239,16075,95,164,"PACMA",281
34,"34129",179,130,129,1,1,"PACMA",1
38,"38013",2949,1896,1867,17,29,"PACMA",17
4,"4036",226,175,175,0,0,"PACMA",1
44,"44237",398,304,301,4,3,"PACMA",0
5,"5238",782,565,563,5,2,"PACMA",2
4,"4100",8768,5390,5353,32,37,"PACMA",53
3,"3055",5164,3695,3647,21,48,"PACMA",39
34,"34146",51,40,39,0,1,"PACMA",0
45,"45029",201,171,171,1,0,"PACMA",0
47,"47003",227,180,179,3,1,"PACMA",2
18,"18173",8939,5922,5849,42,73,"PACMA",67
37,"37367",201,164,161,0,3,"PACMA",0
16,"16033",1714,1319,1305,6,14,"PACMA",9
50,"50281",73,51,50,0,1,"PACMA",0
22,"22156",289,220,220,2,0,"PACMA",7
37,"37371",272,165,162,1,3,"PACMA",0
46,"46239",442,340,338,3,2,"PACMA",3
22,"22004",135,81,80,0,1,"PACMA",0
45,"45190",475,371,366,0,5,"PACMA",2
37,"37052",273,209,209,2,0,"PACMA",1
31,"31098",1903,1428,1419,19,9,"PACMA",13
34,"34901",1104,825,814,5,11,"PACMA",9
46,"46098",2482,1907,1889,11,18,"PACMA",14
45,"45041",3752,2633,2597,12,36,"PACMA",35
5,"5252",64,45,45,1,0,"PACMA",0
45,"45016",4204,3146,3105,22,41,"PACMA",42
20,"20066",454,236,234,1,2,"PACMA",0
46,"46234",348,279,275,3,4,"PACMA",1
9,"9259",230,186,186,5,0,"PACMA",1
50,"50227",109,79,79,0,0,"PACMA",0
33,"33033",9873,6512,6431,68,81,"PACMA",42
5,"5097",475,317,313,0,4,"PACMA",0
47,"47121",544,437,425,6,12,"PACMA",0
44,"44011",52,40,38,0,2,"PACMA",2
37,"37174",1056,820,812,3,8,"PACMA",1
29,"29042",14016,9368,9192,88,176,"PACMA",91
46,"46203",3606,2873,2844,9,29,"PACMA",33
25,"25232",1397,874,871,12,3,"PACMA",5
46,"46027",943,780,771,5,9,"PACMA",2
9,"9287",208,158,156,3,2,"PACMA",0
40,"40069",83,66,63,0,3,"PACMA",0
27,"27025",2831,2152,2110,17,42,"PACMA",21
9,"9224",162,131,131,1,0,"PACMA",2
22,"22032",110,76,74,0,2,"PACMA",0
16,"16147",64,45,45,0,0,"PACMA",0
44,"44045",366,274,269,2,5,"PACMA",0
24,"24084",163,116,116,0,0,"PACMA",0
41,"41902",4659,2679,2646,23,33,"PACMA",28
47,"47058",200,145,143,0,2,"PACMA",1
9,"9419",78,55,55,0,0,"PACMA",0
46,"46074",2696,2069,2038,14,31,"PACMA",25
9,"9037",111,91,91,0,0,"PACMA",2
9,"9392",53,40,37,1,3,"PACMA",0
30,"30019",25857,17544,17374,125,170,"PACMA",195
40,"40222",168,145,144,0,1,"PACMA",2
50,"50175",1002,695,688,5,7,"PACMA",3
52,"52001",53306,27373,27012,267,361,"PACMA",316
18,"18137",989,761,760,7,1,"PACMA",3
6,"6067",1972,1308,1292,8,16,"PACMA",8
20,"20018",11064,6719,6690,41,29,"PACMA",12
5,"5067",83,68,67,0,1,"PACMA",0
13,"13056",11362,8288,8198,70,90,"PACMA",102
40,"40188",90,72,70,0,2,"PACMA",1
37,"37280",78,53,53,0,0,"PACMA",0
37,"37145",259,190,189,2,1,"PACMA",0
21,"21040",3170,2129,2071,20,58,"PACMA",29
45,"45037",1603,1122,1111,5,11,"PACMA",4
37,"37021",79,60,60,0,0,"PACMA",0
41,"41032",3984,2811,2725,27,86,"PACMA",31
14,"14007",15207,10558,10417,82,141,"PACMA",59
16,"16108",49,45,42,0,3,"PACMA",2
26,"26104",13,10,10,0,0,"PACMA",0
13,"13040",868,678,672,4,6,"PACMA",5
29,"29045",1684,1178,1168,8,10,"PACMA",25
22,"22096",301,240,240,0,0,"PACMA",1
10,"10148",32850,22161,21856,177,305,"PACMA",221
16,"16129",95,81,79,0,2,"PACMA",1
40,"40068",26,24,24,0,0,"PACMA",1
13,"13046",724,529,525,1,4,"PACMA",0
49,"49068",462,310,304,4,6,"PACMA",0
40,"40021",27,27,26,0,1,"PACMA",1
40,"40012",269,192,191,2,1,"PACMA",0
44,"44087",80,69,67,1,2,"PACMA",0
16,"16244",718,593,587,6,6,"PACMA",5
42,"42098",10,7,7,1,0,"PACMA",0
3,"3082",12567,8537,8464,44,73,"PACMA",97
24,"24157",2568,1943,1911,22,32,"PACMA",12
42,"42117",140,101,99,0,2,"PACMA",0
31,"31027",836,532,530,2,2,"PACMA",4
28,"28044",5826,4445,4409,24,36,"PACMA",48
44,"44235",92,62,60,0,2,"PACMA",0
34,"34158",288,186,184,3,2,"PACMA",1
9,"9117",76,60,60,0,0,"PACMA",1
29,"29003",983,754,743,1,11,"PACMA",2
33,"33038",2303,1584,1559,13,25,"PACMA",10
40,"40155",3518,2656,2605,18,51,"PACMA",32
44,"44003",19,17,17,0,0,"PACMA",0
39,"39015",839,647,642,4,5,"PACMA",4
48,"48032",5743,4065,4048,29,17,"PACMA",22
6,"6901",2118,1559,1546,23,13,"PACMA",17
31,"31106",698,533,529,3,4,"PACMA",5
50,"50048",34,29,29,0,0,"PACMA",0
45,"45191",543,472,468,3,4,"PACMA",0
9,"9103",217,184,183,1,1,"PACMA",0
10,"10177",1707,1228,1201,5,27,"PACMA",9
49,"49131",264,194,192,6,2,"PACMA",1
22,"22127",505,374,371,3,3,"PACMA",6
37,"37222",93,72,72,0,0,"PACMA",1
22,"22175",197,143,142,1,1,"PACMA",4
50,"50176",236,165,165,3,0,"PACMA",0
47,"47211",47,35,34,0,1,"PACMA",0
6,"6079",652,449,442,4,7,"PACMA",0
19,"19213",70,62,61,2,1,"PACMA",0
37,"37099",73,41,41,0,0,"PACMA",0
47,"47189",152,119,118,0,1,"PACMA",0
19,"19005",84,66,66,0,0,"PACMA",0
45,"45006",1406,942,931,4,11,"PACMA",2
39,"39023",6330,4737,4672,25,65,"PACMA",59
37,"37229",135,112,112,0,0,"PACMA",0
48,"48902",19008,12566,12447,76,119,"PACMA",102
22,"22060",1164,858,850,3,8,"PACMA",4
41,"41033",5075,3313,3277,34,36,"PACMA",20
19,"19214",75,60,58,0,2,"PACMA",0
49,"49188",112,90,89,1,1,"PACMA",1
34,"34024",31,21,21,1,0,"PACMA",0
37,"37143",389,301,300,6,1,"PACMA",1
25,"25220",1015,634,632,1,2,"PACMA",4
39,"39004",1518,1090,1074,4,16,"PACMA",5
37,"37036",61,44,43,0,1,"PACMA",0
19,"19003",42,35,34,1,1,"PACMA",0
37,"37242",91,74,73,0,1,"PACMA",1
22,"22129",183,120,118,1,2,"PACMA",0
46,"46079",318,241,232,1,9,"PACMA",2
34,"34229",68,57,56,1,1,"PACMA",0
50,"50264",156,115,115,0,0,"PACMA",4
23,"23050",90992,64810,64218,485,592,"PACMA",912
25,"25079",299,198,193,2,5,"PACMA",0
19,"19139",29,19,18,0,1,"PACMA",0
9,"9060",145,114,113,2,1,"PACMA",1
14,"14038",32322,22117,21887,179,230,"PACMA",185
46,"46115",378,286,282,1,4,"PACMA",0
10,"10116",3749,2726,2670,21,56,"PACMA",15
37,"37020",430,326,321,1,5,"PACMA",5
37,"37104",27,22,22,0,0,"PACMA",0
34,"34222",120,87,87,3,0,"PACMA",1
5,"5170",50,43,43,0,0,"PACMA",0
39,"39003",297,220,215,0,5,"PACMA",0
44,"44089",45,39,39,1,0,"PACMA",0
19,"19161",211,159,157,1,2,"PACMA",2
10,"10146",1507,1004,977,7,27,"PACMA",4
10,"10163",350,293,290,2,3,"PACMA",1
49,"49178",705,496,487,4,9,"PACMA",2
45,"45132",2197,1645,1632,14,13,"PACMA",13
12,"12038",167,120,118,2,2,"PACMA",1
34,"34225",4921,3588,3559,30,29,"PACMA",42
28,"28165",1794,1293,1285,3,8,"PACMA",5
2,"2071",1011,831,825,5,6,"PACMA",2
37,"37226",155,123,123,2,0,"PACMA",0
27,"27048",2140,1502,1467,20,35,"PACMA",3
40,"40036",515,421,410,3,11,"PACMA",0
45,"45103",397,331,327,3,4,"PACMA",0
23,"23041",499,398,394,2,4,"PACMA",0
12,"12108",456,378,371,2,7,"PACMA",2
6,"6085",3428,2453,2414,25,39,"PACMA",15
11,"11026",4782,3451,3378,26,73,"PACMA",19
26,"26046",1581,1175,1159,4,16,"PACMA",4
33,"33065",1102,722,713,7,9,"PACMA",4
50,"50118",2165,1552,1540,10,12,"PACMA",14
19,"19048",18,15,15,1,0,"PACMA",0
38,"38043",18892,13089,12928,87,161,"PACMA",220
20,"20065",3012,1985,1967,12,18,"PACMA",7
46,"46206",571,453,445,2,8,"PACMA",5
16,"16152",38,32,32,0,0,"PACMA",0
45,"45039",224,192,190,0,2,"PACMA",2
16,"16166",243,176,174,1,2,"PACMA",1
26,"26153",13,12,11,0,1,"PACMA",0
10,"10080",366,257,255,1,2,"PACMA",0
16,"16196",633,508,503,2,5,"PACMA",1
22,"22075",125,83,83,1,0,"PACMA",1
18,"18185",541,434,432,2,2,"PACMA",3
10,"10112",1571,1107,1081,9,26,"PACMA",5
26,"26118",59,48,48,2,0,"PACMA",0
37,"37103",436,310,308,8,2,"PACMA",2
12,"12051",471,339,335,1,4,"PACMA",0
28,"28061",21389,16277,16135,67,142,"PACMA",222
2,"2062",408,297,292,0,5,"PACMA",0
37,"37197",84,57,57,2,0,"PACMA",0
50,"50167",233,183,178,1,5,"PACMA",0
12,"12013",144,121,119,0,2,"PACMA",0
34,"34086",103,89,88,0,1,"PACMA",2
29,"29901",43826,29318,29107,250,211,"PACMA",577
49,"49187",1236,896,888,4,8,"PACMA",1
20,"20034",3145,2026,2014,14,12,"PACMA",18
33,"33062",400,238,233,2,5,"PACMA",0
22,"22062",167,116,116,1,0,"PACMA",1
46,"46149",363,271,268,2,3,"PACMA",1
40,"40203",899,722,715,4,7,"PACMA",12
45,"45193",613,504,497,1,7,"PACMA",2
42,"42006",163,109,107,2,2,"PACMA",1
26,"26166",141,124,122,0,2,"PACMA",2
24,"24044",168,119,118,1,1,"PACMA",1
2,"2078",920,675,664,1,11,"PACMA",6
26,"26140",253,208,206,0,2,"PACMA",0
18,"18124",381,277,277,2,0,"PACMA",0
44,"44032",16,11,11,0,0,"PACMA",0
41,"41056",3687,2841,2812,30,29,"PACMA",18
21,"21013",10591,6580,6452,55,128,"PACMA",84
25,"25104",130,76,74,1,2,"PACMA",0
46,"46089",2132,1602,1574,9,28,"PACMA",12
37,"37311",227,182,182,3,0,"PACMA",0
29,"29005",4358,2859,2817,28,42,"PACMA",30
9,"9023",1102,818,811,11,7,"PACMA",4
20,"20009",11452,7388,7345,62,43,"PACMA",63
33,"33028",1276,649,641,4,8,"PACMA",5
29,"29021",161,108,107,4,1,"PACMA",1
46,"46033",191,156,155,0,1,"PACMA",6
46,"46216",5053,4109,4090,14,19,"PACMA",47
37,"37321",168,132,132,2,0,"PACMA",0
50,"50136",575,414,410,2,4,"PACMA",2
50,"50252",5138,3642,3611,24,31,"PACMA",10
37,"37037",117,84,82,0,2,"PACMA",0
46,"46177",4690,3579,3526,19,53,"PACMA",37
30,"30025",4908,3667,3630,16,37,"PACMA",39
29,"29047",1117,885,866,1,19,"PACMA",5
21,"21029",1562,1127,1097,14,30,"PACMA",5
3,"3106",583,480,478,2,2,"PACMA",4
9,"9024",156,112,110,1,2,"PACMA",0
46,"46111",10930,7931,7828,44,103,"PACMA",91
45,"45070",1427,1147,1142,1,5,"PACMA",9
40,"40158",17,12,12,0,0,"PACMA",0
24,"24034",3394,2380,2342,28,38,"PACMA",23
13,"13052",6422,4651,4580,46,71,"PACMA",40
24,"24129",122,89,89,1,0,"PACMA",2
40,"40148",238,188,187,2,1,"PACMA",0
46,"46227",905,711,702,1,9,"PACMA",7
26,"26173",6,6,6,1,0,"PACMA",0
29,"29049",2962,2132,2110,5,22,"PACMA",12
10,"10205",2020,1319,1293,5,26,"PACMA",9
24,"24052",158,104,102,0,2,"PACMA",0
49,"49229",126,93,93,0,0,"PACMA",3
42,"42003",67,48,47,0,1,"PACMA",0
28,"28145",2431,1760,1736,6,24,"PACMA",19
18,"18076",804,551,549,1,2,"PACMA",1
20,"20061",4273,2601,2590,21,11,"PACMA",16
27,"27014",3254,2103,2067,21,36,"PACMA",8
41,"41017",15158,10718,10616,92,102,"PACMA",161
35,"35023",11686,8212,8076,55,136,"PACMA",68
16,"16096",274,232,229,1,3,"PACMA",2
9,"9298",82,70,69,1,1,"PACMA",0
5,"5066",453,367,367,5,0,"PACMA",0
24,"24049",1483,1054,1048,6,6,"PACMA",8
10,"10210",543,356,355,1,1,"PACMA",2
22,"22184",184,155,155,3,0,"PACMA",1
24,"24133",356,257,257,1,0,"PACMA",2
46,"46010",935,729,723,4,6,"PACMA",6
42,"42121",64,47,47,0,0,"PACMA",0
47,"47200",85,66,66,0,0,"PACMA",0
46,"46219",127,112,112,1,0,"PACMA",1
24,"24230",426,322,320,5,2,"PACMA",4
18,"18061",1057,812,804,1,8,"PACMA",3
50,"50210",38,30,30,1,0,"PACMA",0
7,"7028",899,601,595,7,6,"PACMA",9
47,"47164",378,313,311,1,2,"PACMA",1
42,"42128",42,42,41,1,1,"PACMA",0
49,"49189",202,142,142,1,0,"PACMA",0
9,"9127",56,41,39,0,2,"PACMA",0
28,"28074",138947,103687,102762,620,925,"PACMA",1243
9,"9423",27,24,24,0,0,"PACMA",0
19,"19240",51,44,42,0,2,"PACMA",0
19,"19133",83,72,72,0,0,"PACMA",0
37,"37161",136,106,106,1,0,"PACMA",0
39,"39014",883,619,614,6,5,"PACMA",6
21,"21005",15523,9038,8913,56,125,"PACMA",73
9,"9130",74,51,50,1,1,"PACMA",0
9,"9905",384,279,279,2,0,"PACMA",1
40,"40025",136,117,115,0,2,"PACMA",0
44,"44155",1090,793,782,4,11,"PACMA",3
11,"11023",9348,6410,6349,64,61,"PACMA",65
47,"47020",280,234,231,2,3,"PACMA",0
40,"40193",229,174,172,3,2,"PACMA",2
41,"41903",6757,4562,4504,51,58,"PACMA",49
34,"34006",81,67,66,2,1,"PACMA",0
46,"46120",1113,903,875,2,28,"PACMA",5
42,"42192",42,27,27,2,0,"PACMA",0
20,"20031",176,90,90,0,0,"PACMA",0
45,"45169",189,140,138,0,2,"PACMA",2
41,"41013",4839,3151,3094,33,57,"PACMA",6
26,"26035",17,12,11,0,1,"PACMA",0
19,"19080",65,41,41,0,0,"PACMA",0
42,"42212",69,43,43,1,0,"PACMA",0
19,"19040",52,41,39,0,2,"PACMA",0
23,"23905",1868,1277,1272,6,5,"PACMA",3
26,"26024",228,181,181,0,0,"PACMA",1
45,"45092",232,197,191,0,6,"PACMA",0
15,"15033",2472,1863,1845,8,18,"PACMA",16
32,"32008",8256,5542,5490,39,52,"PACMA",68
36,"36058",4994,3292,3243,33,49,"PACMA",26
36,"36038",66390,47750,47273,449,477,"PACMA",537
32,"32054",87167,60059,59333,540,726,"PACMA",744
32,"32022",1337,892,881,6,11,"PACMA",4
36,"36013",2344,1536,1514,11,22,"PACMA",12
15,"15003",1803,1227,1210,9,17,"PACMA",6
15,"15078",78198,56154,55581,560,573,"PACMA",590
15,"15069",6745,4910,4850,43,60,"PACMA",53
32,"32042",1579,1094,1081,12,13,"PACMA",9
36,"36043",4747,3210,3162,20,48,"PACMA",36
32,"32053",1438,1158,1144,11,14,"PACMA",6
36,"36026",20137,13779,13596,141,183,"PACMA",158
15,"15066",4009,2814,2776,33,38,"PACMA",15
36,"36015",4153,2721,2677,23,44,"PACMA",20
15,"15045",3770,2184,2157,14,27,"PACMA",9
15,"15004",4834,3436,3391,30,45,"PACMA",26
36,"36055",13620,9580,9400,62,180,"PACMA",133
15,"15079",1540,1027,1007,16,20,"PACMA",2
15,"15048",4839,3456,3414,36,42,"PACMA",35
32,"32039",1262,957,941,6,16,"PACMA",5
32,"32074",1044,710,704,4,6,"PACMA",8
32,"32043",2561,1806,1774,9,32,"PACMA",9
36,"36901",4103,3153,3102,19,51,"PACMA",21
36,"36009",4503,3056,3001,15,55,"PACMA",14
36,"36005",8121,5480,5400,52,80,"PACMA",53
15,"15011",15432,10395,10248,74,147,"PACMA",129
15,"15070",9069,6090,5976,94,114,"PACMA",64
36,"36003",9980,7191,7110,67,81,"PACMA",57
32,"32084",918,641,635,3,6,"PACMA",1
36,"36018",3240,2198,2170,10,28,"PACMA",10
36,"36051",14267,9638,9493,71,145,"PACMA",103
15,"15041",9568,6828,6710,75,118,"PACMA",58
36,"36023",8395,5965,5884,41,81,"PACMA",59
32,"32083",835,559,550,4,9,"PACMA",3
36,"36030",4175,2832,2785,27,47,"PACMA",25
15,"15028",1409,1038,1024,6,14,"PACMA",12
36,"36002",3147,2193,2169,20,24,"PACMA",6
15,"15027",1536,1182,1155,6,27,"PACMA",9
32,"32044",876,643,634,2,9,"PACMA",6
32,"32079",1333,950,939,11,11,"PACMA",3
15,"15019",25888,16680,16460,186,220,"PACMA",162
32,"32023",1210,862,849,4,13,"PACMA",7
15,"15013",6151,4237,4189,48,48,"PACMA",51
36,"36034",3475,2403,2367,11,36,"PACMA",24
32,"32048",895,574,569,5,5,"PACMA",3
15,"15015",2799,2045,2008,24,37,"PACMA",22
15,"15053",7729,5089,5043,49,46,"PACMA",43
36,"36019",1625,1042,1029,9,13,"PACMA",5
32,"32029",470,357,352,4,5,"PACMA",0
36,"36006",11520,8529,8396,63,133,"PACMA",116
15,"15071",7951,5255,5178,50,77,"PACMA",55
32,"32038",436,278,271,2,7,"PACMA",1
32,"32002",2017,1413,1398,16,15,"PACMA",7
32,"32007",1517,1046,1028,8,18,"PACMA",6
15,"15056",5722,3869,3818,46,51,"PACMA",22
36,"36046",4036,2971,2921,15,50,"PACMA",21
36,"36021",12073,8447,8342,89,105,"PACMA",114
32,"32024",4821,3320,3254,34,66,"PACMA",21
32,"32070",548,335,329,3,6,"PACMA",2
15,"15032",3444,2322,2269,30,53,"PACMA",11
32,"32063",1914,1297,1279,16,18,"PACMA",7
36,"36054",10993,7476,7363,67,113,"PACMA",67
32,"32040",1477,1090,1084,7,6,"PACMA",3
32,"32012",784,505,497,2,8,"PACMA",2
32,"32065",657,463,454,3,9,"PACMA",7
36,"36025",2257,1360,1350,10,10,"PACMA",8
15,"15052",4314,2889,2838,21,51,"PACMA",17
15,"15901",3546,2247,2228,24,19,"PACMA",16
32,"32021",947,634,630,5,4,"PACMA",4
36,"36056",5076,3584,3515,30,69,"PACMA",35
15,"15016",4749,3058,3020,19,38,"PACMA",15
32,"32069",4308,3221,3164,27,57,"PACMA",35
32,"32047",1784,1255,1244,9,11,"PACMA",5
15,"15091",1135,771,760,13,11,"PACMA",8
36,"36042",17891,12212,12003,93,209,"PACMA",152
32,"32016",790,550,543,2,7,"PACMA",5
15,"15083",1086,757,746,5,11,"PACMA",1
32,"32073",1315,973,960,5,13,"PACMA",6
32,"32034",1124,845,839,5,6,"PACMA",9
15,"15008",5627,4112,4072,36,40,"PACMA",49
32,"32089",1295,888,878,7,10,"PACMA",9
15,"15040",2753,1905,1880,5,25,"PACMA",7
15,"15073",21827,14058,13864,126,194,"PACMA",151
32,"32058",5202,3650,3607,34,43,"PACMA",38
36,"36010",2847,2102,2076,13,26,"PACMA",17
15,"15902",4598,3209,3149,51,60,"PACMA",11
15,"15089",4291,3020,2972,28,48,"PACMA",19
36,"36017",17782,12411,12240,117,171,"PACMA",85
36,"36050",7561,5280,5188,25,92,"PACMA",60
15,"15055",4572,3070,3013,27,57,"PACMA",35
36,"36059",4882,3137,3085,28,52,"PACMA",35
15,"15086",2869,1970,1950,13,20,"PACMA",10
36,"36029",16077,11617,11471,100,146,"PACMA",107
15,"15046",6332,4377,4262,40,115,"PACMA",19
32,"32090",774,530,511,4,19,"PACMA",3
15,"15087",5769,3766,3722,42,44,"PACMA",24
32,"32028",1610,1211,1189,16,22,"PACMA",3
32,"32049",760,510,507,9,3,"PACMA",2
32,"32011",932,619,613,1,6,"PACMA",1
36,"36014",1942,1459,1444,9,15,"PACMA",11
15,"15058",27793,20392,20235,221,157,"PACMA",262
36,"36040",2575,1709,1680,15,29,"PACMA",12
32,"32068",1415,982,978,5,4,"PACMA",5
32,"32078",1188,855,838,4,17,"PACMA",4
15,"15036",57885,39471,39096,417,375,"PACMA",436
15,"15012",3627,2659,2602,28,57,"PACMA",21
15,"15049",1098,758,752,7,6,"PACMA",1
36,"36057",236673,169244,167605,1366,1639,"PACMA",2396
15,"15039",1263,889,875,7,14,"PACMA",11
15,"15014",4002,2566,2524,28,42,"PACMA",13
32,"32062",811,621,617,6,4,"PACMA",2
15,"15054",32106,21026,20772,259,254,"PACMA",311
15,"15080",1756,1131,1117,11,14,"PACMA",5
32,"32010",388,301,299,3,2,"PACMA",1
36,"36049",6804,4960,4860,36,100,"PACMA",49
32,"32075",4217,3089,3044,33,45,"PACMA",31
15,"15037",4061,2588,2552,19,36,"PACMA",10
32,"32088",1622,1018,1002,8,16,"PACMA",5
36,"36024",16455,11971,11781,109,190,"PACMA",92
32,"32006",1531,1114,1090,10,24,"PACMA",4
15,"15061",5571,3746,3691,27,55,"PACMA",41
32,"32064",529,389,388,3,1,"PACMA",2
15,"15085",3332,2280,2247,25,33,"PACMA",10
36,"36033",12298,8968,8788,53,180,"PACMA",91
15,"15082",15180,10841,10726,102,115,"PACMA",116
15,"15067",8029,5789,5732,37,57,"PACMA",56
32,"32017",1244,870,857,6,13,"PACMA",3
15,"15029",5688,3590,3544,32,46,"PACMA",16
36,"36027",4430,3137,3101,15,36,"PACMA",23
32,"32081",2077,1517,1500,14,17,"PACMA",9
32,"32059",1790,1283,1263,7,20,"PACMA",6
32,"32013",2183,1428,1425,8,3,"PACMA",11
15,"15006",5321,3341,3283,49,58,"PACMA",16
32,"32033",737,478,476,3,2,"PACMA",4
32,"32041",767,524,515,4,9,"PACMA",2
15,"15005",24516,15761,15537,213,224,"PACMA",248
15,"15031",23348,16380,16235,191,145,"PACMA",199
15,"15057",12075,8479,8377,66,102,"PACMA",88
15,"15077",8261,5186,5103,59,83,"PACMA",28
36,"36052",7292,4999,4907,45,92,"PACMA",31
32,"32051",1427,1184,1172,6,12,"PACMA",6
32,"32027",1053,765,749,2,16,"PACMA",8
36,"36016",1143,721,711,3,10,"PACMA",2
32,"32037",728,518,509,6,9,"PACMA",2
15,"15018",1142,741,732,18,9,"PACMA",2
32,"32018",1247,975,962,9,13,"PACMA",3
15,"15017",19420,13661,13505,175,156,"PACMA",176
36,"36022",9011,6310,6172,49,138,"PACMA",58
15,"15023",6419,4348,4261,36,87,"PACMA",34
32,"32019",11537,7975,7861,56,114,"PACMA",77
15,"15035",11427,7779,7657,144,122,"PACMA",87
36,"36031",558,465,459,7,6,"PACMA",5
32,"32005",861,662,650,7,12,"PACMA",2
32,"32072",3821,2705,2667,24,38,"PACMA",7
15,"15020",3784,2476,2447,17,29,"PACMA",17
32,"32003",885,654,649,5,5,"PACMA",5
32,"32060",832,583,576,8,7,"PACMA",6
32,"32004",1798,1029,1023,4,6,"PACMA",5
32,"32026",2704,1929,1896,22,33,"PACMA",17
15,"15010",1887,1168,1150,13,18,"PACMA",12
32,"32036",1345,971,953,14,18,"PACMA",4
32,"32082",1243,891,878,1,13,"PACMA",2
36,"36012",3732,2751,2717,9,34,"PACMA",36
32,"32092",520,321,320,6,1,"PACMA",3
36,"36007",1672,1119,1099,8,20,"PACMA",9
36,"36061",8606,6232,6133,41,99,"PACMA",84
15,"15090",1179,812,804,9,8,"PACMA",5
15,"15042",3028,2033,2000,19,33,"PACMA",7
15,"15092",6438,3976,3903,28,73,"PACMA",27
32,"32025",1079,791,777,1,14,"PACMA",7
32,"32066",566,418,416,0,2,"PACMA",2
15,"15007",3303,2262,2246,15,16,"PACMA",12
15,"15024",4393,3141,3073,32,68,"PACMA",28
15,"15081",1034,791,782,11,9,"PACMA",2
15,"15076",2611,1758,1739,17,19,"PACMA",13
15,"15064",2194,1592,1556,21,36,"PACMA",24
32,"32086",2646,1693,1677,13,16,"PACMA",8
15,"15022",5785,3811,3771,33,40,"PACMA",32
32,"32045",2443,1715,1690,14,25,"PACMA",11
32,"32085",10716,7279,7152,66,127,"PACMA",42
36,"36037",2571,1733,1707,11,26,"PACMA",12
36,"36001",2564,1858,1848,5,10,"PACMA",15
15,"15060",5772,4032,3958,46,74,"PACMA",38
32,"32087",1765,1363,1343,13,20,"PACMA",8
36,"36008",21762,15447,15262,128,185,"PACMA",177
36,"36060",30323,21399,21162,164,237,"PACMA",311
32,"32035",1442,957,942,3,15,"PACMA",3
36,"36004",10161,6939,6844,63,95,"PACMA",79
32,"32056",1592,1124,1118,7,6,"PACMA",0
15,"15068",5049,3185,3129,25,56,"PACMA",20
15,"15047",2429,1576,1549,19,27,"PACMA",3
36,"36020",2318,1646,1620,18,26,"PACMA",15
15,"15021",5127,3587,3543,38,44,"PACMA",31
15,"15001",4765,3280,3237,25,43,"PACMA",26
15,"15074",4037,2841,2796,20,45,"PACMA",19
15,"15038",2227,1463,1443,25,20,"PACMA",9
32,"32071",1476,1010,1005,3,5,"PACMA",5
32,"32001",4986,3488,3443,25,45,"PACMA",34
36,"36045",24529,17613,17336,129,277,"PACMA",211
36,"36028",4102,2913,2868,17,45,"PACMA",19
32,"32030",999,736,726,3,10,"PACMA",1
15,"15050",1822,1004,988,13,16,"PACMA",3
36,"36036",2518,1827,1801,18,26,"PACMA",18
15,"15059",10362,7258,7106,91,152,"PACMA",52
36,"36032",3630,2587,2535,16,52,"PACMA",23
15,"15051",4638,3182,3153,44,29,"PACMA",33
32,"32052",1888,1399,1379,6,20,"PACMA",9
32,"32080",328,249,244,5,5,"PACMA",0
32,"32031",1069,822,795,4,27,"PACMA",8
15,"15065",7315,5187,5099,42,88,"PACMA",45
32,"32014",1142,848,834,6,14,"PACMA",1
15,"15009",10739,7688,7559,54,129,"PACMA",85
32,"32015",874,575,573,4,2,"PACMA",0
32,"32046",1160,787,779,4,8,"PACMA",4
15,"15025",1061,629,622,6,7,"PACMA",3
15,"15084",3260,2218,2191,27,27,"PACMA",15
32,"32020",2576,1923,1899,5,24,"PACMA",9
15,"15030",200176,143255,142070,1452,1185,"PACMA",1683
32,"32009",10803,7303,7227,48,76,"PACMA",75
15,"15075",12336,8830,8725,91,105,"PACMA",114
15,"15002",23083,16073,15889,159,184,"PACMA",221
15,"15093",4220,2533,2498,30,35,"PACMA",16
36,"36048",5331,3653,3603,22,50,"PACMA",39
36,"36041",13434,9297,9181,66,116,"PACMA",104
36,"36053",5684,4099,4050,38,49,"PACMA",37
36,"36011",1799,1144,1122,8,22,"PACMA",4
32,"32032",8059,5708,5608,58,100,"PACMA",19
15,"15044",1286,937,927,8,10,"PACMA",9
15,"15034",2885,1782,1760,18,22,"PACMA",11
32,"32055",1280,891,881,7,10,"PACMA",7
36,"36047",2454,1633,1621,13,12,"PACMA",2
36,"36044",2541,1674,1646,7,28,"PACMA",15
32,"32050",2433,1829,1814,12,15,"PACMA",8
32,"32061",1081,812,809,4,3,"PACMA",5
15,"15072",9574,6637,6562,35,75,"PACMA",67
15,"15088",3519,2304,2270,27,34,"PACMA",14
32,"32091",1838,1368,1362,6,6,"PACMA",0
15,"15043",5114,3476,3401,47,75,"PACMA",31
32,"32057",565,416,415,4,1,"PACMA",2
32,"32077",1166,791,785,14,6,"PACMA",8
36,"36035",14433,10333,10188,79,145,"PACMA",131
32,"32067",1294,837,826,8,11,"PACMA",5
32,"32076",2094,1488,1474,20,14,"PACMA",3
36,"36039",15401,10871,10609,71,262,"PACMA",137
15,"15062",5887,3747,3701,36,46,"PACMA",39
17,"17191",141,92,89,1,3,"PACMA",1
8,"8127",2225,1349,1334,14,15,"PACMA",25
8,"8078",219,112,111,3,1,"PACMA",2
8,"8286",2879,1802,1797,14,5,"PACMA",45
8,"8201",442,278,278,4,0,"PACMA",5
43,"43061",45,30,29,0,1,"PACMA",0
43,"43078",846,543,531,8,12,"PACMA",3
8,"8118",17547,12183,12108,105,75,"PACMA",219
17,"17050",652,453,453,3,0,"PACMA",5
17,"17077",548,369,368,1,1,"PACMA",6
17,"17157",125,95,95,1,0,"PACMA",0
8,"8076",16169,10652,10563,75,89,"PACMA",199
8,"8237",1643,1105,1096,8,9,"PACMA",6
8,"8081",339,222,221,3,1,"PACMA",3
43,"43130",195,127,127,1,0,"PACMA",2
17,"17169",2475,1619,1601,11,18,"PACMA",24
17,"17054",370,236,236,1,0,"PACMA",0
17,"17058",177,101,100,3,1,"PACMA",1
8,"8036",163,105,104,1,1,"PACMA",1
43,"43043",3130,2053,2036,18,17,"PACMA",39
8,"8199",663,456,453,14,3,"PACMA",7
43,"43143",54,47,47,3,0,"PACMA",0
8,"8231",20564,13037,12952,96,85,"PACMA",279
43,"43906",2102,1364,1346,15,18,"PACMA",8
43,"43175",554,363,360,5,3,"PACMA",1
8,"8223",1852,1182,1171,12,11,"PACMA",11
8,"8197",7648,5020,5000,37,20,"PACMA",103
8,"8259",6637,4611,4577,39,34,"PACMA",70
17,"17081",246,163,162,2,1,"PACMA",1
43,"43042",2129,1439,1437,12,2,"PACMA",23
17,"17168",380,260,258,0,2,"PACMA",2
17,"17129",133,101,101,1,0,"PACMA",2
43,"43092",7036,4226,4185,39,41,"PACMA",67
8,"8215",2588,1663,1647,16,16,"PACMA",18
8,"8005",6205,4187,4167,22,20,"PACMA",56
43,"43075",89,61,60,1,1,"PACMA",0
17,"17085",301,215,214,5,1,"PACMA",5
17,"17207",2375,1590,1579,11,11,"PACMA",11
17,"17140",670,478,473,5,5,"PACMA",3
8,"8241",73,52,52,0,0,"PACMA",0
43,"43154",130,101,100,0,1,"PACMA",0
17,"17125",130,80,80,0,0,"PACMA",1
17,"17177",549,332,331,1,1,"PACMA",2
17,"17089",5543,3349,3326,22,23,"PACMA",64
17,"17011",637,444,439,6,5,"PACMA",5
8,"8280",97,66,66,2,0,"PACMA",0
8,"8117",2450,1602,1594,11,8,"PACMA",12
17,"17112",190,127,125,2,2,"PACMA",0
43,"43170",868,566,562,5,4,"PACMA",6
17,"17152",10737,6308,6252,45,56,"PACMA",101
43,"43111",2044,1291,1275,9,16,"PACMA",32
8,"8218",8009,5105,5075,59,30,"PACMA",63
8,"8230",7635,5177,5121,54,56,"PACMA",94
43,"43160",1276,837,826,8,11,"PACMA",18
8,"8275",247,179,179,4,0,"PACMA",4
17,"17159",643,413,406,3,7,"PACMA",4
17,"17196",220,150,150,4,0,"PACMA",7
8,"8270",18490,12343,12274,93,69,"PACMA",248
43,"43079",364,248,248,0,0,"PACMA",4
8,"8214",6872,4699,4675,47,24,"PACMA",100
8,"8006",11470,7210,7132,60,78,"PACMA",135
8,"8003",7084,4839,4803,39,36,"PACMA",97
8,"8007",6483,4281,4250,33,31,"PACMA",101
43,"43025",600,408,404,2,4,"PACMA",2
17,"17036",2717,1730,1716,15,14,"PACMA",18
17,"17194",80,55,54,0,1,"PACMA",2
8,"8905",2346,1689,1681,26,8,"PACMA",40
17,"17088",533,368,366,4,2,"PACMA",2
17,"17024",268,153,152,1,1,"PACMA",3
8,"8103",625,395,395,2,0,"PACMA",10
8,"8010",4168,2631,2606,20,25,"PACMA",42
8,"8204",3055,2094,2082,17,12,"PACMA",37
8,"8067",5739,3616,3577,47,39,"PACMA",50
17,"17060",424,268,266,5,2,"PACMA",2
43,"43021",357,232,231,6,1,"PACMA",5
43,"43034",477,350,342,9,8,"PACMA",5
8,"8256",650,484,484,5,0,"PACMA",13
8,"8149",993,569,567,10,2,"PACMA",11
8,"8104",679,432,430,3,2,"PACMA",5
43,"43067",552,397,393,2,4,"PACMA",6
43,"43157",353,268,264,5,4,"PACMA",1
17,"17117",14353,8469,8426,49,43,"PACMA",129
17,"17147",8053,4988,4933,52,55,"PACMA",81
43,"43097",393,291,289,1,2,"PACMA",4
17,"17173",180,132,131,0,1,"PACMA",0
43,"43003",324,217,217,3,0,"PACMA",0
17,"17063",162,111,109,0,2,"PACMA",0
17,"17025",1134,793,787,6,6,"PACMA",5
8,"8232",1775,1183,1176,6,7,"PACMA",17
17,"17130",325,223,222,3,1,"PACMA",1
17,"17056",1715,1120,1106,16,14,"PACMA",7
8,"8177",40,30,30,0,0,"PACMA",0
17,"17028",293,205,204,6,1,"PACMA",3
43,"43031",1458,1020,1014,15,6,"PACMA",7
43,"43083",144,109,108,0,1,"PACMA",3
8,"8043",3201,2056,2041,9,15,"PACMA",41
17,"17199",6853,4147,4122,27,25,"PACMA",68
17,"17004",512,335,334,4,1,"PACMA",3
8,"8151",466,288,287,2,1,"PACMA",2
8,"8109",216,162,161,0,1,"PACMA",0
43,"43133",5666,3397,3356,27,41,"PACMA",34
17,"17145",1482,967,956,8,11,"PACMA",12
8,"8038",1487,959,954,15,5,"PACMA",16
8,"8192",5678,3729,3707,35,22,"PACMA",38
8,"8030",5122,3482,3466,21,16,"PACMA",72
43,"43058",90,63,63,0,0,"PACMA",0
17,"17014",64,48,48,1,0,"PACMA",1
17,"17233",2260,1528,1514,23,14,"PACMA",27
17,"17197",132,102,101,1,1,"PACMA",3
43,"43150",1281,937,923,6,14,"PACMA",12
17,"17100",194,133,131,3,2,"PACMA",0
17,"17217",354,265,263,2,2,"PACMA",1
8,"8130",95,56,55,0,1,"PACMA",1
8,"8101",174621,113632,112942,847,690,"PACMA",2003
17,"17101",559,347,338,2,9,"PACMA",10
43,"43053",191,144,143,3,1,"PACMA",0
8,"8172",20326,13875,13802,92,73,"PACMA",273
17,"17020",3592,2333,2315,20,18,"PACMA",46
8,"8114",18292,12102,12009,72,93,"PACMA",205
17,"17038",366,234,232,6,2,"PACMA",7
17,"17067",696,467,464,5,3,"PACMA",7
8,"8032",1981,1319,1311,11,8,"PACMA",36
8,"8016",1831,1136,1129,19,7,"PACMA",12
8,"8140",4774,3118,3098,23,20,"PACMA",60
17,"17071",1134,778,774,10,4,"PACMA",10
17,"17052",125,78,78,0,0,"PACMA",2
8,"8185",188,123,122,2,1,"PACMA",1
8,"8024",386,243,236,0,7,"PACMA",1
17,"17010",336,224,224,3,0,"PACMA",2
17,"17016",731,500,496,1,4,"PACMA",4
8,"8904",10553,6623,6579,52,44,"PACMA",151
17,"17107",264,167,165,8,2,"PACMA",1
17,"17216",165,110,110,1,0,"PACMA",4
8,"8220",2356,1690,1683,18,7,"PACMA",8
8,"8133",128,72,72,0,0,"PACMA",0
8,"8189",127,90,89,3,1,"PACMA",0
8,"8100",2001,1395,1380,25,15,"PACMA",9
43,"43048",805,525,513,8,12,"PACMA",6
17,"17150",1401,962,951,6,11,"PACMA",16
17,"17183",277,180,179,1,1,"PACMA",9
17,"17218",582,404,401,1,3,"PACMA",4
17,"17198",429,270,267,2,3,"PACMA",6
8,"8249",266,211,209,2,2,"PACMA",3
8,"8901",227,148,145,1,3,"PACMA",0
17,"17142",2550,1806,1797,30,9,"PACMA",28
43,"43178",1350,856,844,5,12,"PACMA",11
17,"17062",5958,3463,3441,22,22,"PACMA",50
8,"8903",214,166,165,0,1,"PACMA",0
17,"17039",1759,1159,1145,14,14,"PACMA",8
43,"43151",107,90,89,0,1,"PACMA",3
8,"8063",453,337,336,4,1,"PACMA",4
8,"8161",11144,6994,6938,73,56,"PACMA",171
8,"8255",134,78,78,0,0,"PACMA",1
8,"8283",5963,3670,3642,24,28,"PACMA",57
43,"43038",21366,13061,12943,111,118,"PACMA",228
17,"17118",12711,7567,7515,42,52,"PACMA",106
8,"8299",391,244,244,5,0,"PACMA",4
8,"8002",201,130,124,0,6,"PACMA",0
43,"43093",3919,2461,2434,47,27,"PACMA",31
8,"8144",717,447,437,5,10,"PACMA",3
8,"8267",6461,4265,4245,51,20,"PACMA",100
8,"8282",6578,4714,4690,45,24,"PACMA",80
8,"8091",5244,3611,3584,17,27,"PACMA",52
43,"43161",17197,10481,10400,95,81,"PACMA",167
43,"43052",938,628,621,12,7,"PACMA",10
43,"43120",441,270,267,1,3,"PACMA",3
8,"8254",1739,1159,1156,10,3,"PACMA",9
43,"43167",375,277,275,9,2,"PACMA",5
17,"17175",578,321,312,5,9,"PACMA",6
43,"43126",1177,782,772,4,10,"PACMA",13
43,"43049",728,464,461,4,3,"PACMA",6
17,"17158",476,276,274,1,2,"PACMA",5
43,"43012",3534,2559,2548,34,11,"PACMA",74
17,"17123",354,266,263,0,3,"PACMA",2
8,"8207",1865,1407,1402,19,5,"PACMA",15
17,"17221",4153,2577,2564,27,13,"PACMA",47
43,"43018",408,325,320,3,5,"PACMA",3
17,"17096",179,106,105,1,1,"PACMA",1
17,"17203",153,99,99,0,0,"PACMA",1
17,"17073",1873,1363,1356,15,7,"PACMA",23
8,"8073",61814,42275,42025,294,250,"PACMA",772
43,"43152",439,323,320,2,3,"PACMA",4
17,"17180",8295,4958,4935,36,23,"PACMA",81
43,"43904",2900,1602,1573,32,29,"PACMA",8
8,"8089",33850,22230,22096,170,134,"PACMA",438
17,"17079",64395,41049,40699,342,350,"PACMA",699
17,"17115",282,183,183,1,0,"PACMA",1
17,"17154",92,67,66,0,1,"PACMA",0
43,"43119",799,470,468,8,2,"PACMA",16
43,"43082",365,290,286,5,4,"PACMA",3
8,"8200",61409,41278,41024,312,254,"PACMA",810
17,"17048",6241,3831,3801,36,30,"PACMA",75
8,"8308",131,87,87,1,0,"PACMA",0
17,"17090",545,370,368,4,2,"PACMA",1
8,"8159",14096,9393,9347,76,46,"PACMA",204
43,"43007",641,456,455,3,1,"PACMA",8
8,"8196",19233,12733,12671,94,62,"PACMA",210
17,"17182",263,181,181,6,0,"PACMA",6
43,"43029",310,213,211,3,2,"PACMA",3
17,"17002",556,401,396,0,5,"PACMA",3
17,"17040",537,347,345,3,2,"PACMA",5
8,"8258",830,557,551,6,6,"PACMA",6
17,"17015",12546,7832,7777,66,55,"PACMA",80
8,"8042",2231,1565,1558,17,7,"PACMA",37
8,"8304",812,562,558,3,4,"PACMA",4
17,"17220",796,538,536,5,2,"PACMA",3
8,"8050",141,99,99,2,0,"PACMA",0
43,"43107",383,238,237,7,1,"PACMA",3
43,"43122",106,77,77,4,0,"PACMA",1
17,"17102",571,400,400,6,0,"PACMA",3
43,"43013",4411,2750,2739,19,11,"PACMA",41
8,"8070",266,194,191,2,3,"PACMA",1
43,"43902",2743,1551,1531,23,20,"PACMA",1
43,"43017",124,101,101,1,0,"PACMA",1
8,"8119",6180,4155,4123,28,32,"PACMA",94
8,"8097",1021,715,712,8,3,"PACMA",10
17,"17078",336,223,220,6,3,"PACMA",1
8,"8120",6835,4708,4688,44,20,"PACMA",70
8,"8179",579,396,396,5,0,"PACMA",5
8,"8305",27339,17960,17809,147,151,"PACMA",280
8,"8273",2333,1654,1637,10,17,"PACMA",23
8,"8138",4248,2638,2618,27,20,"PACMA",41
8,"8203",2390,1466,1456,8,10,"PACMA",46
8,"8221",12368,8798,8763,67,35,"PACMA",136
8,"8180",26613,17585,17490,153,95,"PACMA",321
17,"17057",968,641,636,11,5,"PACMA",4
43,"43137",1868,1254,1242,11,12,"PACMA",20
17,"17105",247,147,147,1,0,"PACMA",3
43,"43023",231,170,169,0,1,"PACMA",1
17,"17066",26562,15223,15087,150,136,"PACMA",214
17,"17134",228,162,161,0,1,"PACMA",6
43,"43164",301,205,204,2,1,"PACMA",5
17,"17031",168,97,97,3,0,"PACMA",0
8,"8157",8382,5823,5789,45,34,"PACMA",105
8,"8171",2103,1288,1280,12,8,"PACMA",9
17,"17143",142,103,99,1,4,"PACMA",0
8,"8054",8998,6172,6129,44,43,"PACMA",122
8,"8167",5910,4081,4051,40,30,"PACMA",98
17,"17007",1731,1191,1182,7,9,"PACMA",12
8,"8046",13290,9054,9000,103,54,"PACMA",157
17,"17151",174,111,110,3,1,"PACMA",1
17,"17111",880,590,586,7,4,"PACMA",2
43,"43006",681,438,437,9,1,"PACMA",4
8,"8077",34508,24070,23956,127,114,"PACMA",413
8,"8037",1864,1242,1230,14,12,"PACMA",17
43,"43070",238,192,191,1,1,"PACMA",5
17,"17190",844,528,528,3,0,"PACMA",2
8,"8224",820,557,551,2,6,"PACMA",13
17,"17094",1059,602,600,4,2,"PACMA",5
8,"8164",913,618,609,7,9,"PACMA",7
43,"43008",307,156,154,6,2,"PACMA",0
8,"8292",1072,730,725,6,5,"PACMA",19
8,"8017",2762,1701,1688,9,13,"PACMA",22
8,"8056",42140,28129,27977,257,152,"PACMA",640
8,"8106",7279,4871,4845,40,26,"PACMA",109
43,"43071",921,613,607,6,6,"PACMA",2
17,"17133",1255,805,796,9,9,"PACMA",9
17,"17188",164,124,124,1,0,"PACMA",0
8,"8058",1730,1102,1095,6,7,"PACMA",34
8,"8208",5732,3976,3952,30,24,"PACMA",90
43,"43173",100,53,51,0,2,"PACMA",0
43,"43141",106,68,67,0,1,"PACMA",1
8,"8240",9348,6512,6483,38,29,"PACMA",84
17,"17181",3372,2135,2112,12,23,"PACMA",43
8,"8035",12547,7877,7828,51,49,"PACMA",176
8,"8212",488,319,316,0,3,"PACMA",0
43,"43050",2505,1507,1496,12,11,"PACMA",28
8,"8156",10891,7322,7259,43,63,"PACMA",157
8,"8285",10224,6396,6342,52,54,"PACMA",63
8,"8072",10259,6462,6422,42,40,"PACMA",137
17,"17205",208,157,155,1,2,"PACMA",4
43,"43073",83,60,58,0,2,"PACMA",3
8,"8121",86351,57040,56655,446,385,"PACMA",1177
8,"8131",704,471,468,7,3,"PACMA",1
17,"17046",717,459,458,4,1,"PACMA",9
43,"43016",3416,2335,2309,15,26,"PACMA",53
43,"43088",1996,1271,1255,7,16,"PACMA",23
8,"8023",6734,4350,4323,35,27,"PACMA",99
8,"8228",301,199,197,6,2,"PACMA",3
43,"43134",282,191,191,4,0,"PACMA",5
43,"43174",138,102,100,1,2,"PACMA",1
17,"17206",146,88,86,1,2,"PACMA",0
8,"8158",3082,2054,2041,21,13,"PACMA",44
8,"8122",1698,1080,1073,5,7,"PACMA",21
8,"8082",1139,711,708,4,3,"PACMA",24
8,"8246",1665,1086,1078,9,8,"PACMA",28
8,"8274",4665,3028,3009,26,19,"PACMA",45
43,"43094",2143,1395,1375,13,20,"PACMA",13
43,"43148",90275,59182,58757,388,425,"PACMA",1086
43,"43080",239,183,181,0,2,"PACMA",4
8,"8051",17948,12140,12076,102,64,"PACMA",223
8,"8216",25,15,15,1,0,"PACMA",0
43,"43109",2606,1491,1475,20,16,"PACMA",35
8,"8025",1490,981,978,4,3,"PACMA",13
43,"43072",105,74,72,0,2,"PACMA",0
8,"8052",141,88,88,0,0,"PACMA",0
43,"43113",393,279,278,5,1,"PACMA",2
17,"17091",407,258,253,5,5,"PACMA",0
8,"8013",1224,802,793,9,9,"PACMA",4
43,"43085",226,180,180,1,0,"PACMA",2
8,"8124",36804,24782,24632,184,150,"PACMA",482
8,"8284",12097,7157,7089,59,68,"PACMA",124
43,"43041",216,152,151,0,1,"PACMA",2
17,"17902",1357,886,878,13,8,"PACMA",12
43,"43110",259,175,175,6,0,"PACMA",0
8,"8217",24989,17765,17661,114,104,"PACMA",321
8,"8148",2233,1491,1483,7,8,"PACMA",26
8,"8027",687,486,485,2,1,"PACMA",5
17,"17075",330,205,205,1,0,"PACMA",2
8,"8281",4802,3343,3318,17,25,"PACMA",67
17,"17092",3509,2256,2223,18,33,"PACMA",39
17,"17171",165,117,116,2,1,"PACMA",1
8,"8045",73,37,35,0,2,"PACMA",0
8,"8187",152377,102805,102199,805,606,"PACMA",2025
17,"17155",14515,8393,8330,65,63,"PACMA",166
8,"8277",157,108,107,0,1,"PACMA",4
8,"8268",1005,665,659,4,6,"PACMA",14
8,"8068",6718,4373,4343,33,30,"PACMA",94
43,"43124",482,308,307,2,1,"PACMA",5
8,"8040",10710,6845,6802,51,43,"PACMA",147
43,"43055",1975,1384,1379,21,5,"PACMA",18
8,"8191",5239,3454,3438,27,16,"PACMA",44
8,"8219",15422,10701,10619,98,82,"PACMA",192
8,"8059",347,195,195,2,0,"PACMA",1
8,"8287",1048,736,735,2,1,"PACMA",5
17,"17172",454,300,297,0,3,"PACMA",8
17,"17003",104,67,66,0,1,"PACMA",2
43,"43030",427,288,283,1,5,"PACMA",5
8,"8247",961,637,634,4,3,"PACMA",7
43,"43112",279,175,174,0,1,"PACMA",0
8,"8012",1672,1075,1061,17,14,"PACMA",11
43,"43166",1584,1029,1022,6,7,"PACMA",23
8,"8110",13315,8457,8368,73,89,"PACMA",123
8,"8193",944,601,596,12,5,"PACMA",8
8,"8065",1176,797,784,10,13,"PACMA",17
17,"17162",150,86,86,1,0,"PACMA",0
43,"43108",1774,1172,1160,14,12,"PACMA",17
43,"43123",70482,44051,43675,345,376,"PACMA",895
8,"8248",5419,3566,3546,45,20,"PACMA",68
17,"17226",867,549,546,8,3,"PACMA",9
8,"8084",1142,773,768,14,5,"PACMA",11
17,"17200",613,424,422,5,2,"PACMA",2
17,"17018",480,327,322,2,5,"PACMA",5
17,"17212",141,104,102,0,2,"PACMA",0
8,"8165",1649,1100,1085,9,15,"PACMA",22
8,"8139",175,132,132,2,0,"PACMA",0
43,"43168",96,57,57,3,0,"PACMA",2
8,"8303",274,193,192,2,1,"PACMA",3
8,"8190",256,168,165,2,3,"PACMA",0
17,"17185",2265,1420,1404,15,16,"PACMA",14
8,"8195",82,63,63,0,0,"PACMA",0
8,"8044",4141,2739,2726,15,13,"PACMA",44
17,"17043",161,122,117,1,5,"PACMA",2
17,"17044",6770,4411,4376,33,35,"PACMA",69
8,"8099",749,487,485,2,2,"PACMA",6
43,"43106",810,526,522,7,4,"PACMA",1
17,"17223",801,516,506,9,10,"PACMA",2
43,"43115",143,100,98,2,2,"PACMA",0
8,"8153",538,386,385,2,1,"PACMA",2
8,"8015",155409,99368,98735,820,633,"PACMA",1988
17,"17227",129,86,85,5,1,"PACMA",1
8,"8141",4563,2953,2929,34,24,"PACMA",20
8,"8181",7887,5178,5144,48,34,"PACMA",106
8,"8209",6773,4410,4382,29,28,"PACMA",88
43,"43142",1100,698,688,5,10,"PACMA",7
43,"43015",112,87,86,0,1,"PACMA",0
8,"8163",18641,11801,11729,68,72,"PACMA",252
17,"17215",2087,1481,1466,7,15,"PACMA",28
17,"17234",182,115,114,0,1,"PACMA",2
17,"17098",301,192,188,2,4,"PACMA",2
8,"8211",33081,23576,23413,226,163,"PACMA",502
8,"8047",3899,2292,2260,16,32,"PACMA",21
8,"8210",4329,2624,2594,31,30,"PACMA",59
17,"17128",308,205,203,3,2,"PACMA",4
8,"8029",3480,2472,2460,25,12,"PACMA",29
8,"8128",563,375,372,2,3,"PACMA",1
8,"8229",535,357,354,9,3,"PACMA",3
8,"8092",3736,2369,2342,13,27,"PACMA",26
17,"17026",544,370,367,5,3,"PACMA",3
43,"43163",25248,15802,15663,104,139,"PACMA",330
8,"8160",327,208,208,1,0,"PACMA",1
8,"8142",133,103,101,5,2,"PACMA",0
17,"17035",548,381,379,5,2,"PACMA",2
17,"17193",4216,2555,2525,16,30,"PACMA",47
43,"43132",373,264,261,4,3,"PACMA",3
43,"43010",322,233,227,0,6,"PACMA",3
17,"17009",4015,2584,2567,14,17,"PACMA",27
8,"8129",462,319,316,3,3,"PACMA",2
43,"43105",162,123,122,2,1,"PACMA",1
17,"17006",1127,686,682,1,4,"PACMA",18
8,"8116",578,387,383,2,4,"PACMA",4
17,"17209",630,443,438,7,5,"PACMA",9
8,"8125",25081,16406,16329,164,77,"PACMA",325
17,"17139",1364,884,865,8,19,"PACMA",5
8,"8022",12212,7210,7155,66,55,"PACMA",104
17,"17202",3791,2280,2263,18,17,"PACMA",43
43,"43156",3946,2524,2470,28,54,"PACMA",24
8,"8294",1966,1287,1280,17,7,"PACMA",28
8,"8049",1293,790,779,3,11,"PACMA",5
43,"43147",524,381,373,4,8,"PACMA",2
43,"43051",8512,5418,5366,32,52,"PACMA",112
8,"8090",128,101,101,2,0,"PACMA",1
17,"17049",3117,2092,2072,14,20,"PACMA",19
8,"8126",8748,5927,5895,56,32,"PACMA",115
43,"43069",182,136,134,1,2,"PACMA",2
17,"17208",995,594,590,8,4,"PACMA",8
8,"8261",2327,1499,1493,11,6,"PACMA",29
17,"17121",224,140,140,1,0,"PACMA",1
43,"43139",2039,1218,1191,8,27,"PACMA",12
43,"43066",158,100,98,5,2,"PACMA",2
17,"17064",322,214,211,4,3,"PACMA",0
43,"43135",340,235,234,1,1,"PACMA",1
43,"43121",599,354,348,1,6,"PACMA",2
8,"8132",383,213,212,4,1,"PACMA",1
8,"8269",2673,1788,1776,14,12,"PACMA",11
8,"8146",1286,885,881,12,4,"PACMA",14
8,"8034",763,538,537,1,1,"PACMA",7
8,"8288",1659,1004,994,7,10,"PACMA",23
17,"17005",413,257,252,3,5,"PACMA",5
8,"8107",11502,7510,7445,67,65,"PACMA",164
17,"17109",696,422,419,1,3,"PACMA",7
17,"17013",2787,1780,1762,17,18,"PACMA",26
43,"43040",330,257,255,5,2,"PACMA",1
8,"8243",162,113,113,7,0,"PACMA",0
17,"17184",1254,814,809,6,5,"PACMA",5
43,"43001",691,441,439,4,2,"PACMA",2
8,"8080",34,26,26,3,0,"PACMA",3
8,"8039",362,266,266,0,0,"PACMA",1
8,"8175",3347,2080,2064,20,16,"PACMA",27
17,"17232",152,92,91,1,1,"PACMA",0
17,"17119",74,54,54,0,0,"PACMA",0
43,"43095",2474,1575,1551,17,24,"PACMA",37
17,"17901",987,623,620,9,3,"PACMA",12
43,"43033",765,531,530,4,1,"PACMA",17
8,"8162",2047,1400,1392,7,8,"PACMA",33
43,"43024",1537,993,983,8,10,"PACMA",22
17,"17023",27269,17209,17032,122,177,"PACMA",284
43,"43125",933,680,677,14,3,"PACMA",6
8,"8205",59828,43344,43140,367,204,"PACMA",688
17,"17186",3788,2554,2526,27,28,"PACMA",47
43,"43056",854,480,470,5,10,"PACMA",0
43,"43047",4161,2359,2341,27,18,"PACMA",48
8,"8135",6677,4813,4775,51,38,"PACMA",83
17,"17106",140,103,102,0,1,"PACMA",2
17,"17176",124,92,92,1,0,"PACMA",2
8,"8252",24570,17009,16901,145,108,"PACMA",357
8,"8009",9180,6207,6192,50,15,"PACMA",113
17,"17210",551,350,349,9,1,"PACMA",7
8,"8182",2811,1799,1789,22,10,"PACMA",24
8,"8069",3169,2161,2148,32,13,"PACMA",26
43,"43044",3963,2671,2640,33,31,"PACMA",20
17,"17068",245,158,156,1,2,"PACMA",4
17,"17041",218,130,129,2,1,"PACMA",0
8,"8206",728,523,515,5,8,"PACMA",11
17,"17055",150,110,109,0,1,"PACMA",1
8,"8233",1871,1153,1140,16,13,"PACMA",12
8,"8188",115,78,78,0,0,"PACMA",1
43,"43905",14392,8444,8393,45,51,"PACMA",198
43,"43026",782,524,520,6,4,"PACMA",6
8,"8235",3686,2488,2470,16,18,"PACMA",33
43,"43176",785,523,520,4,3,"PACMA",1
43,"43127",743,528,527,2,1,"PACMA",5
17,"17095",19555,11537,11428,89,109,"PACMA",235
17,"17174",178,99,97,2,2,"PACMA",0
8,"8239",453,304,302,3,2,"PACMA",9
8,"8098",2381,1544,1534,5,10,"PACMA",32
17,"17019",1775,1201,1188,7,13,"PACMA",8
8,"8111",218,185,184,3,1,"PACMA",1
17,"17213",5424,3239,3219,24,20,"PACMA",54
43,"43068",520,330,326,7,4,"PACMA",1
43,"43099",306,228,226,4,2,"PACMA",1
43,"43064",2015,1310,1296,23,14,"PACMA",6
43,"43149",686,447,443,8,4,"PACMA",8
43,"43086",5249,3271,3244,37,27,"PACMA",58
43,"43169",450,370,367,10,3,"PACMA",4
8,"8289",4338,2912,2898,27,14,"PACMA",57
8,"8001",8907,6316,6269,46,47,"PACMA",128
17,"17084",238,146,144,5,2,"PACMA",0
43,"43129",4580,2844,2805,23,39,"PACMA",47
8,"8250",7061,4480,4448,48,32,"PACMA",67
8,"8019",1136351,768170,764030,5799,4140,"PACMA",12579
17,"17903",897,568,563,2,5,"PACMA",3
43,"43102",480,332,324,3,8,"PACMA",4
8,"8226",891,648,645,6,3,"PACMA",7
8,"8272",151,90,90,1,0,"PACMA",0
8,"8093",27,21,21,0,0,"PACMA",0
17,"17225",214,139,139,3,0,"PACMA",0
43,"43100",3301,2183,2172,24,11,"PACMA",53
8,"8150",255,186,186,1,0,"PACMA",2
8,"8096",42622,28797,28615,263,182,"PACMA",576
43,"43062",281,217,215,2,2,"PACMA",5
17,"17061",156,104,103,1,1,"PACMA",0
17,"17178",1059,654,650,7,4,"PACMA",12
17,"17141",5887,3197,3165,34,32,"PACMA",70
43,"43171",14599,9083,9011,72,72,"PACMA",223
43,"43091",132,86,86,0,0,"PACMA",2
8,"8263",20972,13710,13583,149,127,"PACMA",287
43,"43117",146,108,105,0,3,"PACMA",0
8,"8033",12813,8564,8509,63,55,"PACMA",182
43,"43014",14251,8737,8624,101,113,"PACMA",66
8,"8244",5851,4095,4058,36,37,"PACMA",54
8,"8266",43030,30192,30039,229,153,"PACMA",588
17,"17114",23041,13985,13880,135,105,"PACMA",122
8,"8143",2682,1718,1707,17,11,"PACMA",25
43,"43096",99,81,80,1,1,"PACMA",3
43,"43076",439,300,299,0,1,"PACMA",0
43,"43077",463,272,272,5,0,"PACMA",3
17,"17167",2700,1765,1749,37,16,"PACMA",17
8,"8293",219,168,167,0,1,"PACMA",1
8,"8296",1777,1237,1231,7,6,"PACMA",16
8,"8026",188,134,134,0,0,"PACMA",2
8,"8245",78562,50821,50538,384,283,"PACMA",965
17,"17099",81,57,57,1,0,"PACMA",0
8,"8297",134,85,84,0,1,"PACMA",1
43,"43032",517,332,329,5,3,"PACMA",1
43,"43046",99,68,65,1,3,"PACMA",0
43,"43146",39,29,28,0,1,"PACMA",0
8,"8307",48295,32010,31798,195,212,"PACMA",574
8,"8145",2599,1774,1761,11,13,"PACMA",31
17,"17116",354,228,224,3,4,"PACMA",6
43,"43011",1077,743,737,2,6,"PACMA",11
17,"17097",196,148,148,3,0,"PACMA",2
8,"8053",2788,1605,1591,8,14,"PACMA",26
43,"43165",577,436,433,3,3,"PACMA",6
17,"17189",1516,1076,1070,5,6,"PACMA",2
17,"17070",111,76,76,2,0,"PACMA",1
8,"8085",1000,662,658,5,4,"PACMA",13
17,"17192",144,96,93,1,3,"PACMA",0
17,"17051",218,145,142,1,3,"PACMA",1
8,"8123",19140,13557,13484,106,73,"PACMA",271
8,"8242",219,153,153,4,0,"PACMA",5
17,"17132",1298,884,877,12,7,"PACMA",9
8,"8174",392,283,279,3,4,"PACMA",3
43,"43039",99,66,66,0,0,"PACMA",0
17,"17076",124,86,84,3,2,"PACMA",2
8,"8137",262,188,187,2,1,"PACMA",2
17,"17012",1145,703,698,9,5,"PACMA",7
17,"17187",631,445,441,2,4,"PACMA",1
17,"17126",311,236,234,0,2,"PACMA",3
8,"8066",1365,926,921,8,5,"PACMA",10
8,"8166",991,631,625,7,6,"PACMA",3
43,"43054",2812,1755,1739,16,16,"PACMA",21
43,"43081",593,400,395,3,5,"PACMA",10
8,"8302",9218,5946,5891,82,55,"PACMA",137
43,"43136",10351,6279,6218,63,61,"PACMA",32
8,"8298",26471,16674,16591,139,83,"PACMA",152
17,"17082",417,255,253,2,2,"PACMA",3
17,"17083",2940,1895,1876,16,19,"PACMA",24
8,"8262",6836,4175,4144,50,31,"PACMA",80
8,"8290",1507,1118,1110,12,8,"PACMA",28
8,"8147",16967,11220,11138,65,82,"PACMA",225
8,"8079",343,256,255,4,1,"PACMA",2
8,"8088",11899,8149,8097,69,52,"PACMA",117
17,"17110",1322,856,853,3,3,"PACMA",8
8,"8011",1756,1087,1082,16,5,"PACMA",13
43,"43002",1801,1156,1128,7,28,"PACMA",25
43,"43138",2672,1629,1585,37,44,"PACMA",14
8,"8028",1024,648,644,4,4,"PACMA",11
43,"43059",252,188,188,2,0,"PACMA",1
17,"17135",362,253,253,1,0,"PACMA",5
43,"43089",292,190,186,0,4,"PACMA",4
17,"17027",2821,1896,1889,17,7,"PACMA",10
17,"17021",131,86,85,4,1,"PACMA",0
17,"17065",331,230,230,1,0,"PACMA",1
17,"17195",329,237,234,0,3,"PACMA",2
43,"43045",149,110,110,2,0,"PACMA",0
8,"8057",60,45,44,1,1,"PACMA",0
8,"8136",11450,7703,7641,84,62,"PACMA",192
8,"8260",18335,12325,12263,106,62,"PACMA",244
17,"17136",178,125,124,0,1,"PACMA",0
17,"17211",830,581,580,10,1,"PACMA",8
17,"17164",3982,2363,2350,11,13,"PACMA",20
17,"17086",1729,1068,1059,8,9,"PACMA",15
8,"8251",4984,3257,3241,17,16,"PACMA",62
43,"43153",10688,6675,6615,39,60,"PACMA",97
43,"43172",344,211,209,4,2,"PACMA",2
43,"43090",1076,565,558,6,7,"PACMA",9
43,"43057",38,25,25,1,0,"PACMA",1
17,"17201",135,87,84,0,3,"PACMA",1
43,"43019",1381,862,846,12,16,"PACMA",12
43,"43037",16781,10376,10265,71,111,"PACMA",222
17,"17087",225,152,149,2,3,"PACMA",2
8,"8234",3200,2128,2114,21,14,"PACMA",54
8,"8087",152,121,121,2,0,"PACMA",1
8,"8213",6319,3950,3935,37,15,"PACMA",64
8,"8253",131,81,81,2,0,"PACMA",0
8,"8108",5016,3501,3474,21,27,"PACMA",72
17,"17037",104,69,69,1,0,"PACMA",0
17,"17001",587,404,398,2,6,"PACMA",14
17,"17222",101,76,75,0,1,"PACMA",0
8,"8902",3761,2570,2558,31,12,"PACMA",50
17,"17230",468,318,317,3,1,"PACMA",8
43,"43020",2215,1508,1497,9,11,"PACMA",33
8,"8113",52035,32351,32150,254,201,"PACMA",419
17,"17032",1721,967,961,10,6,"PACMA",21
43,"43074",1754,1170,1157,9,13,"PACMA",13
8,"8198",4411,2972,2954,23,18,"PACMA",60
17,"17161",992,726,721,10,5,"PACMA",5
8,"8086",13582,8612,8557,75,55,"PACMA",166
8,"8227",2326,1508,1487,20,21,"PACMA",29
8,"8170",450,276,274,7,2,"PACMA",8
8,"8083",1675,1146,1144,9,2,"PACMA",3
8,"8168",358,231,231,5,0,"PACMA",10
8,"8183",4550,2809,2796,20,13,"PACMA",25
17,"17146",2969,1868,1855,8,13,"PACMA",49
17,"17034",6931,4166,4150,29,16,"PACMA",65
8,"8021",70,49,46,0,3,"PACMA",1
17,"17029",207,127,127,1,0,"PACMA",3
17,"17228",288,179,176,1,3,"PACMA",0
8,"8295",10870,6972,6918,51,54,"PACMA",141
43,"43162",4346,2983,2958,21,25,"PACMA",36
17,"17165",656,439,435,3,4,"PACMA",7
17,"17144",206,141,141,3,0,"PACMA",4
8,"8055",519,331,327,4,4,"PACMA",6
8,"8134",810,541,538,7,3,"PACMA",16
8,"8257",107,71,71,0,0,"PACMA",1
43,"43009",1403,918,905,14,13,"PACMA",16
8,"8064",1847,1245,1230,9,15,"PACMA",22
17,"17124",1607,1027,1007,11,20,"PACMA",8
43,"43004",6281,3993,3929,38,64,"PACMA",33
43,"43140",2367,1550,1532,4,18,"PACMA",23
43,"43065",399,252,251,3,1,"PACMA",1
43,"43145",4096,2795,2760,19,35,"PACMA",39
43,"43027",161,118,116,15,2,"PACMA",3
8,"8271",70,48,48,0,0,"PACMA",1
17,"17224",314,190,188,2,2,"PACMA",3
8,"8154",696,494,488,5,6,"PACMA",12
43,"43901",8737,4703,4639,62,64,"PACMA",33
43,"43028",2688,1659,1639,6,20,"PACMA",29
43,"43103",880,547,545,4,2,"PACMA",7
43,"43022",1497,897,889,14,8,"PACMA",2
8,"8202",12680,8341,8278,75,63,"PACMA",145
43,"43128",907,587,577,5,10,"PACMA",13
8,"8041",10343,6645,6582,57,63,"PACMA",116
8,"8062",956,619,618,4,1,"PACMA",16
17,"17080",138,96,96,1,0,"PACMA",1
8,"8222",1895,1358,1351,14,7,"PACMA",18
17,"17093",891,563,560,6,3,"PACMA",1
43,"43005",3626,2157,2138,29,19,"PACMA",31
43,"43177",299,231,230,6,1,"PACMA",9
8,"8184",53822,34744,34545,264,199,"PACMA",750
8,"8075",3883,2479,2467,14,12,"PACMA",48
8,"8169",47759,32651,32439,243,212,"PACMA",636
8,"8279",153025,101133,100621,840,512,"PACMA",1984
8,"8105",9630,6394,6339,49,55,"PACMA",95
17,"17170",171,125,123,1,2,"PACMA",1
17,"17022",6910,4207,4184,58,23,"PACMA",54
43,"43060",2860,1950,1926,12,24,"PACMA",15
43,"43098",343,235,233,5,2,"PACMA",4
8,"8095",73,48,47,0,1,"PACMA",0
43,"43084",526,363,361,10,2,"PACMA",6
8,"8094",1559,1112,1097,14,15,"PACMA",23
8,"8236",1527,1006,999,4,7,"PACMA",17
8,"8176",156,109,107,2,2,"PACMA",1
17,"17204",572,355,354,4,1,"PACMA",2
43,"43158",85,52,52,1,0,"PACMA",0
8,"8074",10611,6728,6679,52,49,"PACMA",150
8,"8225",92,66,66,4,0,"PACMA",2
8,"8152",114,80,79,0,1,"PACMA",0
8,"8031",2322,1552,1537,6,15,"PACMA",16
8,"8008",190,110,110,5,0,"PACMA",3
17,"17149",364,248,248,0,0,"PACMA",2
43,"43907",4374,2793,2783,24,10,"PACMA",59
8,"8102",28296,18466,18367,172,99,"PACMA",262
43,"43159",81,59,59,0,0,"PACMA",0
8,"8291",4536,2975,2965,21,10,"PACMA",73
8,"8178",435,309,308,4,1,"PACMA",5
17,"17069",374,256,251,0,5,"PACMA",3
8,"8306",506,299,297,5,2,"PACMA",7
8,"8018",2636,1690,1675,23,15,"PACMA",19
17,"17138",928,637,633,4,4,"PACMA",16
8,"8112",12911,7790,7723,74,67,"PACMA",83
43,"43903",2392,1324,1313,10,11,"PACMA",1
8,"8194",25660,15045,14941,122,104,"PACMA",357
8,"8004",223,165,164,2,1,"PACMA",1
17,"17103",4954,2877,2850,25,27,"PACMA",62
17,"17120",786,517,512,8,5,"PACMA",5
17,"17214",705,423,419,2,4,"PACMA",3
17,"17153",188,133,133,0,0,"PACMA",1
17,"17137",3437,2293,2275,19,18,"PACMA",30
43,"43131",4647,2934,2916,21,18,"PACMA",41
8,"8014",1962,1366,1359,15,7,"PACMA",34
17,"17148",1515,981,972,4,9,"PACMA",25
43,"43101",145,104,102,3,2,"PACMA",0
8,"8300",5678,3983,3964,35,19,"PACMA",65
43,"43116",451,324,317,5,7,"PACMA",4
8,"8238",14531,10378,10325,98,53,"PACMA",170
43,"43155",22873,14209,14082,153,127,"PACMA",150
8,"8155",6730,4353,4320,39,33,"PACMA",89
43,"43063",557,355,349,9,6,"PACMA",2
17,"17030",641,400,398,1,2,"PACMA",4
43,"43036",843,493,485,4,8,"PACMA",7
17,"17163",2626,1764,1747,10,17,"PACMA",24
17,"17033",5307,3264,3241,29,23,"PACMA",43
8,"8276",237,165,165,2,0,"PACMA",0
8,"8278",4779,3161,3148,20,13,"PACMA",38
17,"17047",4798,2773,2757,28,16,"PACMA",45
8,"8301",48557,32715,32533,253,182,"PACMA",654
8,"8265",1553,1028,1018,11,10,"PACMA",12
17,"17160",14747,9189,9129,65,60,"PACMA",165
8,"8115",3799,2589,2572,17,17,"PACMA",53
8,"8061",1497,986,983,14,3,"PACMA",18
8,"8060",144,87,87,0,0,"PACMA",0
8,"8048",582,419,417,4,2,"PACMA",5
17,"17042",419,272,272,2,0,"PACMA",3
43,"43118",419,311,308,5,3,"PACMA",3
8,"8071",240,163,162,5,1,"PACMA",3
43,"43104",1783,1157,1142,10,15,"PACMA",7
43,"43035",254,156,155,2,1,"PACMA",6
43,"43114",392,271,268,2,3,"PACMA",1
17,"17074",510,337,335,2,2,"PACMA",5
8,"8020",4926,3523,3502,33,21,"PACMA",79
17,"17166",522,374,367,1,7,"PACMA",2
8,"8264",4325,2929,2908,26,21,"PACMA",50
43,"43144",1247,842,836,6,6,"PACMA",29
17,"17008",3639,2191,2171,16,20,"PACMA",25
19,"19037",141,115,114,1,1,"PCOE",0
19,"19006",769,547,540,2,7,"PCOE",0
41,"41075",10212,6419,6295,49,124,"PCOE",7
14,"14031",593,469,459,3,10,"PCOE",1
14,"14015",2125,1579,1554,10,25,"PCOE",2
19,"19269",102,81,80,0,1,"PCOE",1
19,"19217",54,40,39,0,1,"PCOE",0
19,"19117",1579,1135,1123,8,12,"PCOE",0
14,"14012",6173,4364,4291,35,73,"PCOE",9
19,"19282",163,124,123,0,1,"PCOE",0
19,"19303",43,35,35,0,0,"PCOE",0
19,"19019",20,18,17,0,1,"PCOE",0
19,"19323",40,31,31,0,0,"PCOE",0
41,"41040",10541,7752,7698,68,54,"PCOE",2
14,"14074",2299,1896,1866,16,30,"PCOE",2
19,"19226",43,38,38,0,0,"PCOE",0
19,"19266",236,188,188,1,0,"PCOE",0
41,"41015",5297,3478,3405,41,73,"PCOE",3
14,"14032",423,334,330,4,4,"PCOE",0
19,"19238",42,28,28,0,0,"PCOE",0
19,"19279",57,55,55,0,0,"PCOE",0
41,"41042",5844,4424,4378,40,46,"PCOE",5
41,"41048",2228,1470,1447,15,23,"PCOE",2
19,"19071",7840,5537,5489,45,48,"PCOE",3
14,"14065",1850,1384,1377,16,7,"PCOE",4
19,"19252",69,60,60,0,0,"PCOE",0
14,"14033",1283,971,959,9,12,"PCOE",0
19,"19230",505,360,357,3,3,"PCOE",0
19,"19008",37,28,27,1,1,"PCOE",0
19,"19111",155,126,126,1,0,"PCOE",0
19,"19308",56,53,53,0,0,"PCOE",0
19,"19098",19,17,17,0,0,"PCOE",0
19,"19270",20,17,17,0,0,"PCOE",0
14,"14071",929,642,630,2,12,"PCOE",1
41,"41089",6493,4398,4331,43,67,"PCOE",7
14,"14042",18891,14051,13848,190,203,"PCOE",35
41,"41021",21294,13762,13570,145,192,"PCOE",22
19,"19023",124,100,98,2,2,"PCOE",0
19,"19301",40,33,33,1,0,"PCOE",0
19,"19218",50,33,33,0,0,"PCOE",0
14,"14050",2391,1822,1787,14,35,"PCOE",7
41,"41005",9068,6366,6281,58,85,"PCOE",9
14,"14034",308,247,244,2,3,"PCOE",1
41,"41006",2740,1782,1768,14,14,"PCOE",2
14,"14067",3889,2946,2899,29,47,"PCOE",3
14,"14023",2021,1660,1639,8,21,"PCOE",1
41,"41016",7355,5248,5175,51,73,"PCOE",5
41,"41060",15242,10021,9847,86,174,"PCOE",10
14,"14049",16309,11635,11515,115,120,"PCOE",29
19,"19193",20,19,19,1,0,"PCOE",0
19,"19049",10,10,9,0,1,"PCOE",0
19,"19078",50,44,43,0,1,"PCOE",0
19,"19097",16,10,10,0,0,"PCOE",0
41,"41902",4659,2679,2646,23,33,"PCOE",4
19,"19254",45,34,34,0,0,"PCOE",0
19,"19059",77,61,58,1,3,"PCOE",1
41,"41007",12341,8039,7844,103,195,"PCOE",16
19,"19225",823,623,619,3,4,"PCOE",0
19,"19087",18,18,18,0,0,"PCOE",0
19,"19171",4961,3670,3628,27,42,"PCOE",2
19,"19335",55,47,47,0,0,"PCOE",0
41,"41061",2195,1749,1703,11,46,"PCOE",0
41,"41087",10237,6923,6774,48,149,"PCOE",4
19,"19091",26,20,20,0,0,"PCOE",0
14,"14063",1046,734,725,2,9,"PCOE",2
19,"19242",87,65,65,1,0,"PCOE",1
19,"19138",255,202,201,2,1,"PCOE",2
14,"14040",3776,2873,2833,32,40,"PCOE",6
19,"19331",2609,1872,1844,12,28,"PCOE",4
19,"19055",52,41,41,1,0,"PCOE",0
14,"14006",1330,1120,1101,8,19,"PCOE",0
14,"14066",5856,4150,4095,48,55,"PCOE",9
19,"19213",70,62,61,2,1,"PCOE",0
41,"41026",4314,3380,3322,18,58,"PCOE",4
19,"19321",39,30,30,1,0,"PCOE",0
41,"41004",56640,37110,36649,440,461,"PCOE",51
19,"19157",55,46,46,0,0,"PCOE",0
19,"19283",30,25,25,0,0,"PCOE",0
19,"19053",2008,1422,1404,10,18,"PCOE",0
41,"41094",6288,4497,4449,38,48,"PCOE",1
41,"41028",2003,1524,1511,9,13,"PCOE",0
19,"19194",98,69,69,1,0,"PCOE",0
19,"19050",16,15,15,0,0,"PCOE",0
41,"41085",4086,3058,3012,22,46,"PCOE",5
19,"19106",89,59,59,0,0,"PCOE",0
14,"14024",1903,1405,1376,16,29,"PCOE",7
19,"19294",29,27,27,0,0,"PCOE",0
19,"19161",211,159,157,1,2,"PCOE",0
19,"19174",109,80,79,0,1,"PCOE",0
19,"19076",27,19,19,0,0,"PCOE",0
19,"19159",93,78,77,0,1,"PCOE",1
41,"41039",31663,22062,21830,193,232,"PCOE",14
19,"19011",250,184,184,0,0,"PCOE",0
19,"19095",12,9,9,0,0,"PCOE",1
19,"19195",40,32,32,1,0,"PCOE",0
14,"14037",3318,2374,2320,22,54,"PCOE",1
19,"19182",38,34,33,0,1,"PCOE",0
19,"19130",60145,45531,45085,286,446,"PCOE",27
19,"19179",69,56,56,1,0,"PCOE",1
19,"19139",29,19,18,0,1,"PCOE",0
14,"14016",1337,1072,1060,2,12,"PCOE",3
19,"19038",28,24,23,0,1,"PCOE",0
14,"14069",7524,5460,5392,43,68,"PCOE",2
41,"41101",5928,4209,4173,18,36,"PCOE",9
19,"19170",193,135,135,0,0,"PCOE",0
41,"41076",2183,1341,1327,19,14,"PCOE",3
19,"19319",4449,3086,3056,18,30,"PCOE",4
19,"19234",43,33,33,0,0,"PCOE",1
19,"19020",44,30,30,1,0,"PCOE",0
19,"19092",409,306,300,1,6,"PCOE",0
19,"19173",45,38,36,0,2,"PCOE",0
19,"19034",22,16,16,0,0,"PCOE",0
19,"19181",56,42,42,0,0,"PCOE",0
19,"19116",12,9,9,0,0,"PCOE",0
19,"19109",39,32,32,0,0,"PCOE",0
41,"41901",2682,2107,2086,28,21,"PCOE",3
14,"14013",16796,11830,11616,129,214,"PCOE",13
19,"19032",165,126,124,1,2,"PCOE",0
41,"41010",4420,2960,2916,30,44,"PCOE",5
41,"41029",13445,9507,9416,78,91,"PCOE",13
14,"14048",1207,884,869,13,15,"PCOE",2
41,"41059",34165,24949,24709,196,240,"PCOE",32
41,"41081",29189,20205,20015,196,190,"PCOE",24
19,"19133",83,72,72,0,0,"PCOE",0
19,"19044",304,245,244,0,1,"PCOE",1
19,"19190",2369,1760,1745,10,15,"PCOE",0
19,"19299",97,79,77,1,2,"PCOE",0
19,"19016",65,49,49,0,0,"PCOE",0
19,"19229",66,56,56,0,0,"PCOE",0
19,"19150",128,99,99,1,0,"PCOE",0
19,"19258",90,77,77,0,0,"PCOE",0
14,"14058",7970,5491,5417,66,74,"PCOE",3
19,"19208",43,30,30,0,0,"PCOE",0
41,"41098",5004,3665,3630,26,35,"PCOE",1
14,"14041",3182,2296,2251,33,45,"PCOE",11
19,"19189",120,91,90,2,1,"PCOE",0
14,"14025",2924,2466,2422,14,44,"PCOE",2
19,"19024",8196,5613,5563,28,50,"PCOE",3
19,"19007",459,341,336,0,5,"PCOE",1
14,"14047",1672,1187,1178,14,9,"PCOE",2
41,"41102",14655,10183,9919,142,264,"PCOE",21
14,"14053",6006,4285,4232,49,53,"PCOE",9
41,"41054",692,560,546,3,14,"PCOE",0
19,"19197",27,22,22,0,0,"PCOE",0
19,"19264",33,26,26,0,0,"PCOE",0
19,"19265",122,97,95,2,2,"PCOE",0
41,"41047",10117,7515,7422,74,93,"PCOE",3
19,"19250",20,17,17,0,0,"PCOE",0
19,"19151",1064,744,726,1,18,"PCOE",2
41,"41095",41232,27076,26793,315,283,"PCOE",20
14,"14029",4178,3047,3009,28,38,"PCOE",7
19,"19184",71,50,48,0,2,"PCOE",1
41,"41084",2845,2124,2081,9,43,"PCOE",0
41,"41051",2180,1529,1501,2,28,"PCOE",0
19,"19298",65,45,45,0,0,"PCOE",0
19,"19148",45,32,31,0,1,"PCOE",0
19,"19220",2302,1519,1501,1,18,"PCOE",2
19,"19064",70,64,64,2,0,"PCOE",0
19,"19043",84,72,72,0,0,"PCOE",0
19,"19302",59,49,49,1,0,"PCOE",0
19,"19326",1841,1280,1272,1,8,"PCOE",2
19,"19244",82,65,64,1,1,"PCOE",0
19,"19204",148,120,120,0,0,"PCOE",0
19,"19214",75,60,58,0,2,"PCOE",0
19,"19317",139,110,109,1,1,"PCOE",0
41,"41049",9299,6896,6771,98,125,"PCOE",3
19,"19330",71,63,63,2,0,"PCOE",0
14,"14021",260178,181773,180348,1872,1425,"PCOE",244
19,"19334",35,31,31,0,0,"PCOE",1
41,"41027",3922,2660,2604,23,56,"PCOE",3
19,"19177",76,61,59,0,2,"PCOE",0
41,"41053",21259,15147,14853,132,294,"PCOE",20
19,"19134",24,15,15,0,0,"PCOE",0
14,"14062",1025,806,792,6,14,"PCOE",1
19,"19187",48,43,43,0,0,"PCOE",0
41,"41072",4054,2965,2933,14,32,"PCOE",1
19,"19061",57,42,42,0,0,"PCOE",0
19,"19048",18,15,15,1,0,"PCOE",0
41,"41020",12887,8210,8118,82,92,"PCOE",5
41,"41031",1238,825,814,11,11,"PCOE",2
19,"19212",703,543,531,3,12,"PCOE",0
41,"41083",1147,864,856,4,8,"PCOE",0
19,"19307",27,23,23,0,0,"PCOE",0
19,"19113",485,366,366,3,0,"PCOE",0
19,"19198",14,12,12,0,0,"PCOE",0
19,"19227",66,44,43,2,1,"PCOE",0
19,"19042",25,24,24,0,0,"PCOE",0
19,"19119",82,72,71,1,1,"PCOE",0
19,"19277",19,13,13,0,0,"PCOE",0
19,"19142",265,182,180,3,2,"PCOE",0
19,"19009",259,200,195,6,5,"PCOE",0
14,"14039",2604,2062,2021,12,41,"PCOE",2
14,"14072",1048,806,795,6,11,"PCOE",0
19,"19054",192,164,164,1,0,"PCOE",1
19,"19090",91,73,73,1,0,"PCOE",0
19,"19127",89,64,64,0,0,"PCOE",0
19,"19027",138,105,105,1,0,"PCOE",0
19,"19112",60,46,46,0,0,"PCOE",0
19,"19169",40,34,34,0,0,"PCOE",0
19,"19102",98,79,78,0,1,"PCOE",0
41,"41093",18554,13978,13874,99,104,"PCOE",9
41,"41082",3415,2671,2647,16,24,"PCOE",2
19,"19322",31,25,25,0,0,"PCOE",0
19,"19060",146,119,118,1,1,"PCOE",0
19,"19096",91,72,69,0,3,"PCOE",0
19,"19211",369,289,284,0,5,"PCOE",0
14,"14052",9379,5917,5854,68,63,"PCOE",9
19,"19065",127,104,104,3,0,"PCOE",0
19,"19309",26,21,21,0,0,"PCOE",0
19,"19052",25,21,21,1,0,"PCOE",1
41,"41030",514,387,373,3,14,"PCOE",1
19,"19215",168,144,140,0,4,"PCOE",0
41,"41090",3523,2576,2512,13,64,"PCOE",5
19,"19290",834,561,558,5,3,"PCOE",1
19,"19222",110,82,82,0,0,"PCOE",0
19,"19041",163,129,129,3,0,"PCOE",2
19,"19162",68,49,47,0,2,"PCOE",0
41,"41065",22779,14769,14636,132,133,"PCOE",6
19,"19033",64,52,50,1,2,"PCOE",0
19,"19045",140,120,120,0,0,"PCOE",0
19,"19103",251,208,208,2,0,"PCOE",0
19,"19066",55,48,48,0,0,"PCOE",0
19,"19107",294,239,237,0,2,"PCOE",0
19,"19333",115,82,82,0,0,"PCOE",0
19,"19243",44,31,31,0,0,"PCOE",1
19,"19146",41,35,32,0,3,"PCOE",0
19,"19263",26,15,15,1,0,"PCOE",0
19,"19123",40,32,31,1,1,"PCOE",0
41,"41033",5075,3313,3277,34,36,"PCOE",4
19,"19305",155,116,115,0,1,"PCOE",0
19,"19082",85,64,64,0,0,"PCOE",0
19,"19280",3464,2469,2438,14,31,"PCOE",3
19,"19143",1738,1306,1297,12,9,"PCOE",0
19,"19039",61,54,54,1,0,"PCOE",0
19,"19209",40,29,29,1,0,"PCOE",0
19,"19314",51,36,36,0,0,"PCOE",0
19,"19278",28,26,26,0,0,"PCOE",0
41,"41023",7905,5402,5347,41,55,"PCOE",3
14,"14030",8625,6248,6181,53,67,"PCOE",12
14,"14055",18557,12950,12764,178,186,"PCOE",11
19,"19260",42,39,39,1,0,"PCOE",0
41,"41012",3290,2071,2030,20,41,"PCOE",2
19,"19010",8,8,8,0,0,"PCOE",0
41,"41100",1013,692,673,6,19,"PCOE",2
19,"19271",46,39,39,0,0,"PCOE",0
41,"41067",7093,4930,4866,37,64,"PCOE",7
19,"19310",9,7,7,0,0,"PCOE",0
14,"14018",3709,2697,2653,26,44,"PCOE",2
41,"41034",23070,14805,14625,186,180,"PCOE",8
19,"19163",56,41,40,0,1,"PCOE",0
14,"14009",2788,1852,1834,20,18,"PCOE",1
19,"19200",71,52,52,1,0,"PCOE",0
19,"19286",720,547,543,2,4,"PCOE",1
19,"19110",56,50,50,0,0,"PCOE",1
19,"19318",25,18,18,0,0,"PCOE",0
19,"19261",37,25,24,0,1,"PCOE",0
19,"19300",772,595,591,5,4,"PCOE",1
14,"14059",690,533,528,4,5,"PCOE",0
19,"19233",80,65,63,1,2,"PCOE",0
41,"41068",13939,9787,9674,72,113,"PCOE",6
19,"19201",58,49,48,1,1,"PCOE",0
19,"19081",29,22,22,1,0,"PCOE",0
19,"19256",43,36,36,0,0,"PCOE",0
19,"19067",70,52,51,1,1,"PCOE",0
19,"19901",41,38,37,0,1,"PCOE",0
19,"19291",1191,879,869,3,10,"PCOE",2
19,"19115",24,18,18,0,0,"PCOE",0
19,"19074",72,62,62,0,0,"PCOE",0
19,"19287",148,109,108,0,1,"PCOE",0
19,"19104",14,12,12,1,0,"PCOE",0
14,"14001",3514,2837,2789,28,48,"PCOE",4
19,"19251",43,29,28,0,1,"PCOE",0
41,"41066",1342,945,927,2,18,"PCOE",1
19,"19013",125,108,108,1,0,"PCOE",0
41,"41077",8702,5983,5875,29,108,"PCOE",8
14,"14020",387,269,264,2,5,"PCOE",0
19,"19329",59,50,50,1,0,"PCOE",0
14,"14064",320,242,236,2,6,"PCOE",0
19,"19047",64,55,55,0,0,"PCOE",0
19,"19129",28,26,26,0,0,"PCOE",0
41,"41063",2695,1850,1830,13,20,"PCOE",2
19,"19272",72,54,53,1,1,"PCOE",0
19,"19075",64,39,39,0,0,"PCOE",0
14,"14068",538,401,398,10,3,"PCOE",1
41,"41071",5586,3724,3661,22,63,"PCOE",0
19,"19145",46,41,41,1,0,"PCOE",0
19,"19186",81,68,68,0,0,"PCOE",0
41,"41069",29138,18991,18683,341,308,"PCOE",35
41,"41903",6757,4562,4504,51,58,"PCOE",3
19,"19257",3403,2430,2402,19,28,"PCOE",1
19,"19249",32,29,29,0,0,"PCOE",0
41,"41057",269,183,181,0,2,"PCOE",0
19,"19121",246,199,194,1,5,"PCOE",0
14,"14003",1248,939,930,2,9,"PCOE",0
19,"19122",96,68,68,1,0,"PCOE",1
19,"19154",68,56,54,0,2,"PCOE",0
19,"19073",23,19,19,0,0,"PCOE",0
41,"41009",1222,812,805,3,7,"PCOE",2
19,"19005",84,66,66,0,0,"PCOE",0
14,"14051",1397,1018,1000,2,18,"PCOE",1
19,"19108",111,97,96,0,1,"PCOE",0
14,"14070",1332,986,974,10,12,"PCOE",0
19,"19199",17,17,17,1,0,"PCOE",0
41,"41050",5150,3817,3777,19,40,"PCOE",3
19,"19304",219,173,171,3,2,"PCOE",0
14,"14060",4868,3473,3412,41,61,"PCOE",9
19,"19172",57,48,47,0,1,"PCOE",0
19,"19235",93,71,71,1,0,"PCOE",0
14,"14004",2034,1531,1518,14,13,"PCOE",1
19,"19228",26,20,20,0,0,"PCOE",0
19,"19240",51,44,42,0,2,"PCOE",0
19,"19120",101,88,88,1,0,"PCOE",0
41,"41079",9294,6670,6580,51,90,"PCOE",6
19,"19099",298,200,199,6,1,"PCOE",0
19,"19114",37,26,26,0,0,"PCOE",0
41,"41045",5756,3988,3924,53,64,"PCOE",5
14,"14036",3740,2747,2696,24,51,"PCOE",9
19,"19245",1155,855,835,5,20,"PCOE",0
41,"41038",100095,67313,66687,760,626,"PCOE",92
41,"41097",3137,2180,2134,18,46,"PCOE",1
41,"41074",3012,2282,2257,18,25,"PCOE",3
41,"41086",16170,10162,10088,73,74,"PCOE",13
14,"14043",7574,5515,5443,81,72,"PCOE",10
19,"19155",66,56,56,0,0,"PCOE",0
41,"41052",3013,2116,2064,14,52,"PCOE",6
19,"19311",82,69,67,0,2,"PCOE",1
19,"19324",176,126,125,3,1,"PCOE",1
41,"41032",3984,2811,2725,27,86,"PCOE",3
19,"19147",43,33,33,0,0,"PCOE",0
19,"19135",107,90,90,3,0,"PCOE",0
19,"19165",47,41,41,0,0,"PCOE",0
41,"41064",5596,3517,3456,55,61,"PCOE",4
19,"19178",33,22,22,0,0,"PCOE",1
41,"41024",22600,14263,14048,128,215,"PCOE",22
19,"19167",130,101,99,0,2,"PCOE",0
19,"19268",35,24,24,1,0,"PCOE",0
19,"19001",49,42,42,0,0,"PCOE",0
19,"19232",71,57,57,1,0,"PCOE",0
14,"14045",3052,2362,2335,11,27,"PCOE",0
41,"41035",1108,794,780,7,14,"PCOE",1
19,"19153",22,17,17,0,0,"PCOE",0
19,"19070",74,53,53,0,0,"PCOE",0
14,"14011",578,464,462,4,2,"PCOE",0
19,"19241",43,34,34,1,0,"PCOE",0
14,"14044",1604,1172,1165,7,7,"PCOE",1
19,"19191",14,13,12,0,1,"PCOE",0
41,"41025",2020,1361,1320,7,41,"PCOE",1
41,"41037",3213,2376,2342,30,34,"PCOE",3
19,"19166",156,120,119,1,1,"PCOE",0
14,"14056",23581,16120,15958,143,162,"PCOE",9
19,"19003",42,35,34,1,1,"PCOE",0
19,"19022",625,476,469,3,7,"PCOE",2
19,"19057",76,59,59,1,0,"PCOE",0
19,"19168",292,204,198,1,6,"PCOE",1
19,"19046",21588,15689,15515,82,174,"PCOE",16
19,"19288",21,21,20,0,1,"PCOE",0
41,"41078",2508,1823,1810,19,13,"PCOE",3
14,"14005",6311,4143,4084,72,59,"PCOE",13
19,"19015",84,69,68,0,1,"PCOE",0
14,"14027",7925,5836,5746,58,90,"PCOE",8
19,"19125",41,32,32,0,0,"PCOE",0
41,"41070",6032,4312,4258,44,54,"PCOE",3
19,"19152",556,390,382,1,8,"PCOE",2
19,"19018",155,119,118,3,1,"PCOE",0
14,"14007",15207,10558,10417,82,141,"PCOE",22
14,"14054",13697,10315,10109,93,206,"PCOE",9
19,"19203",30,24,24,0,0,"PCOE",0
14,"14002",10951,7706,7620,83,86,"PCOE",9
41,"41014",2492,1882,1852,11,30,"PCOE",1
14,"14046",4485,3268,3208,33,60,"PCOE",7
19,"19327",418,350,348,1,2,"PCOE",0
14,"14019",6464,4967,4909,49,58,"PCOE",6
19,"19259",30,25,25,1,0,"PCOE",0
41,"41044",7423,5273,5241,34,32,"PCOE",2
19,"19040",52,41,39,0,2,"PCOE",0
41,"41001",1596,1183,1159,5,24,"PCOE",1
41,"41013",4839,3151,3094,33,57,"PCOE",5
19,"19223",111,83,83,3,0,"PCOE",1
19,"19247",139,102,100,1,2,"PCOE",1
19,"19274",902,660,651,7,9,"PCOE",0
19,"19221",48,38,37,1,1,"PCOE",0
14,"14008",2839,1905,1895,19,10,"PCOE",0
19,"19017",69,57,57,0,0,"PCOE",0
19,"19262",135,100,100,0,0,"PCOE",0
41,"41073",1707,1055,1041,5,14,"PCOE",4
19,"19289",28,25,24,1,1,"PCOE",0
19,"19105",2334,1753,1739,8,14,"PCOE",0
41,"41046",3023,2213,2183,5,30,"PCOE",4
41,"41055",14954,10068,9945,64,123,"PCOE",12
19,"19224",93,87,87,0,0,"PCOE",0
19,"19136",18,14,14,0,0,"PCOE",0
19,"19089",30,22,22,0,0,"PCOE",0
14,"14017",10868,7764,7665,71,99,"PCOE",6
19,"19297",32,24,24,1,0,"PCOE",0
14,"14022",4006,2977,2949,17,28,"PCOE",3
19,"19156",970,704,699,4,5,"PCOE",1
41,"41056",3687,2841,2812,30,29,"PCOE",2
41,"41008",1059,749,739,10,10,"PCOE",3
14,"14028",314,253,249,1,4,"PCOE",0
19,"19332",92,71,69,1,2,"PCOE",0
19,"19281",21,15,15,2,0,"PCOE",1
14,"14061",744,595,582,1,13,"PCOE",1
19,"19196",105,84,81,0,3,"PCOE",0
19,"19058",6793,5258,5218,19,40,"PCOE",2
19,"19284",10,10,9,0,1,"PCOE",0
19,"19202",8,6,6,0,0,"PCOE",0
14,"14026",2067,1424,1405,4,19,"PCOE",1
41,"41062",2223,1653,1637,7,16,"PCOE",1
19,"19231",10,9,9,0,0,"PCOE",0
19,"19160",886,558,552,2,6,"PCOE",0
19,"19188",51,35,35,0,0,"PCOE",0
19,"19210",21,19,18,1,1,"PCOE",0
14,"14035",5966,4236,4177,39,59,"PCOE",1
19,"19237",47,38,38,0,0,"PCOE",0
19,"19185",28,21,20,0,1,"PCOE",0
19,"19002",69,58,57,0,1,"PCOE",0
41,"41096",6161,4553,4476,32,77,"PCOE",8
41,"41022",4290,2889,2851,21,38,"PCOE",7
19,"19246",46,36,34,2,2,"PCOE",0
19,"19285",24,21,21,1,0,"PCOE",0
19,"19036",263,229,229,0,0,"PCOE",0
19,"19080",65,41,41,0,0,"PCOE",0
19,"19051",67,63,63,0,0,"PCOE",0
19,"19124",386,260,257,0,3,"PCOE",0
19,"19216",131,98,98,0,0,"PCOE",0
19,"19086",1473,1123,1111,7,12,"PCOE",2
41,"41058",17395,12556,12332,111,224,"PCOE",19
14,"14057",6136,4713,4631,47,82,"PCOE",16
19,"19004",67,53,53,1,0,"PCOE",0
41,"41092",7743,5358,5311,55,47,"PCOE",2
41,"41099",3976,2369,2347,12,22,"PCOE",1
41,"41041",9706,7239,7120,36,119,"PCOE",0
14,"14073",2891,2079,2016,13,63,"PCOE",1
19,"19306",25,20,20,1,0,"PCOE",0
19,"19296",30,19,18,0,1,"PCOE",0
41,"41043",639,436,427,5,9,"PCOE",2
14,"14014",2557,2035,2007,9,28,"PCOE",1
14,"14010",4027,2850,2807,19,43,"PCOE",2
19,"19267",19,13,13,0,0,"PCOE",0
19,"19325",121,83,82,0,1,"PCOE",0
19,"19293",1867,1358,1342,7,16,"PCOE",2
19,"19192",1736,1324,1308,8,16,"PCOE",1
19,"19248",78,63,63,0,0,"PCOE",0
41,"41019",4691,3089,3056,27,33,"PCOE",9
41,"41036",3941,2674,2642,23,32,"PCOE",2
19,"19118",11,9,9,0,0,"PCOE",0
19,"19132",92,81,81,0,0,"PCOE",0
19,"19255",79,63,61,1,2,"PCOE",0
41,"41003",2333,1693,1671,13,22,"PCOE",0
41,"41017",15158,10718,10616,92,102,"PCOE",12
19,"19079",8,8,7,0,1,"PCOE",0
41,"41002",1473,1038,1014,9,24,"PCOE",0
19,"19183",74,65,65,0,0,"PCOE",0
41,"41091",541987,385251,382091,3298,3160,"PCOE",330
19,"19176",237,181,181,0,0,"PCOE",0
41,"41080",1274,910,892,6,18,"PCOE",0
41,"41011",15401,10170,9986,111,184,"PCOE",11
19,"19126",1627,1155,1134,11,21,"PCOE",0
41,"41018",9480,6523,6455,53,68,"PCOE",13
19,"19021",1030,759,744,7,15,"PCOE",2
14,"14038",32322,22117,21887,179,230,"PCOE",16
19,"19031",15,9,9,0,0,"PCOE",0
19,"19239",92,62,62,1,0,"PCOE",0
14,"14075",572,448,428,1,20,"PCOE",1
19,"19088",79,61,61,0,0,"PCOE",0
19,"19219",13,9,9,0,0,"PCOE",5
19,"19175",32,28,28,0,0,"PCOE",0
41,"41088",509,360,356,0,4,"PCOE",0
38,"38006",39766,20776,20587,139,189,"PCPC",31
38,"38052",1273,883,875,2,8,"PCPC",0
38,"38020",15113,9928,9830,59,98,"PCPC",11
35,"35030",9250,5413,5326,34,87,"PCPC",10
38,"38037",12864,8287,8163,64,124,"PCPC",11
35,"35022",48603,29443,29042,160,401,"PCPC",37
38,"38043",18892,13089,12928,87,161,"PCPC",21
38,"38033",3702,2505,2464,8,41,"PCPC",3
38,"38010",4008,2733,2661,19,72,"PCPC",2
35,"35029",4152,2530,2498,32,32,"PCPC",2
38,"38026",32950,24443,24196,129,247,"PCPC",30
35,"35024",13735,8545,8439,77,106,"PCPC",4
35,"35007",511,316,309,2,7,"PCPC",1
38,"38032",13237,8908,8828,52,80,"PCPC",6
35,"35016",297736,192251,190256,1386,1995,"PCPC",425
38,"38027",5414,3618,3571,16,47,"PCPC",6
35,"35023",11686,8212,8076,55,136,"PCPC",18
35,"35014",11209,6016,5917,42,99,"PCPC",13
38,"38040",5021,3136,3102,14,34,"PCPC",3
38,"38028",22103,15036,14844,85,192,"PCPC",14
35,"35006",30457,21398,21118,162,280,"PCPC",28
38,"38001",20228,11032,10936,47,96,"PCPC",4
38,"38021",1629,1033,1022,9,11,"PCPC",0
38,"38011",20570,13831,13698,75,133,"PCPC",16
35,"35004",39299,20523,20294,140,229,"PCPC",38
35,"35033",6398,4340,4266,19,74,"PCPC",6
35,"35001",4584,3282,3222,26,60,"PCPC",4
35,"35013",6625,4896,4781,41,115,"PCPC",1
38,"38046",9113,6850,6775,40,75,"PCPC",10
38,"38008",5520,3825,3766,17,59,"PCPC",6
38,"38025",6880,4839,4761,30,78,"PCPC",6
38,"38022",18450,12334,12160,62,174,"PCPC",12
38,"38047",1777,1198,1170,4,28,"PCPC",4
35,"35019",32481,19318,19067,123,251,"PCPC",22
35,"35017",25676,15038,14716,94,322,"PCPC",17
38,"38035",9474,5616,5564,36,52,"PCPC",6
38,"38019",13200,8123,8047,36,76,"PCPC",9
38,"38003",1439,969,952,10,17,"PCPC",0
35,"35028",9776,5476,5401,43,75,"PCPC",8
35,"35015",9950,5139,5070,29,69,"PCPC",17
38,"38009",4127,2915,2868,20,47,"PCPC",3
35,"35031",7259,5037,4942,29,95,"PCPC",2
38,"38045",3837,2127,2111,12,16,"PCPC",0
38,"38005",5468,3425,3392,18,33,"PCPC",5
38,"38044",2188,1348,1334,6,14,"PCPC",1
35,"35032",3412,2473,2425,17,48,"PCPC",7
38,"38034",4049,2855,2807,19,48,"PCPC",3
38,"38023",121908,81147,80333,494,814,"PCPC",126
38,"38050",2462,1624,1604,8,20,"PCPC",4
38,"38053",3735,2469,2435,17,34,"PCPC",7
38,"38007",1661,1114,1103,6,11,"PCPC",2
38,"38014",1357,935,926,3,9,"PCPC",1
35,"35003",5211,2949,2908,13,41,"PCPC",4
35,"35018",12552,7609,7547,54,62,"PCPC",12
35,"35025",1797,1261,1245,4,16,"PCPC",7
35,"35011",24002,15928,15684,95,244,"PCPC",18
35,"35021",14924,10477,10370,45,107,"PCPC",19
38,"38018",4402,3058,3011,16,47,"PCPC",7
38,"38012",2347,1644,1630,7,14,"PCPC",3
35,"35012",10382,5443,5392,17,51,"PCPC",9
35,"35002",23328,15495,15313,94,182,"PCPC",24
38,"38041",6821,4908,4861,40,47,"PCPC",0
38,"38016",1223,638,623,3,15,"PCPC",1
35,"35034",7873,3975,3943,27,32,"PCPC",4
38,"38042",3802,2652,2625,14,27,"PCPC",3
38,"38901",1405,900,887,3,13,"PCPC",3
38,"38036",6592,4518,4440,45,78,"PCPC",12
38,"38048",3901,2667,2637,20,30,"PCPC",3
35,"35008",6131,4507,4459,34,48,"PCPC",3
38,"38029",1517,744,734,1,10,"PCPC",1
35,"35009",19905,14185,13961,89,224,"PCPC",33
38,"38004",4456,3026,2983,23,43,"PCPC",4
35,"35020",6034,3992,3934,20,58,"PCPC",11
38,"38013",2949,1896,1867,17,29,"PCPC",6
38,"38049",2655,1654,1627,8,27,"PCPC",4
35,"35010",3558,2341,2301,28,40,"PCPC",4
38,"38017",28437,16239,16075,95,164,"PCPC",26
38,"38051",7194,5158,5080,31,78,"PCPC",5
38,"38038",162027,104978,104035,575,943,"PCPC",161
35,"35026",81091,51953,51195,407,758,"PCPC",75
38,"38024",15077,9512,9356,55,156,"PCPC",15
38,"38039",10641,7547,7459,49,88,"PCPC",4
38,"38031",28687,21132,20858,104,274,"PCPC",16
38,"38002",956,702,696,21,6,"PCPC",2
35,"35027",10344,7310,7216,50,94,"PCPC",13
38,"38030",1933,1296,1290,2,6,"PCPC",2
35,"35005",1048,747,737,8,10,"PCPC",0
38,"38015",4170,2862,2836,10,26,"PCPC",4
8,"8273",2333,1654,1637,10,17,"PCPC",2
17,"17049",3117,2092,2072,14,20,"PCPC",3
43,"43052",938,628,621,12,7,"PCPC",0
17,"17167",2700,1765,1749,37,16,"PCPC",0
25,"25233",275,178,178,4,0,"PCPC",0
25,"25908",226,144,143,3,1,"PCPC",0
17,"17228",288,179,176,1,3,"PCPC",0
8,"8006",11470,7210,7132,60,78,"PCPC",4
43,"43037",16781,10376,10265,71,111,"PCPC",9
8,"8055",519,331,327,4,4,"PCPC",0
25,"25070",823,554,549,15,5,"PCPC",0
43,"43130",195,127,127,1,0,"PCPC",2
17,"17089",5543,3349,3326,22,23,"PCPC",8
17,"17145",1482,967,956,8,11,"PCPC",0
17,"17148",1515,981,972,4,9,"PCPC",4
43,"43028",2688,1659,1639,6,20,"PCPC",8
25,"25167",230,138,138,3,0,"PCPC",0
25,"25169",173,112,111,3,1,"PCPC",0
43,"43156",3946,2524,2470,28,54,"PCPC",3
8,"8060",144,87,87,0,0,"PCPC",0
43,"43029",310,213,211,3,2,"PCPC",1
43,"43147",524,381,373,4,8,"PCPC",0
43,"43164",301,205,204,2,1,"PCPC",2
25,"25121",644,415,410,8,5,"PCPC",1
25,"25007",1405,850,841,8,9,"PCPC",1
17,"17004",512,335,334,4,1,"PCPC",0
8,"8242",219,153,153,4,0,"PCPC",0
25,"25166",181,110,109,2,1,"PCPC",0
8,"8196",19233,12733,12671,94,62,"PCPC",19
8,"8132",383,213,212,4,1,"PCPC",1
43,"43030",427,288,283,1,5,"PCPC",0
25,"25043",807,501,497,11,4,"PCPC",0
8,"8109",216,162,161,0,1,"PCPC",0
17,"17139",1364,884,865,8,19,"PCPC",0
25,"25180",234,143,143,1,0,"PCPC",0
8,"8082",1139,711,708,4,3,"PCPC",0
25,"25220",1015,634,632,1,2,"PCPC",0
8,"8118",17547,12183,12108,105,75,"PCPC",13
25,"25109",231,163,162,2,1,"PCPC",0
25,"25124",166,106,105,1,1,"PCPC",0
17,"17125",130,80,80,0,0,"PCPC",0
43,"43078",846,543,531,8,12,"PCPC",1
25,"25128",136,75,75,0,0,"PCPC",0
8,"8064",1847,1245,1230,9,15,"PCPC",1
43,"43064",2015,1310,1296,23,14,"PCPC",0
8,"8073",61814,42275,42025,294,250,"PCPC",74
25,"25196",113,57,57,0,0,"PCPC",0
17,"17080",138,96,96,1,0,"PCPC",0
43,"43125",933,680,677,14,3,"PCPC",3
43,"43069",182,136,134,1,2,"PCPC",0
8,"8081",339,222,221,3,1,"PCPC",1
8,"8122",1698,1080,1073,5,7,"PCPC",0
43,"43020",2215,1508,1497,9,11,"PCPC",5
8,"8046",13290,9054,9000,103,54,"PCPC",19
25,"25089",105,60,59,0,1,"PCPC",1
8,"8051",17948,12140,12076,102,64,"PCPC",14
25,"25024",351,226,223,2,3,"PCPC",0
43,"43152",439,323,320,2,3,"PCPC",0
17,"17221",4153,2577,2564,27,13,"PCPC",1
17,"17193",4216,2555,2525,16,30,"PCPC",3
8,"8029",3480,2472,2460,25,12,"PCPC",0
43,"43135",340,235,234,1,1,"PCPC",0
25,"25250",345,210,204,0,6,"PCPC",0
17,"17079",64395,41049,40699,342,350,"PCPC",42
8,"8121",86351,57040,56655,446,385,"PCPC",71
17,"17173",180,132,131,0,1,"PCPC",0
8,"8010",4168,2631,2606,20,25,"PCPC",5
43,"43122",106,77,77,4,0,"PCPC",0
8,"8221",12368,8798,8763,67,35,"PCPC",7
25,"25138",569,363,360,4,3,"PCPC",0
8,"8019",1136351,768170,764030,5799,4140,"PCPC",808
8,"8131",704,471,468,7,3,"PCPC",0
17,"17023",27269,17209,17032,122,177,"PCPC",27
17,"17134",228,162,161,0,1,"PCPC",0
25,"25244",361,223,220,5,3,"PCPC",0
8,"8090",128,101,101,2,0,"PCPC",0
8,"8091",5244,3611,3584,17,27,"PCPC",8
25,"25125",417,250,250,5,0,"PCPC",0
25,"25077",463,256,253,6,3,"PCPC",0
43,"43175",554,363,360,5,3,"PCPC",0
17,"17165",656,439,435,3,4,"PCPC",2
8,"8016",1831,1136,1129,19,7,"PCPC",1
25,"25240",1383,925,919,16,6,"PCPC",1
17,"17177",549,332,331,1,1,"PCPC",2
25,"25911",451,273,271,7,2,"PCPC",0
43,"43107",383,238,237,7,1,"PCPC",0
8,"8264",4325,2929,2908,26,21,"PCPC",1
8,"8290",1507,1118,1110,12,8,"PCPC",0
17,"17055",150,110,109,0,1,"PCPC",0
17,"17041",218,130,129,2,1,"PCPC",0
17,"17082",417,255,253,2,2,"PCPC",0
8,"8255",134,78,78,0,0,"PCPC",0
8,"8296",1777,1237,1231,7,6,"PCPC",1
25,"25227",652,402,400,4,2,"PCPC",0
8,"8176",156,109,107,2,2,"PCPC",0
43,"43021",357,232,231,6,1,"PCPC",0
17,"17101",559,347,338,2,9,"PCPC",0
8,"8067",5739,3616,3577,47,39,"PCPC",3
8,"8250",7061,4480,4448,48,32,"PCPC",7
17,"17172",454,300,297,0,3,"PCPC",0
8,"8124",36804,24782,24632,184,150,"PCPC",37
17,"17100",194,133,131,3,2,"PCPC",3
8,"8294",1966,1287,1280,17,7,"PCPC",2
43,"43146",39,29,28,0,1,"PCPC",0
43,"43050",2505,1507,1496,12,11,"PCPC",0
8,"8201",442,278,278,4,0,"PCPC",0
17,"17171",165,117,116,2,1,"PCPC",0
8,"8244",5851,4095,4058,36,37,"PCPC",7
43,"43123",70482,44051,43675,345,376,"PCPC",53
43,"43025",600,408,404,2,4,"PCPC",0
43,"43174",138,102,100,1,2,"PCPC",1
43,"43031",1458,1020,1014,15,6,"PCPC",2
8,"8144",717,447,437,5,10,"PCPC",0
8,"8254",1739,1159,1156,10,3,"PCPC",2
25,"25137",8585,5143,5095,56,48,"PCPC",8
25,"25216",226,138,136,1,2,"PCPC",0
17,"17015",12546,7832,7777,66,55,"PCPC",7
8,"8028",1024,648,644,4,4,"PCPC",2
25,"25170",266,169,167,1,2,"PCPC",0
43,"43016",3416,2335,2309,15,26,"PCPC",1
17,"17132",1298,884,877,12,7,"PCPC",1
25,"25039",277,181,180,3,1,"PCPC",1
8,"8037",1864,1242,1230,14,12,"PCPC",4
25,"25097",84,65,65,3,0,"PCPC",0
8,"8145",2599,1774,1761,11,13,"PCPC",3
17,"17118",12711,7567,7515,42,52,"PCPC",8
25,"25209",1495,995,978,9,17,"PCPC",0
17,"17016",731,500,496,1,4,"PCPC",0
8,"8902",3761,2570,2558,31,12,"PCPC",0
17,"17195",329,237,234,0,3,"PCPC",0
8,"8025",1490,981,978,4,3,"PCPC",1
8,"8300",5678,3983,3964,35,19,"PCPC",1
25,"25153",192,130,128,2,2,"PCPC",0
17,"17013",2787,1780,1762,17,18,"PCPC",2
25,"25040",10546,6367,6300,61,67,"PCPC",8
43,"43086",5249,3271,3244,37,27,"PCPC",4
8,"8134",810,541,538,7,3,"PCPC",0
43,"43059",252,188,188,2,0,"PCPC",1
43,"43150",1281,937,923,6,14,"PCPC",2
17,"17010",336,224,224,3,0,"PCPC",1
25,"25154",122,74,72,0,2,"PCPC",0
17,"17092",3509,2256,2223,18,33,"PCPC",4
8,"8026",188,134,134,0,0,"PCPC",0
25,"25041",568,347,344,4,3,"PCPC",1
8,"8022",12212,7210,7155,66,55,"PCPC",4
25,"25049",151,110,108,1,2,"PCPC",0
25,"25073",582,328,324,8,4,"PCPC",0
17,"17201",135,87,84,0,3,"PCPC",0
8,"8117",2450,1602,1594,11,8,"PCPC",2
8,"8291",4536,2975,2965,21,10,"PCPC",3
25,"25175",186,117,117,1,0,"PCPC",0
8,"8167",5910,4081,4051,40,30,"PCPC",5
43,"43129",4580,2844,2805,23,39,"PCPC",4
25,"25100",211,125,124,1,1,"PCPC",1
8,"8304",812,562,558,3,4,"PCPC",1
25,"25034",2326,1361,1340,15,21,"PCPC",1
43,"43102",480,332,324,3,8,"PCPC",0
43,"43103",880,547,545,4,2,"PCPC",2
17,"17073",1873,1363,1356,15,7,"PCPC",1
25,"25141",153,95,95,0,0,"PCPC",0
43,"43112",279,175,174,0,1,"PCPC",0
43,"43906",2102,1364,1346,15,18,"PCPC",0
25,"25191",334,205,204,4,1,"PCPC",1
17,"17061",156,104,103,1,1,"PCPC",0
17,"17174",178,99,97,2,2,"PCPC",0
8,"8030",5122,3482,3466,21,16,"PCPC",3
8,"8012",1672,1075,1061,17,14,"PCPC",2
25,"25016",2107,1268,1259,14,9,"PCPC",2
25,"25143",84,56,55,0,1,"PCPC",0
17,"17136",178,125,124,0,1,"PCPC",0
17,"17153",188,133,133,0,0,"PCPC",0
8,"8151",466,288,287,2,1,"PCPC",0
8,"8297",134,85,84,0,1,"PCPC",0
25,"25067",719,467,460,7,7,"PCPC",0
43,"43014",14251,8737,8624,101,113,"PCPC",22
43,"43018",408,325,320,3,5,"PCPC",0
8,"8120",6835,4708,4688,44,20,"PCPC",1
8,"8133",128,72,72,0,0,"PCPC",0
17,"17159",643,413,406,3,7,"PCPC",2
8,"8213",6319,3950,3935,37,15,"PCPC",7
25,"25010",211,113,113,2,0,"PCPC",0
8,"8103",625,395,395,2,0,"PCPC",0
25,"25253",159,105,105,1,0,"PCPC",0
25,"25062",750,486,482,1,4,"PCPC",2
25,"25215",345,240,236,0,4,"PCPC",2
8,"8218",8009,5105,5075,59,30,"PCPC",7
43,"43077",463,272,272,5,0,"PCPC",0
8,"8094",1559,1112,1097,14,15,"PCPC",0
17,"17176",124,92,92,1,0,"PCPC",0
17,"17234",182,115,114,0,1,"PCPC",0
25,"25254",728,457,451,2,6,"PCPC",0
43,"43093",3919,2461,2434,47,27,"PCPC",6
17,"17044",6770,4411,4376,33,35,"PCPC",3
8,"8267",6461,4265,4245,51,20,"PCPC",3
17,"17155",14515,8393,8330,65,63,"PCPC",13
8,"8214",6872,4699,4675,47,24,"PCPC",11
8,"8282",6578,4714,4690,45,24,"PCPC",7
17,"17011",637,444,439,6,5,"PCPC",0
25,"25038",1545,995,986,17,9,"PCPC",1
8,"8092",3736,2369,2342,13,27,"PCPC",2
8,"8007",6483,4281,4250,33,31,"PCPC",6
17,"17064",322,214,211,4,3,"PCPC",0
25,"25126",290,200,198,2,2,"PCPC",0
43,"43008",307,156,154,6,2,"PCPC",4
8,"8065",1176,797,784,10,13,"PCPC",1
25,"25913",86,67,67,3,0,"PCPC",0
17,"17158",476,276,274,1,2,"PCPC",1
8,"8146",1286,885,881,12,4,"PCPC",0
25,"25225",564,356,356,1,0,"PCPC",0
8,"8274",4665,3028,3009,26,19,"PCPC",2
43,"43076",439,300,299,0,1,"PCPC",0
25,"25168",509,354,352,7,2,"PCPC",1
8,"8080",34,26,26,3,0,"PCPC",0
8,"8043",3201,2056,2041,9,15,"PCPC",5
17,"17103",4954,2877,2850,25,27,"PCPC",5
17,"17018",480,327,322,2,5,"PCPC",0
25,"25102",707,420,407,6,13,"PCPC",3
25,"25114",98,72,72,0,0,"PCPC",0
43,"43133",5666,3397,3356,27,41,"PCPC",7
17,"17039",1759,1159,1145,14,14,"PCPC",1
25,"25014",260,165,165,5,0,"PCPC",0
43,"43110",259,175,175,6,0,"PCPC",1
43,"43041",216,152,151,0,1,"PCPC",0
25,"25150",181,115,113,3,2,"PCPC",0
8,"8005",6205,4187,4167,22,20,"PCPC",3
8,"8285",10224,6396,6342,52,54,"PCPC",10
8,"8195",82,63,63,0,0,"PCPC",0
8,"8157",8382,5823,5789,45,34,"PCPC",6
17,"17036",2717,1730,1716,15,14,"PCPC",2
8,"8015",155409,99368,98735,820,633,"PCPC",126
25,"25046",422,279,275,2,4,"PCPC",0
17,"17223",801,516,506,9,10,"PCPC",0
25,"25179",162,103,103,2,0,"PCPC",0
8,"8095",73,48,47,0,1,"PCPC",0
43,"43097",393,291,289,1,2,"PCPC",0
43,"43083",144,109,108,0,1,"PCPC",1
25,"25085",148,107,107,0,0,"PCPC",0
8,"8272",151,90,90,1,0,"PCPC",0
25,"25042",208,123,121,1,2,"PCPC",0
17,"17161",992,726,721,10,5,"PCPC",2
17,"17120",786,517,512,8,5,"PCPC",0
43,"43004",6281,3993,3929,38,64,"PCPC",6
17,"17211",830,581,580,10,1,"PCPC",0
43,"43012",3534,2559,2548,34,11,"PCPC",0
25,"25217",10625,6319,6260,99,59,"PCPC",4
25,"25086",522,346,341,2,5,"PCPC",0
25,"25130",195,113,112,2,1,"PCPC",0
25,"25118",346,198,189,3,9,"PCPC",0
43,"43154",130,101,100,0,1,"PCPC",1
25,"25181",172,123,120,4,3,"PCPC",0
8,"8216",25,15,15,1,0,"PCPC",0
17,"17199",6853,4147,4122,27,25,"PCPC",4
8,"8150",255,186,186,1,0,"PCPC",0
17,"17196",220,150,150,4,0,"PCPC",0
25,"25058",4357,2624,2595,20,29,"PCPC",2
17,"17078",336,223,220,6,3,"PCPC",1
43,"43096",99,81,80,1,1,"PCPC",1
25,"25053",1055,671,661,7,10,"PCPC",0
8,"8231",20564,13037,12952,96,85,"PCPC",7
25,"25906",218,125,125,1,0,"PCPC",0
25,"25165",285,179,176,2,3,"PCPC",1
8,"8125",25081,16406,16329,164,77,"PCPC",23
17,"17189",1516,1076,1070,5,6,"PCPC",0
8,"8217",24989,17765,17661,114,104,"PCPC",25
25,"25081",308,189,189,2,0,"PCPC",0
17,"17129",133,101,101,1,0,"PCPC",0
17,"17205",208,157,155,1,2,"PCPC",0
25,"25902",567,365,356,8,9,"PCPC",1
8,"8107",11502,7510,7445,67,65,"PCPC",11
8,"8050",141,99,99,2,0,"PCPC",0
43,"43011",1077,743,737,2,6,"PCPC",2
8,"8113",52035,32351,32150,254,201,"PCPC",23
17,"17214",705,423,419,2,4,"PCPC",0
17,"17097",196,148,148,3,0,"PCPC",0
17,"17202",3791,2280,2263,18,17,"PCPC",3
8,"8014",1962,1366,1359,15,7,"PCPC",1
25,"25020",289,206,205,3,1,"PCPC",1
25,"25907",494,266,265,6,1,"PCPC",1
25,"25146",227,140,140,3,0,"PCPC",0
43,"43075",89,61,60,1,1,"PCPC",0
8,"8127",2225,1349,1334,14,15,"PCPC",2
25,"25251",707,443,442,2,1,"PCPC",1
43,"43034",477,350,342,9,8,"PCPC",0
8,"8100",2001,1395,1380,25,15,"PCPC",1
25,"25134",623,369,366,3,3,"PCPC",2
8,"8047",3899,2292,2260,16,32,"PCPC",2
43,"43171",14599,9083,9011,72,72,"PCPC",8
8,"8129",462,319,316,3,3,"PCPC",0
43,"43131",4647,2934,2916,21,18,"PCPC",1
25,"25057",208,141,140,0,1,"PCPC",0
17,"17107",264,167,165,8,2,"PCPC",0
17,"17230",468,318,317,3,1,"PCPC",0
17,"17166",522,374,367,1,7,"PCPC",0
8,"8013",1224,802,793,9,9,"PCPC",5
43,"43136",10351,6279,6218,63,61,"PCPC",9
8,"8208",5732,3976,3952,30,24,"PCPC",8
17,"17149",364,248,248,0,0,"PCPC",0
25,"25052",1555,1027,1016,14,11,"PCPC",1
25,"25005",279,175,175,4,0,"PCPC",0
17,"17180",8295,4958,4935,36,23,"PCPC",3
8,"8904",10553,6623,6579,52,44,"PCPC",14
8,"8253",131,81,81,2,0,"PCPC",0
43,"43105",162,123,122,2,1,"PCPC",0
8,"8156",10891,7322,7259,43,63,"PCPC",6
8,"8049",1293,790,779,3,11,"PCPC",0
8,"8040",10710,6845,6802,51,43,"PCPC",10
25,"25082",285,186,178,5,8,"PCPC",1
8,"8044",4141,2739,2726,15,13,"PCPC",4
25,"25145",86,65,64,1,1,"PCPC",0
25,"25133",706,432,427,8,5,"PCPC",1
17,"17007",1731,1191,1182,7,9,"PCPC",1
8,"8295",10870,6972,6918,51,54,"PCPC",4
8,"8187",152377,102805,102199,805,606,"PCPC",155
17,"17116",354,228,224,3,4,"PCPC",0
8,"8104",679,432,430,3,2,"PCPC",0
8,"8023",6734,4350,4323,35,27,"PCPC",4
25,"25194",423,246,244,6,2,"PCPC",1
43,"43106",810,526,522,7,4,"PCPC",0
17,"17206",146,88,86,1,2,"PCPC",0
25,"25912",857,547,539,1,8,"PCPC",0
25,"25210",1108,685,677,3,8,"PCPC",0
25,"25151",685,425,419,7,6,"PCPC",0
8,"8256",650,484,484,5,0,"PCPC",0
25,"25011",5243,2796,2767,23,29,"PCPC",3
8,"8038",1487,959,954,15,5,"PCPC",1
8,"8008",190,110,110,5,0,"PCPC",0
17,"17220",796,538,536,5,2,"PCPC",1
8,"8229",535,357,354,9,3,"PCPC",0
43,"43066",158,100,98,5,2,"PCPC",1
25,"25051",1527,931,920,11,11,"PCPC",0
8,"8106",7279,4871,4845,40,26,"PCPC",10
17,"17102",571,400,400,6,0,"PCPC",1
25,"25012",2334,1322,1310,8,12,"PCPC",3
8,"8139",175,132,132,2,0,"PCPC",0
17,"17901",987,623,620,9,3,"PCPC",1
8,"8039",362,266,266,0,0,"PCPC",0
25,"25172",1797,1170,1146,10,24,"PCPC",2
43,"43001",691,441,439,4,2,"PCPC",0
8,"8161",11144,6994,6938,73,56,"PCPC",9
17,"17057",968,641,636,11,5,"PCPC",0
43,"43055",1975,1384,1379,21,5,"PCPC",0
25,"25140",788,435,430,9,5,"PCPC",1
43,"43054",2812,1755,1739,16,16,"PCPC",5
25,"25068",556,346,341,11,5,"PCPC",0
43,"43173",100,53,51,0,2,"PCPC",0
25,"25239",590,258,256,5,2,"PCPC",0
17,"17048",6241,3831,3801,36,30,"PCPC",2
17,"17181",3372,2135,2112,12,23,"PCPC",2
8,"8130",95,56,55,0,1,"PCPC",0
25,"25224",126,70,70,5,0,"PCPC",0
8,"8219",15422,10701,10619,98,82,"PCPC",7
8,"8232",1775,1183,1176,6,7,"PCPC",2
17,"17186",3788,2554,2526,27,28,"PCPC",0
17,"17081",246,163,162,2,1,"PCPC",0
8,"8108",5016,3501,3474,21,27,"PCPC",3
17,"17067",696,467,464,5,3,"PCPC",3
17,"17028",293,205,204,6,1,"PCPC",0
17,"17093",891,563,560,6,3,"PCPC",0
43,"43002",1801,1156,1128,7,28,"PCPC",0
25,"25015",357,219,219,2,0,"PCPC",0
17,"17903",897,568,563,2,5,"PCPC",0
25,"25031",52,29,29,0,0,"PCPC",0
25,"25202",104,73,72,0,1,"PCPC",0
43,"43167",375,277,275,9,2,"PCPC",0
43,"43003",324,217,217,3,0,"PCPC",0
8,"8164",913,618,609,7,9,"PCPC",1
8,"8083",1675,1146,1144,9,2,"PCPC",0
17,"17224",314,190,188,2,2,"PCPC",0
17,"17068",245,158,156,1,2,"PCPC",0
8,"8234",3200,2128,2114,21,14,"PCPC",1
25,"25044",188,122,120,7,2,"PCPC",0
17,"17187",631,445,441,2,4,"PCPC",0
17,"17026",544,370,367,5,3,"PCPC",1
8,"8179",579,396,396,5,0,"PCPC",1
25,"25189",2110,1198,1186,10,12,"PCPC",0
17,"17091",407,258,253,5,5,"PCPC",0
25,"25173",1705,1156,1143,14,13,"PCPC",3
25,"25045",57,40,40,0,0,"PCPC",0
25,"25037",375,247,246,5,1,"PCPC",0
8,"8098",2381,1544,1534,5,10,"PCPC",4
43,"43141",106,68,67,0,1,"PCPC",0
17,"17056",1715,1120,1106,16,14,"PCPC",2
43,"43115",143,100,98,2,2,"PCPC",0
8,"8298",26471,16674,16591,139,83,"PCPC",12
43,"43177",299,231,230,6,1,"PCPC",1
25,"25182",1036,660,655,9,5,"PCPC",0
17,"17066",26562,15223,15087,150,136,"PCPC",22
25,"25183",499,326,323,7,3,"PCPC",1
8,"8112",12911,7790,7723,74,67,"PCPC",12
25,"25088",96,73,72,0,1,"PCPC",2
43,"43047",4161,2359,2341,27,18,"PCPC",4
25,"25206",260,150,150,5,0,"PCPC",1
8,"8032",1981,1319,1311,11,8,"PCPC",2
17,"17020",3592,2333,2315,20,18,"PCPC",1
25,"25104",130,76,74,1,2,"PCPC",0
8,"8263",20972,13710,13583,149,127,"PCPC",15
17,"17032",1721,967,961,10,6,"PCPC",2
8,"8223",1852,1182,1171,12,11,"PCPC",2
43,"43007",641,456,455,3,1,"PCPC",1
17,"17085",301,215,214,5,1,"PCPC",0
8,"8210",4329,2624,2594,31,30,"PCPC",7
25,"25060",72,46,44,1,2,"PCPC",0
17,"17008",3639,2191,2171,16,20,"PCPC",2
43,"43048",805,525,513,8,12,"PCPC",0
8,"8251",4984,3257,3241,17,16,"PCPC",8
8,"8017",2762,1701,1688,9,13,"PCPC",0
25,"25221",122,81,81,0,0,"PCPC",0
8,"8034",763,538,537,1,1,"PCPC",1
8,"8128",563,375,372,2,3,"PCPC",1
17,"17216",165,110,110,1,0,"PCPC",0
25,"25164",376,242,238,4,4,"PCPC",2
8,"8225",92,66,66,4,0,"PCPC",0
43,"43118",419,311,308,5,3,"PCPC",0
43,"43009",1403,918,905,14,13,"PCPC",2
8,"8248",5419,3566,3546,45,20,"PCPC",3
8,"8175",3347,2080,2064,20,16,"PCPC",2
8,"8053",2788,1605,1591,8,14,"PCPC",3
25,"25098",253,151,150,0,1,"PCPC",0
43,"43132",373,264,261,4,3,"PCPC",0
17,"17009",4015,2584,2567,14,17,"PCPC",2
25,"25208",331,183,182,1,1,"PCPC",0
43,"43023",231,170,169,0,1,"PCPC",0
17,"17075",330,205,205,1,0,"PCPC",0
8,"8226",891,648,645,6,3,"PCPC",0
8,"8116",578,387,383,2,4,"PCPC",0
17,"17031",168,97,97,3,0,"PCPC",0
8,"8222",1895,1358,1351,14,7,"PCPC",3
8,"8199",663,456,453,14,3,"PCPC",0
25,"25903",236,161,161,3,0,"PCPC",0
25,"25050",3233,1936,1912,25,24,"PCPC",6
8,"8200",61409,41278,41024,312,254,"PCPC",65
43,"43120",441,270,267,1,3,"PCPC",0
8,"8063",453,337,336,4,1,"PCPC",1
17,"17168",380,260,258,0,2,"PCPC",1
8,"8185",188,123,122,2,1,"PCPC",0
8,"8158",3082,2054,2041,21,13,"PCPC",6
43,"43160",1276,837,826,8,11,"PCPC",1
17,"17182",263,181,181,6,0,"PCPC",0
43,"43161",17197,10481,10400,95,81,"PCPC",11
8,"8078",219,112,111,3,1,"PCPC",0
17,"17077",548,369,368,1,1,"PCPC",0
17,"17207",2375,1590,1579,11,11,"PCPC",0
25,"25096",902,534,525,10,9,"PCPC",0
8,"8159",14096,9393,9347,76,46,"PCPC",7
25,"25243",3646,2193,2167,33,26,"PCPC",1
8,"8160",327,208,208,1,0,"PCPC",0
25,"25197",133,89,88,1,1,"PCPC",0
43,"43026",782,524,520,6,4,"PCPC",0
43,"43176",785,523,520,4,3,"PCPC",0
43,"43080",239,183,181,0,2,"PCPC",0
43,"43067",552,397,393,2,4,"PCPC",0
17,"17051",218,145,142,1,3,"PCPC",0
8,"8243",162,113,113,7,0,"PCPC",0
43,"43068",520,330,326,7,4,"PCPC",0
43,"43019",1381,862,846,12,16,"PCPC",1
25,"25017",236,169,167,7,2,"PCPC",0
43,"43163",25248,15802,15663,104,139,"PCPC",19
17,"17902",1357,886,878,13,8,"PCPC",3
8,"8148",2233,1491,1483,7,8,"PCPC",3
8,"8230",7635,5177,5121,54,56,"PCPC",2
8,"8009",9180,6207,6192,50,15,"PCPC",9
25,"25200",329,213,213,0,0,"PCPC",0
25,"25161",360,219,218,2,1,"PCPC",0
8,"8036",163,105,104,1,1,"PCPC",0
25,"25110",2766,1628,1602,22,26,"PCPC",1
25,"25219",141,102,101,0,1,"PCPC",0
8,"8191",5239,3454,3438,27,16,"PCPC",4
17,"17147",8053,4988,4933,52,55,"PCPC",9
25,"25228",3035,1933,1921,26,12,"PCPC",2
43,"43042",2129,1439,1437,12,2,"PCPC",1
8,"8205",59828,43344,43140,367,204,"PCPC",29
8,"8135",6677,4813,4775,51,38,"PCPC",5
8,"8299",391,244,244,5,0,"PCPC",0
17,"17054",370,236,236,1,0,"PCPC",2
25,"25129",175,83,83,2,0,"PCPC",0
17,"17135",362,253,253,1,0,"PCPC",1
25,"25002",482,316,314,2,2,"PCPC",0
8,"8905",2346,1689,1681,26,8,"PCPC",3
8,"8178",435,309,308,4,1,"PCPC",1
25,"25171",2185,1416,1410,8,6,"PCPC",2
25,"25203",8931,5003,4955,72,48,"PCPC",11
43,"43166",1584,1029,1022,6,7,"PCPC",0
8,"8137",262,188,187,2,1,"PCPC",0
8,"8193",944,601,596,12,5,"PCPC",1
8,"8233",1871,1153,1140,16,13,"PCPC",2
25,"25247",123,66,66,1,0,"PCPC",0
8,"8220",2356,1690,1683,18,7,"PCPC",0
25,"25230",1558,1008,993,13,15,"PCPC",0
43,"43071",921,613,607,6,6,"PCPC",1
43,"43058",90,63,63,0,0,"PCPC",0
17,"17109",696,422,419,1,3,"PCPC",1
25,"25071",49,31,31,0,0,"PCPC",0
8,"8052",141,88,88,0,0,"PCPC",0
17,"17038",366,234,232,6,2,"PCPC",0
25,"25113",1168,811,803,8,8,"PCPC",2
17,"17200",613,424,422,5,2,"PCPC",1
43,"43168",96,57,57,3,0,"PCPC",0
43,"43005",3626,2157,2138,29,19,"PCPC",1
8,"8303",274,193,192,2,1,"PCPC",0
25,"25232",1397,874,871,12,3,"PCPC",1
17,"17006",1127,686,682,1,4,"PCPC",0
8,"8089",33850,22230,22096,170,134,"PCPC",42
17,"17014",64,48,48,1,0,"PCPC",0
43,"43082",365,290,286,5,4,"PCPC",0
17,"17005",413,257,252,3,5,"PCPC",1
8,"8289",4338,2912,2898,27,14,"PCPC",1
8,"8086",13582,8612,8557,75,55,"PCPC",6
17,"17111",880,590,586,7,4,"PCPC",0
43,"43169",450,370,367,10,3,"PCPC",1
17,"17096",179,106,105,1,1,"PCPC",1
43,"43143",54,47,47,3,0,"PCPC",0
17,"17164",3982,2363,2350,11,13,"PCPC",1
8,"8099",749,487,485,2,2,"PCPC",0
17,"17190",844,528,528,3,0,"PCPC",0
25,"25055",169,105,104,4,1,"PCPC",0
43,"43061",45,30,29,0,1,"PCPC",0
17,"17140",670,478,473,5,5,"PCPC",0
25,"25234",4279,2546,2508,23,38,"PCPC",1
17,"17203",153,99,99,0,0,"PCPC",0
8,"8114",18292,12102,12009,72,93,"PCPC",19
17,"17126",311,236,234,0,2,"PCPC",1
8,"8168",358,231,231,5,0,"PCPC",0
17,"17098",301,192,188,2,4,"PCPC",0
17,"17047",4798,2773,2757,28,16,"PCPC",2
43,"43170",868,566,562,5,4,"PCPC",0
8,"8238",14531,10378,10325,98,53,"PCPC",7
25,"25075",117,72,72,2,0,"PCPC",0
43,"43145",4096,2795,2760,19,35,"PCPC",4
25,"25207",6212,3710,3680,47,30,"PCPC",56
8,"8074",10611,6728,6679,52,49,"PCPC",8
25,"25061",83,46,46,0,0,"PCPC",0
8,"8184",53822,34744,34545,264,199,"PCPC",53
8,"8180",26613,17585,17490,153,95,"PCPC",23
25,"25905",375,249,246,3,3,"PCPC",0
25,"25231",486,330,330,4,0,"PCPC",1
8,"8018",2636,1690,1675,23,15,"PCPC",2
17,"17192",144,96,93,1,3,"PCPC",0
25,"25009",627,444,440,8,4,"PCPC",0
8,"8280",97,66,66,2,0,"PCPC",1
8,"8035",12547,7877,7828,51,49,"PCPC",10
17,"17115",282,183,183,1,0,"PCPC",0
43,"43109",2606,1491,1475,20,16,"PCPC",5
25,"25910",100,63,61,2,2,"PCPC",1
8,"8276",237,165,165,2,0,"PCPC",1
25,"25076",145,81,81,2,0,"PCPC",0
8,"8076",16169,10652,10563,75,89,"PCPC",13
43,"43137",1868,1254,1242,11,12,"PCPC",0
43,"43051",8512,5418,5366,32,52,"PCPC",4
17,"17143",142,103,99,1,4,"PCPC",0
43,"43010",322,233,227,0,6,"PCPC",0
25,"25063",87,58,58,1,0,"PCPC",0
17,"17035",548,381,379,5,2,"PCPC",0
17,"17076",124,86,84,3,2,"PCPC",0
25,"25201",112,73,72,3,1,"PCPC",0
17,"17209",630,443,438,7,5,"PCPC",1
17,"17130",325,223,222,3,1,"PCPC",1
8,"8077",34508,24070,23956,127,114,"PCPC",22
17,"17024",268,153,152,1,1,"PCPC",0
43,"43094",2143,1395,1375,13,20,"PCPC",1
8,"8068",6718,4373,4343,33,30,"PCPC",0
17,"17183",277,180,179,1,1,"PCPC",0
8,"8215",2588,1663,1647,16,16,"PCPC",1
8,"8172",20326,13875,13802,92,73,"PCPC",17
43,"43121",599,354,348,1,6,"PCPC",1
8,"8283",5963,3670,3642,24,28,"PCPC",4
43,"43039",99,66,66,0,0,"PCPC",0
25,"25255",417,298,296,2,2,"PCPC",0
43,"43162",4346,2983,2958,21,25,"PCPC",2
43,"43053",191,144,143,3,1,"PCPC",0
17,"17133",1255,805,796,9,9,"PCPC",2
17,"17050",652,453,453,3,0,"PCPC",0
43,"43095",2474,1575,1551,17,24,"PCPC",5
25,"25127",210,136,136,2,0,"PCPC",0
43,"43172",344,211,209,4,2,"PCPC",1
25,"25212",233,154,153,6,1,"PCPC",0
43,"43013",4411,2750,2739,19,11,"PCPC",3
25,"25139",467,294,291,5,3,"PCPC",1
17,"17052",125,78,78,0,0,"PCPC",0
25,"25001",144,73,73,0,0,"PCPC",0
8,"8203",2390,1466,1456,8,10,"PCPC",1
17,"17146",2969,1868,1855,8,13,"PCPC",2
43,"43033",765,531,530,4,1,"PCPC",0
25,"25120",92002,55658,55214,587,444,"PCPC",69
8,"8062",956,619,618,4,1,"PCPC",1
8,"8249",266,211,209,2,2,"PCPC",0
17,"17151",174,111,110,3,1,"PCPC",0
17,"17226",867,549,546,8,3,"PCPC",0
8,"8259",6637,4611,4577,39,34,"PCPC",13
8,"8192",5678,3729,3707,35,22,"PCPC",4
25,"25245",435,289,280,5,9,"PCPC",2
43,"43056",854,480,470,5,10,"PCPC",1
8,"8177",40,30,30,0,0,"PCPC",0
25,"25030",135,74,72,1,2,"PCPC",0
8,"8227",2326,1508,1487,20,21,"PCPC",1
17,"17040",537,347,345,3,2,"PCPC",0
25,"25029",1655,1042,1029,15,13,"PCPC",0
8,"8041",10343,6645,6582,57,63,"PCPC",11
43,"43043",3130,2053,2036,18,17,"PCPC",0
8,"8197",7648,5020,5000,37,20,"PCPC",2
17,"17152",10737,6308,6252,45,56,"PCPC",4
8,"8069",3169,2161,2148,32,13,"PCPC",5
43,"43084",526,363,361,10,2,"PCPC",1
25,"25904",148,112,111,2,1,"PCPC",0
8,"8110",13315,8457,8368,73,89,"PCPC",13
8,"8246",1665,1086,1078,9,8,"PCPC",0
17,"17069",374,256,251,0,5,"PCPC",0
43,"43057",38,25,25,1,0,"PCPC",0
25,"25142",364,229,225,2,4,"PCPC",0
17,"17123",354,266,263,0,3,"PCPC",2
43,"43113",393,279,278,5,1,"PCPC",0
8,"8097",1021,715,712,8,3,"PCPC",0
25,"25004",571,376,373,3,3,"PCPC",0
8,"8138",4248,2638,2618,27,20,"PCPC",3
43,"43081",593,400,395,3,5,"PCPC",0
17,"17212",141,104,102,0,2,"PCPC",0
43,"43085",226,180,180,1,0,"PCPC",0
25,"25158",1620,1019,1012,15,7,"PCPC",0
8,"8207",1865,1407,1402,19,5,"PCPC",1
17,"17188",164,124,124,1,0,"PCPC",1
43,"43046",99,68,65,1,3,"PCPC",0
25,"25132",136,88,87,0,1,"PCPC",0
43,"43063",557,355,349,9,6,"PCPC",0
25,"25193",759,485,480,2,5,"PCPC",1
25,"25013",2146,1240,1226,16,14,"PCPC",1
43,"43159",81,59,59,0,0,"PCPC",0
25,"25023",4531,2782,2763,30,19,"PCPC",2
25,"25033",1096,729,723,4,6,"PCPC",1
25,"25059",805,527,523,7,4,"PCPC",0
17,"17084",238,146,144,5,2,"PCPC",0
8,"8277",157,108,107,0,1,"PCPC",1
17,"17227",129,86,85,5,1,"PCPC",0
8,"8072",10259,6462,6422,42,40,"PCPC",8
17,"17213",5424,3239,3219,24,20,"PCPC",3
43,"43015",112,87,86,0,1,"PCPC",0
8,"8126",8748,5927,5895,56,32,"PCPC",6
8,"8258",830,557,551,6,6,"PCPC",0
8,"8059",347,195,195,2,0,"PCPC",0
43,"43905",14392,8444,8393,45,51,"PCPC",9
43,"43079",364,248,248,0,0,"PCPC",0
43,"43065",399,252,251,3,1,"PCPC",0
8,"8182",2811,1799,1789,22,10,"PCPC",1
43,"43089",292,190,186,0,4,"PCPC",0
8,"8237",1643,1105,1096,8,9,"PCPC",0
43,"43157",353,268,264,5,4,"PCPC",0
25,"25008",1124,715,702,10,13,"PCPC",1
25,"25035",398,249,247,2,2,"PCPC",0
17,"17178",1059,654,650,7,4,"PCPC",0
17,"17128",308,205,203,3,2,"PCPC",0
8,"8279",153025,101133,100621,840,512,"PCPC",144
43,"43144",1247,842,836,6,6,"PCPC",2
25,"25105",125,92,92,2,0,"PCPC",0
43,"43158",85,52,52,1,0,"PCPC",0
17,"17204",572,355,354,4,1,"PCPC",2
43,"43127",743,528,527,2,1,"PCPC",0
8,"8307",48295,32010,31798,195,212,"PCPC",27
17,"17099",81,57,57,1,0,"PCPC",0
8,"8240",9348,6512,6483,38,29,"PCPC",6
25,"25136",95,64,64,1,0,"PCPC",0
43,"43119",799,470,468,8,2,"PCPC",1
17,"17022",6910,4207,4184,58,23,"PCPC",3
8,"8239",453,304,302,3,2,"PCPC",0
8,"8270",18490,12343,12274,93,69,"PCPC",12
43,"43045",149,110,110,2,0,"PCPC",0
17,"17088",533,368,366,4,2,"PCPC",0
8,"8031",2322,1552,1537,6,15,"PCPC",3
43,"43155",22873,14209,14082,153,127,"PCPC",13
8,"8071",240,163,162,5,1,"PCPC",0
8,"8152",114,80,79,0,1,"PCPC",0
43,"43124",482,308,307,2,1,"PCPC",0
25,"25094",137,98,95,1,3,"PCPC",0
17,"17218",582,404,401,1,3,"PCPC",0
8,"8171",2103,1288,1280,12,8,"PCPC",1
8,"8149",993,569,567,10,2,"PCPC",0
8,"8140",4774,3118,3098,23,20,"PCPC",4
43,"43111",2044,1291,1275,9,16,"PCPC",3
43,"43038",21366,13061,12943,111,118,"PCPC",10
8,"8241",73,52,52,0,0,"PCPC",0
8,"8281",4802,3343,3318,17,25,"PCPC",1
8,"8087",152,121,121,2,0,"PCPC",0
17,"17198",429,270,267,2,3,"PCPC",0
17,"17157",125,95,95,1,0,"PCPC",0
17,"17025",1134,793,787,6,6,"PCPC",0
25,"25211",680,386,379,4,7,"PCPC",0
17,"17144",206,141,141,3,0,"PCPC",0
43,"43149",686,447,443,8,4,"PCPC",0
25,"25025",1353,871,864,16,7,"PCPC",0
8,"8188",115,78,78,0,0,"PCPC",0
25,"25078",998,628,627,7,1,"PCPC",2
43,"43040",330,257,255,5,2,"PCPC",0
8,"8174",392,283,279,3,4,"PCPC",0
8,"8061",1497,986,983,14,3,"PCPC",1
25,"25079",299,198,193,2,5,"PCPC",0
8,"8079",343,256,255,4,1,"PCPC",1
8,"8284",12097,7157,7089,59,68,"PCPC",12
8,"8202",12680,8341,8278,75,63,"PCPC",9
25,"25186",213,124,122,3,2,"PCPC",0
8,"8190",256,168,165,2,3,"PCPC",0
8,"8257",107,71,71,0,0,"PCPC",0
8,"8093",27,21,21,0,0,"PCPC",0
25,"25226",253,155,152,3,3,"PCPC",1
25,"25019",4572,2726,2698,34,28,"PCPC",3
8,"8212",488,319,316,0,3,"PCPC",0
8,"8236",1527,1006,999,4,7,"PCPC",3
17,"17154",92,67,66,0,1,"PCPC",0
17,"17070",111,76,76,2,0,"PCPC",0
25,"25072",5850,3493,3444,29,49,"PCPC",1
25,"25119",2248,1449,1442,15,7,"PCPC",1
17,"17019",1775,1201,1188,7,13,"PCPC",0
8,"8286",2879,1802,1797,14,5,"PCPC",4
17,"17106",140,103,102,0,1,"PCPC",0
25,"25155",647,421,418,0,3,"PCPC",0
25,"25174",397,280,280,2,0,"PCPC",0
8,"8054",8998,6172,6129,44,43,"PCPC",5
17,"17058",177,101,100,3,1,"PCPC",0
43,"43165",577,436,433,3,3,"PCPC",1
25,"25099",1273,761,752,7,9,"PCPC",0
43,"43138",2672,1629,1585,37,44,"PCPC",3
17,"17197",132,102,101,1,1,"PCPC",0
17,"17063",162,111,109,0,2,"PCPC",0
8,"8002",201,130,124,0,6,"PCPC",0
25,"25185",692,400,397,6,3,"PCPC",1
8,"8206",728,523,515,5,8,"PCPC",0
25,"25003",3762,2215,2195,22,20,"PCPC",2
43,"43044",3963,2671,2640,33,31,"PCPC",6
8,"8096",42622,28797,28615,263,182,"PCPC",33
8,"8287",1048,736,735,2,1,"PCPC",1
25,"25156",783,543,537,7,6,"PCPC",0
8,"8155",6730,4353,4320,39,33,"PCPC",4
8,"8056",42140,28129,27977,257,152,"PCPC",33
43,"43139",2039,1218,1191,8,27,"PCPC",0
8,"8119",6180,4155,4123,28,32,"PCPC",6
8,"8057",60,45,44,1,1,"PCPC",0
17,"17042",419,272,272,2,0,"PCPC",0
17,"17150",1401,962,951,6,11,"PCPC",0
43,"43100",3301,2183,2172,24,11,"PCPC",6
25,"25048",1651,1051,1040,11,11,"PCPC",2
8,"8247",961,637,634,4,3,"PCPC",0
25,"25032",64,44,44,1,0,"PCPC",0
43,"43072",105,74,72,0,2,"PCPC",0
25,"25204",1231,731,724,5,7,"PCPC",1
8,"8088",11899,8149,8097,69,52,"PCPC",15
8,"8147",16967,11220,11138,65,82,"PCPC",9
25,"25149",1385,963,956,6,7,"PCPC",0
8,"8045",73,37,35,0,2,"PCPC",0
17,"17162",150,86,86,1,0,"PCPC",0
25,"25157",181,115,114,7,1,"PCPC",1
8,"8085",1000,662,658,5,4,"PCPC",1
17,"17138",928,637,633,4,4,"PCPC",2
43,"43006",681,438,437,9,1,"PCPC",0
8,"8209",6773,4410,4382,29,28,"PCPC",6
8,"8153",538,386,385,2,1,"PCPC",0
8,"8308",131,87,87,1,0,"PCPC",0
8,"8181",7887,5178,5144,48,34,"PCPC",5
8,"8162",2047,1400,1392,7,8,"PCPC",3
17,"17210",551,350,349,9,1,"PCPC",0
43,"43151",107,90,89,0,1,"PCPC",1
17,"17185",2265,1420,1404,15,16,"PCPC",1
43,"43049",728,464,461,4,3,"PCPC",1
8,"8101",174621,113632,112942,847,690,"PCPC",222
25,"25021",2607,1490,1481,20,9,"PCPC",3
43,"43092",7036,4226,4185,39,41,"PCPC",5
17,"17003",104,67,66,0,1,"PCPC",0
43,"43134",282,191,191,4,0,"PCPC",1
25,"25092",130,98,95,2,3,"PCPC",0
25,"25148",219,124,124,0,0,"PCPC",0
43,"43090",1076,565,558,6,7,"PCPC",3
43,"43117",146,108,105,0,3,"PCPC",0
17,"17012",1145,703,698,9,5,"PCPC",0
8,"8020",4926,3523,3502,33,21,"PCPC",3
8,"8278",4779,3161,3148,20,13,"PCPC",3
43,"43128",907,587,577,5,10,"PCPC",0
8,"8306",506,299,297,5,2,"PCPC",0
8,"8033",12813,8564,8509,63,55,"PCPC",9
8,"8166",991,631,625,7,6,"PCPC",0
25,"25022",104,79,79,0,0,"PCPC",0
17,"17170",171,125,123,1,2,"PCPC",0
25,"25177",368,226,226,0,0,"PCPC",1
25,"25123",193,134,131,2,3,"PCPC",0
43,"43091",132,86,86,0,0,"PCPC",0
17,"17062",5958,3463,3441,22,22,"PCPC",48
8,"8271",70,48,48,0,0,"PCPC",0
17,"17083",2940,1895,1876,16,19,"PCPC",2
17,"17110",1322,856,853,3,3,"PCPC",0
25,"25242",720,456,450,2,6,"PCPC",1
8,"8275",247,179,179,4,0,"PCPC",0
43,"43148",90275,59182,58757,388,425,"PCPC",72
8,"8301",48557,32715,32533,253,182,"PCPC",55
17,"17043",161,122,117,1,5,"PCPC",2
17,"17222",101,76,75,0,1,"PCPC",0
43,"43024",1537,993,983,8,10,"PCPC",0
17,"17233",2260,1528,1514,23,14,"PCPC",2
43,"43098",343,235,233,5,2,"PCPC",0
25,"25111",117,72,70,2,2,"PCPC",0
43,"43088",1996,1271,1255,7,16,"PCPC",0
8,"8058",1730,1102,1095,6,7,"PCPC",4
17,"17160",14747,9189,9129,65,60,"PCPC",10
43,"43027",161,118,116,15,2,"PCPC",0
43,"43153",10688,6675,6615,39,60,"PCPC",7
8,"8903",214,166,165,0,1,"PCPC",0
8,"8105",9630,6394,6339,49,55,"PCPC",10
17,"17065",331,230,230,1,0,"PCPC",0
25,"25218",81,64,63,1,1,"PCPC",0
25,"25056",235,143,143,2,0,"PCPC",0
8,"8901",227,148,145,1,3,"PCPC",0
17,"17169",2475,1619,1601,11,18,"PCPC",2
17,"17117",14353,8469,8426,49,43,"PCPC",10
43,"43108",1774,1172,1160,14,12,"PCPC",2
43,"43902",2743,1551,1531,23,20,"PCPC",3
8,"8269",2673,1788,1776,14,12,"PCPC",3
25,"25069",451,247,246,4,1,"PCPC",0
25,"25135",1028,600,593,10,7,"PCPC",1
43,"43104",1783,1157,1142,10,15,"PCPC",1
17,"17215",2087,1481,1466,7,15,"PCPC",1
17,"17191",141,92,89,1,3,"PCPC",0
8,"8235",3686,2488,2470,16,18,"PCPC",1
8,"8165",1649,1100,1085,9,15,"PCPC",0
25,"25131",403,248,241,7,7,"PCPC",0
8,"8302",9218,5946,5891,82,55,"PCPC",9
17,"17208",995,594,590,8,4,"PCPC",0
17,"17119",74,54,54,0,0,"PCPC",0
8,"8293",219,168,167,0,1,"PCPC",1
25,"25176",309,216,211,1,5,"PCPC",0
17,"17112",190,127,125,2,2,"PCPC",0
8,"8027",687,486,485,2,1,"PCPC",0
17,"17001",587,404,398,2,6,"PCPC",0
8,"8169",47759,32651,32439,243,212,"PCPC",51
25,"25163",231,135,132,2,3,"PCPC",0
43,"43903",2392,1324,1313,10,11,"PCPC",1
43,"43904",2900,1602,1573,32,29,"PCPC",1
43,"43178",1350,856,844,5,12,"PCPC",0
25,"25115",824,489,487,7,2,"PCPC",0
25,"25190",262,185,183,0,2,"PCPC",0
43,"43070",238,192,191,1,1,"PCPC",0
17,"17027",2821,1896,1889,17,7,"PCPC",0
8,"8204",3055,2094,2082,17,12,"PCPC",1
25,"25901",293,202,202,7,0,"PCPC",1
8,"8189",127,90,89,3,1,"PCPC",0
8,"8001",8907,6316,6269,46,47,"PCPC",2
25,"25112",273,192,188,4,4,"PCPC",1
17,"17021",131,86,85,4,1,"PCPC",0
17,"17033",5307,3264,3241,29,23,"PCPC",4
25,"25238",204,140,138,4,2,"PCPC",0
17,"17121",224,140,140,1,0,"PCPC",0
43,"43901",8737,4703,4639,62,64,"PCPC",7
17,"17094",1059,602,600,4,2,"PCPC",0
8,"8042",2231,1565,1558,17,7,"PCPC",2
8,"8136",11450,7703,7641,84,62,"PCPC",8
8,"8292",1072,730,725,6,5,"PCPC",2
8,"8003",7084,4839,4803,39,36,"PCPC",2
17,"17046",717,459,458,4,1,"PCPC",1
8,"8048",582,419,417,4,2,"PCPC",0
25,"25027",976,633,630,7,3,"PCPC",1
25,"25152",140,86,86,1,0,"PCPC",0
25,"25122",1915,1208,1197,16,11,"PCPC",0
8,"8266",43030,30192,30039,229,153,"PCPC",41
8,"8143",2682,1718,1707,17,11,"PCPC",1
25,"25093",640,403,395,7,8,"PCPC",1
8,"8111",218,185,184,3,1,"PCPC",0
8,"8070",266,194,191,2,3,"PCPC",0
8,"8066",1365,926,921,8,5,"PCPC",1
25,"25064",108,68,68,2,0,"PCPC",0
43,"43060",2860,1950,1926,12,24,"PCPC",3
25,"25252",548,343,342,9,1,"PCPC",0
17,"17002",556,401,396,0,5,"PCPC",0
17,"17060",424,268,266,5,2,"PCPC",0
17,"17086",1729,1068,1059,8,9,"PCPC",0
8,"8141",4563,2953,2929,34,24,"PCPC",2
25,"25205",566,382,372,8,10,"PCPC",0
25,"25103",135,76,76,4,0,"PCPC",0
43,"43142",1100,698,688,5,10,"PCPC",1
25,"25223",922,553,543,8,10,"PCPC",0
43,"43074",1754,1170,1157,9,13,"PCPC",2
17,"17071",1134,778,774,10,4,"PCPC",1
8,"8252",24570,17009,16901,145,108,"PCPC",18
43,"43099",306,228,226,4,2,"PCPC",0
25,"25909",148,93,92,2,1,"PCPC",1
8,"8024",386,243,236,0,7,"PCPC",0
17,"17142",2550,1806,1797,30,9,"PCPC",0
17,"17037",104,69,69,1,0,"PCPC",0
25,"25222",66,52,52,1,0,"PCPC",0
17,"17090",545,370,368,4,2,"PCPC",2
43,"43140",2367,1550,1532,4,18,"PCPC",2
17,"17194",80,55,54,0,1,"PCPC",0
43,"43035",254,156,155,2,1,"PCPC",0
25,"25074",178,132,128,6,4,"PCPC",0
25,"25192",743,449,436,2,13,"PCPC",3
25,"25047",1014,675,674,8,1,"PCPC",0
8,"8261",2327,1499,1493,11,6,"PCPC",1
17,"17232",152,92,91,1,1,"PCPC",0
8,"8084",1142,773,768,14,5,"PCPC",0
43,"43036",843,493,485,4,8,"PCPC",0
17,"17034",6931,4166,4150,29,16,"PCPC",4
8,"8211",33081,23576,23413,226,163,"PCPC",12
8,"8183",4550,2809,2796,20,13,"PCPC",3
43,"43032",517,332,329,5,3,"PCPC",0
17,"17225",214,139,139,3,0,"PCPC",0
43,"43017",124,101,101,1,0,"PCPC",0
17,"17217",354,265,263,2,2,"PCPC",0
8,"8004",223,165,164,2,1,"PCPC",0
17,"17184",1254,814,809,6,5,"PCPC",0
8,"8260",18335,12325,12263,106,62,"PCPC",11
17,"17087",225,152,149,2,3,"PCPC",0
43,"43116",451,324,317,5,7,"PCPC",0
8,"8142",133,103,101,5,2,"PCPC",0
8,"8115",3799,2589,2572,17,17,"PCPC",3
17,"17074",510,337,335,2,2,"PCPC",0
8,"8163",18641,11801,11729,68,72,"PCPC",13
17,"17095",19555,11537,11428,89,109,"PCPC",10
17,"17105",247,147,147,1,0,"PCPC",0
43,"43101",145,104,102,3,2,"PCPC",0
8,"8194",25660,15045,14941,122,104,"PCPC",23
8,"8268",1005,665,659,4,6,"PCPC",4
8,"8245",78562,50821,50538,384,283,"PCPC",100
25,"25087",60,43,43,0,0,"PCPC",0
8,"8123",19140,13557,13484,106,73,"PCPC",18
17,"17114",23041,13985,13880,135,105,"PCPC",20
25,"25036",184,112,111,4,1,"PCPC",0
17,"17141",5887,3197,3165,34,32,"PCPC",5
25,"25006",340,201,200,6,1,"PCPC",0
17,"17029",207,127,127,1,0,"PCPC",0
8,"8154",696,494,488,5,6,"PCPC",0
8,"8198",4411,2972,2954,23,18,"PCPC",8
17,"17124",1607,1027,1007,11,20,"PCPC",0
8,"8021",70,49,46,0,3,"PCPC",0
8,"8228",301,199,197,6,2,"PCPC",1
8,"8011",1756,1087,1082,16,5,"PCPC",0
8,"8170",450,276,274,7,2,"PCPC",0
43,"43022",1497,897,889,14,8,"PCPC",0
25,"25101",561,364,358,2,6,"PCPC",2
8,"8288",1659,1004,994,7,10,"PCPC",1
43,"43073",83,60,58,0,2,"PCPC",0
17,"17137",3437,2293,2275,19,18,"PCPC",3
8,"8102",28296,18466,18367,172,99,"PCPC",18
17,"17030",641,400,398,1,2,"PCPC",0
43,"43126",1177,782,772,4,10,"PCPC",0
43,"43062",281,217,215,2,2,"PCPC",0
25,"25249",182,99,98,1,1,"PCPC",0
25,"25248",891,592,586,6,6,"PCPC",0
8,"8262",6836,4175,4144,50,31,"PCPC",6
43,"43114",392,271,268,2,3,"PCPC",0
8,"8305",27339,17960,17809,147,151,"PCPC",33
17,"17175",578,321,312,5,9,"PCPC",0
8,"8265",1553,1028,1018,11,10,"PCPC",0
8,"8075",3883,2479,2467,14,12,"PCPC",3
17,"17163",2626,1764,1747,10,17,"PCPC",3
43,"43907",4374,2793,2783,24,10,"PCPC",1
8,"8224",820,557,551,2,6,"PCPC",0
15,"15041",9568,6828,6710,75,118,"PCPE",7
15,"15048",4839,3456,3414,36,42,"PCPE",6
15,"15032",3444,2322,2269,30,53,"PCPE",0
15,"15024",4393,3141,3073,32,68,"PCPE",3
15,"15066",4009,2814,2776,33,38,"PCPE",0
36,"36025",2257,1360,1350,10,10,"PCPE",1
15,"15079",1540,1027,1007,16,20,"PCPE",1
36,"36030",4175,2832,2785,27,47,"PCPE",6
36,"36010",2847,2102,2076,13,26,"PCPE",0
15,"15002",23083,16073,15889,159,184,"PCPE",20
15,"15011",15432,10395,10248,74,147,"PCPE",22
15,"15074",4037,2841,2796,20,45,"PCPE",5
36,"36029",16077,11617,11471,100,146,"PCPE",15
36,"36002",3147,2193,2169,20,24,"PCPE",5
15,"15003",1803,1227,1210,9,17,"PCPE",0
15,"15078",78198,56154,55581,560,573,"PCPE",45
15,"15076",2611,1758,1739,17,19,"PCPE",5
36,"36009",4503,3056,3001,15,55,"PCPE",9
36,"36001",2564,1858,1848,5,10,"PCPE",1
15,"15016",4749,3058,3020,19,38,"PCPE",3
36,"36050",7561,5280,5188,25,92,"PCPE",5
15,"15037",4061,2588,2552,19,36,"PCPE",5
15,"15044",1286,937,927,8,10,"PCPE",0
15,"15028",1409,1038,1024,6,14,"PCPE",1
36,"36018",3240,2198,2170,10,28,"PCPE",1
15,"15052",4314,2889,2838,21,51,"PCPE",2
36,"36038",66390,47750,47273,449,477,"PCPE",42
15,"15061",5571,3746,3691,27,55,"PCPE",1
15,"15004",4834,3436,3391,30,45,"PCPE",3
36,"36015",4153,2721,2677,23,44,"PCPE",0
36,"36026",20137,13779,13596,141,183,"PCPE",11
36,"36017",17782,12411,12240,117,171,"PCPE",16
15,"15069",6745,4910,4850,43,60,"PCPE",4
15,"15033",2472,1863,1845,8,18,"PCPE",3
36,"36054",10993,7476,7363,67,113,"PCPE",13
15,"15036",57885,39471,39096,417,375,"PCPE",86
15,"15006",5321,3341,3283,49,58,"PCPE",6
15,"15071",7951,5255,5178,50,77,"PCPE",10
15,"15054",32106,21026,20772,259,254,"PCPE",32
15,"15086",2869,1970,1950,13,20,"PCPE",1
15,"15047",2429,1576,1549,19,27,"PCPE",6
36,"36034",3475,2403,2367,11,36,"PCPE",7
36,"36014",1942,1459,1444,9,15,"PCPE",6
15,"15070",9069,6090,5976,94,114,"PCPE",9
15,"15019",25888,16680,16460,186,220,"PCPE",17
36,"36033",12298,8968,8788,53,180,"PCPE",16
15,"15015",2799,2045,2008,24,37,"PCPE",3
15,"15902",4598,3209,3149,51,60,"PCPE",3
36,"36042",17891,12212,12003,93,209,"PCPE",15
15,"15049",1098,758,752,7,6,"PCPE",1
15,"15065",7315,5187,5099,42,88,"PCPE",6
15,"15051",4638,3182,3153,44,29,"PCPE",8
15,"15059",10362,7258,7106,91,152,"PCPE",3
15,"15030",200176,143255,142070,1452,1185,"PCPE",134
36,"36012",3732,2751,2717,9,34,"PCPE",2
15,"15040",2753,1905,1880,5,25,"PCPE",3
15,"15091",1135,771,760,13,11,"PCPE",1
15,"15901",3546,2247,2228,24,19,"PCPE",2
15,"15090",1179,812,804,9,8,"PCPE",1
15,"15022",5785,3811,3771,33,40,"PCPE",8
36,"36049",6804,4960,4860,36,100,"PCPE",8
15,"15073",21827,14058,13864,126,194,"PCPE",12
15,"15027",1536,1182,1155,6,27,"PCPE",0
15,"15018",1142,741,732,18,9,"PCPE",0
36,"36059",4882,3137,3085,28,52,"PCPE",5
36,"36058",4994,3292,3243,33,49,"PCPE",5
15,"15017",19420,13661,13505,175,156,"PCPE",16
15,"15029",5688,3590,3544,32,46,"PCPE",4
15,"15057",12075,8479,8377,66,102,"PCPE",11
15,"15082",15180,10841,10726,102,115,"PCPE",6
15,"15053",7729,5089,5043,49,46,"PCPE",7
36,"36901",4103,3153,3102,19,51,"PCPE",1
36,"36055",13620,9580,9400,62,180,"PCPE",19
36,"36005",8121,5480,5400,52,80,"PCPE",5
36,"36046",4036,2971,2921,15,50,"PCPE",7
15,"15007",3303,2262,2246,15,16,"PCPE",0
36,"36053",5684,4099,4050,38,49,"PCPE",6
36,"36011",1799,1144,1122,8,22,"PCPE",1
36,"36023",8395,5965,5884,41,81,"PCPE",10
15,"15031",23348,16380,16235,191,145,"PCPE",19
15,"15034",2885,1782,1760,18,22,"PCPE",0
15,"15067",8029,5789,5732,37,57,"PCPE",5
36,"36006",11520,8529,8396,63,133,"PCPE",16
36,"36013",2344,1536,1514,11,22,"PCPE",4
15,"15045",3770,2184,2157,14,27,"PCPE",0
15,"15093",4220,2533,2498,30,35,"PCPE",3
15,"15092",6438,3976,3903,28,73,"PCPE",2
15,"15081",1034,791,782,11,9,"PCPE",0
15,"15056",5722,3869,3818,46,51,"PCPE",2
15,"15080",1756,1131,1117,11,14,"PCPE",0
36,"36008",21762,15447,15262,128,185,"PCPE",17
15,"15084",3260,2218,2191,27,27,"PCPE",4
15,"15035",11427,7779,7657,144,122,"PCPE",13
15,"15068",5049,3185,3129,25,56,"PCPE",3
15,"15085",3332,2280,2247,25,33,"PCPE",3
15,"15077",8261,5186,5103,59,83,"PCPE",0
36,"36037",2571,1733,1707,11,26,"PCPE",3
36,"36016",1143,721,711,3,10,"PCPE",0
15,"15060",5772,4032,3958,46,74,"PCPE",11
15,"15023",6419,4348,4261,36,87,"PCPE",6
15,"15083",1086,757,746,5,11,"PCPE",2
36,"36052",7292,4999,4907,45,92,"PCPE",8
36,"36045",24529,17613,17336,129,277,"PCPE",26
36,"36040",2575,1709,1680,15,29,"PCPE",1
36,"36043",4747,3210,3162,20,48,"PCPE",2
15,"15008",5627,4112,4072,36,40,"PCPE",4
15,"15064",2194,1592,1556,21,36,"PCPE",1
15,"15075",12336,8830,8725,91,105,"PCPE",7
15,"15012",3627,2659,2602,28,57,"PCPE",3
15,"15005",24516,15761,15537,213,224,"PCPE",20
36,"36022",9011,6310,6172,49,138,"PCPE",13
15,"15001",4765,3280,3237,25,43,"PCPE",6
15,"15042",3028,2033,2000,19,33,"PCPE",2
36,"36041",13434,9297,9181,66,116,"PCPE",10
36,"36021",12073,8447,8342,89,105,"PCPE",8
36,"36003",9980,7191,7110,67,81,"PCPE",8
15,"15020",3784,2476,2447,17,29,"PCPE",5
15,"15021",5127,3587,3543,38,44,"PCPE",3
15,"15087",5769,3766,3722,42,44,"PCPE",4
15,"15038",2227,1463,1443,25,20,"PCPE",0
15,"15014",4002,2566,2524,28,42,"PCPE",3
15,"15043",5114,3476,3401,47,75,"PCPE",4
15,"15055",4572,3070,3013,27,57,"PCPE",9
36,"36057",236673,169244,167605,1366,1639,"PCPE",213
36,"36048",5331,3653,3603,22,50,"PCPE",4
36,"36020",2318,1646,1620,18,26,"PCPE",0
15,"15072",9574,6637,6562,35,75,"PCPE",11
15,"15058",27793,20392,20235,221,157,"PCPE",13
36,"36024",16455,11971,11781,109,190,"PCPE",11
15,"15050",1822,1004,988,13,16,"PCPE",3
36,"36036",2518,1827,1801,18,26,"PCPE",4
36,"36032",3630,2587,2535,16,52,"PCPE",2
36,"36035",14433,10333,10188,79,145,"PCPE",13
15,"15039",1263,889,875,7,14,"PCPE",2
15,"15088",3519,2304,2270,27,34,"PCPE",1
15,"15025",1061,629,622,6,7,"PCPE",1
36,"36039",15401,10871,10609,71,262,"PCPE",13
36,"36004",10161,6939,6844,63,95,"PCPE",14
36,"36051",14267,9638,9493,71,145,"PCPE",12
15,"15013",6151,4237,4189,48,48,"PCPE",11
36,"36031",558,465,459,7,6,"PCPE",0
36,"36056",5076,3584,3515,30,69,"PCPE",4
15,"15046",6332,4377,4262,40,115,"PCPE",5
15,"15010",1887,1168,1150,13,18,"PCPE",0
36,"36028",4102,2913,2868,17,45,"PCPE",4
15,"15062",5887,3747,3701,36,46,"PCPE",5
36,"36027",4430,3137,3101,15,36,"PCPE",5
36,"36060",30323,21399,21162,164,237,"PCPE",36
36,"36061",8606,6232,6133,41,99,"PCPE",4
15,"15009",10739,7688,7559,54,129,"PCPE",8
36,"36019",1625,1042,1029,9,13,"PCPE",0
36,"36044",2541,1674,1646,7,28,"PCPE",0
36,"36047",2454,1633,1621,13,12,"PCPE",4
15,"15089",4291,3020,2972,28,48,"PCPE",7
36,"36007",1672,1119,1099,8,20,"PCPE",3
32,"32021",947,634,630,5,4,"PCPE",4
32,"32086",2646,1693,1677,13,16,"PCPE",1
32,"32015",874,575,573,4,2,"PCPE",2
32,"32020",2576,1923,1899,5,24,"PCPE",2
32,"32032",8059,5708,5608,58,100,"PCPE",5
32,"32075",4217,3089,3044,33,45,"PCPE",1
32,"32007",1517,1046,1028,8,18,"PCPE",2
32,"32031",1069,822,795,4,27,"PCPE",1
32,"32043",2561,1806,1774,9,32,"PCPE",1
32,"32045",2443,1715,1690,14,25,"PCPE",3
32,"32033",737,478,476,3,2,"PCPE",0
32,"32076",2094,1488,1474,20,14,"PCPE",2
32,"32082",1243,891,878,1,13,"PCPE",1
32,"32049",760,510,507,9,3,"PCPE",1
32,"32004",1798,1029,1023,4,6,"PCPE",0
32,"32022",1337,892,881,6,11,"PCPE",0
32,"32089",1295,888,878,7,10,"PCPE",0
32,"32046",1160,787,779,4,8,"PCPE",1
32,"32026",2704,1929,1896,22,33,"PCPE",4
32,"32030",999,736,726,3,10,"PCPE",0
32,"32080",328,249,244,5,5,"PCPE",0
32,"32085",10716,7279,7152,66,127,"PCPE",8
32,"32062",811,621,617,6,4,"PCPE",1
32,"32091",1838,1368,1362,6,6,"PCPE",0
32,"32088",1622,1018,1002,8,16,"PCPE",1
32,"32047",1784,1255,1244,9,11,"PCPE",0
32,"32013",2183,1428,1425,8,3,"PCPE",4
32,"32003",885,654,649,5,5,"PCPE",3
32,"32079",1333,950,939,11,11,"PCPE",0
32,"32039",1262,957,941,6,16,"PCPE",2
32,"32077",1166,791,785,14,6,"PCPE",0
32,"32009",10803,7303,7227,48,76,"PCPE",7
32,"32012",784,505,497,2,8,"PCPE",2
32,"32034",1124,845,839,5,6,"PCPE",0
32,"32025",1079,791,777,1,14,"PCPE",2
32,"32090",774,530,511,4,19,"PCPE",0
32,"32072",3821,2705,2667,24,38,"PCPE",1
32,"32061",1081,812,809,4,3,"PCPE",0
32,"32001",4986,3488,3443,25,45,"PCPE",4
32,"32017",1244,870,857,6,13,"PCPE",2
32,"32027",1053,765,749,2,16,"PCPE",1
32,"32029",470,357,352,4,5,"PCPE",2
32,"32048",895,574,569,5,5,"PCPE",2
32,"32038",436,278,271,2,7,"PCPE",0
32,"32053",1438,1158,1144,11,14,"PCPE",0
32,"32002",2017,1413,1398,16,15,"PCPE",4
32,"32066",566,418,416,0,2,"PCPE",0
32,"32078",1188,855,838,4,17,"PCPE",0
32,"32051",1427,1184,1172,6,12,"PCPE",0
32,"32092",520,321,320,6,1,"PCPE",0
32,"32087",1765,1363,1343,13,20,"PCPE",2
32,"32081",2077,1517,1500,14,17,"PCPE",4
32,"32024",4821,3320,3254,34,66,"PCPE",5
32,"32063",1914,1297,1279,16,18,"PCPE",1
32,"32014",1142,848,834,6,14,"PCPE",1
32,"32060",832,583,576,8,7,"PCPE",0
32,"32084",918,641,635,3,6,"PCPE",2
32,"32005",861,662,650,7,12,"PCPE",0
32,"32041",767,524,515,4,9,"PCPE",1
32,"32059",1790,1283,1263,7,20,"PCPE",0
32,"32018",1247,975,962,9,13,"PCPE",1
32,"32023",1210,862,849,4,13,"PCPE",0
32,"32068",1415,982,978,5,4,"PCPE",2
32,"32057",565,416,415,4,1,"PCPE",0
32,"32067",1294,837,826,8,11,"PCPE",1
32,"32050",2433,1829,1814,12,15,"PCPE",2
32,"32010",388,301,299,3,2,"PCPE",2
32,"32070",548,335,329,3,6,"PCPE",1
32,"32016",790,550,543,2,7,"PCPE",0
32,"32055",1280,891,881,7,10,"PCPE",1
32,"32006",1531,1114,1090,10,24,"PCPE",1
32,"32011",932,619,613,1,6,"PCPE",0
32,"32071",1476,1010,1005,3,5,"PCPE",0
32,"32042",1579,1094,1081,12,13,"PCPE",2
32,"32083",835,559,550,4,9,"PCPE",2
32,"32065",657,463,454,3,9,"PCPE",0
32,"32064",529,389,388,3,1,"PCPE",0
32,"32019",11537,7975,7861,56,114,"PCPE",11
32,"32058",5202,3650,3607,34,43,"PCPE",2
32,"32008",8256,5542,5490,39,52,"PCPE",9
32,"32036",1345,971,953,14,18,"PCPE",2
32,"32054",87167,60059,59333,540,726,"PCPE",64
32,"32044",876,643,634,2,9,"PCPE",0
32,"32056",1592,1124,1118,7,6,"PCPE",0
32,"32074",1044,710,704,4,6,"PCPE",2
32,"32052",1888,1399,1379,6,20,"PCPE",1
32,"32037",728,518,509,6,9,"PCPE",0
32,"32040",1477,1090,1084,7,6,"PCPE",2
32,"32028",1610,1211,1189,16,22,"PCPE",3
32,"32035",1442,957,942,3,15,"PCPE",1
32,"32073",1315,973,960,5,13,"PCPE",3
32,"32069",4308,3221,3164,27,57,"PCPE",3
49,"49214",698,525,512,3,13,"PCPE",0
24,"24166",1407,1013,993,8,20,"PCPE",0
20,"20033",868,600,599,1,1,"PCPE",0
23,"23065",1597,1170,1149,2,21,"PCPE",3
34,"34048",73,59,59,1,0,"PCPE",0
9,"9306",106,82,82,1,0,"PCPE",0
11,"11012",99886,70290,69673,693,617,"PCPE",61
23,"23047",1629,1258,1250,10,8,"PCPE",0
44,"44121",60,47,47,2,0,"PCPE",0
42,"42121",64,47,47,0,0,"PCPE",0
47,"47232",102,77,74,1,3,"PCPE",0
26,"26056",419,338,332,1,6,"PCPE",0
42,"42004",2285,1757,1737,15,20,"PCPE",1
24,"24207",294,241,238,3,3,"PCPE",0
26,"26130",203,167,167,1,0,"PCPE",0
4,"4098",1516,1115,1106,11,9,"PCPE",0
46,"46126",5556,4449,4405,24,44,"PCPE",2
28,"28048",500,391,387,3,4,"PCPE",0
37,"37363",118,88,87,0,1,"PCPE",0
41,"41066",1342,945,927,2,18,"PCPE",2
26,"26179",41,32,31,0,1,"PCPE",0
49,"49123",546,391,384,1,7,"PCPE",0
46,"46053",553,445,436,2,9,"PCPE",1
40,"40076",6492,4768,4700,26,68,"PCPE",12
20,"20081",7470,4856,4833,40,23,"PCPE",1
20,"20038",387,261,259,0,2,"PCPE",0
37,"37267",200,156,147,2,9,"PCPE",0
28,"28138",60,46,46,0,0,"PCPE",0
9,"9077",34,27,27,0,0,"PCPE",0
37,"37222",93,72,72,0,0,"PCPE",0
37,"37290",141,113,113,0,0,"PCPE",0
1,"1037",587,411,408,1,3,"PCPE",1
16,"16185",43,37,37,0,0,"PCPE",0
44,"44252",86,65,65,0,0,"PCPE",0
16,"16115",44,35,34,0,1,"PCPE",0
48,"48045",5167,3809,3757,28,52,"PCPE",1
9,"9088",66,45,45,0,0,"PCPE",0
34,"34127",93,65,64,1,1,"PCPE",0
41,"41027",3922,2660,2604,23,56,"PCPE",3
22,"22020",115,86,86,1,0,"PCPE",0
33,"33047",1107,852,843,9,9,"PCPE",0
2,"2086",2586,1701,1687,7,14,"PCPE",0
9,"9182",80,69,67,1,2,"PCPE",0
4,"4032",5586,3642,3623,23,19,"PCPE",2
49,"49249",69,58,58,1,0,"PCPE",0
3,"3031",41499,27031,26813,128,218,"PCPE",79
47,"47014",51,45,45,0,0,"PCPE",0
24,"24116",417,314,309,1,5,"PCPE",0
47,"47093",813,613,600,5,13,"PCPE",0
28,"28012",887,664,661,2,3,"PCPE",1
50,"50150",649,402,397,2,5,"PCPE",0
47,"47154",152,128,125,1,3,"PCPE",1
42,"42206",8,8,8,1,0,"PCPE",0
26,"26129",967,775,766,6,9,"PCPE",0
50,"50155",103,80,78,0,2,"PCPE",0
3,"3050",18652,13325,13234,57,91,"PCPE",14
16,"16259",29,22,21,0,1,"PCPE",0
16,"16011",27,22,22,1,0,"PCPE",0
49,"49008",460,332,331,5,1,"PCPE",0
45,"45202",3894,2776,2744,14,32,"PCPE",2
16,"16022",78,67,66,0,1,"PCPE",0
22,"22184",184,155,155,3,0,"PCPE",0
16,"16117",1040,787,777,4,10,"PCPE",0
14,"14028",314,253,249,1,4,"PCPE",0
9,"9329",121,87,87,1,0,"PCPE",0
50,"50023",224,175,175,0,0,"PCPE",0
2,"2037",22865,14632,14477,91,155,"PCPE",14
45,"45084",2257,1679,1656,13,23,"PCPE",1
46,"46052",499,421,417,2,4,"PCPE",0
2,"2051",1676,1177,1162,6,15,"PCPE",0
9,"9394",715,533,521,3,12,"PCPE",0
18,"18067",702,469,466,0,3,"PCPE",0
9,"9152",257,183,183,0,0,"PCPE",0
21,"21023",2124,1298,1264,7,34,"PCPE",1
47,"47169",68,59,59,0,0,"PCPE",0
46,"46903",6065,4790,4763,18,27,"PCPE",1
45,"45032",436,283,275,1,8,"PCPE",0
16,"16111",171,123,123,1,0,"PCPE",1
2,"2022",351,281,279,1,2,"PCPE",0
23,"23034",2540,1957,1934,14,23,"PCPE",0
37,"37092",1758,1225,1215,8,10,"PCPE",0
9,"9074",794,575,569,6,6,"PCPE",0
49,"49157",206,163,160,2,3,"PCPE",0
18,"18149",5230,3903,3864,20,39,"PCPE",6
22,"22209",155,120,120,3,0,"PCPE",0
50,"50129",235,161,158,2,3,"PCPE",0
45,"45144",783,620,618,3,2,"PCPE",1
30,"30002",9903,7011,6943,28,68,"PCPE",6
49,"49046",268,203,203,0,0,"PCPE",0
21,"21017",3600,2187,2164,26,23,"PCPE",11
20,"20052",1090,779,776,8,3,"PCPE",0
42,"42211",82,66,66,1,0,"PCPE",0
48,"48910",2909,1950,1937,10,13,"PCPE",1
24,"24006",472,353,347,0,6,"PCPE",2
28,"28024",151,125,124,1,1,"PCPE",0
20,"20053",4774,2973,2953,13,20,"PCPE",5
37,"37273",107,71,71,1,0,"PCPE",0
34,"34073",185,149,149,0,0,"PCPE",0
29,"29045",1684,1178,1168,8,10,"PCPE",0
20,"20060",88,67,67,2,0,"PCPE",0
47,"47100",138,117,117,1,0,"PCPE",0
16,"16211",370,263,263,3,0,"PCPE",0
24,"24003",648,460,453,7,7,"PCPE",0
16,"16032",278,224,221,1,3,"PCPE",1
49,"49136",318,220,218,1,2,"PCPE",0
33,"33005",1449,936,924,11,12,"PCPE",3
47,"47174",267,218,215,1,3,"PCPE",0
24,"24083",1042,727,715,6,12,"PCPE",2
4,"4075",5196,3735,3706,23,29,"PCPE",1
49,"49183",100,77,77,2,0,"PCPE",0
16,"16187",74,55,55,1,0,"PCPE",0
37,"37371",272,165,162,1,3,"PCPE",1
1,"1044",236,169,167,0,2,"PCPE",0
48,"48013",79716,53419,52997,345,422,"PCPE",59
40,"40030",473,369,363,3,6,"PCPE",1
9,"9387",117,95,90,0,5,"PCPE",0
50,"50086",187,132,128,2,4,"PCPE",0
42,"42087",49,43,42,0,1,"PCPE",0
37,"37368",17,17,17,0,0,"PCPE",0
45,"45134",1581,1204,1192,6,12,"PCPE",1
16,"16902",137,107,107,0,0,"PCPE",0
42,"42177",69,60,60,1,0,"PCPE",1
14,"14014",2557,2035,2007,9,28,"PCPE",1
22,"22201",266,188,187,3,1,"PCPE",0
45,"45157",2128,1456,1427,13,29,"PCPE",2
18,"18050",1710,1165,1152,3,13,"PCPE",0
9,"9460",176,131,131,1,0,"PCPE",1
44,"44142",35,27,27,0,0,"PCPE",0
47,"47129",871,664,659,4,5,"PCPE",0
47,"47130",96,72,72,0,0,"PCPE",0
9,"9070",34,26,26,0,0,"PCPE",0
1,"1056",219,136,135,0,1,"PCPE",0
4,"4903",4320,2858,2825,19,33,"PCPE",4
37,"37317",304,238,234,1,4,"PCPE",0
16,"16276",21,16,16,1,0,"PCPE",0
29,"29011",2900,1822,1803,9,19,"PCPE",0
47,"47073",122,103,101,1,2,"PCPE",0
26,"26127",212,181,176,0,5,"PCPE",0
22,"22243",45,28,28,0,0,"PCPE",0
2,"2046",1098,896,878,12,18,"PCPE",1
42,"42092",56,44,42,1,2,"PCPE",0
42,"42080",157,117,115,0,2,"PCPE",0
20,"20049",4122,2677,2666,15,11,"PCPE",1
47,"47212",380,323,322,2,1,"PCPE",0
34,"34904",315,234,230,2,4,"PCPE",0
50,"50054",58,50,50,0,0,"PCPE",0
3,"3124",460,388,384,3,4,"PCPE",1
42,"42042",45,35,35,0,0,"PCPE",0
18,"18905",14618,9789,9682,110,107,"PCPE",14
9,"9173",124,100,99,2,1,"PCPE",0
9,"9135",41,31,31,1,0,"PCPE",0
24,"24023",263,188,188,1,0,"PCPE",0
46,"46215",1436,1154,1143,5,11,"PCPE",0
37,"37272",141,107,104,0,3,"PCPE",0
29,"29080",6676,4469,4419,35,50,"PCPE",9
3,"3069",3076,2123,2102,17,21,"PCPE",2
18,"18065",618,496,470,3,26,"PCPE",2
18,"18174",446,330,324,2,6,"PCPE",0
42,"42153",14,12,12,0,0,"PCPE",0
26,"26094",83,70,70,0,0,"PCPE",0
40,"40156",322,238,235,1,3,"PCPE",0
45,"45194",68,54,53,0,1,"PCPE",0
44,"44247",316,218,215,3,3,"PCPE",1
40,"40010",121,102,101,1,1,"PCPE",0
16,"16029",99,72,70,0,2,"PCPE",0
37,"37221",430,293,290,0,3,"PCPE",1
48,"48034",12866,8798,8747,43,51,"PCPE",15
34,"34218",461,343,339,2,4,"PCPE",0
22,"22227",206,163,160,3,3,"PCPE",0
16,"16150",97,72,72,0,0,"PCPE",0
9,"9480",110,90,90,1,0,"PCPE",0
41,"41085",4086,3058,3012,22,46,"PCPE",3
2,"2050",98,83,82,0,1,"PCPE",0
47,"47180",73,61,60,4,1,"PCPE",0
9,"9369",436,319,316,1,3,"PCPE",0
9,"9215",368,256,256,2,0,"PCPE",0
26,"26092",107,92,90,0,2,"PCPE",0
24,"24156",239,159,158,1,1,"PCPE",1
9,"9055",52,42,41,1,1,"PCPE",0
22,"22167",493,388,381,9,7,"PCPE",0
16,"16010",152,115,112,0,3,"PCPE",0
18,"18171",2120,1572,1551,9,21,"PCPE",3
3,"3118",2437,1659,1642,4,17,"PCPE",1
50,"50081",511,382,378,4,4,"PCPE",0
37,"37311",227,182,182,3,0,"PCPE",0
49,"49180",148,103,102,2,1,"PCPE",0
37,"37013",119,79,76,0,3,"PCPE",0
49,"49239",663,458,448,3,10,"PCPE",2
9,"9396",156,121,121,0,0,"PCPE",1
39,"39021",487,381,376,2,5,"PCPE",0
50,"50227",109,79,79,0,0,"PCPE",0
48,"48058",968,647,646,2,1,"PCPE",1
33,"33058",1796,1232,1209,11,23,"PCPE",11
47,"47167",241,204,204,1,0,"PCPE",0
9,"9021",56,33,31,1,2,"PCPE",0
4,"4005",556,437,431,3,6,"PCPE",2
18,"18074",262,201,200,2,1,"PCPE",0
16,"16116",77,68,68,0,0,"PCPE",0
11,"11013",2312,1547,1518,15,29,"PCPE",2
49,"49018",329,261,256,2,5,"PCPE",0
9,"9119",46,28,28,0,0,"PCPE",0
50,"50092",299,233,231,0,2,"PCPE",0
21,"21072",10262,7442,7307,85,135,"PCPE",13
18,"18138",2486,1620,1606,13,14,"PCPE",5
9,"9312",96,78,77,0,1,"PCPE",1
44,"44219",194,145,143,1,2,"PCPE",0
9,"9363",965,737,734,2,3,"PCPE",2
37,"37119",107,84,82,0,2,"PCPE",0
2,"2082",101,80,80,1,0,"PCPE",0
28,"28181",20386,16155,16069,57,86,"PCPE",6
41,"41062",2223,1653,1637,7,16,"PCPE",0
16,"16045",222,172,171,1,1,"PCPE",0
28,"28095",1529,1119,1106,6,13,"PCPE",2
37,"37300",566,398,395,0,3,"PCPE",0
3,"3064",5015,3660,3611,11,49,"PCPE",3
3,"3054",343,277,275,3,2,"PCPE",1
4,"4079",51383,33777,33586,257,191,"PCPE",39
20,"20035",486,337,334,1,3,"PCPE",0
24,"24163",3962,2950,2933,24,17,"PCPE",3
50,"50099",3083,2148,2132,13,16,"PCPE",1
48,"48088",136,102,102,0,0,"PCPE",0
2,"2002",470,394,389,3,5,"PCPE",0
16,"16195",497,392,390,1,2,"PCPE",1
37,"37027",228,172,171,0,1,"PCPE",0
22,"22903",652,514,507,1,7,"PCPE",1
40,"40035",137,105,104,0,1,"PCPE",0
34,"34184",57,46,45,0,1,"PCPE",0
50,"50084",77,59,59,2,0,"PCPE",0
24,"24164",370,218,217,0,1,"PCPE",0
11,"11027",67913,45219,44833,454,386,"PCPE",74
37,"37126",29,24,24,0,0,"PCPE",0
9,"9051",170,130,128,0,2,"PCPE",1
24,"24218",451,330,325,2,5,"PCPE",0
26,"26139",54,45,44,0,1,"PCPE",0
39,"39059",7986,5879,5806,45,73,"PCPE",9
47,"47228",440,331,331,2,0,"PCPE",0
47,"47147",116,92,92,0,0,"PCPE",0
34,"34185",63,38,37,2,1,"PCPE",0
26,"26174",146,107,105,2,2,"PCPE",0
22,"22157",192,129,128,3,1,"PCPE",2
49,"49034",432,327,325,2,2,"PCPE",1
49,"49227",315,230,228,2,2,"PCPE",0
50,"50085",167,126,126,1,0,"PCPE",0
44,"44130",34,24,24,0,0,"PCPE",0
34,"34031",30,30,29,0,1,"PCPE",0
16,"16193",66,49,48,0,1,"PCPE",0
45,"45168",62229,47154,46741,285,413,"PCPE",60
37,"37235",224,153,148,2,5,"PCPE",0
33,"33003",646,355,352,9,3,"PCPE",0
46,"46148",1513,1160,1146,7,14,"PCPE",0
29,"29030",805,620,614,4,6,"PCPE",1
37,"37318",208,159,158,1,1,"PCPE",0
50,"50184",115,85,85,0,0,"PCPE",0
9,"9066",62,48,47,0,1,"PCPE",0
28,"28111",596,467,467,3,0,"PCPE",0
46,"46041",329,253,252,5,1,"PCPE",3
16,"16088",108,88,87,0,1,"PCPE",0
28,"28159",589,468,468,5,0,"PCPE",0
26,"26080",472,391,389,0,2,"PCPE",0
42,"42098",10,7,7,1,0,"PCPE",0
24,"24201",1090,762,759,10,3,"PCPE",1
48,"48051",213,163,163,0,0,"PCPE",0
26,"26046",1581,1175,1159,4,16,"PCPE",3
44,"44071",591,398,398,5,0,"PCPE",0
18,"18910",788,541,536,3,5,"PCPE",1
9,"9020",259,196,188,5,8,"PCPE",0
50,"50050",98,64,64,2,0,"PCPE",0
20,"20043",1739,1090,1088,9,2,"PCPE",1
46,"46129",524,420,412,4,8,"PCPE",2
46,"46155",1029,833,822,4,11,"PCPE",0
40,"40062",60,51,48,0,3,"PCPE",0
48,"48001",5838,3923,3898,28,25,"PCPE",4
16,"16096",274,232,229,1,3,"PCPE",0
20,"20021",200,100,100,2,0,"PCPE",0
37,"37377",241,201,199,1,2,"PCPE",0
49,"49022",288,229,225,3,4,"PCPE",0
34,"34170",61,42,42,0,0,"PCPE",0
41,"41054",692,560,546,3,14,"PCPE",0
46,"46121",105,95,94,0,1,"PCPE",1
22,"22229",114,80,80,1,0,"PCPE",0
4,"4078",1078,758,746,8,12,"PCPE",1
47,"47080",30,22,21,0,1,"PCPE",0
37,"37181",286,210,207,4,3,"PCPE",0
49,"49270",133,99,99,1,0,"PCPE",0
37,"37322",2465,1592,1564,8,28,"PCPE",1
47,"47124",392,316,311,3,5,"PCPE",0
37,"37258",172,116,115,3,1,"PCPE",0
16,"16083",52,33,33,0,0,"PCPE",0
41,"41084",2845,2124,2081,9,43,"PCPE",0
46,"46211",1745,1387,1378,8,9,"PCPE",0
45,"45091",394,269,267,3,2,"PCPE",0
29,"29094",57554,38071,37696,339,375,"PCPE",44
23,"23003",8688,6326,6257,52,69,"PCPE",4
9,"9247",24,21,21,1,0,"PCPE",0
50,"50279",86,64,64,0,0,"PCPE",0
49,"49233",93,58,55,0,3,"PCPE",0
49,"49111",127,98,96,4,2,"PCPE",0
28,"28092",151841,110916,109954,582,962,"PCPE",98
9,"9059",136488,101469,100463,907,1006,"PCPE",126
33,"33062",400,238,233,2,5,"PCPE",0
42,"42184",57,43,43,0,0,"PCPE",0
44,"44115",102,90,90,3,0,"PCPE",0
49,"49221",245,129,127,1,2,"PCPE",0
37,"37325",89,62,62,0,0,"PCPE",0
49,"49189",202,142,142,1,0,"PCPE",0
16,"16160",60,44,42,1,2,"PCPE",0
46,"46039",2130,1728,1699,8,29,"PCPE",1
28,"28043",5921,3803,3759,18,44,"PCPE",2
14,"14049",16309,11635,11515,115,120,"PCPE",21
44,"44056",501,345,342,2,3,"PCPE",0
42,"42043",3791,2727,2682,25,45,"PCPE",5
22,"22125",38773,27021,26732,258,289,"PCPE",27
28,"28003",173,141,141,0,0,"PCPE",0
9,"9085",475,347,342,2,5,"PCPE",1
24,"24161",285,203,201,3,2,"PCPE",0
44,"44032",16,11,11,0,0,"PCPE",0
49,"49186",261,188,185,0,3,"PCPE",0
18,"18111",2765,1949,1936,18,13,"PCPE",0
37,"37354",5240,3823,3771,39,52,"PCPE",2
9,"9388",34,27,26,0,1,"PCPE",0
50,"50082",82,65,64,0,1,"PCPE",0
9,"9374",90,71,70,1,1,"PCPE",0
46,"46228",2348,1815,1794,7,21,"PCPE",5
24,"24115",54058,37780,37357,308,423,"PCPE",31
49,"49206",840,614,604,9,10,"PCPE",0
9,"9908",449,307,306,3,1,"PCPE",0
40,"40138",2169,1673,1656,7,17,"PCPE",0
37,"37346",273,212,211,1,1,"PCPE",0
45,"45199",2940,1848,1805,14,43,"PCPE",3
20,"20041",255,123,123,0,0,"PCPE",0
37,"37156",4292,2996,2966,24,30,"PCPE",0
34,"34071",171,132,132,1,0,"PCPE",0
49,"49263",51,36,36,0,0,"PCPE",0
44,"44023",17,16,16,0,0,"PCPE",0
24,"24219",516,387,386,4,1,"PCPE",0
48,"48097",1297,900,894,8,6,"PCPE",3
16,"16084",48,38,37,1,1,"PCPE",0
44,"44118",164,132,131,2,1,"PCPE",0
37,"37133",111,78,73,1,5,"PCPE",0
3,"3027",157,138,135,0,3,"PCPE",0
21,"21047",1917,1111,1065,15,46,"PCPE",1
9,"9482",33,28,28,0,0,"PCPE",0
44,"44035",113,90,88,1,2,"PCPE",0
44,"44055",69,56,56,4,0,"PCPE",0
49,"49102",196,143,139,2,4,"PCPE",0
23,"23045",2132,1260,1247,5,13,"PCPE",4
40,"40058",325,277,276,4,1,"PCPE",0
50,"50181",993,733,720,5,13,"PCPE",0
42,"42178",115,83,83,0,0,"PCPE",0
50,"50078",235,177,173,0,4,"PCPE",0
39,"39069",1972,1510,1489,12,21,"PCPE",7
49,"49257",291,190,184,1,6,"PCPE",0
37,"37018",107,79,79,0,0,"PCPE",0
29,"29077",199,149,146,2,3,"PCPE",0
44,"44187",201,152,149,4,3,"PCPE",0
21,"21008",2658,1660,1636,10,24,"PCPE",1
22,"22095",72,58,58,1,0,"PCPE",0
14,"14050",2391,1822,1787,14,35,"PCPE",1
9,"9151",448,362,360,6,2,"PCPE",1
42,"42190",89,65,64,0,1,"PCPE",0
45,"45101",3756,3020,2984,12,36,"PCPE",1
45,"45079",369,288,286,3,2,"PCPE",0
3,"3080",1300,1035,1025,3,10,"PCPE",0
39,"39100",860,633,629,15,4,"PCPE",1
47,"47059",97,76,76,2,0,"PCPE",0
50,"50001",100,77,77,0,0,"PCPE",0
39,"39046",1404,1001,973,6,28,"PCPE",2
9,"9422",17,11,11,0,0,"PCPE",0
49,"49027",140,112,108,1,4,"PCPE",1
29,"29063",323,250,245,1,5,"PCPE",0
9,"9109",1056,619,595,8,24,"PCPE",3
4,"4095",714,471,468,5,3,"PCPE",0
37,"37205",231,189,182,0,7,"PCPE",0
22,"22036",92,77,77,0,0,"PCPE",0
47,"47115",281,236,233,3,3,"PCPE",0
44,"44037",453,317,315,0,2,"PCPE",1
20,"20030",21423,13960,13898,101,62,"PCPE",16
48,"48914",332,272,272,1,0,"PCPE",0
24,"24065",2138,1503,1472,15,31,"PCPE",4
42,"42029",137,104,104,2,0,"PCPE",0
39,"39102",2277,1615,1598,9,17,"PCPE",3
9,"9351",62,49,48,1,1,"PCPE",0
42,"42117",140,101,99,0,2,"PCPE",0
46,"46163",1866,1504,1480,8,24,"PCPE",2
26,"26010",93,80,80,2,0,"PCPE",0
47,"47221",111,94,94,0,0,"PCPE",0
33,"33001",1588,887,880,8,7,"PCPE",0
16,"16176",38,30,30,0,0,"PCPE",0
2,"2057",2020,1487,1461,10,26,"PCPE",0
37,"37237",324,244,240,1,4,"PCPE",0
18,"18133",2168,1648,1636,6,12,"PCPE",1
16,"16038",38,31,31,0,0,"PCPE",0
16,"16043",95,73,73,1,0,"PCPE",0
14,"14034",308,247,244,2,3,"PCPE",0
37,"37292",104,77,77,1,0,"PCPE",0
14,"14025",2924,2466,2422,14,44,"PCPE",7
16,"16280",192,164,161,1,3,"PCPE",0
49,"49067",367,250,249,0,1,"PCPE",0
37,"37224",206,183,175,3,8,"PCPE",0
23,"23002",17428,12820,12644,70,176,"PCPE",28
22,"22115",360,257,256,3,1,"PCPE",0
46,"46078",28017,20288,20143,132,145,"PCPE",31
40,"40211",74,64,64,0,0,"PCPE",0
47,"47089",148,125,124,0,1,"PCPE",0
40,"40164",177,139,138,0,1,"PCPE",0
11,"11007",17964,10038,9856,197,182,"PCPE",20
50,"50231",250,195,192,4,3,"PCPE",0
45,"45042",187,140,140,0,0,"PCPE",0
48,"48019",3553,2406,2397,18,9,"PCPE",2
47,"47036",228,181,181,3,0,"PCPE",0
45,"45106",7439,5613,5534,52,79,"PCPE",9
24,"24226",199,139,137,0,2,"PCPE",0
40,"40002",36,32,32,0,0,"PCPE",0
37,"37294",11692,8317,8221,71,96,"PCPE",9
4,"4004",425,329,329,0,0,"PCPE",0
34,"34143",168,123,120,2,3,"PCPE",0
41,"41078",2508,1823,1810,19,13,"PCPE",1
50,"50080",33,27,27,0,0,"PCPE",0
49,"49175",230,172,171,1,1,"PCPE",0
41,"41089",6493,4398,4331,43,67,"PCPE",9
49,"49222",380,279,272,0,7,"PCPE",1
48,"48044",62774,45594,45399,287,195,"PCPE",31
1,"1063",1798,1269,1261,19,8,"PCPE",1
50,"50136",575,414,410,2,4,"PCPE",0
2,"2016",569,413,410,6,3,"PCPE",0
29,"29092",570,397,390,4,7,"PCPE",0
14,"14052",9379,5917,5854,68,63,"PCPE",1
26,"26098",88,73,73,1,0,"PCPE",0
47,"47026",46,40,40,1,0,"PCPE",0
47,"47105",183,158,156,0,2,"PCPE",0
4,"4070",1584,1184,1179,3,5,"PCPE",3
46,"46141",439,351,342,2,9,"PCPE",1
42,"42034",30,22,22,0,0,"PCPE",0
47,"47091",84,71,71,2,0,"PCPE",0
46,"46167",364,266,264,0,2,"PCPE",0
46,"46219",127,112,112,1,0,"PCPE",0
16,"16173",205,157,156,0,1,"PCPE",0
9,"9047",54,47,46,1,1,"PCPE",0
9,"9249",46,33,33,0,0,"PCPE",0
42,"42157",13,10,10,0,0,"PCPE",0
40,"40160",102,71,70,1,1,"PCPE",0
9,"9103",217,184,183,1,1,"PCPE",0
16,"16905",1224,920,910,4,10,"PCPE",1
2,"2068",337,251,246,1,5,"PCPE",0
9,"9266",91,74,74,0,0,"PCPE",0
46,"46256",6853,4951,4890,25,61,"PCPE",7
50,"50235",2339,1664,1648,11,16,"PCPE",2
14,"14054",13697,10315,10109,93,206,"PCPE",4
49,"49178",705,496,487,4,9,"PCPE",0
47,"47112",2587,2015,1988,7,27,"PCPE",0
33,"33013",446,321,318,3,3,"PCPE",3
3,"3047",9207,6309,6226,25,83,"PCPE",8
47,"47121",544,437,425,6,12,"PCPE",0
48,"48026",1140,830,823,5,7,"PCPE",0
40,"40091",119,97,95,1,2,"PCPE",0
44,"44044",88,72,71,2,1,"PCPE",1
30,"30005",29526,20713,20526,121,187,"PCPE",11
22,"22032",110,76,74,0,2,"PCPE",0
34,"34903",198,131,131,1,0,"PCPE",0
16,"16099",203,153,147,0,6,"PCPE",0
44,"44084",54,41,41,0,0,"PCPE",0
46,"46238",13282,9786,9721,61,65,"PCPE",23
2,"2029",3282,2467,2445,17,22,"PCPE",3
4,"4073",330,234,233,2,1,"PCPE",0
3,"3129",1194,957,938,0,19,"PCPE",1
37,"37198",207,160,157,3,3,"PCPE",0
50,"50270",38,26,26,0,0,"PCPE",0
47,"47141",134,111,110,0,1,"PCPE",1
16,"16254",214,174,170,2,4,"PCPE",0
37,"37172",888,572,566,3,6,"PCPE",1
50,"50139",313,241,239,3,2,"PCPE",0
20,"20028",2237,1373,1365,11,8,"PCPE",1
11,"11038",13737,10181,10034,99,147,"PCPE",19
18,"18192",1538,1151,1123,6,28,"PCPE",2
3,"3101",4808,3627,3580,22,47,"PCPE",8
34,"34223",218,155,155,1,0,"PCPE",0
40,"40065",493,373,373,3,0,"PCPE",0
20,"20073",4677,3014,2995,15,19,"PCPE",2
37,"37204",276,198,195,1,3,"PCPE",0
9,"9123",40,35,35,0,0,"PCPE",0
40,"40093",77,65,65,1,0,"PCPE",0
14,"14041",3182,2296,2251,33,45,"PCPE",8
23,"23063",3829,2560,2522,21,38,"PCPE",7
50,"50140",166,115,115,0,0,"PCPE",0
16,"16053",426,351,347,5,4,"PCPE",0
40,"40075",160,139,139,0,0,"PCPE",0
37,"37299",219,166,163,4,3,"PCPE",0
49,"49006",154,99,95,0,4,"PCPE",0
49,"49170",102,72,71,0,1,"PCPE",0
46,"46249",9288,6746,6676,56,70,"PCPE",6
47,"47042",54,37,37,0,0,"PCPE",0
45,"45191",543,472,468,3,4,"PCPE",0
26,"26164",59,46,45,2,1,"PCPE",0
44,"44016",482,363,360,2,3,"PCPE",0
28,"28099",1748,1290,1283,7,7,"PCPE",3
24,"24021",1675,1162,1144,8,18,"PCPE",2
9,"9411",151,102,101,0,1,"PCPE",0
29,"29024",386,227,219,2,8,"PCPE",0
9,"9137",174,132,131,3,1,"PCPE",1
22,"22173",232,152,152,3,0,"PCPE",0
42,"42003",67,48,47,0,1,"PCPE",0
40,"40026",119,109,109,0,0,"PCPE",0
40,"40207",763,599,593,3,6,"PCPE",1
45,"45181",2315,1674,1640,7,34,"PCPE",1
29,"29088",2714,1829,1800,12,29,"PCPE",2
49,"49250",1245,935,920,7,15,"PCPE",2
1,"1031",1169,882,863,6,19,"PCPE",3
34,"34108",542,421,417,3,4,"PCPE",0
3,"3093",19683,14633,14484,70,149,"PCPE",21
16,"16008",89,69,69,0,0,"PCPE",0
24,"24099",171,132,132,0,0,"PCPE",0
1,"1034",161,124,123,1,1,"PCPE",0
47,"47017",201,158,153,1,5,"PCPE",0
44,"44074",429,333,326,4,7,"PCPE",0
50,"50037",136,98,96,0,2,"PCPE",0
42,"42007",113,86,86,5,0,"PCPE",0
40,"40071",43,39,38,1,1,"PCPE",0
47,"47207",278,215,212,3,3,"PCPE",0
18,"18121",129,98,98,1,0,"PCPE",1
22,"22085",104,86,86,0,0,"PCPE",0
40,"40099",52,44,42,0,2,"PCPE",0
16,"16203",9972,7094,7007,34,87,"PCPE",12
18,"18903",889,669,661,5,8,"PCPE",1
2,"2009",19660,14256,14116,127,140,"PCPE",14
16,"16901",675,506,501,6,5,"PCPE",1
39,"39039",568,382,379,0,3,"PCPE",0
30,"30038",15411,10847,10767,46,80,"PCPE",7
2,"2059",302,234,232,1,2,"PCPE",0
33,"33020",13307,9011,8914,99,97,"PCPE",31
45,"45195",2141,1635,1606,7,29,"PCPE",2
44,"44008",1613,1163,1153,6,10,"PCPE",0
47,"47045",763,575,567,1,8,"PCPE",2
34,"34067",127,93,93,1,0,"PCPE",0
50,"50048",34,29,29,0,0,"PCPE",0
44,"44193",78,54,54,1,0,"PCPE",0
26,"26095",100,83,82,0,1,"PCPE",0
37,"37310",178,123,123,1,0,"PCPE",0
1,"1023",267,187,186,1,1,"PCPE",1
47,"47155",3228,2277,2254,18,23,"PCPE",5
26,"26131",35,33,33,1,0,"PCPE",0
37,"37380",56,47,45,0,2,"PCPE",0
30,"30043",24967,18981,18685,101,296,"PCPE",22
16,"16016",224,171,168,0,3,"PCPE",1
44,"44020",24,20,19,1,1,"PCPE",0
20,"20046",1223,739,737,5,2,"PCPE",1
37,"37324",360,276,275,2,1,"PCPE",1
44,"44168",189,139,138,2,1,"PCPE",0
37,"37228",360,297,295,2,2,"PCPE",0
37,"37022",268,215,215,2,0,"PCPE",1
37,"37375",700,578,570,4,8,"PCPE",1
24,"24059",880,536,535,4,1,"PCPE",0
28,"28056",863,630,617,4,13,"PCPE",1
47,"47064",33,28,25,0,3,"PCPE",0
20,"20024",386,210,209,3,1,"PCPE",1
37,"37270",189,152,151,2,1,"PCPE",3
50,"50178",293,190,187,0,3,"PCPE",2
9,"9060",145,114,113,2,1,"PCPE",0
46,"46252",118,99,98,0,1,"PCPE",0
39,"39086",358,256,253,0,3,"PCPE",0
39,"39025",8637,6486,6378,47,108,"PCPE",9
9,"9416",53,35,35,0,0,"PCPE",0
9,"9277",120,101,99,0,2,"PCPE",0
47,"47191",108,79,79,0,0,"PCPE",0
40,"40104",265,198,195,0,3,"PCPE",0
16,"16005",255,180,178,2,2,"PCPE",0
46,"46246",1058,835,823,5,12,"PCPE",1
11,"11003",1261,836,822,7,14,"PCPE",0
37,"37328",186,135,131,1,4,"PCPE",0
1,"1055",838,538,527,8,11,"PCPE",0
45,"45009",524,344,341,2,3,"PCPE",0
47,"47200",85,66,66,0,0,"PCPE",0
47,"47065",857,674,669,1,5,"PCPE",0
24,"24027",1211,863,847,8,16,"PCPE",3
16,"16212",247,203,202,0,1,"PCPE",1
9,"9375",36,31,31,0,0,"PCPE",0
28,"28011",442,317,316,1,1,"PCPE",0
42,"42050",31,18,18,0,0,"PCPE",0
9,"9224",162,131,131,1,0,"PCPE",1
22,"22080",280,197,194,6,3,"PCPE",0
2,"2083",219,191,191,0,0,"PCPE",0
33,"33004",66857,46390,45960,426,430,"PCPE",124
18,"18023",15655,10879,10774,82,105,"PCPE",18
26,"26088",37,32,31,0,1,"PCPE",0
40,"40177",153,125,125,1,0,"PCPE",0
40,"40106",201,158,158,2,0,"PCPE",0
22,"22906",186,141,139,3,2,"PCPE",1
4,"4015",124,96,96,2,0,"PCPE",0
37,"37106",258,165,162,0,3,"PCPE",0
4,"4053",12320,8946,8866,70,80,"PCPE",4
33,"33035",11284,7681,7618,70,63,"PCPE",7
40,"40150",69,61,61,1,0,"PCPE",0
37,"37057",215,172,171,1,1,"PCPE",0
40,"40107",100,73,73,1,0,"PCPE",0
24,"24197",763,538,533,1,5,"PCPE",3
40,"40151",46,33,33,0,0,"PCPE",0
37,"37345",163,128,128,3,0,"PCPE",1
18,"18069",502,362,357,0,5,"PCPE",0
18,"18193",14343,9951,9847,93,104,"PCPE",18
42,"42115",61,47,47,1,0,"PCPE",0
30,"30027",48176,35521,35266,153,255,"PCPE",32
44,"44231",38,33,33,0,0,"PCPE",0
24,"24143",510,358,349,0,9,"PCPE",0
29,"29100",2433,1684,1667,5,17,"PCPE",0
14,"14022",4006,2977,2949,17,28,"PCPE",5
44,"44165",175,135,133,2,2,"PCPE",0
18,"18163",324,235,233,2,2,"PCPE",0
9,"9410",3040,2117,2095,16,22,"PCPE",6
48,"48029",8338,5721,5683,37,38,"PCPE",1
37,"37262",78,64,63,0,1,"PCPE",0
9,"9154",137,98,97,2,1,"PCPE",0
24,"24107",236,175,173,0,2,"PCPE",0
39,"39030",1895,1225,1212,10,13,"PCPE",0
3,"3102",7229,5492,5414,52,78,"PCPE",8
18,"18070",288,227,226,0,1,"PCPE",1
37,"37109",183,129,127,0,2,"PCPE",0
14,"14023",2021,1660,1639,8,21,"PCPE",0
22,"22214",128,106,105,3,1,"PCPE",0
22,"22909",315,226,225,4,1,"PCPE",0
9,"9270",163,115,115,0,0,"PCPE",0
16,"16026",82,62,61,2,1,"PCPE",0
18,"18028",928,765,758,2,7,"PCPE",1
28,"28071",60,55,53,1,2,"PCPE",0
3,"3051",348,296,294,0,2,"PCPE",0
49,"49269",229,165,162,1,3,"PCPE",1
45,"45081",17875,12656,12533,82,123,"PCPE",10
37,"37334",76,48,48,1,0,"PCPE",0
39,"39027",3118,2322,2295,26,27,"PCPE",3
26,"26025",87,71,70,1,1,"PCPE",0
18,"18120",264,209,208,1,1,"PCPE",0
50,"50247",823,588,581,3,7,"PCPE",1
40,"40013",62,49,48,0,1,"PCPE",0
30,"30030",312993,231648,230185,1207,1463,"PCPE",221
26,"26003",413,331,329,2,2,"PCPE",0
18,"18167",1895,1258,1250,4,8,"PCPE",1
41,"41064",5596,3517,3456,55,61,"PCPE",0
2,"2075",1670,1321,1304,4,17,"PCPE",1
47,"47144",78,64,64,1,0,"PCPE",0
50,"50059",769,549,544,8,5,"PCPE",0
47,"47135",83,72,72,2,0,"PCPE",0
41,"41021",21294,13762,13570,145,192,"PCPE",22
9,"9384",295,211,206,0,5,"PCPE",1
29,"29047",1117,885,866,1,19,"PCPE",2
23,"23042",292,217,213,1,4,"PCPE",0
9,"9425",517,384,378,0,6,"PCPE",0
46,"46104",1940,1504,1487,7,17,"PCPE",1
29,"29048",1405,1121,1110,8,11,"PCPE",1
3,"3073",236,200,199,1,1,"PCPE",0
42,"42105",50,45,45,0,0,"PCPE",0
34,"34129",179,130,129,1,1,"PCPE",1
11,"11902",3629,2275,2252,25,23,"PCPE",4
26,"26005",2381,1598,1577,23,21,"PCPE",0
14,"14017",10868,7764,7665,71,99,"PCPE",5
37,"37364",820,607,598,6,9,"PCPE",0
23,"23044",4816,3663,3569,27,94,"PCPE",12
21,"21028",375,277,271,2,6,"PCPE",0
50,"50124",415,318,317,2,1,"PCPE",1
26,"26107",94,77,77,2,0,"PCPE",0
49,"49149",390,273,268,3,5,"PCPE",0
28,"28123",57078,45270,44992,215,278,"PCPE",36
37,"37296",336,259,254,2,5,"PCPE",0
26,"26168",5340,3774,3717,22,57,"PCPE",12
44,"44158",1180,876,862,10,14,"PCPE",1
4,"4014",144,117,114,1,3,"PCPE",0
2,"2065",476,394,392,1,2,"PCPE",0
21,"21043",1871,1310,1285,9,25,"PCPE",1
44,"44264",248,191,189,1,2,"PCPE",0
37,"37241",168,131,131,1,0,"PCPE",0
29,"29017",6553,4744,4668,33,76,"PCPE",7
44,"44194",109,78,73,3,5,"PCPE",1
49,"49176",667,433,431,1,2,"PCPE",0
21,"21044",17591,10679,10558,118,121,"PCPE",12
46,"46010",935,729,723,4,6,"PCPE",1
2,"2053",2998,2231,2189,16,42,"PCPE",7
34,"34163",45,38,38,0,0,"PCPE",0
47,"47138",241,170,164,1,6,"PCPE",0
46,"46184",26505,20428,20223,115,205,"PCPE",24
2,"2026",836,690,679,3,11,"PCPE",0
28,"28106",76907,52773,52265,385,508,"PCPE",88
23,"23006",4660,3687,3647,24,40,"PCPE",1
28,"28115",60892,49705,49510,209,195,"PCPE",11
44,"44173",101,81,79,2,2,"PCPE",0
41,"41069",29138,18991,18683,341,308,"PCPE",41
16,"16063",97,85,84,1,1,"PCPE",0
1,"1013",712,454,450,0,4,"PCPE",0
26,"26041",132,92,91,0,1,"PCPE",0
49,"49030",86,69,69,0,0,"PCPE",0
9,"9345",123,93,91,2,2,"PCPE",0
18,"18144",781,567,558,4,9,"PCPE",1
39,"39016",23868,17883,17701,122,182,"PCPE",25
18,"18049",595,459,452,3,7,"PCPE",1
40,"40189",512,401,392,2,9,"PCPE",0
9,"9236",38,32,32,0,0,"PCPE",0
37,"37355",178,142,142,1,0,"PCPE",0
49,"49191",272,213,206,2,7,"PCPE",0
14,"14029",4178,3047,3009,28,38,"PCPE",2
21,"21073",1862,1125,1109,8,16,"PCPE",0
44,"44066",108,79,74,0,5,"PCPE",0
26,"26075",329,267,264,2,3,"PCPE",0
40,"40161",36,28,28,2,0,"PCPE",0
18,"18176",250,191,189,2,2,"PCPE",0
47,"47040",64,53,53,0,0,"PCPE",0
26,"26043",365,292,281,1,11,"PCPE",0
46,"46134",2357,1725,1712,14,13,"PCPE",2
9,"9024",156,112,110,1,2,"PCPE",0
39,"39007",417,278,275,2,3,"PCPE",0
46,"46212",1620,1150,1124,9,26,"PCPE",0
48,"48911",380,276,272,1,4,"PCPE",0
24,"24153",232,179,177,2,2,"PCPE",0
3,"3111",5436,3918,3883,18,35,"PCPE",3
50,"50192",236,180,180,2,0,"PCPE",0
3,"3079",18224,13904,13709,80,195,"PCPE",61
41,"41094",6288,4497,4449,38,48,"PCPE",3
49,"49078",170,141,140,1,1,"PCPE",0
47,"47113",159,129,128,0,1,"PCPE",0
37,"37331",212,137,135,0,2,"PCPE",0
40,"40136",112,88,87,0,1,"PCPE",0
50,"50151",636,499,499,0,0,"PCPE",0
4,"4054",358,285,281,2,4,"PCPE",0
41,"41028",2003,1524,1511,9,13,"PCPE",2
30,"30037",18793,13150,13003,47,147,"PCPE",11
50,"50003",128,92,91,1,1,"PCPE",0
22,"22111",154,103,102,0,1,"PCPE",0
47,"47194",298,239,237,2,2,"PCPE",1
9,"9255",89,63,62,0,1,"PCPE",0
18,"18040",231,136,133,0,3,"PCPE",0
45,"45012",661,510,503,6,7,"PCPE",0
28,"28051",1541,1163,1149,1,14,"PCPE",4
47,"47205",384,266,260,0,6,"PCPE",0
44,"44177",115,84,84,1,0,"PCPE",0
46,"46240",210,164,161,1,3,"PCPE",0
26,"26151",448,370,368,1,2,"PCPE",0
37,"37333",224,142,142,1,0,"PCPE",0
9,"9434",1227,922,909,6,13,"PCPE",1
34,"34091",123,94,93,3,1,"PCPE",0
46,"46032",5653,4402,4361,33,41,"PCPE",4
48,"48050",191,147,146,0,1,"PCPE",0
9,"9437",282,219,218,3,1,"PCPE",0
37,"37249",43,29,29,0,0,"PCPE",0
37,"37124",212,146,144,1,2,"PCPE",0
40,"40039",210,156,153,3,3,"PCPE",0
45,"45147",581,450,446,1,4,"PCPE",0
14,"14061",744,595,582,1,13,"PCPE",1
33,"33018",2901,2000,1976,18,24,"PCPE",3
24,"24109",977,633,624,3,9,"PCPE",1
45,"45014",4010,2646,2616,22,30,"PCPE",5
50,"50257",171,134,134,2,0,"PCPE",0
4,"4077",295,263,261,2,2,"PCPE",0
4,"4033",135,97,93,1,4,"PCPE",0
9,"9257",93,81,80,4,1,"PCPE",1
45,"45070",1427,1147,1142,1,5,"PCPE",4
28,"28151",3142,2235,2199,8,36,"PCPE",0
37,"37251",124,93,92,1,1,"PCPE",0
1,"1061",154,127,127,1,0,"PCPE",0
46,"46008",2651,2108,2089,21,19,"PCPE",3
34,"34093",85,70,70,0,0,"PCPE",0
20,"20906",119,87,87,1,0,"PCPE",0
9,"9018",24668,17575,17369,111,206,"PCPE",22
42,"42134",2627,1927,1890,19,37,"PCPE",0
37,"37279",750,522,513,4,9,"PCPE",1
18,"18044",181,107,107,0,0,"PCPE",0
29,"29025",39665,25907,25714,192,193,"PCPE",18
11,"11032",53874,31273,31008,348,265,"PCPE",59
20,"20055",17475,11073,10997,56,76,"PCPE",5
4,"4003",17357,11157,11075,64,82,"PCPE",3
45,"45083",472,368,365,0,3,"PCPE",1
28,"28091",5440,3596,3558,24,38,"PCPE",5
16,"16169",58,37,37,3,0,"PCPE",0
18,"18170",330,219,217,0,2,"PCPE",0
16,"16030",24,19,19,0,0,"PCPE",0
30,"30021",9099,6095,6045,20,50,"PCPE",4
22,"22230",284,216,216,1,0,"PCPE",0
3,"3084",539,454,446,3,8,"PCPE",0
24,"24159",1806,1386,1366,6,20,"PCPE",0
47,"47145",603,448,441,3,7,"PCPE",1
14,"14008",2839,1905,1895,19,10,"PCPE",1
18,"18004",714,518,509,2,9,"PCPE",1
49,"49004",126,100,100,4,0,"PCPE",0
44,"44216",26555,18997,18737,168,260,"PCPE",13
24,"24227",1607,1127,1116,22,11,"PCPE",0
22,"22052",925,712,710,8,2,"PCPE",0
46,"46062",4631,3511,3474,27,37,"PCPE",1
9,"9355",98,75,75,0,0,"PCPE",0
37,"37339",315,251,251,4,0,"PCPE",0
2,"2052",459,372,369,4,3,"PCPE",0
18,"18034",505,366,364,1,2,"PCPE",1
44,"44009",809,596,593,7,3,"PCPE",0
26,"26120",1454,1139,1126,7,13,"PCPE",1
40,"40074",255,222,219,2,3,"PCPE",1
26,"26180",221,173,172,0,1,"PCPE",1
33,"33031",35120,22295,22024,271,271,"PCPE",86
22,"22042",117,95,92,0,3,"PCPE",0
42,"42078",1020,717,703,7,14,"PCPE",1
37,"37283",123,92,90,0,2,"PCPE",1
45,"45152",587,458,451,0,7,"PCPE",3
9,"9131",462,365,364,2,1,"PCPE",0
33,"33052",721,485,482,3,3,"PCPE",2
47,"47227",61,50,50,0,0,"PCPE",0
11,"11002",4273,2835,2815,16,20,"PCPE",2
24,"24229",418,322,319,2,3,"PCPE",0
9,"9443",179,128,124,0,4,"PCPE",0
3,"3119",16636,12281,12194,57,87,"PCPE",23
29,"29018",2010,1472,1420,9,52,"PCPE",1
14,"14075",572,448,428,1,20,"PCPE",0
3,"3036",87,81,78,0,3,"PCPE",0
29,"29086",793,470,470,3,0,"PCPE",1
50,"50041",12,9,9,0,0,"PCPE",0
34,"34180",66,55,55,1,0,"PCPE",0
46,"46081",10134,7771,7702,41,69,"PCPE",6
26,"26064",2275,1659,1638,17,21,"PCPE",6
47,"47140",115,102,102,1,0,"PCPE",0
44,"44107",218,152,152,5,0,"PCPE",0
40,"40033",58,51,51,0,0,"PCPE",0
44,"44117",340,271,268,4,3,"PCPE",0
9,"9048",1467,1048,1033,13,15,"PCPE",5
16,"16098",561,456,454,3,2,"PCPE",1
9,"9360",30,23,23,0,0,"PCPE",0
47,"47229",210,148,147,1,1,"PCPE",0
16,"16194",242,185,179,1,6,"PCPE",0
22,"22249",116,95,95,4,0,"PCPE",0
37,"37189",121,88,88,0,0,"PCPE",0
33,"33054",1682,1159,1149,12,10,"PCPE",2
26,"26124",807,649,639,7,10,"PCPE",0
39,"39068",646,450,445,2,5,"PCPE",0
21,"21007",6225,4080,3999,52,81,"PCPE",6
21,"21006",3368,2182,2146,13,36,"PCPE",0
45,"45121",6796,4743,4692,22,51,"PCPE",2
4,"4041",322,240,238,6,2,"PCPE",0
18,"18100",7807,5452,5398,50,54,"PCPE",9
37,"37259",44,28,28,0,0,"PCPE",0
39,"39048",1716,1329,1312,12,17,"PCPE",1
28,"28096",18354,13310,13205,68,105,"PCPE",9
49,"49009",393,293,288,2,5,"PCPE",0
48,"48028",717,543,537,3,6,"PCPE",0
50,"50013",219,180,180,0,0,"PCPE",0
49,"49091",260,193,193,0,0,"PCPE",0
4,"4043",549,465,461,1,4,"PCPE",0
37,"37260",150,116,116,1,0,"PCPE",0
44,"44059",544,425,412,9,13,"PCPE",1
37,"37261",221,163,160,1,3,"PCPE",0
45,"45123",3081,2144,2131,11,13,"PCPE",1
18,"18101",9265,6618,6560,59,58,"PCPE",8
22,"22251",364,284,284,0,0,"PCPE",0
29,"29089",3228,2377,2321,10,56,"PCPE",26
33,"33026",8530,5397,5337,48,60,"PCPE",15
47,"47041",150,112,110,2,2,"PCPE",0
16,"16258",194,150,150,1,0,"PCPE",0
50,"50295",48,43,42,0,1,"PCPE",0
24,"24053",442,286,280,1,6,"PCPE",2
18,"18102",8400,5592,5504,44,88,"PCPE",9
44,"44222",131,98,98,0,0,"PCPE",0
47,"47068",34,26,26,0,0,"PCPE",0
42,"42176",29,25,25,0,0,"PCPE",0
9,"9227",119,91,89,4,2,"PCPE",0
2,"2006",579,464,458,3,6,"PCPE",0
39,"39050",270,187,186,0,1,"PCPE",1
41,"41052",3013,2116,2064,14,52,"PCPE",1
21,"21051",239,174,170,1,4,"PCPE",0
9,"9447",44,41,41,0,0,"PCPE",0
40,"40053",83,66,65,0,1,"PCPE",0
18,"18103",757,579,575,4,4,"PCPE",0
37,"37138",203,149,148,2,1,"PCPE",0
18,"18180",633,410,410,3,0,"PCPE",1
28,"28034",361,274,269,1,5,"PCPE",0
9,"9228",160,137,136,1,1,"PCPE",0
9,"9125",584,432,430,1,2,"PCPE",0
22,"22215",128,96,96,1,0,"PCPE",0
22,"22084",535,403,399,4,4,"PCPE",0
2,"2007",1030,824,818,4,6,"PCPE",0
47,"47153",108,77,77,0,0,"PCPE",0
46,"46042",3380,2799,2755,20,44,"PCPE",0
24,"24066",494,368,366,4,2,"PCPE",0
46,"46016",1061,870,856,5,14,"PCPE",0
49,"49095",291,221,220,0,1,"PCPE",0
50,"50068",1982,1348,1335,8,13,"PCPE",1
26,"26106",86,72,72,0,0,"PCPE",0
42,"42119",158,100,99,3,1,"PCPE",1
9,"9098",507,369,362,5,7,"PCPE",0
30,"30020",6303,4543,4497,25,46,"PCPE",3
24,"24133",356,257,257,1,0,"PCPE",0
37,"37140",674,443,439,5,4,"PCPE",2
48,"48002",7829,5490,5451,44,39,"PCPE",3
2,"2036",95,78,78,0,0,"PCPE",0
24,"24169",2969,2140,2118,13,22,"PCPE",7
46,"46226",41,36,35,0,1,"PCPE",0
37,"37020",430,326,321,1,5,"PCPE",0
37,"37338",79,65,64,0,1,"PCPE",0
16,"16266",368,264,259,1,5,"PCPE",0
40,"40015",28,26,26,1,0,"PCPE",0
11,"11011",1716,1195,1165,12,30,"PCPE",0
37,"37049",137,96,96,1,0,"PCPE",0
39,"39053",219,153,152,2,1,"PCPE",0
44,"44226",140,98,98,2,0,"PCPE",0
42,"42045",301,206,197,2,9,"PCPE",0
14,"14045",3052,2362,2335,11,27,"PCPE",4
44,"44181",76,57,56,0,1,"PCPE",0
16,"16002",187,158,158,1,0,"PCPE",0
1,"1039",209,155,153,0,2,"PCPE",1
50,"50019",55,41,41,0,0,"PCPE",0
48,"48064",606,447,445,4,2,"PCPE",0
34,"34037",302,218,216,1,2,"PCPE",0
18,"18047",5903,3893,3857,28,36,"PCPE",6
3,"3004",581,438,437,2,1,"PCPE",1
37,"37268",112,76,76,0,0,"PCPE",0
37,"37269",447,326,324,1,2,"PCPE",0
21,"21056",2895,1990,1906,18,84,"PCPE",0
42,"42048",66,51,51,0,0,"PCPE",0
21,"21057",1041,661,657,12,4,"PCPE",2
50,"50040",89,75,75,0,0,"PCPE",0
37,"37340",151,106,106,1,0,"PCPE",0
44,"44265",186,141,138,2,3,"PCPE",0
39,"39085",6836,5086,5032,44,54,"PCPE",3
50,"50051",816,616,614,2,2,"PCPE",0
40,"40018",91,72,72,1,0,"PCPE",0
47,"47156",162,136,133,0,3,"PCPE",0
22,"22088",153,110,110,2,0,"PCPE",0
20,"20036",13210,8518,8475,67,43,"PCPE",6
42,"42049",116,81,81,1,0,"PCPE",0
34,"34232",750,578,564,7,14,"PCPE",2
18,"18082",861,616,611,5,5,"PCPE",1
40,"40230",94,68,66,0,2,"PCPE",0
24,"24005",378,260,257,2,3,"PCPE",0
24,"24094",1385,983,968,11,15,"PCPE",1
40,"40006",22,18,18,0,0,"PCPE",0
28,"28116",704,528,523,2,5,"PCPE",0
28,"28001",61,46,45,0,1,"PCPE",0
24,"24162",1683,1257,1246,13,11,"PCPE",1
34,"34057",471,339,338,1,1,"PCPE",0
16,"16273",321,242,236,3,6,"PCPE",0
14,"14048",1207,884,869,13,15,"PCPE",2
4,"4082",297,200,200,0,0,"PCPE",0
39,"39057",2330,1671,1645,7,26,"PCPE",6
37,"37055",123,98,94,0,4,"PCPE",0
50,"50180",119,99,99,2,0,"PCPE",0
46,"46073",1092,888,884,6,4,"PCPE",0
40,"40176",395,306,305,2,1,"PCPE",1
24,"24105",1459,1042,1025,16,17,"PCPE",0
40,"40231",108,90,89,0,1,"PCPE",0
46,"46117",495,402,399,5,3,"PCPE",0
46,"46151",728,550,541,0,9,"PCPE",0
48,"48068",1550,1130,1118,12,12,"PCPE",1
9,"9419",78,55,55,0,0,"PCPE",0
47,"47076",17399,13097,12972,92,125,"PCPE",13
22,"22094",101,74,74,1,0,"PCPE",0
9,"9330",1507,1108,1092,10,16,"PCPE",2
46,"46204",6681,5256,5202,32,54,"PCPE",2
44,"44024",27,25,25,0,0,"PCPE",0
50,"50243",331,250,246,0,4,"PCPE",1
24,"24074",97,75,75,1,0,"PCPE",0
47,"47103",267,197,192,5,5,"PCPE",0
16,"16255",140,122,121,0,1,"PCPE",0
16,"16068",137,98,97,1,1,"PCPE",0
46,"46248",4897,3596,3544,18,52,"PCPE",1
37,"37014",1155,817,808,7,9,"PCPE",0
49,"49266",76,63,61,2,2,"PCPE",0
1,"1003",1190,782,774,2,8,"PCPE",0
22,"22226",767,570,562,10,8,"PCPE",0
42,"42148",10,10,10,1,0,"PCPE",0
37,"37191",114,78,75,1,3,"PCPE",0
26,"26033",170,132,129,1,3,"PCPE",1
21,"21063",2615,2001,1957,22,44,"PCPE",1
45,"45001",1835,1281,1251,3,30,"PCPE",3
2,"2085",322,253,252,2,1,"PCPE",0
21,"21064",6522,4227,4146,48,81,"PCPE",2
49,"49105",150,109,108,0,1,"PCPE",0
24,"24175",1832,1314,1297,14,17,"PCPE",1
34,"34123",1648,1287,1258,12,29,"PCPE",1
42,"42191",185,136,133,0,3,"PCPE",0
26,"26034",654,497,489,1,8,"PCPE",0
44,"44232",378,284,276,6,8,"PCPE",0
24,"24076",1277,956,947,4,9,"PCPE",1
47,"47025",120,94,94,1,0,"PCPE",0
26,"26175",51,41,41,0,0,"PCPE",0
37,"37319",114,78,74,0,4,"PCPE",0
21,"21024",492,338,326,6,12,"PCPE",1
29,"29046",2675,1825,1807,14,18,"PCPE",0
44,"44060",41,32,32,0,0,"PCPE",0
9,"9155",27,20,20,0,0,"PCPE",0
46,"46024",413,314,313,2,1,"PCPE",1
50,"50121",277,216,214,1,2,"PCPE",0
41,"41041",9706,7239,7120,36,119,"PCPE",4
34,"34157",2442,1792,1768,21,24,"PCPE",3
47,"47196",34,27,27,0,0,"PCPE",0
11,"11020",165378,109810,108830,1188,980,"PCPE",133
16,"16279",203,128,127,1,1,"PCPE",0
45,"45137",1604,1032,1024,4,8,"PCPE",0
33,"33068",1093,645,641,4,4,"PCPE",3
40,"40195",885,672,669,1,3,"PCPE",0
46,"46904",792,610,603,8,7,"PCPE",2
37,"37321",168,132,132,2,0,"PCPE",0
45,"45170",228,176,167,0,9,"PCPE",0
46,"46190",48947,35638,35419,211,219,"PCPE",50
26,"26118",59,48,48,2,0,"PCPE",0
24,"24202",8008,5367,5276,53,91,"PCPE",25
40,"40904",357,308,306,3,2,"PCPE",0
24,"24044",168,119,118,1,1,"PCPE",0
42,"42057",164,104,104,2,0,"PCPE",0
37,"37155",65,57,57,0,0,"PCPE",0
48,"48012",2049,1527,1512,7,15,"PCPE",0
3,"3042",1393,1010,996,7,14,"PCPE",2
26,"26142",787,612,606,3,6,"PCPE",0
44,"44236",63,48,47,0,1,"PCPE",0
33,"33070",3351,2403,2373,26,30,"PCPE",2
44,"44103",132,102,102,1,0,"PCPE",0
50,"50289",51,38,38,0,0,"PCPE",0
1,"1052",245,184,181,0,3,"PCPE",0
46,"46208",1112,887,881,4,6,"PCPE",0
3,"3043",2911,2431,2399,13,32,"PCPE",4
28,"28171",4239,2848,2820,19,28,"PCPE",1
9,"9339",128,110,110,0,0,"PCPE",0
37,"37281",36,33,31,0,2,"PCPE",0
45,"45172",689,530,522,2,8,"PCPE",0
9,"9472",55,45,44,0,1,"PCPE",0
40,"40072",211,162,159,1,3,"PCPE",0
3,"3065",167284,123032,122305,711,727,"PCPE",196
46,"46166",8155,6320,6251,30,69,"PCPE",7
47,"47198",69,50,50,0,0,"PCPE",0
3,"3044",4521,3510,3465,21,45,"PCPE",5
46,"46036",564,383,378,5,5,"PCPE",0
48,"48095",2347,1555,1546,12,9,"PCPE",0
46,"46209",1933,1445,1415,5,30,"PCPE",0
21,"21069",1702,1167,1149,6,18,"PCPE",2
22,"22193",276,225,224,2,1,"PCPE",1
39,"39095",2266,1760,1726,14,34,"PCPE",1
9,"9206",59,45,45,0,0,"PCPE",0
9,"9117",76,60,60,0,0,"PCPE",0
24,"24171",356,197,196,0,1,"PCPE",0
2,"2012",1835,1476,1453,7,23,"PCPE",0
46,"46236",972,818,809,2,9,"PCPE",1
9,"9343",93,66,65,0,1,"PCPE",0
46,"46054",11293,8477,8409,47,68,"PCPE",13
18,"18079",3441,2442,2411,16,31,"PCPE",13
22,"22028",371,282,280,3,2,"PCPE",0
1,"1054",960,654,651,4,3,"PCPE",0
4,"4091",334,268,267,6,1,"PCPE",0
37,"37199",142,105,105,1,0,"PCPE",0
41,"41002",1473,1038,1014,9,24,"PCPE",0
37,"37010",939,708,702,0,6,"PCPE",1
34,"34070",154,123,123,2,0,"PCPE",1
46,"46133",533,415,410,6,5,"PCPE",0
44,"44239",22,20,20,0,0,"PCPE",0
39,"39066",872,667,661,4,6,"PCPE",2
34,"34131",59,52,51,0,1,"PCPE",0
22,"22208",188,150,145,0,5,"PCPE",1
9,"9279",174,131,130,3,1,"PCPE",0
44,"44161",443,314,313,2,1,"PCPE",0
42,"42012",35,28,28,0,0,"PCPE",1
28,"28020",145,94,94,0,0,"PCPE",0
22,"22235",98,76,76,1,0,"PCPE",0
26,"26042",834,635,625,5,10,"PCPE",0
26,"26147",30,28,27,0,1,"PCPE",0
37,"37285",403,310,308,2,2,"PCPE",0
42,"42024",86,61,59,0,2,"PCPE",0
42,"42159",37,29,29,0,0,"PCPE",0
49,"49192",130,110,109,2,1,"PCPE",0
47,"47192",102,83,81,1,2,"PCPE",0
2,"2070",403,332,328,4,4,"PCPE",0
16,"16130",571,450,448,1,2,"PCPE",0
34,"34182",786,606,597,10,9,"PCPE",0
9,"9211",1441,1056,1039,9,17,"PCPE",0
28,"28049",58480,45136,44820,242,316,"PCPE",70
9,"9167",58,41,41,1,0,"PCPE",1
50,"50064",437,342,339,0,3,"PCPE",0
47,"47085",16612,11829,11706,114,123,"PCPE",12
14,"14058",7970,5491,5417,66,74,"PCPE",6
1,"1057",240,201,200,1,1,"PCPE",0
39,"39038",1452,997,990,8,7,"PCPE",4
28,"28022",33479,27129,27037,133,92,"PCPE",14
18,"18132",3291,2524,2494,9,30,"PCPE",11
21,"21075",349,275,270,4,5,"PCPE",0
42,"42204",54,38,38,1,0,"PCPE",0
44,"44070",53,48,48,0,0,"PCPE",0
44,"44164",27,23,23,0,0,"PCPE",0
26,"26089",110582,82972,82186,588,786,"PCPE",148
50,"50096",39,27,27,0,0,"PCPE",0
47,"47222",83,64,64,1,0,"PCPE",1
41,"41006",2740,1782,1768,14,14,"PCPE",1
48,"48079",427,305,304,2,1,"PCPE",0
34,"34135",399,293,289,0,4,"PCPE",0
3,"3049",12088,9121,9027,52,94,"PCPE",8
24,"24185",474,357,350,3,7,"PCPE",0
45,"45146",107,84,83,0,1,"PCPE",0
37,"37332",68,51,50,0,1,"PCPE",1
2,"2032",276,207,202,1,5,"PCPE",0
34,"34089",155,124,124,2,0,"PCPE",0
24,"24054",430,314,313,1,1,"PCPE",0
46,"46110",21228,15563,15443,86,120,"PCPE",20
50,"50098",174,130,124,0,6,"PCPE",1
44,"44144",346,248,245,2,3,"PCPE",0
44,"44244",75,47,47,1,0,"PCPE",0
49,"49241",248,177,177,0,0,"PCPE",0
26,"26150",112,101,95,0,6,"PCPE",0
34,"34137",27,23,22,0,1,"PCPE",0
39,"39070",144,96,94,2,2,"PCPE",1
48,"48020",273626,184710,183628,1185,1082,"PCPE",126
9,"9901",371,263,259,4,4,"PCPE",1
9,"9078",41,30,30,1,0,"PCPE",0
34,"34189",56,44,44,1,0,"PCPE",0
47,"47087",381,301,297,3,4,"PCPE",0
26,"26152",33,28,28,1,0,"PCPE",0
46,"46059",1261,1035,1019,9,16,"PCPE",2
50,"50164",390,247,246,6,1,"PCPE",0
9,"9056",4919,3395,3344,20,51,"PCPE",12
1,"1020",327,237,234,3,3,"PCPE",0
40,"40208",766,596,589,3,7,"PCPE",1
11,"11031",76455,49854,49405,535,449,"PCPE",51
28,"28025",420,320,315,4,5,"PCPE",0
34,"34139",166,107,106,1,1,"PCPE",0
24,"24089",102747,74428,73688,631,740,"PCPE",110
29,"29058",1450,911,894,4,17,"PCPE",2
49,"49243",111,94,93,0,1,"PCPE",0
39,"39072",344,198,196,2,2,"PCPE",0
16,"16225",73,57,57,3,0,"PCPE",0
22,"22061",6630,4555,4526,40,29,"PCPE",6
40,"40041",979,725,717,5,8,"PCPE",0
22,"22245",309,267,261,1,6,"PCPE",0
9,"9439",1028,752,744,9,8,"PCPE",3
44,"44007",173,122,121,4,1,"PCPE",0
18,"18002",553,395,393,1,2,"PCPE",1
16,"16246",482,361,355,3,6,"PCPE",0
28,"28180",5251,3927,3893,7,34,"PCPE",1
50,"50258",54,34,34,0,0,"PCPE",0
24,"24090",343,235,233,1,2,"PCPE",0
9,"9100",59,45,44,0,1,"PCPE",0
21,"21054",8100,5656,5571,46,85,"PCPE",5
16,"16123",82,61,61,3,0,"PCPE",0
50,"50008",5097,3457,3417,31,40,"PCPE",3
37,"37253",135,109,109,2,0,"PCPE",0
48,"48023",600,455,452,0,3,"PCPE",0
9,"9083",37,33,33,0,0,"PCPE",0
44,"44249",55,44,44,2,0,"PCPE",0
44,"44148",90,75,73,2,2,"PCPE",0
14,"14036",3740,2747,2696,24,51,"PCPE",1
46,"46009",3121,2459,2427,8,32,"PCPE",4
42,"42075",83,62,62,0,0,"PCPE",0
39,"39074",6902,5113,5039,40,74,"PCPE",1
44,"44125",61,44,44,0,0,"PCPE",0
16,"16109",44,38,38,1,0,"PCPE",0
47,"47118",168,127,127,2,0,"PCPE",0
22,"22087",67,45,45,2,0,"PCPE",0
42,"42155",167,103,102,1,1,"PCPE",0
9,"9441",74,65,65,0,0,"PCPE",0
46,"46192",761,576,570,5,6,"PCPE",0
28,"28154",5408,3806,3767,16,39,"PCPE",3
40,"40213",86,65,65,3,0,"PCPE",0
24,"24228",660,430,422,6,8,"PCPE",0
23,"23058",8678,6532,6461,37,71,"PCPE",4
37,"37256",218,156,152,1,4,"PCPE",0
30,"30013",7396,5147,5102,32,45,"PCPE",2
3,"3024",3901,3067,3024,11,43,"PCPE",5
29,"29085",144,109,108,0,1,"PCPE",0
42,"42171",127,80,79,0,1,"PCPE",0
24,"24193",378,268,265,2,3,"PCPE",1
41,"41079",9294,6670,6580,51,90,"PCPE",7
49,"49247",443,283,279,2,4,"PCPE",0
40,"40046",89,75,75,1,0,"PCPE",0
16,"16249",1995,1519,1499,6,20,"PCPE",1
4,"4101",4266,2909,2876,26,33,"PCPE",3
41,"41036",3941,2674,2642,23,32,"PCPE",0
42,"42062",22,12,12,0,0,"PCPE",0
44,"44082",89,78,77,0,1,"PCPE",0
4,"4102",13694,8944,8865,50,79,"PCPE",10
34,"34056",1998,1452,1444,13,8,"PCPE",3
45,"45120",129,104,104,1,0,"PCPE",0
11,"11025",4398,2899,2848,51,51,"PCPE",12
39,"39097",697,371,368,2,3,"PCPE",0
4,"4092",2838,2127,2103,10,24,"PCPE",3
23,"23087",11292,8222,8084,59,138,"PCPE",31
9,"9444",72,58,58,3,0,"PCPE",0
50,"50170",371,283,280,0,3,"PCPE",0
24,"24194",290,212,212,3,0,"PCPE",0
47,"47175",6564,4781,4728,39,53,"PCPE",6
44,"44012",334,263,261,5,2,"PCPE",0
3,"3057",182,147,147,1,0,"PCPE",0
50,"50232",175,110,110,3,0,"PCPE",0
47,"47013",100,82,81,1,1,"PCPE",0
45,"45188",2785,1960,1938,15,22,"PCPE",3
44,"44256",38,34,34,0,0,"PCPE",0
18,"18099",1584,1228,1206,14,22,"PCPE",3
3,"3058",4951,3897,3851,30,46,"PCPE",8
9,"9314",94,73,70,0,3,"PCPE",0
39,"39047",1962,1385,1371,10,14,"PCPE",2
40,"40048",38,29,27,0,2,"PCPE",0
33,"33055",1514,1109,1092,5,17,"PCPE",0
23,"23902",2320,1867,1847,4,20,"PCPE",2
48,"48027",22150,15089,14982,78,107,"PCPE",11
14,"14040",3776,2873,2833,32,40,"PCPE",4
21,"21048",305,214,210,4,4,"PCPE",0
20,"20061",4273,2601,2590,21,11,"PCPE",2
29,"29032",6657,5031,4977,33,54,"PCPE",18
47,"47149",42,34,34,3,0,"PCPE",0
44,"44257",166,123,119,1,4,"PCPE",0
40,"40092",118,87,87,1,0,"PCPE",0
46,"46144",663,532,529,2,3,"PCPE",0
18,"18911",7473,5098,5035,51,63,"PCPE",6
50,"50234",243,189,185,6,4,"PCPE",0
21,"21049",3361,2049,1984,17,65,"PCPE",6
47,"47067",174,127,126,0,1,"PCPE",0
42,"42039",226,138,138,4,0,"PCPE",0
20,"20029",4281,2813,2802,19,11,"PCPE",1
21,"21050",12427,8036,7969,80,67,"PCPE",14
28,"28004",6234,4202,4167,16,35,"PCPE",1
47,"47015",200,162,160,0,2,"PCPE",0
34,"34106",109,89,86,2,3,"PCPE",0
47,"47231",4401,3299,3277,24,22,"PCPE",2
18,"18148",817,637,634,5,3,"PCPE",0
47,"47016",69,56,55,0,1,"PCPE",0
40,"40094",374,279,276,2,3,"PCPE",0
3,"3060",109,91,91,0,0,"PCPE",0
20,"20063",8017,5263,5231,35,32,"PCPE",4
46,"46223",7801,5950,5899,34,51,"PCPE",4
34,"34017",918,744,736,9,8,"PCPE",2
49,"49255",418,319,316,1,3,"PCPE",0
22,"22011",88,71,69,0,2,"PCPE",0
46,"46015",7244,5615,5560,40,55,"PCPE",4
46,"46145",21990,16337,16187,93,150,"PCPE",10
11,"11041",9866,6477,6402,69,75,"PCPE",4
14,"14070",1332,986,974,10,12,"PCPE",3
50,"50077",221,168,167,1,1,"PCPE",0
39,"39051",66,57,57,0,0,"PCPE",0
34,"34107",81,52,51,5,1,"PCPE",0
37,"37305",216,171,170,0,1,"PCPE",0
49,"49242",447,360,357,5,3,"PCPE",0
22,"22254",1124,801,792,11,9,"PCPE",1
18,"18015",434,334,333,0,1,"PCPE",1
47,"47096",140,110,110,0,0,"PCPE",0
14,"14071",929,642,630,2,12,"PCPE",1
37,"37306",259,186,183,1,3,"PCPE",0
4,"4012",191,161,161,0,0,"PCPE",0
26,"26058",154,116,115,0,1,"PCPE",0
9,"9366",86,62,62,2,0,"PCPE",0
11,"11009",605,414,410,1,4,"PCPE",0
44,"44246",1543,1045,1027,12,18,"PCPE",1
46,"46060",9369,7052,6993,42,59,"PCPE",8
9,"9413",436,306,302,2,4,"PCPE",1
18,"18059",4180,2907,2870,20,37,"PCPE",5
50,"50079",249,175,174,0,1,"PCPE",0
44,"44050",3113,2120,2100,25,20,"PCPE",2
26,"26059",1125,828,812,5,16,"PCPE",0
4,"4013",141378,94872,94288,741,584,"PCPE",81
37,"37047",180,84,84,0,0,"PCPE",0
40,"40183",130,120,119,2,1,"PCPE",0
44,"44225",107,74,74,1,0,"PCPE",0
46,"46043",136,124,124,0,0,"PCPE",0
22,"22163",425,360,355,0,5,"PCPE",0
40,"40129",177,148,147,1,1,"PCPE",0
9,"9451",238,191,190,0,1,"PCPE",0
37,"37309",44,30,30,1,0,"PCPE",0
3,"3033",117,96,95,0,1,"PCPE",0
40,"40225",1138,883,867,3,16,"PCPE",0
22,"22901",742,478,470,5,8,"PCPE",1
24,"24101",397,258,257,3,1,"PCPE",1
40,"40224",22,21,21,0,0,"PCPE",0
37,"37183",414,306,304,0,2,"PCPE",0
48,"48033",217,149,149,0,0,"PCPE",0
20,"20034",3145,2026,2014,14,12,"PCPE",2
2,"2078",920,675,664,1,11,"PCPE",0
4,"4036",226,175,175,0,0,"PCPE",1
3,"3034",1376,1067,1052,5,15,"PCPE",0
18,"18078",732,570,566,2,4,"PCPE",1
49,"49246",227,190,183,2,7,"PCPE",0
28,"28037",1559,1177,1166,5,11,"PCPE",0
28,"28008",1799,1182,1174,4,8,"PCPE",1
42,"42089",54,44,44,0,0,"PCPE",0
24,"24205",945,694,685,11,9,"PCPE",0
29,"29095",3321,2376,2307,24,69,"PCPE",9
26,"26061",1565,1160,1141,13,19,"PCPE",0
9,"9232",154,119,116,0,3,"PCPE",0
18,"18143",973,742,730,5,12,"PCPE",2
28,"28164",2993,2183,2168,8,15,"PCPE",2
23,"23033",1352,1045,1034,12,11,"PCPE",1
50,"50179",249,214,213,2,1,"PCPE",0
37,"37185",591,423,417,2,6,"PCPE",0
29,"29007",27491,19071,18910,153,161,"PCPE",25
48,"48035",413,293,292,1,1,"PCPE",0
24,"24206",1700,1253,1240,12,13,"PCPE",1
3,"3066",42121,29655,29419,214,236,"PCPE",46
44,"44053",105,78,78,0,0,"PCPE",0
40,"40132",56,37,36,1,1,"PCPE",0
44,"44228",100,82,82,0,0,"PCPE",0
22,"22133",115,81,80,1,1,"PCPE",0
49,"49100",295,212,208,5,4,"PCPE",3
49,"49019",243,188,182,2,6,"PCPE",0
4,"4071",394,338,337,3,1,"PCPE",0
41,"41080",1274,910,892,6,18,"PCPE",1
44,"44150",28,22,21,0,1,"PCPE",0
9,"9086",666,462,459,2,3,"PCPE",0
23,"23073",4507,3229,3200,13,29,"PCPE",4
37,"37314",82,65,65,0,0,"PCPE",0
22,"22905",281,209,209,1,0,"PCPE",0
28,"28107",457,312,312,0,0,"PCPE",0
44,"44054",108,85,85,2,0,"PCPE",1
45,"45065",271,207,206,1,1,"PCPE",0
24,"24073",478,332,328,2,4,"PCPE",0
50,"50083",89,75,75,1,0,"PCPE",0
49,"49264",578,383,377,5,6,"PCPE",0
24,"24007",773,550,548,4,2,"PCPE",0
47,"47211",47,35,34,0,1,"PCPE",0
18,"18161",212,175,174,3,1,"PCPE",0
2,"2015",1441,1112,1093,5,19,"PCPE",2
48,"48901",4839,3459,3426,32,33,"PCPE",1
3,"3038",355,288,285,3,3,"PCPE",0
49,"49020",289,214,214,2,0,"PCPE",0
26,"26065",50,43,42,0,1,"PCPE",0
29,"29010",1651,1278,1237,4,41,"PCPE",3
37,"37056",37,30,29,0,1,"PCPE",0
24,"24008",9282,6685,6603,52,82,"PCPE",6
49,"49265",128,91,91,1,0,"PCPE",0
24,"24106",248,167,166,1,1,"PCPE",0
40,"40233",417,314,310,3,4,"PCPE",0
26,"26138",4588,3290,3247,15,43,"PCPE",4
49,"49063",338,272,266,4,6,"PCPE",0
49,"49062",122,90,89,0,1,"PCPE",1
16,"16148",573,504,500,4,4,"PCPE",0
47,"47185",99,73,71,0,2,"PCPE",1
50,"50212",40,36,36,0,0,"PCPE",0
48,"48069",12798,8679,8612,55,67,"PCPE",3
42,"42095",1773,1269,1251,15,18,"PCPE",2
49,"49104",343,234,232,0,2,"PCPE",0
45,"45067",2318,1791,1752,19,39,"PCPE",1
47,"47024",259,208,207,1,1,"PCPE",1
24,"24211",272,205,205,2,0,"PCPE",1
3,"3133",41576,25849,25639,127,210,"PCPE",57
14,"14051",1397,1018,1000,2,18,"PCPE",0
48,"48039",239,190,188,0,2,"PCPE",0
16,"16277",113,84,83,1,1,"PCPE",0
22,"22139",79,64,64,1,0,"PCPE",0
9,"9241",202,156,154,4,2,"PCPE",1
24,"24009",322,153,152,2,1,"PCPE",0
33,"33006",1540,1010,1003,5,7,"PCPE",3
24,"24212",1032,773,760,4,13,"PCPE",1
9,"9242",80,66,66,2,0,"PCPE",0
40,"40068",26,24,24,0,0,"PCPE",0
40,"40110",349,265,263,3,2,"PCPE",0
48,"48040",1281,877,869,3,8,"PCPE",0
49,"49024",672,459,454,5,5,"PCPE",0
22,"22021",1971,1414,1398,17,16,"PCPE",3
16,"16071",20,20,20,0,0,"PCPE",0
4,"4021",185,151,148,1,3,"PCPE",0
2,"2061",637,516,511,4,5,"PCPE",3
24,"24011",203,133,132,0,1,"PCPE",0
9,"9381",30,24,24,1,0,"PCPE",0
28,"28033",3899,2805,2788,7,17,"PCPE",2
42,"42152",78,55,55,0,0,"PCPE",0
9,"9467",64,43,42,1,1,"PCPE",0
16,"16166",243,176,174,1,2,"PCPE",0
37,"37152",418,290,286,2,4,"PCPE",0
40,"40111",58,49,49,0,0,"PCPE",0
45,"45003",562,408,402,1,6,"PCPE",0
46,"46233",3860,2859,2817,10,42,"PCPE",0
28,"28080",48554,38885,38691,164,194,"PCPE",10
29,"29069",85684,54130,53621,455,509,"PCPE",44
28,"28006",78966,59065,58698,267,367,"PCPE",53
34,"34063",83,76,75,1,1,"PCPE",0
9,"9113",449,339,332,4,7,"PCPE",0
37,"37238",110,87,85,0,2,"PCPE",0
21,"21067",414,288,287,1,1,"PCPE",0
46,"46077",7496,5909,5827,45,82,"PCPE",11
4,"4023",138,96,95,2,1,"PCPE",0
40,"40112",2555,1932,1909,8,23,"PCPE",5
50,"50089",8225,6074,6043,43,31,"PCPE",6
45,"45105",392,301,297,3,4,"PCPE",0
45,"45005",238,193,192,3,1,"PCPE",0
37,"37195",46,36,36,1,0,"PCPE",0
50,"50206",460,363,357,4,6,"PCPE",1
18,"18017",18114,11610,11510,77,100,"PCPE",14
37,"37280",78,53,53,0,0,"PCPE",0
46,"46130",901,687,683,3,4,"PCPE",1
40,"40113",425,323,316,0,7,"PCPE",1
9,"9114",86,66,66,0,0,"PCPE",0
30,"30001",4582,3620,3594,18,26,"PCPE",5
24,"24112",309,228,227,1,1,"PCPE",2
34,"34036",211,150,150,0,0,"PCPE",0
50,"50187",69,44,44,0,0,"PCPE",0
9,"9201",28,18,18,1,0,"PCPE",0
44,"44063",71,54,54,0,0,"PCPE",0
23,"23070",3914,2433,2407,14,26,"PCPE",0
34,"34160",139,115,114,3,1,"PCPE",0
16,"16247",67,58,58,0,0,"PCPE",0
11,"11034",2334,1549,1517,14,32,"PCPE",5
18,"18154",1007,664,660,2,4,"PCPE",0
41,"41067",7093,4930,4866,37,64,"PCPE",3
46,"46157",2980,2321,2298,10,23,"PCPE",1
24,"24216",723,522,518,1,4,"PCPE",0
49,"49150",139,112,111,1,1,"PCPE",0
22,"22027",329,221,218,0,3,"PCPE",0
37,"37158",246,183,183,0,0,"PCPE",1
4,"4050",800,558,553,3,5,"PCPE",1
41,"41068",13939,9787,9674,72,113,"PCPE",5
30,"30033",10188,7403,7285,68,118,"PCPE",7
37,"37068",365,267,267,1,0,"PCPE",0
18,"18035",1232,992,988,6,4,"PCPE",0
20,"20047",469,307,304,5,3,"PCPE",1
46,"46132",2150,1803,1784,7,19,"PCPE",2
28,"28019",1233,893,885,4,8,"PCPE",1
34,"34039",61,49,47,0,2,"PCPE",0
29,"29073",1579,1091,1080,7,11,"PCPE",1
37,"37159",90,70,70,1,0,"PCPE",0
45,"45198",1809,1475,1442,7,33,"PCPE",0
24,"24151",478,353,352,1,1,"PCPE",0
49,"49151",619,459,456,2,3,"PCPE",1
22,"22150",472,331,330,1,1,"PCPE",2
2,"2067",1158,858,847,6,11,"PCPE",1
49,"49275",52210,36205,35754,356,451,"PCPE",41
3,"3076",8467,6238,6157,30,81,"PCPE",7
9,"9194",2020,1472,1459,9,13,"PCPE",5
44,"44196",131,101,98,2,3,"PCPE",0
40,"40120",192,170,166,0,4,"PCPE",0
46,"46237",7211,5395,5343,42,52,"PCPE",3
18,"18175",11670,8200,8097,36,103,"PCPE",6
16,"16035",261,203,198,4,5,"PCPE",0
49,"49032",326,259,259,1,0,"PCPE",1
41,"41092",7743,5358,5311,55,47,"PCPE",8
18,"18128",343,270,269,1,1,"PCPE",0
18,"18037",535,402,396,2,6,"PCPE",0
2,"2069",11490,8470,8373,41,97,"PCPE",8
46,"46004",1922,1565,1547,11,18,"PCPE",1
44,"44067",114,81,81,1,0,"PCPE",1
39,"39098",1402,1046,1036,8,10,"PCPE",2
37,"37370",328,258,254,1,4,"PCPE",0
9,"9251",375,277,274,4,3,"PCPE",0
26,"26148",165,135,133,1,2,"PCPE",0
48,"48017",13261,8543,8482,42,61,"PCPE",1
47,"47031",189,145,145,1,0,"PCPE",0
24,"24117",434,334,331,1,3,"PCPE",0
14,"14002",10951,7706,7620,83,86,"PCPE",103
37,"37072",168,140,138,0,2,"PCPE",1
48,"48912",2308,1707,1679,14,28,"PCPE",1
50,"50033",66,49,48,0,1,"PCPE",0
47,"47032",152,117,116,1,1,"PCPE",0
40,"40122",512,395,394,2,1,"PCPE",2
48,"48018",869,522,522,2,0,"PCPE",1
45,"45078",1379,1129,1119,6,10,"PCPE",0
48,"48038",1126,798,794,3,4,"PCPE",1
2,"2072",1549,1086,1070,2,16,"PCPE",0
18,"18178",719,549,544,4,5,"PCPE",0
50,"50284",141,107,104,0,3,"PCPE",0
21,"21035",9617,6033,5943,76,90,"PCPE",9
26,"26044",52,46,46,0,0,"PCPE",0
30,"30007",6411,4360,4329,24,31,"PCPE",2
47,"47033",196,154,154,1,0,"PCPE",0
50,"50004",522,390,388,0,2,"PCPE",0
2,"2071",1011,831,825,5,6,"PCPE",1
9,"9169",95,78,78,0,0,"PCPE",0
16,"16039",392,261,254,1,7,"PCPE",0
48,"48049",549,416,416,1,0,"PCPE",0
46,"46084",1576,1263,1242,5,21,"PCPE",0
3,"3904",1396,1033,1026,4,7,"PCPE",3
24,"24187",857,603,593,7,10,"PCPE",0
33,"33016",19130,13666,13526,125,140,"PCPE",20
46,"46162",1189,938,929,3,9,"PCPE",1
20,"20904",95,44,44,2,0,"PCPE",0
9,"9124",1506,1040,1028,6,12,"PCPE",2
49,"49035",226,200,196,3,4,"PCPE",0
2,"2073",4867,3520,3474,40,46,"PCPE",4
29,"29023",2081,1354,1340,4,14,"PCPE",0
44,"44178",58,37,37,0,0,"PCPE",0
22,"22037",115,86,86,0,0,"PCPE",0
24,"24224",616,454,451,4,3,"PCPE",1
23,"23012",4162,2907,2889,14,18,"PCPE",1
46,"46085",11081,7938,7866,46,72,"PCPE",8
37,"37207",287,195,193,1,2,"PCPE",0
20,"20905",145,100,100,1,0,"PCPE",0
50,"50287",270,191,191,0,0,"PCPE",0
23,"23093",3226,2302,2273,19,29,"PCPE",2
28,"28052",3855,2626,2587,11,39,"PCPE",0
14,"14005",6311,4143,4084,72,59,"PCPE",17
42,"42030",94,78,78,1,0,"PCPE",0
24,"24022",330,230,229,0,1,"PCPE",0
50,"50195",54,40,40,0,0,"PCPE",0
9,"9127",56,41,39,0,2,"PCPE",0
30,"30010",6869,5194,5142,21,52,"PCPE",4
37,"37335",406,296,290,0,6,"PCPE",0
41,"41032",3984,2811,2725,27,86,"PCPE",4
50,"50006",925,674,657,6,17,"PCPE",0
24,"24189",5865,3933,3885,31,48,"PCPE",6
24,"24121",645,492,487,1,5,"PCPE",1
22,"22160",209,168,168,6,0,"PCPE",0
34,"34242",95,71,68,3,3,"PCPE",0
22,"22204",1114,745,739,12,6,"PCPE",1
23,"23095",8735,6347,6310,14,37,"PCPE",0
20,"20907",118,85,85,2,0,"PCPE",0
47,"47171",407,303,301,6,2,"PCPE",0
49,"49121",365,273,273,2,0,"PCPE",0
41,"41077",8702,5983,5875,29,108,"PCPE",7
1,"1062",313,211,210,2,1,"PCPE",1
26,"26016",28,25,24,1,1,"PCPE",0
46,"46035",6822,5202,5142,43,60,"PCPE",2
29,"29083",2107,1540,1512,9,28,"PCPE",0
46,"46087",120,98,97,0,1,"PCPE",0
24,"24024",692,496,491,4,5,"PCPE",0
42,"42120",145,91,89,2,2,"PCPE",1
47,"47117",301,233,227,2,6,"PCPE",3
22,"22116",1430,1004,994,5,10,"PCPE",1
14,"14064",320,242,236,2,6,"PCPE",0
9,"9261",469,332,329,2,3,"PCPE",1
34,"34052",174,135,133,0,2,"PCPE",1
50,"50167",233,183,178,1,5,"PCPE",0
49,"49260",755,590,586,8,4,"PCPE",2
40,"40101",877,635,628,8,7,"PCPE",2
44,"44237",398,304,301,4,3,"PCPE",0
22,"22041",163,134,134,1,0,"PCPE",0
44,"44182",197,157,157,0,0,"PCPE",0
24,"24123",746,488,485,2,3,"PCPE",1
37,"37297",425,328,322,2,6,"PCPE",0
22,"22077",379,279,273,2,6,"PCPE",0
48,"48085",10338,7190,7153,39,37,"PCPE",6
24,"24160",684,483,474,6,9,"PCPE",0
47,"47119",92,80,79,1,1,"PCPE",0
21,"21003",690,471,458,6,13,"PCPE",2
49,"49041",432,326,322,5,4,"PCPE",0
9,"9405",130,98,96,0,2,"PCPE",0
45,"45018",498,333,330,4,3,"PCPE",0
50,"50010",68,58,58,0,0,"PCPE",0
18,"18185",541,434,432,2,2,"PCPE",0
29,"29029",403,298,294,2,4,"PCPE",0
26,"26051",239,193,191,1,2,"PCPE",0
45,"45119",3330,2096,2067,15,29,"PCPE",4
34,"34202",29,18,18,1,0,"PCPE",0
50,"50062",1829,1304,1290,16,14,"PCPE",5
21,"21005",15523,9038,8913,56,125,"PCPE",12
16,"16143",16,14,14,2,0,"PCPE",0
49,"49043",289,217,213,1,4,"PCPE",1
44,"44251",254,198,191,1,7,"PCPE",0
16,"16251",1849,1381,1366,7,15,"PCPE",0
39,"39076",3476,2594,2559,19,35,"PCPE",2
2,"2027",315,248,246,2,2,"PCPE",0
44,"44174",428,307,304,3,3,"PCPE",0
44,"44184",45,34,34,0,0,"PCPE",0
46,"46090",1637,1391,1367,3,24,"PCPE",0
37,"37215",136,104,103,1,1,"PCPE",0
50,"50292",125,102,102,1,0,"PCPE",0
28,"28057",1458,1097,1088,3,9,"PCPE",0
34,"34010",577,440,438,5,2,"PCPE",0
50,"50012",100,80,79,2,1,"PCPE",1
22,"22122",64,57,57,2,0,"PCPE",0
40,"40007",78,63,61,0,2,"PCPE",0
37,"37087",862,639,635,2,4,"PCPE",0
9,"9133",40,32,32,0,0,"PCPE",0
22,"22045",82,65,64,1,1,"PCPE",0
22,"22168",23,18,18,0,0,"PCPE",0
46,"46169",32247,24214,24053,154,161,"PCPE",24
24,"24901",889,636,623,5,13,"PCPE",0
18,"18146",965,703,685,9,18,"PCPE",1
24,"24096",117,80,79,1,1,"PCPE",0
45,"45021",2500,1708,1665,12,43,"PCPE",2
47,"47122",2032,1563,1535,7,28,"PCPE",1
37,"37088",207,163,162,3,1,"PCPE",0
47,"47094",133,115,114,1,1,"PCPE",0
41,"41049",9299,6896,6771,98,125,"PCPE",15
46,"46118",3763,2940,2908,16,32,"PCPE",0
42,"42082",8,8,8,1,0,"PCPE",0
14,"14012",6173,4364,4291,35,73,"PCPE",7
24,"24902",347,270,269,2,1,"PCPE",0
47,"47204",256,204,198,0,6,"PCPE",0
30,"30017",11605,8541,8451,46,90,"PCPE",3
37,"37089",67,56,56,0,0,"PCPE",0
49,"49168",93,74,74,0,0,"PCPE",0
22,"22170",651,498,491,5,7,"PCPE",1
37,"37218",67,42,41,0,1,"PCPE",0
2,"2045",3665,2895,2855,21,40,"PCPE",8
22,"22082",291,213,212,1,1,"PCPE",0
28,"28097",119,94,94,0,0,"PCPE",0
40,"40009",49,43,43,0,0,"PCPE",0
44,"44086",449,342,336,3,6,"PCPE",0
9,"9136",192,142,137,2,5,"PCPE",0
29,"29033",1122,747,730,4,17,"PCPE",1
26,"26091",161,146,146,0,0,"PCPE",0
21,"21009",857,532,523,4,9,"PCPE",1
18,"18194",2128,1451,1437,9,14,"PCPE",1
24,"24131",724,511,507,3,4,"PCPE",0
18,"18056",3530,2641,2614,24,27,"PCPE",4
44,"44258",67,47,47,0,0,"PCPE",0
24,"24199",424,302,301,0,1,"PCPE",0
37,"37304",169,124,124,0,0,"PCPE",0
28,"28005",134246,99236,98481,583,755,"PCPE",94
9,"9054",101,68,66,1,2,"PCPE",1
48,"48060",3634,2143,2134,7,9,"PCPE",2
30,"30018",7978,5866,5811,30,55,"PCPE",2
16,"16055",691,466,463,2,3,"PCPE",0
40,"40139",279,202,198,1,4,"PCPE",0
39,"39020",23592,15594,15384,128,210,"PCPE",25
9,"9272",282,210,206,3,4,"PCPE",0
44,"44260",137,91,89,3,2,"PCPE",0
34,"34062",171,119,118,2,1,"PCPE",0
37,"37180",75,56,56,0,0,"PCPE",0
30,"30019",25857,17544,17374,125,170,"PCPE",15
45,"45126",260,176,175,3,1,"PCPE",0
45,"45125",2305,1865,1841,8,24,"PCPE",3
50,"50110",367,256,254,0,2,"PCPE",0
45,"45025",1205,831,827,2,4,"PCPE",1
16,"16057",75,63,63,0,0,"PCPE",0
42,"42132",141,114,114,0,0,"PCPE",0
9,"9273",52,40,39,2,1,"PCPE",0
49,"49037",185,153,151,0,2,"PCPE",0
18,"18902",816,632,620,4,12,"PCPE",0
28,"28130",28293,21253,21040,116,213,"PCPE",31
40,"40223",216,163,163,1,0,"PCPE",0
34,"34214",183,144,144,0,0,"PCPE",0
37,"37349",117,88,88,0,0,"PCPE",0
9,"9138",85,72,70,0,2,"PCPE",0
44,"44123",105,71,70,1,1,"PCPE",0
45,"45026",211,167,166,2,1,"PCPE",0
50,"50017",1773,1276,1269,13,7,"PCPE",1
37,"37350",420,318,314,5,4,"PCPE",0
21,"21013",10591,6580,6452,55,128,"PCPE",9
48,"48032",5743,4065,4048,29,17,"PCPE",3
29,"29037",209,158,157,1,1,"PCPE",0
24,"24203",95,69,68,0,1,"PCPE",0
28,"28064",129,106,106,2,0,"PCPE",0
9,"9414",189,148,146,0,2,"PCPE",0
4,"4048",1503,1090,1085,9,5,"PCPE",1
47,"47127",137,98,97,0,1,"PCPE",2
37,"37225",103,89,86,0,3,"PCPE",0
34,"34215",164,141,140,1,1,"PCPE",0
49,"49174",125,95,92,1,3,"PCPE",0
24,"24034",3394,2380,2342,28,38,"PCPE",0
50,"50018",953,656,655,1,1,"PCPE",0
48,"48003",14339,9918,9838,53,80,"PCPE",2
47,"47090",2418,1728,1699,8,29,"PCPE",1
9,"9295",61,44,44,0,0,"PCPE",0
41,"41100",1013,692,673,6,19,"PCPE",0
21,"21015",680,398,393,8,5,"PCPE",0
26,"26096",245,190,190,1,0,"PCPE",1
20,"20068",190,135,135,3,0,"PCPE",0
42,"42139",23,15,15,1,0,"PCPE",0
24,"24137",1099,783,778,7,5,"PCPE",2
22,"22177",98,75,75,0,0,"PCPE",0
9,"9415",268,175,175,2,0,"PCPE",0
3,"3096",5786,4358,4289,17,69,"PCPE",7
34,"34068",27,22,22,0,0,"PCPE",0
37,"37052",273,209,209,2,0,"PCPE",0
9,"9455",45,33,33,0,0,"PCPE",0
40,"40103",159,125,123,2,2,"PCPE",0
42,"42140",16,12,12,0,0,"PCPE",0
9,"9143",27,19,18,0,1,"PCPE",0
33,"33032",11395,7592,7465,90,127,"PCPE",23
14,"14019",6464,4967,4909,49,58,"PCPE",5
37,"37230",221,159,159,2,0,"PCPE",0
28,"28134",61008,45177,44904,263,273,"PCPE",40
3,"3097",993,822,812,6,10,"PCPE",2
23,"23072",1986,1542,1530,7,12,"PCPE",4
16,"16018",394,318,315,1,3,"PCPE",0
49,"49057",109,85,83,1,2,"PCPE",0
34,"34165",66,58,58,1,0,"PCPE",0
18,"18021",17485,11800,11669,95,131,"PCPE",16
45,"45097",1046,839,834,4,5,"PCPE",0
24,"24125",462,290,286,4,4,"PCPE",0
22,"22044",252,198,197,0,1,"PCPE",0
3,"3131",175,154,147,0,7,"PCPE",0
47,"47183",130,106,105,0,1,"PCPE",0
21,"21019",612,400,391,2,9,"PCPE",0
18,"18066",2107,1392,1384,4,8,"PCPE",5
50,"50021",30,21,21,0,0,"PCPE",0
37,"37231",250,196,193,4,3,"PCPE",0
48,"48036",24073,16076,15971,86,105,"PCPE",8
44,"44128",68,54,54,1,0,"PCPE",0
9,"9062",51,40,39,0,1,"PCPE",0
34,"34168",52,47,47,2,0,"PCPE",0
50,"50211",249,176,173,0,3,"PCPE",0
37,"37188",181,129,129,3,0,"PCPE",0
42,"42093",37,29,28,1,1,"PCPE",0
28,"28108",3374,2482,2465,10,17,"PCPE",1
45,"45099",3500,2390,2361,9,29,"PCPE",3
16,"16020",17,10,10,0,0,"PCPE",0
14,"14021",260178,181773,180348,1872,1425,"PCPE",213
50,"50117",126,104,103,1,1,"PCPE",0
3,"3007",166,139,137,0,2,"PCPE",0
9,"9281",145,114,109,1,5,"PCPE",0
34,"34072",152,136,135,2,1,"PCPE",0
50,"50118",2165,1552,1540,10,12,"PCPE",0
40,"40149",514,375,369,5,6,"PCPE",2
22,"22136",806,588,588,5,0,"PCPE",1
46,"46074",2696,2069,2038,14,31,"PCPE",1
50,"50274",71,55,55,0,0,"PCPE",0
39,"39028",3739,2850,2817,16,33,"PCPE",4
28,"28041",4524,3508,3490,20,18,"PCPE",2
2,"2058",337,234,231,0,3,"PCPE",0
9,"9108",384,283,279,1,4,"PCPE",0
26,"26102",6111,4486,4435,28,51,"PCPE",3
40,"40234",397,298,292,2,6,"PCPE",1
26,"26066",251,201,194,1,7,"PCPE",0
47,"47050",3719,2630,2598,26,32,"PCPE",3
33,"33036",11542,8062,7987,60,75,"PCPE",14
40,"40901",384,309,307,4,2,"PCPE",0
40,"40193",229,174,172,3,2,"PCPE",0
37,"37015",224,144,144,1,0,"PCPE",0
47,"47186",246129,186191,184733,1198,1458,"PCPE",194
47,"47214",1409,1087,1062,7,25,"PCPE",2
18,"18912",1473,994,979,3,15,"PCPE",1
34,"34224",47,37,37,1,0,"PCPE",0
24,"24144",695,470,465,2,5,"PCPE",0
30,"30028",6649,4797,4726,21,71,"PCPE",6
40,"40152",760,592,584,3,8,"PCPE",0
33,"33037",34454,22881,22586,243,295,"PCPE",132
29,"29902",2567,1577,1559,11,18,"PCPE",0
47,"47104",2836,2182,2121,19,61,"PCPE",3
28,"28140",3007,2276,2256,7,20,"PCPE",0
34,"34171",968,708,703,5,5,"PCPE",0
45,"45203",2563,1801,1771,8,30,"PCPE",1
50,"50153",935,713,708,6,5,"PCPE",0
42,"42017",140,113,112,0,1,"PCPE",0
4,"4056",143,113,109,0,4,"PCPE",0
50,"50057",1395,919,907,11,12,"PCPE",0
2,"2020",432,365,364,1,1,"PCPE",0
20,"20009",11452,7388,7345,62,43,"PCPE",8
21,"21025",4026,2433,2396,30,37,"PCPE",1
45,"45204",632,488,487,1,1,"PCPE",0
44,"44201",495,411,406,0,5,"PCPE",1
47,"47052",6576,4988,4944,40,44,"PCPE",6
9,"9029",168,131,129,4,2,"PCPE",1
9,"9112",109,85,85,0,0,"PCPE",0
34,"34175",90,72,70,0,2,"PCPE",0
37,"37097",39,27,27,1,0,"PCPE",0
47,"47216",115,91,87,0,4,"PCPE",0
9,"9030",112,75,73,1,2,"PCPE",0
3,"3136",441,338,334,0,4,"PCPE",2
45,"45037",1603,1122,1111,5,11,"PCPE",0
40,"40028",105,91,90,2,1,"PCPE",0
28,"28072",5709,4356,4324,22,32,"PCPE",2
3,"3104",27103,19953,19787,131,166,"PCPE",36
49,"49066",492,336,332,4,4,"PCPE",0
45,"45038",3356,2376,2350,15,26,"PCPE",3
20,"20011",1658,1219,1210,7,9,"PCPE",0
39,"39093",299,229,226,4,3,"PCPE",0
48,"48043",4423,3118,3108,17,10,"PCPE",0
49,"49187",1236,896,888,4,8,"PCPE",0
16,"16074",37,30,30,1,0,"PCPE",0
23,"23043",546,398,396,3,2,"PCPE",2
14,"14026",2067,1424,1405,4,19,"PCPE",2
24,"24047",783,545,540,2,5,"PCPE",0
44,"44204",24,21,21,0,0,"PCPE",0
45,"45006",1406,942,931,4,11,"PCPE",1
42,"42154",97,69,69,1,0,"PCPE",0
9,"9473",85,70,65,1,5,"PCPE",1
39,"39024",1879,1390,1372,2,18,"PCPE",1
21,"21002",15478,10597,10507,94,90,"PCPE",10
18,"18063",1200,679,675,2,4,"PCPE",0
50,"50029",626,450,450,3,0,"PCPE",0
16,"16171",1800,1469,1443,8,26,"PCPE",2
50,"50218",113,91,91,1,0,"PCPE",0
16,"16079",30,19,18,0,1,"PCPE",0
33,"33041",7199,4922,4877,52,45,"PCPE",6
22,"22063",169,133,129,1,4,"PCPE",0
47,"47055",203,167,163,0,4,"PCPE",0
49,"49272",88,70,69,1,1,"PCPE",0
48,"48908",249,181,181,0,0,"PCPE",0
46,"46106",1535,1150,1140,10,10,"PCPE",1
22,"22233",82,57,57,3,0,"PCPE",0
45,"45141",884,700,689,3,11,"PCPE",2
47,"47218",993,743,734,2,9,"PCPE",0
28,"28145",2431,1760,1736,6,24,"PCPE",4
26,"26007",511,384,375,0,9,"PCPE",0
40,"40032",390,289,285,2,4,"PCPE",0
14,"14056",23581,16120,15958,143,162,"PCPE",31
37,"37327",185,149,146,3,3,"PCPE",0
18,"18173",8939,5922,5849,42,73,"PCPE",6
30,"30003",24332,16183,16040,104,143,"PCPE",14
9,"9208",210,136,134,3,2,"PCPE",0
44,"44106",155,116,114,5,2,"PCPE",0
37,"37243",98,70,70,1,0,"PCPE",0
22,"22197",473,354,354,1,0,"PCPE",0
42,"42158",103,76,76,0,0,"PCPE",0
50,"50126",2371,1573,1559,19,14,"PCPE",1
14,"14047",1672,1187,1178,14,9,"PCPE",1
34,"34084",138,109,107,0,2,"PCPE",1
39,"39036",969,743,739,2,4,"PCPE",0
24,"24051",423,309,307,0,2,"PCPE",0
28,"28146",1787,1205,1194,0,11,"PCPE",0
46,"46107",1900,1516,1504,5,12,"PCPE",4
37,"37244",131,98,98,0,0,"PCPE",1
4,"4062",4504,3534,3490,18,44,"PCPE",0
29,"29020",3267,2408,2359,16,49,"PCPE",2
37,"37369",137,95,94,0,1,"PCPE",0
47,"47220",165,130,129,0,1,"PCPE",0
3,"3077",1371,1071,1060,13,11,"PCPE",0
49,"49238",254,194,193,1,1,"PCPE",1
14,"14001",3514,2837,2789,28,48,"PCPE",5
29,"29075",12934,8234,8147,69,87,"PCPE",9
50,"50128",26,25,25,1,0,"PCPE",0
48,"48047",159,111,111,0,0,"PCPE",0
42,"42111",303,229,227,2,2,"PCPE",0
22,"22199",7000,4737,4688,104,49,"PCPE",6
42,"42160",254,206,205,0,1,"PCPE",2
46,"46186",19068,14599,14474,69,125,"PCPE",8
20,"20016",1520,826,821,2,5,"PCPE",0
20,"20902",14156,9664,9613,74,51,"PCPE",10
23,"23090",1312,1041,1018,5,23,"PCPE",1
24,"24052",158,104,102,0,2,"PCPE",0
41,"41038",100095,67313,66687,760,626,"PCPE",88
18,"18039",3490,2406,2378,33,28,"PCPE",1
22,"22110",738,531,527,4,4,"PCPE",1
9,"9392",53,40,37,1,3,"PCPE",0
23,"23010",14347,9669,9560,86,109,"PCPE",7
14,"14003",1248,939,930,2,9,"PCPE",0
46,"46031",10535,7543,7451,66,92,"PCPE",7
22,"22035",234,165,159,3,6,"PCPE",0
44,"44068",659,509,503,3,6,"PCPE",0
44,"44004",408,303,297,0,6,"PCPE",0
14,"14031",593,469,459,3,10,"PCPE",0
23,"23051",2758,2171,2144,9,27,"PCPE",0
21,"21036",200,141,139,0,2,"PCPE",1
24,"24020",456,314,307,4,7,"PCPE",0
14,"14032",423,334,330,4,4,"PCPE",1
40,"40037",41,29,29,0,0,"PCPE",0
16,"16240",102,78,78,0,0,"PCPE",0
46,"46006",4523,3665,3623,20,42,"PCPE",0
42,"42028",75,51,51,0,0,"PCPE",0
16,"16242",317,272,270,1,2,"PCPE",0
1,"1059",186557,126506,125278,798,1228,"PCPE",160
45,"45047",2606,1666,1647,6,19,"PCPE",2
39,"39040",4292,3208,3166,14,42,"PCPE",5
49,"49080",685,520,514,2,6,"PCPE",1
23,"23052",1125,936,922,4,14,"PCPE",1
44,"44005",50,30,30,0,0,"PCPE",0
34,"34240",89,64,64,0,0,"PCPE",0
26,"26115",19,16,16,0,0,"PCPE",0
37,"37250",356,229,228,0,1,"PCPE",0
46,"46137",270,210,207,4,3,"PCPE",1
3,"3021",5613,4570,4500,26,70,"PCPE",5
46,"46189",467,393,390,2,3,"PCPE",0
33,"33048",154,95,94,0,1,"PCPE",0
50,"50225",1570,956,950,3,6,"PCPE",2
49,"49158",215,170,166,2,4,"PCPE",0
45,"45048",358,278,275,1,3,"PCPE",1
41,"41097",3137,2180,2134,18,46,"PCPE",1
42,"42207",40,33,32,0,1,"PCPE",0
16,"16091",65,53,53,0,0,"PCPE",0
42,"42164",1600,1150,1127,8,23,"PCPE",0
16,"16244",718,593,587,6,6,"PCPE",0
24,"24056",2883,2040,2003,11,37,"PCPE",0
45,"45049",433,305,304,1,1,"PCPE",0
48,"48082",37605,25134,24938,176,196,"PCPE",20
41,"41042",5844,4424,4378,40,46,"PCPE",2
30,"30040",732,617,607,2,10,"PCPE",1
40,"40168",34,29,29,1,0,"PCPE",0
50,"50133",113,80,80,4,0,"PCPE",0
50,"50288",3387,2415,2398,31,17,"PCPE",3
16,"16092",158,125,125,1,0,"PCPE",0
41,"41098",5004,3665,3630,26,35,"PCPE",1
28,"28152",16093,12945,12877,58,68,"PCPE",4
2,"2076",329,237,236,1,1,"PCPE",0
42,"42031",26,21,21,0,0,"PCPE",0
28,"28026",6317,4734,4701,33,33,"PCPE",2
47,"47197",876,673,668,8,5,"PCPE",0
18,"18045",1126,756,742,4,14,"PCPE",0
37,"37081",930,728,722,3,6,"PCPE",0
9,"9400",317,247,245,1,2,"PCPE",0
34,"34096",55,42,42,0,0,"PCPE",0
50,"50228",268,210,208,5,2,"PCPE",1
40,"40171",32,23,23,0,0,"PCPE",0
46,"46191",1937,1530,1505,5,25,"PCPE",3
37,"37211",224,172,172,4,0,"PCPE",0
22,"22076",311,201,199,0,2,"PCPE",0
9,"9309",301,224,220,0,4,"PCPE",0
47,"47063",103,81,80,1,1,"PCPE",0
9,"9006",59,39,39,0,0,"PCPE",0
16,"16205",115,88,87,0,1,"PCPE",0
48,"48074",3312,2330,2309,6,21,"PCPE",2
29,"29061",1016,798,769,8,29,"PCPE",3
9,"9046",29,25,25,0,0,"PCPE",0
46,"46114",569,461,458,1,3,"PCPE",0
34,"34098",777,551,545,8,6,"PCPE",1
48,"48054",24171,16797,16711,118,86,"PCPE",15
26,"26017",381,293,293,5,0,"PCPE",0
22,"22003",137,110,107,1,3,"PCPE",0
14,"14065",1850,1384,1377,16,7,"PCPE",1
45,"45151",578,417,414,0,3,"PCPE",0
14,"14037",3318,2374,2320,22,54,"PCPE",2
34,"34246",67,53,51,0,2,"PCPE",0
37,"37129",251,204,201,3,3,"PCPE",0
16,"16095",83,64,63,0,1,"PCPE",0
37,"37130",172,151,150,0,1,"PCPE",0
3,"3025",1270,950,941,2,9,"PCPE",1
49,"49086",115,96,91,0,5,"PCPE",1
29,"29062",654,551,545,2,6,"PCPE",0
41,"41046",3023,2213,2183,5,30,"PCPE",1
20,"20025",1143,765,760,8,5,"PCPE",1
16,"16250",76,59,59,0,0,"PCPE",0
37,"37173",1504,1129,1114,4,15,"PCPE",0
26,"26086",16,15,15,1,0,"PCPE",0
28,"28029",520,408,406,0,2,"PCPE",0
40,"40215",84,60,60,0,0,"PCPE",0
40,"40088",284,228,224,0,4,"PCPE",0
30,"30014",1567,1174,1160,8,14,"PCPE",1
29,"29019",878,652,636,3,16,"PCPE",1
24,"24060",602,363,361,3,2,"PCPE",0
40,"40047",30,25,25,0,0,"PCPE",0
46,"46253",115,82,82,0,0,"PCPE",2
46,"46116",13159,10193,10135,53,58,"PCPE",8
44,"44011",52,40,38,0,2,"PCPE",0
23,"23060",19003,12924,12812,102,112,"PCPE",12
24,"24061",1704,1213,1204,9,9,"PCPE",4
30,"30902",7975,5318,5273,24,45,"PCPE",6
45,"45054",3959,2882,2848,12,34,"PCPE",4
20,"20027",2814,1761,1750,15,11,"PCPE",1
34,"34101",50,41,41,0,0,"PCPE",0
46,"46038",327,242,242,3,0,"PCPE",1
45,"45154",1493,1079,1074,6,5,"PCPE",2
46,"46195",1962,1531,1516,11,15,"PCPE",0
50,"50042",15,15,15,1,0,"PCPE",0
34,"34058",189,172,172,2,0,"PCPE",0
9,"9267",111,99,97,1,2,"PCPE",0
9,"9445",44,32,32,3,0,"PCPE",0
49,"49208",394,248,244,2,4,"PCPE",0
23,"23061",7560,5303,5234,29,69,"PCPE",4
44,"44119",130,92,91,3,1,"PCPE",0
37,"37176",133,110,110,0,0,"PCPE",0
4,"4901",545,395,394,0,1,"PCPE",0
40,"40008",44,39,39,1,0,"PCPE",0
42,"42038",36,28,28,1,0,"PCPE",0
22,"22212",79,64,62,0,2,"PCPE",0
40,"40178",98,73,71,1,2,"PCPE",0
29,"29065",187,137,136,0,1,"PCPE",0
26,"26125",2699,1931,1907,23,24,"PCPE",0
45,"45156",3410,2751,2711,13,40,"PCPE",2
39,"39049",322,229,229,0,0,"PCPE",1
16,"16101",154,132,132,0,0,"PCPE",0
40,"40051",38,34,34,0,0,"PCPE",0
45,"45090",384,294,293,3,1,"PCPE",0
37,"37001",192,151,148,0,3,"PCPE",1
2,"2004",612,479,473,5,6,"PCPE",1
46,"46040",1078,888,878,7,10,"PCPE",2
9,"9181",300,221,221,0,0,"PCPE",0
47,"47151",27,24,24,0,0,"PCPE",0
46,"46197",1942,1527,1514,5,13,"PCPE",0
49,"49092",129,90,89,1,1,"PCPE",0
50,"50141",109,90,90,1,0,"PCPE",0
48,"48090",6001,4345,4295,28,50,"PCPE",4
9,"9317",19,16,16,0,0,"PCPE",0
40,"40180",299,246,241,1,5,"PCPE",1
22,"22048",12598,8790,8731,91,59,"PCPE",195
42,"42130",59,46,45,1,1,"PCPE",0
9,"9448",212,169,165,0,4,"PCPE",1
22,"22126",88,64,64,0,0,"PCPE",0
45,"45158",2514,1777,1760,11,17,"PCPE",1
34,"34156",50,45,45,0,0,"PCPE",0
47,"47178",172,140,140,3,0,"PCPE",0
42,"42084",25,22,22,1,0,"PCPE",0
23,"23905",1868,1277,1272,6,5,"PCPE",0
40,"40181",4233,3260,3219,23,41,"PCPE",7
47,"47043",297,239,237,0,2,"PCPE",1
46,"46257",5571,4266,4224,25,42,"PCPE",9
40,"40095",477,377,369,0,8,"PCPE",0
49,"49013",246,182,181,2,1,"PCPE",1
45,"45159",90,75,75,0,0,"PCPE",0
16,"16263",959,722,715,4,7,"PCPE",0
37,"37264",65,40,40,0,0,"PCPE",0
37,"37139",205,169,168,2,1,"PCPE",0
16,"16264",435,366,364,2,2,"PCPE",0
46,"46258",2652,2084,2062,16,22,"PCPE",1
3,"3094",9080,6440,6396,34,44,"PCPE",9
9,"9449",86,68,66,0,2,"PCPE",0
47,"47044",331,293,290,2,3,"PCPE",0
22,"22013",288,216,210,3,6,"PCPE",0
44,"44224",22,14,14,0,0,"PCPE",0
14,"14044",1604,1172,1165,7,7,"PCPE",0
34,"34158",288,186,184,3,2,"PCPE",0
49,"49096",170,131,124,2,7,"PCPE",0
3,"3032",108,91,90,1,1,"PCPE",0
24,"24168",460,361,359,0,2,"PCPE",2
26,"26026",1321,1039,1025,6,14,"PCPE",0
18,"18061",1057,812,804,1,8,"PCPE",0
37,"37006",138,103,103,2,0,"PCPE",0
47,"47071",410,324,321,4,3,"PCPE",0
28,"28162",2617,2029,2016,6,13,"PCPE",1
41,"41055",14954,10068,9945,64,123,"PCPE",10
3,"3127",350,278,273,1,5,"PCPE",0
24,"24067",623,388,384,0,4,"PCPE",0
49,"49220",135,110,109,0,1,"PCPE",0
46,"46122",2704,2082,2063,10,19,"PCPE",1
26,"26027",157,112,108,0,4,"PCPE",0
42,"42183",111,82,82,2,0,"PCPE",0
22,"22220",166,126,125,2,1,"PCPE",1
39,"39054",4493,3376,3334,33,42,"PCPE",5
9,"9130",74,51,50,1,1,"PCPE",0
41,"41045",5756,3988,3924,53,64,"PCPE",9
37,"37142",586,430,429,1,1,"PCPE",0
9,"9190",86,58,56,0,2,"PCPE",0
40,"40057",1456,1154,1148,7,6,"PCPE",3
37,"37008",4266,3216,3197,19,19,"PCPE",2
34,"34023",5236,3685,3636,30,49,"PCPE",3
50,"50239",62,50,48,0,2,"PCPE",0
28,"28163",442,344,339,1,5,"PCPE",0
22,"22221",84,58,58,0,0,"PCPE",0
45,"45063",417,310,303,1,7,"PCPE",0
28,"28133",5979,4140,4098,18,42,"PCPE",3
50,"50209",2601,1731,1721,13,10,"PCPE",1
40,"40145",1103,879,870,2,9,"PCPE",0
16,"16271",633,517,516,4,1,"PCPE",0
40,"40186",42,29,29,0,0,"PCPE",0
9,"9327",26,24,24,0,0,"PCPE",1
50,"50147",777,552,552,2,0,"PCPE",0
45,"45163",8298,5942,5855,28,87,"PCPE",7
4,"4080",209,162,162,3,0,"PCPE",0
28,"28010",9963,7745,7688,25,57,"PCPE",3
37,"37186",104,85,85,2,0,"PCPE",0
37,"37144",363,277,276,1,1,"PCPE",0
44,"44021",107,89,88,0,1,"PCPE",1
39,"39026",1750,1236,1224,11,12,"PCPE",1
4,"4081",355,287,287,0,0,"PCPE",0
50,"50148",316,233,229,4,4,"PCPE",0
37,"37382",173,137,137,0,0,"PCPE",0
16,"16065",388,320,314,2,6,"PCPE",1
4,"4051",436,360,356,1,4,"PCPE",0
9,"9417",40,32,32,1,0,"PCPE",0
16,"16272",221,176,175,0,1,"PCPE",1
28,"28165",1794,1293,1285,3,8,"PCPE",2
18,"18112",123,82,82,2,0,"PCPE",0
40,"40061",67,55,54,1,1,"PCPE",0
26,"26031",106,83,83,0,0,"PCPE",0
29,"29098",1253,917,895,9,22,"PCPE",0
29,"29009",1468,1069,1045,8,24,"PCPE",2
46,"46229",948,762,758,0,4,"PCPE",0
34,"34167",113,94,94,0,0,"PCPE",0
33,"33034",10612,6602,6536,62,66,"PCPE",15
26,"26172",30,23,23,0,0,"PCPE",0
49,"49225",147,91,90,0,1,"PCPE",0
22,"22223",75,58,58,0,0,"PCPE",0
47,"47049",101,68,68,0,0,"PCPE",0
3,"3132",534,436,435,3,1,"PCPE",0
40,"40190",53,45,44,0,1,"PCPE",0
16,"16274",121,92,92,0,0,"PCPE",0
49,"49226",255,198,195,0,3,"PCPE",0
39,"39058",810,559,557,2,2,"PCPE",0
9,"9063",209,168,167,2,1,"PCPE",1
9,"9195",59,36,36,2,0,"PCPE",0
26,"26136",107,85,85,0,0,"PCPE",1
9,"9196",149,103,103,1,0,"PCPE",0
37,"37274",118913,85506,84764,566,742,"PCPE",90
44,"44097",142,92,92,0,0,"PCPE",0
20,"20039",2111,1480,1472,14,8,"PCPE",0
45,"45068",160,126,126,0,0,"PCPE",0
47,"47077",246,193,191,1,2,"PCPE",0
11,"11017",3212,2233,2203,39,30,"PCPE",2
50,"50055",3611,2445,2407,22,38,"PCPE",3
37,"37107",10764,7379,7264,56,115,"PCPE",5
22,"22057",370,271,270,3,1,"PCPE",0
40,"40108",112,82,82,0,0,"PCPE",0
28,"28109",1576,1103,1098,1,5,"PCPE",0
18,"18025",288,220,220,1,0,"PCPE",0
37,"37058",58,45,45,0,0,"PCPE",0
16,"16024",129,98,97,0,1,"PCPE",0
48,"48009",783,586,575,1,11,"PCPE",1
22,"22096",301,240,240,0,0,"PCPE",0
9,"9334",50,39,37,0,2,"PCPE",0
23,"23077",620,501,494,3,7,"PCPE",0
16,"16163",74,62,62,0,0,"PCPE",0
28,"28014",33085,23626,23466,113,160,"PCPE",47
42,"42054",19,16,16,0,0,"PCPE",0
49,"49229",126,93,93,0,0,"PCPE",0
3,"3071",3982,3048,3012,26,36,"PCPE",3
48,"48904",3511,2625,2600,22,25,"PCPE",1
2,"2019",2405,1871,1835,12,36,"PCPE",1
18,"18913",813,566,559,2,7,"PCPE",0
1,"1047",968,673,668,5,5,"PCPE",1
46,"46154",808,636,631,5,5,"PCPE",0
1,"1006",175,140,140,0,0,"PCPE",0
34,"34033",17,17,17,0,0,"PCPE",0
37,"37110",113,86,86,1,0,"PCPE",0
18,"18165",4123,2787,2758,18,29,"PCPE",5
24,"24177",476,325,322,3,3,"PCPE",0
37,"37278",732,532,528,3,4,"PCPE",2
44,"44027",164,123,123,1,0,"PCPE",0
3,"3041",5954,4218,4194,22,24,"PCPE",3
28,"28079",2362038,1743924,1733354,8859,10570,"PCPE",1477
3,"3135",211,170,166,2,4,"PCPE",0
34,"34034",123,95,95,1,0,"PCPE",0
24,"24078",380,289,277,0,12,"PCPE",0
9,"9337",117,92,91,0,1,"PCPE",0
21,"21066",498,392,389,3,3,"PCPE",1
9,"9289",1451,1014,1000,5,14,"PCPE",0
39,"39032",1463,1087,1081,7,6,"PCPE",0
44,"44203",10,10,10,0,0,"PCPE",0
9,"9200",50,32,31,0,1,"PCPE",0
9,"9471",149,114,114,1,0,"PCPE",0
41,"41065",22779,14769,14636,132,133,"PCPE",8
28,"28170",2472,1640,1622,13,18,"PCPE",1
49,"49231",330,232,232,2,0,"PCPE",0
24,"24079",906,664,658,9,6,"PCPE",3
40,"40196",30,25,25,0,0,"PCPE",0
49,"49026",226,179,176,0,3,"PCPE",0
34,"34081",61,53,52,0,1,"PCPE",0
9,"9068",29,24,24,0,0,"PCPE",0
29,"29070",40333,25991,25728,214,263,"PCPE",21
3,"3137",651,492,489,5,3,"PCPE",0
42,"42058",113,92,89,0,3,"PCPE",0
21,"21068",998,605,592,11,13,"PCPE",0
2,"2023",568,486,479,3,7,"PCPE",0
26,"26038",89,68,67,0,1,"PCPE",0
24,"24080",213,164,161,3,3,"PCPE",0
29,"29071",934,596,588,3,8,"PCPE",0
47,"47081",45,36,35,1,1,"PCPE",0
47,"47163",290,230,228,3,2,"PCPE",0
9,"9325",190,130,129,2,1,"PCPE",0
16,"16269",419,336,332,2,4,"PCPE",0
47,"47002",23,21,20,1,1,"PCPE",0
22,"22232",93,71,69,1,2,"PCPE",0
42,"42021",83,55,55,3,0,"PCPE",0
40,"40073",401,345,343,3,2,"PCPE",0
46,"46131",49431,36570,36227,231,343,"PCPE",33
45,"45073",298,233,233,1,0,"PCPE",0
33,"33071",595,433,430,10,3,"PCPE",1
18,"18124",381,277,277,2,0,"PCPE",0
14,"14055",18557,12950,12764,178,186,"PCPE",7
42,"42106",14,10,10,0,0,"PCPE",0
24,"24114",3061,2025,1994,9,31,"PCPE",7
50,"50281",73,51,50,0,1,"PCPE",0
3,"3045",210,176,172,0,4,"PCPE",0
11,"11024",6723,4696,4634,44,62,"PCPE",5
45,"45174",301,237,233,1,4,"PCPE",0
47,"47164",378,313,311,1,2,"PCPE",0
16,"16904",472,378,373,4,5,"PCPE",0
4,"4060",445,348,345,5,3,"PCPE",0
39,"39065",252,191,189,1,2,"PCPE",0
37,"37284",316,246,238,4,8,"PCPE",0
50,"50251",8262,5946,5872,44,74,"PCPE",6
37,"37069",968,695,689,7,6,"PCPE",1
45,"45075",143,109,108,0,1,"PCPE",0
9,"9478",41,32,32,1,0,"PCPE",1
9,"9072",316,242,241,0,1,"PCPE",1
42,"42200",81,59,58,2,1,"PCPE",0
40,"40201",49,42,42,0,0,"PCPE",0
3,"3140",26070,18999,18742,174,257,"PCPE",22
47,"47004",1181,939,930,7,9,"PCPE",0
47,"47165",6955,4955,4303,66,652,"PCPE",3
48,"48016",5271,3694,3674,24,20,"PCPE",2
45,"45076",553,368,364,3,4,"PCPE",0
41,"41070",6032,4312,4258,44,54,"PCPE",8
3,"3901",1135,822,817,8,5,"PCPE",0
37,"37025",257,220,220,4,0,"PCPE",1
14,"14057",6136,4713,4631,47,82,"PCPE",7
34,"34132",114,89,86,0,3,"PCPE",0
24,"24183",805,555,549,6,6,"PCPE",2
37,"37245",346,261,259,2,2,"PCPE",0
41,"41004",56640,37110,36649,440,461,"PCPE",39
41,"41071",5586,3724,3661,22,63,"PCPE",4
24,"24018",174,143,141,0,2,"PCPE",0
23,"23088",6089,4558,4472,34,86,"PCPE",8
16,"16129",95,81,79,0,2,"PCPE",0
23,"23049",1813,1238,1222,9,16,"PCPE",5
37,"37286",207,152,145,4,7,"PCPE",0
9,"9075",112,91,91,3,0,"PCPE",0
37,"37026",189,146,146,0,0,"PCPE",1
22,"22236",253,200,200,0,0,"PCPE",0
3,"3018",12240,8853,8777,47,76,"PCPE",12
41,"41005",9068,6366,6281,58,85,"PCPE",8
44,"44241",533,396,389,0,7,"PCPE",1
45,"45177",2110,1679,1656,3,23,"PCPE",0
4,"4094",207,144,144,0,0,"PCPE",0
37,"37163",41,34,34,0,0,"PCPE",0
14,"14059",690,533,528,4,5,"PCPE",2
22,"22156",289,220,220,2,0,"PCPE",0
16,"16177",78,64,64,0,0,"PCPE",0
44,"44243",24,20,20,0,0,"PCPE",0
37,"37247",196,163,162,3,1,"PCPE",0
22,"22068",79,60,60,0,0,"PCPE",1
21,"21076",2121,1458,1437,17,21,"PCPE",3
22,"22239",88,72,72,0,0,"PCPE",0
46,"46057",487,321,317,1,4,"PCPE",1
50,"50254",180,118,116,1,2,"PCPE",0
42,"42161",137,102,101,0,1,"PCPE",0
46,"46058",1772,1398,1373,15,25,"PCPE",4
11,"11029",5430,3039,3000,44,39,"PCPE",1
29,"29079",2416,1788,1764,10,24,"PCPE",0
18,"18087",184857,134428,133526,864,902,"PCPE",124
47,"47086",3906,2970,2936,24,34,"PCPE",7
37,"37289",232,167,166,3,1,"PCPE",0
9,"9350",469,350,343,2,7,"PCPE",0
26,"26045",12,12,12,0,0,"PCPE",0
46,"46136",2537,1952,1930,11,22,"PCPE",4
37,"37165",33,26,25,0,1,"PCPE",0
40,"40080",59,43,41,0,2,"PCPE",0
28,"28089",3677,2748,2730,10,18,"PCPE",2
47,"47007",3769,2765,2736,24,29,"PCPE",3
18,"18135",4568,3009,2961,14,48,"PCPE",4
4,"4096",266,209,208,0,1,"PCPE",0
22,"22158",11995,8197,8126,62,71,"PCPE",22
44,"44038",104,83,82,0,1,"PCPE",0
18,"18136",1851,1354,1337,5,17,"PCPE",9
49,"49119",227,169,168,0,1,"PCPE",0
24,"24088",1029,791,789,10,2,"PCPE",1
37,"37030",85,66,66,0,0,"PCPE",0
21,"21078",2726,1793,1768,17,25,"PCPE",4
30,"30039",19277,13165,13054,75,111,"PCPE",14
18,"18043",123,80,79,1,1,"PCPE",1
42,"42070",34,27,26,1,1,"PCPE",0
4,"4097",248,189,189,1,0,"PCPE",0
9,"9217",351,251,249,6,2,"PCPE",0
18,"18137",989,761,760,7,1,"PCPE",0
16,"16135",134,92,92,2,0,"PCPE",0
29,"29081",261,197,197,1,0,"PCPE",0
47,"47009",107,86,85,0,1,"PCPE",0
22,"22244",52,38,37,0,1,"PCPE",0
49,"49120",74,53,52,0,1,"PCPE",0
3,"3052",970,769,755,8,14,"PCPE",0
3,"3115",255,222,220,2,2,"PCPE",0
3,"3022",145,125,125,0,0,"PCPE",0
39,"39042",5915,4530,4474,21,56,"PCPE",8
16,"16139",335,256,255,2,1,"PCPE",0
34,"34003",164,122,119,0,3,"PCPE",0
44,"44146",174,153,152,2,1,"PCPE",1
33,"33019",3072,2020,2005,18,15,"PCPE",5
1,"1021",473,310,309,0,1,"PCPE",1
4,"4035",8364,5810,5766,28,44,"PCPE",2
21,"21041",113337,72318,71637,748,681,"PCPE",115
46,"46250",578719,442973,440154,2541,2819,"PCPE",484
44,"44040",201,160,157,1,3,"PCPE",0
39,"39073",9837,7356,7298,31,58,"PCPE",6
16,"16140",27,16,16,0,0,"PCPE",0
34,"34004",5608,4120,4063,43,57,"PCPE",5
11,"11033",20903,12949,12771,164,178,"PCPE",16
40,"40084",62,55,52,0,3,"PCPE",0
40,"40212",27,23,22,2,1,"PCPE",0
23,"23096",2642,2164,2138,9,26,"PCPE",2
24,"24190",165,123,121,1,2,"PCPE",0
21,"21029",1562,1127,1097,14,30,"PCPE",1
29,"29084",27359,17843,17627,176,216,"PCPE",10
49,"49040",114,101,101,0,0,"PCPE",0
37,"37034",85,65,65,0,0,"PCPE",0
2,"2038",281,223,223,0,0,"PCPE",1
37,"37171",409,317,310,2,7,"PCPE",0
46,"46251",2462,1997,1956,6,41,"PCPE",2
40,"40086",685,561,552,4,9,"PCPE",0
37,"37255",49,34,34,1,0,"PCPE",0
2,"2079",2875,2209,2181,12,28,"PCPE",4
42,"42212",69,43,43,1,0,"PCPE",1
50,"50071",132,92,92,0,0,"PCPE",0
42,"42076",216,179,174,5,5,"PCPE",1
2,"2039",984,790,786,10,4,"PCPE",1
34,"34146",51,40,39,0,1,"PCPE",0
9,"9906",1219,902,898,8,4,"PCPE",4
47,"47173",880,644,638,20,6,"PCPE",0
28,"28093",2096,1670,1653,10,17,"PCPE",3
44,"44042",123,91,90,0,1,"PCPE",0
42,"42213",27,21,21,1,0,"PCPE",0
24,"24093",360,249,248,2,1,"PCPE",0
28,"28028",1755,1353,1344,6,9,"PCPE",1
14,"14066",5856,4150,4095,48,55,"PCPE",8
21,"21004",1631,1045,1028,13,17,"PCPE",0
23,"23020",1590,1370,1349,9,21,"PCPE",3
33,"33023",3321,2299,2265,31,34,"PCPE",2
22,"22165",487,364,360,6,4,"PCPE",0
18,"18098",6135,4206,4161,21,45,"PCPE",5
34,"34149",23,18,18,0,0,"PCPE",0
37,"37038",788,595,583,4,12,"PCPE",0
28,"28094",865,624,622,4,2,"PCPE",0
18,"18007",781,521,512,5,9,"PCPE",2
16,"16145",450,363,361,5,2,"PCPE",0
2,"2041",336,265,260,0,5,"PCPE",0
9,"9223",45,37,37,0,0,"PCPE",0
42,"42079",26,18,18,1,0,"PCPE",0
46,"46064",509,412,399,1,13,"PCPE",1
37,"37174",1056,820,812,3,8,"PCPE",0
18,"18145",10491,7538,7477,59,61,"PCPE",6
49,"49007",370,255,249,1,6,"PCPE",0
4,"4103",1476,1018,1008,3,10,"PCPE",1
40,"40089",222,167,164,0,3,"PCPE",1
37,"37175",403,314,312,6,2,"PCPE",1
24,"24095",320,234,232,0,2,"PCPE",0
45,"45088",2115,1351,1338,4,13,"PCPE",5
42,"42037",33,25,25,2,0,"PCPE",0
26,"26020",476,349,339,3,10,"PCPE",0
45,"45189",599,470,462,2,8,"PCPE",0
34,"34152",125,96,92,1,4,"PCPE",1
49,"49128",552,423,414,3,9,"PCPE",2
47,"47150",274,209,205,0,4,"PCPE",0
3,"3121",21273,14569,14468,62,101,"PCPE",16
2,"2003",132346,95878,95217,630,661,"PCPE",108
42,"42174",174,137,135,5,2,"PCPE",0
37,"37041",78,52,52,0,0,"PCPE",0
2,"2043",1239,937,927,3,10,"PCPE",0
44,"44153",1774,1135,1121,5,14,"PCPE",1
11,"11039",10018,6186,6109,103,77,"PCPE",6
9,"9225",83,55,54,0,1,"PCPE",0
34,"34154",74,55,53,1,2,"PCPE",0
3,"3059",20583,15125,15018,63,107,"PCPE",14
49,"49010",345,279,273,5,6,"PCPE",2
16,"16009",62,51,50,0,1,"PCPE",0
44,"44221",372,303,300,1,3,"PCPE",0
4,"4902",45437,28936,28699,214,237,"PCPE",23
28,"28032",4762,3428,3401,19,27,"PCPE",7
9,"9226",63,54,54,0,0,"PCPE",0
37,"37303",190,142,139,1,3,"PCPE",1
24,"24097",218,140,139,3,1,"PCPE",0
44,"44047",220,137,132,2,5,"PCPE",0
37,"37178",100,76,75,0,1,"PCPE",0
34,"34155",129,104,103,2,1,"PCPE",0
49,"49011",232,168,165,6,3,"PCPE",0
4,"4010",576,444,443,3,1,"PCPE",0
49,"49130",180,143,141,5,2,"PCPE",0
42,"42083",26,20,20,0,0,"PCPE",0
50,"50173",182,132,131,1,1,"PCPE",0
44,"44154",256,192,188,3,4,"PCPE",0
45,"45058",375,311,304,1,7,"PCPE",0
34,"34061",106,82,82,1,0,"PCPE",0
3,"3092",6743,5254,5178,37,76,"PCPE",6
37,"37347",468,348,346,2,2,"PCPE",1
28,"28129",8030,5986,5941,42,45,"PCPE",6
44,"44087",80,69,67,1,2,"PCPE",0
18,"18150",6763,4733,4678,21,55,"PCPE",7
37,"37263",342,237,229,0,8,"PCPE",1
34,"34018",209,168,164,1,4,"PCPE",0
42,"42085",189,129,127,3,2,"PCPE",0
28,"28062",292,231,226,1,5,"PCPE",0
2,"2047",117,88,88,2,0,"PCPE",0
26,"26057",48,38,38,0,0,"PCPE",0
16,"16151",64,61,59,0,2,"PCPE",0
46,"46224",159,121,121,0,0,"PCPE",0
29,"29002",1177,804,789,5,15,"PCPE",2
46,"46146",1654,1304,1278,7,26,"PCPE",0
50,"50205",90,63,61,0,2,"PCPE",0
46,"46068",346,276,266,6,10,"PCPE",0
21,"21053",3316,2141,2107,17,34,"PCPE",5
37,"37307",159,104,103,1,1,"PCPE",0
39,"39083",1135,679,670,8,9,"PCPE",0
40,"40014",58,46,45,0,1,"PCPE",0
47,"47097",325,266,265,0,1,"PCPE",0
11,"11901",5648,3676,3631,67,45,"PCPE",5
16,"16265",20,19,19,0,0,"PCPE",0
50,"50237",101,74,73,1,1,"PCPE",0
18,"18152",944,707,703,0,4,"PCPE",1
9,"9368",22,17,17,2,0,"PCPE",0
49,"49258",114,93,91,2,2,"PCPE",0
16,"16107",109,86,85,1,1,"PCPE",0
50,"50176",236,165,165,3,0,"PCPE",2
34,"34159",357,253,248,4,5,"PCPE",0
34,"34020",52,39,39,0,0,"PCPE",0
34,"34022",1082,873,861,9,12,"PCPE",1
40,"40100",270,213,211,2,2,"PCPE",0
26,"26060",84,62,62,2,0,"PCPE",1
22,"22014",243,192,188,3,4,"PCPE",0
9,"9230",38,32,32,0,0,"PCPE",0
16,"16154",4871,3547,3509,24,38,"PCPE",0
26,"26167",59,47,46,1,1,"PCPE",0
20,"20067",30828,19984,19882,140,102,"PCPE",14
49,"49259",89,66,65,1,1,"PCPE",0
22,"22246",76,50,50,0,0,"PCPE",0
28,"28036",2539,1899,1878,11,21,"PCPE",6
9,"9101",76,56,55,1,1,"PCPE",0
50,"50177",308,245,244,4,1,"PCPE",1
37,"37050",66,52,52,0,0,"PCPE",0
50,"50269",285,193,188,0,5,"PCPE",0
20,"20001",246,133,132,2,1,"PCPE",0
22,"22015",319,234,228,3,6,"PCPE",0
44,"44051",2683,1977,1946,17,31,"PCPE",3
47,"47099",150,135,135,1,0,"PCPE",0
45,"45196",1400,1047,1033,5,14,"PCPE",0
24,"24004",463,350,348,4,2,"PCPE",0
24,"24069",41,35,35,0,0,"PCPE",0
46,"46149",363,271,268,2,3,"PCPE",0
44,"44227",74,63,62,0,1,"PCPE",0
34,"34161",23,16,16,0,0,"PCPE",0
26,"26062",89,72,71,2,1,"PCPE",0
40,"40229",36,24,24,0,0,"PCPE",0
18,"18907",1843,1393,1388,4,5,"PCPE",1
18,"18157",1121,815,803,3,12,"PCPE",2
16,"16017",366,294,294,2,0,"PCPE",1
50,"50020",809,564,559,2,5,"PCPE",0
42,"42090",91,69,67,1,2,"PCPE",0
24,"24103",283,163,157,1,6,"PCPE",1
37,"37313",550,386,384,2,2,"PCPE",0
26,"26170",446,330,326,2,4,"PCPE",0
9,"9373",425,287,285,2,2,"PCPE",0
50,"50241",588,415,410,4,5,"PCPE",1
47,"47075",4856,3681,3637,24,44,"PCPE",2
26,"26030",16,16,15,0,1,"PCPE",0
9,"9456",130,97,96,0,1,"PCPE",0
44,"44266",115,90,90,0,0,"PCPE",0
50,"50272",12904,8880,8819,84,61,"PCPE",7
26,"26171",176,139,133,1,6,"PCPE",0
18,"18159",995,797,795,2,2,"PCPE",2
44,"44022",493,323,318,7,5,"PCPE",0
37,"37012",154,116,115,1,1,"PCPE",0
3,"3037",346,282,278,3,4,"PCPE",0
37,"37147",193,134,132,1,2,"PCPE",0
49,"49139",171,135,135,0,0,"PCPE",0
20,"20005",1260,738,736,11,2,"PCPE",0
40,"40148",238,188,187,2,1,"PCPE",1
45,"45132",2197,1645,1632,14,13,"PCPE",0
4,"4083",1776,1345,1336,6,9,"PCPE",0
46,"46099",901,689,684,1,5,"PCPE",1
39,"39088",69,52,52,0,0,"PCPE",0
47,"47022",59,50,49,0,1,"PCPE",0
48,"48037",673,481,478,5,3,"PCPE",0
47,"47102",291,230,220,1,10,"PCPE",1
28,"28040",15811,10118,10009,56,109,"PCPE",10
46,"46152",96,68,68,0,0,"PCPE",0
22,"22907",1435,1059,1046,18,13,"PCPE",2
50,"50273",30,22,22,0,0,"PCPE",0
24,"24210",503,358,356,3,2,"PCPE",0
42,"42053",26,19,19,1,0,"PCPE",0
18,"18162",938,698,686,1,12,"PCPE",2
45,"45100",188,150,150,0,0,"PCPE",2
37,"37190",215,171,171,1,0,"PCPE",0
16,"16161",57,48,46,0,2,"PCPE",0
9,"9378",31,24,23,0,1,"PCPE",0
9,"9332",140,106,106,2,0,"PCPE",0
37,"37149",68,64,64,0,0,"PCPE",0
40,"40192",159,117,117,2,0,"PCPE",1
9,"9239",52,40,39,0,1,"PCPE",0
16,"16216",315,268,265,1,3,"PCPE",0
9,"9197",144,111,109,1,2,"PCPE",0
9,"9464",35,27,27,0,0,"PCPE",0
37,"37192",356,231,227,2,4,"PCPE",0
46,"46231",2421,1721,1708,14,13,"PCPE",2
18,"18027",2570,1711,1700,13,11,"PCPE",0
46,"46075",150,130,123,1,7,"PCPE",0
46,"46101",860,716,705,3,11,"PCPE",4
28,"28110",1944,1478,1463,4,15,"PCPE",0
34,"34032",40,33,33,1,0,"PCPE",0
1,"1004",1399,1008,995,8,13,"PCPE",2
42,"42097",23,14,11,0,3,"PCPE",0
16,"16165",61,54,53,0,1,"PCPE",0
26,"26068",80,61,61,1,0,"PCPE",0
44,"44167",38,31,31,0,0,"PCPE",0
2,"2060",1294,997,983,2,14,"PCPE",0
50,"50087",26,17,17,1,0,"PCPE",0
47,"47161",3918,3145,3126,12,19,"PCPE",4
21,"21065",273,186,184,0,2,"PCPE",1
23,"23041",499,398,394,2,4,"PCPE",0
47,"47187",84,61,58,0,3,"PCPE",0
34,"34225",4921,3588,3559,30,29,"PCPE",7
18,"18029",1833,1196,1190,12,6,"PCPE",0
39,"39001",2102,1622,1601,18,21,"PCPE",1
50,"50185",133,108,108,1,0,"PCPE",0
23,"23001",963,801,799,1,2,"PCPE",0
39,"39092",894,626,620,1,6,"PCPE",0
49,"49268",403,313,309,1,4,"PCPE",0
45,"45136",5845,4091,4019,25,72,"PCPE",2
4,"4022",347,249,249,7,0,"PCPE",1
40,"40070",149,107,105,1,2,"PCPE",1
33,"33069",3491,2430,2390,17,40,"PCPE",4
23,"23080",1762,1332,1322,4,10,"PCPE",0
47,"47188",111,88,88,3,0,"PCPE",0
48,"48011",9673,6468,6423,45,45,"PCPE",2
42,"42100",32,30,30,0,0,"PCPE",0
18,"18030",576,413,409,6,4,"PCPE",2
22,"22143",217,143,141,1,2,"PCPE",0
22,"22024",226,174,171,3,3,"PCPE",0
24,"24214",656,490,485,3,5,"PCPE",0
9,"9246",620,451,444,2,7,"PCPE",0
29,"29015",31880,22220,21952,190,268,"PCPE",36
24,"24148",1672,1249,1241,23,8,"PCPE",2
18,"18122",16114,11098,10945,83,153,"PCPE",19
50,"50186",42,31,31,0,0,"PCPE",0
44,"44169",342,252,252,3,0,"PCPE",0
28,"28045",33328,24620,24434,146,186,"PCPE",29
24,"24215",152,113,113,0,0,"PCPE",0
37,"37065",312,223,222,3,1,"PCPE",0
50,"50090",150,113,112,0,1,"PCPE",0
20,"20077",5213,3614,3591,36,23,"PCPE",2
34,"34229",68,57,56,1,1,"PCPE",0
50,"50123",449,334,331,1,3,"PCPE",0
47,"47109",179,138,138,2,0,"PCPE",0
33,"33010",1822,1190,1180,17,10,"PCPE",2
14,"14073",2891,2079,2016,13,63,"PCPE",0
24,"24113",366,293,287,5,6,"PCPE",0
37,"37197",84,57,57,2,0,"PCPE",0
22,"22025",1071,676,669,18,7,"PCPE",1
42,"42059",21,15,14,0,1,"PCPE",0
34,"34178",117,103,103,0,0,"PCPE",0
24,"24015",2265,1649,1635,18,14,"PCPE",1
44,"44171",178,126,124,2,2,"PCPE",0
33,"33011",11260,6250,6163,83,87,"PCPE",13
20,"20079",17886,11860,11799,91,61,"PCPE",9
28,"28046",4460,3447,3422,16,25,"PCPE",3
26,"26039",39,35,35,2,0,"PCPE",0
33,"33072",1566,1008,994,11,14,"PCPE",2
14,"14027",7925,5836,5746,58,90,"PCPE",8
22,"22149",305,228,228,0,0,"PCPE",2
2,"2066",234,189,187,1,2,"PCPE",0
50,"50091",41,36,36,0,0,"PCPE",0
4,"4027",250,159,159,0,0,"PCPE",0
39,"39004",1518,1090,1074,4,16,"PCPE",3
46,"46210",330,277,277,2,0,"PCPE",0
39,"39005",1380,1053,1046,9,7,"PCPE",3
44,"44065",60,40,40,0,0,"PCPE",0
49,"49273",187,112,112,0,0,"PCPE",0
28,"28075",5621,4186,4148,26,38,"PCPE",5
16,"16234",25,18,18,0,0,"PCPE",0
39,"39035",9502,7017,6928,57,89,"PCPE",7
40,"40119",169,138,133,1,5,"PCPE",0
45,"45108",509,412,411,1,1,"PCPE",0
46,"46159",22857,16840,16697,128,143,"PCPE",30
1,"1014",371,280,272,4,8,"PCPE",0
9,"9389",73,60,60,1,0,"PCPE",0
45,"45008",139,118,118,1,0,"PCPE",0
50,"50282",69,54,54,0,0,"PCPE",0
42,"42110",59,45,45,2,0,"PCPE",0
37,"37070",529,399,392,1,7,"PCPE",0
9,"9120",38,32,32,1,0,"PCPE",0
26,"26183",64,49,49,0,0,"PCPE",0
37,"37329",42,34,34,0,0,"PCPE",0
9,"9250",269,196,194,1,2,"PCPE",0
9,"9390",611,484,482,3,2,"PCPE",0
22,"22029",127,100,100,0,0,"PCPE",0
41,"41037",3213,2376,2342,30,34,"PCPE",2
9,"9166",97,81,81,0,0,"PCPE",0
44,"44208",37,22,22,0,0,"PCPE",0
49,"49153",174,136,132,0,4,"PCPE",0
46,"46030",800,627,614,5,13,"PCPE",2
50,"50161",106,75,72,0,3,"PCPE",0
18,"18038",1066,828,802,1,26,"PCPE",5
24,"24221",795,543,538,7,5,"PCPE",0
46,"46160",1913,1452,1436,1,16,"PCPE",0
45,"45111",65,50,50,0,0,"PCPE",0
29,"29021",161,108,107,4,1,"PCPE",1
4,"4063",1096,776,768,2,8,"PCPE",0
21,"21034",1188,798,786,8,12,"PCPE",4
45,"45011",278,239,233,1,6,"PCPE",1
37,"37203",158,117,117,0,0,"PCPE",0
28,"28118",57,46,45,0,1,"PCPE",0
40,"40204",167,113,110,1,3,"PCPE",0
24,"24118",126,88,88,1,0,"PCPE",0
41,"41072",4054,2965,2933,14,32,"PCPE",0
48,"48048",557,395,393,5,2,"PCPE",0
37,"37073",586,448,438,2,10,"PCPE",1
9,"9253",109,94,91,1,3,"PCPE",0
46,"46239",442,340,338,3,2,"PCPE",1
34,"34046",41,36,35,0,1,"PCPE",0
29,"29022",179,137,136,0,1,"PCPE",0
39,"39008",13877,10258,10153,96,105,"PCPE",8
50,"50193",651,514,501,2,13,"PCPE",1
1,"1058",1345,799,793,7,6,"PCPE",0
49,"49156",237,184,175,0,9,"PCPE",0
20,"20903",4330,2756,2734,28,22,"PCPE",3
4,"4031",2338,1772,1762,2,10,"PCPE",1
23,"23011",2170,1515,1496,7,19,"PCPE",9
24,"24223",2610,1917,1908,39,9,"PCPE",6
18,"18179",538,376,374,6,2,"PCPE",0
34,"34186",52,45,45,0,0,"PCPE",0
45,"45113",1915,1390,1366,6,24,"PCPE",2
28,"28119",2092,1590,1582,12,8,"PCPE",2
41,"41007",12341,8039,7844,103,195,"PCPE",15
37,"37374",1166,935,919,9,16,"PCPE",1
26,"26079",634,520,512,4,8,"PCPE",1
49,"49036",506,374,367,2,7,"PCPE",1
47,"47195",459,345,344,4,1,"PCPE",0
50,"50256",83,53,53,0,0,"PCPE",0
50,"50005",229,189,189,1,0,"PCPE",1
3,"3081",1436,1084,1075,5,9,"PCPE",0
24,"24120",341,246,244,1,2,"PCPE",0
47,"47034",72,58,58,3,0,"PCPE",0
23,"23014",2559,1971,1942,13,29,"PCPE",11
16,"16186",456,375,371,0,4,"PCPE",0
3,"3114",1562,1198,1188,9,10,"PCPE",0
47,"47224",87,76,76,0,0,"PCPE",0
40,"40040",2607,1843,1828,19,15,"PCPE",1
44,"44179",337,229,226,1,3,"PCPE",0
9,"9001",27,22,22,0,0,"PCPE",0
49,"49038",99,71,65,1,6,"PCPE",0
42,"42118",23,17,17,0,0,"PCPE",0
22,"22074",313,228,225,4,3,"PCPE",1
16,"16042",1157,933,921,4,12,"PCPE",0
9,"9258",172,141,139,5,2,"PCPE",0
46,"46242",333,267,266,0,1,"PCPE",1
39,"39011",1585,1169,1160,5,9,"PCPE",0
46,"46164",11771,8564,8483,64,81,"PCPE",9
44,"44075",323,248,246,0,2,"PCPE",0
24,"24225",1014,752,739,10,13,"PCPE",1
3,"3083",5586,3971,3928,33,43,"PCPE",9
28,"28122",513,375,370,2,5,"PCPE",0
9,"9128",80,63,63,0,0,"PCPE",0
41,"41043",639,436,427,5,9,"PCPE",0
45,"45183",2220,1444,1428,3,16,"PCPE",7
49,"49245",262,176,173,2,3,"PCPE",0
1,"1022",799,557,544,2,13,"PCPE",0
37,"37169",176,127,126,0,1,"PCPE",0
50,"50101",864,603,597,8,6,"PCPE",2
29,"29026",1057,751,748,5,3,"PCPE",2
30,"30011",4697,3421,3383,15,38,"PCPE",4
48,"48053",895,666,662,6,4,"PCPE",0
44,"44076",2203,1690,1663,18,27,"PCPE",1
49,"49162",186,142,140,1,2,"PCPE",0
45,"45016",4204,3146,3105,22,41,"PCPE",3
18,"18046",1832,1160,1140,6,20,"PCPE",1
9,"9129",104,83,83,0,0,"PCPE",0
2,"2077",55,47,47,0,0,"PCPE",0
23,"23056",3088,2243,2203,15,40,"PCPE",8
9,"9174",794,559,552,4,7,"PCPE",1
37,"37082",796,551,544,4,7,"PCPE",0
23,"23017",1572,1269,1257,4,12,"PCPE",0
50,"50102",859,658,653,8,5,"PCPE",0
50,"50198",54,41,41,1,0,"PCPE",0
40,"40130",130,107,106,1,1,"PCPE",0
26,"26050",113,88,85,0,3,"PCPE",0
16,"16248",859,654,636,5,18,"PCPE",1
23,"23018",2325,1668,1653,10,15,"PCPE",4
47,"47037",168,138,133,0,5,"PCPE",0
16,"16046",245,180,180,1,0,"PCPE",0
3,"3085",272,217,213,0,4,"PCPE",2
4,"4037",1314,969,955,6,14,"PCPE",3
34,"34201",193,158,155,1,3,"PCPE",0
49,"49042",244,178,176,1,2,"PCPE",0
42,"42123",164,117,116,4,1,"PCPE",0
16,"16047",232,175,175,2,0,"PCPE",0
16,"16048",408,313,312,1,1,"PCPE",0
22,"22043",93,66,65,0,1,"PCPE",0
18,"18048",2387,1683,1662,8,21,"PCPE",2
45,"45019",7377,5307,5251,37,56,"PCPE",11
37,"37298",179,127,126,0,1,"PCPE",0
47,"47012",113,93,93,0,0,"PCPE",0
20,"20058",755,529,525,3,4,"PCPE",0
26,"26158",251,214,210,0,4,"PCPE",0
34,"34009",31,29,29,1,0,"PCPE",0
2,"2081",18342,13244,13075,80,169,"PCPE",11
14,"14010",4027,2850,2807,19,43,"PCPE",5
9,"9010",32,23,23,1,0,"PCPE",0
18,"18187",557,383,379,0,4,"PCPE",0
41,"41014",2492,1882,1852,11,30,"PCPE",5
48,"48056",966,705,700,5,5,"PCPE",0
18,"18188",1653,1183,1175,5,8,"PCPE",2
46,"46168",1938,1495,1486,2,9,"PCPE",0
34,"34204",46,41,41,0,0,"PCPE",0
14,"14011",578,464,462,4,2,"PCPE",0
37,"37216",302,252,248,3,4,"PCPE",0
16,"16050",245,201,195,1,6,"PCPE",0
45,"45020",1290,1037,1026,6,11,"PCPE",0
29,"29031",1614,1107,1094,13,13,"PCPE",1
9,"9407",28,23,23,0,0,"PCPE",0
37,"37343",60,47,47,0,0,"PCPE",0
24,"24028",388,292,288,2,4,"PCPE",2
46,"46247",1006,714,710,3,4,"PCPE",1
28,"28031",2048,1500,1486,3,14,"PCPE",0
50,"50293",413,276,275,4,1,"PCPE",0
33,"33024",226679,158750,157564,1209,1186,"PCPE",318
34,"34205",61,50,50,0,0,"PCPE",0
18,"18051",1147,817,810,8,7,"PCPE",0
46,"46065",1579,1174,1163,8,11,"PCPE",1
44,"44045",366,274,269,2,5,"PCPE",0
42,"42081",145,102,100,1,2,"PCPE",0
18,"18053",1630,1082,1076,8,6,"PCPE",4
9,"9012",89,64,63,0,1,"PCPE",0
50,"50202",152,100,99,1,1,"PCPE",0
45,"45022",391,285,281,3,4,"PCPE",0
16,"16196",633,508,503,2,5,"PCPE",0
42,"42128",42,42,41,1,1,"PCPE",0
46,"46170",3417,2714,2688,10,26,"PCPE",2
41,"41903",6757,4562,4504,51,58,"PCPE",9
16,"16197",59,42,42,0,0,"PCPE",0
26,"26055",39,32,32,0,0,"PCPE",0
24,"24130",438,323,321,4,2,"PCPE",0
42,"42001",278,212,210,3,2,"PCPE",0
34,"34208",51,42,42,0,0,"PCPE",0
46,"46092",276,192,189,0,3,"PCPE",0
1,"1032",517,361,354,1,7,"PCPE",0
50,"50014",147,94,94,0,0,"PCPE",0
9,"9014",195,115,114,1,1,"PCPE",0
39,"39019",2079,1560,1531,10,29,"PCPE",2
49,"49169",35,26,26,0,0,"PCPE",0
4,"4044",1547,1166,1156,5,10,"PCPE",3
50,"50296",396,286,275,4,11,"PCPE",0
1,"1033",651,484,479,2,5,"PCPE",0
4,"4045",1757,1309,1288,6,21,"PCPE",4
45,"45024",1062,793,785,4,8,"PCPE",1
49,"49050",507,342,338,1,4,"PCPE",1
22,"22083",463,394,390,5,4,"PCPE",1
50,"50045",1243,926,925,6,1,"PCPE",1
46,"46067",1753,1418,1393,1,25,"PCPE",1
39,"39081",437,337,332,4,5,"PCPE",0
29,"29001",4170,3106,3068,19,38,"PCPE",3
50,"50204",2436,1785,1770,3,15,"PCPE",5
45,"45092",232,197,191,0,6,"PCPE",0
47,"47125",58,46,46,0,0,"PCPE",0
16,"16199",30,25,25,1,0,"PCPE",0
49,"49012",73,43,43,0,0,"PCPE",0
46,"46172",5042,3504,3477,22,27,"PCPE",2
40,"40012",269,192,191,2,1,"PCPE",0
3,"3001",337,269,268,0,1,"PCPE",1
34,"34211",178,155,152,1,3,"PCPE",0
24,"24033",205,158,157,0,1,"PCPE",0
44,"44223",72,54,54,0,0,"PCPE",0
41,"41020",12887,8210,8118,82,92,"PCPE",10
49,"49053",931,709,699,8,10,"PCPE",0
44,"44088",29,21,21,0,0,"PCPE",0
9,"9017",89,68,67,4,1,"PCPE",0
4,"4904",1777,1230,1221,12,9,"PCPE",2
40,"40141",842,593,584,10,9,"PCPE",0
49,"49172",527,347,343,1,4,"PCPE",0
44,"44156",45,31,31,1,0,"PCPE",0
49,"49133",304,214,213,1,1,"PCPE",0
44,"44089",45,39,39,1,0,"PCPE",0
45,"45127",696,514,511,3,3,"PCPE",0
46,"46095",610,467,459,1,8,"PCPE",2
16,"16058",103,77,77,0,0,"PCPE",0
1,"1036",14955,10052,9959,55,93,"PCPE",20
22,"22175",197,143,142,1,1,"PCPE",4
21,"21014",4016,3025,2991,21,34,"PCPE",4
14,"14016",1337,1072,1060,2,12,"PCPE",2
39,"39023",6330,4737,4672,25,65,"PCPE",5
18,"18904",775,565,558,1,7,"PCPE",2
18,"18062",10393,7235,7161,63,74,"PCPE",9
40,"40142",53,39,37,0,2,"PCPE",0
23,"23031",747,637,619,0,18,"PCPE",1
37,"37351",281,229,227,0,2,"PCPE",0
42,"42008",57,43,43,0,0,"PCPE",1
49,"49055",102,82,82,2,0,"PCPE",0
46,"46018",608,515,511,0,4,"PCPE",1
16,"16206",204,158,157,6,1,"PCPE",0
9,"9275",192,129,129,2,0,"PCPE",0
44,"44092",81,59,57,0,2,"PCPE",0
46,"46044",4218,3222,3158,18,64,"PCPE",3
24,"24068",457,344,340,0,4,"PCPE",0
37,"37100",80,61,61,1,0,"PCPE",0
20,"20002",346,203,203,4,0,"PCPE",0
45,"45029",201,171,171,1,0,"PCPE",0
16,"16062",24,23,23,0,0,"PCPE",0
47,"47209",41,34,34,0,0,"PCPE",0
41,"41023",7905,5402,5347,41,55,"PCPE",6
23,"23032",566,450,448,4,2,"PCPE",0
49,"49056",300,211,208,2,3,"PCPE",0
34,"34217",1207,937,923,8,14,"PCPE",1
46,"46175",456,389,387,3,2,"PCPE",0
42,"42185",26,22,22,0,0,"PCPE",0
49,"49223",752,608,600,4,8,"PCPE",0
18,"18064",377,291,290,2,1,"PCPE",0
46,"46019",8849,7072,7004,33,68,"PCPE",6
46,"46071",464,383,377,0,6,"PCPE",0
34,"34069",2266,1666,1637,11,29,"PCPE",1
16,"16157",211,179,179,2,0,"PCPE",0
45,"45130",317,253,250,1,3,"PCPE",0
42,"42141",112,80,80,0,0,"PCPE",0
24,"24139",2183,1548,1525,16,23,"PCPE",1
29,"29096",2810,1944,1909,31,35,"PCPE",8
42,"42142",50,35,35,1,0,"PCPE",0
3,"3098",505,393,386,0,7,"PCPE",0
28,"28135",948,713,709,4,4,"PCPE",1
33,"33033",9873,6512,6431,68,81,"PCPE",23
46,"46020",3760,2916,2866,22,50,"PCPE",2
24,"24141",95,85,84,0,1,"PCPE",0
49,"49059",94,64,64,0,0,"PCPE",0
9,"9022",66,57,57,1,0,"PCPE",0
24,"24209",2769,1888,1865,12,23,"PCPE",2
20,"20071",14801,9466,9421,60,45,"PCPE",6
39,"39087",41985,31178,30805,228,373,"PCPE",80
29,"29008",14596,9519,9407,94,112,"PCPE",8
46,"46177",4690,3579,3526,19,53,"PCPE",8
37,"37356",87,67,65,0,2,"PCPE",0
48,"48007",364,240,240,5,0,"PCPE",0
18,"18114",609,424,422,8,2,"PCPE",0
47,"47158",889,667,659,8,8,"PCPE",0
41,"41060",15242,10021,9847,86,174,"PCPE",6
28,"28068",10955,8136,8076,49,60,"PCPE",12
9,"9280",28,20,20,0,0,"PCPE",0
28,"28136",647,528,518,2,10,"PCPE",0
49,"49179",371,238,237,0,1,"PCPE",0
37,"37233",61,48,47,1,1,"PCPE",1
16,"16067",123,87,87,0,0,"PCPE",0
40,"40021",27,27,26,0,1,"PCPE",0
49,"49061",150,114,112,2,2,"PCPE",0
3,"3100",503,440,437,0,3,"PCPE",1
26,"26173",6,6,6,1,0,"PCPE",0
47,"47131",170,134,128,2,6,"PCPE",0
9,"9025",122,83,83,1,0,"PCPE",0
18,"18068",1569,1189,1166,6,23,"PCPE",3
50,"50119",927,724,713,5,11,"PCPE",0
28,"28137",1664,1232,1220,7,12,"PCPE",2
45,"45201",3447,2082,2050,9,32,"PCPE",3
28,"28069",50,44,41,0,3,"PCPE",0
4,"4019",249,196,196,1,0,"PCPE",0
41,"41061",2195,1749,1703,11,46,"PCPE",1
22,"22137",1069,727,718,3,9,"PCPE",2
49,"49142",249,180,179,0,1,"PCPE",1
16,"16162",43,35,34,0,1,"PCPE",0
44,"44025",6009,4087,3997,25,90,"PCPE",6
37,"37108",99,79,78,0,1,"PCPE",0
16,"16217",74,62,62,0,0,"PCPE",0
40,"40024",856,651,639,6,12,"PCPE",0
37,"37150",41,34,34,0,0,"PCPE",0
16,"16070",30,26,26,1,0,"PCPE",0
45,"45135",4269,3340,3288,8,52,"PCPE",3
46,"46049",281,232,224,0,8,"PCPE",1
45,"45035",281,212,209,1,3,"PCPE",0
42,"42016",18,14,14,0,0,"PCPE",0
50,"50214",27,18,17,0,1,"PCPE",0
4,"4055",371,310,308,0,2,"PCPE",0
9,"9288",90,70,70,0,0,"PCPE",0
49,"49064",515,346,338,6,8,"PCPE",0
23,"23040",1480,1199,1192,2,7,"PCPE",12
37,"37193",390,279,275,4,4,"PCPE",1
39,"39091",1926,1493,1476,10,17,"PCPE",0
45,"45036",656,471,469,2,2,"PCPE",1
34,"34174",200,159,154,5,5,"PCPE",0
18,"18071",5579,4044,3985,37,59,"PCPE",5
34,"34077",347,244,238,4,6,"PCPE",0
49,"49184",172,115,112,0,3,"PCPE",0
40,"40154",20,15,15,0,0,"PCPE",0
3,"3011",7753,5464,5415,27,49,"PCPE",6
33,"33038",2303,1584,1559,13,25,"PCPE",5
26,"26069",236,194,189,0,5,"PCPE",0
22,"22188",82,60,59,6,1,"PCPE",0
50,"50088",302,246,237,5,9,"PCPE",0
33,"33008",1777,1238,1229,3,9,"PCPE",3
24,"24110",1247,899,892,6,7,"PCPE",0
33,"33039",1655,1223,1209,12,14,"PCPE",2
37,"37113",433,334,333,3,1,"PCPE",1
20,"20010",1499,992,986,9,6,"PCPE",1
21,"21026",266,166,159,3,7,"PCPE",1
45,"45138",1091,877,871,4,6,"PCPE",0
44,"44028",183,151,150,4,1,"PCPE",0
34,"34228",83,74,74,1,0,"PCPE",0
50,"50027",225,178,177,2,1,"PCPE",0
44,"44102",30,27,26,0,1,"PCPE",0
39,"39063",967,697,690,9,7,"PCPE",1
42,"42103",575,450,445,1,5,"PCPE",0
3,"3105",5373,3911,3828,15,83,"PCPE",6
16,"16227",113,93,93,0,0,"PCPE",0
50,"50217",446,342,342,1,0,"PCPE",0
22,"22190",119,86,85,0,1,"PCPE",0
37,"37114",84,70,69,2,1,"PCPE",0
42,"42020",4263,2877,2821,35,56,"PCPE",3
46,"46182",1266,929,922,6,7,"PCPE",3
22,"22103",682,508,502,3,6,"PCPE",0
28,"28017",1208,907,899,7,8,"PCPE",1
49,"49068",462,310,304,4,6,"PCPE",0
41,"41033",5075,3313,3277,34,36,"PCPE",4
24,"24179",290,197,192,4,5,"PCPE",0
47,"47189",152,119,118,0,1,"PCPE",0
28,"28074",138947,103687,102762,620,925,"PCPE",120
45,"45140",1087,833,823,3,10,"PCPE",1
39,"39034",286,188,185,5,3,"PCPE",1
26,"26108",266,215,213,0,2,"PCPE",0
1,"1053",582,321,320,4,1,"PCPE",0
3,"3106",583,480,478,2,2,"PCPE",1
46,"46183",5993,4443,4381,19,62,"PCPE",2
24,"24149",152,120,116,3,4,"PCPE",0
3,"3014",237287,167428,166445,847,983,"PCPE",374
44,"44031",97,62,62,0,0,"PCPE",0
44,"44172",301,218,216,4,2,"PCPE",0
42,"42060",38,21,19,1,2,"PCPE",0
50,"50030",215,141,140,1,1,"PCPE",0
9,"9429",56,41,41,0,0,"PCPE",0
16,"16231",46,37,37,0,0,"PCPE",0
34,"34231",229,168,167,1,1,"PCPE",0
9,"9163",582,467,459,2,8,"PCPE",0
16,"16081",48,34,34,0,0,"PCPE",0
40,"40159",142,100,99,1,1,"PCPE",0
37,"37117",1494,1067,1048,3,19,"PCPE",1
9,"9035",311,227,225,2,2,"PCPE",0
28,"28084",15859,11156,11058,64,98,"PCPE",19
9,"9476",62,43,43,0,0,"PCPE",0
24,"24181",1493,1054,1045,5,9,"PCPE",0
49,"49075",137,120,119,0,1,"PCPE",0
41,"41035",1108,794,780,7,14,"PCPE",0
21,"21031",1199,852,837,6,15,"PCPE",1
50,"50902",87,79,79,2,0,"PCPE",0
4,"4061",638,506,498,4,8,"PCPE",1
33,"33043",683,446,441,2,5,"PCPE",3
47,"47056",87,67,67,0,0,"PCPE",0
44,"44207",156,118,115,4,3,"PCPE",0
46,"46029",20613,14964,14879,93,85,"PCPE",6
47,"47139",1040,777,767,6,10,"PCPE",1
16,"16237",110,87,87,0,0,"PCPE",0
34,"34086",103,89,88,0,1,"PCPE",0
48,"48077",3364,2437,2431,18,6,"PCPE",1
30,"30035",18671,13103,12979,54,124,"PCPE",12
1,"1016",433,228,226,5,2,"PCPE",2
50,"50252",5138,3642,3611,24,31,"PCPE",1
44,"44034",139,109,108,0,1,"PCPE",0
28,"28078",38,32,32,0,0,"PCPE",0
37,"37161",136,106,106,1,0,"PCPE",0
16,"16036",126,109,106,0,3,"PCPE",0
34,"34087",129,103,102,1,1,"PCPE",1
45,"45043",793,657,649,1,8,"PCPE",0
50,"50032",261,189,189,5,0,"PCPE",0
9,"9037",111,91,91,0,0,"PCPE",0
16,"16909",699,535,532,0,3,"PCPE",1
49,"49116",383,276,269,3,7,"PCPE",0
40,"40163",53,44,43,0,1,"PCPE",1
33,"33045",4487,3057,2999,28,58,"PCPE",3
16,"16085",138,113,112,0,1,"PCPE",0
37,"37287",310,213,210,2,3,"PCPE",0
46,"46135",9680,7682,7634,36,48,"PCPE",8
1,"1017",849,571,565,5,6,"PCPE",0
40,"40036",515,421,410,3,11,"PCPE",1
9,"9303",86,68,68,0,0,"PCPE",0
50,"50130",383,240,238,2,2,"PCPE",0
44,"44110",49,42,42,1,0,"PCPE",0
45,"45045",1318,905,888,5,17,"PCPE",1
18,"18086",349,274,272,0,2,"PCPE",0
37,"37372",144,111,108,0,3,"PCPE",0
37,"37028",147,116,112,0,4,"PCPE",0
29,"29055",1796,1354,1336,11,18,"PCPE",1
9,"9038",119,100,100,0,0,"PCPE",0
24,"24155",471,388,384,6,4,"PCPE",0
48,"48080",9976,6820,6763,62,57,"PCPE",5
47,"47142",141,99,97,0,2,"PCPE",0
34,"34238",330,268,266,3,2,"PCPE",1
26,"26012",23,23,23,1,0,"PCPE",0
50,"50224",72,57,56,2,1,"PCPE",0
20,"20019",9986,6428,6392,48,36,"PCPE",10
9,"9304",199,157,155,3,2,"PCPE",0
50,"50163",3689,2702,2680,37,22,"PCPE",7
47,"47143",118,91,90,0,1,"PCPE",0
3,"3020",99,79,79,0,0,"PCPE",0
49,"49199",254,193,189,3,4,"PCPE",0
22,"22202",141,119,119,0,0,"PCPE",0
4,"4066",13571,8786,8724,50,62,"PCPE",13
18,"18088",1541,1124,1117,5,7,"PCPE",1
29,"29057",357,241,238,1,3,"PCPE",0
46,"46111",10930,7931,7828,44,103,"PCPE",5
39,"39041",1760,1370,1354,9,16,"PCPE",4
16,"16041",358,275,271,0,4,"PCPE",0
21,"21038",1095,705,693,4,12,"PCPE",1
21,"21079",722,494,490,5,4,"PCPE",2
34,"34092",288,230,226,1,4,"PCPE",1
14,"14033",1283,971,959,9,12,"PCPE",2
26,"26117",2152,1625,1605,10,20,"PCPE",1
18,"18089",14719,10163,10099,63,64,"PCPE",9
37,"37291",272,207,206,0,1,"PCPE",0
4,"4067",570,441,436,2,5,"PCPE",0
34,"34241",18,13,13,1,0,"PCPE",0
21,"21039",311,225,223,1,2,"PCPE",1
44,"44039",221,165,159,0,6,"PCPE",0
22,"22001",225,151,151,1,0,"PCPE",0
47,"47061",256,212,211,2,1,"PCPE",0
45,"45148",292,223,223,0,0,"PCPE",0
46,"46112",536,455,450,2,5,"PCPE",0
46,"46034",1758,1390,1379,4,11,"PCPE",2
44,"44213",62,50,50,0,0,"PCPE",0
37,"37168",439,316,311,0,5,"PCPE",0
40,"40001",702,560,554,3,6,"PCPE",0
45,"45116",687,509,505,1,4,"PCPE",0
9,"9353",76,57,56,1,1,"PCPE",1
40,"40128",129,95,93,0,2,"PCPE",0
40,"40043",1802,1400,1381,8,19,"PCPE",0
30,"30041",13621,8970,8889,46,81,"PCPE",7
47,"47225",80,63,63,0,0,"PCPE",0
47,"47062",163,130,130,0,0,"PCPE",1
39,"39043",1481,1122,1115,9,7,"PCPE",0
29,"29060",692,510,508,1,2,"PCPE",0
42,"42032",146,118,118,0,0,"PCPE",0
50,"50038",1502,1121,1111,7,10,"PCPE",0
42,"42167",251,175,172,2,3,"PCPE",0
47,"47226",156,123,123,0,0,"PCPE",0
41,"41011",15401,10170,9986,111,184,"PCPE",8
50,"50070",60,36,36,0,0,"PCPE",0
9,"9045",268,181,181,4,0,"PCPE",0
9,"9310",13,9,8,0,1,"PCPE",0
39,"39044",3849,2765,2732,21,33,"PCPE",4
3,"3117",362,318,313,2,5,"PCPE",0
37,"37379",174,133,131,1,2,"PCPE",2
45,"45085",1500,1011,999,4,12,"PCPE",0
40,"40045",109,85,85,2,0,"PCPE",0
49,"49204",63,51,51,0,0,"PCPE",1
23,"23057",766,625,619,4,6,"PCPE",2
34,"34099",60,48,48,0,0,"PCPE",0
24,"24191",108,79,79,0,0,"PCPE",0
20,"20057",196,122,122,0,0,"PCPE",0
42,"42168",107,80,80,0,0,"PCPE",0
40,"40173",138,99,93,1,6,"PCPE",1
44,"44217",29,25,25,3,0,"PCPE",0
22,"22207",125,72,71,2,1,"PCPE",0
9,"9442",375,279,277,2,2,"PCPE",0
46,"46193",8788,6925,6871,50,54,"PCPE",3
26,"26018",10477,8053,7956,65,97,"PCPE",5
26,"26122",118,102,102,0,0,"PCPE",1
37,"37341",53,39,39,0,0,"PCPE",0
9,"9406",251,192,191,2,1,"PCPE",0
50,"50200",511,410,403,2,7,"PCPE",0
23,"23019",1536,1196,1174,2,22,"PCPE",4
3,"3026",1224,949,936,5,13,"PCPE",1
18,"18097",960,693,685,5,8,"PCPE",0
44,"44218",35,28,28,1,0,"PCPE",0
46,"46194",15567,11156,11044,86,112,"PCPE",15
26,"26019",355,274,271,1,3,"PCPE",0
50,"50137",1011,772,764,8,8,"PCPE",0
21,"21046",1705,1099,996,16,103,"PCPE",7
20,"20026",197,145,133,0,12,"PCPE",0
47,"47148",442,342,338,2,4,"PCPE",0
41,"41048",2228,1470,1447,15,23,"PCPE",0
2,"2001",656,527,523,1,4,"PCPE",1
28,"28156",1019,742,738,3,4,"PCPE",0
42,"42173",29281,20286,20035,261,251,"PCPE",25
3,"3120",2406,1753,1720,11,33,"PCPE",1
26,"26123",126,108,107,2,1,"PCPE",0
24,"24196",2057,1502,1485,9,17,"PCPE",3
49,"49207",239,150,146,0,4,"PCPE",0
50,"50138",46,37,37,2,0,"PCPE",0
9,"9134",221,161,156,7,5,"PCPE",0
9,"9050",68,56,55,1,1,"PCPE",0
24,"24062",139,98,98,1,0,"PCPE",1
3,"3028",998,818,812,2,6,"PCPE",2
34,"34102",205,169,168,1,1,"PCPE",0
37,"37134",230,168,165,0,3,"PCPE",0
46,"46254",1000,785,779,6,6,"PCPE",2
47,"47066",1268,981,977,12,4,"PCPE",0
9,"9315",378,245,243,1,2,"PCPE",0
14,"14068",538,401,398,10,3,"PCPE",0
50,"50171",106,79,79,0,0,"PCPE",1
44,"44220",121,84,83,1,1,"PCPE",0
24,"24063",374,254,252,2,2,"PCPE",0
9,"9446",12,7,7,0,0,"PCPE",0
50,"50043",253,171,171,0,0,"PCPE",0
16,"16100",670,564,559,0,5,"PCPE",1
44,"44014",2521,1896,1867,8,29,"PCPE",2
44,"44120",222,154,150,2,4,"PCPE",2
24,"24165",354,240,238,2,2,"PCPE",1
40,"40179",626,503,493,2,10,"PCPE",0
46,"46255",3174,2448,2424,22,24,"PCPE",5
45,"45057",222,180,177,1,3,"PCPE",0
22,"22213",3003,2169,2131,19,38,"PCPE",2
49,"49210",471,370,365,1,5,"PCPE",1
26,"26163",136,118,118,0,0,"PCPE",0
50,"50265",79,61,61,0,0,"PCPE",0
24,"24064",1523,1101,1087,3,14,"PCPE",2
26,"26126",31,27,27,0,0,"PCPE",0
28,"28060",1510,1134,1117,1,17,"PCPE",1
37,"37044",466,362,360,2,2,"PCPE",0
23,"23904",2796,1825,1798,8,27,"PCPE",2
14,"14042",18891,14051,13848,190,203,"PCPE",33
24,"24031",215,172,168,0,4,"PCPE",0
18,"18901",511,356,355,3,1,"PCPE",0
28,"28061",21389,16277,16135,67,142,"PCPE",9
26,"26023",469,358,354,0,4,"PCPE",0
48,"48030",606,441,439,1,2,"PCPE",0
50,"50266",122,90,90,0,0,"PCPE",1
33,"33027",834,506,498,4,8,"PCPE",1
47,"47152",78,60,60,0,0,"PCPE",0
37,"37045",26,23,21,0,2,"PCPE",0
46,"46198",839,684,674,4,10,"PCPE",2
44,"44155",1090,793,782,4,11,"PCPE",0
44,"44122",1333,925,913,8,12,"PCPE",1
9,"9318",61,41,41,0,0,"PCPE",0
20,"20031",176,90,90,0,0,"PCPE",0
9,"9183",51,41,41,0,0,"PCPE",0
26,"26128",105,81,81,1,0,"PCPE",0
49,"49171",646,514,508,10,6,"PCPE",0
44,"44017",285,227,223,4,4,"PCPE",0
50,"50143",566,394,391,6,3,"PCPE",1
49,"49219",7464,4988,4914,53,74,"PCPE",4
47,"47070",37,27,27,0,0,"PCPE",0
29,"29036",632,423,416,2,7,"PCPE",0
42,"42044",54,42,39,0,3,"PCPE",0
20,"20032",8797,5672,5630,40,42,"PCPE",3
48,"48062",302,237,236,4,1,"PCPE",0
37,"37265",220,181,181,0,0,"PCPE",0
48,"48092",836,618,613,5,5,"PCPE",0
9,"9184",5,4,4,0,0,"PCPE",0
33,"33060",14633,9647,9474,72,173,"PCPE",39
46,"46199",5718,4314,4266,28,48,"PCPE",4
50,"50238",91,66,66,1,0,"PCPE",0
34,"34109",59,48,48,0,0,"PCPE",0
42,"42182",56,43,41,1,2,"PCPE",0
37,"37266",82,63,63,2,0,"PCPE",0
45,"45061",2447,1703,1689,12,14,"PCPE",0
9,"9323",61,46,46,1,0,"PCPE",0
18,"18107",943,663,655,1,8,"PCPE",0
44,"44019",67,50,49,0,1,"PCPE",1
50,"50144",34,29,29,2,0,"PCPE",0
45,"45161",13688,9007,8902,32,105,"PCPE",19
37,"37141",154,122,122,2,0,"PCPE",0
37,"37007",437,314,306,3,8,"PCPE",0
45,"45062",1112,878,867,4,11,"PCPE",0
48,"48094",3161,2094,2073,12,21,"PCPE",1
41,"41056",3687,2841,2812,30,29,"PCPE",3
49,"49098",219,167,165,0,2,"PCPE",0
46,"46070",16950,12765,12676,61,89,"PCPE",17
3,"3128",4092,2861,2840,10,21,"PCPE",3
49,"49135",626,434,430,1,4,"PCPE",2
24,"24102",652,470,467,2,3,"PCPE",0
30,"30022",16913,11371,11214,93,157,"PCPE",21
18,"18020",1028,691,686,3,5,"PCPE",0
26,"26132",112,82,82,0,0,"PCPE",0
50,"50146",187,145,144,3,1,"PCPE",1
29,"29039",2666,1898,1873,22,25,"PCPE",10
46,"46201",64,52,51,1,1,"PCPE",0
39,"39055",1086,824,816,6,8,"PCPE",3
46,"46123",1829,1407,1388,7,19,"PCPE",3
26,"26029",37,32,32,0,0,"PCPE",0
41,"41057",269,183,181,0,2,"PCPE",0
16,"16209",116,101,101,2,0,"PCPE",0
50,"50115",3235,2128,2109,14,19,"PCPE",2
16,"16270",162,137,137,0,0,"PCPE",0
46,"46045",1249,1028,1010,3,18,"PCPE",2
1,"1041",149,103,100,1,3,"PCPE",0
47,"47046",118,92,90,1,2,"PCPE",0
4,"4016",2138,1551,1536,9,15,"PCPE",1
21,"21058",2609,1883,1856,23,27,"PCPE",0
11,"11014",16858,10366,10245,153,121,"PCPE",10
45,"45064",3858,2804,2763,20,41,"PCPE",1
37,"37145",259,190,189,2,1,"PCPE",0
46,"46202",16947,12814,12710,79,104,"PCPE",9
50,"50052",90,68,68,0,0,"PCPE",0
44,"44127",68,51,51,0,0,"PCPE",0
16,"16112",1497,1031,1021,9,10,"PCPE",1
39,"39056",2286,1714,1684,8,30,"PCPE",5
49,"49101",153,102,99,0,3,"PCPE",1
49,"49224",162,112,112,1,0,"PCPE",0
34,"34116",62,49,49,0,0,"PCPE",0
50,"50149",34,24,24,0,0,"PCPE",0
22,"22090",99,71,71,0,0,"PCPE",0
42,"42187",62,46,45,1,1,"PCPE",0
21,"21060",11957,7356,7279,88,77,"PCPE",8
46,"46203",3606,2873,2844,9,29,"PCPE",2
22,"22018",327,245,244,3,1,"PCPE",0
14,"14020",387,269,264,2,5,"PCPE",0
44,"44197",56,36,36,0,0,"PCPE",0
42,"42013",34,28,27,0,1,"PCPE",0
34,"34221",179,144,144,3,0,"PCPE",0
42,"42051",20,14,14,1,0,"PCPE",0
26,"26032",51,41,39,0,2,"PCPE",0
46,"46263",251,214,212,0,2,"PCPE",0
24,"24173",951,679,674,9,5,"PCPE",0
40,"40191",215,181,179,1,2,"PCPE",0
22,"22225",2679,1700,1665,17,35,"PCPE",3
44,"44230",155,123,123,2,0,"PCPE",0
9,"9105",109,86,81,1,5,"PCPE",0
45,"45166",1617,1305,1286,8,19,"PCPE",0
4,"4084",341,249,247,2,2,"PCPE",0
49,"49103",414,330,328,5,2,"PCPE",0
48,"48902",19008,12566,12447,76,119,"PCPE",17
47,"47159",822,644,636,1,8,"PCPE",0
28,"28167",8356,6158,6106,46,52,"PCPE",4
50,"50213",94,75,74,0,1,"PCPE",0
34,"34122",83,60,60,0,0,"PCPE",0
21,"21062",1392,887,879,6,8,"PCPE",2
28,"28013",40471,28739,28490,188,249,"PCPE",32
34,"34169",404,287,286,0,1,"PCPE",0
44,"44268",25,25,24,0,1,"PCPE",0
23,"23076",827,640,630,1,10,"PCPE",1
33,"33066",42963,28564,28282,300,282,"PCPE",56
33,"33067",784,587,579,9,8,"PCPE",3
46,"46205",14313,10932,10834,51,98,"PCPE",7
9,"9065",143,122,122,1,0,"PCPE",0
46,"46153",439,355,351,1,4,"PCPE",0
29,"29901",43826,29318,29107,250,211,"PCPE",26
50,"50275",108,55,55,0,0,"PCPE",1
20,"20074",11592,7954,7914,45,40,"PCPE",5
18,"18117",506,383,373,1,10,"PCPE",1
24,"24176",316,247,244,1,3,"PCPE",0
47,"47078",163,127,125,1,2,"PCPE",0
39,"39060",6679,5196,5121,29,75,"PCPE",9
44,"44131",25,20,20,0,0,"PCPE",0
40,"40069",83,66,63,0,3,"PCPE",0
22,"22141",117,91,90,1,1,"PCPE",0
41,"41063",2695,1850,1830,13,20,"PCPE",1
22,"22099",483,379,377,4,2,"PCPE",0
39,"39031",1236,878,868,4,10,"PCPE",0
24,"24077",225,190,187,2,3,"PCPE",0
44,"44234",61,51,51,1,0,"PCPE",0
47,"47079",58,48,47,0,1,"PCPE",0
26,"26036",16986,11940,11816,66,124,"PCPE",13
48,"48905",2553,1792,1771,12,21,"PCPE",2
26,"26141",113,87,82,0,5,"PCPE",0
48,"48041",693,533,529,3,4,"PCPE",0
50,"50277",50,42,41,0,1,"PCPE",0
49,"49108",466,346,344,0,2,"PCPE",0
44,"44061",70,54,51,0,3,"PCPE",0
37,"37154",140,113,110,3,3,"PCPE",0
49,"49109",619,483,483,11,0,"PCPE",0
9,"9067",437,295,294,6,1,"PCPE",0
4,"4087",182,135,135,0,0,"PCPE",0
50,"50154",116,96,96,0,0,"PCPE",0
45,"45004",567,410,406,1,4,"PCPE",3
39,"39062",1812,1379,1366,5,13,"PCPE",1
48,"48906",766,547,544,0,3,"PCPE",0
33,"33009",905,611,609,3,2,"PCPE",1
18,"18168",804,546,543,7,3,"PCPE",0
1,"1009",1265,849,845,2,4,"PCPE",0
18,"18032",246,175,174,2,1,"PCPE",2
9,"9338",227,170,169,0,1,"PCPE",0
44,"44135",113,88,87,0,1,"PCPE",0
20,"20044",367,236,236,0,0,"PCPE",0
40,"40198",24,19,19,0,0,"PCPE",0
44,"44029",559,425,424,5,1,"PCPE",0
23,"23082",1921,1425,1416,8,9,"PCPE",0
46,"46234",348,279,275,3,4,"PCPE",0
45,"45139",167,139,139,1,0,"PCPE",0
50,"50060",172,128,127,1,1,"PCPE",0
49,"49232",96,74,74,1,0,"PCPE",0
26,"26143",220,175,173,1,2,"PCPE",0
29,"29016",251,188,188,1,0,"PCPE",0
28,"28083",8939,6396,6348,38,48,"PCPE",9
28,"28018",3768,2968,2945,26,23,"PCPE",2
16,"16124",1858,1476,1459,12,17,"PCPE",2
44,"44136",49,43,43,1,0,"PCPE",0
42,"42197",75,58,56,0,2,"PCPE",0
9,"9202",25,22,22,1,0,"PCPE",0
45,"45173",9520,6938,6864,30,74,"PCPE",5
24,"24081",140,98,92,0,6,"PCPE",0
24,"24180",1134,812,800,9,12,"PCPE",3
9,"9115",92,68,67,0,1,"PCPE",0
16,"16125",1667,1249,1231,3,18,"PCPE",0
23,"23005",30465,20878,20630,177,248,"PCPE",26
49,"49112",126,75,75,0,0,"PCPE",0
44,"44064",69,49,49,0,0,"PCPE",0
37,"37282",204,149,148,1,1,"PCPE",1
18,"18126",1483,1081,1074,15,7,"PCPE",2
2,"2025",7461,5759,5618,34,141,"PCPE",12
21,"21071",203,157,153,4,4,"PCPE",0
22,"22106",22,14,14,0,0,"PCPE",0
47,"47082",812,640,628,8,12,"PCPE",0
24,"24082",858,629,614,8,15,"PCPE",1
45,"45007",696,534,522,3,12,"PCPE",0
16,"16082",291,213,212,0,1,"PCPE",0
9,"9164",157,127,126,0,1,"PCPE",0
26,"26146",94,73,72,0,1,"PCPE",0
49,"49113",167,137,135,1,2,"PCPE",1
48,"48909",209,161,161,0,0,"PCPE",0
29,"29074",794,586,581,0,5,"PCPE",0
30,"30004",1137,870,862,3,8,"PCPE",0
18,"18036",3851,2870,2841,17,29,"PCPE",0
28,"28085",3922,2972,2954,14,18,"PCPE",0
24,"24182",416,294,290,2,4,"PCPE",0
40,"40202",60,46,46,0,0,"PCPE",0
45,"45175",664,545,543,5,2,"PCPE",0
20,"20048",182,100,98,2,2,"PCPE",0
49,"49236",75,58,58,0,0,"PCPE",0
49,"49114",43,34,33,0,1,"PCPE",0
18,"18127",16635,11440,11332,91,108,"PCPE",22
47,"47005",549,413,408,2,5,"PCPE",0
28,"28147",963,722,720,5,2,"PCPE",1
46,"46082",4918,3745,3712,33,33,"PCPE",4
28,"28086",5154,3530,3493,13,37,"PCPE",1
37,"37162",204,152,151,0,1,"PCPE",0
16,"16174",185,145,143,0,2,"PCPE",0
9,"9209",4473,3223,3192,20,31,"PCPE",1
40,"40203",899,722,715,4,7,"PCPE",1
33,"33075",271,154,153,2,1,"PCPE",0
49,"49115",184,136,135,0,1,"PCPE",0
45,"45077",556,428,427,1,1,"PCPE",0
44,"44175",122,85,84,1,1,"PCPE",0
37,"37330",339,248,246,0,2,"PCPE",0
26,"26076",129,107,106,0,1,"PCPE",0
28,"28087",3186,2503,2487,19,16,"PCPE",1
29,"29076",2153,1390,1360,10,30,"PCPE",4
24,"24086",270,223,218,0,5,"PCPE",0
2,"2030",3065,2287,2263,6,24,"PCPE",0
50,"50253",423,330,328,4,2,"PCPE",0
9,"9433",60,48,45,1,3,"PCPE",0
44,"44176",158,115,114,0,1,"PCPE",1
9,"9483",211,158,157,0,1,"PCPE",2
47,"47006",190,136,135,1,1,"PCPE",0
40,"40079",234,179,179,3,0,"PCPE",1
16,"16910",91,69,69,1,0,"PCPE",0
16,"16132",35,27,26,0,1,"PCPE",1
40,"40205",261,202,198,2,4,"PCPE",1
50,"50162",146,109,105,4,4,"PCPE",0
41,"41095",41232,27076,26793,315,283,"PCPE",26
22,"22112",9566,6354,6305,56,49,"PCPE",3
41,"41073",1707,1055,1041,5,14,"PCPE",0
24,"24087",631,470,466,7,4,"PCPE",0
18,"18134",5828,3840,3800,36,40,"PCPE",3
16,"16181",64,52,52,2,0,"PCPE",0
39,"39009",3216,2366,2337,17,29,"PCPE",2
42,"42068",82,63,60,1,3,"PCPE",0
40,"40206",173,135,134,0,1,"PCPE",0
34,"34136",179,110,110,1,0,"PCPE",0
48,"48913",1248,884,869,10,15,"PCPE",1
42,"42116",45,39,38,3,1,"PCPE",0
45,"45080",6,6,6,0,0,"PCPE",0
49,"49118",203,161,160,1,1,"PCPE",2
41,"41074",3012,2282,2257,18,25,"PCPE",2
39,"39071",397,261,256,1,5,"PCPE",0
42,"42069",1536,1036,1019,6,17,"PCPE",2
2,"2033",1892,1505,1474,6,31,"PCPE",3
40,"40081",124,94,92,2,2,"PCPE",0
24,"24188",3822,2850,2817,19,33,"PCPE",8
33,"33078",142,101,99,0,2,"PCPE",0
28,"28178",1065,824,818,5,6,"PCPE",0
46,"46007",11989,8784,8711,67,73,"PCPE",10
30,"30009",12433,9586,9503,41,83,"PCPE",10
48,"48021",1336,908,899,1,9,"PCPE",3
2,"2034",1382,1110,1093,7,17,"PCPE",1
37,"37167",173,143,140,2,3,"PCPE",0
22,"22113",495,370,368,4,2,"PCPE",0
28,"28121",198,160,158,1,2,"PCPE",0
34,"34001",34,28,28,2,0,"PCPE",0
26,"26047",1947,1578,1563,8,15,"PCPE",0
34,"34140",107,67,67,0,0,"PCPE",0
37,"37336",52,50,50,1,0,"PCPE",0
50,"50007",45,34,34,1,0,"PCPE",1
26,"26048",22,22,22,0,0,"PCPE",0
42,"42073",75,58,58,0,0,"PCPE",0
49,"49002",63,51,49,0,2,"PCPE",0
40,"40083",77,59,59,0,0,"PCPE",1
41,"41076",2183,1341,1327,19,14,"PCPE",13
41,"41010",4420,2960,2916,30,44,"PCPE",9
21,"21040",3170,2129,2071,20,58,"PCPE",1
3,"3023",1398,1184,1167,7,17,"PCPE",4
22,"22040",144,117,115,1,2,"PCPE",0
48,"48022",2336,1444,1433,6,11,"PCPE",1
49,"49244",43,29,29,0,0,"PCPE",0
47,"47010",13729,10549,10454,81,95,"PCPE",7
26,"26049",172,125,122,1,3,"PCPE",0
3,"3053",7226,5651,5584,32,67,"PCPE",5
50,"50069",73,53,53,1,0,"PCPE",0
9,"9354",33,29,28,2,1,"PCPE",0
49,"49122",782,526,520,5,6,"PCPE",1
18,"18140",43496,28038,27872,212,166,"PCPE",25
50,"50259",88,67,66,0,1,"PCPE",0
50,"50197",90,67,67,2,0,"PCPE",0
4,"4069",4687,3471,3437,27,34,"PCPE",2
34,"34245",307,209,208,5,1,"PCPE",0
37,"37378",111,77,75,2,2,"PCPE",0
40,"40003",139,107,104,0,3,"PCPE",1
28,"28027",1203,872,857,3,15,"PCPE",1
48,"48024",995,757,754,7,3,"PCPE",0
4,"4100",8768,5390,5353,32,37,"PCPE",2
50,"50260",33,33,32,0,1,"PCPE",0
49,"49085",996,684,680,2,4,"PCPE",0
3,"3055",5164,3695,3647,21,48,"PCPE",2
44,"44041",56,44,44,1,0,"PCPE",0
39,"39075",137376,99899,99048,718,851,"PCPE",111
18,"18005",372,262,258,0,4,"PCPE",1
9,"9262",163,130,127,1,3,"PCPE",0
22,"22247",33,20,20,0,0,"PCPE",0
47,"47011",565,461,458,5,3,"PCPE",0
22,"22004",135,81,80,0,1,"PCPE",0
11,"11035",13593,8375,8276,90,99,"PCPE",5
28,"28182",210,171,169,0,2,"PCPE",0
40,"40131",48,42,42,0,0,"PCPE",0
2,"2040",559,484,483,3,1,"PCPE",0
16,"16004",259,198,197,2,1,"PCPE",0
34,"34147",166,118,117,0,1,"PCPE",0
9,"9356",42,33,32,0,1,"PCPE",0
26,"26052",154,121,117,0,4,"PCPE",1
44,"44043",102,74,72,0,2,"PCPE",0
1,"1902",734,514,502,4,12,"PCPE",0
9,"9358",255,194,190,3,4,"PCPE",1
49,"49248",186,151,150,1,1,"PCPE",1
22,"22119",1291,942,935,5,7,"PCPE",1
50,"50261",213,157,157,0,0,"PCPE",0
9,"9907",1420,1058,1041,12,17,"PCPE",1
50,"50072",170,125,125,0,0,"PCPE",0
20,"20059",8874,5873,5855,29,18,"PCPE",2
49,"49126",235,155,154,2,1,"PCPE",0
44,"44151",190,151,148,0,3,"PCPE",0
50,"50262",1170,896,887,15,9,"PCPE",0
45,"45087",8311,5828,5747,43,81,"PCPE",5
39,"39017",569,398,391,4,7,"PCPE",2
11,"11037",5661,4347,4265,33,82,"PCPE",13
40,"40216",759,574,571,3,3,"PCPE",0
26,"26161",8,7,7,0,0,"PCPE",0
41,"41901",2682,2107,2086,28,21,"PCPE",2
42,"42216",25,23,23,0,0,"PCPE",0
50,"50073",2141,1592,1577,7,15,"PCPE",0
49,"49090",197,143,141,6,2,"PCPE",0
44,"44152",64,46,45,0,1,"PCPE",0
9,"9090",54,48,48,0,0,"PCPE",0
40,"40218",92,65,64,1,1,"PCPE",0
50,"50263",193,121,121,0,0,"PCPE",0
42,"42217",31,25,24,0,1,"PCPE",0
50,"50074",6366,4230,4165,31,65,"PCPE",8
34,"34012",357,269,264,5,5,"PCPE",0
41,"41016",7355,5248,5175,51,73,"PCPE",6
9,"9268",95,68,66,0,2,"PCPE",0
30,"30016",151668,102093,101363,484,730,"PCPE",96
39,"39078",1401,975,963,5,12,"PCPE",3
41,"41082",3415,2671,2647,16,24,"PCPE",0
18,"18147",3729,2335,2304,16,31,"PCPE",1
45,"45190",475,371,366,0,5,"PCPE",2
50,"50264",156,115,115,0,0,"PCPE",1
39,"39079",8874,6547,6478,47,69,"PCPE",16
40,"40219",587,455,444,5,11,"PCPE",0
44,"44046",49,34,34,1,0,"PCPE",0
34,"34015",41,35,35,3,0,"PCPE",0
14,"14069",7524,5460,5392,43,68,"PCPE",3
49,"49129",853,592,574,9,18,"PCPE",1
18,"18012",2278,1662,1641,13,21,"PCPE",4
50,"50076",78,66,65,0,1,"PCPE",0
28,"28903",33082,27065,26922,154,143,"PCPE",14
14,"14013",16796,11830,11616,129,214,"PCPE",22
34,"34060",137,111,108,0,3,"PCPE",0
40,"40220",66,50,46,1,4,"PCPE",0
9,"9093",154,121,119,0,2,"PCPE",0
37,"37042",44,28,27,0,1,"PCPE",0
41,"41018",9480,6523,6455,53,68,"PCPE",19
46,"46171",16563,12213,12128,85,85,"PCPE",15
23,"23027",723,576,572,3,4,"PCPE",1
37,"37003",115,93,93,0,0,"PCPE",1
46,"46119",780,653,647,5,6,"PCPE",3
37,"37137",105,66,66,0,0,"PCPE",0
21,"21010",14687,8293,8220,92,73,"PCPE",15
33,"33057",1593,1063,1049,16,14,"PCPE",2
40,"40221",49,39,39,0,0,"PCPE",0
45,"45192",2491,2069,2049,2,20,"PCPE",0
49,"49256",256,204,204,0,0,"PCPE",0
29,"29035",1567,1157,1144,11,13,"PCPE",4
37,"37179",209,180,180,0,0,"PCPE",0
37,"37348",115,96,95,0,1,"PCPE",0
20,"20064",12503,7803,7755,52,48,"PCPE",10
40,"40097",128,93,92,0,1,"PCPE",0
50,"50267",602,433,430,8,3,"PCPE",1
28,"28100",4196,2987,2955,14,32,"PCPE",3
40,"40140",92,69,67,0,2,"PCPE",0
28,"28160",8256,6102,6059,31,43,"PCPE",3
37,"37223",110,85,83,0,2,"PCPE",0
40,"40222",168,145,144,0,1,"PCPE",0
16,"16013",27,24,24,0,0,"PCPE",0
29,"29093",2214,1643,1621,3,22,"PCPE",3
45,"45093",155,129,127,1,2,"PCPE",0
29,"29003",983,754,743,1,11,"PCPE",2
16,"16152",38,32,32,0,0,"PCPE",0
2,"2008",1193,857,847,7,10,"PCPE",4
49,"49014",112,91,91,2,0,"PCPE",1
28,"28161",48848,35503,35203,210,300,"PCPE",53
18,"18106",425,293,290,0,3,"PCPE",1
24,"24100",761,561,555,7,6,"PCPE",1
37,"37182",75,56,55,0,1,"PCPE",0
47,"47018",34,28,28,0,0,"PCPE",0
46,"46069",162,124,123,0,1,"PCPE",0
22,"22129",183,120,118,1,2,"PCPE",0
2,"2049",823,573,564,1,9,"PCPE",0
20,"20066",454,236,234,1,2,"PCPE",0
45,"45094",387,298,297,1,1,"PCPE",0
16,"16014",602,485,483,0,2,"PCPE",0
46,"46147",16835,11920,11791,61,129,"PCPE",15
49,"49015",227,179,177,0,2,"PCPE",0
45,"45027",346,275,272,0,3,"PCPE",0
3,"3095",4579,3489,3459,25,30,"PCPE",4
22,"22902",221,159,156,0,3,"PCPE",0
49,"49016",247,176,174,5,2,"PCPE",0
39,"39084",838,631,624,2,7,"PCPE",1
45,"45095",689,513,505,0,8,"PCPE",0
44,"44263",376,266,263,3,3,"PCPE",0
24,"24036",288,184,184,2,0,"PCPE",0
22,"22130",10092,6671,6608,59,63,"PCPE",15
50,"50114",116,89,88,0,1,"PCPE",0
24,"24136",540,387,383,4,4,"PCPE",1
29,"29005",4358,2859,2817,28,42,"PCPE",1
46,"46096",274,209,209,1,0,"PCPE",0
45,"45096",1004,807,799,1,8,"PCPE",0
44,"44052",77,56,56,0,0,"PCPE",0
34,"34216",66,50,50,0,0,"PCPE",0
16,"16156",97,78,77,0,1,"PCPE",0
40,"40228",510,390,382,1,8,"PCPE",0
9,"9102",36,30,30,0,0,"PCPE",0
49,"49261",1537,1048,1033,8,15,"PCPE",3
47,"47020",280,234,231,2,3,"PCPE",1
40,"40059",110,95,95,1,0,"PCPE",0
14,"14046",4485,3268,3208,33,60,"PCPE",3
18,"18906",905,664,657,3,7,"PCPE",0
33,"33002",9995,6765,6672,47,93,"PCPE",23
46,"46097",963,733,728,4,5,"PCPE",1
28,"28065",126539,96997,96210,505,787,"PCPE",103
29,"29040",1977,1290,1278,12,12,"PCPE",2
22,"22904",815,579,575,8,4,"PCPE",3
47,"47182",1323,977,967,8,10,"PCPE",0
50,"50271",252,200,197,2,3,"PCPE",0
49,"49177",278,179,177,1,2,"PCPE",0
29,"29041",3175,2090,2045,24,45,"PCPE",4
50,"50210",38,30,30,1,0,"PCPE",0
46,"46072",3611,2871,2821,23,50,"PCPE",1
18,"18158",8358,5096,5031,28,65,"PCPE",15
45,"45098",2159,1632,1609,12,23,"PCPE",1
18,"18022",13432,8491,8407,67,84,"PCPE",8
4,"4017",1296,857,854,5,3,"PCPE",0
47,"47101",1710,1357,1336,16,21,"PCPE",2
20,"20070",1092,748,746,5,2,"PCPE",2
40,"40105",47,42,42,2,0,"PCPE",0
22,"22135",189,128,127,0,1,"PCPE",0
1,"1001",1979,1339,1318,7,21,"PCPE",3
16,"16159",220,159,159,0,0,"PCPE",0
3,"3099",42319,31083,30801,165,282,"PCPE",60
9,"9458",469,343,336,5,7,"PCPE",0
44,"44229",152,112,111,3,1,"PCPE",0
42,"42188",50,39,38,0,1,"PCPE",0
46,"46125",847,689,684,5,5,"PCPE",0
44,"44096",161,138,135,3,3,"PCPE",0
3,"3068",47,44,44,0,0,"PCPE",0
37,"37315",96,70,70,0,0,"PCPE",0
9,"9238",921,573,561,4,12,"PCPE",0
45,"45200",4592,3539,3476,14,63,"PCPE",1
18,"18024",855,665,654,7,11,"PCPE",1
4,"4018",270,232,229,0,3,"PCPE",0
44,"44267",70,57,56,0,1,"PCPE",0
28,"28166",320,254,251,2,3,"PCPE",0
34,"34029",714,587,570,3,17,"PCPE",0
46,"46230",13960,10351,10241,54,110,"PCPE",9
22,"22019",180,151,150,2,1,"PCPE",0
39,"39089",143,104,100,1,4,"PCPE",0
40,"40022",213,164,161,2,3,"PCPE",1
16,"16275",11,11,11,1,0,"PCPE",0
44,"44199",44,41,41,2,0,"PCPE",0
24,"24040",449,329,325,2,4,"PCPE",0
18,"18116",2850,2059,2025,20,34,"PCPE",5
16,"16023",469,335,335,2,0,"PCPE",0
37,"37359",184,130,129,0,1,"PCPE",1
29,"29044",809,561,561,3,0,"PCPE",0
46,"46023",327,280,278,2,2,"PCPE",0
3,"3009",46657,35143,34801,223,342,"PCPE",61
23,"23039",2204,1596,1558,11,38,"PCPE",0
24,"24042",63,56,56,1,0,"PCPE",0
34,"34074",707,540,531,9,9,"PCPE",0
45,"45034",1353,1082,1078,6,4,"PCPE",1
40,"40109",73,59,59,1,0,"PCPE",0
28,"28042",1173,890,883,3,7,"PCPE",0
24,"24108",376,280,277,2,3,"PCPE",0
49,"49267",88,73,69,2,4,"PCPE",0
24,"24010",8386,5708,5632,60,76,"PCPE",7
18,"18164",1836,1146,1126,6,20,"PCPE",3
16,"16025",26,23,23,0,0,"PCPE",0
24,"24145",654,463,461,2,2,"PCPE",1
40,"40025",136,117,115,0,2,"PCPE",1
9,"9110",80,63,63,0,0,"PCPE",0
14,"14024",1903,1405,1376,16,29,"PCPE",1
45,"45103",397,331,327,3,4,"PCPE",0
26,"26176",53,44,44,1,0,"PCPE",0
46,"46076",575,454,443,0,11,"PCPE",0
1,"1008",786,513,509,11,4,"PCPE",1
29,"29013",1610,1238,1207,9,31,"PCPE",0
24,"24213",150,122,122,1,0,"PCPE",0
29,"29903",524,353,349,3,4,"PCPE",0
42,"42056",23,20,20,0,0,"PCPE",0
1,"1049",138,109,109,1,0,"PCPE",0
30,"30029",11864,8125,8058,73,67,"PCPE",6
49,"49025",173,133,133,1,0,"PCPE",0
47,"47215",53,45,45,0,0,"PCPE",0
28,"28044",5826,4445,4409,24,36,"PCPE",6
9,"9382",33,28,28,0,0,"PCPE",1
29,"29904",421,338,335,3,3,"PCPE",0
24,"24012",290,207,205,1,2,"PCPE",0
45,"45205",6824,4424,4362,22,62,"PCPE",5
41,"41031",1238,825,814,11,11,"PCPE",1
49,"49147",263,190,186,0,4,"PCPE",0
34,"34176",133,102,101,0,1,"PCPE",0
45,"45171",1361,1035,1023,0,12,"PCPE",4
42,"42019",516,363,356,3,7,"PCPE",0
48,"48073",6910,4306,4271,31,35,"PCPE",1
22,"22189",185,145,144,5,1,"PCPE",0
44,"44062",34,25,22,0,3,"PCPE",0
48,"48042",1369,1068,1053,7,15,"PCPE",1
47,"47027",2745,2036,2018,9,18,"PCPE",2
39,"39003",297,220,215,0,5,"PCPE",1
46,"46156",2080,1697,1675,10,22,"PCPE",3
9,"9427",1419,978,959,8,19,"PCPE",2
11,"11021",6764,4434,4362,52,72,"PCPE",2
3,"3013",1113,839,836,4,3,"PCPE",2
40,"40906",2003,1569,1550,12,19,"PCPE",3
2,"2064",372,325,324,1,1,"PCPE",0
34,"34230",15,12,12,0,0,"PCPE",0
3,"3074",1707,1397,1389,4,8,"PCPE",1
47,"47028",33,21,21,0,0,"PCPE",0
46,"46079",318,241,232,1,9,"PCPE",0
46,"46235",21579,15929,15763,113,166,"PCPE",22
4,"4026",66,54,51,0,3,"PCPE",0
28,"28114",150,101,100,1,1,"PCPE",0
26,"26072",281,254,254,0,0,"PCPE",1
23,"23004",436,364,358,1,6,"PCPE",0
40,"40115",101,86,85,1,1,"PCPE",0
49,"49234",412,328,324,0,4,"PCPE",0
9,"9033",90,74,74,1,0,"PCPE",0
4,"4090",304,238,234,0,4,"PCPE",0
41,"41001",1596,1183,1159,5,24,"PCPE",0
3,"3107",2508,1755,1744,7,11,"PCPE",3
47,"47110",450,350,346,1,4,"PCPE",0
1,"1011",235,174,171,4,3,"PCPE",0
46,"46002",1175,941,932,5,9,"PCPE",4
39,"39096",690,487,479,4,8,"PCPE",0
20,"20080",7910,5294,5260,49,34,"PCPE",5
46,"46080",998,803,799,7,4,"PCPE",0
26,"26073",97,78,78,0,0,"PCPE",0
45,"45041",3752,2633,2597,12,36,"PCPE",3
48,"48015",33581,22727,22528,122,199,"PCPE",16
44,"44138",135,98,94,0,4,"PCPE",0
9,"9430",22,18,17,0,1,"PCPE",0
41,"41003",2333,1693,1671,13,22,"PCPE",1
34,"34041",90,71,71,1,0,"PCPE",0
24,"24017",577,426,418,1,8,"PCPE",1
24,"24050",102,77,76,0,1,"PCPE",0
29,"29052",224,144,144,3,0,"PCPE",0
26,"26074",105,86,85,1,1,"PCPE",0
50,"50190",695,523,515,3,8,"PCPE",0
26,"26181",14,14,14,0,0,"PCPE",0
16,"16034",180,146,144,2,2,"PCPE",0
23,"23007",3087,2205,2187,6,18,"PCPE",1
49,"49031",148,120,119,6,1,"PCPE",0
39,"39006",1711,1307,1287,10,20,"PCPE",3
47,"47030",993,766,751,6,15,"PCPE",0
48,"48046",12611,8836,8794,39,42,"PCPE",5
37,"37201",262,187,186,1,1,"PCPE",0
40,"40034",84,70,70,0,0,"PCPE",0
50,"50093",92,66,66,1,0,"PCPE",0
44,"44240",158,130,129,0,1,"PCPE",0
11,"11026",4782,3451,3378,26,73,"PCPE",7
42,"42025",1189,844,833,2,11,"PCPE",0
37,"37071",78,65,64,0,1,"PCPE",0
50,"50191",470,310,308,1,2,"PCPE",1
45,"45010",415,311,310,2,1,"PCPE",0
16,"16175",5095,3980,3914,35,66,"PCPE",1
3,"3048",4847,3719,3683,20,36,"PCPE",7
49,"49077",183,103,103,0,0,"PCPE",0
37,"37246",5304,3993,3949,26,44,"PCPE",3
16,"16238",501,428,422,3,6,"PCPE",0
14,"14030",8625,6248,6181,53,67,"PCPE",9
37,"37121",575,418,413,3,5,"PCPE",0
33,"33015",1540,998,986,8,12,"PCPE",7
34,"34045",76,66,66,2,0,"PCPE",0
16,"16131",130,100,97,2,3,"PCPE",2
46,"46109",6150,4625,4556,25,69,"PCPE",6
40,"40123",147,114,106,0,8,"PCPE",0
47,"47193",1577,1251,1241,7,10,"PCPE",4
39,"39099",3114,2308,2281,12,27,"PCPE",1
24,"24222",14256,9996,9884,101,112,"PCPE",10
50,"50095",12323,8628,8550,110,78,"PCPE",10
46,"46083",15422,11179,11049,86,130,"PCPE",8
50,"50285",644,436,434,2,2,"PCPE",0
49,"49194",368,218,216,1,2,"PCPE",0
45,"45145",2565,1695,1675,12,20,"PCPE",2
20,"20018",11064,6719,6690,41,29,"PCPE",3
45,"45112",1922,1247,1211,6,36,"PCPE",2
47,"47114",4045,2787,2762,26,25,"PCPE",2
37,"37248",152,126,125,1,1,"PCPE",0
49,"49197",175,123,123,1,0,"PCPE",0
26,"26078",82,70,70,0,0,"PCPE",0
3,"3113",4243,3091,3046,10,45,"PCPE",2
24,"24119",706,488,481,3,7,"PCPE",1
37,"37373",748,503,499,1,4,"PCPE",0
26,"26114",79,66,65,1,1,"PCPE",0
41,"41040",10541,7752,7698,68,54,"PCPE",8
39,"39010",631,480,475,7,5,"PCPE",0
9,"9256",354,258,258,2,0,"PCPE",1
37,"37077",261,226,223,1,3,"PCPE",0
18,"18042",403,324,322,2,2,"PCPE",1
9,"9395",138,104,104,0,0,"PCPE",0
41,"41008",1059,749,739,10,10,"PCPE",0
45,"45114",588,447,447,0,0,"PCPE",0
28,"28120",1223,892,884,2,8,"PCPE",2
1,"1019",150,106,105,1,1,"PCPE",0
2,"2074",5935,4193,4139,32,54,"PCPE",3
50,"50036",104,91,90,0,1,"PCPE",0
26,"26013",347,249,246,2,3,"PCPE",1
9,"9172",129,103,101,1,2,"PCPE",0
37,"37078",829,674,664,8,10,"PCPE",1
34,"34049",359,266,260,1,6,"PCPE",0
37,"37079",77,73,73,1,0,"PCPE",0
23,"23094",3839,3009,2954,14,55,"PCPE",2
37,"37376",2233,1539,1515,6,24,"PCPE",1
3,"3082",12567,8537,8464,44,73,"PCPE",12
47,"47035",921,717,715,3,2,"PCPE",0
22,"22114",123,81,81,0,0,"PCPE",0
28,"28179",1432,1040,1037,4,3,"PCPE",2
41,"41009",1222,812,805,3,7,"PCPE",0
44,"44180",70,61,61,0,0,"PCPE",0
48,"48052",1562,1160,1150,4,10,"PCPE",2
50,"50196",107,87,86,0,1,"PCPE",0
4,"4034",160,99,99,2,0,"PCPE",0
23,"23054",382,282,281,1,1,"PCPE",0
45,"45015",606,437,433,2,4,"PCPE",2
2,"2035",1960,1483,1465,13,18,"PCPE",0
9,"9044",46,35,34,1,1,"PCPE",1
22,"22162",130,102,102,0,0,"PCPE",1
46,"46243",138,115,112,1,3,"PCPE",0
39,"39012",6687,5021,4957,51,64,"PCPE",6
34,"34196",89,68,68,1,0,"PCPE",1
49,"49160",49,33,33,0,0,"PCPE",1
46,"46165",7129,5436,5388,25,48,"PCPE",5
21,"21001",637,462,455,6,7,"PCPE",0
37,"37337",139,124,124,0,0,"PCPE",0
39,"39013",511,402,399,4,3,"PCPE",0
26,"26082",112,87,87,1,0,"PCPE",0
48,"48084",22449,14670,14553,90,117,"PCPE",16
46,"46061",342,274,272,1,2,"PCPE",2
9,"9440",91,78,78,2,0,"PCPE",0
37,"37128",260,202,196,0,6,"PCPE",0
50,"50135",91,70,70,3,0,"PCPE",0
49,"49163",219,158,154,5,4,"PCPE",1
46,"46244",58771,42137,41867,270,270,"PCPE",65
46,"46088",166,125,125,4,0,"PCPE",0
24,"24025",297,228,227,0,1,"PCPE",1
9,"9220",75,56,54,1,2,"PCPE",0
34,"34199",1218,918,899,10,19,"PCPE",0
39,"39014",883,619,614,6,5,"PCPE",1
45,"45118",1991,1351,1339,6,12,"PCPE",0
37,"37083",182,156,155,0,1,"PCPE",2
40,"40172",39,34,34,0,0,"PCPE",0
18,"18096",341,227,224,3,3,"PCPE",0
1,"1027",416,257,254,3,3,"PCPE",0
16,"16191",899,675,671,2,4,"PCPE",0
37,"37213",89,74,73,0,1,"PCPE",0
39,"39015",839,647,642,4,5,"PCPE",0
39,"39045",367,271,268,1,3,"PCPE",0
49,"49164",155,119,115,2,4,"PCPE",1
50,"50104",348,271,269,2,2,"PCPE",0
2,"2080",528,406,400,2,6,"PCPE",0
9,"9132",171,122,122,2,0,"PCPE",1
28,"28125",3002,2180,2163,11,17,"PCPE",1
44,"44080",292,229,223,3,6,"PCPE",1
22,"22248",116,92,90,1,2,"PCPE",0
24,"24026",1177,864,849,7,15,"PCPE",2
46,"46011",7609,5249,5191,26,58,"PCPE",3
46,"46089",2132,1602,1574,9,28,"PCPE",1
50,"50011",122,95,94,1,1,"PCPE",0
49,"49165",59,51,51,0,0,"PCPE",0
37,"37086",101,72,71,1,1,"PCPE",0
45,"45153",1615,1258,1243,7,15,"PCPE",0
24,"24230",426,322,320,5,2,"PCPE",0
49,"49088",87,61,60,0,1,"PCPE",0
16,"16049",149,111,110,0,1,"PCPE",0
24,"24127",296,226,215,4,11,"PCPE",0
48,"48087",427,344,338,0,6,"PCPE",0
50,"50201",448,339,335,7,4,"PCPE",0
49,"49166",1227,946,933,6,13,"PCPE",7
28,"28126",39,29,29,0,0,"PCPE",0
34,"34151",159,104,103,0,1,"PCPE",0
2,"2042",837,618,611,1,7,"PCPE",0
42,"42127",38,31,31,1,0,"PCPE",0
11,"11004",88783,51500,51015,513,485,"PCPE",51
28,"28058",139342,100637,99753,634,884,"PCPE",124
50,"50106",134,104,104,0,0,"PCPE",0
18,"18189",776,581,574,4,7,"PCPE",1
24,"24129",122,89,89,1,0,"PCPE",0
41,"41902",4659,2679,2646,23,33,"PCPE",5
16,"16051",142,120,119,0,1,"PCPE",0
28,"28127",64827,51776,51613,220,163,"PCPE",21
28,"28157",609,433,430,1,3,"PCPE",0
50,"50233",106,81,81,0,0,"PCPE",0
46,"46091",118,94,94,0,0,"PCPE",0
28,"28059",4323,3171,3157,11,14,"PCPE",3
42,"42218",82,55,55,0,0,"PCPE",0
39,"39018",4220,3264,3204,35,60,"PCPE",9
23,"23025",2802,2056,2037,9,19,"PCPE",2
47,"47123",466,354,352,4,2,"PCPE",0
44,"44085",52,35,35,0,0,"PCPE",0
2,"2084",323,231,225,0,6,"PCPE",0
42,"42129",681,503,495,3,8,"PCPE",0
16,"16052",547,418,416,2,2,"PCPE",0
50,"50108",48,38,38,0,0,"PCPE",0
23,"23026",3586,2620,2585,16,35,"PCPE",0
22,"22172",556,372,370,6,2,"PCPE",1
3,"3091",252,217,215,2,2,"PCPE",0
28,"28128",444,315,314,0,1,"PCPE",0
29,"29066",334,234,233,4,1,"PCPE",0
46,"46066",1263,1024,1018,9,6,"PCPE",0
34,"34210",103,90,90,0,0,"PCPE",0
46,"46014",3030,2383,2350,20,33,"PCPE",5
48,"48059",400,294,291,0,3,"PCPE",0
9,"9269",36,26,26,1,0,"PCPE",0
23,"23064",1655,1363,1353,1,10,"PCPE",0
46,"46093",2118,1647,1624,4,23,"PCPE",1
37,"37091",177,117,116,1,1,"PCPE",0
45,"45124",2140,1677,1641,10,36,"PCPE",0
16,"16198",1348,981,971,10,10,"PCPE",0
41,"41051",2180,1529,1501,2,28,"PCPE",1
3,"3030",524,448,440,5,8,"PCPE",2
3,"3123",7476,5557,5501,29,56,"PCPE",12
29,"29091",8957,6186,6078,56,108,"PCPE",7
4,"4011",2765,2119,2096,21,23,"PCPE",3
11,"11008",17471,10952,10812,128,140,"PCPE",15
4,"4076",1279,960,944,8,16,"PCPE",3
47,"47206",92,80,80,0,0,"PCPE",0
23,"23028",6220,4409,4369,23,40,"PCPE",6
21,"21012",316,235,233,2,2,"PCPE",0
37,"37096",214,166,163,2,3,"PCPE",0
50,"50142",26,17,17,0,0,"PCPE",0
22,"22253",61,52,52,0,0,"PCPE",0
14,"14043",7574,5515,5443,81,72,"PCPE",12
22,"22174",478,379,378,2,1,"PCPE",1
14,"14015",2125,1579,1554,10,25,"PCPE",4
9,"9412",790,528,523,4,5,"PCPE",0
34,"34213",57,45,44,1,1,"PCPE",0
50,"50016",52,40,40,0,0,"PCPE",0
44,"44192",355,280,278,4,2,"PCPE",0
42,"42086",36,27,26,2,1,"PCPE",0
9,"9139",103,87,85,3,2,"PCPE",0
28,"28101",231,187,187,0,0,"PCPE",0
26,"26166",141,124,122,0,2,"PCPE",0
22,"22050",88,77,77,0,0,"PCPE",0
49,"49173",375,230,221,3,9,"PCPE",0
16,"16204",261,199,199,1,0,"PCPE",0
47,"47126",50,41,41,0,0,"PCPE",1
28,"28131",12990,9512,9433,38,79,"PCPE",8
39,"39022",980,721,713,2,8,"PCPE",0
37,"37098",333,247,247,1,0,"PCPE",0
3,"3003",450,378,376,2,2,"PCPE",0
44,"44090",78,53,53,0,0,"PCPE",0
42,"42135",72,52,52,1,0,"PCPE",0
9,"9058",390,283,279,1,4,"PCPE",0
22,"22086",215,161,159,1,2,"PCPE",1
40,"40143",86,75,74,0,1,"PCPE",1
47,"47208",58,38,36,1,2,"PCPE",0
37,"37352",207,153,152,1,1,"PCPE",0
4,"4049",5313,3620,3579,18,41,"PCPE",2
16,"16061",969,771,764,14,7,"PCPE",1
2,"2010",1789,1437,1421,11,16,"PCPE",0
9,"9454",43,34,33,0,1,"PCPE",0
46,"46200",1903,1561,1539,3,22,"PCPE",2
45,"45162",669,494,486,2,8,"PCPE",1
9,"9019",150,92,90,0,2,"PCPE",0
40,"40017",92,75,75,0,0,"PCPE",0
14,"14018",3709,2697,2653,26,44,"PCPE",2
3,"3139",22437,15315,15170,100,145,"PCPE",43
9,"9276",382,251,240,3,11,"PCPE",0
34,"34113",38,36,36,0,0,"PCPE",0
37,"37101",160,128,125,0,3,"PCPE",0
47,"47128",60,52,51,0,1,"PCPE",0
45,"45129",131,92,92,0,0,"PCPE",0
22,"22016",601,413,411,6,2,"PCPE",0
42,"42010",19,14,14,1,0,"PCPE",1
23,"23071",1715,1290,1278,7,12,"PCPE",1
44,"44093",80,66,66,0,0,"PCPE",0
9,"9191",38,28,27,0,1,"PCPE",0
16,"16110",93,70,70,0,0,"PCPE",0
24,"24037",360,254,250,2,4,"PCPE",2
49,"49017",251,180,177,1,3,"PCPE",0
44,"44126",329,234,229,4,5,"PCPE",0
41,"41025",2020,1361,1320,7,41,"PCPE",2
45,"45164",182,162,160,1,2,"PCPE",0
40,"40188",90,72,70,0,2,"PCPE",0
48,"48005",115,63,61,0,2,"PCPE",0
42,"42011",18,10,10,1,0,"PCPE",0
46,"46176",2017,1358,1349,5,9,"PCPE",4
24,"24038",3089,2312,2273,17,39,"PCPE",4
45,"45031",2723,1835,1822,12,13,"PCPE",1
50,"50116",182,136,132,0,4,"PCPE",0
49,"49058",307,237,233,0,4,"PCPE",0
37,"37011",121,91,91,3,0,"PCPE",1
9,"9023",1102,818,811,11,7,"PCPE",0
9,"9418",82,62,61,1,1,"PCPE",0
22,"22182",250,161,158,1,3,"PCPE",1
9,"9148",87,70,68,3,2,"PCPE",0
48,"48067",1158,813,810,2,3,"PCPE",0
26,"26100",49,44,43,0,1,"PCPE",0
23,"23035",1106,873,855,1,18,"PCPE",0
18,"18909",579,435,429,0,6,"PCPE",0
11,"11015",62476,38177,37875,488,302,"PCPE",47
42,"42144",436,353,348,2,5,"PCPE",0
46,"46021",23649,17291,17153,100,138,"PCPE",32
16,"16215",242,172,169,2,3,"PCPE",0
50,"50022",530,397,390,7,7,"PCPE",0
44,"44198",182,147,146,4,1,"PCPE",0
29,"29043",2509,1608,1576,18,32,"PCPE",5
21,"21020",365,223,222,1,1,"PCPE",0
37,"37357",262,205,203,1,2,"PCPE",0
46,"46022",15365,11093,10997,59,96,"PCPE",13
45,"45133",2797,2068,2048,13,20,"PCPE",0
34,"34222",120,87,87,3,0,"PCPE",0
46,"46100",286,232,230,1,2,"PCPE",3
2,"2017",838,594,589,1,5,"PCPE",2
42,"42014",64,43,43,1,0,"PCPE",0
11,"11016",14929,9426,9302,123,124,"PCPE",9
23,"23075",3298,2564,2541,18,23,"PCPE",5
50,"50244",201,162,161,1,1,"PCPE",0
49,"49079",106,93,92,1,1,"PCPE",0
46,"46005",22918,16958,16827,102,131,"PCPE",21
37,"37288",262,182,181,4,1,"PCPE",1
46,"46179",2165,1760,1737,16,23,"PCPE",1
11,"11018",1468,1046,1031,9,15,"PCPE",1
2,"2018",829,661,653,1,8,"PCPE",1
47,"47160",425,308,303,0,5,"PCPE",0
46,"46127",2692,2120,2091,18,29,"PCPE",3
22,"22908",197,142,140,3,2,"PCPE",0
26,"26103",796,616,610,6,6,"PCPE",0
42,"42096",272,171,170,6,1,"PCPE",0
48,"48903",1835,1361,1351,7,10,"PCPE",0
49,"49228",54,44,43,0,1,"PCPE",0
37,"37360",225,174,173,1,1,"PCPE",0
9,"9287",208,158,156,3,2,"PCPE",0
9,"9423",27,24,24,0,0,"PCPE",0
29,"29068",7016,4300,4244,35,56,"PCPE",2
34,"34124",60,50,49,0,1,"PCPE",0
46,"46180",682,553,549,0,4,"PCPE",1
45,"45102",3610,2506,2470,14,36,"PCPE",1
3,"3010",325,277,275,1,2,"PCPE",0
9,"9027",46,42,41,0,1,"PCPE",0
22,"22059",1149,807,800,3,7,"PCPE",2
41,"41030",514,387,373,3,14,"PCPE",0
44,"44101",58,46,46,2,0,"PCPE",0
24,"24043",134,75,75,1,0,"PCPE",0
16,"16072",146,104,103,2,1,"PCPE",0
37,"37320",95,72,72,0,0,"PCPE",0
22,"22022",552,414,408,6,6,"PCPE",0
3,"3072",348,289,285,0,4,"PCPE",1
34,"34227",77,61,61,2,0,"PCPE",1
18,"18914",1649,1238,1213,3,25,"PCPE",5
16,"16224",83,66,65,1,1,"PCPE",0
9,"9159",60,52,51,2,1,"PCPE",0
16,"16073",185,164,164,1,0,"PCPE",0
22,"22060",1164,858,850,3,8,"PCPE",2
46,"46025",2499,1953,1934,8,19,"PCPE",0
28,"28016",79,53,51,0,2,"PCPE",1
22,"22102",179,141,138,2,3,"PCPE",0
50,"50058",66,39,39,0,0,"PCPE",0
37,"37063",69,59,58,0,1,"PCPE",0
16,"16167",316,249,244,1,5,"PCPE",0
37,"37019",150,123,120,0,3,"PCPE",0
49,"49148",260,137,134,1,3,"PCPE",0
50,"50122",68,52,52,1,0,"PCPE",0
26,"26004",67,50,50,0,0,"PCPE",0
24,"24046",942,637,633,5,4,"PCPE",2
28,"28143",72,57,57,1,0,"PCPE",0
34,"34080",5560,3723,3665,32,58,"PCPE",4
9,"9160",85,64,64,0,0,"PCPE",0
39,"39002",3298,2342,2309,13,33,"PCPE",1
28,"28073",12549,8788,8701,54,87,"PCPE",10
4,"4088",2454,1660,1650,15,10,"PCPE",0
40,"40157",47,44,44,0,0,"PCPE",0
30,"30031",492,409,401,0,8,"PCPE",0
48,"48907",348,266,266,2,0,"PCPE",0
46,"46105",16190,11323,11206,44,117,"PCPE",9
37,"37240",945,623,619,5,4,"PCPE",0
28,"28144",6010,4676,4644,22,32,"PCPE",1
30,"30032",2856,2163,2144,6,19,"PCPE",1
49,"49188",112,90,89,1,1,"PCPE",0
16,"16228",172,137,137,4,0,"PCPE",0
22,"22206",193,129,128,1,1,"PCPE",0
22,"22062",167,116,116,1,0,"PCPE",0
49,"49069",367,258,254,5,4,"PCPE",0
29,"29049",2962,2132,2110,5,22,"PCPE",0
21,"21042",15350,7643,7530,124,113,"PCPE",7
45,"45074",414,327,323,1,4,"PCPE",0
45,"45040",1349,846,838,4,8,"PCPE",1
23,"23085",2252,1655,1644,6,11,"PCPE",1
21,"21030",1830,1452,1430,13,22,"PCPE",1
40,"40031",526,398,396,2,2,"PCPE",0
48,"48014",1211,806,801,7,5,"PCPE",0
46,"46028",387,330,328,3,2,"PCPE",0
50,"50219",4119,2833,2804,19,29,"PCPE",3
3,"3015",12566,9257,9177,39,80,"PCPE",21
49,"49235",443,301,292,0,9,"PCPE",1
9,"9034",276,228,227,2,1,"PCPE",0
42,"42023",63,51,51,0,0,"PCPE",0
44,"44137",193,149,148,0,1,"PCPE",0
9,"9297",323,251,250,6,1,"PCPE",1
9,"9073",926,691,686,4,5,"PCPE",1
20,"20014",1108,611,609,4,2,"PCPE",0
33,"33073",8554,4945,4884,41,61,"PCPE",6
30,"30034",1129,858,844,7,14,"PCPE",1
37,"37118",123,92,90,0,2,"PCPE",0
22,"22066",702,502,498,7,4,"PCPE",0
45,"45142",7871,6007,5927,37,80,"PCPE",1
3,"3016",93,75,75,0,0,"PCPE",0
28,"28076",398,325,317,1,8,"PCPE",1
47,"47219",41,36,34,0,2,"PCPE",0
9,"9431",118,98,98,0,0,"PCPE",0
29,"29053",1699,1105,1091,14,14,"PCPE",1
26,"26111",242,180,176,0,4,"PCPE",0
9,"9036",37,31,30,1,1,"PCPE",0
33,"33074",3484,2298,2274,24,24,"PCPE",4
23,"23048",870,619,613,1,6,"PCPE",0
39,"39067",790,513,505,1,8,"PCPE",1
28,"28021",554,370,364,3,6,"PCPE",1
42,"42201",22,22,21,0,1,"PCPE",0
26,"26112",236,194,190,1,4,"PCPE",0
22,"22067",65,50,50,1,0,"PCPE",0
50,"50221",35,17,17,0,0,"PCPE",0
39,"39037",1987,1516,1503,8,13,"PCPE",1
22,"22155",76,51,51,0,0,"PCPE",0
9,"9391",361,264,263,3,1,"PCPE",1
41,"41093",18554,13978,13874,99,104,"PCPE",65
42,"42064",86,68,68,0,0,"PCPE",0
21,"21074",2649,1755,1733,13,22,"PCPE",1
24,"24184",198,118,117,0,1,"PCPE",0
22,"22200",244,184,182,5,2,"PCPE",0
42,"42202",20,14,13,0,1,"PCPE",0
50,"50222",1622,1091,1071,7,20,"PCPE",4
30,"30006",803,691,685,2,6,"PCPE",0
44,"44109",108,73,73,0,0,"PCPE",0
23,"23050",90992,64810,64218,485,592,"PCPE",65
44,"44210",746,554,545,3,9,"PCPE",0
37,"37122",201,154,153,5,1,"PCPE",0
50,"50223",920,712,701,4,11,"PCPE",1
22,"22069",429,333,331,2,2,"PCPE",0
4,"4074",2840,2000,1979,23,21,"PCPE",2
41,"41050",5150,3817,3777,19,40,"PCPE",9
28,"28158",665,537,533,4,4,"PCPE",0
20,"20051",6877,4699,4679,34,20,"PCPE",8
2,"2031",565,457,455,0,2,"PCPE",0
37,"37164",256,191,189,5,2,"PCPE",0
37,"37074",150,123,120,0,3,"PCPE",0
16,"16040",80,62,62,0,0,"PCPE",1
14,"14004",2034,1531,1518,14,13,"PCPE",1
9,"9039",58,46,46,2,0,"PCPE",0
22,"22242",62,45,44,0,1,"PCPE",0
21,"21077",1711,1224,1202,3,22,"PCPE",0
50,"50066",2621,1862,1851,9,11,"PCPE",5
42,"42162",2352,1637,1601,16,36,"PCPE",1
9,"9170",205,162,162,1,0,"PCPE",0
40,"40165",77,65,64,1,1,"PCPE",0
50,"50131",231,167,165,0,2,"PCPE",1
44,"44111",92,69,68,0,1,"PCPE",0
47,"47060",258,216,214,1,2,"PCPE",0
28,"28150",3087,2294,2277,10,17,"PCPE",2
44,"44112",429,290,290,2,0,"PCPE",0
50,"50132",751,543,536,0,7,"PCPE",1
22,"22072",191,136,135,0,1,"PCPE",0
39,"39101",274,197,192,3,5,"PCPE",1
46,"46120",1113,903,875,2,28,"PCPE",1
42,"42163",50,41,40,0,1,"PCPE",0
46,"46033",191,156,155,0,1,"PCPE",0
16,"16089",375,303,303,6,0,"PCPE",0
49,"49081",1382,1016,1003,9,13,"PCPE",0
9,"9438",538,437,433,6,4,"PCPE",0
20,"20054",447,286,284,2,2,"PCPE",0
26,"26014",474,327,324,1,3,"PCPE",0
22,"22203",83,67,67,1,0,"PCPE",0
40,"40126",79,56,54,0,2,"PCPE",0
40,"40082",114,84,82,1,2,"PCPE",0
37,"37031",361,269,266,2,3,"PCPE",0
42,"42165",409,271,261,10,10,"PCPE",1
22,"22075",125,83,83,1,0,"PCPE",1
18,"18093",2750,1793,1776,7,17,"PCPE",1
46,"46216",5053,4109,4090,14,19,"PCPE",1
9,"9352",114,92,92,1,0,"PCPE",0
16,"16245",419,327,323,7,4,"PCPE",0
16,"16188",91,65,65,0,0,"PCPE",0
26,"26119",197,156,155,4,1,"PCPE",0
34,"34243",325,252,248,0,4,"PCPE",0
16,"16093",60,49,47,0,2,"PCPE",0
46,"46113",2457,1804,1782,6,22,"PCPE",0
45,"45184",200,129,129,0,0,"PCPE",0
34,"34094",64,45,44,0,1,"PCPE",0
20,"20056",4082,2589,2570,27,19,"PCPE",1
49,"49084",287,229,228,4,1,"PCPE",4
18,"18094",2359,1744,1720,14,24,"PCPE",0
48,"48083",6958,4885,4856,40,29,"PCPE",7
16,"16001",76,61,61,0,0,"PCPE",0
18,"18108",850,659,656,3,3,"PCPE",1
34,"34141",177,149,145,2,4,"PCPE",0
28,"28153",697,499,499,1,0,"PCPE",1
40,"40044",145,114,113,2,1,"PCPE",1
18,"18095",1967,1450,1430,11,20,"PCPE",3
11,"11001",4358,2816,2767,11,49,"PCPE",2
18,"18018",634,472,468,5,4,"PCPE",0
24,"24092",798,606,602,1,4,"PCPE",0
16,"16141",143,102,102,0,0,"PCPE",0
33,"33051",7061,4640,4587,27,53,"PCPE",3
42,"42046",49,39,39,0,0,"PCPE",1
50,"50230",1165,833,828,8,5,"PCPE",0
44,"44250",19,12,12,0,0,"PCPE",0
9,"9084",186,136,135,4,1,"PCPE",0
45,"45185",7700,5771,5691,20,80,"PCPE",1
18,"18141",404,285,282,0,3,"PCPE",0
26,"26121",25,22,22,0,0,"PCPE",0
34,"34006",81,67,66,2,1,"PCPE",0
40,"40087",92,71,70,1,1,"PCPE",2
41,"41013",4839,3151,3094,33,57,"PCPE",10
44,"44010",175,130,128,1,2,"PCPE",0
44,"44116",83,60,60,1,0,"PCPE",0
22,"22078",438,319,316,3,3,"PCPE",0
33,"33053",1141,742,732,6,10,"PCPE",5
37,"37381",147,114,107,2,7,"PCPE",0
41,"41102",14655,10183,9919,142,264,"PCPE",13
45,"45053",8005,6211,6140,42,71,"PCPE",1
14,"14038",32322,22117,21887,179,230,"PCPE",26
34,"34902",139,106,106,0,0,"PCPE",0
42,"42172",29,26,26,0,0,"PCPE",0
41,"41047",10117,7515,7422,74,93,"PCPE",5
37,"37132",351,256,253,2,3,"PCPE",0
9,"9311",59,46,45,0,1,"PCPE",0
21,"21045",249,180,178,3,2,"PCPE",1
47,"47021",76,64,64,0,0,"PCPE",0
28,"28155",506,416,411,0,5,"PCPE",0
46,"46142",787,619,602,1,17,"PCPE",0
26,"26160",709,552,549,2,3,"PCPE",2
14,"14039",2604,2062,2021,12,41,"PCPE",4
28,"28002",3007,2091,2074,14,17,"PCPE",3
41,"41081",29189,20205,20015,196,190,"PCPE",25
49,"49044",80,60,58,0,2,"PCPE",0
42,"42125",70,59,59,1,0,"PCPE",0
29,"29087",376,270,266,1,4,"PCPE",1
14,"14067",3889,2946,2899,29,47,"PCPE",3
16,"16253",337,264,263,2,1,"PCPE",1
26,"26053",208,168,163,4,5,"PCPE",0
34,"34011",397,321,320,5,1,"PCPE",0
26,"26054",320,263,260,4,3,"PCPE",0
26,"26021",2827,2098,2076,15,22,"PCPE",2
9,"9408",41,36,36,0,0,"PCPE",0
16,"16147",64,45,45,0,0,"PCPE",0
33,"33025",9174,5838,5786,57,52,"PCPE",10
44,"44013",11244,7815,7712,82,103,"PCPE",9
46,"46013",17383,13569,13483,82,86,"PCPE",13
50,"50294",70,63,63,0,0,"PCPE",0
22,"22008",173,137,133,3,4,"PCPE",0
37,"37135",1207,905,899,15,6,"PCPE",0
42,"42175",21,16,16,0,0,"PCPE",0
49,"49209",505,342,341,2,1,"PCPE",1
9,"9180",142,107,102,1,5,"PCPE",0
34,"34104",246,185,182,1,3,"PCPE",1
48,"48089",3306,2341,2329,20,12,"PCPE",2
45,"45167",1440,1144,1133,6,11,"PCPE",0
45,"45046",2412,1667,1654,7,13,"PCPE",0
4,"4064",2771,2001,1988,13,13,"PCPE",2
37,"37136",652,440,435,3,5,"PCPE",2
50,"50044",230,145,145,1,0,"PCPE",0
11,"11040",397,307,292,1,15,"PCPE",0
40,"40052",74,60,60,0,0,"PCPE",0
18,"18013",4218,3024,2986,15,38,"PCPE",6
18,"18054",849,606,605,7,1,"PCPE",0
44,"44189",56,41,41,0,0,"PCPE",0
49,"49023",967,673,662,10,11,"PCPE",1
16,"16149",148,124,122,2,2,"PCPE",0
42,"42219",43,31,30,0,1,"PCPE",0
42,"42041",34,25,25,0,0,"PCPE",0
2,"2005",559,424,416,5,8,"PCPE",0
49,"49093",280,223,222,1,1,"PCPE",0
45,"45069",1847,1391,1376,6,15,"PCPE",0
34,"34076",587,479,479,2,0,"PCPE",0
16,"16102",1205,912,905,12,7,"PCPE",0
46,"46128",1597,1290,1250,5,40,"PCPE",1
24,"24098",1193,842,831,11,11,"PCPE",0
50,"50174",91,69,68,0,1,"PCPE",0
22,"22127",505,374,371,3,3,"PCPE",0
18,"18014",6581,4584,4545,37,39,"PCPE",6
47,"47069",124,105,104,1,1,"PCPE",1
28,"28015",18736,14221,14127,68,94,"PCPE",10
37,"37004",30,21,21,0,0,"PCPE",0
21,"21052",4583,2734,2663,22,71,"PCPE",5
26,"26165",358,304,299,2,5,"PCPE",0
16,"16056",457,306,305,3,1,"PCPE",0
49,"49052",187,133,132,1,1,"PCPE",0
49,"49216",162,142,142,0,0,"PCPE",0
39,"39052",18236,13537,13380,110,157,"PCPE",11
24,"24167",750,505,499,4,6,"PCPE",2
37,"37005",74,54,54,2,0,"PCPE",0
22,"22217",385,287,281,1,6,"PCPE",0
3,"3125",343,254,251,0,3,"PCPE",0
50,"50047",48,36,36,0,0,"PCPE",0
40,"40182",178,133,130,2,3,"PCPE",0
45,"45060",173,126,125,1,1,"PCPE",0
45,"45160",1109,874,864,6,10,"PCPE",0
33,"33059",4646,3075,3033,29,42,"PCPE",4
28,"28007",124592,94222,93521,491,701,"PCPE",75
9,"9450",28,22,21,0,1,"PCPE",0
44,"44018",19,19,19,0,0,"PCPE",0
40,"40056",34,28,28,1,0,"PCPE",0
22,"22218",43,33,33,0,0,"PCPE",0
47,"47098",576,464,452,4,12,"PCPE",0
11,"11010",6410,4189,4130,88,59,"PCPE",1
34,"34110",88,71,71,1,0,"PCPE",0
44,"44124",77,64,64,3,0,"PCPE",0
49,"49054",894,617,601,13,16,"PCPE",3
48,"48063",372,279,277,2,2,"PCPE",0
21,"21055",6975,5293,5241,48,52,"PCPE",5
49,"49097",85,52,51,0,1,"PCPE",0
26,"26071",8491,5834,5761,47,73,"PCPE",14
34,"34112",46,38,37,0,1,"PCPE",0
16,"16155",508,398,391,2,7,"PCPE",1
16,"16015",374,263,262,4,1,"PCPE",0
40,"40185",863,646,642,3,4,"PCPE",1
16,"16903",1070,777,765,4,12,"PCPE",0
18,"18123",301,228,222,1,6,"PCPE",0
29,"29072",3262,2382,2352,17,30,"PCPE",3
37,"37184",327,255,252,2,3,"PCPE",0
9,"9294",108,86,82,0,4,"PCPE",0
23,"23084",935,658,653,7,5,"PCPE",0
50,"50208",1774,1207,1195,10,12,"PCPE",0
47,"47181",165,135,132,3,3,"PCPE",0
2,"2011",632,520,516,1,4,"PCPE",0
28,"28009",14086,10611,10545,57,66,"PCPE",10
46,"46260",2581,2087,2068,22,19,"PCPE",1
3,"3035",652,547,541,1,6,"PCPE",3
48,"48004",335,222,222,0,0,"PCPE",0
37,"37229",135,112,112,0,0,"PCPE",0
37,"37009",213,172,171,3,1,"PCPE",0
33,"33012",5201,3466,3432,25,34,"PCPE",9
47,"47029",57,52,52,0,0,"PCPE",0
26,"26040",70,60,60,0,0,"PCPE",0
41,"41024",22600,14263,14048,128,215,"PCPE",10
45,"45197",1906,1455,1430,8,25,"PCPE",3
26,"26134",82,68,68,2,0,"PCPE",0
20,"20069",147046,100691,100232,836,459,"PCPE",71
28,"28066",7182,5422,5371,17,51,"PCPE",1
48,"48066",348,258,258,1,0,"PCPE",0
2,"2013",119,92,90,0,2,"PCPE",0
24,"24071",1006,745,734,10,11,"PCPE",0
22,"22089",302,225,223,0,2,"PCPE",1
20,"20037",99,64,64,2,0,"PCPE",0
9,"9192",55,43,43,0,0,"PCPE",0
28,"28174",1795,1232,1221,7,11,"PCPE",1
9,"9104",53,42,42,0,0,"PCPE",0
46,"46262",223,162,159,2,3,"PCPE",1
50,"50053",687,513,510,2,3,"PCPE",0
9,"9061",162,124,123,0,1,"PCPE",0
40,"40060",82,61,61,0,0,"PCPE",0
22,"22054",1542,1091,1077,13,14,"PCPE",0
16,"16113",3077,2225,2202,10,23,"PCPE",0
37,"37146",117,96,95,1,1,"PCPE",0
16,"16213",36,34,34,0,0,"PCPE",0
50,"50242",93,75,75,3,0,"PCPE",0
42,"42189",60,46,45,0,1,"PCPE",0
45,"45066",7570,5550,5484,25,66,"PCPE",4
34,"34120",64214,47193,46683,331,510,"PCPE",38
21,"21061",5084,3223,3177,28,46,"PCPE",3
34,"34028",143,116,113,1,3,"PCPE",0
23,"23074",3021,2317,2295,11,22,"PCPE",1
26,"26101",44,36,35,0,1,"PCPE",0
29,"29099",950,693,685,4,8,"PCPE",0
34,"34121",187,148,148,3,0,"PCPE",0
42,"42052",15,13,13,0,0,"PCPE",0
9,"9463",264,195,195,7,0,"PCPE",0
40,"40063",7096,5184,5100,36,84,"PCPE",5
45,"45033",343,249,243,2,6,"PCPE",0
48,"48008",606,424,414,6,10,"PCPE",0
30,"30026",15734,10007,9901,51,106,"PCPE",5
37,"37358",159,135,133,0,2,"PCPE",0
23,"23091",729,555,553,5,2,"PCPE",0
11,"11028",32488,21971,21672,316,299,"PCPE",32
50,"50075",80,62,61,1,1,"PCPE",0
2,"2044",1105,768,758,7,10,"PCPE",2
16,"16086",890,740,735,6,5,"PCPE",1
26,"26113",35,35,34,0,1,"PCPE",0
22,"22186",181,130,129,1,1,"PCPE",0
47,"47132",45,36,33,1,3,"PCPE",0
1,"1046",601,432,428,3,4,"PCPE",0
22,"22058",194,164,162,1,2,"PCPE",1
47,"47133",2682,2033,2015,16,18,"PCPE",0
34,"34047",1782,1397,1374,12,23,"PCPE",0
42,"42015",30,20,19,1,1,"PCPE",0
4,"4020",288,201,197,0,4,"PCPE",0
50,"50183",331,246,246,3,0,"PCPE",0
37,"37276",143,104,103,1,1,"PCPE",0
26,"26140",253,208,206,0,2,"PCPE",0
29,"29056",1098,757,750,5,7,"PCPE",1
3,"3070",2051,1455,1437,7,18,"PCPE",2
9,"9380",78,58,58,0,0,"PCPE",0
33,"33017",3144,2094,2071,35,23,"PCPE",0
28,"28169",1448,1122,1113,5,9,"PCPE",0
16,"16278",70,55,55,0,0,"PCPE",0
49,"49107",126,94,93,2,1,"PCPE",0
39,"39061",3478,2695,2677,13,18,"PCPE",5
46,"46050",194,150,149,0,1,"PCPE",0
24,"24032",109,91,89,0,2,"PCPE",0
49,"49230",97,72,72,0,0,"PCPE",0
48,"48010",458,318,317,0,1,"PCPE",0
50,"50215",24,19,19,0,0,"PCPE",0
9,"9424",36,29,29,1,0,"PCPE",0
26,"26002",830,632,622,0,10,"PCPE",1
37,"37017",245,182,177,1,5,"PCPE",0
23,"23053",9531,6704,6658,37,46,"PCPE",14
45,"45104",428,324,323,1,1,"PCPE",1
9,"9199",92,72,71,1,1,"PCPE",1
44,"44133",21,15,15,0,0,"PCPE",1
45,"45071",1835,1426,1408,5,18,"PCPE",2
50,"50278",197,145,145,0,0,"PCPE",1
22,"22142",97,75,74,1,1,"PCPE",0
37,"37062",83,65,64,1,1,"PCPE",0
24,"24178",70,59,58,0,1,"PCPE",0
16,"16121",258,202,202,3,0,"PCPE",0
26,"26037",128,108,108,2,0,"PCPE",0
47,"47106",50,39,39,0,0,"PCPE",0
40,"40905",133,103,100,1,3,"PCPE",0
2,"2062",408,297,292,0,5,"PCPE",0
47,"47053",119,98,96,0,2,"PCPE",0
16,"16122",249,188,187,0,1,"PCPE",0
49,"49110",348,231,229,0,2,"PCPE",0
50,"50248",508,387,374,2,13,"PCPE",0
42,"42195",101,62,62,0,0,"PCPE",0
46,"46026",1204,1015,1004,3,11,"PCPE",0
28,"28113",34751,25832,25612,120,220,"PCPE",28
50,"50028",78,51,51,0,0,"PCPE",0
11,"11022",48675,26491,26256,270,235,"PCPE",37
4,"4024",3074,2347,2327,20,20,"PCPE",3
37,"37033",95,68,68,5,0,"PCPE",1
50,"50156",215,181,178,2,3,"PCPE",1
39,"39064",1345,1031,1015,7,16,"PCPE",6
28,"28082",5683,4324,4286,25,38,"PCPE",4
37,"37021",79,60,60,0,0,"PCPE",0
9,"9340",77,49,49,0,0,"PCPE",0
9,"9219",27509,19084,18859,146,225,"PCPE",20
46,"46140",344,284,279,0,5,"PCPE",0
37,"37212",104,78,74,0,4,"PCPE",0
40,"40158",17,12,12,0,0,"PCPE",0
16,"16003",125,105,104,0,1,"PCPE",0
40,"40004",459,356,352,2,4,"PCPE",0
44,"44205",700,460,453,4,7,"PCPE",0
50,"50061",202,172,172,3,0,"PCPE",0
24,"24049",1483,1054,1048,6,6,"PCPE",1
3,"3075",147,128,128,0,0,"PCPE",0
34,"34038",277,204,203,1,1,"PCPE",0
42,"42107",74,54,54,3,0,"PCPE",0
28,"28173",517,390,388,1,2,"PCPE",0
21,"21070",6258,4165,4092,48,73,"PCPE",6
40,"40200",40,31,31,0,0,"PCPE",0
50,"50168",28,27,27,0,0,"PCPE",0
9,"9265",37,28,28,0,0,"PCPE",0
48,"48025",883,642,637,7,5,"PCPE",0
37,"37023",1413,1072,1060,5,12,"PCPE",1
48,"48075",1996,1364,1359,6,5,"PCPE",0
44,"44033",269,191,190,0,1,"PCPE",0
24,"24016",466,270,269,1,1,"PCPE",0
37,"37024",89,67,67,0,0,"PCPE",0
42,"42108",12,9,9,1,0,"PCPE",0
3,"3046",1599,1153,1143,8,10,"PCPE",1
47,"47111",1020,742,732,7,10,"PCPE",0
22,"22107",112,74,74,0,0,"PCPE",0
22,"22234",794,552,544,3,8,"PCPE",1
16,"16128",63,50,50,0,0,"PCPE",0
28,"28183",1039,743,735,2,8,"PCPE",1
37,"37160",615,434,429,8,5,"PCPE",1
46,"46003",950,791,769,1,22,"PCPE",0
46,"46055",1262,1025,1012,5,13,"PCPE",1
21,"21033",538,373,370,3,3,"PCPE",1
22,"22151",93,64,64,1,0,"PCPE",0
34,"34181",448,322,319,7,3,"PCPE",0
9,"9346",92,64,63,1,1,"PCPE",1
46,"46012",896,682,663,1,19,"PCPE",0
16,"16906",80,67,67,1,0,"PCPE",0
49,"49237",165,119,117,2,2,"PCPE",0
46,"46056",182,167,166,1,1,"PCPE",1
28,"28175",863,670,668,5,2,"PCPE",0
40,"40077",842,632,619,3,13,"PCPE",1
40,"40121",280,226,218,3,8,"PCPE",0
44,"44002",47,40,40,0,0,"PCPE",0
49,"49033",714,508,505,1,3,"PCPE",0
50,"50094",1617,1173,1159,12,14,"PCPE",3
47,"47057",268,197,196,0,1,"PCPE",0
9,"9432",182,145,138,0,7,"PCPE",0
46,"46108",469,378,375,1,3,"PCPE",0
28,"28176",12491,9723,9667,37,56,"PCPE",3
44,"44209",833,611,602,6,9,"PCPE",0
37,"37120",99,82,78,0,4,"PCPE",0
46,"46161",1483,1188,1173,7,15,"PCPE",0
49,"49155",79,61,60,3,1,"PCPE",0
42,"42065",21,18,18,0,0,"PCPE",0
50,"50065",53,43,43,0,0,"PCPE",0
41,"41083",1147,864,856,4,8,"PCPE",1
37,"37302",290,196,195,2,1,"PCPE",0
26,"26077",22,22,21,1,1,"PCPE",0
9,"9076",23,17,17,1,0,"PCPE",1
37,"37177",289,220,219,2,1,"PCPE",1
34,"34206",866,661,654,4,7,"PCPE",0
44,"44143",380,307,306,2,1,"PCPE",3
49,"49240",206,162,161,2,1,"PCPE",0
26,"26011",7321,5133,5083,38,50,"PCPE",2
42,"42027",76,61,60,0,1,"PCPE",0
14,"14060",4868,3473,3412,41,61,"PCPE",2
22,"22252",121,86,81,0,5,"PCPE",0
28,"28023",4775,3755,3735,12,20,"PCPE",2
40,"40124",237,182,177,6,5,"PCPE",2
44,"44211",42,35,35,0,0,"PCPE",0
4,"4065",363,284,282,7,2,"PCPE",0
28,"28088",261,178,178,0,0,"PCPE",0
37,"37002",139,87,86,0,1,"PCPE",0
37,"37029",209,137,135,1,2,"PCPE",0
29,"29067",424813,286785,284689,2351,2096,"PCPE",406
42,"42151",34,26,26,0,0,"PCPE",0
44,"44245",248,179,176,2,3,"PCPE",0
44,"44145",1020,719,709,9,10,"PCPE",0
16,"16134",4371,3288,3254,20,34,"PCPE",3
4,"4001",1062,823,814,5,9,"PCPE",1
50,"50067",14119,9909,9819,112,90,"PCPE",8
50,"50120",52,40,40,1,0,"PCPE",0
2,"2901",2200,1440,1437,7,3,"PCPE",1
22,"22012",111,87,86,3,1,"PCPE",0
24,"24055",708,516,512,0,4,"PCPE",0
41,"41075",10212,6419,6295,49,124,"PCPE",5
9,"9216",387,270,265,1,5,"PCPE",0
20,"20075",4371,2692,2679,18,13,"PCPE",1
4,"4046",858,609,599,7,10,"PCPE",0
18,"18001",251,168,167,5,1,"PCPE",0
9,"9902",458,331,327,3,4,"PCPE",2
49,"49082",359,304,301,6,3,"PCPE",1
9,"9043",192,137,133,1,4,"PCPE",0
14,"14006",1330,1120,1101,8,19,"PCPE",1
16,"16137",54,32,31,1,1,"PCPE",0
9,"9903",3221,2304,2281,27,23,"PCPE",4
14,"14062",1025,806,792,6,14,"PCPE",1
40,"40210",106,74,71,0,3,"PCPE",0
37,"37209",412,272,270,7,2,"PCPE",1
29,"29082",31885,22572,22400,152,172,"PCPE",98
40,"40127",32,25,25,0,0,"PCPE",0
22,"22205",438,322,320,0,2,"PCPE",0
14,"14007",15207,10558,10417,82,141,"PCPE",10
9,"9003",194,147,146,0,1,"PCPE",0
26,"26154",13,10,10,0,0,"PCPE",0
46,"46139",4485,3617,3574,18,43,"PCPE",0
16,"16189",264,206,205,4,1,"PCPE",0
24,"24091",645,454,451,1,3,"PCPE",0
41,"41099",3976,2369,2347,12,22,"PCPE",2
49,"49003",900,612,599,5,13,"PCPE",0
4,"4099",4989,3636,3588,27,48,"PCPE",1
14,"14063",1046,734,725,2,9,"PCPE",1
41,"41088",509,360,356,0,4,"PCPE",0
47,"47019",85,74,73,0,1,"PCPE",0
18,"18153",8597,6024,5972,40,52,"PCPE",20
30,"30042",1922,1504,1491,7,13,"PCPE",0
45,"45117",747,606,601,4,5,"PCPE",0
9,"9386",54,39,38,1,1,"PCPE",0
50,"50280",332,253,250,0,3,"PCPE",1
46,"46001",795,601,592,3,9,"PCPE",1
50,"50009",105,80,80,0,0,"PCPE",0
22,"22176",173,134,130,1,4,"PCPE",0
2,"2024",3409,2589,2554,29,35,"PCPE",4
9,"9905",384,279,279,2,0,"PCPE",0
23,"23097",6443,4117,4063,21,54,"PCPE",6
33,"33021",4573,3024,2971,22,53,"PCPE",4
26,"26083",284,205,205,2,0,"PCPE",1
44,"44149",103,78,78,3,0,"PCPE",0
14,"14009",2788,1852,1834,20,18,"PCPE",1
49,"49005",149,91,91,2,0,"PCPE",0
23,"23098",867,713,701,1,12,"PCPE",2
37,"37036",61,44,43,0,1,"PCPE",0
44,"44195",88,60,60,1,0,"PCPE",0
50,"50125",360,248,246,3,2,"PCPE",0
29,"29051",40391,25780,25419,232,361,"PCPE",19
45,"45086",496,351,343,2,8,"PCPE",0
45,"45186",3061,2242,2214,11,28,"PCPE",1
18,"18006",4130,2904,2864,13,40,"PCPE",5
37,"37037",117,84,82,0,2,"PCPE",0
9,"9221",461,343,338,3,5,"PCPE",2
42,"42215",773,531,520,7,11,"PCPE",1
46,"46063",1756,1367,1345,15,22,"PCPE",4
47,"47092",110,87,87,0,0,"PCPE",0
1,"1028",1070,716,710,3,6,"PCPE",1
46,"46037",1122,936,923,4,13,"PCPE",2
49,"49138",234,184,184,3,0,"PCPE",0
24,"24104",259,169,169,0,0,"PCPE",1
22,"22181",92,61,61,2,0,"PCPE",0
46,"46220",48410,34644,34292,279,352,"PCPE",73
50,"50105",296,214,211,1,3,"PCPE",1
22,"22006",298,204,204,5,0,"PCPE",0
1,"1030",156,129,129,3,0,"PCPE",0
9,"9011",65,48,48,0,0,"PCPE",0
37,"37342",259,189,186,0,3,"PCPE",0
40,"40019",36,31,31,1,0,"PCPE",0
18,"18010",566,427,421,1,6,"PCPE",1
37,"37039",301,217,213,0,4,"PCPE",0
16,"16006",120,98,96,3,2,"PCPE",0
4,"4008",505,423,417,5,6,"PCPE",0
45,"45055",1020,821,790,6,31,"PCPE",0
46,"46221",352,305,304,0,1,"PCPE",0
16,"16007",1177,888,880,7,8,"PCPE",0
46,"46143",4239,3104,3053,14,51,"PCPE",3
29,"29064",503,348,339,8,9,"PCPE",1
37,"37301",74,63,63,0,0,"PCPE",0
3,"3090",17182,12487,12385,74,102,"PCPE",22
9,"9179",41,32,32,1,0,"PCPE",0
45,"45122",5212,4004,3961,16,43,"PCPE",5
40,"40135",283,236,231,2,5,"PCPE",0
37,"37217",58,45,44,0,1,"PCPE",0
22,"22124",201,144,143,1,1,"PCPE",0
50,"50172",193,132,129,1,3,"PCPE",0
46,"46222",384,307,304,1,3,"PCPE",0
47,"47176",219,139,139,1,0,"PCPE",0
20,"20062",973,653,653,11,0,"PCPE",0
9,"9348",148,111,110,2,1,"PCPE",0
24,"24019",354,272,267,3,5,"PCPE",0
3,"3029",245,185,183,1,2,"PCPE",0
9,"9013",48,37,37,0,0,"PCPE",0
9,"9168",290,217,217,3,0,"PCPE",1
50,"50034",826,567,563,5,4,"PCPE",2
49,"49252",320,254,252,5,2,"PCPE",0
24,"24030",4277,3038,3007,11,31,"PCPE",8
24,"24198",592,412,407,2,5,"PCPE",0
47,"47095",38,31,31,0,0,"PCPE",0
29,"29090",1688,1144,1134,15,10,"PCPE",3
20,"20007",310,218,218,3,0,"PCPE",0
42,"42149",381,277,273,2,4,"PCPE",0
49,"49048",124,97,95,0,2,"PCPE",0
44,"44099",709,465,462,3,3,"PCPE",3
22,"22047",243,205,203,2,2,"PCPE",0
29,"29034",467,358,356,0,2,"PCPE",1
37,"37059",124,94,93,1,1,"PCPE",0
44,"44100",185,153,151,0,2,"PCPE",0
50,"50276",125,104,103,2,1,"PCPE",2
40,"40902",123,99,96,1,3,"PCPE",0
9,"9026",386,301,300,0,1,"PCPE",1
9,"9365",29,19,19,0,0,"PCPE",0
49,"49131",264,194,192,6,2,"PCPE",1
9,"9094",53,42,42,1,0,"PCPE",0
26,"26104",13,10,10,0,0,"PCPE",0
33,"33007",1514,946,942,12,4,"PCPE",2
20,"20065",3012,1985,1967,12,18,"PCPE",5
42,"42131",51,37,37,1,0,"PCPE",0
44,"44132",60,54,54,1,0,"PCPE",0
37,"37125",228,161,156,0,5,"PCPE",0
34,"34125",86,65,64,0,1,"PCPE",0
26,"26093",53,39,38,0,1,"PCPE",0
44,"44261",739,536,529,6,7,"PCPE",0
9,"9095",84,61,61,0,0,"PCPE",0
47,"47179",395,293,287,0,6,"PCPE",0
39,"39082",1653,1173,1157,11,16,"PCPE",2
18,"18016",307,235,233,0,2,"PCPE",0
50,"50175",1002,695,688,5,7,"PCPE",3
9,"9229",198,146,143,0,3,"PCPE",0
34,"34019",125,107,105,0,2,"PCPE",0
40,"40055",37,26,26,0,0,"PCPE",0
18,"18151",260,171,170,3,1,"PCPE",0
41,"41087",10237,6923,6774,48,149,"PCPE",7
16,"16153",949,778,772,7,6,"PCPE",0
46,"46225",337,290,281,5,9,"PCPE",1
29,"29004",312,236,233,2,3,"PCPE",1
50,"50268",44,37,37,0,0,"PCPE",0
28,"28063",258,194,193,1,1,"PCPE",0
3,"3063",26462,18591,18492,91,99,"PCPE",33
41,"41022",4290,2889,2851,21,38,"PCPE",0
16,"16060",744,565,554,7,11,"PCPE",1
28,"28132",11685,8130,8062,56,68,"PCPE",14
46,"46017",32949,23913,23685,142,228,"PCPE",17
9,"9274",1079,848,835,12,13,"PCPE",5
47,"47217",1910,1370,1366,1,4,"PCPE",5
33,"33040",4549,2986,2942,35,44,"PCPE",4
16,"16170",692,501,493,4,8,"PCPE",1
39,"39094",848,655,651,3,4,"PCPE",1
22,"22051",100,81,81,0,0,"PCPE",0
16,"16108",49,45,42,0,3,"PCPE",0
20,"20023",441,252,251,1,1,"PCPE",0
18,"18184",2168,1629,1607,13,22,"PCPE",2
22,"22164",35,28,28,0,0,"PCPE",0
1,"1010",2268,1623,1603,11,20,"PCPE",1
50,"50249",302,226,220,0,6,"PCPE",0
9,"9403",94,78,78,1,0,"PCPE",0
34,"34005",851,673,658,4,15,"PCPE",1
42,"42009",78,63,63,0,0,"PCPE",0
40,"40016",58,49,49,0,0,"PCPE",0
37,"37051",85,66,66,0,0,"PCPE",0
41,"41090",3523,2576,2512,13,64,"PCPE",7
28,"28104",14040,11151,11096,57,55,"PCPE",11
46,"46227",905,711,702,1,9,"PCPE",1
9,"9372",212,176,176,4,0,"PCPE",0
48,"48065",3281,2271,2237,8,34,"PCPE",0
46,"46158",1026,811,795,6,16,"PCPE",1
9,"9326",140,112,111,0,1,"PCPE",0
26,"26084",6696,5012,4955,35,57,"PCPE",9
16,"16033",1714,1319,1305,6,14,"PCPE",2
30,"30023",3780,2874,2850,12,24,"PCPE",2
47,"47003",227,180,179,3,1,"PCPE",0
34,"34025",57,39,39,1,0,"PCPE",0
26,"26099",1264,1003,991,9,12,"PCPE",1
47,"47074",149,117,116,2,1,"PCPE",0
3,"3005",7769,5917,5866,19,51,"PCPE",15
28,"28039",128,98,97,2,1,"PCPE",1
2,"2054",386,291,290,0,1,"PCPE",1
41,"41091",541987,385251,382091,3298,3160,"PCPE",404
49,"49190",63,47,45,0,2,"PCPE",0
45,"45109",2883,2271,2214,9,57,"PCPE",1
47,"47048",188,144,144,1,0,"PCPE",0
16,"16019",214,156,152,0,4,"PCPE",1
24,"24172",418,255,250,2,5,"PCPE",1
18,"18908",801,593,588,3,5,"PCPE",3
2,"2055",1127,679,668,6,11,"PCPE",1
37,"37271",368,297,296,0,1,"PCPE",0
50,"50220",40,32,32,0,0,"PCPE",0
24,"24039",2063,1597,1596,41,1,"PCPE",0
29,"29042",14016,9368,9192,88,176,"PCPE",6
44,"44141",135,97,96,1,1,"PCPE",0
26,"26135",164,125,124,1,1,"PCPE",1
4,"4052",12274,8372,8306,93,66,"PCPE",7
37,"37104",27,22,22,0,0,"PCPE",0
49,"49141",340,248,246,0,2,"PCPE",0
28,"28117",104,89,89,1,0,"PCPE",0
44,"44163",126,94,94,1,0,"PCPE",0
16,"16066",2325,1788,1745,19,43,"PCPE",4
9,"9377",632,485,480,1,5,"PCPE",0
2,"2056",1718,1296,1274,6,22,"PCPE",0
20,"20072",4728,2902,2886,21,16,"PCPE",3
37,"37316",744,563,558,3,5,"PCPE",0
49,"49021",14330,9878,9758,95,120,"PCPE",9
46,"46178",4637,3405,3381,27,24,"PCPE",0
47,"47023",2995,2344,2326,18,18,"PCPE",2
46,"46048",3452,2749,2713,14,36,"PCPE",9
21,"21021",12254,7339,7244,78,95,"PCPE",6
18,"18115",2553,1800,1781,17,19,"PCPE",3
49,"49047",107,75,75,0,0,"PCPE",0
50,"50107",947,738,733,4,5,"PCPE",0
34,"34237",592,462,452,6,10,"PCPE",3
3,"3019",15269,11520,11398,72,122,"PCPE",22
37,"37090",52,43,43,0,0,"PCPE",0
41,"41017",15158,10718,10616,92,102,"PCPE",97
45,"45023",2177,1571,1556,6,15,"PCPE",0
24,"24041",538,367,366,3,1,"PCPE",1
37,"37275",118,70,69,0,1,"PCPE",1
20,"20040",15289,9444,9373,66,71,"PCPE",7
4,"4085",387,304,301,2,3,"PCPE",0
45,"45179",525,391,386,3,5,"PCPE",1
50,"50245",88,65,64,0,1,"PCPE",0
33,"33046",499,379,367,5,12,"PCPE",0
21,"21037",472,341,336,2,5,"PCPE",0
21,"21022",171,107,105,0,2,"PCPE",0
49,"49145",236,162,157,0,5,"PCPE",1
37,"37123",177,126,126,0,0,"PCPE",0
46,"46214",15766,12131,12036,42,95,"PCPE",8
16,"16133",4389,3358,3316,24,42,"PCPE",8
29,"29012",9755,6689,6599,71,90,"PCPE",4
3,"3134",143,112,111,0,1,"PCPE",1
37,"37206",94,73,73,3,0,"PCPE",0
37,"37060",243,187,187,1,0,"PCPE",1
9,"9243",76,59,57,1,2,"PCPE",0
46,"46232",895,711,696,5,15,"PCPE",4
9,"9041",28,27,27,0,0,"PCPE",0
23,"23079",3717,2825,2801,28,24,"PCPE",2
41,"41019",4691,3089,3056,27,33,"PCPE",4
40,"40903",86,67,67,0,0,"PCPE",0
16,"16119",169,127,127,0,0,"PCPE",0
20,"20020",125,71,69,3,2,"PCPE",0
49,"49146",295,216,213,3,3,"PCPE",0
48,"48915",362,227,226,0,1,"PCPE",0
40,"40166",253,218,215,1,3,"PCPE",0
46,"46181",16955,12313,12148,95,165,"PCPE",8
26,"26105",2205,1670,1658,12,12,"PCPE",0
16,"16027",710,542,538,5,4,"PCPE",0
34,"34035",111,98,97,0,1,"PCPE",0
3,"3012",1085,852,841,3,11,"PCPE",0
18,"18915",745,533,525,2,8,"PCPE",2
46,"46103",1264,1015,984,7,31,"PCPE",10
49,"49185",157,123,122,2,1,"PCPE",0
47,"47162",74,60,60,0,0,"PCPE",0
22,"22023",421,313,309,6,4,"PCPE",1
26,"26177",304,255,254,7,1,"PCPE",0
26,"26070",183,153,153,1,0,"PCPE",0
29,"29014",217,141,140,4,1,"PCPE",1
28,"28112",161,136,136,1,0,"PCPE",0
2,"2063",1463,1073,1060,3,13,"PCPE",1
40,"40029",35,27,26,0,1,"PCPE",0
24,"24014",7425,5124,5053,32,71,"PCPE",3
37,"37323",516,376,372,5,4,"PCPE",0
26,"26178",75,57,55,1,2,"PCPE",0
1,"1051",3603,2259,2235,17,24,"PCPE",4
39,"39033",568,418,415,2,3,"PCPE",0
20,"20012",147,99,98,5,1,"PCPE",0
16,"16044",39,30,30,0,0,"PCPE",0
29,"29027",2326,1626,1609,12,17,"PCPE",1
46,"46174",972,764,752,2,12,"PCPE",2
50,"50113",618,489,484,2,5,"PCPE",0
37,"37067",3163,2496,2467,31,29,"PCPE",2
49,"49271",194,145,141,1,4,"PCPE",0
37,"37226",155,123,123,2,0,"PCPE",0
16,"16078",41429,30053,29775,235,278,"PCPE",14
4,"4059",1079,723,712,4,11,"PCPE",1
47,"47146",255,206,204,1,2,"PCPE",1
50,"50229",62,47,47,2,0,"PCPE",0
20,"20078",1155,850,846,4,4,"PCPE",1
37,"37035",190,150,150,2,0,"PCPE",1
9,"9071",41,35,35,1,0,"PCPE",0
42,"42156",28,16,16,1,0,"PCPE",0
26,"26145",246,197,197,2,0,"PCPE",2
37,"37116",69,50,50,0,0,"PCPE",0
37,"37242",91,74,73,0,1,"PCPE",0
33,"33042",4306,2988,2970,35,18,"PCPE",5
45,"45107",3257,2504,2472,15,32,"PCPE",2
9,"9248",78,59,59,1,0,"PCPE",0
26,"26028",134,113,112,0,1,"PCPE",0
24,"24150",243,172,172,6,0,"PCPE",0
16,"16172",325,268,267,1,1,"PCPE",0
47,"47199",80,63,63,0,0,"PCPE",0
28,"28047",40914,30019,29788,169,231,"PCPE",20
9,"9009",163,133,131,2,2,"PCPE",2
50,"50159",665,512,507,2,5,"PCPE",0
47,"47083",80,59,54,1,5,"PCPE",0
42,"42198",23,16,16,4,0,"PCPE",0
46,"46185",378,320,313,2,7,"PCPE",0
49,"49152",525,339,334,2,5,"PCPE",0
23,"23086",11511,7997,7874,91,123,"PCPE",29
4,"4028",221,191,190,1,1,"PCPE",0
4,"4038",3084,2140,2126,16,14,"PCPE",2
40,"40146",254,197,196,0,1,"PCPE",0
21,"21018",1769,1120,1095,11,25,"PCPE",0
48,"48076",308,218,217,2,1,"PCPE",0
34,"34233",130,107,107,1,0,"PCPE",0
37,"37200",187,136,136,0,0,"PCPE",0
3,"3067",99,85,85,0,0,"PCPE",0
9,"9298",82,70,69,1,1,"PCPE",0
49,"49076",321,217,217,2,0,"PCPE",0
9,"9178",47,35,35,0,0,"PCPE",0
4,"4072",313,247,245,2,2,"PCPE",0
40,"40134",731,579,570,1,9,"PCPE",3
41,"41015",5297,3478,3405,41,73,"PCPE",5
3,"3017",374,314,307,1,7,"PCPE",0
9,"9122",94,67,66,1,1,"PCPE",0
50,"50283",70,57,57,1,0,"PCPE",0
34,"34234",71,52,50,0,2,"PCPE",0
1,"1043",2304,1552,1532,13,20,"PCPE",0
20,"20901",1437,908,906,2,2,"PCPE",0
50,"50002",143,108,104,1,4,"PCPE",0
3,"3078",478,389,389,5,0,"PCPE",0
24,"24084",163,116,116,0,0,"PCPE",0
34,"34134",50,40,40,2,0,"PCPE",0
47,"47058",200,145,143,0,2,"PCPE",0
49,"49193",467,313,308,4,5,"PCPE",0
23,"23038",3587,2794,2770,16,24,"PCPE",5
3,"3089",9571,6775,6639,47,136,"PCPE",6
44,"44003",19,17,17,0,0,"PCPE",0
42,"42026",24,20,20,0,0,"PCPE",0
28,"28050",4076,2860,2839,21,21,"PCPE",3
24,"24142",25119,17336,17141,154,195,"PCPE",30
23,"23009",12861,9649,9543,72,106,"PCPE",11
11,"11006",24455,15750,15587,193,163,"PCPE",19
22,"22009",617,444,441,6,3,"PCPE",1
3,"3112",628,511,507,2,4,"PCPE",0
28,"28177",10270,8083,8030,36,53,"PCPE",6
46,"46213",15409,10924,10805,97,119,"PCPE",14
46,"46196",147,125,125,1,0,"PCPE",0
44,"44036",25,21,21,0,0,"PCPE",0
42,"42205",89,71,71,2,0,"PCPE",0
49,"49117",465,330,324,6,6,"PCPE",0
9,"9362",208,172,171,2,1,"PCPE",0
39,"39080",3542,2656,2628,20,28,"PCPE",1
9,"9064",324,271,267,1,4,"PCPE",0
50,"50203",1040,748,739,7,9,"PCPE",0
23,"23092",27775,19734,19541,175,193,"PCPE",19
9,"9485",55,43,42,0,1,"PCPE",0
49,"49143",225,163,162,0,1,"PCPE",0
16,"16087",208,179,177,5,2,"PCPE",0
39,"39090",756,553,542,0,11,"PCPE",0
47,"47168",29,26,26,1,0,"PCPE",0
45,"45028",3649,2701,2673,12,28,"PCPE",4
44,"44026",90,77,76,0,1,"PCPE",0
41,"41096",6161,4553,4476,32,77,"PCPE",2
50,"50286",77,50,50,3,0,"PCPE",0
46,"46241",392,299,291,1,8,"PCPE",0
46,"46206",571,453,445,2,8,"PCPE",0
37,"37151",148,125,124,2,1,"PCPE",1
16,"16218",191,150,150,3,0,"PCPE",0
18,"18057",5305,3827,3791,27,36,"PCPE",4
21,"21011",3453,2441,2419,15,22,"PCPE",4
49,"49094",224,149,149,2,0,"PCPE",0
44,"44006",248,185,183,2,2,"PCPE",0
9,"9016",85,60,59,3,1,"PCPE",0
16,"16103",261,222,222,0,0,"PCPE",0
44,"44212",39,37,37,1,0,"PCPE",0
1,"1060",197,160,157,0,3,"PCPE",0
42,"42208",22,13,13,2,0,"PCPE",0
42,"42006",163,109,107,2,2,"PCPE",0
50,"50165",1814,1287,1264,26,23,"PCPE",1
18,"18181",223,174,172,0,2,"PCPE",0
46,"46086",82,70,69,1,1,"PCPE",0
45,"45115",2552,1999,1966,8,33,"PCPE",0
28,"28053",6498,4995,4955,28,40,"PCPE",5
49,"49201",302,270,268,3,2,"PCPE",0
34,"34190",56,41,40,2,1,"PCPE",0
47,"47170",33,28,27,2,1,"PCPE",0
37,"37208",76,56,54,1,2,"PCPE",0
14,"14035",5966,4236,4177,39,59,"PCPE",2
9,"9308",67,42,42,1,0,"PCPE",0
34,"34192",90,75,72,0,3,"PCPE",0
9,"9259",230,186,186,5,0,"PCPE",1
23,"23055",47167,31479,31198,264,281,"PCPE",44
24,"24122",1342,930,924,8,6,"PCPE",1
9,"9904",478,374,370,5,4,"PCPE",1
18,"18183",658,438,434,3,4,"PCPE",0
44,"44114",243,178,173,0,5,"PCPE",0
40,"40184",258,211,210,2,1,"PCPE",0
47,"47001",55,46,46,0,0,"PCPE",0
50,"50297",498961,362043,359558,2748,2485,"PCPE",409
45,"45128",2502,1680,1668,6,12,"PCPE",2
3,"3088",5498,4041,3989,29,52,"PCPE",13
37,"37254",181,142,141,0,1,"PCPE",0
45,"45039",224,192,190,0,2,"PCPE",0
41,"41044",7423,5273,5241,34,32,"PCPE",3
49,"49203",313,240,232,0,8,"PCPE",0
50,"50298",5333,3949,3902,39,47,"PCPE",4
37,"37366",43,32,32,0,0,"PCPE",0
47,"47172",144,124,122,0,2,"PCPE",0
34,"34082",83,74,73,0,1,"PCPE",0
30,"30012",9091,6962,6897,36,65,"PCPE",4
34,"34053",207,170,169,3,1,"PCPE",0
45,"45052",2948,2321,2295,16,26,"PCPE",5
24,"24170",1908,1365,1345,8,20,"PCPE",3
1,"1901",2354,1592,1571,8,21,"PCPE",2
22,"22117",2478,1714,1693,22,21,"PCPE",3
26,"26157",296,241,237,4,4,"PCPE",0
49,"49099",115,87,87,0,0,"PCPE",0
23,"23046",2391,1916,1895,6,21,"PCPE",3
18,"18109",597,411,408,2,3,"PCPE",0
22,"22178",103,82,81,0,1,"PCPE",0
34,"34179",28,21,20,0,1,"PCPE",0
33,"33022",893,578,567,11,11,"PCPE",25
46,"46115",378,286,282,1,4,"PCPE",0
34,"34055",270,209,207,2,2,"PCPE",0
44,"44183",77,50,49,0,1,"PCPE",0
3,"3086",151,135,134,1,1,"PCPE",0
42,"42124",64,49,49,0,0,"PCPE",0
34,"34901",1104,825,814,5,11,"PCPE",0
37,"37085",4712,3366,3333,27,33,"PCPE",2
22,"22079",118,83,83,1,0,"PCPE",0
37,"37102",404,307,305,2,2,"PCPE",0
26,"26008",1860,1399,1387,5,12,"PCPE",0
22,"22064",166,122,121,1,1,"PCPE",0
46,"46261",1725,1356,1337,5,19,"PCPE",0
9,"9177",1121,757,749,9,8,"PCPE",0
23,"23101",378,276,271,1,5,"PCPE",0
50,"50903",2214,1602,1585,8,17,"PCPE",0
45,"45187",4062,3277,3233,15,44,"PCPE",0
42,"42036",50,41,41,1,0,"PCPE",0
33,"33044",178278,125469,124554,1124,915,"PCPE",201
46,"46217",878,691,676,4,15,"PCPE",0
37,"37103",436,310,308,8,2,"PCPE",1
33,"33064",234,168,167,1,1,"PCPE",0
4,"4007",734,524,522,1,2,"PCPE",2
28,"28901",799,558,554,0,4,"PCPE",2
39,"39077",236,173,171,1,2,"PCPE",0
16,"16146",83,57,57,0,0,"PCPE",0
3,"3902",10254,6996,6930,34,66,"PCPE",4
23,"23901",1154,970,964,3,6,"PCPE",0
22,"22007",792,581,581,8,0,"PCPE",0
24,"24029",735,539,535,3,4,"PCPE",0
45,"45155",355,291,285,0,6,"PCPE",0
22,"22250",353,261,258,4,3,"PCPE",1
40,"40049",49,43,43,0,0,"PCPE",0
42,"42094",621,444,433,10,11,"PCPE",0
9,"9301",625,473,467,2,6,"PCPE",2
33,"33065",1102,722,713,7,9,"PCPE",0
42,"42145",138,108,107,2,1,"PCPE",0
18,"18011",4335,3037,3015,20,22,"PCPE",5
37,"37344",241,175,174,2,1,"PCPE",0
28,"28148",85454,62367,61884,370,483,"PCPE",57
23,"23062",1454,1141,1128,1,13,"PCPE",0
4,"4030",1119,819,812,5,7,"PCPE",4
9,"9213",307,220,218,2,2,"PCPE",1
45,"45056",2201,1260,1243,12,17,"PCPE",2
26,"26162",121,99,99,1,0,"PCPE",1
37,"37219",173,109,108,0,1,"PCPE",0
9,"9409",111,86,86,4,0,"PCPE",0
33,"33056",4997,3269,3244,22,25,"PCPE",7
26,"26022",198,164,163,1,1,"PCPE",0
9,"9052",29,23,23,0,0,"PCPE",0
9,"9421",230,166,163,3,3,"PCPE",0
46,"46902",364,306,303,0,3,"PCPE",0
49,"49181",362,277,276,2,1,"PCPE",0
1,"1018",1386,939,930,3,9,"PCPE",0
45,"45180",2727,1966,1940,9,26,"PCPE",1
50,"50035",72,54,53,1,1,"PCPE",0
28,"28149",5759,4352,4310,25,42,"PCPE",5
45,"45150",443,356,354,0,2,"PCPE",0
46,"46188",672,544,537,8,7,"PCPE",0
47,"47039",185,141,140,0,1,"PCPE",0
45,"45901",771,547,544,3,3,"PCPE",0
41,"41029",13445,9507,9416,78,91,"PCPE",9
50,"50246",41,28,28,0,0,"PCPE",0
46,"46102",19788,15154,15038,89,116,"PCPE",8
50,"50025",4562,3158,3124,31,34,"PCPE",3
11,"11030",22775,15157,14958,149,199,"PCPE",20
47,"47008",24,19,19,1,0,"PCPE",0
22,"22187",293,218,216,2,2,"PCPE",0
50,"50026",439,335,325,10,10,"PCPE",1
16,"16219",89,71,71,0,0,"PCPE",0
48,"48071",6087,4294,4254,32,40,"PCPE",3
3,"3061",1056,776,768,4,8,"PCPE",0
24,"24132",615,379,375,1,4,"PCPE",0
50,"50046",178,133,133,5,0,"PCPE",0
18,"18105",3782,2450,2420,17,30,"PCPE",4
48,"48061",762,565,561,0,4,"PCPE",0
16,"16104",51,41,41,0,0,"PCPE",0
34,"34079",1616,1222,1205,5,17,"PCPE",0
11,"11042",1186,868,858,7,10,"PCPE",0
16,"16012",84,72,71,0,1,"PCPE",0
46,"46094",20540,15378,15234,102,144,"PCPE",11
22,"22049",78,64,64,0,0,"PCPE",0
44,"44235",92,62,60,0,2,"PCPE",0
44,"44049",849,616,604,9,12,"PCPE",0
9,"9057",145,108,108,0,0,"PCPE",0
4,"4047",2281,1893,1878,11,15,"PCPE",2
23,"23029",843,628,624,2,4,"PCPE",0
46,"46173",1328,1069,1057,4,12,"PCPE",0
34,"34066",59,49,48,0,1,"PCPE",0
33,"33029",350,181,174,2,7,"PCPE",0
42,"42181",412,313,307,2,6,"PCPE",0
9,"9140",124,80,79,0,1,"PCPE",0
44,"44262",135,108,107,2,1,"PCPE",0
24,"24134",3416,2470,2417,19,53,"PCPE",0
40,"40170",1320,1030,1021,7,9,"PCPE",0
44,"44147",412,298,293,5,5,"PCPE",0
9,"9218",369,275,275,1,0,"PCPE",1
21,"21059",221,166,163,5,3,"PCPE",0
50,"50166",255,208,206,2,2,"PCPE",0
29,"29059",2587,1965,1922,14,43,"PCPE",1
21,"21032",1800,1286,1259,10,27,"PCPE",2
23,"23069",5353,4310,4212,27,98,"PCPE",4
42,"42088",67,47,47,1,0,"PCPE",0
9,"9231",69,38,38,1,0,"PCPE",0
42,"42196",10,7,7,0,0,"PCPE",0
42,"42033",48,45,45,1,0,"PCPE",0
37,"37170",1449,994,971,3,23,"PCPE",2
20,"20045",46626,30525,30353,197,172,"PCPE",26
45,"45017",262,204,203,0,1,"PCPE",0
50,"50290",386,283,282,1,1,"PCPE",0
4,"4089",742,521,518,1,3,"PCPE",0
50,"50250",52,44,44,0,0,"PCPE",0
41,"41034",23070,14805,14625,186,180,"PCPE",16
40,"40144",18,14,14,0,0,"PCPE",0
9,"9141",616,485,483,5,2,"PCPE",0
34,"34024",31,21,21,1,0,"PCPE",0
50,"50188",28,25,25,0,0,"PCPE",0
22,"22131",82,63,63,0,0,"PCPE",0
44,"44238",2323,1603,1590,5,13,"PCPE",3
34,"34130",212,164,163,1,1,"PCPE",0
49,"49124",253,174,169,1,5,"PCPE",0
24,"24217",135,109,108,1,1,"PCPE",0
46,"46245",511,420,415,0,5,"PCPE",0
26,"26110",152,131,129,0,2,"PCPE",0
42,"42022",221,173,171,5,2,"PCPE",0
37,"37367",201,164,161,0,3,"PCPE",0
49,"49137",176,139,138,0,1,"PCPE",0
48,"48096",6577,4794,4728,31,66,"PCPE",1
3,"3130",48,25,25,0,0,"PCPE",0
44,"44094",113,94,94,0,0,"PCPE",0
20,"20015",1265,858,851,7,7,"PCPE",0
49,"49205",382,293,291,2,2,"PCPE",0
46,"46046",892,675,668,1,7,"PCPE",0
18,"18083",247,200,196,0,4,"PCPE",1
44,"44160",466,304,301,2,3,"PCPE",0
48,"48006",290,239,239,2,0,"PCPE",0
46,"46098",2482,1907,1889,11,18,"PCPE",1
9,"9214",672,427,427,4,0,"PCPE",1
30,"30025",4908,3667,3630,16,37,"PCPE",4
44,"44001",68,53,52,1,1,"PCPE",1
3,"3006",497,384,380,1,4,"PCPE",3
44,"44185",99,76,75,0,1,"PCPE",0
22,"22144",243,188,187,1,1,"PCPE",1
47,"47203",62,53,53,1,0,"PCPE",0
4,"4093",1882,1216,1204,11,12,"PCPE",2
45,"45165",62718,44420,44006,236,414,"PCPE",26
37,"37232",390,341,339,1,2,"PCPE",0
24,"24152",464,295,291,1,4,"PCPE",0
34,"34042",296,237,234,1,3,"PCPE",0
23,"23037",502,404,400,6,4,"PCPE",0
46,"46047",532,446,437,2,9,"PCPE",0
9,"9149",35,24,24,2,0,"PCPE",0
4,"4029",8859,5834,5790,35,44,"PCPE",8
47,"47184",573,453,451,1,2,"PCPE",2
20,"20050",266,170,169,1,1,"PCPE",0
29,"29054",41997,28422,28238,189,184,"PCPE",20
44,"44129",39,32,32,0,0,"PCPE",0
50,"50216",235,186,184,5,2,"PCPE",0
50,"50182",3399,2364,2335,21,29,"PCPE",2
24,"24174",486,343,342,4,1,"PCPE",1
11,"11005",4583,3018,2967,25,51,"PCPE",4
42,"42113",534,409,399,1,10,"PCPE",1
24,"24154",1005,673,666,4,7,"PCPE",0
4,"4009",162,123,122,2,1,"PCPE",0
40,"40078",161,125,124,2,1,"PCPE",0
33,"33076",12258,8106,8031,63,75,"PCPE",10
41,"41039",31663,22062,21830,193,232,"PCPE",16
26,"26149",57,47,46,0,1,"PCPE",0
34,"34059",426,347,342,6,5,"PCPE",1
50,"50024",571,437,437,6,0,"PCPE",1
50,"50255",209,163,163,5,0,"PCPE",0
9,"9316",105,80,80,1,0,"PCPE",0
37,"37234",345,247,247,1,0,"PCPE",0
3,"3039",81,62,61,1,1,"PCPE",0
9,"9283",44,32,31,0,1,"PCPE",0
23,"23016",387,321,320,0,1,"PCPE",0
42,"42209",140,107,106,4,1,"PCPE",0
37,"37293",115,84,84,1,0,"PCPE",0
44,"44113",71,52,52,0,0,"PCPE",0
41,"41059",34165,24949,24709,196,240,"PCPE",33
9,"9189",125,90,87,2,3,"PCPE",0
26,"26087",201,153,149,3,4,"PCPE",0
50,"50194",88,63,63,1,0,"PCPE",0
47,"47223",157,122,118,2,4,"PCPE",0
16,"16243",407,338,334,3,4,"PCPE",1
26,"26001",195,161,157,2,4,"PCPE",1
3,"3103",272,235,234,1,1,"PCPE",0
37,"37361",86,66,66,0,0,"PCPE",0
37,"37277",75,58,58,0,0,"PCPE",0
48,"48091",1121,771,765,7,6,"PCPE",0
26,"26024",228,181,181,0,0,"PCPE",0
18,"18119",1702,1298,1283,13,15,"PCPE",3
26,"26035",17,12,11,0,1,"PCPE",0
37,"37016",569,406,401,2,5,"PCPE",0
50,"50109",103,78,78,3,0,"PCPE",1
48,"48081",1868,1361,1350,4,11,"PCPE",0
29,"29050",421,306,302,3,4,"PCPE",0
28,"28090",8505,6654,6609,33,45,"PCPE",8
18,"18072",667,424,420,0,4,"PCPE",1
46,"46051",8347,6355,6302,24,53,"PCPE",1
20,"20076",6990,4666,4648,29,18,"PCPE",3
42,"42194",170,118,114,1,4,"PCPE",0
33,"33049",6322,4116,4062,43,54,"PCPE",4
42,"42018",152,117,116,1,1,"PCPE",0
34,"34126",277,200,199,2,1,"PCPE",0
2,"2021",1017,784,778,6,6,"PCPE",0
23,"23015",1374,1029,1019,5,10,"PCPE",2
26,"26153",13,12,11,0,1,"PCPE",0
45,"45149",556,446,440,0,6,"PCPE",0
21,"21027",48,36,35,1,1,"PCPE",0
37,"37239",217,185,183,3,2,"PCPE",1
4,"4058",354,261,259,1,2,"PCPE",0
23,"23081",1513,1103,1084,10,19,"PCPE",0
45,"45072",671,484,483,2,1,"PCPE",1
18,"18182",1906,1298,1288,4,10,"PCPE",3
50,"50063",61,51,51,0,0,"PCPE",0
3,"3109",2850,2181,2164,8,17,"PCPE",3
50,"50160",2238,1546,1528,12,18,"PCPE",0
29,"29097",4108,2871,2821,37,50,"PCPE",3
2,"2014",356,283,280,1,3,"PCPE",0
22,"22017",866,650,642,5,8,"PCPE",3
28,"28102",894,644,636,6,8,"PCPE",0
40,"40199",105,84,84,0,0,"PCPE",0
34,"34177",179,149,149,2,0,"PCPE",0
26,"26144",188,155,155,3,0,"PCPE",0
18,"18033",282,201,200,5,1,"PCPE",0
16,"16190",5105,3945,3887,17,58,"PCPE",4
16,"16031",46,28,28,1,0,"PCPE",0
3,"3138",3145,2310,2275,9,35,"PCPE",3
44,"44077",74,60,58,0,2,"PCPE",0
29,"29028",1237,836,826,6,10,"PCPE",0
28,"28124",74,54,54,1,0,"PCPE",1
50,"50157",290,220,218,3,2,"PCPE",0
47,"47190",98,80,80,1,0,"PCPE",0
49,"49029",623,495,488,3,7,"PCPE",1
40,"40054",108,90,90,0,0,"PCPE",0
26,"26006",1800,1419,1405,8,14,"PCPE",1
9,"9428",108,92,91,0,1,"PCPE",0
37,"37312",258,201,200,2,1,"PCPE",0
37,"37353",126,97,97,1,0,"PCPE",0
41,"41101",5928,4209,4173,18,36,"PCPE",7
44,"44159",38,31,31,1,0,"PCPE",0
9,"9176",63,47,46,2,1,"PCPE",0
16,"16142",136,101,101,1,0,"PCPE",0
30,"30901",10309,7821,7718,43,103,"PCPE",8
22,"22195",235,182,181,3,1,"PCPE",1
42,"42061",291,214,213,3,1,"PCPE",1
44,"44206",114,90,87,0,3,"PCPE",1
34,"34100",142,108,108,1,0,"PCPE",0
11,"11036",689,407,400,3,7,"PCPE",0
46,"46124",787,653,642,4,11,"PCPE",1
16,"16236",910,656,651,4,5,"PCPE",0
47,"47157",515,424,423,1,1,"PCPE",0
50,"50031",154,93,93,0,0,"PCPE",1
9,"9292",87,75,73,1,2,"PCPE",0
44,"44215",159,109,109,2,0,"PCPE",0
37,"37127",214,154,151,1,3,"PCPE",0
24,"24057",1373,1045,1023,11,22,"PCPE",0
22,"22222",530,384,379,3,5,"PCPE",0
9,"9235",156,132,131,3,1,"PCPE",0
33,"33061",378,202,200,0,2,"PCPE",0
41,"41026",4314,3380,3322,18,58,"PCPE",7
23,"23021",524,431,429,0,2,"PCPE",2
44,"44108",320,222,222,1,0,"PCPE",0
40,"40162",392,303,302,1,1,"PCPE",0
47,"47084",1150,887,870,7,17,"PCPE",0
40,"40020",157,118,117,1,1,"PCPE",0
3,"3110",291,241,241,1,0,"PCPE",1
9,"9361",115,90,89,0,1,"PCPE",1
37,"37202",978,734,727,10,7,"PCPE",1
37,"37040",391,299,297,2,2,"PCPE",1
18,"18084",4257,3107,3075,26,32,"PCPE",3
28,"28902",471,363,356,4,7,"PCPE",1
49,"49167",197,147,145,0,2,"PCPE",0
50,"50240",1025,729,718,10,11,"PCPE",0
9,"9079",49,45,45,0,0,"PCPE",0
49,"49154",127,78,77,0,1,"PCPE",0
18,"18085",720,507,499,3,8,"PCPE",0
48,"48078",38617,26366,26212,158,154,"PCPE",41
49,"49251",163,127,121,1,6,"PCPE",1
45,"45082",1224,1020,1011,8,9,"PCPE",0
20,"20017",8559,5478,5435,24,43,"PCPE",5
18,"18177",418,258,256,0,2,"PCPE",0
23,"23903",3540,2662,2634,13,28,"PCPE",2
22,"22046",728,566,561,5,5,"PCPE",1
34,"34103",98,77,76,0,1,"PCPE",0
45,"45089",1495,1102,1094,0,8,"PCPE",0
47,"47230",303,246,242,2,4,"PCPE",0
33,"33077",1192,811,808,5,3,"PCPE",0
47,"47177",105,76,73,1,3,"PCPE",1
49,"49202",187,130,130,4,0,"PCPE",0
18,"18003",14022,9938,9820,80,118,"PCPE",11
47,"47213",109,82,82,0,0,"PCPE",0
34,"34027",1085,751,741,6,10,"PCPE",0
28,"28067",4063,3102,3079,3,23,"PCPE",1
49,"49262",392,279,274,1,5,"PCPE",0
24,"24070",4124,3024,2981,20,43,"PCPE",7
9,"9328",76,56,56,0,0,"PCPE",0
16,"16158",535,416,413,5,3,"PCPE",0
30,"30024",58746,42036,41731,206,305,"PCPE",23
16,"16064",684,568,562,4,6,"PCPE",0
26,"26067",22,15,15,1,0,"PCPE",0
47,"47051",335,268,263,2,5,"PCPE",0
9,"9335",88,68,68,0,0,"PCPE",0
44,"44200",39,26,26,0,0,"PCPE",0
40,"40125",87,58,58,1,0,"PCPE",0
30,"30008",13918,9757,9645,59,112,"PCPE",11
40,"40194",39602,29382,29042,206,340,"PCPE",36
20,"20042",3228,1967,1958,27,9,"PCPE",1
22,"22228",514,364,360,5,4,"PCPE",1
44,"44048",61,52,52,0,0,"PCPE",0
47,"47054",635,507,495,9,12,"PCPE",0
26,"26169",64,60,60,0,0,"PCPE",0
44,"44190",71,58,56,0,2,"PCPE",0
26,"26109",81,69,69,0,0,"PCPE",0
14,"14074",2299,1896,1866,16,30,"PCPE",0
22,"22128",188,146,144,3,2,"PCPE",0
9,"9321",1626,1238,1227,8,11,"PCPE",2
4,"4002",1039,748,740,2,8,"PCPE",0
37,"37080",225,171,167,0,4,"PCPE",0
34,"34083",1769,1218,1201,10,17,"PCPE",0
49,"49132",316,235,232,1,3,"PCPE",0
24,"24158",320,207,203,2,4,"PCPE",0
9,"9082",39,36,36,0,0,"PCPE",0
37,"37032",548,401,399,0,2,"PCPE",0
23,"23066",4347,3465,3410,15,55,"PCPE",4
48,"48093",893,653,643,7,10,"PCPE",0
23,"23067",2460,1831,1805,11,26,"PCPE",7
26,"26015",196,158,157,2,1,"PCPE",1
42,"42166",59,45,45,0,0,"PCPE",0
50,"50189",705,527,519,13,8,"PCPE",0
37,"37054",250,195,192,1,3,"PCPE",0
22,"22002",107,95,95,0,0,"PCPE",0
50,"50207",106,93,93,1,0,"PCPE",0
33,"33050",592,387,376,2,11,"PCPE",1
49,"49083",52,44,44,2,0,"PCPE",0
34,"34220",147,126,125,3,1,"PCPE",0
20,"20022",839,473,472,4,1,"PCPE",0
28,"28038",4952,3730,3688,34,42,"PCPE",8
46,"46150",1831,1341,1333,7,8,"PCPE",0
20,"20003",547,308,308,3,0,"PCPE",1
37,"37099",73,41,41,0,0,"PCPE",0
29,"29038",17676,11056,10970,141,86,"PCPE",5
46,"46259",491,396,393,4,3,"PCPE",0
9,"9175",127,94,93,2,1,"PCPE",0
28,"28055",916,693,687,5,6,"PCPE",0
9,"9032",109,75,73,0,2,"PCPE",0
24,"24058",208,155,154,3,1,"PCPE",0
45,"45051",1590,1171,1152,5,19,"PCPE",3
49,"49028",115,104,103,1,1,"PCPE",0
26,"26155",160,132,132,0,0,"PCPE",1
22,"22055",320,243,238,2,5,"PCPE",1
23,"23024",12435,9058,8833,55,225,"PCPE",10
29,"29006",673,428,420,1,8,"PCPE",0
30,"30015",19171,13561,13464,61,97,"PCPE",5
44,"44105",82,64,64,0,0,"PCPE",0
21,"21016",1023,746,723,4,23,"PCPE",0
37,"37148",427,298,295,3,3,"PCPE",0
40,"40118",51,35,34,1,1,"PCPE",0
2,"2048",1226,981,975,7,6,"PCPE",2
3,"3062",212,169,165,0,4,"PCPE",0
48,"48031",332,233,231,1,2,"PCPE",0
9,"9302",112,83,83,1,0,"PCPE",0
40,"40214",208,168,168,2,0,"PCPE",0
50,"50901",138,105,105,0,0,"PCPE",0
42,"42035",769,527,516,2,11,"PCPE",0
16,"16097",156,124,121,0,3,"PCPE",0
50,"50291",96,74,74,0,0,"PCPE",0
47,"47047",199,157,156,2,1,"PCPE",0
41,"41058",17395,12556,12332,111,224,"PCPE",11
39,"39029",618,488,481,3,7,"PCPE",0
23,"23030",1238,968,960,3,8,"PCPE",1
26,"26063",124,94,94,2,0,"PCPE",1
45,"45131",282,234,230,0,4,"PCPE",0
37,"37187",572,427,423,1,4,"PCPE",0
20,"20004",252,121,121,0,0,"PCPE",0
45,"45030",478,368,360,2,8,"PCPE",0
1,"1002",8124,5722,5654,31,68,"PCPE",4
22,"22053",789,520,513,9,7,"PCPE",1
41,"41012",3290,2071,2030,20,41,"PCPE",1
45,"45110",1786,1403,1398,5,5,"PCPE",0
34,"34114",207,144,144,0,0,"PCPE",0
9,"9198",104,83,82,1,1,"PCPE",1
28,"28070",117,91,91,0,0,"PCPE",0
49,"49127",2367,1668,1650,16,18,"PCPE",2
28,"28030",1726,1320,1299,8,21,"PCPE",0
3,"3040",254,216,213,2,3,"PCPE",0
33,"33014",9037,5999,5938,53,61,"PCPE",29
45,"45143",1170,881,874,4,7,"PCPE",2
26,"26009",401,325,321,4,4,"PCPE",1
22,"22081",254,181,181,0,0,"PCPE",0
37,"37061",225,168,168,1,0,"PCPE",0
16,"16239",135,110,105,0,5,"PCPE",0
3,"3903",2494,1880,1865,7,15,"PCPE",3
11,"11023",9348,6410,6349,64,61,"PCPE",5
46,"46218",1060,910,885,7,25,"PCPE",0
45,"45059",1712,1337,1311,1,26,"PCPE",3
24,"24157",2568,1943,1911,22,32,"PCPE",2
3,"3008",168,130,129,0,1,"PCPE",0
34,"34088",246,193,186,1,7,"PCPE",0
42,"42193",14,10,10,0,0,"PCPE",0
37,"37143",389,301,300,6,1,"PCPE",1
4,"4057",1325,894,884,5,10,"PCPE",1
50,"50111",180,143,143,0,0,"PCPE",0
46,"46187",1306,1017,1000,0,17,"PCPE",0
4,"4068",187,154,152,0,2,"PCPE",0
50,"50015",96,67,67,0,0,"PCPE",0
42,"42071",171,115,115,3,0,"PCPE",1
9,"9398",75,56,56,0,0,"PCPE",0
44,"44157",64,48,48,1,0,"PCPE",0
3,"3002",3605,2583,2557,15,26,"PCPE",15
40,"40174",349,254,251,2,3,"PCPE",1
28,"28035",1353,1006,998,2,8,"PCPE",0
18,"18076",804,551,549,1,2,"PCPE",0
37,"37196",75,64,64,0,0,"PCPE",0
3,"3116",1155,877,875,6,2,"PCPE",1
37,"37236",135,105,103,1,2,"PCPE",0
33,"33028",1276,649,641,4,8,"PCPE",1
9,"9162",141,101,101,0,0,"PCPE",0
14,"14053",6006,4285,4232,49,53,"PCPE",11
9,"9007",57,39,39,0,0,"PCPE",0
48,"48057",5723,3988,3962,26,26,"PCPE",2
50,"50169",351,269,265,0,4,"PCPE",0
33,"33030",895,669,666,9,3,"PCPE",4
28,"28168",1237,884,880,4,4,"PCPE",0
37,"37365",172,134,133,1,1,"PCPE",0
46,"46027",943,780,771,5,9,"PCPE",1
4,"4086",1760,1243,1234,9,9,"PCPE",2
11,"11019",1826,1302,1248,7,54,"PCPE",2
47,"47134",165,128,125,1,3,"PCPE",0
24,"24146",265,210,207,1,3,"PCPE",0
47,"47088",103,86,85,1,1,"PCPE",0
22,"22109",261,191,190,1,1,"PCPE",0
48,"48072",977,716,713,4,3,"PCPE",0
4,"4006",7022,4792,4749,30,43,"PCPE",8
50,"50152",1430,1008,994,14,14,"PCPE",0
22,"22105",114,78,77,2,1,"PCPE",0
20,"20013",5415,3602,3579,19,23,"PCPE",3
46,"46207",6676,5106,5040,41,66,"PCPE",2
16,"16202",769,564,558,0,6,"PCPE",0
20,"20006",259,143,143,3,0,"PCPE",0
37,"37194",251,196,195,1,1,"PCPE",0
9,"9144",53,40,40,0,0,"PCPE",0
45,"45050",457,333,328,1,5,"PCPE",0
48,"48070",544,362,362,4,0,"PCPE",0
30,"30036",14698,9859,9734,41,125,"PCPE",2
45,"45169",189,140,138,0,2,"PCPE",0
23,"23008",1502,1144,1131,9,13,"PCPE",2
9,"9091",724,500,490,4,10,"PCPE",1
16,"16126",770,634,624,3,10,"PCPE",0
37,"37257",52,46,46,0,0,"PCPE",0
1,"1042",904,653,648,6,5,"PCPE",0
40,"40005",30,23,23,0,0,"PCPE",0
49,"49039",338,245,239,3,6,"PCPE",1
28,"28172",9077,6992,6936,31,56,"PCPE",3
37,"37115",123,89,87,0,2,"PCPE",0
26,"26081",16,14,14,0,0,"PCPE",0
16,"16094",127,96,94,0,2,"PCPE",0
47,"47038",105,77,77,0,0,"PCPE",0
49,"49071",765,495,490,2,5,"PCPE",0
9,"9466",129,97,97,1,0,"PCPE",0
34,"34050",200,153,152,0,1,"PCPE",0
37,"37157",78,63,62,0,1,"PCPE",0
45,"45002",2564,1681,1665,17,16,"PCPE",2
42,"42063",49,35,35,0,0,"PCPE",0
45,"45176",3706,2554,2521,22,33,"PCPE",0
50,"50039",491,392,390,2,2,"PCPE",0
45,"45193",613,504,497,1,7,"PCPE",0
49,"49200",949,720,715,10,5,"PCPE",0
16,"16908",186,152,152,1,0,"PCPE",0
45,"45182",1034,806,791,1,15,"PCPE",0
20,"20008",716,362,361,6,1,"PCPE",0
45,"45013",1758,1352,1329,8,23,"PCPE",0
3,"3122",42425,30153,29954,154,199,"PCPE",45
37,"37252",112,79,79,0,0,"PCPE",0
37,"37131",185,139,139,0,0,"PCPE",0
49,"49134",172,121,119,0,2,"PCPE",0
44,"44191",764,586,583,6,3,"PCPE",2
34,"34051",101,88,83,0,5,"PCPE",0
14,"14072",1048,806,795,6,11,"PCPE",1
23,"23059",5837,4387,4310,40,77,"PCPE",5
28,"28054",11257,8349,8273,55,76,"PCPE",4
37,"37166",214,152,151,2,1,"PCPE",0
46,"46138",343,275,272,1,3,"PCPE",0
34,"34236",156,120,119,0,1,"PCPE",0
47,"47116",416,341,339,0,2,"PCPE",0
50,"50056",409,300,300,3,0,"PCPE",0
37,"37214",129,93,91,0,2,"PCPE",0
9,"9307",109,81,80,0,1,"PCPE",0
33,"33063",415,320,318,3,2,"PCPE",0
42,"42192",42,27,27,2,0,"PCPE",0
47,"47210",382,282,274,3,8,"PCPE",0
50,"50134",128,91,89,2,2,"PCPE",0
47,"47166",259,204,197,2,7,"PCPE",0
24,"24002",231,173,172,1,1,"PCPE",0
23,"23099",4769,3359,3309,16,50,"PCPE",2
16,"16118",1375,1106,1086,13,20,"PCPE",1
42,"42055",164,121,121,0,0,"PCPE",0
47,"47137",29,25,25,1,0,"PCPE",0
50,"50100",329,246,241,1,5,"PCPE",0
3,"3056",8676,6638,6541,34,97,"PCPE",12
9,"9347",143,117,115,2,2,"PCPE",0
49,"49087",521,322,318,0,4,"PCPE",0
48,"48055",2668,1872,1849,11,23,"PCPE",1
41,"41086",16170,10162,10088,73,74,"PCPE",20
24,"24124",367,244,233,3,11,"PCPE",0
49,"49125",1391,933,918,10,15,"PCPE",2
37,"37046",11225,7824,7697,53,127,"PCPE",9
28,"28141",5823,4297,4262,29,35,"PCPE",4
24,"24001",189,124,122,0,2,"PCPE",0
37,"37362",4632,3389,3351,25,38,"PCPE",6
49,"49159",271,209,205,4,4,"PCPE",0
50,"50199",334,244,242,3,2,"PCPE",0
9,"9244",46,34,34,1,0,"PCPE",0
22,"22039",863,671,667,4,4,"PCPE",0
48,"48086",2050,1414,1401,5,13,"PCPE",0
50,"50236",102,79,77,0,2,"PCPE",0
16,"16106",2727,2009,1989,12,20,"PCPE",0
2,"2028",126,98,98,0,0,"PCPE",0
49,"49065",1103,836,818,2,18,"PCPE",2
34,"34133",107,91,90,0,1,"PCPE",0
41,"41053",21259,15147,14853,132,294,"PCPE",26
16,"16192",48,31,30,1,1,"PCPE",0
40,"40155",3518,2656,2605,18,51,"PCPE",5
37,"37112",161,112,111,2,1,"PCPE",0
12,"12071",1274,992,979,3,13,"PCPE",3
12,"12080",1932,1598,1570,10,28,"PCPE",1
12,"12076",84,69,69,0,0,"PCPE",0
12,"12016",1582,1307,1297,6,10,"PCPE",1
12,"12128",1393,1090,1072,10,18,"PCPE",1
12,"12074",785,652,648,5,4,"PCPE",1
12,"12031",3807,2941,2894,24,47,"PCPE",4
12,"12111",360,305,299,3,6,"PCPE",1
12,"12058",71,63,62,1,1,"PCPE",0
12,"12137",36,23,23,0,0,"PCPE",0
12,"12006",172,135,133,0,2,"PCPE",0
12,"12117",3585,2727,2677,20,50,"PCPE",1
12,"12118",72,55,53,0,2,"PCPE",0
12,"12094",847,674,665,5,9,"PCPE",6
12,"12042",607,520,513,13,7,"PCPE",0
12,"12134",141,95,94,0,1,"PCPE",0
12,"12138",19061,13010,12847,129,163,"PCPE",14
12,"12123",48,40,40,3,0,"PCPE",0
12,"12141",101,83,83,0,0,"PCPE",0
12,"12095",959,749,742,8,7,"PCPE",0
12,"12018",287,246,242,1,4,"PCPE",0
12,"12036",581,426,421,10,5,"PCPE",0
12,"12101",358,279,275,3,4,"PCPE",1
12,"12052",578,452,435,3,17,"PCPE",0
12,"12075",123,88,88,0,0,"PCPE",0
12,"12100",1333,1065,1047,10,18,"PCPE",1
12,"12127",75,55,55,0,0,"PCPE",0
12,"12059",231,189,188,2,1,"PCPE",1
12,"12115",219,179,177,0,2,"PCPE",0
12,"12098",580,451,447,5,4,"PCPE",0
12,"12126",24464,18533,18331,113,202,"PCPE",39
12,"12050",1305,1015,1000,6,15,"PCPE",0
12,"12070",522,406,401,0,5,"PCPE",1
12,"12025",136,104,104,0,0,"PCPE",0
12,"12105",848,644,638,2,6,"PCPE",1
12,"12114",198,144,144,1,0,"PCPE",0
12,"12107",355,303,299,4,4,"PCPE",0
12,"12069",66,49,48,0,1,"PCPE",0
12,"12053",2034,1655,1633,6,22,"PCPE",3
12,"12129",1828,1322,1298,11,24,"PCPE",8
12,"12039",833,717,710,4,7,"PCPE",0
12,"12063",41,29,29,1,0,"PCPE",0
12,"12088",62,59,59,0,0,"PCPE",0
12,"12084",17615,12766,12644,105,122,"PCPE",9
12,"12099",539,416,403,7,13,"PCPE",0
12,"12122",796,637,627,0,10,"PCPE",0
12,"12007",746,651,636,3,15,"PCPE",0
12,"12133",59,53,52,0,1,"PCPE",0
12,"12028",12586,9733,9676,62,57,"PCPE",7
12,"12082",9617,7324,7231,46,93,"PCPE",7
12,"12092",111,91,90,0,1,"PCPE",0
12,"12005",8062,5829,5754,64,75,"PCPE",10
12,"12119",148,95,93,0,2,"PCPE",0
12,"12142",158,117,117,1,0,"PCPE",0
12,"12020",118,105,105,0,0,"PCPE",0
12,"12112",99,79,78,3,1,"PCPE",0
12,"12109",649,532,524,6,8,"PCPE",1
12,"12041",100,81,81,0,0,"PCPE",0
12,"12003",976,746,736,6,10,"PCPE",1
12,"12012",2685,2234,2202,13,32,"PCPE",4
12,"12011",4565,3331,3283,20,48,"PCPE",6
12,"12073",152,119,117,0,2,"PCPE",0
12,"12026",881,678,663,13,15,"PCPE",0
12,"12017",161,130,128,0,2,"PCPE",0
12,"12044",468,419,412,3,7,"PCPE",0
12,"12055",104,83,82,3,1,"PCPE",0
12,"12015",93,81,78,0,3,"PCPE",0
12,"12027",17283,12015,11888,89,127,"PCPE",15
12,"12132",480,396,389,3,7,"PCPE",0
12,"12093",178,137,136,2,1,"PCPE",0
12,"12038",167,120,118,2,2,"PCPE",0
12,"12091",177,113,112,0,1,"PCPE",0
12,"12104",6933,5411,5342,25,69,"PCPE",3
12,"12064",91,82,81,2,1,"PCPE",0
12,"12140",1143,939,930,6,9,"PCPE",4
12,"12013",144,121,119,0,2,"PCPE",0
12,"12090",102,86,85,1,1,"PCPE",0
12,"12065",188,169,169,2,0,"PCPE",0
12,"12068",48,36,35,1,1,"PCPE",1
12,"12051",471,339,335,1,4,"PCPE",0
12,"12046",191,151,150,2,1,"PCPE",0
12,"12002",110,99,98,1,1,"PCPE",0
12,"12034",1424,1065,1035,3,30,"PCPE",2
12,"12136",2635,2201,2171,18,30,"PCPE",2
12,"12139",318,237,233,0,4,"PCPE",0
12,"12135",35719,26016,25793,196,223,"PCPE",60
12,"12057",606,487,474,5,13,"PCPE",1
12,"12108",456,378,371,2,7,"PCPE",0
12,"12901",3405,2626,2598,23,28,"PCPE",4
12,"12078",325,235,233,0,2,"PCPE",0
12,"12045",345,268,259,1,9,"PCPE",1
12,"12121",1107,924,893,4,31,"PCPE",0
12,"12085",4976,3236,3209,16,27,"PCPE",5
12,"12072",1101,929,911,11,18,"PCPE",3
12,"12116",58,49,49,0,0,"PCPE",0
12,"12089",4328,3078,3020,15,58,"PCPE",4
12,"12087",25,18,18,4,0,"PCPE",0
12,"12113",83,67,66,3,1,"PCPE",1
12,"12077",4605,3439,3382,15,57,"PCPE",4
12,"12024",143,125,124,0,1,"PCPE",0
12,"12048",251,185,182,0,3,"PCPE",0
12,"12120",177,152,152,0,0,"PCPE",0
12,"12056",282,236,231,1,5,"PCPE",0
12,"12097",63,49,49,0,0,"PCPE",0
12,"12081",608,486,480,5,6,"PCPE",0
12,"12010",259,213,208,2,5,"PCPE",0
12,"12029",702,557,555,4,2,"PCPE",2
12,"12060",446,368,364,4,4,"PCPE",0
12,"12125",216,180,177,0,3,"PCPE",0
12,"12110",234,176,173,0,3,"PCPE",0
12,"12021",4436,3381,3332,27,49,"PCPE",2
12,"12014",184,144,143,2,1,"PCPE",1
12,"12096",777,587,577,6,10,"PCPE",0
12,"12130",404,340,335,0,5,"PCPE",0
12,"12032",23525,17093,16966,104,127,"PCPE",23
12,"12067",537,435,427,0,8,"PCPE",1
12,"12106",1158,955,942,8,13,"PCPE",0
12,"12043",570,449,442,2,7,"PCPE",0
12,"12079",399,316,314,2,2,"PCPE",2
12,"12061",373,285,282,3,3,"PCPE",0
12,"12022",344,265,262,2,3,"PCPE",1
12,"12103",91,69,67,0,2,"PCPE",0
12,"12033",1919,1437,1404,19,33,"PCPE",2
12,"12102",522,423,418,1,5,"PCPE",0
12,"12008",222,193,192,1,1,"PCPE",0
12,"12001",1051,821,800,4,21,"PCPE",0
12,"12083",93,79,76,0,3,"PCPE",0
12,"12009",17445,12088,11999,75,89,"PCPE",11
12,"12004",4170,3125,3088,19,37,"PCPE",3
12,"12040",117608,85588,84946,496,642,"PCPE",108
12,"12124",1840,1387,1381,33,6,"PCPE",0
12,"12037",17,16,14,0,2,"PCPE",0
12,"12049",441,322,312,1,10,"PCPE",0
12,"12902",2158,1504,1489,14,15,"PCPE",2
12,"12131",63,52,52,0,0,"PCPE",0
7,"7003",11761,6631,6541,55,90,"PFyV",11
7,"7031",23833,14836,14707,124,129,"PFyV",21
7,"7059",2996,2053,2013,17,40,"PFyV",2
7,"7051",5215,3171,3134,39,37,"PFyV",8
7,"7017",851,582,571,7,11,"PFyV",0
7,"7007",421,296,293,2,3,"PFyV",0
7,"7004",3854,2574,2547,30,27,"PFyV",6
7,"7902",1064,685,664,15,21,"PFyV",0
7,"7052",4667,2908,2886,29,22,"PFyV",2
7,"7061",9819,6351,6280,53,71,"PFyV",28
7,"7029",4166,2949,2913,37,36,"PFyV",3
7,"7015",20991,12552,12433,184,119,"PFyV",10
7,"7047",2246,1517,1482,18,35,"PFyV",3
7,"7045",1295,947,936,5,11,"PFyV",1
7,"7054",22334,12814,12708,99,106,"PFyV",14
7,"7038",2010,1424,1412,18,12,"PFyV",0
7,"7062",7513,4273,4219,52,54,"PFyV",3
7,"7049",1480,1003,993,14,10,"PFyV",1
7,"7060",2568,1677,1653,16,24,"PFyV",2
7,"7020",3581,2542,2502,43,40,"PFyV",5
7,"7044",8439,5681,5543,48,138,"PFyV",6
7,"7027",20769,13097,12987,100,110,"PFyV",29
7,"7064",5315,3475,3434,31,41,"PFyV",5
7,"7040",280477,173945,172463,1359,1482,"PFyV",382
7,"7033",27104,15524,15337,174,187,"PFyV",20
7,"7058",2791,2060,2034,13,26,"PFyV",2
7,"7014",7320,4163,4116,45,47,"PFyV",4
7,"7901",610,462,459,7,3,"PFyV",1
7,"7065",2083,1346,1328,9,18,"PFyV",7
7,"7002",6341,4295,4255,39,40,"PFyV",3
7,"7041",2044,1486,1451,13,35,"PFyV",0
7,"7050",3348,2156,2139,19,17,"PFyV",2
7,"7010",4880,3395,3361,32,34,"PFyV",10
7,"7026",31074,18280,18135,168,145,"PFyV",34
7,"7006",5178,3366,3329,52,37,"PFyV",4
7,"7022",11545,7385,7306,88,79,"PFyV",15
7,"7018",382,272,269,1,3,"PFyV",0
7,"7063",1418,1043,1033,6,10,"PFyV",3
7,"7037",3197,1934,1917,26,17,"PFyV",0
7,"7042",10666,6680,6613,64,67,"PFyV",11
7,"7056",5026,3410,3375,32,35,"PFyV",4
7,"7011",27721,17817,17720,139,97,"PFyV",19
7,"7057",7169,4719,4659,47,60,"PFyV",10
7,"7036",26955,18578,18433,148,145,"PFyV",34
7,"7032",20034,12824,12710,110,114,"PFyV",26
7,"7024",6843,3657,3612,38,45,"PFyV",2
7,"7009",738,521,510,12,11,"PFyV",0
7,"7028",899,601,595,7,6,"PFyV",1
7,"7008",5692,3956,3913,26,43,"PFyV",12
7,"7005",6710,4127,4090,25,37,"PFyV",6
7,"7039",4839,3136,3060,31,76,"PFyV",4
7,"7023",3604,2498,2470,49,28,"PFyV",3
7,"7046",15797,9127,9043,86,84,"PFyV",18
7,"7001",3573,2531,2497,21,34,"PFyV",2
7,"7021",230,177,174,2,3,"PFyV",0
7,"7055",7442,4604,4553,42,51,"PFyV",5
7,"7035",1524,1078,1055,8,23,"PFyV",4
7,"7013",6881,4693,4587,39,106,"PFyV",8
7,"7048",17252,10055,9984,105,71,"PFyV",15
7,"7019",187,133,129,2,4,"PFyV",0
7,"7043",3389,2290,2252,26,38,"PFyV",3
7,"7053",1188,926,918,16,8,"PFyV",1
7,"7016",2809,1865,1836,23,29,"PFyV",1
7,"7025",472,355,351,1,4,"PFyV",0
7,"7030",1551,1127,1101,13,26,"PFyV",0
7,"7034",1008,743,734,7,9,"PFyV",1
7,"7012",1876,1369,1353,13,16,"PFyV",1
28,"28055",916,693,687,5,6,"PH",1
28,"28166",320,254,251,2,3,"PH",0
33,"33071",595,433,430,10,3,"PH",0
28,"28036",2539,1899,1878,11,21,"PH",2
33,"33020",13307,9011,8914,99,97,"PH",4
28,"28151",3142,2235,2199,8,36,"PH",0
28,"28171",4239,2848,2820,19,28,"PH",1
28,"28008",1799,1182,1174,4,8,"PH",0
33,"33059",4646,3075,3033,29,42,"PH",3
28,"28040",15811,10118,10009,56,109,"PH",5
28,"28123",57078,45270,44992,215,278,"PH",28
28,"28021",554,370,364,3,6,"PH",0
35,"35027",10344,7310,7216,50,94,"PH",7
33,"33050",592,387,376,2,11,"PH",0
28,"28156",1019,742,738,3,4,"PH",0
28,"28100",4196,2987,2955,14,32,"PH",3
35,"35001",4584,3282,3222,26,60,"PH",2
28,"28155",506,416,411,0,5,"PH",0
35,"35030",9250,5413,5326,34,87,"PH",3
35,"35022",48603,29443,29042,160,401,"PH",12
33,"33062",400,238,233,2,5,"PH",0
28,"28153",697,499,499,1,0,"PH",0
33,"33031",35120,22295,22024,271,271,"PH",24
33,"33014",9037,5999,5938,53,61,"PH",3
28,"28073",12549,8788,8701,54,87,"PH",9
28,"28058",139342,100637,99753,634,884,"PH",77
28,"28067",4063,3102,3079,3,23,"PH",4
28,"28056",863,630,617,4,13,"PH",0
28,"28176",12491,9723,9667,37,56,"PH",3
33,"33058",1796,1232,1209,11,23,"PH",1
28,"28062",292,231,226,1,5,"PH",0
28,"28157",609,433,430,1,3,"PH",0
33,"33052",721,485,482,3,3,"PH",0
28,"28032",4762,3428,3401,19,27,"PH",1
28,"28099",1748,1290,1283,7,7,"PH",0
28,"28052",3855,2626,2587,11,39,"PH",1
28,"28007",124592,94222,93521,491,701,"PH",59
28,"28180",5251,3927,3893,7,34,"PH",0
28,"28072",5709,4356,4324,22,32,"PH",1
28,"28130",28293,21253,21040,116,213,"PH",20
35,"35017",25676,15038,14716,94,322,"PH",16
28,"28034",361,274,269,1,5,"PH",0
28,"28160",8256,6102,6059,31,43,"PH",2
33,"33076",12258,8106,8031,63,75,"PH",5
28,"28020",145,94,94,0,0,"PH",0
33,"33027",834,506,498,4,8,"PH",0
33,"33040",4549,2986,2942,35,44,"PH",6
28,"28076",398,325,317,1,8,"PH",0
28,"28126",39,29,29,0,0,"PH",0
28,"28175",863,670,668,5,2,"PH",0
28,"28136",647,528,518,2,10,"PH",0
28,"28024",151,125,124,1,1,"PH",0
28,"28158",665,537,533,4,4,"PH",0
28,"28119",2092,1590,1582,12,8,"PH",1
28,"28050",4076,2860,2839,21,21,"PH",2
33,"33054",1682,1159,1149,12,10,"PH",1
28,"28046",4460,3447,3422,16,25,"PH",1
28,"28003",173,141,141,0,0,"PH",0
28,"28037",1559,1177,1166,5,11,"PH",1
28,"28009",14086,10611,10545,57,66,"PH",8
28,"28118",57,46,45,0,1,"PH",0
33,"33005",1449,936,924,11,12,"PH",1
28,"28069",50,44,41,0,3,"PH",0
33,"33026",8530,5397,5337,48,60,"PH",3
28,"28152",16093,12945,12877,58,68,"PH",5
28,"28049",58480,45136,44820,242,316,"PH",36
28,"28150",3087,2294,2277,10,17,"PH",2
28,"28133",5979,4140,4098,18,42,"PH",2
35,"35032",3412,2473,2425,17,48,"PH",4
33,"33069",3491,2430,2390,17,40,"PH",0
28,"28093",2096,1670,1653,10,17,"PH",0
28,"28066",7182,5422,5371,17,51,"PH",2
28,"28047",40914,30019,29788,169,231,"PH",15
28,"28145",2431,1760,1736,6,24,"PH",2
33,"33009",905,611,609,3,2,"PH",0
28,"28131",12990,9512,9433,38,79,"PH",4
33,"33028",1276,649,641,4,8,"PH",1
35,"35029",4152,2530,2498,32,32,"PH",2
33,"33046",499,379,367,5,12,"PH",0
35,"35019",32481,19318,19067,123,251,"PH",18
33,"33019",3072,2020,2005,18,15,"PH",2
28,"28141",5823,4297,4262,29,35,"PH",2
28,"28033",3899,2805,2788,7,17,"PH",2
28,"28116",704,528,523,2,5,"PH",0
28,"28104",14040,11151,11096,57,55,"PH",4
28,"28092",151841,110916,109954,582,962,"PH",75
28,"28129",8030,5986,5941,42,45,"PH",7
33,"33065",1102,722,713,7,9,"PH",0
33,"33018",2901,2000,1976,18,24,"PH",0
28,"28084",15859,11156,11058,64,98,"PH",11
28,"28117",104,89,89,1,0,"PH",0
28,"28902",471,363,356,4,7,"PH",0
28,"28030",1726,1320,1299,8,21,"PH",2
33,"33055",1514,1109,1092,5,17,"PH",2
33,"33075",271,154,153,2,1,"PH",0
28,"28147",963,722,720,5,2,"PH",0
28,"28059",4323,3171,3157,11,14,"PH",0
33,"33001",1588,887,880,8,7,"PH",1
28,"28090",8505,6654,6609,33,45,"PH",3
28,"28177",10270,8083,8030,36,53,"PH",5
28,"28109",1576,1103,1098,1,5,"PH",0
28,"28127",64827,51776,51613,220,163,"PH",20
28,"28172",9077,6992,6936,31,56,"PH",3
33,"33066",42963,28564,28282,300,282,"PH",25
35,"35018",12552,7609,7547,54,62,"PH",6
28,"28016",79,53,51,0,2,"PH",0
28,"28106",76907,52773,52265,385,508,"PH",61
28,"28038",4952,3730,3688,34,42,"PH",1
28,"28174",1795,1232,1221,7,11,"PH",1
28,"28097",119,94,94,0,0,"PH",0
33,"33053",1141,742,732,6,10,"PH",0
28,"28010",9963,7745,7688,25,57,"PH",6
33,"33077",1192,811,808,5,3,"PH",1
28,"28027",1203,872,857,3,15,"PH",0
28,"28039",128,98,97,2,1,"PH",0
28,"28091",5440,3596,3558,24,38,"PH",2
33,"33003",646,355,352,9,3,"PH",4
33,"33057",1593,1063,1049,16,14,"PH",0
28,"28146",1787,1205,1194,0,11,"PH",0
33,"33023",3321,2299,2265,31,34,"PH",2
33,"33047",1107,852,843,9,9,"PH",0
28,"28159",589,468,468,5,0,"PH",0
35,"35005",1048,747,737,8,10,"PH",0
33,"33030",895,669,666,9,3,"PH",0
33,"33033",9873,6512,6431,68,81,"PH",4
28,"28018",3768,2968,2945,26,23,"PH",0
35,"35010",3558,2341,2301,28,40,"PH",0
33,"33004",66857,46390,45960,426,430,"PH",33
28,"28083",8939,6396,6348,38,48,"PH",8
33,"33021",4573,3024,2971,22,53,"PH",0
35,"35003",5211,2949,2908,13,41,"PH",5
33,"33078",142,101,99,0,2,"PH",0
28,"28121",198,160,158,1,2,"PH",1
28,"28089",3677,2748,2730,10,18,"PH",1
33,"33061",378,202,200,0,2,"PH",1
28,"28086",5154,3530,3493,13,37,"PH",3
28,"28031",2048,1500,1486,3,14,"PH",1
28,"28096",18354,13310,13205,68,105,"PH",11
28,"28173",517,390,388,1,2,"PH",0
33,"33044",178278,125469,124554,1124,915,"PH",72
33,"33049",6322,4116,4062,43,54,"PH",3
33,"33056",4997,3269,3244,22,25,"PH",0
33,"33025",9174,5838,5786,57,52,"PH",1
28,"28053",6498,4995,4955,28,40,"PH",3
33,"33039",1655,1223,1209,12,14,"PH",0
35,"35024",13735,8545,8439,77,106,"PH",7
28,"28019",1233,893,885,4,8,"PH",0
28,"28164",2993,2183,2168,8,15,"PH",0
28,"28025",420,320,315,4,5,"PH",0
28,"28161",48848,35503,35203,210,300,"PH",33
33,"33060",14633,9647,9474,72,173,"PH",2
28,"28035",1353,1006,998,2,8,"PH",1
33,"33074",3484,2298,2274,24,24,"PH",2
28,"28042",1173,890,883,3,7,"PH",3
28,"28901",799,558,554,0,4,"PH",0
35,"35025",1797,1261,1245,4,16,"PH",2
33,"33064",234,168,167,1,1,"PH",0
28,"28051",1541,1163,1149,1,14,"PH",2
35,"35023",11686,8212,8076,55,136,"PH",4
28,"28181",20386,16155,16069,57,86,"PH",6
28,"28132",11685,8130,8062,56,68,"PH",1
33,"33070",3351,2403,2373,26,30,"PH",0
28,"28113",34751,25832,25612,120,220,"PH",8
28,"28048",500,391,387,3,4,"PH",0
28,"28182",210,171,169,0,2,"PH",0
28,"28108",3374,2482,2465,10,17,"PH",2
33,"33034",10612,6602,6536,62,66,"PH",2
28,"28005",134246,99236,98481,583,755,"PH",69
28,"28114",150,101,100,1,1,"PH",0
33,"33072",1566,1008,994,11,14,"PH",2
28,"28044",5826,4445,4409,24,36,"PH",4
35,"35006",30457,21398,21118,162,280,"PH",17
35,"35002",23328,15495,15313,94,182,"PH",10
35,"35033",6398,4340,4266,19,74,"PH",3
28,"28068",10955,8136,8076,49,60,"PH",4
33,"33042",4306,2988,2970,35,18,"PH",1
35,"35009",19905,14185,13961,89,224,"PH",8
28,"28080",48554,38885,38691,164,194,"PH",14
28,"28013",40471,28739,28490,188,249,"PH",18
28,"28006",78966,59065,58698,267,367,"PH",47
28,"28022",33479,27129,27037,133,92,"PH",9
28,"28137",1664,1232,1220,7,12,"PH",0
28,"28170",2472,1640,1622,13,18,"PH",1
28,"28125",3002,2180,2163,11,17,"PH",2
28,"28070",117,91,91,0,0,"PH",0
33,"33024",226679,158750,157564,1209,1186,"PH",113
28,"28085",3922,2972,2954,14,18,"PH",0
33,"33073",8554,4945,4884,41,61,"PH",3
33,"33013",446,321,318,3,3,"PH",1
28,"28101",231,187,187,0,0,"PH",0
28,"28004",6234,4202,4167,16,35,"PH",0
35,"35034",7873,3975,3943,27,32,"PH",4
28,"28002",3007,2091,2074,14,17,"PH",0
28,"28088",261,178,178,0,0,"PH",0
28,"28120",1223,892,884,2,8,"PH",2
33,"33037",34454,22881,22586,243,295,"PH",15
33,"33045",4487,3057,2999,28,58,"PH",3
28,"28102",894,644,636,6,8,"PH",0
28,"28162",2617,2029,2016,6,13,"PH",1
33,"33022",893,578,567,11,11,"PH",0
28,"28012",887,664,661,2,3,"PH",0
28,"28140",3007,2276,2256,7,20,"PH",3
35,"35026",81091,51953,51195,407,758,"PH",53
33,"33041",7199,4922,4877,52,45,"PH",2
35,"35012",10382,5443,5392,17,51,"PH",7
28,"28154",5408,3806,3767,16,39,"PH",0
28,"28169",1448,1122,1113,5,9,"PH",0
28,"28078",38,32,32,0,0,"PH",0
33,"33002",9995,6765,6672,47,93,"PH",6
35,"35020",6034,3992,3934,20,58,"PH",2
28,"28074",138947,103687,102762,620,925,"PH",101
28,"28124",74,54,54,1,0,"PH",0
35,"35015",9950,5139,5070,29,69,"PH",6
28,"28028",1755,1353,1344,6,9,"PH",0
33,"33035",11284,7681,7618,70,63,"PH",2
28,"28148",85454,62367,61884,370,483,"PH",51
28,"28087",3186,2503,2487,19,16,"PH",0
33,"33029",350,181,174,2,7,"PH",0
28,"28094",865,624,622,4,2,"PH",0
28,"28178",1065,824,818,5,6,"PH",0
33,"33012",5201,3466,3432,25,34,"PH",1
33,"33067",784,587,579,9,8,"PH",1
28,"28023",4775,3755,3735,12,20,"PH",3
33,"33010",1822,1190,1180,17,10,"PH",0
28,"28029",520,408,406,0,2,"PH",0
35,"35028",9776,5476,5401,43,75,"PH",3
33,"33043",683,446,441,2,5,"PH",0
28,"28149",5759,4352,4310,25,42,"PH",2
35,"35016",297736,192251,190256,1386,1995,"PH",205
28,"28095",1529,1119,1106,6,13,"PH",0
33,"33011",11260,6250,6163,83,87,"PH",11
33,"33051",7061,4640,4587,27,53,"PH",4
35,"35013",6625,4896,4781,41,115,"PH",4
33,"33017",3144,2094,2071,35,23,"PH",1
28,"28045",33328,24620,24434,146,186,"PH",14
28,"28143",72,57,57,1,0,"PH",0
28,"28054",11257,8349,8273,55,76,"PH",3
28,"28183",1039,743,735,2,8,"PH",0
28,"28017",1208,907,899,7,8,"PH",0
28,"28144",6010,4676,4644,22,32,"PH",1
35,"35008",6131,4507,4459,34,48,"PH",5
35,"35007",511,316,309,2,7,"PH",0
28,"28134",61008,45177,44904,263,273,"PH",30
28,"28071",60,55,53,1,2,"PH",0
28,"28122",513,375,370,2,5,"PH",0
35,"35011",24002,15928,15684,95,244,"PH",8
35,"35031",7259,5037,4942,29,95,"PH",3
28,"28082",5683,4324,4286,25,38,"PH",1
28,"28026",6317,4734,4701,33,33,"PH",1
28,"28903",33082,27065,26922,154,143,"PH",15
28,"28110",1944,1478,1463,4,15,"PH",1
28,"28112",161,136,136,1,0,"PH",0
28,"28179",1432,1040,1037,4,3,"PH",0
28,"28115",60892,49705,49510,209,195,"PH",16
28,"28063",258,194,193,1,1,"PH",0
28,"28138",60,46,46,0,0,"PH",0
33,"33015",1540,998,986,8,12,"PH",1
28,"28135",948,713,709,4,4,"PH",0
33,"33016",19130,13666,13526,125,140,"PH",13
28,"28079",2362038,1743924,1733354,8859,10570,"PH",1034
35,"35004",39299,20523,20294,140,229,"PH",11
28,"28057",1458,1097,1088,3,9,"PH",0
33,"33036",11542,8062,7987,60,75,"PH",6
33,"33008",1777,1238,1229,3,9,"PH",2
28,"28111",596,467,467,3,0,"PH",0
28,"28167",8356,6158,6106,46,52,"PH",3
28,"28011",442,317,316,1,1,"PH",0
35,"35014",11209,6016,5917,42,99,"PH",5
28,"28014",33085,23626,23466,113,160,"PH",17
35,"35021",14924,10477,10370,45,107,"PH",8
28,"28064",129,106,106,2,0,"PH",0
33,"33007",1514,946,942,12,4,"PH",0
28,"28168",1237,884,880,4,4,"PH",0
28,"28165",1794,1293,1285,3,8,"PH",0
28,"28001",61,46,45,0,1,"PH",0
33,"33068",1093,645,641,4,4,"PH",0
28,"28041",4524,3508,3490,20,18,"PH",5
28,"28061",21389,16277,16135,67,142,"PH",4
28,"28015",18736,14221,14127,68,94,"PH",6
28,"28060",1510,1134,1117,1,17,"PH",0
33,"33032",11395,7592,7465,90,127,"PH",2
28,"28128",444,315,314,0,1,"PH",0
33,"33038",2303,1584,1559,13,25,"PH",0
28,"28043",5921,3803,3759,18,44,"PH",2
33,"33063",415,320,318,3,2,"PH",0
28,"28163",442,344,339,1,5,"PH",0
33,"33048",154,95,94,0,1,"PH",0
33,"33006",1540,1010,1003,5,7,"PH",1
28,"28065",126539,96997,96210,505,787,"PH",62
28,"28075",5621,4186,4148,26,38,"PH",3
28,"28107",457,312,312,0,0,"PH",0
47,"47039",185,141,140,0,1,"P-LIB",0
3,"3030",524,448,440,5,8,"P-LIB",0
46,"46039",2130,1728,1699,8,29,"P-LIB",0
28,"28129",8030,5986,5941,42,45,"P-LIB",1
47,"47175",6564,4781,4728,39,53,"P-LIB",2
47,"47150",274,209,205,0,4,"P-LIB",0
47,"47067",174,127,126,0,1,"P-LIB",0
47,"47032",152,117,116,1,1,"P-LIB",0
46,"46249",9288,6746,6676,56,70,"P-LIB",2
39,"39020",23592,15594,15384,128,210,"P-LIB",9
28,"28056",863,630,617,4,13,"P-LIB",0
46,"46115",378,286,282,1,4,"P-LIB",0
3,"3092",6743,5254,5178,37,76,"P-LIB",1
47,"47082",812,640,628,8,12,"P-LIB",0
28,"28087",3186,2503,2487,19,16,"P-LIB",0
39,"39040",4292,3208,3166,14,42,"P-LIB",1
46,"46198",839,684,674,4,10,"P-LIB",0
3,"3027",157,138,135,0,3,"P-LIB",0
46,"46074",2696,2069,2038,14,31,"P-LIB",1
3,"3068",47,44,44,0,0,"P-LIB",0
46,"46080",998,803,799,7,4,"P-LIB",0
47,"47123",466,354,352,4,2,"P-LIB",0
20,"20024",386,210,209,3,1,"P-LIB",0
46,"46263",251,214,212,0,2,"P-LIB",0
28,"28096",18354,13310,13205,68,105,"P-LIB",4
46,"46214",15766,12131,12036,42,95,"P-LIB",3
47,"47155",3228,2277,2254,18,23,"P-LIB",5
46,"46141",439,351,342,2,9,"P-LIB",0
28,"28040",15811,10118,10009,56,109,"P-LIB",2
46,"46012",896,682,663,1,19,"P-LIB",0
20,"20028",2237,1373,1365,11,8,"P-LIB",0
39,"39051",66,57,57,0,0,"P-LIB",0
46,"46204",6681,5256,5202,32,54,"P-LIB",0
3,"3113",4243,3091,3046,10,45,"P-LIB",2
46,"46047",532,446,437,2,9,"P-LIB",0
20,"20035",486,337,334,1,3,"P-LIB",1
20,"20031",176,90,90,0,0,"P-LIB",0
46,"46116",13159,10193,10135,53,58,"P-LIB",3
39,"39015",839,647,642,4,5,"P-LIB",0
47,"47115",281,236,233,3,3,"P-LIB",0
47,"47230",303,246,242,2,4,"P-LIB",0
47,"47023",2995,2344,2326,18,18,"P-LIB",2
28,"28151",3142,2235,2199,8,36,"P-LIB",1
47,"47170",33,28,27,2,1,"P-LIB",0
28,"28005",134246,99236,98481,583,755,"P-LIB",39
20,"20902",14156,9664,9613,74,51,"P-LIB",8
3,"3065",167284,123032,122305,711,727,"P-LIB",65
47,"47223",157,122,118,2,4,"P-LIB",0
47,"47143",118,91,90,0,1,"P-LIB",0
46,"46119",780,653,647,5,6,"P-LIB",0
46,"46131",49431,36570,36227,231,343,"P-LIB",12
39,"39050",270,187,186,0,1,"P-LIB",0
47,"47119",92,80,79,1,1,"P-LIB",0
28,"28115",60892,49705,49510,209,195,"P-LIB",13
46,"46245",511,420,415,0,5,"P-LIB",0
20,"20079",17886,11860,11799,91,61,"P-LIB",4
47,"47096",140,110,110,0,0,"P-LIB",0
3,"3007",166,139,137,0,2,"P-LIB",0
28,"28051",1541,1163,1149,1,14,"P-LIB",1
3,"3134",143,112,111,0,1,"P-LIB",0
3,"3035",652,547,541,1,6,"P-LIB",1
39,"39101",274,197,192,3,5,"P-LIB",0
11,"11023",9348,6410,6349,64,61,"P-LIB",4
28,"28178",1065,824,818,5,6,"P-LIB",0
47,"47212",380,323,322,2,1,"P-LIB",0
46,"46062",4631,3511,3474,27,37,"P-LIB",0
46,"46038",327,242,242,3,0,"P-LIB",0
39,"39017",569,398,391,4,7,"P-LIB",0
46,"46153",439,355,351,1,4,"P-LIB",0
3,"3051",348,296,294,0,2,"P-LIB",0
47,"47158",889,667,659,8,8,"P-LIB",0
3,"3100",503,440,437,0,3,"P-LIB",0
46,"46177",4690,3579,3526,19,53,"P-LIB",1
46,"46162",1189,938,929,3,9,"P-LIB",0
47,"47031",189,145,145,1,0,"P-LIB",0
20,"20027",2814,1761,1750,15,11,"P-LIB",0
28,"28174",1795,1232,1221,7,11,"P-LIB",0
28,"28117",104,89,89,1,0,"P-LIB",0
47,"47113",159,129,128,0,1,"P-LIB",0
39,"39068",646,450,445,2,5,"P-LIB",0
3,"3038",355,288,285,3,3,"P-LIB",0
39,"39099",3114,2308,2281,12,27,"P-LIB",0
46,"46083",15422,11179,11049,86,130,"P-LIB",6
28,"28052",3855,2626,2587,11,39,"P-LIB",0
3,"3904",1396,1033,1026,4,7,"P-LIB",0
28,"28108",3374,2482,2465,10,17,"P-LIB",0
39,"39060",6679,5196,5121,29,75,"P-LIB",1
46,"46201",64,52,51,1,1,"P-LIB",0
28,"28177",10270,8083,8030,36,53,"P-LIB",5
46,"46146",1654,1304,1278,7,26,"P-LIB",0
39,"39014",883,619,614,6,5,"P-LIB",0
39,"39032",1463,1087,1081,7,6,"P-LIB",0
3,"3102",7229,5492,5414,52,78,"P-LIB",2
3,"3078",478,389,389,5,0,"P-LIB",2
46,"46066",1263,1024,1018,9,6,"P-LIB",0
20,"20033",868,600,599,1,1,"P-LIB",0
47,"47195",459,345,344,4,1,"P-LIB",2
39,"39088",69,52,52,0,0,"P-LIB",0
3,"3050",18652,13325,13234,57,91,"P-LIB",4
28,"28175",863,670,668,5,2,"P-LIB",0
47,"47071",410,324,321,4,3,"P-LIB",0
28,"28068",10955,8136,8076,49,60,"P-LIB",0
39,"39087",41985,31178,30805,228,373,"P-LIB",15
3,"3020",99,79,79,0,0,"P-LIB",0
20,"20064",12503,7803,7755,52,48,"P-LIB",2
28,"28061",21389,16277,16135,67,142,"P-LIB",7
46,"46247",1006,714,710,3,4,"P-LIB",0
28,"28136",647,528,518,2,10,"P-LIB",0
3,"3099",42319,31083,30801,165,282,"P-LIB",8
28,"28109",1576,1103,1098,1,5,"P-LIB",0
3,"3902",10254,6996,6930,34,66,"P-LIB",1
20,"20904",95,44,44,2,0,"P-LIB",0
47,"47181",165,135,132,3,3,"P-LIB",0
3,"3006",497,384,380,1,4,"P-LIB",0
46,"46149",363,271,268,2,3,"P-LIB",0
47,"47146",255,206,204,1,2,"P-LIB",1
47,"47167",241,204,204,1,0,"P-LIB",0
39,"39039",568,382,379,0,3,"P-LIB",0
20,"20053",4774,2973,2953,13,20,"P-LIB",1
46,"46172",5042,3504,3477,22,27,"P-LIB",1
46,"46060",9369,7052,6993,42,59,"P-LIB",2
20,"20076",6990,4666,4648,29,18,"P-LIB",12
47,"47087",381,301,297,3,4,"P-LIB",0
47,"47078",163,127,125,1,2,"P-LIB",0
39,"39098",1402,1046,1036,8,10,"P-LIB",1
47,"47112",2587,2015,1988,7,27,"P-LIB",1
47,"47132",45,36,33,1,3,"P-LIB",0
47,"47033",196,154,154,1,0,"P-LIB",0
28,"28113",34751,25832,25612,120,220,"P-LIB",12
46,"46223",7801,5950,5899,34,51,"P-LIB",4
46,"46262",223,162,159,2,3,"P-LIB",0
47,"47066",1268,981,977,12,4,"P-LIB",2
47,"47027",2745,2036,2018,9,18,"P-LIB",0
47,"47104",2836,2182,2121,19,61,"P-LIB",0
28,"28078",38,32,32,0,0,"P-LIB",0
20,"20072",4728,2902,2886,21,16,"P-LIB",2
47,"47008",24,19,19,1,0,"P-LIB",0
47,"47046",118,92,90,1,2,"P-LIB",0
20,"20052",1090,779,776,8,3,"P-LIB",0
46,"46238",13282,9786,9721,61,65,"P-LIB",5
39,"39058",810,559,557,2,2,"P-LIB",0
39,"39092",894,626,620,1,6,"P-LIB",1
46,"46001",795,601,592,3,9,"P-LIB",1
28,"28018",3768,2968,2945,26,23,"P-LIB",1
3,"3123",7476,5557,5501,29,56,"P-LIB",0
20,"20004",252,121,121,0,0,"P-LIB",1
46,"46251",2462,1997,1956,6,41,"P-LIB",4
46,"46106",1535,1150,1140,10,10,"P-LIB",0
46,"46175",456,389,387,3,2,"P-LIB",0
46,"46023",327,280,278,2,2,"P-LIB",0
46,"46203",3606,2873,2844,9,29,"P-LIB",3
46,"46164",11771,8564,8483,64,81,"P-LIB",7
28,"28180",5251,3927,3893,7,34,"P-LIB",0
47,"47188",111,88,88,3,0,"P-LIB",0
46,"46112",536,455,450,2,5,"P-LIB",0
3,"3083",5586,3971,3928,33,43,"P-LIB",2
20,"20021",200,100,100,2,0,"P-LIB",0
46,"46036",564,383,378,5,5,"P-LIB",0
3,"3014",237287,167428,166445,847,983,"P-LIB",65
28,"28035",1353,1006,998,2,8,"P-LIB",0
47,"47186",246129,186191,184733,1198,1458,"P-LIB",88
46,"46049",281,232,224,0,8,"P-LIB",0
46,"46227",905,711,702,1,9,"P-LIB",0
47,"47217",1910,1370,1366,1,4,"P-LIB",1
28,"28138",60,46,46,0,0,"P-LIB",0
47,"47189",152,119,118,0,1,"P-LIB",0
28,"28132",11685,8130,8062,56,68,"P-LIB",4
28,"28107",457,312,312,0,0,"P-LIB",0
47,"47048",188,144,144,1,0,"P-LIB",0
46,"46067",1753,1418,1393,1,25,"P-LIB",0
47,"47152",78,60,60,0,0,"P-LIB",0
39,"39006",1711,1307,1287,10,20,"P-LIB",0
46,"46197",1942,1527,1514,5,13,"P-LIB",0
46,"46257",5571,4266,4224,25,42,"P-LIB",1
28,"28039",128,98,97,2,1,"P-LIB",0
46,"46234",348,279,275,3,4,"P-LIB",0
46,"46021",23649,17291,17153,100,138,"P-LIB",12
46,"46099",901,689,684,1,5,"P-LIB",0
28,"28086",5154,3530,3493,13,37,"P-LIB",2
20,"20034",3145,2026,2014,14,12,"P-LIB",0
47,"47190",98,80,80,1,0,"P-LIB",0
46,"46183",5993,4443,4381,19,62,"P-LIB",3
3,"3121",21273,14569,14468,62,101,"P-LIB",9
11,"11038",13737,10181,10034,99,147,"P-LIB",5
3,"3110",291,241,241,1,0,"P-LIB",0
28,"28902",471,363,356,4,7,"P-LIB",0
47,"47040",64,53,53,0,0,"P-LIB",0
46,"46217",878,691,676,4,15,"P-LIB",0
46,"46190",48947,35638,35419,211,219,"P-LIB",9
3,"3094",9080,6440,6396,34,44,"P-LIB",3
47,"47135",83,72,72,2,0,"P-LIB",0
39,"39069",1972,1510,1489,12,21,"P-LIB",1
46,"46216",5053,4109,4090,14,19,"P-LIB",2
39,"39100",860,633,629,15,4,"P-LIB",0
3,"3091",252,217,215,2,2,"P-LIB",0
39,"39048",1716,1329,1312,12,17,"P-LIB",0
47,"47124",392,316,311,3,5,"P-LIB",0
3,"3019",15269,11520,11398,72,122,"P-LIB",4
47,"47180",73,61,60,4,1,"P-LIB",0
46,"46101",860,716,705,3,11,"P-LIB",0
20,"20008",716,362,361,6,1,"P-LIB",0
3,"3070",2051,1455,1437,7,18,"P-LIB",0
46,"46208",1112,887,881,4,6,"P-LIB",0
20,"20070",1092,748,746,5,2,"P-LIB",0
28,"28067",4063,3102,3079,3,23,"P-LIB",1
20,"20030",21423,13960,13898,101,62,"P-LIB",8
46,"46058",1772,1398,1373,15,25,"P-LIB",0
11,"11004",88783,51500,51015,513,485,"P-LIB",27
20,"20015",1265,858,851,7,7,"P-LIB",0
47,"47042",54,37,37,0,0,"P-LIB",0
47,"47145",603,448,441,3,7,"P-LIB",0
47,"47140",115,102,102,1,0,"P-LIB",0
28,"28033",3899,2805,2788,7,17,"P-LIB",0
47,"47178",172,140,140,3,0,"P-LIB",0
47,"47215",53,45,45,0,0,"P-LIB",0
28,"28043",5921,3803,3759,18,44,"P-LIB",0
20,"20042",3228,1967,1958,27,9,"P-LIB",0
47,"47184",573,453,451,1,2,"P-LIB",1
11,"11026",4782,3451,3378,26,73,"P-LIB",4
3,"3021",5613,4570,4500,26,70,"P-LIB",3
3,"3135",211,170,166,2,4,"P-LIB",0
3,"3093",19683,14633,14484,70,149,"P-LIB",13
39,"39082",1653,1173,1157,11,16,"P-LIB",0
46,"46120",1113,903,875,2,28,"P-LIB",0
3,"3089",9571,6775,6639,47,136,"P-LIB",0
46,"46100",286,232,230,1,2,"P-LIB",1
20,"20907",118,85,85,2,0,"P-LIB",0
46,"46077",7496,5909,5827,45,82,"P-LIB",2
28,"28091",5440,3596,3558,24,38,"P-LIB",1
47,"47171",407,303,301,6,2,"P-LIB",0
11,"11016",14929,9426,9302,123,124,"P-LIB",1
47,"47080",30,22,21,0,1,"P-LIB",0
3,"3012",1085,852,841,3,11,"P-LIB",0
28,"28131",12990,9512,9433,38,79,"P-LIB",4
47,"47026",46,40,40,1,0,"P-LIB",0
47,"47068",34,26,26,0,0,"P-LIB",0
39,"39053",219,153,152,2,1,"P-LIB",0
11,"11011",1716,1195,1165,12,30,"P-LIB",0
39,"39023",6330,4737,4672,25,65,"P-LIB",1
28,"28042",1173,890,883,3,7,"P-LIB",0
20,"20019",9986,6428,6392,48,36,"P-LIB",3
47,"47086",3906,2970,2936,24,34,"P-LIB",0
28,"28045",33328,24620,24434,146,186,"P-LIB",7
11,"11010",6410,4189,4130,88,59,"P-LIB",5
20,"20051",6877,4699,4679,34,20,"P-LIB",1
46,"46110",21228,15563,15443,86,120,"P-LIB",13
3,"3131",175,154,147,0,7,"P-LIB",0
39,"39047",1962,1385,1371,10,14,"P-LIB",0
47,"47214",1409,1087,1062,7,25,"P-LIB",0
46,"46166",8155,6320,6251,30,69,"P-LIB",3
28,"28037",1559,1177,1166,5,11,"P-LIB",0
3,"3096",5786,4358,4289,17,69,"P-LIB",3
3,"3034",1376,1067,1052,5,15,"P-LIB",0
46,"46123",1829,1407,1388,7,19,"P-LIB",0
28,"28064",129,106,106,2,0,"P-LIB",0
47,"47110",450,350,346,1,4,"P-LIB",0
47,"47105",183,158,156,0,2,"P-LIB",1
3,"3024",3901,3067,3024,11,43,"P-LIB",1
47,"47063",103,81,80,1,1,"P-LIB",0
39,"39034",286,188,185,5,3,"P-LIB",0
20,"20025",1143,765,760,8,5,"P-LIB",1
20,"20002",346,203,203,4,0,"P-LIB",0
47,"47091",84,71,71,2,0,"P-LIB",0
46,"46193",8788,6925,6871,50,54,"P-LIB",4
39,"39012",6687,5021,4957,51,64,"P-LIB",2
47,"47156",162,136,133,0,3,"P-LIB",0
39,"39025",8637,6486,6378,47,108,"P-LIB",2
47,"47097",325,266,265,0,1,"P-LIB",0
46,"46025",2499,1953,1934,8,19,"P-LIB",4
39,"39008",13877,10258,10153,96,105,"P-LIB",3
3,"3903",2494,1880,1865,7,15,"P-LIB",2
28,"28148",85454,62367,61884,370,483,"P-LIB",15
28,"28038",4952,3730,3688,34,42,"P-LIB",1
20,"20037",99,64,64,2,0,"P-LIB",0
3,"3043",2911,2431,2399,13,32,"P-LIB",3
39,"39030",1895,1225,1212,10,13,"P-LIB",0
20,"20074",11592,7954,7914,45,40,"P-LIB",1
3,"3040",254,216,213,2,3,"P-LIB",0
46,"46156",2080,1697,1675,10,22,"P-LIB",0
28,"28161",48848,35503,35203,210,300,"P-LIB",6
39,"39063",967,697,690,9,7,"P-LIB",0
46,"46003",950,791,769,1,22,"P-LIB",1
28,"28165",1794,1293,1285,3,8,"P-LIB",1
28,"28085",3922,2972,2954,14,18,"P-LIB",1
20,"20081",7470,4856,4833,40,23,"P-LIB",2
46,"46136",2537,1952,1930,11,22,"P-LIB",2
46,"46041",329,253,252,5,1,"P-LIB",0
46,"46226",41,36,35,0,1,"P-LIB",0
28,"28156",1019,742,738,3,4,"P-LIB",0
11,"11037",5661,4347,4265,33,82,"P-LIB",0
3,"3047",9207,6309,6226,25,83,"P-LIB",2
46,"46117",495,402,399,5,3,"P-LIB",0
46,"46134",2357,1725,1712,14,13,"P-LIB",3
28,"28166",320,254,251,2,3,"P-LIB",1
3,"3048",4847,3719,3683,20,36,"P-LIB",0
47,"47218",993,743,734,2,9,"P-LIB",1
47,"47084",1150,887,870,7,17,"P-LIB",1
47,"47131",170,134,128,2,6,"P-LIB",0
3,"3132",534,436,435,3,1,"P-LIB",1
46,"46065",1579,1174,1163,8,11,"P-LIB",0
39,"39027",3118,2322,2295,26,27,"P-LIB",0
28,"28012",887,664,661,2,3,"P-LIB",0
46,"46126",5556,4449,4405,24,44,"P-LIB",1
46,"46222",384,307,304,1,3,"P-LIB",0
28,"28106",76907,52773,52265,385,508,"P-LIB",33
20,"20073",4677,3014,2995,15,19,"P-LIB",0
46,"46097",963,733,728,4,5,"P-LIB",0
46,"46213",15409,10924,10805,97,119,"P-LIB",3
3,"3052",970,769,755,8,14,"P-LIB",1
47,"47088",103,86,85,1,1,"P-LIB",0
46,"46138",343,275,272,1,3,"P-LIB",0
46,"46170",3417,2714,2688,10,26,"P-LIB",0
46,"46092",276,192,189,0,3,"P-LIB",0
28,"28032",4762,3428,3401,19,27,"P-LIB",1
47,"47117",301,233,227,2,6,"P-LIB",0
3,"3002",3605,2583,2557,15,26,"P-LIB",0
46,"46017",32949,23913,23685,142,228,"P-LIB",14
47,"47205",384,266,260,0,6,"P-LIB",0
47,"47024",259,208,207,1,1,"P-LIB",0
46,"46176",2017,1358,1349,5,9,"P-LIB",1
39,"39019",2079,1560,1531,10,29,"P-LIB",1
46,"46032",5653,4402,4361,33,41,"P-LIB",4
39,"39009",3216,2366,2337,17,29,"P-LIB",2
28,"28030",1726,1320,1299,8,21,"P-LIB",0
28,"28076",398,325,317,1,8,"P-LIB",0
3,"3120",2406,1753,1720,11,33,"P-LIB",1
47,"47232",102,77,74,1,3,"P-LIB",0
46,"46093",2118,1647,1624,4,23,"P-LIB",0
11,"11007",17964,10038,9856,197,182,"P-LIB",8
46,"46015",7244,5615,5560,40,55,"P-LIB",5
39,"39011",1585,1169,1160,5,9,"P-LIB",0
46,"46241",392,299,291,1,8,"P-LIB",0
3,"3103",272,235,234,1,1,"P-LIB",0
47,"47014",51,45,45,0,0,"P-LIB",0
28,"28169",1448,1122,1113,5,9,"P-LIB",0
39,"39081",437,337,332,4,5,"P-LIB",0
47,"47016",69,56,55,0,1,"P-LIB",0
28,"28034",361,274,269,1,5,"P-LIB",0
46,"46224",159,121,121,0,0,"P-LIB",0
46,"46111",10930,7931,7828,44,103,"P-LIB",3
3,"3011",7753,5464,5415,27,49,"P-LIB",1
46,"46155",1029,833,822,4,11,"P-LIB",3
46,"46230",13960,10351,10241,54,110,"P-LIB",5
39,"39028",3739,2850,2817,16,33,"P-LIB",2
20,"20069",147046,100691,100232,836,459,"P-LIB",69
3,"3069",3076,2123,2102,17,21,"P-LIB",1
3,"3104",27103,19953,19787,131,166,"P-LIB",4
46,"46237",7211,5395,5343,42,52,"P-LIB",3
47,"47159",822,644,636,1,8,"P-LIB",1
46,"46109",6150,4625,4556,25,69,"P-LIB",0
28,"28044",5826,4445,4409,24,36,"P-LIB",3
39,"39072",344,198,196,2,2,"P-LIB",0
39,"39042",5915,4530,4474,21,56,"P-LIB",0
47,"47059",97,76,76,2,0,"P-LIB",0
28,"28168",1237,884,880,4,4,"P-LIB",1
11,"11018",1468,1046,1031,9,15,"P-LIB",1
47,"47018",34,28,28,0,0,"P-LIB",0
3,"3116",1155,877,875,6,2,"P-LIB",0
47,"47133",2682,2033,2015,16,18,"P-LIB",1
47,"47154",152,128,125,1,3,"P-LIB",0
46,"46174",972,764,752,2,12,"P-LIB",0
47,"47109",179,138,138,2,0,"P-LIB",0
3,"3105",5373,3911,3828,15,83,"P-LIB",0
20,"20063",8017,5263,5231,35,32,"P-LIB",0
11,"11040",397,307,292,1,15,"P-LIB",0
46,"46145",21990,16337,16187,93,150,"P-LIB",6
47,"47137",29,25,25,1,0,"P-LIB",0
11,"11902",3629,2275,2252,25,23,"P-LIB",0
3,"3054",343,277,275,3,2,"P-LIB",0
28,"28153",697,499,499,1,0,"P-LIB",0
39,"39024",1879,1390,1372,2,18,"P-LIB",0
47,"47099",150,135,135,1,0,"P-LIB",0
47,"47073",122,103,101,1,2,"P-LIB",0
46,"46044",4218,3222,3158,18,64,"P-LIB",0
3,"3128",4092,2861,2840,10,21,"P-LIB",1
3,"3075",147,128,128,0,0,"P-LIB",0
3,"3106",583,480,478,2,2,"P-LIB",0
28,"28114",150,101,100,1,1,"P-LIB",0
28,"28046",4460,3447,3422,16,25,"P-LIB",0
39,"39065",252,191,189,1,2,"P-LIB",1
39,"39044",3849,2765,2732,21,33,"P-LIB",1
47,"47029",57,52,52,0,0,"P-LIB",0
20,"20046",1223,739,737,5,2,"P-LIB",0
46,"46261",1725,1356,1337,5,19,"P-LIB",3
28,"28069",50,44,41,0,3,"P-LIB",0
28,"28066",7182,5422,5371,17,51,"P-LIB",1
3,"3129",1194,957,938,0,19,"P-LIB",2
46,"46902",364,306,303,0,3,"P-LIB",1
20,"20055",17475,11073,10997,56,76,"P-LIB",7
39,"39093",299,229,226,4,3,"P-LIB",0
20,"20036",13210,8518,8475,67,43,"P-LIB",6
28,"28084",15859,11156,11058,64,98,"P-LIB",3
28,"28090",8505,6654,6609,33,45,"P-LIB",0
46,"46069",162,124,123,0,1,"P-LIB",0
28,"28122",513,375,370,2,5,"P-LIB",1
46,"46020",3760,2916,2866,22,50,"P-LIB",3
3,"3067",99,85,85,0,0,"P-LIB",0
20,"20011",1658,1219,1210,7,9,"P-LIB",0
47,"47192",102,83,81,1,2,"P-LIB",0
11,"11014",16858,10366,10245,153,121,"P-LIB",5
39,"39036",969,743,739,2,4,"P-LIB",0
46,"46098",2482,1907,1889,11,18,"P-LIB",0
20,"20059",8874,5873,5855,29,18,"P-LIB",1
3,"3037",346,282,278,3,4,"P-LIB",0
47,"47093",813,613,600,5,13,"P-LIB",0
46,"46254",1000,785,779,6,6,"P-LIB",0
46,"46064",509,412,399,1,13,"P-LIB",0
47,"47203",62,53,53,1,0,"P-LIB",0
20,"20038",387,261,259,0,2,"P-LIB",0
20,"20005",1260,738,736,11,2,"P-LIB",0
20,"20049",4122,2677,2666,15,11,"P-LIB",1
46,"46151",728,550,541,0,9,"P-LIB",0
47,"47005",549,413,408,2,5,"P-LIB",0
47,"47149",42,34,34,3,0,"P-LIB",0
47,"47102",291,230,220,1,10,"P-LIB",0
11,"11005",4583,3018,2967,25,51,"P-LIB",3
47,"47229",210,148,147,1,1,"P-LIB",0
47,"47141",134,111,110,0,1,"P-LIB",0
46,"46186",19068,14599,14474,69,125,"P-LIB",2
46,"46160",1913,1452,1436,1,16,"P-LIB",0
47,"47221",111,94,94,0,0,"P-LIB",0
46,"46091",118,94,94,0,0,"P-LIB",0
3,"3005",7769,5917,5866,19,51,"P-LIB",4
47,"47204",256,204,198,0,6,"P-LIB",0
47,"47164",378,313,311,1,2,"P-LIB",0
39,"39022",980,721,713,2,8,"P-LIB",0
47,"47003",227,180,179,3,1,"P-LIB",0
46,"46239",442,340,338,3,2,"P-LIB",0
3,"3133",41576,25849,25639,127,210,"P-LIB",39
11,"11017",3212,2233,2203,39,30,"P-LIB",0
47,"47231",4401,3299,3277,24,22,"P-LIB",0
3,"3122",42425,30153,29954,154,199,"P-LIB",11
46,"46255",3174,2448,2424,22,24,"P-LIB",1
47,"47151",27,24,24,0,0,"P-LIB",0
46,"46256",6853,4951,4890,25,61,"P-LIB",2
47,"47160",425,308,303,0,5,"P-LIB",0
46,"46231",2421,1721,1708,14,13,"P-LIB",0
28,"28004",6234,4202,4167,16,35,"P-LIB",1
28,"28903",33082,27065,26922,154,143,"P-LIB",10
28,"28060",1510,1134,1117,1,17,"P-LIB",0
11,"11029",5430,3039,3000,44,39,"P-LIB",2
47,"47007",3769,2765,2736,24,29,"P-LIB",0
46,"46090",1637,1391,1367,3,24,"P-LIB",0
28,"28023",4775,3755,3735,12,20,"P-LIB",2
28,"28159",589,468,468,5,0,"P-LIB",0
20,"20045",46626,30525,30353,197,172,"P-LIB",23
28,"28092",151841,110916,109954,582,962,"P-LIB",49
46,"46033",191,156,155,0,1,"P-LIB",0
46,"46154",808,636,631,5,5,"P-LIB",0
46,"46102",19788,15154,15038,89,116,"P-LIB",11
46,"46189",467,393,390,2,3,"P-LIB",0
46,"46206",571,453,445,2,8,"P-LIB",0
3,"3082",12567,8537,8464,44,73,"P-LIB",4
47,"47161",3918,3145,3126,12,19,"P-LIB",1
28,"28111",596,467,467,3,0,"P-LIB",0
46,"46903",6065,4790,4763,18,27,"P-LIB",3
47,"47206",92,80,80,0,0,"P-LIB",0
46,"46068",346,276,266,6,10,"P-LIB",0
46,"46215",1436,1154,1143,5,11,"P-LIB",0
28,"28025",420,320,315,4,5,"P-LIB",0
11,"11031",76455,49854,49405,535,449,"P-LIB",33
20,"20017",8559,5478,5435,24,43,"P-LIB",2
46,"46173",1328,1069,1057,4,12,"P-LIB",0
39,"39089",143,104,100,1,4,"P-LIB",0
46,"46045",1249,1028,1010,3,18,"P-LIB",1
3,"3039",81,62,61,1,1,"P-LIB",0
47,"47126",50,41,41,0,0,"P-LIB",0
46,"46242",333,267,266,0,1,"P-LIB",0
47,"47196",34,27,27,0,0,"P-LIB",0
47,"47061",256,212,211,2,1,"P-LIB",0
47,"47009",107,86,85,0,1,"P-LIB",0
47,"47224",87,76,76,0,0,"P-LIB",0
46,"46147",16835,11920,11791,61,129,"P-LIB",4
20,"20066",454,236,234,1,2,"P-LIB",0
46,"46052",499,421,417,2,4,"P-LIB",0
3,"3127",350,278,273,1,5,"P-LIB",0
3,"3023",1398,1184,1167,7,17,"P-LIB",0
39,"39033",568,418,415,2,3,"P-LIB",0
47,"47053",119,98,96,0,2,"P-LIB",0
3,"3063",26462,18591,18492,91,99,"P-LIB",7
28,"28143",72,57,57,1,0,"P-LIB",0
28,"28082",5683,4324,4286,25,38,"P-LIB",2
46,"46188",672,544,537,8,7,"P-LIB",0
28,"28123",57078,45270,44992,215,278,"P-LIB",10
47,"47010",13729,10549,10454,81,95,"P-LIB",2
46,"46168",1938,1495,1486,2,9,"P-LIB",0
47,"47118",168,127,127,2,0,"P-LIB",0
28,"28008",1799,1182,1174,4,8,"P-LIB",0
47,"47020",280,234,231,2,3,"P-LIB",0
46,"46096",274,209,209,1,0,"P-LIB",0
47,"47138",241,170,164,1,6,"P-LIB",0
46,"46105",16190,11323,11206,44,117,"P-LIB",6
46,"46209",1933,1445,1415,5,30,"P-LIB",2
3,"3117",362,318,313,2,5,"P-LIB",0
20,"20057",196,122,122,0,0,"P-LIB",0
47,"47198",69,50,50,0,0,"P-LIB",0
46,"46157",2980,2321,2298,10,23,"P-LIB",2
3,"3045",210,176,172,0,4,"P-LIB",0
11,"11001",4358,2816,2767,11,49,"P-LIB",2
3,"3139",22437,15315,15170,100,145,"P-LIB",11
47,"47199",80,63,63,0,0,"P-LIB",0
46,"46002",1175,941,932,5,9,"P-LIB",1
11,"11013",2312,1547,1518,15,29,"P-LIB",0
47,"47050",3719,2630,2598,26,32,"P-LIB",1
46,"46103",1264,1015,984,7,31,"P-LIB",0
28,"28134",61008,45177,44904,263,273,"P-LIB",11
28,"28075",5621,4186,4148,26,38,"P-LIB",2
28,"28047",40914,30019,29788,169,231,"P-LIB",7
20,"20014",1108,611,609,4,2,"P-LIB",0
20,"20058",755,529,525,3,4,"P-LIB",0
46,"46133",533,415,410,6,5,"P-LIB",0
28,"28057",1458,1097,1088,3,9,"P-LIB",1
28,"28011",442,317,316,1,1,"P-LIB",0
47,"47200",85,66,66,0,0,"P-LIB",1
47,"47157",515,424,423,1,1,"P-LIB",0
20,"20071",14801,9466,9421,60,45,"P-LIB",4
47,"47211",47,35,34,0,1,"P-LIB",0
47,"47220",165,130,129,0,1,"P-LIB",0
47,"47013",100,82,81,1,1,"P-LIB",0
3,"3016",93,75,75,0,0,"P-LIB",0
3,"3098",505,393,386,0,7,"P-LIB",0
47,"47228",440,331,331,2,0,"P-LIB",0
47,"47065",857,674,669,1,5,"P-LIB",0
28,"28901",799,558,554,0,4,"P-LIB",0
28,"28162",2617,2029,2016,6,13,"P-LIB",0
28,"28183",1039,743,735,2,8,"P-LIB",0
28,"28125",3002,2180,2163,11,17,"P-LIB",0
3,"3077",1371,1071,1060,13,11,"P-LIB",0
39,"39057",2330,1671,1645,7,26,"P-LIB",1
46,"46195",1962,1531,1516,11,15,"P-LIB",0
46,"46004",1922,1565,1547,11,18,"P-LIB",1
46,"46229",948,762,758,0,4,"P-LIB",1
46,"46056",182,167,166,1,1,"P-LIB",1
47,"47122",2032,1563,1535,7,28,"P-LIB",1
28,"28002",3007,2091,2074,14,17,"P-LIB",1
46,"46169",32247,24214,24053,154,161,"P-LIB",6
28,"28157",609,433,430,1,3,"P-LIB",0
28,"28003",173,141,141,0,0,"P-LIB",0
28,"28147",963,722,720,5,2,"P-LIB",0
28,"28127",64827,51776,51613,220,163,"P-LIB",11
3,"3017",374,314,307,1,7,"P-LIB",0
39,"39001",2102,1622,1601,18,21,"P-LIB",0
46,"46152",96,68,68,0,0,"P-LIB",0
46,"46019",8849,7072,7004,33,68,"P-LIB",1
46,"46054",11293,8477,8409,47,68,"P-LIB",1
28,"28176",12491,9723,9667,37,56,"P-LIB",2
28,"28059",4323,3171,3157,11,14,"P-LIB",0
46,"46161",1483,1188,1173,7,15,"P-LIB",0
46,"46135",9680,7682,7634,36,48,"P-LIB",5
20,"20039",2111,1480,1472,14,8,"P-LIB",0
28,"28167",8356,6158,6106,46,52,"P-LIB",1
47,"47041",150,112,110,2,2,"P-LIB",0
20,"20029",4281,2813,2802,19,11,"P-LIB",1
46,"46075",150,130,123,1,7,"P-LIB",0
20,"20903",4330,2756,2734,28,22,"P-LIB",0
11,"11006",24455,15750,15587,193,163,"P-LIB",6
46,"46179",2165,1760,1737,16,23,"P-LIB",0
28,"28099",1748,1290,1283,7,7,"P-LIB",1
47,"47177",105,76,73,1,3,"P-LIB",0
47,"47114",4045,2787,2762,26,25,"P-LIB",1
47,"47168",29,26,26,1,0,"P-LIB",0
20,"20018",11064,6719,6690,41,29,"P-LIB",1
28,"28036",2539,1899,1878,11,21,"P-LIB",0
3,"3119",16636,12281,12194,57,87,"P-LIB",1
46,"46130",901,687,683,3,4,"P-LIB",0
28,"28027",1203,872,857,3,15,"P-LIB",0
46,"46171",16563,12213,12128,85,85,"P-LIB",4
3,"3041",5954,4218,4194,22,24,"P-LIB",6
47,"47034",72,58,58,3,0,"P-LIB",0
46,"46232",895,711,696,5,15,"P-LIB",0
46,"46007",11989,8784,8711,67,73,"P-LIB",4
46,"46128",1597,1290,1250,5,40,"P-LIB",0
47,"47169",68,59,59,0,0,"P-LIB",0
3,"3114",1562,1198,1188,9,10,"P-LIB",0
11,"11030",22775,15157,14958,149,199,"P-LIB",12
28,"28014",33085,23626,23466,113,160,"P-LIB",4
47,"47043",297,239,237,0,2,"P-LIB",0
46,"46042",3380,2799,2755,20,44,"P-LIB",2
20,"20054",447,286,284,2,2,"P-LIB",0
20,"20013",5415,3602,3579,19,23,"P-LIB",2
46,"46199",5718,4314,4266,28,48,"P-LIB",1
46,"46178",4637,3405,3381,27,24,"P-LIB",0
47,"47077",246,193,191,1,2,"P-LIB",0
20,"20906",119,87,87,1,0,"P-LIB",0
28,"28112",161,136,136,1,0,"P-LIB",0
28,"28141",5823,4297,4262,29,35,"P-LIB",2
47,"47216",115,91,87,0,4,"P-LIB",0
47,"47089",148,125,124,0,1,"P-LIB",0
3,"3115",255,222,220,2,2,"P-LIB",0
3,"3001",337,269,268,0,1,"P-LIB",0
28,"28080",48554,38885,38691,164,194,"P-LIB",5
47,"47225",80,63,63,0,0,"P-LIB",0
11,"11901",5648,3676,3631,67,45,"P-LIB",2
46,"46078",28017,20288,20143,132,145,"P-LIB",16
3,"3033",117,96,95,0,1,"P-LIB",0
20,"20044",367,236,236,0,0,"P-LIB",0
28,"28007",124592,94222,93521,491,701,"P-LIB",21
39,"39002",3298,2342,2309,13,33,"P-LIB",1
20,"20003",547,308,308,3,0,"P-LIB",0
3,"3095",4579,3489,3459,25,30,"P-LIB",1
46,"46122",2704,2082,2063,10,19,"P-LIB",0
47,"47174",267,218,215,1,3,"P-LIB",0
46,"46200",1903,1561,1539,3,22,"P-LIB",0
11,"11036",689,407,400,3,7,"P-LIB",0
20,"20067",30828,19984,19882,140,102,"P-LIB",8
47,"47090",2418,1728,1699,8,29,"P-LIB",3
39,"39074",6902,5113,5039,40,74,"P-LIB",2
3,"3004",581,438,437,2,1,"P-LIB",0
3,"3085",272,217,213,0,4,"P-LIB",1
20,"20068",190,135,135,3,0,"P-LIB",0
11,"11012",99886,70290,69673,693,617,"P-LIB",61
11,"11034",2334,1549,1517,14,32,"P-LIB",0
46,"46053",553,445,436,2,9,"P-LIB",0
46,"46027",943,780,771,5,9,"P-LIB",0
46,"46079",318,241,232,1,9,"P-LIB",1
39,"39095",2266,1760,1726,14,34,"P-LIB",1
46,"46235",21579,15929,15763,113,166,"P-LIB",7
46,"46010",935,729,723,4,6,"P-LIB",1
28,"28024",151,125,124,1,1,"P-LIB",0
3,"3055",5164,3695,3647,21,48,"P-LIB",1
28,"28074",138947,103687,102762,620,925,"P-LIB",33
3,"3032",108,91,90,1,1,"P-LIB",0
47,"47227",61,50,50,0,0,"P-LIB",0
28,"28154",5408,3806,3767,16,39,"P-LIB",2
11,"11002",4273,2835,2815,16,20,"P-LIB",0
47,"47012",113,93,93,0,0,"P-LIB",0
46,"46158",1026,811,795,6,16,"P-LIB",0
46,"46228",2348,1815,1794,7,21,"P-LIB",0
46,"46081",10134,7771,7702,41,69,"P-LIB",1
47,"47038",105,77,77,0,0,"P-LIB",0
46,"46055",1262,1025,1012,5,13,"P-LIB",0
11,"11025",4398,2899,2848,51,51,"P-LIB",0
47,"47075",4856,3681,3637,24,44,"P-LIB",0
28,"28116",704,528,523,2,5,"P-LIB",0
39,"39056",2286,1714,1684,8,30,"P-LIB",0
47,"47047",199,157,156,2,1,"P-LIB",0
47,"47127",137,98,97,0,1,"P-LIB",0
47,"47030",993,766,751,6,15,"P-LIB",0
3,"3057",182,147,147,1,0,"P-LIB",0
39,"39084",838,631,624,2,7,"P-LIB",0
46,"46220",48410,34644,34292,279,352,"P-LIB",8
20,"20056",4082,2589,2570,27,19,"P-LIB",0
46,"46142",787,619,602,1,17,"P-LIB",0
47,"47098",576,464,452,4,12,"P-LIB",0
39,"39067",790,513,505,1,8,"P-LIB",0
11,"11015",62476,38177,37875,488,302,"P-LIB",18
47,"47022",59,50,49,0,1,"P-LIB",0
46,"46212",1620,1150,1124,9,26,"P-LIB",0
47,"47130",96,72,72,0,0,"P-LIB",0
39,"39007",417,278,275,2,3,"P-LIB",0
28,"28095",1529,1119,1106,6,13,"P-LIB",0
28,"28021",554,370,364,3,6,"P-LIB",0
46,"46143",4239,3104,3053,14,51,"P-LIB",2
20,"20060",88,67,67,2,0,"P-LIB",0
46,"46013",17383,13569,13483,82,86,"P-LIB",4
46,"46022",15365,11093,10997,59,96,"P-LIB",4
47,"47011",565,461,458,5,3,"P-LIB",0
28,"28053",6498,4995,4955,28,40,"P-LIB",2
46,"46086",82,70,69,1,1,"P-LIB",0
39,"39004",1518,1090,1074,4,16,"P-LIB",0
47,"47176",219,139,139,1,0,"P-LIB",0
46,"46048",3452,2749,2713,14,36,"P-LIB",1
3,"3049",12088,9121,9027,52,94,"P-LIB",1
3,"3090",17182,12487,12385,74,102,"P-LIB",4
47,"47015",200,162,160,0,2,"P-LIB",0
47,"47058",200,145,143,0,2,"P-LIB",0
39,"39059",7986,5879,5806,45,73,"P-LIB",4
28,"28149",5759,4352,4310,25,42,"P-LIB",7
3,"3080",1300,1035,1025,3,10,"P-LIB",1
47,"47095",38,31,31,0,0,"P-LIB",0
3,"3009",46657,35143,34801,223,342,"P-LIB",16
20,"20007",310,218,218,3,0,"P-LIB",0
39,"39029",618,488,481,3,7,"P-LIB",0
46,"46240",210,164,161,1,3,"P-LIB",0
39,"39097",697,371,368,2,3,"P-LIB",0
47,"47045",763,575,567,1,8,"P-LIB",0
39,"39070",144,96,94,2,2,"P-LIB",0
46,"46107",1900,1516,1504,5,12,"P-LIB",1
3,"3013",1113,839,836,4,3,"P-LIB",0
46,"46095",610,467,459,1,8,"P-LIB",1
46,"46087",120,98,97,0,1,"P-LIB",0
28,"28181",20386,16155,16069,57,86,"P-LIB",4
3,"3064",5015,3660,3611,11,49,"P-LIB",0
47,"47019",85,74,73,0,1,"P-LIB",0
46,"46076",575,454,443,0,11,"P-LIB",1
46,"46163",1866,1504,1480,8,24,"P-LIB",15
20,"20009",11452,7388,7345,62,43,"P-LIB",2
28,"28160",8256,6102,6059,31,43,"P-LIB",3
20,"20075",4371,2692,2679,18,13,"P-LIB",0
3,"3010",325,277,275,1,2,"P-LIB",0
39,"39041",1760,1370,1354,9,16,"P-LIB",1
46,"46094",20540,15378,15234,102,144,"P-LIB",7
28,"28179",1432,1040,1037,4,3,"P-LIB",0
47,"47125",58,46,46,0,0,"P-LIB",0
47,"47057",268,197,196,0,1,"P-LIB",0
39,"39045",367,271,268,1,3,"P-LIB",0
47,"47055",203,167,163,0,4,"P-LIB",0
46,"46196",147,125,125,1,0,"P-LIB",0
28,"28100",4196,2987,2955,14,32,"P-LIB",1
28,"28063",258,194,193,1,1,"P-LIB",0
39,"39052",18236,13537,13380,110,157,"P-LIB",10
47,"47207",278,215,212,3,3,"P-LIB",0
28,"28072",5709,4356,4324,22,32,"P-LIB",1
20,"20010",1499,992,986,9,6,"P-LIB",0
47,"47052",6576,4988,4944,40,44,"P-LIB",3
47,"47035",921,717,715,3,2,"P-LIB",0
46,"46258",2652,2084,2062,16,22,"P-LIB",1
47,"47179",395,293,287,0,6,"P-LIB",0
39,"39003",297,220,215,0,5,"P-LIB",1
47,"47062",163,130,130,0,0,"P-LIB",0
3,"3137",651,492,489,5,3,"P-LIB",1
47,"47194",298,239,237,2,2,"P-LIB",1
46,"46029",20613,14964,14879,93,85,"P-LIB",5
28,"28017",1208,907,899,7,8,"P-LIB",0
46,"46043",136,124,124,0,0,"P-LIB",0
28,"28026",6317,4734,4701,33,33,"P-LIB",1
46,"46061",342,274,272,1,2,"P-LIB",0
47,"47208",58,38,36,1,2,"P-LIB",0
11,"11021",6764,4434,4362,52,72,"P-LIB",2
46,"46035",6822,5202,5142,43,60,"P-LIB",1
28,"28065",126539,96997,96210,505,787,"P-LIB",22
46,"46018",608,515,511,0,4,"P-LIB",0
28,"28083",8939,6396,6348,38,48,"P-LIB",2
47,"47028",33,21,21,0,0,"P-LIB",0
28,"28172",9077,6992,6936,31,56,"P-LIB",4
47,"47037",168,138,133,0,5,"P-LIB",0
46,"46218",1060,910,885,7,25,"P-LIB",0
46,"46244",58771,42137,41867,270,270,"P-LIB",8
46,"46140",344,284,279,0,5,"P-LIB",0
46,"46088",166,125,125,4,0,"P-LIB",0
39,"39078",1401,975,963,5,12,"P-LIB",0
28,"28130",28293,21253,21040,116,213,"P-LIB",6
46,"46221",352,305,304,0,1,"P-LIB",1
11,"11008",17471,10952,10812,128,140,"P-LIB",2
28,"28028",1755,1353,1344,6,9,"P-LIB",0
47,"47129",871,664,659,4,5,"P-LIB",0
39,"39055",1086,824,816,6,8,"P-LIB",0
3,"3066",42121,29655,29419,214,236,"P-LIB",15
28,"28163",442,344,339,1,5,"P-LIB",0
39,"39096",690,487,479,4,8,"P-LIB",0
39,"39035",9502,7017,6928,57,89,"P-LIB",2
46,"46037",1122,936,923,4,13,"P-LIB",0
47,"47147",116,92,92,0,0,"P-LIB",0
46,"46202",16947,12814,12710,79,104,"P-LIB",5
46,"46211",1745,1387,1378,8,9,"P-LIB",0
28,"28001",61,46,45,0,1,"P-LIB",0
39,"39016",23868,17883,17701,122,182,"P-LIB",5
28,"28135",948,713,709,4,4,"P-LIB",0
3,"3109",2850,2181,2164,8,17,"P-LIB",3
20,"20022",839,473,472,4,1,"P-LIB",0
46,"46026",1204,1015,1004,3,11,"P-LIB",0
28,"28048",500,391,387,3,4,"P-LIB",0
47,"47092",110,87,87,0,0,"P-LIB",1
47,"47219",41,36,34,0,2,"P-LIB",0
20,"20026",197,145,133,0,12,"P-LIB",0
47,"47182",1323,977,967,8,10,"P-LIB",1
46,"46139",4485,3617,3574,18,43,"P-LIB",0
47,"47172",144,124,122,0,2,"P-LIB",0
47,"47226",156,123,123,0,0,"P-LIB",1
3,"3088",5498,4041,3989,29,52,"P-LIB",2
47,"47049",101,68,68,0,0,"P-LIB",0
28,"28049",58480,45136,44820,242,316,"P-LIB",24
46,"46073",1092,888,884,6,4,"P-LIB",0
46,"46082",4918,3745,3712,33,33,"P-LIB",0
46,"46125",847,689,684,5,5,"P-LIB",0
39,"39037",1987,1516,1503,8,13,"P-LIB",1
3,"3901",1135,822,817,8,5,"P-LIB",0
3,"3071",3982,3048,3012,26,36,"P-LIB",1
28,"28126",39,29,29,0,0,"P-LIB",0
3,"3061",1056,776,768,4,8,"P-LIB",0
28,"28070",117,91,91,0,0,"P-LIB",0
46,"46028",387,330,328,3,2,"P-LIB",1
11,"11009",605,414,410,1,4,"P-LIB",0
20,"20006",259,143,143,3,0,"P-LIB",0
3,"3008",168,130,129,0,1,"P-LIB",0
28,"28050",4076,2860,2839,21,21,"P-LIB",1
47,"47094",133,115,114,1,1,"P-LIB",0
47,"47085",16612,11829,11706,114,123,"P-LIB",6
46,"46005",22918,16958,16827,102,131,"P-LIB",7
46,"46118",3763,2940,2908,16,32,"P-LIB",1
28,"28097",119,94,94,0,0,"P-LIB",1
20,"20062",973,653,653,11,0,"P-LIB",0
28,"28158",665,537,533,4,4,"P-LIB",0
46,"46084",1576,1263,1242,5,21,"P-LIB",0
47,"47142",141,99,97,0,2,"P-LIB",1
28,"28128",444,315,314,0,1,"P-LIB",0
47,"47213",109,82,82,0,0,"P-LIB",0
28,"28155",506,416,411,0,5,"P-LIB",0
11,"11003",1261,836,822,7,14,"P-LIB",0
46,"46182",1266,929,922,6,7,"P-LIB",0
46,"46259",491,396,393,4,3,"P-LIB",0
3,"3026",1224,949,936,5,13,"P-LIB",0
3,"3130",48,25,25,0,0,"P-LIB",0
47,"47165",6955,4955,4303,66,652,"P-LIB",2
28,"28173",517,390,388,1,2,"P-LIB",0
47,"47036",228,181,181,3,0,"P-LIB",0
28,"28055",916,693,687,5,6,"P-LIB",0
39,"39054",4493,3376,3334,33,42,"P-LIB",0
3,"3124",460,388,384,3,4,"P-LIB",0
28,"28140",3007,2276,2256,7,20,"P-LIB",1
28,"28120",1223,892,884,2,8,"P-LIB",0
47,"47069",124,105,104,1,1,"P-LIB",0
46,"46085",11081,7938,7866,46,72,"P-LIB",3
28,"28089",3677,2748,2730,10,18,"P-LIB",2
46,"46192",761,576,570,5,6,"P-LIB",0
11,"11041",9866,6477,6402,69,75,"P-LIB",1
39,"39010",631,480,475,7,5,"P-LIB",0
47,"47051",335,268,263,2,5,"P-LIB",0
3,"3058",4951,3897,3851,30,46,"P-LIB",0
47,"47173",880,644,638,20,6,"P-LIB",0
3,"3125",343,254,251,0,3,"P-LIB",0
20,"20065",3012,1985,1967,12,18,"P-LIB",0
3,"3136",441,338,334,0,4,"P-LIB",0
11,"11020",165378,109810,108830,1188,980,"P-LIB",99
28,"28016",79,53,51,0,2,"P-LIB",0
46,"46129",524,420,412,4,8,"P-LIB",1
3,"3022",145,125,125,0,0,"P-LIB",0
47,"47017",201,158,153,1,5,"P-LIB",0
3,"3107",2508,1755,1744,7,11,"P-LIB",0
28,"28094",865,624,622,4,2,"P-LIB",0
47,"47021",76,64,64,0,0,"P-LIB",0
47,"47001",55,46,46,0,0,"P-LIB",0
3,"3073",236,200,199,1,1,"P-LIB",0
46,"46191",1937,1530,1505,5,25,"P-LIB",0
47,"47162",74,60,60,0,0,"P-LIB",0
46,"46006",4523,3665,3623,20,42,"P-LIB",0
28,"28041",4524,3508,3490,20,18,"P-LIB",2
46,"46194",15567,11156,11044,86,112,"P-LIB",0
47,"47056",87,67,67,0,0,"P-LIB",0
47,"47166",259,204,197,2,7,"P-LIB",0
46,"46150",1831,1341,1333,7,8,"P-LIB",1
47,"47139",1040,777,767,6,10,"P-LIB",0
46,"46124",787,653,642,4,11,"P-LIB",0
47,"47193",1577,1251,1241,7,10,"P-LIB",0
11,"11033",20903,12949,12771,164,178,"P-LIB",1
47,"47002",23,21,20,1,1,"P-LIB",0
47,"47081",45,36,35,1,1,"P-LIB",0
3,"3003",450,378,376,2,2,"P-LIB",0
20,"20023",441,252,251,1,1,"P-LIB",0
3,"3074",1707,1397,1389,4,8,"P-LIB",2
3,"3138",3145,2310,2275,9,35,"P-LIB",3
47,"47054",635,507,495,9,12,"P-LIB",0
28,"28144",6010,4676,4644,22,32,"P-LIB",2
39,"39091",1926,1493,1476,10,17,"P-LIB",0
28,"28150",3087,2294,2277,10,17,"P-LIB",2
46,"46180",682,553,549,0,4,"P-LIB",0
3,"3015",12566,9257,9177,39,80,"P-LIB",2
47,"47148",442,342,338,2,4,"P-LIB",0
39,"39061",3478,2695,2677,13,18,"P-LIB",2
28,"28020",145,94,94,0,0,"P-LIB",0
28,"28009",14086,10611,10545,57,66,"P-LIB",3
28,"28145",2431,1760,1736,6,24,"P-LIB",0
47,"47074",149,117,116,2,1,"P-LIB",0
28,"28133",5979,4140,4098,18,42,"P-LIB",0
28,"28164",2993,2183,2168,8,15,"P-LIB",0
47,"47083",80,59,54,1,5,"P-LIB",0
3,"3025",1270,950,941,2,9,"P-LIB",0
11,"11024",6723,4696,4634,44,62,"P-LIB",1
3,"3079",18224,13904,13709,80,195,"P-LIB",3
20,"20041",255,123,123,0,0,"P-LIB",0
3,"3140",26070,18999,18742,174,257,"P-LIB",10
47,"47101",1710,1357,1336,16,21,"P-LIB",0
28,"28102",894,644,636,6,8,"P-LIB",0
20,"20048",182,100,98,2,2,"P-LIB",0
46,"46121",105,95,94,0,1,"P-LIB",0
46,"46113",2457,1804,1782,6,22,"P-LIB",0
28,"28152",16093,12945,12877,58,68,"P-LIB",5
47,"47183",130,106,105,0,1,"P-LIB",0
46,"46072",3611,2871,2821,23,50,"P-LIB",1
47,"47191",108,79,79,0,0,"P-LIB",0
46,"46207",6676,5106,5040,41,66,"P-LIB",1
3,"3086",151,135,134,1,1,"P-LIB",0
46,"46040",1078,888,878,7,10,"P-LIB",0
39,"39080",3542,2656,2628,20,28,"P-LIB",1
39,"39043",1481,1122,1115,9,7,"P-LIB",0
47,"47076",17399,13097,12972,92,125,"P-LIB",8
3,"3031",41499,27031,26813,128,218,"P-LIB",14
46,"46030",800,627,614,5,13,"P-LIB",0
46,"46108",469,378,375,1,3,"P-LIB",0
20,"20901",1437,908,906,2,2,"P-LIB",0
20,"20016",1520,826,821,2,5,"P-LIB",0
46,"46114",569,461,458,1,3,"P-LIB",0
47,"47025",120,94,94,1,0,"P-LIB",0
28,"28079",2362038,1743924,1733354,8859,10570,"P-LIB",557
28,"28146",1787,1205,1194,0,11,"P-LIB",0
3,"3097",993,822,812,6,10,"P-LIB",0
46,"46132",2150,1803,1784,7,19,"P-LIB",1
46,"46144",663,532,529,2,3,"P-LIB",0
47,"47144",78,64,64,1,0,"P-LIB",0
3,"3028",998,818,812,2,6,"P-LIB",0
11,"11039",10018,6186,6109,103,77,"P-LIB",5
39,"39018",4220,3264,3204,35,60,"P-LIB",3
11,"11028",32488,21971,21672,316,299,"P-LIB",15
28,"28119",2092,1590,1582,12,8,"P-LIB",4
39,"39079",8874,6547,6478,47,69,"P-LIB",2
3,"3018",12240,8853,8777,47,76,"P-LIB",9
47,"47064",33,28,25,0,3,"P-LIB",0
3,"3111",5436,3918,3883,18,35,"P-LIB",0
46,"46210",330,277,277,2,0,"P-LIB",0
46,"46243",138,115,112,1,3,"P-LIB",0
3,"3060",109,91,91,0,0,"P-LIB",0
28,"28088",261,178,178,0,0,"P-LIB",0
46,"46253",115,82,82,0,0,"P-LIB",0
46,"46046",892,675,668,1,7,"P-LIB",0
47,"47004",1181,939,930,7,9,"P-LIB",0
46,"46225",337,290,281,5,9,"P-LIB",0
47,"47100",138,117,117,1,0,"P-LIB",0
3,"3046",1599,1153,1143,8,10,"P-LIB",2
39,"39094",848,655,651,3,4,"P-LIB",0
47,"47079",58,48,47,0,1,"P-LIB",0
28,"28022",33479,27129,27037,133,92,"P-LIB",8
28,"28062",292,231,226,1,5,"P-LIB",0
28,"28029",520,408,406,0,2,"P-LIB",1
3,"3053",7226,5651,5584,32,67,"P-LIB",0
3,"3081",1436,1084,1075,5,9,"P-LIB",3
20,"20012",147,99,98,5,1,"P-LIB",0
47,"47134",165,128,125,1,3,"P-LIB",0
11,"11019",1826,1302,1248,7,54,"P-LIB",2
46,"46137",270,210,207,4,3,"P-LIB",0
28,"28071",60,55,53,1,2,"P-LIB",0
47,"47060",258,216,214,1,2,"P-LIB",0
39,"39046",1404,1001,973,6,28,"P-LIB",0
28,"28093",2096,1670,1653,10,17,"P-LIB",0
46,"46059",1261,1035,1019,9,16,"P-LIB",0
46,"46233",3860,2859,2817,10,42,"P-LIB",1
47,"47111",1020,742,732,7,10,"P-LIB",0
46,"46246",1058,835,823,5,12,"P-LIB",1
28,"28101",231,187,187,0,0,"P-LIB",0
39,"39083",1135,679,670,8,9,"P-LIB",0
28,"28170",2472,1640,1622,13,18,"P-LIB",0
28,"28121",198,160,158,1,2,"P-LIB",0
46,"46008",2651,2108,2089,21,19,"P-LIB",1
39,"39102",2277,1615,1598,9,17,"P-LIB",2
3,"3062",212,169,165,0,4,"P-LIB",0
47,"47187",84,61,58,0,3,"P-LIB",0
20,"20020",125,71,69,3,2,"P-LIB",0
28,"28118",57,46,45,0,1,"P-LIB",0
46,"46057",487,321,317,1,4,"P-LIB",0
47,"47006",190,136,135,1,1,"P-LIB",0
11,"11032",53874,31273,31008,348,265,"P-LIB",17
3,"3084",539,454,446,3,8,"P-LIB",1
20,"20077",5213,3614,3591,36,23,"P-LIB",17
28,"28110",1944,1478,1463,4,15,"P-LIB",0
28,"28013",40471,28739,28490,188,249,"P-LIB",5
46,"46104",1940,1504,1487,7,17,"P-LIB",1
3,"3056",8676,6638,6541,34,97,"P-LIB",3
3,"3059",20583,15125,15018,63,107,"P-LIB",4
28,"28031",2048,1500,1486,3,14,"P-LIB",0
39,"39071",397,261,256,1,5,"P-LIB",3
3,"3044",4521,3510,3465,21,45,"P-LIB",1
39,"39085",6836,5086,5032,44,54,"P-LIB",2
46,"46014",3030,2383,2350,20,33,"P-LIB",2
46,"46031",10535,7543,7451,66,92,"P-LIB",3
46,"46070",16950,12765,12676,61,89,"P-LIB",4
28,"28058",139342,100637,99753,634,884,"P-LIB",33
20,"20001",246,133,132,2,1,"P-LIB",0
20,"20078",1155,850,846,4,4,"P-LIB",0
11,"11022",48675,26491,26256,270,235,"P-LIB",11
46,"46260",2581,2087,2068,22,19,"P-LIB",0
39,"39005",1380,1053,1046,9,7,"P-LIB",0
39,"39064",1345,1031,1015,7,16,"P-LIB",2
47,"47070",37,27,27,0,0,"P-LIB",0
39,"39062",1812,1379,1366,5,13,"P-LIB",0
46,"46071",464,383,377,0,6,"P-LIB",0
11,"11027",67913,45219,44833,454,386,"P-LIB",27
20,"20047",469,307,304,5,3,"P-LIB",0
39,"39076",3476,2594,2559,19,35,"P-LIB",1
39,"39075",137376,99899,99048,718,851,"P-LIB",45
28,"28182",210,171,169,0,2,"P-LIB",0
46,"46248",4897,3596,3544,18,52,"P-LIB",0
46,"46159",22857,16840,16697,128,143,"P-LIB",11
46,"46148",1513,1160,1146,7,14,"P-LIB",0
47,"47153",108,77,77,0,0,"P-LIB",0
46,"46050",194,150,149,0,1,"P-LIB",0
3,"3101",4808,3627,3580,22,47,"P-LIB",0
47,"47106",50,39,39,0,0,"P-LIB",0
46,"46181",16955,12313,12148,95,165,"P-LIB",4
46,"46252",118,99,98,0,1,"P-LIB",0
3,"3118",2437,1659,1642,4,17,"P-LIB",2
39,"39077",236,173,171,1,2,"P-LIB",1
47,"47044",331,293,290,2,3,"P-LIB",0
46,"46185",378,320,313,2,7,"P-LIB",0
39,"39066",872,667,661,4,6,"P-LIB",0
20,"20905",145,100,100,1,0,"P-LIB",0
46,"46016",1061,870,856,5,14,"P-LIB",1
47,"47128",60,52,51,0,1,"P-LIB",0
20,"20061",4273,2601,2590,21,11,"P-LIB",1
46,"46219",127,112,112,1,0,"P-LIB",0
3,"3072",348,289,285,0,4,"P-LIB",0
47,"47222",83,64,64,1,0,"P-LIB",0
39,"39038",1452,997,990,8,7,"P-LIB",2
46,"46250",578719,442973,440154,2541,2819,"P-LIB",189
47,"47197",876,673,668,8,5,"P-LIB",1
46,"46024",413,314,313,2,1,"P-LIB",0
28,"28010",9963,7745,7688,25,57,"P-LIB",3
20,"20032",8797,5672,5630,40,42,"P-LIB",2
39,"39086",358,256,253,0,3,"P-LIB",0
47,"47103",267,197,192,5,5,"P-LIB",0
46,"46034",1758,1390,1379,4,11,"P-LIB",0
46,"46904",792,610,603,8,7,"P-LIB",1
46,"46063",1756,1367,1345,15,22,"P-LIB",0
20,"20050",266,170,169,1,1,"P-LIB",0
28,"28006",78966,59065,58698,267,367,"P-LIB",19
3,"3042",1393,1010,996,7,14,"P-LIB",0
46,"46205",14313,10932,10834,51,98,"P-LIB",6
46,"46127",2692,2120,2091,18,29,"P-LIB",1
28,"28073",12549,8788,8701,54,87,"P-LIB",3
20,"20080",7910,5294,5260,49,34,"P-LIB",1
28,"28137",1664,1232,1220,7,12,"P-LIB",0
47,"47163",290,230,228,3,2,"P-LIB",0
28,"28015",18736,14221,14127,68,94,"P-LIB",7
46,"46051",8347,6355,6302,24,53,"P-LIB",3
39,"39021",487,381,376,2,5,"P-LIB",0
46,"46187",1306,1017,1000,0,17,"P-LIB",0
46,"46009",3121,2459,2427,8,32,"P-LIB",1
3,"3076",8467,6238,6157,30,81,"P-LIB",2
47,"47185",99,73,71,0,2,"P-LIB",0
39,"39031",1236,878,868,4,10,"P-LIB",0
47,"47116",416,341,339,0,2,"P-LIB",0
3,"3036",87,81,78,0,3,"P-LIB",0
39,"39013",511,402,399,4,3,"P-LIB",0
20,"20043",1739,1090,1088,9,2,"P-LIB",0
46,"46011",7609,5249,5191,26,58,"P-LIB",3
39,"39049",322,229,229,0,0,"P-LIB",0
28,"28104",14040,11151,11096,57,55,"P-LIB",2
47,"47210",382,282,274,3,8,"P-LIB",0
39,"39090",756,553,542,0,11,"P-LIB",2
46,"46167",364,266,264,0,2,"P-LIB",0
28,"28171",4239,2848,2820,19,28,"P-LIB",1
11,"11042",1186,868,858,7,10,"P-LIB",0
46,"46089",2132,1602,1574,9,28,"P-LIB",2
46,"46165",7129,5436,5388,25,48,"P-LIB",0
47,"47209",41,34,34,0,0,"P-LIB",0
3,"3112",628,511,507,2,4,"P-LIB",0
39,"39073",9837,7356,7298,31,58,"P-LIB",3
47,"47121",544,437,425,6,12,"P-LIB",0
3,"3029",245,185,183,1,2,"P-LIB",0
46,"46184",26505,20428,20223,115,205,"P-LIB",11
28,"28054",11257,8349,8273,55,76,"P-LIB",3
39,"39026",1750,1236,1224,11,12,"P-LIB",0
28,"28124",74,54,54,1,0,"P-LIB",0
11,"11035",13593,8375,8276,90,99,"P-LIB",9
20,"20040",15289,9444,9373,66,71,"P-LIB",9
28,"28019",1233,893,885,4,8,"P-LIB",0
46,"46236",972,818,809,2,9,"P-LIB",0
48,"48031",332,233,231,1,2,"PODEMOS/AHAL DUGU-IU-EQUO",28
20,"20029",4281,2813,2802,19,11,"PODEMOS/AHAL DUGU-IU-EQUO",737
48,"48038",1126,798,794,3,4,"PODEMOS/AHAL DUGU-IU-EQUO",188
48,"48902",19008,12566,12447,76,119,"PODEMOS/AHAL DUGU-IU-EQUO",4165
20,"20062",973,653,653,11,0,"PODEMOS/AHAL DUGU-IU-EQUO",124
1,"1003",1190,782,774,2,8,"PODEMOS/AHAL DUGU-IU-EQUO",197
48,"48008",606,424,414,6,10,"PODEMOS/AHAL DUGU-IU-EQUO",107
1,"1046",601,432,428,3,4,"PODEMOS/AHAL DUGU-IU-EQUO",123
1,"1021",473,310,309,0,1,"PODEMOS/AHAL DUGU-IU-EQUO",63
48,"48912",2308,1707,1679,14,28,"PODEMOS/AHAL DUGU-IU-EQUO",473
20,"20903",4330,2756,2734,28,22,"PODEMOS/AHAL DUGU-IU-EQUO",961
20,"20032",8797,5672,5630,40,42,"PODEMOS/AHAL DUGU-IU-EQUO",1337
48,"48069",12798,8679,8612,55,67,"PODEMOS/AHAL DUGU-IU-EQUO",2094
48,"48001",5838,3923,3898,28,25,"PODEMOS/AHAL DUGU-IU-EQUO",1063
48,"48915",362,227,226,0,1,"PODEMOS/AHAL DUGU-IU-EQUO",18
1,"1036",14955,10052,9959,55,93,"PODEMOS/AHAL DUGU-IU-EQUO",3266
48,"48043",4423,3118,3108,17,10,"PODEMOS/AHAL DUGU-IU-EQUO",886
20,"20081",7470,4856,4833,40,23,"PODEMOS/AHAL DUGU-IU-EQUO",1317
20,"20042",3228,1967,1958,27,9,"PODEMOS/AHAL DUGU-IU-EQUO",562
20,"20017",8559,5478,5435,24,43,"PODEMOS/AHAL DUGU-IU-EQUO",1245
20,"20043",1739,1090,1088,9,2,"PODEMOS/AHAL DUGU-IU-EQUO",174
20,"20073",4677,3014,2995,15,19,"PODEMOS/AHAL DUGU-IU-EQUO",868
1,"1017",849,571,565,5,6,"PODEMOS/AHAL DUGU-IU-EQUO",144
1,"1047",968,673,668,5,5,"PODEMOS/AHAL DUGU-IU-EQUO",186
1,"1032",517,361,354,1,7,"PODEMOS/AHAL DUGU-IU-EQUO",77
48,"48010",458,318,317,0,1,"PODEMOS/AHAL DUGU-IU-EQUO",70
1,"1055",838,538,527,8,11,"PODEMOS/AHAL DUGU-IU-EQUO",127
48,"48064",606,447,445,4,2,"PODEMOS/AHAL DUGU-IU-EQUO",94
20,"20901",1437,908,906,2,2,"PODEMOS/AHAL DUGU-IU-EQUO",290
48,"48911",380,276,272,1,4,"PODEMOS/AHAL DUGU-IU-EQUO",39
48,"48085",10338,7190,7153,39,37,"PODEMOS/AHAL DUGU-IU-EQUO",2402
48,"48062",302,237,236,4,1,"PODEMOS/AHAL DUGU-IU-EQUO",35
20,"20076",6990,4666,4648,29,18,"PODEMOS/AHAL DUGU-IU-EQUO",1129
20,"20058",755,529,525,3,4,"PODEMOS/AHAL DUGU-IU-EQUO",130
1,"1020",327,237,234,3,3,"PODEMOS/AHAL DUGU-IU-EQUO",63
48,"48092",836,618,613,5,5,"PODEMOS/AHAL DUGU-IU-EQUO",132
20,"20010",1499,992,986,9,6,"PODEMOS/AHAL DUGU-IU-EQUO",235
48,"48904",3511,2625,2600,22,25,"PODEMOS/AHAL DUGU-IU-EQUO",615
20,"20080",7910,5294,5260,49,34,"PODEMOS/AHAL DUGU-IU-EQUO",1626
1,"1043",2304,1552,1532,13,20,"PODEMOS/AHAL DUGU-IU-EQUO",418
48,"48045",5167,3809,3757,28,52,"PODEMOS/AHAL DUGU-IU-EQUO",1037
1,"1039",209,155,153,0,2,"PODEMOS/AHAL DUGU-IU-EQUO",44
48,"48909",209,161,161,0,0,"PODEMOS/AHAL DUGU-IU-EQUO",30
48,"48012",2049,1527,1512,7,15,"PODEMOS/AHAL DUGU-IU-EQUO",310
20,"20021",200,100,100,2,0,"PODEMOS/AHAL DUGU-IU-EQUO",22
1,"1028",1070,716,710,3,6,"PODEMOS/AHAL DUGU-IU-EQUO",187
48,"48078",38617,26366,26212,158,154,"PODEMOS/AHAL DUGU-IU-EQUO",8774
48,"48058",968,647,646,2,1,"PODEMOS/AHAL DUGU-IU-EQUO",129
1,"1031",1169,882,863,6,19,"PODEMOS/AHAL DUGU-IU-EQUO",202
20,"20016",1520,826,821,2,5,"PODEMOS/AHAL DUGU-IU-EQUO",206
20,"20054",447,286,284,2,2,"PODEMOS/AHAL DUGU-IU-EQUO",40
48,"48914",332,272,272,1,0,"PODEMOS/AHAL DUGU-IU-EQUO",42
48,"48005",115,63,61,0,2,"PODEMOS/AHAL DUGU-IU-EQUO",22
48,"48050",191,147,146,0,1,"PODEMOS/AHAL DUGU-IU-EQUO",19
48,"48035",413,293,292,1,1,"PODEMOS/AHAL DUGU-IU-EQUO",60
48,"48040",1281,877,869,3,8,"PODEMOS/AHAL DUGU-IU-EQUO",211
48,"48080",9976,6820,6763,62,57,"PODEMOS/AHAL DUGU-IU-EQUO",2431
1,"1018",1386,939,930,3,9,"PODEMOS/AHAL DUGU-IU-EQUO",289
48,"48037",673,481,478,5,3,"PODEMOS/AHAL DUGU-IU-EQUO",119
48,"48026",1140,830,823,5,7,"PODEMOS/AHAL DUGU-IU-EQUO",153
48,"48028",717,543,537,3,6,"PODEMOS/AHAL DUGU-IU-EQUO",57
20,"20906",119,87,87,1,0,"PODEMOS/AHAL DUGU-IU-EQUO",19
48,"48065",3281,2271,2237,8,34,"PODEMOS/AHAL DUGU-IU-EQUO",687
48,"48051",213,163,163,0,0,"PODEMOS/AHAL DUGU-IU-EQUO",45
1,"1041",149,103,100,1,3,"PODEMOS/AHAL DUGU-IU-EQUO",16
48,"48023",600,455,452,0,3,"PODEMOS/AHAL DUGU-IU-EQUO",83
48,"48072",977,716,713,4,3,"PODEMOS/AHAL DUGU-IU-EQUO",141
20,"20049",4122,2677,2666,15,11,"PODEMOS/AHAL DUGU-IU-EQUO",653
1,"1019",150,106,105,1,1,"PODEMOS/AHAL DUGU-IU-EQUO",10
20,"20902",14156,9664,9613,74,51,"PODEMOS/AHAL DUGU-IU-EQUO",2822
20,"20079",17886,11860,11799,91,61,"PODEMOS/AHAL DUGU-IU-EQUO",3135
20,"20024",386,210,209,3,1,"PODEMOS/AHAL DUGU-IU-EQUO",37
1,"1063",1798,1269,1261,19,8,"PODEMOS/AHAL DUGU-IU-EQUO",341
20,"20020",125,71,69,3,2,"PODEMOS/AHAL DUGU-IU-EQUO",10
1,"1901",2354,1592,1571,8,21,"PODEMOS/AHAL DUGU-IU-EQUO",535
1,"1061",154,127,127,1,0,"PODEMOS/AHAL DUGU-IU-EQUO",38
48,"48018",869,522,522,2,0,"PODEMOS/AHAL DUGU-IU-EQUO",82
20,"20031",176,90,90,0,0,"PODEMOS/AHAL DUGU-IU-EQUO",16
20,"20039",2111,1480,1472,14,8,"PODEMOS/AHAL DUGU-IU-EQUO",256
20,"20044",367,236,236,0,0,"PODEMOS/AHAL DUGU-IU-EQUO",62
20,"20045",46626,30525,30353,197,172,"PODEMOS/AHAL DUGU-IU-EQUO",10086
20,"20036",13210,8518,8475,67,43,"PODEMOS/AHAL DUGU-IU-EQUO",2678
1,"1051",3603,2259,2235,17,24,"PODEMOS/AHAL DUGU-IU-EQUO",745
48,"48015",33581,22727,22528,122,199,"PODEMOS/AHAL DUGU-IU-EQUO",7059
20,"20077",5213,3614,3591,36,23,"PODEMOS/AHAL DUGU-IU-EQUO",868
48,"48022",2336,1444,1433,6,11,"PODEMOS/AHAL DUGU-IU-EQUO",422
48,"48025",883,642,637,7,5,"PODEMOS/AHAL DUGU-IU-EQUO",120
20,"20057",196,122,122,0,0,"PODEMOS/AHAL DUGU-IU-EQUO",34
20,"20061",4273,2601,2590,21,11,"PODEMOS/AHAL DUGU-IU-EQUO",690
48,"48048",557,395,393,5,2,"PODEMOS/AHAL DUGU-IU-EQUO",79
20,"20078",1155,850,846,4,4,"PODEMOS/AHAL DUGU-IU-EQUO",126
48,"48074",3312,2330,2309,6,21,"PODEMOS/AHAL DUGU-IU-EQUO",609
1,"1002",8124,5722,5654,31,68,"PODEMOS/AHAL DUGU-IU-EQUO",1913
20,"20069",147046,100691,100232,836,459,"PODEMOS/AHAL DUGU-IU-EQUO",28354
20,"20011",1658,1219,1210,7,9,"PODEMOS/AHAL DUGU-IU-EQUO",264
48,"48016",5271,3694,3674,24,20,"PODEMOS/AHAL DUGU-IU-EQUO",1014
48,"48056",966,705,700,5,5,"PODEMOS/AHAL DUGU-IU-EQUO",188
1,"1059",186557,126506,125278,798,1228,"PODEMOS/AHAL DUGU-IU-EQUO",38903
20,"20008",716,362,361,6,1,"PODEMOS/AHAL DUGU-IU-EQUO",89
48,"48060",3634,2143,2134,7,9,"PODEMOS/AHAL DUGU-IU-EQUO",388
48,"48070",544,362,362,4,0,"PODEMOS/AHAL DUGU-IU-EQUO",32
20,"20050",266,170,169,1,1,"PODEMOS/AHAL DUGU-IU-EQUO",20
48,"48088",136,102,102,0,0,"PODEMOS/AHAL DUGU-IU-EQUO",18
48,"48071",6087,4294,4254,32,40,"PODEMOS/AHAL DUGU-IU-EQUO",1456
48,"48907",348,266,266,2,0,"PODEMOS/AHAL DUGU-IU-EQUO",43
48,"48024",995,757,754,7,3,"PODEMOS/AHAL DUGU-IU-EQUO",127
48,"48077",3364,2437,2431,18,6,"PODEMOS/AHAL DUGU-IU-EQUO",653
48,"48007",364,240,240,5,0,"PODEMOS/AHAL DUGU-IU-EQUO",25
48,"48057",5723,3988,3962,26,26,"PODEMOS/AHAL DUGU-IU-EQUO",717
20,"20053",4774,2973,2953,13,20,"PODEMOS/AHAL DUGU-IU-EQUO",1098
48,"48017",13261,8543,8482,42,61,"PODEMOS/AHAL DUGU-IU-EQUO",2070
48,"48908",249,181,181,0,0,"PODEMOS/AHAL DUGU-IU-EQUO",35
1,"1057",240,201,200,1,1,"PODEMOS/AHAL DUGU-IU-EQUO",39
48,"48014",1211,806,801,7,5,"PODEMOS/AHAL DUGU-IU-EQUO",233
20,"20065",3012,1985,1967,12,18,"PODEMOS/AHAL DUGU-IU-EQUO",452
20,"20013",5415,3602,3579,19,23,"PODEMOS/AHAL DUGU-IU-EQUO",1009
48,"48033",217,149,149,0,0,"PODEMOS/AHAL DUGU-IU-EQUO",29
20,"20006",259,143,143,3,0,"PODEMOS/AHAL DUGU-IU-EQUO",36
48,"48901",4839,3459,3426,32,33,"PODEMOS/AHAL DUGU-IU-EQUO",1049
48,"48061",762,565,561,0,4,"PODEMOS/AHAL DUGU-IU-EQUO",114
48,"48906",766,547,544,0,3,"PODEMOS/AHAL DUGU-IU-EQUO",95
20,"20015",1265,858,851,7,7,"PODEMOS/AHAL DUGU-IU-EQUO",127
20,"20003",547,308,308,3,0,"PODEMOS/AHAL DUGU-IU-EQUO",81
20,"20033",868,600,599,1,1,"PODEMOS/AHAL DUGU-IU-EQUO",148
48,"48076",308,218,217,2,1,"PODEMOS/AHAL DUGU-IU-EQUO",29
1,"1902",734,514,502,4,12,"PODEMOS/AHAL DUGU-IU-EQUO",146
20,"20014",1108,611,609,4,2,"PODEMOS/AHAL DUGU-IU-EQUO",155
48,"48086",2050,1414,1401,5,13,"PODEMOS/AHAL DUGU-IU-EQUO",501
20,"20025",1143,765,760,8,5,"PODEMOS/AHAL DUGU-IU-EQUO",139
48,"48075",1996,1364,1359,6,5,"PODEMOS/AHAL DUGU-IU-EQUO",362
20,"20067",30828,19984,19882,140,102,"PODEMOS/AHAL DUGU-IU-EQUO",7407
1,"1052",245,184,181,0,3,"PODEMOS/AHAL DUGU-IU-EQUO",32
1,"1016",433,228,226,5,2,"PODEMOS/AHAL DUGU-IU-EQUO",51
48,"48094",3161,2094,2073,12,21,"PODEMOS/AHAL DUGU-IU-EQUO",443
20,"20019",9986,6428,6392,48,36,"PODEMOS/AHAL DUGU-IU-EQUO",1740
48,"48910",2909,1950,1937,10,13,"PODEMOS/AHAL DUGU-IU-EQUO",464
20,"20030",21423,13960,13898,101,62,"PODEMOS/AHAL DUGU-IU-EQUO",3950
1,"1014",371,280,272,4,8,"PODEMOS/AHAL DUGU-IU-EQUO",64
48,"48089",3306,2341,2329,20,12,"PODEMOS/AHAL DUGU-IU-EQUO",733
1,"1056",219,136,135,0,1,"PODEMOS/AHAL DUGU-IU-EQUO",25
1,"1006",175,140,140,0,0,"PODEMOS/AHAL DUGU-IU-EQUO",48
20,"20072",4728,2902,2886,21,16,"PODEMOS/AHAL DUGU-IU-EQUO",933
48,"48905",2553,1792,1771,12,21,"PODEMOS/AHAL DUGU-IU-EQUO",408
1,"1060",197,160,157,0,3,"PODEMOS/AHAL DUGU-IU-EQUO",27
20,"20034",3145,2026,2014,14,12,"PODEMOS/AHAL DUGU-IU-EQUO",546
20,"20905",145,100,100,1,0,"PODEMOS/AHAL DUGU-IU-EQUO",16
48,"48073",6910,4306,4271,31,35,"PODEMOS/AHAL DUGU-IU-EQUO",857
48,"48032",5743,4065,4048,29,17,"PODEMOS/AHAL DUGU-IU-EQUO",898
20,"20023",441,252,251,1,1,"PODEMOS/AHAL DUGU-IU-EQUO",63
20,"20038",387,261,259,0,2,"PODEMOS/AHAL DUGU-IU-EQUO",40
48,"48021",1336,908,899,1,9,"PODEMOS/AHAL DUGU-IU-EQUO",191
48,"48047",159,111,111,0,0,"PODEMOS/AHAL DUGU-IU-EQUO",21
48,"48004",335,222,222,0,0,"PODEMOS/AHAL DUGU-IU-EQUO",22
1,"1054",960,654,651,4,3,"PODEMOS/AHAL DUGU-IU-EQUO",200
48,"48095",2347,1555,1546,12,9,"PODEMOS/AHAL DUGU-IU-EQUO",395
20,"20007",310,218,218,3,0,"PODEMOS/AHAL DUGU-IU-EQUO",50
1,"1037",587,411,408,1,3,"PODEMOS/AHAL DUGU-IU-EQUO",104
1,"1042",904,653,648,6,5,"PODEMOS/AHAL DUGU-IU-EQUO",197
20,"20022",839,473,472,4,1,"PODEMOS/AHAL DUGU-IU-EQUO",90
20,"20068",190,135,135,3,0,"PODEMOS/AHAL DUGU-IU-EQUO",30
1,"1034",161,124,123,1,1,"PODEMOS/AHAL DUGU-IU-EQUO",30
20,"20048",182,100,98,2,2,"PODEMOS/AHAL DUGU-IU-EQUO",31
48,"48030",606,441,439,1,2,"PODEMOS/AHAL DUGU-IU-EQUO",55
1,"1027",416,257,254,3,3,"PODEMOS/AHAL DUGU-IU-EQUO",73
20,"20907",118,85,85,2,0,"PODEMOS/AHAL DUGU-IU-EQUO",23
48,"48082",37605,25134,24938,176,196,"PODEMOS/AHAL DUGU-IU-EQUO",8819
48,"48052",1562,1160,1150,4,10,"PODEMOS/AHAL DUGU-IU-EQUO",209
20,"20026",197,145,133,0,12,"PODEMOS/AHAL DUGU-IU-EQUO",12
20,"20002",346,203,203,4,0,"PODEMOS/AHAL DUGU-IU-EQUO",51
20,"20046",1223,739,737,5,2,"PODEMOS/AHAL DUGU-IU-EQUO",204
1,"1011",235,174,171,4,3,"PODEMOS/AHAL DUGU-IU-EQUO",19
1,"1044",236,169,167,0,2,"PODEMOS/AHAL DUGU-IU-EQUO",49
48,"48046",12611,8836,8794,39,42,"PODEMOS/AHAL DUGU-IU-EQUO",2002
1,"1009",1265,849,845,2,4,"PODEMOS/AHAL DUGU-IU-EQUO",298
20,"20056",4082,2589,2570,27,19,"PODEMOS/AHAL DUGU-IU-EQUO",679
1,"1030",156,129,129,3,0,"PODEMOS/AHAL DUGU-IU-EQUO",26
48,"48097",1297,900,894,8,6,"PODEMOS/AHAL DUGU-IU-EQUO",280
20,"20904",95,44,44,2,0,"PODEMOS/AHAL DUGU-IU-EQUO",8
20,"20070",1092,748,746,5,2,"PODEMOS/AHAL DUGU-IU-EQUO",99
20,"20074",11592,7954,7914,45,40,"PODEMOS/AHAL DUGU-IU-EQUO",2157
20,"20009",11452,7388,7345,62,43,"PODEMOS/AHAL DUGU-IU-EQUO",2378
48,"48081",1868,1361,1350,4,11,"PODEMOS/AHAL DUGU-IU-EQUO",312
48,"48903",1835,1361,1351,7,10,"PODEMOS/AHAL DUGU-IU-EQUO",261
20,"20001",246,133,132,2,1,"PODEMOS/AHAL DUGU-IU-EQUO",15
20,"20004",252,121,121,0,0,"PODEMOS/AHAL DUGU-IU-EQUO",30
48,"48041",693,533,529,3,4,"PODEMOS/AHAL DUGU-IU-EQUO",99
48,"48020",273626,184710,183628,1185,1082,"PODEMOS/AHAL DUGU-IU-EQUO",50083
48,"48093",893,653,643,7,10,"PODEMOS/AHAL DUGU-IU-EQUO",112
48,"48090",6001,4345,4295,28,50,"PODEMOS/AHAL DUGU-IU-EQUO",1246
20,"20037",99,64,64,2,0,"PODEMOS/AHAL DUGU-IU-EQUO",7
20,"20041",255,123,123,0,0,"PODEMOS/AHAL DUGU-IU-EQUO",35
20,"20075",4371,2692,2679,18,13,"PODEMOS/AHAL DUGU-IU-EQUO",681
20,"20035",486,337,334,1,3,"PODEMOS/AHAL DUGU-IU-EQUO",69
20,"20047",469,307,304,5,3,"PODEMOS/AHAL DUGU-IU-EQUO",54
48,"48059",400,294,291,0,3,"PODEMOS/AHAL DUGU-IU-EQUO",41
48,"48091",1121,771,765,7,6,"PODEMOS/AHAL DUGU-IU-EQUO",181
48,"48068",1550,1130,1118,12,12,"PODEMOS/AHAL DUGU-IU-EQUO",222
1,"1049",138,109,109,1,0,"PODEMOS/AHAL DUGU-IU-EQUO",34
1,"1033",651,484,479,2,5,"PODEMOS/AHAL DUGU-IU-EQUO",82
48,"48913",1248,884,869,10,15,"PODEMOS/AHAL DUGU-IU-EQUO",298
48,"48013",79716,53419,52997,345,422,"PODEMOS/AHAL DUGU-IU-EQUO",18849
20,"20071",14801,9466,9421,60,45,"PODEMOS/AHAL DUGU-IU-EQUO",2568
20,"20055",17475,11073,10997,56,76,"PODEMOS/AHAL DUGU-IU-EQUO",3161
20,"20063",8017,5263,5231,35,32,"PODEMOS/AHAL DUGU-IU-EQUO",1472
1,"1013",712,454,450,0,4,"PODEMOS/AHAL DUGU-IU-EQUO",149
48,"48055",2668,1872,1849,11,23,"PODEMOS/AHAL DUGU-IU-EQUO",446
48,"48029",8338,5721,5683,37,38,"PODEMOS/AHAL DUGU-IU-EQUO",2230
20,"20005",1260,738,736,11,2,"PODEMOS/AHAL DUGU-IU-EQUO",154
48,"48034",12866,8798,8747,43,51,"PODEMOS/AHAL DUGU-IU-EQUO",2726
1,"1008",786,513,509,11,4,"PODEMOS/AHAL DUGU-IU-EQUO",120
48,"48087",427,344,338,0,6,"PODEMOS/AHAL DUGU-IU-EQUO",71
48,"48084",22449,14670,14553,90,117,"PODEMOS/AHAL DUGU-IU-EQUO",5274
48,"48049",549,416,416,1,0,"PODEMOS/AHAL DUGU-IU-EQUO",87
48,"48002",7829,5490,5451,44,39,"PODEMOS/AHAL DUGU-IU-EQUO",2254
48,"48066",348,258,258,1,0,"PODEMOS/AHAL DUGU-IU-EQUO",32
20,"20064",12503,7803,7755,52,48,"PODEMOS/AHAL DUGU-IU-EQUO",2697
48,"48083",6958,4885,4856,40,29,"PODEMOS/AHAL DUGU-IU-EQUO",2106
1,"1001",1979,1339,1318,7,21,"PODEMOS/AHAL DUGU-IU-EQUO",466
48,"48009",783,586,575,1,11,"PODEMOS/AHAL DUGU-IU-EQUO",107
48,"48044",62774,45594,45399,287,195,"PODEMOS/AHAL DUGU-IU-EQUO",9408
48,"48011",9673,6468,6423,45,45,"PODEMOS/AHAL DUGU-IU-EQUO",2244
1,"1062",313,211,210,2,1,"PODEMOS/AHAL DUGU-IU-EQUO",54
48,"48054",24171,16797,16711,118,86,"PODEMOS/AHAL DUGU-IU-EQUO",5135
48,"48027",22150,15089,14982,78,107,"PODEMOS/AHAL DUGU-IU-EQUO",4084
48,"48063",372,279,277,2,2,"PODEMOS/AHAL DUGU-IU-EQUO",60
48,"48019",3553,2406,2397,18,9,"PODEMOS/AHAL DUGU-IU-EQUO",681
48,"48006",290,239,239,2,0,"PODEMOS/AHAL DUGU-IU-EQUO",47
48,"48042",1369,1068,1053,7,15,"PODEMOS/AHAL DUGU-IU-EQUO",259
20,"20040",15289,9444,9373,66,71,"PODEMOS/AHAL DUGU-IU-EQUO",2866
20,"20012",147,99,98,5,1,"PODEMOS/AHAL DUGU-IU-EQUO",9
48,"48067",1158,813,810,2,3,"PODEMOS/AHAL DUGU-IU-EQUO",164
48,"48053",895,666,662,6,4,"PODEMOS/AHAL DUGU-IU-EQUO",76
20,"20027",2814,1761,1750,15,11,"PODEMOS/AHAL DUGU-IU-EQUO",401
1,"1004",1399,1008,995,8,13,"PODEMOS/AHAL DUGU-IU-EQUO",296
1,"1010",2268,1623,1603,11,20,"PODEMOS/AHAL DUGU-IU-EQUO",537
20,"20066",454,236,234,1,2,"PODEMOS/AHAL DUGU-IU-EQUO",14
1,"1022",799,557,544,2,13,"PODEMOS/AHAL DUGU-IU-EQUO",114
20,"20028",2237,1373,1365,11,8,"PODEMOS/AHAL DUGU-IU-EQUO",344
48,"48036",24073,16076,15971,86,105,"PODEMOS/AHAL DUGU-IU-EQUO",5043
1,"1058",1345,799,793,7,6,"PODEMOS/AHAL DUGU-IU-EQUO",286
20,"20060",88,67,67,2,0,"PODEMOS/AHAL DUGU-IU-EQUO",0
20,"20052",1090,779,776,8,3,"PODEMOS/AHAL DUGU-IU-EQUO",220
48,"48039",239,190,188,0,2,"PODEMOS/AHAL DUGU-IU-EQUO",21
1,"1023",267,187,186,1,1,"PODEMOS/AHAL DUGU-IU-EQUO",37
20,"20059",8874,5873,5855,29,18,"PODEMOS/AHAL DUGU-IU-EQUO",1296
20,"20051",6877,4699,4679,34,20,"PODEMOS/AHAL DUGU-IU-EQUO",1340
20,"20018",11064,6719,6690,41,29,"PODEMOS/AHAL DUGU-IU-EQUO",1116
48,"48096",6577,4794,4728,31,66,"PODEMOS/AHAL DUGU-IU-EQUO",1492
48,"48079",427,305,304,2,1,"PODEMOS/AHAL DUGU-IU-EQUO",54
48,"48003",14339,9918,9838,53,80,"PODEMOS/AHAL DUGU-IU-EQUO",2696
1,"1053",582,321,320,4,1,"PODEMOS/AHAL DUGU-IU-EQUO",97
3,"3057",182,147,147,1,0,"PODEMOS-COM",41
46,"46117",495,402,399,5,3,"PODEMOS-COM",105
12,"12064",91,82,81,2,1,"PODEMOS-COM",21
12,"12111",360,305,299,3,6,"PODEMOS-COM",67
12,"12115",219,179,177,0,2,"PODEMOS-COM",18
46,"46204",6681,5256,5202,32,54,"PODEMOS-COM",1329
46,"46904",792,610,603,8,7,"PODEMOS-COM",207
12,"12125",216,180,177,0,3,"PODEMOS-COM",33
12,"12055",104,83,82,3,1,"PODEMOS-COM",32
12,"12039",833,717,710,4,7,"PODEMOS-COM",101
46,"46036",564,383,378,5,5,"PODEMOS-COM",74
46,"46126",5556,4449,4405,24,44,"PODEMOS-COM",1370
3,"3102",7229,5492,5414,52,78,"PODEMOS-COM",1832
46,"46111",10930,7931,7828,44,103,"PODEMOS-COM",2138
12,"12027",17283,12015,11888,89,127,"PODEMOS-COM",3053
46,"46119",780,653,647,5,6,"PODEMOS-COM",204
12,"12074",785,652,648,5,4,"PODEMOS-COM",87
12,"12076",84,69,69,0,0,"PODEMOS-COM",11
3,"3026",1224,949,936,5,13,"PODEMOS-COM",304
46,"46080",998,803,799,7,4,"PODEMOS-COM",187
3,"3070",2051,1455,1437,7,18,"PODEMOS-COM",240
46,"46013",17383,13569,13483,82,86,"PODEMOS-COM",3834
3,"3092",6743,5254,5178,37,76,"PODEMOS-COM",1821
12,"12102",522,423,418,1,5,"PODEMOS-COM",57
46,"46246",1058,835,823,5,12,"PODEMOS-COM",131
46,"46090",1637,1391,1367,3,24,"PODEMOS-COM",354
46,"46255",3174,2448,2424,22,24,"PODEMOS-COM",721
46,"46012",896,682,663,1,19,"PODEMOS-COM",154
3,"3045",210,176,172,0,4,"PODEMOS-COM",17
46,"46172",5042,3504,3477,22,27,"PODEMOS-COM",1015
46,"46245",511,420,415,0,5,"PODEMOS-COM",120
12,"12128",1393,1090,1072,10,18,"PODEMOS-COM",302
3,"3061",1056,776,768,4,8,"PODEMOS-COM",94
46,"46099",901,689,684,1,5,"PODEMOS-COM",143
12,"12139",318,237,233,0,4,"PODEMOS-COM",78
12,"12070",522,406,401,0,5,"PODEMOS-COM",73
46,"46215",1436,1154,1143,5,11,"PODEMOS-COM",555
46,"46221",352,305,304,0,1,"PODEMOS-COM",79
46,"46039",2130,1728,1699,8,29,"PODEMOS-COM",390
46,"46197",1942,1527,1514,5,13,"PODEMOS-COM",665
3,"3088",5498,4041,3989,29,52,"PODEMOS-COM",840
3,"3040",254,216,213,2,3,"PODEMOS-COM",69
12,"12041",100,81,81,0,0,"PODEMOS-COM",6
46,"46220",48410,34644,34292,279,352,"PODEMOS-COM",12175
3,"3034",1376,1067,1052,5,15,"PODEMOS-COM",188
46,"46263",251,214,212,0,2,"PODEMOS-COM",46
46,"46136",2537,1952,1930,11,22,"PODEMOS-COM",544
12,"12124",1840,1387,1381,33,6,"PODEMOS-COM",200
12,"12011",4565,3331,3283,20,48,"PODEMOS-COM",884
12,"12025",136,104,104,0,0,"PODEMOS-COM",24
46,"46116",13159,10193,10135,53,58,"PODEMOS-COM",2690
46,"46146",1654,1304,1278,7,26,"PODEMOS-COM",410
46,"46169",32247,24214,24053,154,161,"PODEMOS-COM",6830
46,"46194",15567,11156,11044,86,112,"PODEMOS-COM",2957
46,"46145",21990,16337,16187,93,150,"PODEMOS-COM",4834
3,"3024",3901,3067,3024,11,43,"PODEMOS-COM",333
46,"46088",166,125,125,4,0,"PODEMOS-COM",40
12,"12065",188,169,169,2,0,"PODEMOS-COM",15
12,"12114",198,144,144,1,0,"PODEMOS-COM",34
12,"12099",539,416,403,7,13,"PODEMOS-COM",75
12,"12134",141,95,94,0,1,"PODEMOS-COM",29
12,"12045",345,268,259,1,9,"PODEMOS-COM",62
12,"12012",2685,2234,2202,13,32,"PODEMOS-COM",516
46,"46171",16563,12213,12128,85,85,"PODEMOS-COM",3484
12,"12136",2635,2201,2171,18,30,"PODEMOS-COM",227
3,"3134",143,112,111,0,1,"PODEMOS-COM",30
46,"46240",210,164,161,1,3,"PODEMOS-COM",37
46,"46032",5653,4402,4361,33,41,"PODEMOS-COM",1345
3,"3037",346,282,278,3,4,"PODEMOS-COM",83
3,"3121",21273,14569,14468,62,101,"PODEMOS-COM",3197
46,"46064",509,412,399,1,13,"PODEMOS-COM",118
3,"3006",497,384,380,1,4,"PODEMOS-COM",150
12,"12080",1932,1598,1570,10,28,"PODEMOS-COM",265
12,"12097",63,49,49,0,0,"PODEMOS-COM",13
12,"12022",344,265,262,2,3,"PODEMOS-COM",65
3,"3018",12240,8853,8777,47,76,"PODEMOS-COM",2214
12,"12029",702,557,555,4,2,"PODEMOS-COM",176
12,"12053",2034,1655,1633,6,22,"PODEMOS-COM",348
46,"46021",23649,17291,17153,100,138,"PODEMOS-COM",4715
46,"46004",1922,1565,1547,11,18,"PODEMOS-COM",482
3,"3904",1396,1033,1026,4,7,"PODEMOS-COM",173
46,"46038",327,242,242,3,0,"PODEMOS-COM",69
3,"3075",147,128,128,0,0,"PODEMOS-COM",26
46,"46186",19068,14599,14474,69,125,"PODEMOS-COM",4012
46,"46060",9369,7052,6993,42,59,"PODEMOS-COM",1793
3,"3058",4951,3897,3851,30,46,"PODEMOS-COM",475
3,"3093",19683,14633,14484,70,149,"PODEMOS-COM",3261
46,"46073",1092,888,884,6,4,"PODEMOS-COM",223
46,"46256",6853,4951,4890,25,61,"PODEMOS-COM",1303
3,"3007",166,139,137,0,2,"PODEMOS-COM",56
46,"46227",905,711,702,1,9,"PODEMOS-COM",251
46,"46081",10134,7771,7702,41,69,"PODEMOS-COM",2076
46,"46110",21228,15563,15443,86,120,"PODEMOS-COM",4354
3,"3117",362,318,313,2,5,"PODEMOS-COM",88
46,"46235",21579,15929,15763,113,166,"PODEMOS-COM",5660
3,"3050",18652,13325,13234,57,91,"PODEMOS-COM",3142
3,"3042",1393,1010,996,7,14,"PODEMOS-COM",223
46,"46150",1831,1341,1333,7,8,"PODEMOS-COM",274
46,"46020",3760,2916,2866,22,50,"PODEMOS-COM",780
3,"3119",16636,12281,12194,57,87,"PODEMOS-COM",2732
46,"46083",15422,11179,11049,86,130,"PODEMOS-COM",3334
46,"46041",329,253,252,5,1,"PODEMOS-COM",84
12,"12105",848,644,638,2,6,"PODEMOS-COM",74
3,"3130",48,25,25,0,0,"PODEMOS-COM",7
3,"3081",1436,1084,1075,5,9,"PODEMOS-COM",344
3,"3100",503,440,437,0,3,"PODEMOS-COM",167
46,"46107",1900,1516,1504,5,12,"PODEMOS-COM",373
12,"12004",4170,3125,3088,19,37,"PODEMOS-COM",742
46,"46254",1000,785,779,6,6,"PODEMOS-COM",128
46,"46232",895,711,696,5,15,"PODEMOS-COM",94
46,"46247",1006,714,710,3,4,"PODEMOS-COM",160
3,"3041",5954,4218,4194,22,24,"PODEMOS-COM",1159
46,"46142",787,619,602,1,17,"PODEMOS-COM",108
12,"12005",8062,5829,5754,64,75,"PODEMOS-COM",1451
3,"3068",47,44,44,0,0,"PODEMOS-COM",3
12,"12073",152,119,117,0,2,"PODEMOS-COM",21
3,"3099",42319,31083,30801,165,282,"PODEMOS-COM",4328
3,"3113",4243,3091,3046,10,45,"PODEMOS-COM",475
12,"12014",184,144,143,2,1,"PODEMOS-COM",31
12,"12084",17615,12766,12644,105,122,"PODEMOS-COM",2576
12,"12103",91,69,67,0,2,"PODEMOS-COM",5
46,"46065",1579,1174,1163,8,11,"PODEMOS-COM",408
46,"46248",4897,3596,3544,18,52,"PODEMOS-COM",815
46,"46162",1189,938,929,3,9,"PODEMOS-COM",163
46,"46250",578719,442973,440154,2541,2819,"PODEMOS-COM",119236
46,"46132",2150,1803,1784,7,19,"PODEMOS-COM",461
46,"46249",9288,6746,6676,56,70,"PODEMOS-COM",1233
12,"12077",4605,3439,3382,15,57,"PODEMOS-COM",860
46,"46143",4239,3104,3053,14,51,"PODEMOS-COM",911
46,"46175",456,389,387,3,2,"PODEMOS-COM",136
3,"3078",478,389,389,5,0,"PODEMOS-COM",46
12,"12028",12586,9733,9676,62,57,"PODEMOS-COM",2258
46,"46188",672,544,537,8,7,"PODEMOS-COM",183
12,"12135",35719,26016,25793,196,223,"PODEMOS-COM",6454
3,"3022",145,125,125,0,0,"PODEMOS-COM",43
3,"3016",93,75,75,0,0,"PODEMOS-COM",15
12,"12140",1143,939,930,6,9,"PODEMOS-COM",222
46,"46003",950,791,769,1,22,"PODEMOS-COM",201
46,"46009",3121,2459,2427,8,32,"PODEMOS-COM",694
46,"46138",343,275,272,1,3,"PODEMOS-COM",58
46,"46006",4523,3665,3623,20,42,"PODEMOS-COM",971
46,"46214",15766,12131,12036,42,95,"PODEMOS-COM",3271
46,"46067",1753,1418,1393,1,25,"PODEMOS-COM",316
46,"46075",150,130,123,1,7,"PODEMOS-COM",26
46,"46262",223,162,159,2,3,"PODEMOS-COM",32
12,"12038",167,120,118,2,2,"PODEMOS-COM",8
3,"3020",99,79,79,0,0,"PODEMOS-COM",14
46,"46058",1772,1398,1373,15,25,"PODEMOS-COM",340
46,"46114",569,461,458,1,3,"PODEMOS-COM",74
12,"12057",606,487,474,5,13,"PODEMOS-COM",111
3,"3014",237287,167428,166445,847,983,"PODEMOS-COM",36190
3,"3054",343,277,275,3,2,"PODEMOS-COM",62
3,"3015",12566,9257,9177,39,80,"PODEMOS-COM",1560
12,"12093",178,137,136,2,1,"PODEMOS-COM",37
3,"3047",9207,6309,6226,25,83,"PODEMOS-COM",1472
3,"3005",7769,5917,5866,19,51,"PODEMOS-COM",843
12,"12018",287,246,242,1,4,"PODEMOS-COM",44
12,"12037",17,16,14,0,2,"PODEMOS-COM",3
46,"46261",1725,1356,1337,5,19,"PODEMOS-COM",329
3,"3065",167284,123032,122305,711,727,"PODEMOS-COM",24661
3,"3071",3982,3048,3012,26,36,"PODEMOS-COM",906
3,"3043",2911,2431,2399,13,32,"PODEMOS-COM",623
46,"46216",5053,4109,4090,14,19,"PODEMOS-COM",984
46,"46130",901,687,683,3,4,"PODEMOS-COM",218
3,"3110",291,241,241,1,0,"PODEMOS-COM",92
46,"46010",935,729,723,4,6,"PODEMOS-COM",253
46,"46201",64,52,51,1,1,"PODEMOS-COM",8
46,"46023",327,280,278,2,2,"PODEMOS-COM",92
46,"46223",7801,5950,5899,34,51,"PODEMOS-COM",1503
12,"12131",63,52,52,0,0,"PODEMOS-COM",3
12,"12104",6933,5411,5342,25,69,"PODEMOS-COM",1157
3,"3095",4579,3489,3459,25,30,"PODEMOS-COM",1164
3,"3098",505,393,386,0,7,"PODEMOS-COM",108
12,"12010",259,213,208,2,5,"PODEMOS-COM",35
12,"12048",251,185,182,0,3,"PODEMOS-COM",26
46,"46043",136,124,124,0,0,"PODEMOS-COM",28
3,"3077",1371,1071,1060,13,11,"PODEMOS-COM",173
3,"3080",1300,1035,1025,3,10,"PODEMOS-COM",110
46,"46218",1060,910,885,7,25,"PODEMOS-COM",243
46,"46168",1938,1495,1486,2,9,"PODEMOS-COM",427
46,"46195",1962,1531,1516,11,15,"PODEMOS-COM",413
12,"12036",581,426,421,10,5,"PODEMOS-COM",56
46,"46174",972,764,752,2,12,"PODEMOS-COM",185
46,"46151",728,550,541,0,9,"PODEMOS-COM",185
12,"12069",66,49,48,0,1,"PODEMOS-COM",8
46,"46238",13282,9786,9721,61,65,"PODEMOS-COM",3604
46,"46212",1620,1150,1124,9,26,"PODEMOS-COM",370
12,"12094",847,674,665,5,9,"PODEMOS-COM",246
12,"12026",881,678,663,13,15,"PODEMOS-COM",103
12,"12087",25,18,18,4,0,"PODEMOS-COM",0
12,"12091",177,113,112,0,1,"PODEMOS-COM",11
3,"3010",325,277,275,1,2,"PODEMOS-COM",94
12,"12050",1305,1015,1000,6,15,"PODEMOS-COM",223
46,"46152",96,68,68,0,0,"PODEMOS-COM",13
46,"46028",387,330,328,3,2,"PODEMOS-COM",95
46,"46002",1175,941,932,5,9,"PODEMOS-COM",341
46,"46019",8849,7072,7004,33,68,"PODEMOS-COM",1815
46,"46112",536,455,450,2,5,"PODEMOS-COM",92
12,"12089",4328,3078,3020,15,58,"PODEMOS-COM",693
12,"12056",282,236,231,1,5,"PODEMOS-COM",79
46,"46187",1306,1017,1000,0,17,"PODEMOS-COM",287
46,"46086",82,70,69,1,1,"PODEMOS-COM",36
3,"3094",9080,6440,6396,34,44,"PODEMOS-COM",1544
12,"12100",1333,1065,1047,10,18,"PODEMOS-COM",193
12,"12033",1919,1437,1404,19,33,"PODEMOS-COM",299
46,"46049",281,232,224,0,8,"PODEMOS-COM",38
12,"12044",468,419,412,3,7,"PODEMOS-COM",72
46,"46902",364,306,303,0,3,"PODEMOS-COM",68
12,"12117",3585,2727,2677,20,50,"PODEMOS-COM",688
3,"3109",2850,2181,2164,8,17,"PODEMOS-COM",265
3,"3060",109,91,91,0,0,"PODEMOS-COM",36
3,"3901",1135,822,817,8,5,"PODEMOS-COM",262
12,"12040",117608,85588,84946,496,642,"PODEMOS-COM",21579
12,"12902",2158,1504,1489,14,15,"PODEMOS-COM",311
3,"3013",1113,839,836,4,3,"PODEMOS-COM",141
46,"46253",115,82,82,0,0,"PODEMOS-COM",24
46,"46157",2980,2321,2298,10,23,"PODEMOS-COM",540
46,"46131",49431,36570,36227,231,343,"PODEMOS-COM",9091
46,"46251",2462,1997,1956,6,41,"PODEMOS-COM",552
46,"46183",5993,4443,4381,19,62,"PODEMOS-COM",1099
46,"46177",4690,3579,3526,19,53,"PODEMOS-COM",1113
3,"3902",10254,6996,6930,34,66,"PODEMOS-COM",809
46,"46122",2704,2082,2063,10,19,"PODEMOS-COM",603
46,"46056",182,167,166,1,1,"PODEMOS-COM",54
3,"3135",211,170,166,2,4,"PODEMOS-COM",55
12,"12008",222,193,192,1,1,"PODEMOS-COM",48
12,"12118",72,55,53,0,2,"PODEMOS-COM",11
3,"3124",460,388,384,3,4,"PODEMOS-COM",150
46,"46108",469,378,375,1,3,"PODEMOS-COM",44
3,"3103",272,235,234,1,1,"PODEMOS-COM",69
3,"3128",4092,2861,2840,10,21,"PODEMOS-COM",662
46,"46198",839,684,674,4,10,"PODEMOS-COM",292
12,"12108",456,378,371,2,7,"PODEMOS-COM",70
3,"3028",998,818,812,2,6,"PODEMOS-COM",221
3,"3008",168,130,129,0,1,"PODEMOS-COM",15
46,"46022",15365,11093,10997,59,96,"PODEMOS-COM",2997
46,"46213",15409,10924,10805,97,119,"PODEMOS-COM",1977
3,"3139",22437,15315,15170,100,145,"PODEMOS-COM",3640
3,"3903",2494,1880,1865,7,15,"PODEMOS-COM",253
3,"3072",348,289,285,0,4,"PODEMOS-COM",97
46,"46057",487,321,317,1,4,"PODEMOS-COM",69
46,"46077",7496,5909,5827,45,82,"PODEMOS-COM",2578
12,"12009",17445,12088,11999,75,89,"PODEMOS-COM",2701
46,"46040",1078,888,878,7,10,"PODEMOS-COM",267
46,"46121",105,95,94,0,1,"PODEMOS-COM",15
3,"3101",4808,3627,3580,22,47,"PODEMOS-COM",1411
12,"12007",746,651,636,3,15,"PODEMOS-COM",201
46,"46017",32949,23913,23685,142,228,"PODEMOS-COM",6531
46,"46179",2165,1760,1737,16,23,"PODEMOS-COM",418
12,"12137",36,23,23,0,0,"PODEMOS-COM",4
3,"3105",5373,3911,3828,15,83,"PODEMOS-COM",601
12,"12052",578,452,435,3,17,"PODEMOS-COM",58
3,"3116",1155,877,875,6,2,"PODEMOS-COM",216
12,"12060",446,368,364,4,4,"PODEMOS-COM",93
3,"3140",26070,18999,18742,174,257,"PODEMOS-COM",4246
46,"46259",491,396,393,4,3,"PODEMOS-COM",77
46,"46185",378,320,313,2,7,"PODEMOS-COM",182
46,"46208",1112,887,881,4,6,"PODEMOS-COM",260
12,"12090",102,86,85,1,1,"PODEMOS-COM",11
46,"46069",162,124,123,0,1,"PODEMOS-COM",20
46,"46093",2118,1647,1624,4,23,"PODEMOS-COM",374
46,"46096",274,209,209,1,0,"PODEMOS-COM",57
3,"3048",4847,3719,3683,20,36,"PODEMOS-COM",796
3,"3096",5786,4358,4289,17,69,"PODEMOS-COM",1115
3,"3138",3145,2310,2275,9,35,"PODEMOS-COM",534
3,"3106",583,480,478,2,2,"PODEMOS-COM",107
46,"46209",1933,1445,1415,5,30,"PODEMOS-COM",354
12,"12121",1107,924,893,4,31,"PODEMOS-COM",124
46,"46903",6065,4790,4763,18,27,"PODEMOS-COM",1064
46,"46033",191,156,155,0,1,"PODEMOS-COM",28
46,"46059",1261,1035,1019,9,16,"PODEMOS-COM",482
46,"46252",118,99,98,0,1,"PODEMOS-COM",6
46,"46106",1535,1150,1140,10,10,"PODEMOS-COM",253
12,"12002",110,99,98,1,1,"PODEMOS-COM",45
3,"3055",5164,3695,3647,21,48,"PODEMOS-COM",491
12,"12142",158,117,117,1,0,"PODEMOS-COM",4
46,"46258",2652,2084,2062,16,22,"PODEMOS-COM",521
46,"46097",963,733,728,4,5,"PODEMOS-COM",133
46,"46190",48947,35638,35419,211,219,"PODEMOS-COM",10030
46,"46054",11293,8477,8409,47,68,"PODEMOS-COM",2454
3,"3052",970,769,755,8,14,"PODEMOS-COM",111
46,"46196",147,125,125,1,0,"PODEMOS-COM",14
3,"3053",7226,5651,5584,32,67,"PODEMOS-COM",1316
46,"46092",276,192,189,0,3,"PODEMOS-COM",40
46,"46153",439,355,351,1,4,"PODEMOS-COM",117
46,"46101",860,716,705,3,11,"PODEMOS-COM",215
46,"46078",28017,20288,20143,132,145,"PODEMOS-COM",6123
12,"12130",404,340,335,0,5,"PODEMOS-COM",30
3,"3067",99,85,85,0,0,"PODEMOS-COM",17
3,"3063",26462,18591,18492,91,99,"PODEMOS-COM",5187
46,"46124",787,653,642,4,11,"PODEMOS-COM",192
46,"46052",499,421,417,2,4,"PODEMOS-COM",93
46,"46095",610,467,459,1,8,"PODEMOS-COM",64
12,"12082",9617,7324,7231,46,93,"PODEMOS-COM",1439
12,"12901",3405,2626,2598,23,28,"PODEMOS-COM",546
46,"46159",22857,16840,16697,128,143,"PODEMOS-COM",4887
46,"46035",6822,5202,5142,43,60,"PODEMOS-COM",1482
46,"46244",58771,42137,41867,270,270,"PODEMOS-COM",9777
12,"12120",177,152,152,0,0,"PODEMOS-COM",17
46,"46125",847,689,684,5,5,"PODEMOS-COM",205
46,"46044",4218,3222,3158,18,64,"PODEMOS-COM",641
46,"46047",532,446,437,2,9,"PODEMOS-COM",114
46,"46030",800,627,614,5,13,"PODEMOS-COM",168
12,"12061",373,285,282,3,3,"PODEMOS-COM",57
3,"3114",1562,1198,1188,9,10,"PODEMOS-COM",193
3,"3089",9571,6775,6639,47,136,"PODEMOS-COM",1445
46,"46082",4918,3745,3712,33,33,"PODEMOS-COM",1128
46,"46128",1597,1290,1250,5,40,"PODEMOS-COM",331
12,"12138",19061,13010,12847,129,163,"PODEMOS-COM",4067
46,"46050",194,150,149,0,1,"PODEMOS-COM",41
46,"46034",1758,1390,1379,4,11,"PODEMOS-COM",448
46,"46091",118,94,94,0,0,"PODEMOS-COM",15
3,"3017",374,314,307,1,7,"PODEMOS-COM",136
46,"46100",286,232,230,1,2,"PODEMOS-COM",62
46,"46048",3452,2749,2713,14,36,"PODEMOS-COM",948
12,"12122",796,637,627,0,10,"PODEMOS-COM",84
3,"3079",18224,13904,13709,80,195,"PODEMOS-COM",3253
46,"46005",22918,16958,16827,102,131,"PODEMOS-COM",4909
46,"46207",6676,5106,5040,41,66,"PODEMOS-COM",1383
12,"12043",570,449,442,2,7,"PODEMOS-COM",97
3,"3118",2437,1659,1642,4,17,"PODEMOS-COM",276
12,"12021",4436,3381,3332,27,49,"PODEMOS-COM",911
3,"3062",212,169,165,0,4,"PODEMOS-COM",38
3,"3033",117,96,95,0,1,"PODEMOS-COM",27
46,"46014",3030,2383,2350,20,33,"PODEMOS-COM",661
3,"3123",7476,5557,5501,29,56,"PODEMOS-COM",1107
46,"46205",14313,10932,10834,51,98,"PODEMOS-COM",2771
12,"12113",83,67,66,3,1,"PODEMOS-COM",12
46,"46084",1576,1263,1242,5,21,"PODEMOS-COM",327
46,"46098",2482,1907,1889,11,18,"PODEMOS-COM",688
12,"12059",231,189,188,2,1,"PODEMOS-COM",51
46,"46046",892,675,668,1,7,"PODEMOS-COM",214
3,"3056",8676,6638,6541,34,97,"PODEMOS-COM",1851
12,"12133",59,53,52,0,1,"PODEMOS-COM",5
46,"46163",1866,1504,1480,8,24,"PODEMOS-COM",472
46,"46226",41,36,35,0,1,"PODEMOS-COM",9
46,"46087",120,98,97,0,1,"PODEMOS-COM",23
12,"12031",3807,2941,2894,24,47,"PODEMOS-COM",861
3,"3120",2406,1753,1720,11,33,"PODEMOS-COM",319
46,"46189",467,393,390,2,3,"PODEMOS-COM",135
3,"3011",7753,5464,5415,27,49,"PODEMOS-COM",1124
46,"46076",575,454,443,0,11,"PODEMOS-COM",112
46,"46079",318,241,232,1,9,"PODEMOS-COM",33
46,"46024",413,314,313,2,1,"PODEMOS-COM",36
3,"3051",348,296,294,0,2,"PODEMOS-COM",68
46,"46140",344,284,279,0,5,"PODEMOS-COM",89
46,"46001",795,601,592,3,9,"PODEMOS-COM",107
46,"46066",1263,1024,1018,9,6,"PODEMOS-COM",261
3,"3137",651,492,489,5,3,"PODEMOS-COM",182
3,"3030",524,448,440,5,8,"PODEMOS-COM",128
12,"12088",62,59,59,0,0,"PODEMOS-COM",12
12,"12129",1828,1322,1298,11,24,"PODEMOS-COM",407
46,"46178",4637,3405,3381,27,24,"PODEMOS-COM",930
12,"12032",23525,17093,16966,104,127,"PODEMOS-COM",3671
46,"46239",442,340,338,3,2,"PODEMOS-COM",42
12,"12078",325,235,233,0,2,"PODEMOS-COM",47
46,"46025",2499,1953,1934,8,19,"PODEMOS-COM",557
12,"12126",24464,18533,18331,113,202,"PODEMOS-COM",5156
12,"12119",148,95,93,0,2,"PODEMOS-COM",11
3,"3066",42121,29655,29419,214,236,"PODEMOS-COM",6362
46,"46211",1745,1387,1378,8,9,"PODEMOS-COM",310
46,"46237",7211,5395,5343,42,52,"PODEMOS-COM",1517
46,"46200",1903,1561,1539,3,22,"PODEMOS-COM",400
46,"46222",384,307,304,1,3,"PODEMOS-COM",126
46,"46191",1937,1530,1505,5,25,"PODEMOS-COM",403
3,"3127",350,278,273,1,5,"PODEMOS-COM",56
3,"3091",252,217,215,2,2,"PODEMOS-COM",37
46,"46104",1940,1504,1487,7,17,"PODEMOS-COM",441
46,"46199",5718,4314,4266,28,48,"PODEMOS-COM",1011
46,"46202",16947,12814,12710,79,104,"PODEMOS-COM",3665
3,"3046",1599,1153,1143,8,10,"PODEMOS-COM",302
12,"12072",1101,929,911,11,18,"PODEMOS-COM",114
46,"46015",7244,5615,5560,40,55,"PODEMOS-COM",1592
12,"12075",123,88,88,0,0,"PODEMOS-COM",25
3,"3084",539,454,446,3,8,"PODEMOS-COM",98
46,"46053",553,445,436,2,9,"PODEMOS-COM",147
46,"46166",8155,6320,6251,30,69,"PODEMOS-COM",1960
46,"46260",2581,2087,2068,22,19,"PODEMOS-COM",604
46,"46148",1513,1160,1146,7,14,"PODEMOS-COM",233
3,"3085",272,217,213,0,4,"PODEMOS-COM",51
12,"12049",441,322,312,1,10,"PODEMOS-COM",109
46,"46192",761,576,570,5,6,"PODEMOS-COM",158
12,"12141",101,83,83,0,0,"PODEMOS-COM",15
46,"46085",11081,7938,7866,46,72,"PODEMOS-COM",2069
3,"3049",12088,9121,9027,52,94,"PODEMOS-COM",1454
46,"46051",8347,6355,6302,24,53,"PODEMOS-COM",1396
12,"12013",144,121,119,0,2,"PODEMOS-COM",39
46,"46147",16835,11920,11791,61,129,"PODEMOS-COM",3225
12,"12058",71,63,62,1,1,"PODEMOS-COM",13
46,"46062",4631,3511,3474,27,37,"PODEMOS-COM",807
12,"12095",959,749,742,8,7,"PODEMOS-COM",168
46,"46184",26505,20428,20223,115,205,"PODEMOS-COM",6307
12,"12081",608,486,480,5,6,"PODEMOS-COM",102
46,"46045",1249,1028,1010,3,18,"PODEMOS-COM",446
46,"46071",464,383,377,0,6,"PODEMOS-COM",109
46,"46155",1029,833,822,4,11,"PODEMOS-COM",282
12,"12046",191,151,150,2,1,"PODEMOS-COM",30
46,"46027",943,780,771,5,9,"PODEMOS-COM",176
3,"3136",441,338,334,0,4,"PODEMOS-COM",111
46,"46236",972,818,809,2,9,"PODEMOS-COM",271
3,"3097",993,822,812,6,10,"PODEMOS-COM",310
3,"3073",236,200,199,1,1,"PODEMOS-COM",53
46,"46127",2692,2120,2091,18,29,"PODEMOS-COM",627
46,"46231",2421,1721,1708,14,13,"PODEMOS-COM",725
12,"12116",58,49,49,0,0,"PODEMOS-COM",4
46,"46026",1204,1015,1004,3,11,"PODEMOS-COM",296
46,"46029",20613,14964,14879,93,85,"PODEMOS-COM",3794
46,"46228",2348,1815,1794,7,21,"PODEMOS-COM",447
46,"46165",7129,5436,5388,25,48,"PODEMOS-COM",1510
46,"46161",1483,1188,1173,7,15,"PODEMOS-COM",324
3,"3003",450,378,376,2,2,"PODEMOS-COM",104
12,"12112",99,79,78,3,1,"PODEMOS-COM",1
46,"46210",330,277,277,2,0,"PODEMOS-COM",75
46,"46217",878,691,676,4,15,"PODEMOS-COM",197
46,"46139",4485,3617,3574,18,43,"PODEMOS-COM",910
46,"46160",1913,1452,1436,1,16,"PODEMOS-COM",526
12,"12083",93,79,76,0,3,"PODEMOS-COM",8
46,"46229",948,762,758,0,4,"PODEMOS-COM",185
46,"46206",571,453,445,2,8,"PODEMOS-COM",93
12,"12042",607,520,513,13,7,"PODEMOS-COM",31
46,"46137",270,210,207,4,3,"PODEMOS-COM",48
12,"12096",777,587,577,6,10,"PODEMOS-COM",135
3,"3107",2508,1755,1744,7,11,"PODEMOS-COM",500
46,"46016",1061,870,856,5,14,"PODEMOS-COM",260
46,"46144",663,532,529,2,3,"PODEMOS-COM",80
46,"46118",3763,2940,2908,16,32,"PODEMOS-COM",606
3,"3132",534,436,435,3,1,"PODEMOS-COM",115
3,"3002",3605,2583,2557,15,26,"PODEMOS-COM",537
46,"46074",2696,2069,2038,14,31,"PODEMOS-COM",624
46,"46230",13960,10351,10241,54,110,"PODEMOS-COM",2778
3,"3059",20583,15125,15018,63,107,"PODEMOS-COM",3518
3,"3090",17182,12487,12385,74,102,"PODEMOS-COM",2879
3,"3104",27103,19953,19787,131,166,"PODEMOS-COM",4889
12,"12071",1274,992,979,3,13,"PODEMOS-COM",186
3,"3031",41499,27031,26813,128,218,"PODEMOS-COM",5239
12,"12107",355,303,299,4,4,"PODEMOS-COM",53
12,"12085",4976,3236,3209,16,27,"PODEMOS-COM",726
12,"12015",93,81,78,0,3,"PODEMOS-COM",37
46,"46133",533,415,410,6,5,"PODEMOS-COM",55
3,"3029",245,185,183,1,2,"PODEMOS-COM",46
12,"12110",234,176,173,0,3,"PODEMOS-COM",30
46,"46234",348,279,275,3,4,"PODEMOS-COM",62
3,"3069",3076,2123,2102,17,21,"PODEMOS-COM",481
46,"46156",2080,1697,1675,10,22,"PODEMOS-COM",465
12,"12006",172,135,133,0,2,"PODEMOS-COM",36
46,"46072",3611,2871,2821,23,50,"PODEMOS-COM",828
46,"46055",1262,1025,1012,5,13,"PODEMOS-COM",342
3,"3001",337,269,268,0,1,"PODEMOS-COM",81
46,"46094",20540,15378,15234,102,144,"PODEMOS-COM",4377
46,"46181",16955,12313,12148,95,165,"PODEMOS-COM",3451
46,"46141",439,351,342,2,9,"PODEMOS-COM",82
3,"3076",8467,6238,6157,30,81,"PODEMOS-COM",1082
46,"46061",342,274,272,1,2,"PODEMOS-COM",91
46,"46243",138,115,112,1,3,"PODEMOS-COM",27
46,"46241",392,299,291,1,8,"PODEMOS-COM",82
46,"46154",808,636,631,5,5,"PODEMOS-COM",97
12,"12017",161,130,128,0,2,"PODEMOS-COM",15
12,"12034",1424,1065,1035,3,30,"PODEMOS-COM",220
46,"46105",16190,11323,11206,44,117,"PODEMOS-COM",2622
3,"3131",175,154,147,0,7,"PODEMOS-COM",55
3,"3064",5015,3660,3611,11,49,"PODEMOS-COM",432
3,"3044",4521,3510,3465,21,45,"PODEMOS-COM",403
46,"46233",3860,2859,2817,10,42,"PODEMOS-COM",766
12,"12092",111,91,90,0,1,"PODEMOS-COM",10
46,"46037",1122,936,923,4,13,"PODEMOS-COM",238
46,"46158",1026,811,795,6,16,"PODEMOS-COM",244
3,"3129",1194,957,938,0,19,"PODEMOS-COM",199
46,"46068",346,276,266,6,10,"PODEMOS-COM",53
12,"12098",580,451,447,5,4,"PODEMOS-COM",84
46,"46008",2651,2108,2089,21,19,"PODEMOS-COM",793
46,"46182",1266,929,922,6,7,"PODEMOS-COM",336
12,"12132",480,396,389,3,7,"PODEMOS-COM",135
12,"12106",1158,955,942,8,13,"PODEMOS-COM",218
46,"46042",3380,2799,2755,20,44,"PODEMOS-COM",637
46,"46007",11989,8784,8711,67,73,"PODEMOS-COM",2155
46,"46123",1829,1407,1388,7,19,"PODEMOS-COM",518
12,"12020",118,105,105,0,0,"PODEMOS-COM",8
3,"3111",5436,3918,3883,18,35,"PODEMOS-COM",582
3,"3012",1085,852,841,3,11,"PODEMOS-COM",135
12,"12127",75,55,55,0,0,"PODEMOS-COM",12
3,"3009",46657,35143,34801,223,342,"PODEMOS-COM",10821
46,"46113",2457,1804,1782,6,22,"PODEMOS-COM",484
12,"12003",976,746,736,6,10,"PODEMOS-COM",166
3,"3036",87,81,78,0,3,"PODEMOS-COM",35
46,"46167",364,266,264,0,2,"PODEMOS-COM",50
12,"12101",358,279,275,3,4,"PODEMOS-COM",77
46,"46203",3606,2873,2844,9,29,"PODEMOS-COM",1053
46,"46102",19788,15154,15038,89,116,"PODEMOS-COM",4226
12,"12109",649,532,524,6,8,"PODEMOS-COM",85
46,"46149",363,271,268,2,3,"PODEMOS-COM",41
46,"46103",1264,1015,984,7,31,"PODEMOS-COM",295
3,"3023",1398,1184,1167,7,17,"PODEMOS-COM",282
3,"3083",5586,3971,3928,33,43,"PODEMOS-COM",914
46,"46018",608,515,511,0,4,"PODEMOS-COM",90
3,"3004",581,438,437,2,1,"PODEMOS-COM",94
3,"3074",1707,1397,1389,4,8,"PODEMOS-COM",137
3,"3038",355,288,285,3,3,"PODEMOS-COM",78
46,"46180",682,553,549,0,4,"PODEMOS-COM",178
3,"3133",41576,25849,25639,127,210,"PODEMOS-COM",5432
46,"46115",378,286,282,1,4,"PODEMOS-COM",24
3,"3025",1270,950,941,2,9,"PODEMOS-COM",80
12,"12079",399,316,314,2,2,"PODEMOS-COM",37
3,"3082",12567,8537,8464,44,73,"PODEMOS-COM",2110
3,"3035",652,547,541,1,6,"PODEMOS-COM",158
46,"46170",3417,2714,2688,10,26,"PODEMOS-COM",404
3,"3019",15269,11520,11398,72,122,"PODEMOS-COM",2257
12,"12016",1582,1307,1297,6,10,"PODEMOS-COM",217
46,"46120",1113,903,875,2,28,"PODEMOS-COM",246
46,"46164",11771,8564,8483,64,81,"PODEMOS-COM",2191
46,"46242",333,267,266,0,1,"PODEMOS-COM",34
3,"3125",343,254,251,0,3,"PODEMOS-COM",69
46,"46063",1756,1367,1345,15,22,"PODEMOS-COM",452
3,"3086",151,135,134,1,1,"PODEMOS-COM",46
46,"46219",127,112,112,1,0,"PODEMOS-COM",22
12,"12001",1051,821,800,4,21,"PODEMOS-COM",155
12,"12123",48,40,40,3,0,"PODEMOS-COM",10
3,"3115",255,222,220,2,2,"PODEMOS-COM",71
12,"12051",471,339,335,1,4,"PODEMOS-COM",27
12,"12024",143,125,124,0,1,"PODEMOS-COM",33
3,"3032",108,91,90,1,1,"PODEMOS-COM",26
46,"46225",337,290,281,5,9,"PODEMOS-COM",79
46,"46257",5571,4266,4224,25,42,"PODEMOS-COM",1602
46,"46109",6150,4625,4556,25,69,"PODEMOS-COM",1221
3,"3027",157,138,135,0,3,"PODEMOS-COM",31
46,"46135",9680,7682,7634,36,48,"PODEMOS-COM",2177
46,"46173",1328,1069,1057,4,12,"PODEMOS-COM",322
46,"46193",8788,6925,6871,50,54,"PODEMOS-COM",2048
12,"12068",48,36,35,1,1,"PODEMOS-COM",7
3,"3021",5613,4570,4500,26,70,"PODEMOS-COM",1002
46,"46129",524,420,412,4,8,"PODEMOS-COM",175
46,"46134",2357,1725,1712,14,13,"PODEMOS-COM",553
3,"3122",42425,30153,29954,154,199,"PODEMOS-COM",7496
46,"46224",159,121,121,0,0,"PODEMOS-COM",29
3,"3112",628,511,507,2,4,"PODEMOS-COM",89
3,"3039",81,62,61,1,1,"PODEMOS-COM",24
12,"12063",41,29,29,1,0,"PODEMOS-COM",12
46,"46176",2017,1358,1349,5,9,"PODEMOS-COM",341
46,"46070",16950,12765,12676,61,89,"PODEMOS-COM",3116
46,"46011",7609,5249,5191,26,58,"PODEMOS-COM",1414
12,"12067",537,435,427,0,8,"PODEMOS-COM",68
46,"46031",10535,7543,7451,66,92,"PODEMOS-COM",2337
46,"46089",2132,1602,1574,9,28,"PODEMOS-COM",448
32,"32038",436,278,271,2,7,"PODEMOS-EN MAREA-ANOVA-EU",35
15,"15066",4009,2814,2776,33,38,"PODEMOS-EN MAREA-ANOVA-EU",388
27,"27020",3524,2816,2761,28,55,"PODEMOS-EN MAREA-ANOVA-EU",202
32,"32060",832,583,576,8,7,"PODEMOS-EN MAREA-ANOVA-EU",135
15,"15029",5688,3590,3544,32,46,"PODEMOS-EN MAREA-ANOVA-EU",458
32,"32089",1295,888,878,7,10,"PODEMOS-EN MAREA-ANOVA-EU",57
36,"36054",10993,7476,7363,67,113,"PODEMOS-EN MAREA-ANOVA-EU",1631
32,"32028",1610,1211,1189,16,22,"PODEMOS-EN MAREA-ANOVA-EU",87
32,"32014",1142,848,834,6,14,"PODEMOS-EN MAREA-ANOVA-EU",87
15,"15082",15180,10841,10726,102,115,"PODEMOS-EN MAREA-ANOVA-EU",2671
15,"15083",1086,757,746,5,11,"PODEMOS-EN MAREA-ANOVA-EU",66
32,"32002",2017,1413,1398,16,15,"PODEMOS-EN MAREA-ANOVA-EU",175
36,"36013",2344,1536,1514,11,22,"PODEMOS-EN MAREA-ANOVA-EU",232
15,"15056",5722,3869,3818,46,51,"PODEMOS-EN MAREA-ANOVA-EU",570
15,"15069",6745,4910,4850,43,60,"PODEMOS-EN MAREA-ANOVA-EU",1341
27,"27057",11169,7551,7386,79,165,"PODEMOS-EN MAREA-ANOVA-EU",1230
15,"15007",3303,2262,2246,15,16,"PODEMOS-EN MAREA-ANOVA-EU",261
36,"36018",3240,2198,2170,10,28,"PODEMOS-EN MAREA-ANOVA-EU",252
27,"27021",1753,1090,1056,12,34,"PODEMOS-EN MAREA-ANOVA-EU",127
27,"27004",1227,760,749,7,11,"PODEMOS-EN MAREA-ANOVA-EU",56
27,"27901",2386,1596,1569,25,27,"PODEMOS-EN MAREA-ANOVA-EU",171
15,"15028",1409,1038,1024,6,14,"PODEMOS-EN MAREA-ANOVA-EU",268
15,"15052",4314,2889,2838,21,51,"PODEMOS-EN MAREA-ANOVA-EU",358
15,"15032",3444,2322,2269,30,53,"PODEMOS-EN MAREA-ANOVA-EU",316
15,"15065",7315,5187,5099,42,88,"PODEMOS-EN MAREA-ANOVA-EU",1134
27,"27027",1929,1369,1342,11,27,"PODEMOS-EN MAREA-ANOVA-EU",205
27,"27044",2879,1705,1662,27,43,"PODEMOS-EN MAREA-ANOVA-EU",213
32,"32063",1914,1297,1279,16,18,"PODEMOS-EN MAREA-ANOVA-EU",223
32,"32048",895,574,569,5,5,"PODEMOS-EN MAREA-ANOVA-EU",78
32,"32043",2561,1806,1774,9,32,"PODEMOS-EN MAREA-ANOVA-EU",293
36,"36037",2571,1733,1707,11,26,"PODEMOS-EN MAREA-ANOVA-EU",395
36,"36002",3147,2193,2169,20,24,"PODEMOS-EN MAREA-ANOVA-EU",279
15,"15091",1135,771,760,13,11,"PODEMOS-EN MAREA-ANOVA-EU",143
15,"15014",4002,2566,2524,28,42,"PODEMOS-EN MAREA-ANOVA-EU",354
32,"32054",87167,60059,59333,540,726,"PODEMOS-EN MAREA-ANOVA-EU",12497
15,"15053",7729,5089,5043,49,46,"PODEMOS-EN MAREA-ANOVA-EU",1157
32,"32070",548,335,329,3,6,"PODEMOS-EN MAREA-ANOVA-EU",34
27,"27045",1038,613,603,10,10,"PODEMOS-EN MAREA-ANOVA-EU",47
27,"27063",1737,1226,1186,14,40,"PODEMOS-EN MAREA-ANOVA-EU",197
27,"27002",1633,1137,1108,9,29,"PODEMOS-EN MAREA-ANOVA-EU",130
36,"36029",16077,11617,11471,100,146,"PODEMOS-EN MAREA-ANOVA-EU",3722
15,"15003",1803,1227,1210,9,17,"PODEMOS-EN MAREA-ANOVA-EU",119
15,"15071",7951,5255,5178,50,77,"PODEMOS-EN MAREA-ANOVA-EU",1107
15,"15057",12075,8479,8377,66,102,"PODEMOS-EN MAREA-ANOVA-EU",1780
27,"27030",3327,2207,2159,31,48,"PODEMOS-EN MAREA-ANOVA-EU",341
32,"32053",1438,1158,1144,11,14,"PODEMOS-EN MAREA-ANOVA-EU",139
27,"27038",935,679,671,7,8,"PODEMOS-EN MAREA-ANOVA-EU",74
32,"32016",790,550,543,2,7,"PODEMOS-EN MAREA-ANOVA-EU",24
32,"32030",999,736,726,3,10,"PODEMOS-EN MAREA-ANOVA-EU",78
15,"15027",1536,1182,1155,6,27,"PODEMOS-EN MAREA-ANOVA-EU",164
36,"36901",4103,3153,3102,19,51,"PODEMOS-EN MAREA-ANOVA-EU",747
15,"15039",1263,889,875,7,14,"PODEMOS-EN MAREA-ANOVA-EU",127
27,"27046",1530,1022,1007,9,15,"PODEMOS-EN MAREA-ANOVA-EU",143
36,"36007",1672,1119,1099,8,20,"PODEMOS-EN MAREA-ANOVA-EU",126
32,"32084",918,641,635,3,6,"PODEMOS-EN MAREA-ANOVA-EU",50
15,"15067",8029,5789,5732,37,57,"PODEMOS-EN MAREA-ANOVA-EU",1646
32,"32045",2443,1715,1690,14,25,"PODEMOS-EN MAREA-ANOVA-EU",189
15,"15078",78198,56154,55581,560,573,"PODEMOS-EN MAREA-ANOVA-EU",13640
32,"32073",1315,973,960,5,13,"PODEMOS-EN MAREA-ANOVA-EU",121
36,"36035",14433,10333,10188,79,145,"PODEMOS-EN MAREA-ANOVA-EU",2382
15,"15058",27793,20392,20235,221,157,"PODEMOS-EN MAREA-ANOVA-EU",4978
32,"32050",2433,1829,1814,12,15,"PODEMOS-EN MAREA-ANOVA-EU",169
15,"15016",4749,3058,3020,19,38,"PODEMOS-EN MAREA-ANOVA-EU",311
15,"15070",9069,6090,5976,94,114,"PODEMOS-EN MAREA-ANOVA-EU",1704
27,"27902",7205,4829,4754,53,75,"PODEMOS-EN MAREA-ANOVA-EU",1096
36,"36045",24529,17613,17336,129,277,"PODEMOS-EN MAREA-ANOVA-EU",5350
15,"15044",1286,937,927,8,10,"PODEMOS-EN MAREA-ANOVA-EU",128
27,"27049",1409,921,909,7,12,"PODEMOS-EN MAREA-ANOVA-EU",74
15,"15036",57885,39471,39096,417,375,"PODEMOS-EN MAREA-ANOVA-EU",10722
15,"15035",11427,7779,7657,144,122,"PODEMOS-EN MAREA-ANOVA-EU",2291
32,"32086",2646,1693,1677,13,16,"PODEMOS-EN MAREA-ANOVA-EU",193
32,"32052",1888,1399,1379,6,20,"PODEMOS-EN MAREA-ANOVA-EU",156
15,"15076",2611,1758,1739,17,19,"PODEMOS-EN MAREA-ANOVA-EU",274
15,"15090",1179,812,804,9,8,"PODEMOS-EN MAREA-ANOVA-EU",56
32,"32006",1531,1114,1090,10,24,"PODEMOS-EN MAREA-ANOVA-EU",101
32,"32072",3821,2705,2667,24,38,"PODEMOS-EN MAREA-ANOVA-EU",594
32,"32058",5202,3650,3607,34,43,"PODEMOS-EN MAREA-ANOVA-EU",579
32,"32083",835,559,550,4,9,"PODEMOS-EN MAREA-ANOVA-EU",42
36,"36042",17891,12212,12003,93,209,"PODEMOS-EN MAREA-ANOVA-EU",3431
32,"32023",1210,862,849,4,13,"PODEMOS-EN MAREA-ANOVA-EU",112
36,"36027",4430,3137,3101,15,36,"PODEMOS-EN MAREA-ANOVA-EU",442
32,"32017",1244,870,857,6,13,"PODEMOS-EN MAREA-ANOVA-EU",58
32,"32022",1337,892,881,6,11,"PODEMOS-EN MAREA-ANOVA-EU",103
36,"36036",2518,1827,1801,18,26,"PODEMOS-EN MAREA-ANOVA-EU",379
15,"15061",5571,3746,3691,27,55,"PODEMOS-EN MAREA-ANOVA-EU",499
36,"36034",3475,2403,2367,11,36,"PODEMOS-EN MAREA-ANOVA-EU",417
32,"32008",8256,5542,5490,39,52,"PODEMOS-EN MAREA-ANOVA-EU",1091
36,"36014",1942,1459,1444,9,15,"PODEMOS-EN MAREA-ANOVA-EU",201
32,"32007",1517,1046,1028,8,18,"PODEMOS-EN MAREA-ANOVA-EU",104
15,"15020",3784,2476,2447,17,29,"PODEMOS-EN MAREA-ANOVA-EU",466
27,"27003",1876,1344,1320,12,24,"PODEMOS-EN MAREA-ANOVA-EU",159
27,"27008",1379,1000,982,9,18,"PODEMOS-EN MAREA-ANOVA-EU",140
36,"36025",2257,1360,1350,10,10,"PODEMOS-EN MAREA-ANOVA-EU",170
15,"15048",4839,3456,3414,36,42,"PODEMOS-EN MAREA-ANOVA-EU",712
15,"15008",5627,4112,4072,36,40,"PODEMOS-EN MAREA-ANOVA-EU",798
32,"32001",4986,3488,3443,25,45,"PODEMOS-EN MAREA-ANOVA-EU",729
32,"32033",737,478,476,3,2,"PODEMOS-EN MAREA-ANOVA-EU",47
15,"15004",4834,3436,3391,30,45,"PODEMOS-EN MAREA-ANOVA-EU",847
27,"27058",3495,2510,2480,30,30,"PODEMOS-EN MAREA-ANOVA-EU",212
27,"27034",1120,681,672,4,9,"PODEMOS-EN MAREA-ANOVA-EU",81
15,"15005",24516,15761,15537,213,224,"PODEMOS-EN MAREA-ANOVA-EU",4222
15,"15079",1540,1027,1007,16,20,"PODEMOS-EN MAREA-ANOVA-EU",121
15,"15038",2227,1463,1443,25,20,"PODEMOS-EN MAREA-ANOVA-EU",179
27,"27006",2564,1659,1637,17,22,"PODEMOS-EN MAREA-ANOVA-EU",216
15,"15033",2472,1863,1845,8,18,"PODEMOS-EN MAREA-ANOVA-EU",380
36,"36015",4153,2721,2677,23,44,"PODEMOS-EN MAREA-ANOVA-EU",433
15,"15045",3770,2184,2157,14,27,"PODEMOS-EN MAREA-ANOVA-EU",211
15,"15093",4220,2533,2498,30,35,"PODEMOS-EN MAREA-ANOVA-EU",310
36,"36050",7561,5280,5188,25,92,"PODEMOS-EN MAREA-ANOVA-EU",1222
27,"27012",1355,736,729,5,7,"PODEMOS-EN MAREA-ANOVA-EU",51
32,"32077",1166,791,785,14,6,"PODEMOS-EN MAREA-ANOVA-EU",95
36,"36033",12298,8968,8788,53,180,"PODEMOS-EN MAREA-ANOVA-EU",2331
32,"32062",811,621,617,6,4,"PODEMOS-EN MAREA-ANOVA-EU",53
32,"32078",1188,855,838,4,17,"PODEMOS-EN MAREA-ANOVA-EU",70
15,"15085",3332,2280,2247,25,33,"PODEMOS-EN MAREA-ANOVA-EU",309
15,"15002",23083,16073,15889,159,184,"PODEMOS-EN MAREA-ANOVA-EU",4337
27,"27054",1190,881,860,9,21,"PODEMOS-EN MAREA-ANOVA-EU",105
15,"15018",1142,741,732,18,9,"PODEMOS-EN MAREA-ANOVA-EU",167
36,"36061",8606,6232,6133,41,99,"PODEMOS-EN MAREA-ANOVA-EU",919
32,"32012",784,505,497,2,8,"PODEMOS-EN MAREA-ANOVA-EU",70
32,"32090",774,530,511,4,19,"PODEMOS-EN MAREA-ANOVA-EU",137
36,"36006",11520,8529,8396,63,133,"PODEMOS-EN MAREA-ANOVA-EU",1723
36,"36021",12073,8447,8342,89,105,"PODEMOS-EN MAREA-ANOVA-EU",2116
36,"36031",558,465,459,7,6,"PODEMOS-EN MAREA-ANOVA-EU",94
32,"32065",657,463,454,3,9,"PODEMOS-EN MAREA-ANOVA-EU",51
15,"15015",2799,2045,2008,24,37,"PODEMOS-EN MAREA-ANOVA-EU",471
15,"15040",2753,1905,1880,5,25,"PODEMOS-EN MAREA-ANOVA-EU",291
27,"27039",4358,3143,3085,40,58,"PODEMOS-EN MAREA-ANOVA-EU",417
27,"27056",1248,848,836,9,12,"PODEMOS-EN MAREA-ANOVA-EU",145
36,"36051",14267,9638,9493,71,145,"PODEMOS-EN MAREA-ANOVA-EU",1820
15,"15902",4598,3209,3149,51,60,"PODEMOS-EN MAREA-ANOVA-EU",398
15,"15037",4061,2588,2552,19,36,"PODEMOS-EN MAREA-ANOVA-EU",465
32,"32029",470,357,352,4,5,"PODEMOS-EN MAREA-ANOVA-EU",29
15,"15081",1034,791,782,11,9,"PODEMOS-EN MAREA-ANOVA-EU",85
36,"36017",17782,12411,12240,117,171,"PODEMOS-EN MAREA-ANOVA-EU",2141
36,"36003",9980,7191,7110,67,81,"PODEMOS-EN MAREA-ANOVA-EU",1703
36,"36048",5331,3653,3603,22,50,"PODEMOS-EN MAREA-ANOVA-EU",841
27,"27037",1065,750,740,11,10,"PODEMOS-EN MAREA-ANOVA-EU",55
32,"32066",566,418,416,0,2,"PODEMOS-EN MAREA-ANOVA-EU",19
32,"32040",1477,1090,1084,7,6,"PODEMOS-EN MAREA-ANOVA-EU",113
36,"36023",8395,5965,5884,41,81,"PODEMOS-EN MAREA-ANOVA-EU",1475
15,"15012",3627,2659,2602,28,57,"PODEMOS-EN MAREA-ANOVA-EU",385
36,"36052",7292,4999,4907,45,92,"PODEMOS-EN MAREA-ANOVA-EU",658
27,"27041",2341,1718,1705,16,13,"PODEMOS-EN MAREA-ANOVA-EU",208
15,"15017",19420,13661,13505,175,156,"PODEMOS-EN MAREA-ANOVA-EU",3696
15,"15043",5114,3476,3401,47,75,"PODEMOS-EN MAREA-ANOVA-EU",691
15,"15023",6419,4348,4261,36,87,"PODEMOS-EN MAREA-ANOVA-EU",849
36,"36059",4882,3137,3085,28,52,"PODEMOS-EN MAREA-ANOVA-EU",384
32,"32031",1069,822,795,4,27,"PODEMOS-EN MAREA-ANOVA-EU",73
32,"32069",4308,3221,3164,27,57,"PODEMOS-EN MAREA-ANOVA-EU",631
36,"36026",20137,13779,13596,141,183,"PODEMOS-EN MAREA-ANOVA-EU",3084
32,"32067",1294,837,826,8,11,"PODEMOS-EN MAREA-ANOVA-EU",115
27,"27001",2370,1281,1256,13,25,"PODEMOS-EN MAREA-ANOVA-EU",114
15,"15051",4638,3182,3153,44,29,"PODEMOS-EN MAREA-ANOVA-EU",894
27,"27019",8111,5773,5680,53,93,"PODEMOS-EN MAREA-ANOVA-EU",1167
27,"27048",2140,1502,1467,20,35,"PODEMOS-EN MAREA-ANOVA-EU",153
27,"27025",2831,2152,2110,17,42,"PODEMOS-EN MAREA-ANOVA-EU",403
27,"27013",3766,2900,2851,25,49,"PODEMOS-EN MAREA-ANOVA-EU",830
27,"27061",1027,753,732,6,21,"PODEMOS-EN MAREA-ANOVA-EU",87
32,"32032",8059,5708,5608,58,100,"PODEMOS-EN MAREA-ANOVA-EU",879
15,"15060",5772,4032,3958,46,74,"PODEMOS-EN MAREA-ANOVA-EU",792
36,"36041",13434,9297,9181,66,116,"PODEMOS-EN MAREA-ANOVA-EU",1776
15,"15001",4765,3280,3237,25,43,"PODEMOS-EN MAREA-ANOVA-EU",606
32,"32087",1765,1363,1343,13,20,"PODEMOS-EN MAREA-ANOVA-EU",146
32,"32018",1247,975,962,9,13,"PODEMOS-EN MAREA-ANOVA-EU",129
15,"15901",3546,2247,2228,24,19,"PODEMOS-EN MAREA-ANOVA-EU",472
32,"32081",2077,1517,1500,14,17,"PODEMOS-EN MAREA-ANOVA-EU",211
15,"15019",25888,16680,16460,186,220,"PODEMOS-EN MAREA-ANOVA-EU",3204
36,"36030",4175,2832,2785,27,47,"PODEMOS-EN MAREA-ANOVA-EU",590
32,"32074",1044,710,704,4,6,"PODEMOS-EN MAREA-ANOVA-EU",60
32,"32049",760,510,507,9,3,"PODEMOS-EN MAREA-ANOVA-EU",52
32,"32085",10716,7279,7152,66,127,"PODEMOS-EN MAREA-ANOVA-EU",1053
32,"32003",885,654,649,5,5,"PODEMOS-EN MAREA-ANOVA-EU",84
32,"32013",2183,1428,1425,8,3,"PODEMOS-EN MAREA-ANOVA-EU",100
32,"32059",1790,1283,1263,7,20,"PODEMOS-EN MAREA-ANOVA-EU",124
27,"27014",3254,2103,2067,21,36,"PODEMOS-EN MAREA-ANOVA-EU",240
32,"32044",876,643,634,2,9,"PODEMOS-EN MAREA-ANOVA-EU",115
32,"32092",520,321,320,6,1,"PODEMOS-EN MAREA-ANOVA-EU",51
27,"27022",4833,3022,2954,30,68,"PODEMOS-EN MAREA-ANOVA-EU",473
27,"27035",187,122,121,1,1,"PODEMOS-EN MAREA-ANOVA-EU",27
27,"27033",623,415,409,8,6,"PODEMOS-EN MAREA-ANOVA-EU",36
32,"32010",388,301,299,3,2,"PODEMOS-EN MAREA-ANOVA-EU",36
15,"15025",1061,629,622,6,7,"PODEMOS-EN MAREA-ANOVA-EU",54
32,"32020",2576,1923,1899,5,24,"PODEMOS-EN MAREA-ANOVA-EU",208
15,"15080",1756,1131,1117,11,14,"PODEMOS-EN MAREA-ANOVA-EU",93
36,"36040",2575,1709,1680,15,29,"PODEMOS-EN MAREA-ANOVA-EU",270
15,"15068",5049,3185,3129,25,56,"PODEMOS-EN MAREA-ANOVA-EU",575
32,"32047",1784,1255,1244,9,11,"PODEMOS-EN MAREA-ANOVA-EU",114
32,"32037",728,518,509,6,9,"PODEMOS-EN MAREA-ANOVA-EU",43
27,"27018",3467,2086,2059,20,27,"PODEMOS-EN MAREA-ANOVA-EU",301
36,"36058",4994,3292,3243,33,49,"PODEMOS-EN MAREA-ANOVA-EU",724
15,"15013",6151,4237,4189,48,48,"PODEMOS-EN MAREA-ANOVA-EU",929
15,"15011",15432,10395,10248,74,147,"PODEMOS-EN MAREA-ANOVA-EU",2381
15,"15088",3519,2304,2270,27,34,"PODEMOS-EN MAREA-ANOVA-EU",370
15,"15073",21827,14058,13864,126,194,"PODEMOS-EN MAREA-ANOVA-EU",2901
32,"32021",947,634,630,5,4,"PODEMOS-EN MAREA-ANOVA-EU",85
15,"15077",8261,5186,5103,59,83,"PODEMOS-EN MAREA-ANOVA-EU",541
27,"27007",2805,2133,2078,38,55,"PODEMOS-EN MAREA-ANOVA-EU",208
15,"15022",5785,3811,3771,33,40,"PODEMOS-EN MAREA-ANOVA-EU",907
15,"15089",4291,3020,2972,28,48,"PODEMOS-EN MAREA-ANOVA-EU",557
32,"32088",1622,1018,1002,8,16,"PODEMOS-EN MAREA-ANOVA-EU",150
27,"27066",12696,8704,8537,98,167,"PODEMOS-EN MAREA-ANOVA-EU",1798
32,"32061",1081,812,809,4,3,"PODEMOS-EN MAREA-ANOVA-EU",57
27,"27029",1463,1023,1002,11,21,"PODEMOS-EN MAREA-ANOVA-EU",126
27,"27051",8108,5503,5424,62,79,"PODEMOS-EN MAREA-ANOVA-EU",1135
32,"32079",1333,950,939,11,11,"PODEMOS-EN MAREA-ANOVA-EU",105
32,"32024",4821,3320,3254,34,66,"PODEMOS-EN MAREA-ANOVA-EU",401
27,"27031",15570,10606,10420,118,186,"PODEMOS-EN MAREA-ANOVA-EU",2114
15,"15074",4037,2841,2796,20,45,"PODEMOS-EN MAREA-ANOVA-EU",453
27,"27055",1293,826,809,6,17,"PODEMOS-EN MAREA-ANOVA-EU",72
27,"27010",4327,2899,2837,53,62,"PODEMOS-EN MAREA-ANOVA-EU",416
36,"36055",13620,9580,9400,62,180,"PODEMOS-EN MAREA-ANOVA-EU",1961
27,"27009",2097,1533,1507,12,26,"PODEMOS-EN MAREA-ANOVA-EU",143
15,"15024",4393,3141,3073,32,68,"PODEMOS-EN MAREA-ANOVA-EU",378
27,"27005",2595,1846,1816,13,30,"PODEMOS-EN MAREA-ANOVA-EU",268
15,"15010",1887,1168,1150,13,18,"PODEMOS-EN MAREA-ANOVA-EU",94
32,"32080",328,249,244,5,5,"PODEMOS-EN MAREA-ANOVA-EU",20
15,"15064",2194,1592,1556,21,36,"PODEMOS-EN MAREA-ANOVA-EU",211
32,"32042",1579,1094,1081,12,13,"PODEMOS-EN MAREA-ANOVA-EU",115
27,"27023",2579,1891,1865,23,26,"PODEMOS-EN MAREA-ANOVA-EU",131
15,"15030",200176,143255,142070,1452,1185,"PODEMOS-EN MAREA-ANOVA-EU",37446
32,"32004",1798,1029,1023,4,6,"PODEMOS-EN MAREA-ANOVA-EU",30
32,"32025",1079,791,777,1,14,"PODEMOS-EN MAREA-ANOVA-EU",104
36,"36016",1143,721,711,3,10,"PODEMOS-EN MAREA-ANOVA-EU",35
32,"32005",861,662,650,7,12,"PODEMOS-EN MAREA-ANOVA-EU",47
15,"15054",32106,21026,20772,259,254,"PODEMOS-EN MAREA-ANOVA-EU",5871
32,"32041",767,524,515,4,9,"PODEMOS-EN MAREA-ANOVA-EU",56
36,"36057",236673,169244,167605,1366,1639,"PODEMOS-EN MAREA-ANOVA-EU",50830
32,"32036",1345,971,953,14,18,"PODEMOS-EN MAREA-ANOVA-EU",80
15,"15059",10362,7258,7106,91,152,"PODEMOS-EN MAREA-ANOVA-EU",1106
36,"36049",6804,4960,4860,36,100,"PODEMOS-EN MAREA-ANOVA-EU",1323
15,"15075",12336,8830,8725,91,105,"PODEMOS-EN MAREA-ANOVA-EU",2069
32,"32034",1124,845,839,5,6,"PODEMOS-EN MAREA-ANOVA-EU",91
36,"36012",3732,2751,2717,9,34,"PODEMOS-EN MAREA-ANOVA-EU",479
36,"36005",8121,5480,5400,52,80,"PODEMOS-EN MAREA-ANOVA-EU",974
36,"36044",2541,1674,1646,7,28,"PODEMOS-EN MAREA-ANOVA-EU",397
32,"32011",932,619,613,1,6,"PODEMOS-EN MAREA-ANOVA-EU",26
15,"15047",2429,1576,1549,19,27,"PODEMOS-EN MAREA-ANOVA-EU",229
36,"36004",10161,6939,6844,63,95,"PODEMOS-EN MAREA-ANOVA-EU",1791
27,"27060",2598,1690,1665,19,25,"PODEMOS-EN MAREA-ANOVA-EU",240
27,"27026",2397,1503,1471,9,32,"PODEMOS-EN MAREA-ANOVA-EU",176
32,"32027",1053,765,749,2,16,"PODEMOS-EN MAREA-ANOVA-EU",73
15,"15092",6438,3976,3903,28,73,"PODEMOS-EN MAREA-ANOVA-EU",570
32,"32082",1243,891,878,1,13,"PODEMOS-EN MAREA-ANOVA-EU",71
27,"27065",12444,8261,8056,112,205,"PODEMOS-EN MAREA-ANOVA-EU",1165
36,"36020",2318,1646,1620,18,26,"PODEMOS-EN MAREA-ANOVA-EU",123
15,"15087",5769,3766,3722,42,44,"PODEMOS-EN MAREA-ANOVA-EU",739
32,"32019",11537,7975,7861,56,114,"PODEMOS-EN MAREA-ANOVA-EU",1080
36,"36038",66390,47750,47273,449,477,"PODEMOS-EN MAREA-ANOVA-EU",10917
36,"36046",4036,2971,2921,15,50,"PODEMOS-EN MAREA-ANOVA-EU",523
27,"27015",4270,2832,2769,33,63,"PODEMOS-EN MAREA-ANOVA-EU",379
36,"36022",9011,6310,6172,49,138,"PODEMOS-EN MAREA-ANOVA-EU",2080
27,"27032",3275,2128,2096,22,32,"PODEMOS-EN MAREA-ANOVA-EU",307
27,"27059",2163,1570,1543,17,27,"PODEMOS-EN MAREA-ANOVA-EU",192
36,"36009",4503,3056,3001,15,55,"PODEMOS-EN MAREA-ANOVA-EU",470
36,"36053",5684,4099,4050,38,49,"PODEMOS-EN MAREA-ANOVA-EU",922
27,"27053",537,316,308,3,8,"PODEMOS-EN MAREA-ANOVA-EU",15
15,"15084",3260,2218,2191,27,27,"PODEMOS-EN MAREA-ANOVA-EU",171
36,"36032",3630,2587,2535,16,52,"PODEMOS-EN MAREA-ANOVA-EU",332
15,"15034",2885,1782,1760,18,22,"PODEMOS-EN MAREA-ANOVA-EU",202
27,"27024",1598,1173,1158,8,15,"PODEMOS-EN MAREA-ANOVA-EU",122
27,"27016",7172,4910,4846,51,64,"PODEMOS-EN MAREA-ANOVA-EU",792
27,"27047",1629,1106,1089,8,17,"PODEMOS-EN MAREA-ANOVA-EU",158
15,"15041",9568,6828,6710,75,118,"PODEMOS-EN MAREA-ANOVA-EU",1256
15,"15055",4572,3070,3013,27,57,"PODEMOS-EN MAREA-ANOVA-EU",762
27,"27017",1003,674,670,4,4,"PODEMOS-EN MAREA-ANOVA-EU",105
32,"32064",529,389,388,3,1,"PODEMOS-EN MAREA-ANOVA-EU",27
27,"27040",3200,2351,2310,21,41,"PODEMOS-EN MAREA-ANOVA-EU",200
32,"32071",1476,1010,1005,3,5,"PODEMOS-EN MAREA-ANOVA-EU",119
15,"15042",3028,2033,2000,19,33,"PODEMOS-EN MAREA-ANOVA-EU",336
36,"36024",16455,11971,11781,109,190,"PODEMOS-EN MAREA-ANOVA-EU",1429
32,"32051",1427,1184,1172,6,12,"PODEMOS-EN MAREA-ANOVA-EU",60
36,"36019",1625,1042,1029,9,13,"PODEMOS-EN MAREA-ANOVA-EU",126
36,"36010",2847,2102,2076,13,26,"PODEMOS-EN MAREA-ANOVA-EU",527
15,"15031",23348,16380,16235,191,145,"PODEMOS-EN MAREA-ANOVA-EU",4360
15,"15006",5321,3341,3283,49,58,"PODEMOS-EN MAREA-ANOVA-EU",526
32,"32026",2704,1929,1896,22,33,"PODEMOS-EN MAREA-ANOVA-EU",314
27,"27043",1295,805,793,9,12,"PODEMOS-EN MAREA-ANOVA-EU",80
27,"27042",1740,1235,1218,12,17,"PODEMOS-EN MAREA-ANOVA-EU",80
32,"32055",1280,891,881,7,10,"PODEMOS-EN MAREA-ANOVA-EU",116
36,"36060",30323,21399,21162,164,237,"PODEMOS-EN MAREA-ANOVA-EU",5312
32,"32057",565,416,415,4,1,"PODEMOS-EN MAREA-ANOVA-EU",46
27,"27064",1581,1097,1068,12,29,"PODEMOS-EN MAREA-ANOVA-EU",128
32,"32009",10803,7303,7227,48,76,"PODEMOS-EN MAREA-ANOVA-EU",1070
15,"15009",10739,7688,7559,54,129,"PODEMOS-EN MAREA-ANOVA-EU",1675
32,"32076",2094,1488,1474,20,14,"PODEMOS-EN MAREA-ANOVA-EU",103
27,"27011",2452,1494,1467,19,27,"PODEMOS-EN MAREA-ANOVA-EU",203
32,"32039",1262,957,941,6,16,"PODEMOS-EN MAREA-ANOVA-EU",100
27,"27050",2975,2190,2154,16,36,"PODEMOS-EN MAREA-ANOVA-EU",305
36,"36001",2564,1858,1848,5,10,"PODEMOS-EN MAREA-ANOVA-EU",300
15,"15086",2869,1970,1950,13,20,"PODEMOS-EN MAREA-ANOVA-EU",247
27,"27062",605,447,444,1,3,"PODEMOS-EN MAREA-ANOVA-EU",51
15,"15050",1822,1004,988,13,16,"PODEMOS-EN MAREA-ANOVA-EU",122
32,"32075",4217,3089,3044,33,45,"PODEMOS-EN MAREA-ANOVA-EU",427
36,"36008",21762,15447,15262,128,185,"PODEMOS-EN MAREA-ANOVA-EU",5819
36,"36056",5076,3584,3515,30,69,"PODEMOS-EN MAREA-ANOVA-EU",614
32,"32015",874,575,573,4,2,"PODEMOS-EN MAREA-ANOVA-EU",51
15,"15062",5887,3747,3701,36,46,"PODEMOS-EN MAREA-ANOVA-EU",650
27,"27052",915,676,667,6,9,"PODEMOS-EN MAREA-ANOVA-EU",59
36,"36039",15401,10871,10609,71,262,"PODEMOS-EN MAREA-ANOVA-EU",3004
15,"15021",5127,3587,3543,38,44,"PODEMOS-EN MAREA-ANOVA-EU",653
32,"32046",1160,787,779,4,8,"PODEMOS-EN MAREA-ANOVA-EU",96
32,"32035",1442,957,942,3,15,"PODEMOS-EN MAREA-ANOVA-EU",83
15,"15049",1098,758,752,7,6,"PODEMOS-EN MAREA-ANOVA-EU",86
32,"32056",1592,1124,1118,7,6,"PODEMOS-EN MAREA-ANOVA-EU",70
32,"32068",1415,982,978,5,4,"PODEMOS-EN MAREA-ANOVA-EU",92
15,"15072",9574,6637,6562,35,75,"PODEMOS-EN MAREA-ANOVA-EU",1542
36,"36028",4102,2913,2868,17,45,"PODEMOS-EN MAREA-ANOVA-EU",443
27,"27028",79049,54057,53355,559,702,"PODEMOS-EN MAREA-ANOVA-EU",11277
36,"36043",4747,3210,3162,20,48,"PODEMOS-EN MAREA-ANOVA-EU",538
32,"32091",1838,1368,1362,6,6,"PODEMOS-EN MAREA-ANOVA-EU",99
36,"36011",1799,1144,1122,8,22,"PODEMOS-EN MAREA-ANOVA-EU",113
36,"36047",2454,1633,1621,13,12,"PODEMOS-EN MAREA-ANOVA-EU",119
15,"15046",6332,4377,4262,40,115,"PODEMOS-EN MAREA-ANOVA-EU",658
7,"7047",2246,1517,1482,18,35,"PODEMOS-EUI",433
7,"7033",27104,15524,15337,174,187,"PODEMOS-EUI",4087
7,"7009",738,521,510,12,11,"PODEMOS-EUI",112
7,"7030",1551,1127,1101,13,26,"PODEMOS-EUI",284
7,"7007",421,296,293,2,3,"PODEMOS-EUI",91
7,"7044",8439,5681,5543,48,138,"PODEMOS-EUI",1158
7,"7021",230,177,174,2,3,"PODEMOS-EUI",44
7,"7002",6341,4295,4255,39,40,"PODEMOS-EUI",1223
7,"7043",3389,2290,2252,26,38,"PODEMOS-EUI",491
7,"7049",1480,1003,993,14,10,"PODEMOS-EUI",268
7,"7034",1008,743,734,7,9,"PODEMOS-EUI",212
7,"7053",1188,926,918,16,8,"PODEMOS-EUI",246
7,"7038",2010,1424,1412,18,12,"PODEMOS-EUI",466
7,"7048",17252,10055,9984,105,71,"PODEMOS-EUI",2810
7,"7031",23833,14836,14707,124,129,"PODEMOS-EUI",3255
7,"7054",22334,12814,12708,99,106,"PODEMOS-EUI",3126
7,"7015",20991,12552,12433,184,119,"PODEMOS-EUI",3853
7,"7064",5315,3475,3434,31,41,"PODEMOS-EUI",1159
7,"7025",472,355,351,1,4,"PODEMOS-EUI",78
7,"7059",2996,2053,2013,17,40,"PODEMOS-EUI",344
7,"7004",3854,2574,2547,30,27,"PODEMOS-EUI",676
7,"7032",20034,12824,12710,110,114,"PODEMOS-EUI",3590
7,"7035",1524,1078,1055,8,23,"PODEMOS-EUI",256
7,"7062",7513,4273,4219,52,54,"PODEMOS-EUI",1002
7,"7020",3581,2542,2502,43,40,"PODEMOS-EUI",882
7,"7040",280477,173945,172463,1359,1482,"PODEMOS-EUI",44359
7,"7901",610,462,459,7,3,"PODEMOS-EUI",66
7,"7013",6881,4693,4587,39,106,"PODEMOS-EUI",778
7,"7051",5215,3171,3134,39,37,"PODEMOS-EUI",742
7,"7037",3197,1934,1917,26,17,"PODEMOS-EUI",591
7,"7024",6843,3657,3612,38,45,"PODEMOS-EUI",1090
7,"7001",3573,2531,2497,21,34,"PODEMOS-EUI",636
7,"7058",2791,2060,2034,13,26,"PODEMOS-EUI",490
7,"7036",26955,18578,18433,148,145,"PODEMOS-EUI",4383
7,"7011",27721,17817,17720,139,97,"PODEMOS-EUI",3670
7,"7023",3604,2498,2470,49,28,"PODEMOS-EUI",737
7,"7014",7320,4163,4116,45,47,"PODEMOS-EUI",1174
7,"7003",11761,6631,6541,55,90,"PODEMOS-EUI",1592
7,"7006",5178,3366,3329,52,37,"PODEMOS-EUI",1144
7,"7029",4166,2949,2913,37,36,"PODEMOS-EUI",709
7,"7065",2083,1346,1328,9,18,"PODEMOS-EUI",446
7,"7010",4880,3395,3361,32,34,"PODEMOS-EUI",1019
7,"7050",3348,2156,2139,19,17,"PODEMOS-EUI",394
7,"7028",899,601,595,7,6,"PODEMOS-EUI",170
7,"7045",1295,947,936,5,11,"PODEMOS-EUI",291
7,"7902",1064,685,664,15,21,"PODEMOS-EUI",167
7,"7022",11545,7385,7306,88,79,"PODEMOS-EUI",1499
7,"7026",31074,18280,18135,168,145,"PODEMOS-EUI",4440
7,"7052",4667,2908,2886,29,22,"PODEMOS-EUI",926
7,"7041",2044,1486,1451,13,35,"PODEMOS-EUI",362
7,"7063",1418,1043,1033,6,10,"PODEMOS-EUI",261
7,"7005",6710,4127,4090,25,37,"PODEMOS-EUI",1025
7,"7042",10666,6680,6613,64,67,"PODEMOS-EUI",1914
7,"7008",5692,3956,3913,26,43,"PODEMOS-EUI",1097
7,"7019",187,133,129,2,4,"PODEMOS-EUI",20
7,"7012",1876,1369,1353,13,16,"PODEMOS-EUI",477
7,"7057",7169,4719,4659,47,60,"PODEMOS-EUI",856
7,"7056",5026,3410,3375,32,35,"PODEMOS-EUI",1053
7,"7060",2568,1677,1653,16,24,"PODEMOS-EUI",432
7,"7018",382,272,269,1,3,"PODEMOS-EUI",107
7,"7046",15797,9127,9043,86,84,"PODEMOS-EUI",2059
7,"7055",7442,4604,4553,42,51,"PODEMOS-EUI",846
7,"7039",4839,3136,3060,31,76,"PODEMOS-EUI",552
7,"7061",9819,6351,6280,53,71,"PODEMOS-EUI",1740
7,"7017",851,582,571,7,11,"PODEMOS-EUI",149
7,"7016",2809,1865,1836,23,29,"PODEMOS-EUI",437
7,"7027",20769,13097,12987,100,110,"PODEMOS-EUI",2766
39,"39102",2277,1615,1598,9,17,"PODEMOS-IU-EQUO",245
37,"37004",30,21,21,0,0,"PODEMOS-IU-EQUO",2
6,"6064",841,666,656,2,10,"PODEMOS-IU-EQUO",162
24,"24117",434,334,331,1,3,"PODEMOS-IU-EQUO",18
37,"37283",123,92,90,0,2,"PODEMOS-IU-EQUO",10
37,"37259",44,28,28,0,0,"PODEMOS-IU-EQUO",0
5,"5243",85,61,60,0,1,"PODEMOS-IU-EQUO",5
45,"45177",2110,1679,1656,3,23,"PODEMOS-IU-EQUO",217
9,"9220",75,56,54,1,2,"PODEMOS-IU-EQUO",5
19,"19204",148,120,120,0,0,"PODEMOS-IU-EQUO",19
10,"10139",114,82,78,1,4,"PODEMOS-IU-EQUO",7
16,"16253",337,264,263,2,1,"PODEMOS-IU-EQUO",18
19,"19330",71,63,63,2,0,"PODEMOS-IU-EQUO",4
5,"5121",249,185,185,4,0,"PODEMOS-IU-EQUO",22
16,"16274",121,92,92,0,0,"PODEMOS-IU-EQUO",13
2,"2083",219,191,191,0,0,"PODEMOS-IU-EQUO",15
19,"19306",25,20,20,1,0,"PODEMOS-IU-EQUO",1
45,"45185",7700,5771,5691,20,80,"PODEMOS-IU-EQUO",759
6,"6109",3919,3139,3012,24,127,"PODEMOS-IU-EQUO",377
9,"9191",38,28,27,0,1,"PODEMOS-IU-EQUO",1
37,"37180",75,56,56,0,0,"PODEMOS-IU-EQUO",6
13,"13077",3489,2205,2152,18,53,"PODEMOS-IU-EQUO",287
42,"42038",36,28,28,1,0,"PODEMOS-IU-EQUO",1
5,"5169",226,187,185,1,2,"PODEMOS-IU-EQUO",11
42,"42064",86,68,68,0,0,"PODEMOS-IU-EQUO",7
16,"16215",242,172,169,2,3,"PODEMOS-IU-EQUO",34
9,"9051",170,130,128,0,2,"PODEMOS-IU-EQUO",18
10,"10007",629,459,454,5,5,"PODEMOS-IU-EQUO",24
13,"13042",920,652,648,2,4,"PODEMOS-IU-EQUO",40
39,"39098",1402,1046,1036,8,10,"PODEMOS-IU-EQUO",105
26,"26115",19,16,16,0,0,"PODEMOS-IU-EQUO",1
2,"2073",4867,3520,3474,40,46,"PODEMOS-IU-EQUO",634
9,"9149",35,24,24,2,0,"PODEMOS-IU-EQUO",3
30,"30023",3780,2874,2850,12,24,"PODEMOS-IU-EQUO",515
16,"16079",30,19,18,0,1,"PODEMOS-IU-EQUO",1
39,"39010",631,480,475,7,5,"PODEMOS-IU-EQUO",73
34,"34224",47,37,37,1,0,"PODEMOS-IU-EQUO",0
37,"37152",418,290,286,2,4,"PODEMOS-IU-EQUO",27
2,"2052",459,372,369,4,3,"PODEMOS-IU-EQUO",36
26,"26131",35,33,33,1,0,"PODEMOS-IU-EQUO",5
45,"45143",1170,881,874,4,7,"PODEMOS-IU-EQUO",186
42,"42206",8,8,8,1,0,"PODEMOS-IU-EQUO",2
39,"39071",397,261,256,1,5,"PODEMOS-IU-EQUO",9
5,"5183",138,111,110,0,1,"PODEMOS-IU-EQUO",0
37,"37192",356,231,227,2,4,"PODEMOS-IU-EQUO",54
10,"10149",421,283,280,1,3,"PODEMOS-IU-EQUO",35
38,"38002",956,702,696,21,6,"PODEMOS-IU-EQUO",59
13,"13058",4100,2986,2954,25,32,"PODEMOS-IU-EQUO",201
42,"42184",57,43,43,0,0,"PODEMOS-IU-EQUO",1
42,"42014",64,43,43,1,0,"PODEMOS-IU-EQUO",1
9,"9170",205,162,162,1,0,"PODEMOS-IU-EQUO",14
2,"2001",656,527,523,1,4,"PODEMOS-IU-EQUO",35
19,"19095",12,9,9,0,0,"PODEMOS-IU-EQUO",0
19,"19299",97,79,77,1,2,"PODEMOS-IU-EQUO",6
26,"26061",1565,1160,1141,13,19,"PODEMOS-IU-EQUO",228
6,"6155",1874,1218,1202,16,16,"PODEMOS-IU-EQUO",156
42,"42069",1536,1036,1019,6,17,"PODEMOS-IU-EQUO",242
34,"34222",120,87,87,3,0,"PODEMOS-IU-EQUO",4
45,"45124",2140,1677,1641,10,36,"PODEMOS-IU-EQUO",134
34,"34137",27,23,22,0,1,"PODEMOS-IU-EQUO",1
5,"5159",252,165,164,0,1,"PODEMOS-IU-EQUO",5
26,"26012",23,23,23,1,0,"PODEMOS-IU-EQUO",3
37,"37059",124,94,93,1,1,"PODEMOS-IU-EQUO",5
45,"45173",9520,6938,6864,30,74,"PODEMOS-IU-EQUO",819
2,"2038",281,223,223,0,0,"PODEMOS-IU-EQUO",14
26,"26076",129,107,106,0,1,"PODEMOS-IU-EQUO",4
42,"42045",301,206,197,2,9,"PODEMOS-IU-EQUO",22
19,"19127",89,64,64,0,0,"PODEMOS-IU-EQUO",3
6,"6111",500,337,337,1,0,"PODEMOS-IU-EQUO",46
34,"34024",31,21,21,1,0,"PODEMOS-IU-EQUO",3
6,"6145",922,696,694,5,2,"PODEMOS-IU-EQUO",46
9,"9372",212,176,176,4,0,"PODEMOS-IU-EQUO",34
26,"26175",51,41,41,0,0,"PODEMOS-IU-EQUO",4
16,"16134",4371,3288,3254,20,34,"PODEMOS-IU-EQUO",494
2,"2003",132346,95878,95217,630,661,"PODEMOS-IU-EQUO",16193
42,"42033",48,45,45,1,0,"PODEMOS-IU-EQUO",1
10,"10173",577,400,399,5,1,"PODEMOS-IU-EQUO",52
39,"39101",274,197,192,3,5,"PODEMOS-IU-EQUO",46
5,"5037",255,173,172,1,1,"PODEMOS-IU-EQUO",13
45,"45056",2201,1260,1243,12,17,"PODEMOS-IU-EQUO",225
16,"16213",36,34,34,0,0,"PODEMOS-IU-EQUO",8
9,"9414",189,148,146,0,2,"PODEMOS-IU-EQUO",8
19,"19051",67,63,63,0,0,"PODEMOS-IU-EQUO",6
24,"24901",889,636,623,5,13,"PODEMOS-IU-EQUO",128
19,"19293",1867,1358,1342,7,16,"PODEMOS-IU-EQUO",365
9,"9280",28,20,20,0,0,"PODEMOS-IU-EQUO",0
5,"5246",59,46,44,0,2,"PODEMOS-IU-EQUO",2
37,"37178",100,76,75,0,1,"PODEMOS-IU-EQUO",1
16,"16024",129,98,97,0,1,"PODEMOS-IU-EQUO",18
16,"16270",162,137,137,0,0,"PODEMOS-IU-EQUO",12
42,"42145",138,108,107,2,1,"PODEMOS-IU-EQUO",11
6,"6050",4106,3134,3075,25,59,"PODEMOS-IU-EQUO",320
37,"37050",66,52,52,0,0,"PODEMOS-IU-EQUO",0
42,"42097",23,14,11,0,3,"PODEMOS-IU-EQUO",0
5,"5116",109,89,89,1,0,"PODEMOS-IU-EQUO",9
37,"37133",111,78,73,1,5,"PODEMOS-IU-EQUO",6
26,"26121",25,22,22,0,0,"PODEMOS-IU-EQUO",2
26,"26032",51,41,39,0,2,"PODEMOS-IU-EQUO",6
16,"16198",1348,981,971,10,10,"PODEMOS-IU-EQUO",98
39,"39028",3739,2850,2817,16,33,"PODEMOS-IU-EQUO",474
37,"37325",89,62,62,0,0,"PODEMOS-IU-EQUO",8
24,"24191",108,79,79,0,0,"PODEMOS-IU-EQUO",7
6,"6053",602,454,444,3,10,"PODEMOS-IU-EQUO",61
24,"24199",424,302,301,0,1,"PODEMOS-IU-EQUO",48
38,"38029",1517,744,734,1,10,"PODEMOS-IU-EQUO",126
10,"10037",76232,55104,54464,418,640,"PODEMOS-IU-EQUO",9173
10,"10022",427,349,341,0,8,"PODEMOS-IU-EQUO",58
10,"10035",1920,1343,1315,5,28,"PODEMOS-IU-EQUO",225
39,"39048",1716,1329,1312,12,17,"PODEMOS-IU-EQUO",223
10,"10036",329,241,238,1,3,"PODEMOS-IU-EQUO",34
9,"9351",62,49,48,1,1,"PODEMOS-IU-EQUO",4
9,"9460",176,131,131,1,0,"PODEMOS-IU-EQUO",12
16,"16122",249,188,187,0,1,"PODEMOS-IU-EQUO",21
9,"9451",238,191,190,0,1,"PODEMOS-IU-EQUO",39
34,"34159",357,253,248,4,5,"PODEMOS-IU-EQUO",52
19,"19153",22,17,17,0,0,"PODEMOS-IU-EQUO",7
37,"37197",84,57,57,2,0,"PODEMOS-IU-EQUO",9
13,"13095",85,66,66,0,0,"PODEMOS-IU-EQUO",5
10,"10005",540,377,362,3,15,"PODEMOS-IU-EQUO",25
9,"9242",80,66,66,2,0,"PODEMOS-IU-EQUO",0
16,"16219",89,71,71,0,0,"PODEMOS-IU-EQUO",13
19,"19143",1738,1306,1297,12,9,"PODEMOS-IU-EQUO",165
5,"5104",35,28,28,0,0,"PODEMOS-IU-EQUO",7
9,"9411",151,102,101,0,1,"PODEMOS-IU-EQUO",22
39,"39058",810,559,557,2,2,"PODEMOS-IU-EQUO",122
9,"9448",212,169,165,0,4,"PODEMOS-IU-EQUO",12
38,"38001",20228,11032,10936,47,96,"PODEMOS-IU-EQUO",2140
9,"9016",85,60,59,3,1,"PODEMOS-IU-EQUO",8
42,"42176",29,25,25,0,0,"PODEMOS-IU-EQUO",1
5,"5157",232,162,159,1,3,"PODEMOS-IU-EQUO",17
10,"10102",529,411,405,5,6,"PODEMOS-IU-EQUO",31
10,"10114",953,665,660,3,5,"PODEMOS-IU-EQUO",170
45,"45196",1400,1047,1033,5,14,"PODEMOS-IU-EQUO",93
24,"24216",723,522,518,1,4,"PODEMOS-IU-EQUO",38
24,"24177",476,325,322,3,3,"PODEMOS-IU-EQUO",26
16,"16166",243,176,174,1,2,"PODEMOS-IU-EQUO",13
9,"9012",89,64,63,0,1,"PODEMOS-IU-EQUO",5
2,"2046",1098,896,878,12,18,"PODEMOS-IU-EQUO",134
37,"37274",118913,85506,84764,566,742,"PODEMOS-IU-EQUO",12178
45,"45057",222,180,177,1,3,"PODEMOS-IU-EQUO",9
19,"19019",20,18,17,0,1,"PODEMOS-IU-EQUO",3
34,"34121",187,148,148,3,0,"PODEMOS-IU-EQUO",7
9,"9176",63,47,46,2,1,"PODEMOS-IU-EQUO",6
19,"19190",2369,1760,1745,10,15,"PODEMOS-IU-EQUO",352
39,"39060",6679,5196,5121,29,75,"PODEMOS-IU-EQUO",1086
13,"13029",84,71,71,0,0,"PODEMOS-IU-EQUO",8
42,"42106",14,10,10,0,0,"PODEMOS-IU-EQUO",0
5,"5058",78,49,48,0,1,"PODEMOS-IU-EQUO",10
13,"13006",597,456,447,4,9,"PODEMOS-IU-EQUO",22
37,"37374",1166,935,919,9,16,"PODEMOS-IU-EQUO",63
37,"37189",121,88,88,0,0,"PODEMOS-IU-EQUO",4
6,"6119",689,501,499,4,2,"PODEMOS-IU-EQUO",30
16,"16035",261,203,198,4,5,"PODEMOS-IU-EQUO",30
16,"16240",102,78,78,0,0,"PODEMOS-IU-EQUO",12
37,"37276",143,104,103,1,1,"PODEMOS-IU-EQUO",4
19,"19195",40,32,32,1,0,"PODEMOS-IU-EQUO",5
13,"13092",1846,1477,1462,5,15,"PODEMOS-IU-EQUO",92
37,"37129",251,204,201,3,3,"PODEMOS-IU-EQUO",32
9,"9059",136488,101469,100463,907,1006,"PODEMOS-IU-EQUO",17182
19,"19031",15,9,9,0,0,"PODEMOS-IU-EQUO",2
19,"19200",71,52,52,1,0,"PODEMOS-IU-EQUO",12
39,"39004",1518,1090,1074,4,16,"PODEMOS-IU-EQUO",171
19,"19298",65,45,45,0,0,"PODEMOS-IU-EQUO",5
45,"45193",613,504,497,1,7,"PODEMOS-IU-EQUO",65
45,"45109",2883,2271,2214,9,57,"PODEMOS-IU-EQUO",200
5,"5078",115,91,89,1,2,"PODEMOS-IU-EQUO",5
24,"24065",2138,1503,1472,15,31,"PODEMOS-IU-EQUO",230
45,"45088",2115,1351,1338,4,13,"PODEMOS-IU-EQUO",203
42,"42051",20,14,14,1,0,"PODEMOS-IU-EQUO",0
35,"35009",19905,14185,13961,89,224,"PODEMOS-IU-EQUO",2556
34,"34210",103,90,90,0,0,"PODEMOS-IU-EQUO",10
35,"35005",1048,747,737,8,10,"PODEMOS-IU-EQUO",90
5,"5115",523,378,373,0,5,"PODEMOS-IU-EQUO",38
30,"30902",7975,5318,5273,24,45,"PODEMOS-IU-EQUO",849
24,"24116",417,314,309,1,5,"PODEMOS-IU-EQUO",31
2,"2066",234,189,187,1,2,"PODEMOS-IU-EQUO",19
13,"13075",211,164,161,1,3,"PODEMOS-IU-EQUO",7
5,"5228",174,121,120,0,1,"PODEMOS-IU-EQUO",3
37,"37262",78,64,63,0,1,"PODEMOS-IU-EQUO",1
19,"19170",193,135,135,0,0,"PODEMOS-IU-EQUO",29
16,"16196",633,508,503,2,5,"PODEMOS-IU-EQUO",73
5,"5015",82,61,61,1,0,"PODEMOS-IU-EQUO",16
37,"37182",75,56,55,0,1,"PODEMOS-IU-EQUO",3
9,"9377",632,485,480,1,5,"PODEMOS-IU-EQUO",34
37,"37106",258,165,162,0,3,"PODEMOS-IU-EQUO",7
24,"24098",1193,842,831,11,11,"PODEMOS-IU-EQUO",188
34,"34904",315,234,230,2,4,"PODEMOS-IU-EQUO",31
26,"26065",50,43,42,0,1,"PODEMOS-IU-EQUO",5
24,"24162",1683,1257,1246,13,11,"PODEMOS-IU-EQUO",246
9,"9480",110,90,90,1,0,"PODEMOS-IU-EQUO",5
5,"5107",62,39,39,0,0,"PODEMOS-IU-EQUO",3
9,"9256",354,258,258,2,0,"PODEMOS-IU-EQUO",36
6,"6901",2118,1559,1546,23,13,"PODEMOS-IU-EQUO",171
24,"24023",263,188,188,1,0,"PODEMOS-IU-EQUO",42
19,"19284",10,10,9,0,1,"PODEMOS-IU-EQUO",1
24,"24127",296,226,215,4,11,"PODEMOS-IU-EQUO",13
9,"9386",54,39,38,1,1,"PODEMOS-IU-EQUO",4
5,"5024",224,169,168,3,1,"PODEMOS-IU-EQUO",18
2,"2016",569,413,410,6,3,"PODEMOS-IU-EQUO",44
16,"16065",388,320,314,2,6,"PODEMOS-IU-EQUO",28
19,"19210",21,19,18,1,1,"PODEMOS-IU-EQUO",1
6,"6004",1600,1212,1207,2,5,"PODEMOS-IU-EQUO",94
42,"42111",303,229,227,2,2,"PODEMOS-IU-EQUO",32
10,"10219",1276,796,790,7,6,"PODEMOS-IU-EQUO",109
37,"37125",228,161,156,0,5,"PODEMOS-IU-EQUO",17
19,"19054",192,164,164,1,0,"PODEMOS-IU-EQUO",8
5,"5158",367,290,286,6,4,"PODEMOS-IU-EQUO",21
37,"37290",141,113,113,0,0,"PODEMOS-IU-EQUO",14
5,"5094",139,116,116,1,0,"PODEMOS-IU-EQUO",5
9,"9267",111,99,97,1,2,"PODEMOS-IU-EQUO",3
37,"37056",37,30,29,0,1,"PODEMOS-IU-EQUO",0
10,"10112",1571,1107,1081,9,26,"PODEMOS-IU-EQUO",78
13,"13094",304,249,247,1,2,"PODEMOS-IU-EQUO",14
37,"37110",113,86,86,1,0,"PODEMOS-IU-EQUO",8
37,"37165",33,26,25,0,1,"PODEMOS-IU-EQUO",2
6,"6008",632,525,519,2,6,"PODEMOS-IU-EQUO",41
6,"6146",1084,838,830,1,8,"PODEMOS-IU-EQUO",120
13,"13091",538,450,446,0,4,"PODEMOS-IU-EQUO",28
37,"37171",409,317,310,2,7,"PODEMOS-IU-EQUO",8
19,"19197",27,22,22,0,0,"PODEMOS-IU-EQUO",7
45,"45052",2948,2321,2295,16,26,"PODEMOS-IU-EQUO",419
26,"26008",1860,1399,1387,5,12,"PODEMOS-IU-EQUO",104
34,"34127",93,65,64,1,1,"PODEMOS-IU-EQUO",10
19,"19092",409,306,300,1,6,"PODEMOS-IU-EQUO",39
19,"19121",246,199,194,1,5,"PODEMOS-IU-EQUO",17
42,"42093",37,29,28,1,1,"PODEMOS-IU-EQUO",2
19,"19231",10,9,9,0,0,"PODEMOS-IU-EQUO",0
19,"19211",369,289,284,0,5,"PODEMOS-IU-EQUO",44
16,"16244",718,593,587,6,6,"PODEMOS-IU-EQUO",52
2,"2072",1549,1086,1070,2,16,"PODEMOS-IU-EQUO",125
13,"13081",636,480,472,9,8,"PODEMOS-IU-EQUO",40
34,"34135",399,293,289,0,4,"PODEMOS-IU-EQUO",39
37,"37186",104,85,85,2,0,"PODEMOS-IU-EQUO",8
16,"16083",52,33,33,0,0,"PODEMOS-IU-EQUO",3
39,"39047",1962,1385,1371,10,14,"PODEMOS-IU-EQUO",210
6,"6069",3065,2053,2035,14,18,"PODEMOS-IU-EQUO",167
26,"26092",107,92,90,0,2,"PODEMOS-IU-EQUO",4
6,"6113",2721,2004,1971,7,33,"PODEMOS-IU-EQUO",344
30,"30009",12433,9586,9503,41,83,"PODEMOS-IU-EQUO",1344
26,"26120",1454,1139,1126,7,13,"PODEMOS-IU-EQUO",162
16,"16266",368,264,259,1,5,"PODEMOS-IU-EQUO",9
9,"9231",69,38,38,1,0,"PODEMOS-IU-EQUO",1
37,"37365",172,134,133,1,1,"PODEMOS-IU-EQUO",8
34,"34146",51,40,39,0,1,"PODEMOS-IU-EQUO",6
19,"19156",970,704,699,4,5,"PODEMOS-IU-EQUO",73
19,"19181",56,42,42,0,0,"PODEMOS-IU-EQUO",6
16,"16145",450,363,361,5,2,"PODEMOS-IU-EQUO",52
42,"42217",31,25,24,0,1,"PODEMOS-IU-EQUO",3
34,"34103",98,77,76,0,1,"PODEMOS-IU-EQUO",2
19,"19076",27,19,19,0,0,"PODEMOS-IU-EQUO",0
9,"9063",209,168,167,2,1,"PODEMOS-IU-EQUO",10
13,"13046",724,529,525,1,4,"PODEMOS-IU-EQUO",42
5,"5231",165,133,133,2,0,"PODEMOS-IU-EQUO",0
24,"24015",2265,1649,1635,18,14,"PODEMOS-IU-EQUO",154
26,"26017",381,293,293,5,0,"PODEMOS-IU-EQUO",77
24,"24025",297,228,227,0,1,"PODEMOS-IU-EQUO",12
5,"5161",579,459,447,3,12,"PODEMOS-IU-EQUO",47
37,"37134",230,168,165,0,3,"PODEMOS-IU-EQUO",18
19,"19252",69,60,60,0,0,"PODEMOS-IU-EQUO",5
26,"26054",320,263,260,4,3,"PODEMOS-IU-EQUO",14
24,"24053",442,286,280,1,6,"PODEMOS-IU-EQUO",21
34,"34208",51,42,42,0,0,"PODEMOS-IU-EQUO",1
30,"30038",15411,10847,10767,46,80,"PODEMOS-IU-EQUO",1416
45,"45005",238,193,192,3,1,"PODEMOS-IU-EQUO",32
38,"38010",4008,2733,2661,19,72,"PODEMOS-IU-EQUO",508
10,"10088",204,131,128,1,3,"PODEMOS-IU-EQUO",10
34,"34160",139,115,114,3,1,"PODEMOS-IU-EQUO",16
45,"45132",2197,1645,1632,14,13,"PODEMOS-IU-EQUO",165
5,"5013",868,728,721,6,7,"PODEMOS-IU-EQUO",189
37,"37300",566,398,395,0,3,"PODEMOS-IU-EQUO",68
19,"19118",11,9,9,0,0,"PODEMOS-IU-EQUO",2
13,"13062",574,453,448,3,5,"PODEMOS-IU-EQUO",51
19,"19021",1030,759,744,7,15,"PODEMOS-IU-EQUO",94
9,"9039",58,46,46,2,0,"PODEMOS-IU-EQUO",4
45,"45013",1758,1352,1329,8,23,"PODEMOS-IU-EQUO",88
16,"16098",561,456,454,3,2,"PODEMOS-IU-EQUO",60
45,"45099",3500,2390,2361,9,29,"PODEMOS-IU-EQUO",497
42,"42087",49,43,42,0,1,"PODEMOS-IU-EQUO",14
37,"37002",139,87,86,0,1,"PODEMOS-IU-EQUO",4
19,"19302",59,49,49,1,0,"PODEMOS-IU-EQUO",4
9,"9105",109,86,81,1,5,"PODEMOS-IU-EQUO",19
5,"5211",459,345,343,1,2,"PODEMOS-IU-EQUO",26
10,"10124",852,665,655,2,10,"PODEMOS-IU-EQUO",85
9,"9054",101,68,66,1,2,"PODEMOS-IU-EQUO",17
9,"9215",368,256,256,2,0,"PODEMOS-IU-EQUO",47
16,"16040",80,62,62,0,0,"PODEMOS-IU-EQUO",9
10,"10144",975,746,735,3,11,"PODEMOS-IU-EQUO",60
26,"26128",105,81,81,1,0,"PODEMOS-IU-EQUO",15
37,"37096",214,166,163,2,3,"PODEMOS-IU-EQUO",10
16,"16254",214,174,170,2,4,"PODEMOS-IU-EQUO",27
5,"5247",241,138,138,1,0,"PODEMOS-IU-EQUO",17
30,"30026",15734,10007,9901,51,106,"PODEMOS-IU-EQUO",1257
34,"34177",179,149,149,2,0,"PODEMOS-IU-EQUO",17
24,"24006",472,353,347,0,6,"PODEMOS-IU-EQUO",25
2,"2086",2586,1701,1687,7,14,"PODEMOS-IU-EQUO",159
35,"35028",9776,5476,5401,43,75,"PODEMOS-IU-EQUO",1057
42,"42056",23,20,20,0,0,"PODEMOS-IU-EQUO",2
19,"19186",81,68,68,0,0,"PODEMOS-IU-EQUO",6
39,"39082",1653,1173,1157,11,16,"PODEMOS-IU-EQUO",100
37,"37224",206,183,175,3,8,"PODEMOS-IU-EQUO",8
30,"30010",6869,5194,5142,21,52,"PODEMOS-IU-EQUO",572
16,"16058",103,77,77,0,0,"PODEMOS-IU-EQUO",7
6,"6902",1667,1121,1113,13,8,"PODEMOS-IU-EQUO",124
19,"19332",92,71,69,1,2,"PODEMOS-IU-EQUO",8
37,"37136",652,440,435,3,5,"PODEMOS-IU-EQUO",41
45,"45066",7570,5550,5484,25,66,"PODEMOS-IU-EQUO",709
24,"24166",1407,1013,993,8,20,"PODEMOS-IU-EQUO",109
9,"9257",93,81,80,4,1,"PODEMOS-IU-EQUO",8
34,"34049",359,266,260,1,6,"PODEMOS-IU-EQUO",31
2,"2085",322,253,252,2,1,"PODEMOS-IU-EQUO",20
9,"9258",172,141,139,5,2,"PODEMOS-IU-EQUO",4
6,"6047",849,639,628,2,11,"PODEMOS-IU-EQUO",73
16,"16107",109,86,85,1,1,"PODEMOS-IU-EQUO",6
45,"45161",13688,9007,8902,32,105,"PODEMOS-IU-EQUO",2176
37,"37007",437,314,306,3,8,"PODEMOS-IU-EQUO",21
37,"37179",209,180,180,0,0,"PODEMOS-IU-EQUO",16
9,"9125",584,432,430,1,2,"PODEMOS-IU-EQUO",40
16,"16002",187,158,158,1,0,"PODEMOS-IU-EQUO",7
5,"5002",1963,1422,1390,3,32,"PODEMOS-IU-EQUO",290
37,"37077",261,226,223,1,3,"PODEMOS-IU-EQUO",17
9,"9317",19,16,16,0,0,"PODEMOS-IU-EQUO",7
42,"42135",72,52,52,1,0,"PODEMOS-IU-EQUO",10
19,"19308",56,53,53,0,0,"PODEMOS-IU-EQUO",5
5,"5173",60,49,49,0,0,"PODEMOS-IU-EQUO",4
9,"9006",59,39,39,0,0,"PODEMOS-IU-EQUO",7
24,"24004",463,350,348,4,2,"PODEMOS-IU-EQUO",28
9,"9020",259,196,188,5,8,"PODEMOS-IU-EQUO",15
9,"9415",268,175,175,2,0,"PODEMOS-IU-EQUO",11
30,"30022",16913,11371,11214,93,157,"PODEMOS-IU-EQUO",1390
24,"24059",880,536,535,4,1,"PODEMOS-IU-EQUO",68
9,"9268",95,68,66,0,2,"PODEMOS-IU-EQUO",10
19,"19289",28,25,24,1,1,"PODEMOS-IU-EQUO",5
26,"26028",134,113,112,0,1,"PODEMOS-IU-EQUO",14
19,"19016",65,49,49,0,0,"PODEMOS-IU-EQUO",7
19,"19032",165,126,124,1,2,"PODEMOS-IU-EQUO",28
45,"45151",578,417,414,0,3,"PODEMOS-IU-EQUO",80
5,"5206",30,22,20,1,2,"PODEMOS-IU-EQUO",2
5,"5109",450,352,339,4,13,"PODEMOS-IU-EQUO",33
5,"5035",100,84,84,0,0,"PODEMOS-IU-EQUO",9
34,"34114",207,144,144,0,0,"PODEMOS-IU-EQUO",6
42,"42049",116,81,81,1,0,"PODEMOS-IU-EQUO",6
5,"5010",152,117,116,1,1,"PODEMOS-IU-EQUO",6
35,"35033",6398,4340,4266,19,74,"PODEMOS-IU-EQUO",772
19,"19175",32,28,28,0,0,"PODEMOS-IU-EQUO",2
9,"9058",390,283,279,1,4,"PODEMOS-IU-EQUO",53
16,"16906",80,67,67,1,0,"PODEMOS-IU-EQUO",6
10,"10101",185,145,141,1,4,"PODEMOS-IU-EQUO",21
30,"30021",9099,6095,6045,20,50,"PODEMOS-IU-EQUO",501
37,"37328",186,135,131,1,4,"PODEMOS-IU-EQUO",33
16,"16188",91,65,65,0,0,"PODEMOS-IU-EQUO",13
10,"10197",123,90,89,0,1,"PODEMOS-IU-EQUO",9
5,"5063",32,28,27,0,1,"PODEMOS-IU-EQUO",2
5,"5147",159,128,124,5,4,"PODEMOS-IU-EQUO",14
26,"26100",49,44,43,0,1,"PODEMOS-IU-EQUO",1
37,"37272",141,107,104,0,3,"PODEMOS-IU-EQUO",7
5,"5260",105,90,90,0,0,"PODEMOS-IU-EQUO",2
34,"34167",113,94,94,0,0,"PODEMOS-IU-EQUO",10
37,"37216",302,252,248,3,4,"PODEMOS-IU-EQUO",14
5,"5193",193,167,164,1,3,"PODEMOS-IU-EQUO",4
24,"24073",478,332,328,2,4,"PODEMOS-IU-EQUO",51
19,"19229",66,56,56,0,0,"PODEMOS-IU-EQUO",7
39,"39017",569,398,391,4,7,"PODEMOS-IU-EQUO",29
16,"16159",220,159,159,0,0,"PODEMOS-IU-EQUO",6
26,"26064",2275,1659,1638,17,21,"PODEMOS-IU-EQUO",289
19,"19145",46,41,41,1,0,"PODEMOS-IU-EQUO",3
9,"9024",156,112,110,1,2,"PODEMOS-IU-EQUO",14
10,"10154",181,131,129,0,2,"PODEMOS-IU-EQUO",20
10,"10200",392,306,302,1,4,"PODEMOS-IU-EQUO",18
16,"16066",2325,1788,1745,19,43,"PODEMOS-IU-EQUO",255
45,"45100",188,150,150,0,0,"PODEMOS-IU-EQUO",12
19,"19139",29,19,18,0,1,"PODEMOS-IU-EQUO",3
13,"13903",524,419,415,3,4,"PODEMOS-IU-EQUO",23
5,"5062",179,148,147,0,1,"PODEMOS-IU-EQUO",3
5,"5181",43,34,34,1,0,"PODEMOS-IU-EQUO",2
24,"24030",4277,3038,3007,11,31,"PODEMOS-IU-EQUO",680
16,"16099",203,153,147,0,6,"PODEMOS-IU-EQUO",16
19,"19317",139,110,109,1,1,"PODEMOS-IU-EQUO",29
42,"42129",681,503,495,3,8,"PODEMOS-IU-EQUO",53
9,"9450",28,22,21,0,1,"PODEMOS-IU-EQUO",4
26,"26089",110582,82972,82186,588,786,"PODEMOS-IU-EQUO",15401
37,"37014",1155,817,808,7,9,"PODEMOS-IU-EQUO",86
24,"24130",438,323,321,4,2,"PODEMOS-IU-EQUO",40
39,"39090",756,553,542,0,11,"PODEMOS-IU-EQUO",115
37,"37090",52,43,43,0,0,"PODEMOS-IU-EQUO",11
39,"39066",872,667,661,4,6,"PODEMOS-IU-EQUO",130
45,"45001",1835,1281,1251,3,30,"PODEMOS-IU-EQUO",155
42,"42054",19,16,16,0,0,"PODEMOS-IU-EQUO",4
19,"19046",21588,15689,15515,82,174,"PODEMOS-IU-EQUO",3334
10,"10020",1604,1185,1169,9,16,"PODEMOS-IU-EQUO",129
45,"45141",884,700,689,3,11,"PODEMOS-IU-EQUO",85
13,"13040",868,678,672,4,6,"PODEMOS-IU-EQUO",96
26,"26103",796,616,610,6,6,"PODEMOS-IU-EQUO",94
24,"24144",695,470,465,2,5,"PODEMOS-IU-EQUO",76
37,"37263",342,237,229,0,8,"PODEMOS-IU-EQUO",35
19,"19232",71,57,57,1,0,"PODEMOS-IU-EQUO",4
16,"16102",1205,912,905,12,7,"PODEMOS-IU-EQUO",63
5,"5086",80,67,67,2,0,"PODEMOS-IU-EQUO",1
2,"2901",2200,1440,1437,7,3,"PODEMOS-IU-EQUO",90
9,"9901",371,263,259,4,4,"PODEMOS-IU-EQUO",24
24,"24132",615,379,375,1,4,"PODEMOS-IU-EQUO",62
5,"5200",44,31,30,1,1,"PODEMOS-IU-EQUO",1
45,"45204",632,488,487,1,1,"PODEMOS-IU-EQUO",54
2,"2059",302,234,232,1,2,"PODEMOS-IU-EQUO",18
10,"10052",182,130,129,0,1,"PODEMOS-IU-EQUO",10
30,"30039",19277,13165,13054,75,111,"PODEMOS-IU-EQUO",1913
37,"37320",95,72,72,0,0,"PODEMOS-IU-EQUO",4
38,"38018",4402,3058,3011,16,47,"PODEMOS-IU-EQUO",310
34,"34034",123,95,95,1,0,"PODEMOS-IU-EQUO",17
16,"16279",203,128,127,1,1,"PODEMOS-IU-EQUO",10
16,"16119",169,127,127,0,0,"PODEMOS-IU-EQUO",29
45,"45067",2318,1791,1752,19,39,"PODEMOS-IU-EQUO",154
24,"24174",486,343,342,4,1,"PODEMOS-IU-EQUO",58
16,"16081",48,34,34,0,0,"PODEMOS-IU-EQUO",8
45,"45164",182,162,160,1,2,"PODEMOS-IU-EQUO",10
34,"34100",142,108,108,1,0,"PODEMOS-IU-EQUO",7
9,"9365",29,19,19,0,0,"PODEMOS-IU-EQUO",1
42,"42204",54,38,38,1,0,"PODEMOS-IU-EQUO",7
13,"13026",438,345,343,2,2,"PODEMOS-IU-EQUO",87
9,"9047",54,47,46,1,1,"PODEMOS-IU-EQUO",6
35,"35021",14924,10477,10370,45,107,"PODEMOS-IU-EQUO",2176
42,"42209",140,107,106,4,1,"PODEMOS-IU-EQUO",17
5,"5156",256,160,159,1,1,"PODEMOS-IU-EQUO",33
5,"5901",263,182,180,2,2,"PODEMOS-IU-EQUO",30
37,"37196",75,64,64,0,0,"PODEMOS-IU-EQUO",2
5,"5166",185,139,139,1,0,"PODEMOS-IU-EQUO",5
19,"19082",85,64,64,0,0,"PODEMOS-IU-EQUO",16
16,"16169",58,37,37,3,0,"PODEMOS-IU-EQUO",1
34,"34155",129,104,103,2,1,"PODEMOS-IU-EQUO",6
45,"45172",689,530,522,2,8,"PODEMOS-IU-EQUO",38
19,"19270",20,17,17,0,0,"PODEMOS-IU-EQUO",5
9,"9140",124,80,79,0,1,"PODEMOS-IU-EQUO",5
6,"6903",2021,1377,1360,12,17,"PODEMOS-IU-EQUO",173
5,"5253",86,70,68,0,2,"PODEMOS-IU-EQUO",11
42,"42105",50,45,45,0,0,"PODEMOS-IU-EQUO",1
10,"10025",400,327,318,1,9,"PODEMOS-IU-EQUO",48
5,"5172",123,93,93,1,0,"PODEMOS-IU-EQUO",5
26,"26050",113,88,85,0,3,"PODEMOS-IU-EQUO",14
26,"26144",188,155,155,3,0,"PODEMOS-IU-EQUO",10
13,"13047",5760,4295,4224,23,71,"PODEMOS-IU-EQUO",453
45,"45129",131,92,92,0,0,"PODEMOS-IU-EQUO",24
37,"37269",447,326,324,1,2,"PODEMOS-IU-EQUO",39
42,"42140",16,12,12,0,0,"PODEMOS-IU-EQUO",0
24,"24160",684,483,474,6,9,"PODEMOS-IU-EQUO",87
45,"45162",669,494,486,2,8,"PODEMOS-IU-EQUO",37
13,"13048",504,390,387,2,3,"PODEMOS-IU-EQUO",85
9,"9162",141,101,101,0,0,"PODEMOS-IU-EQUO",30
16,"16125",1667,1249,1231,3,18,"PODEMOS-IU-EQUO",109
24,"24049",1483,1054,1048,6,6,"PODEMOS-IU-EQUO",177
9,"9071",41,35,35,1,0,"PODEMOS-IU-EQUO",3
42,"42060",38,21,19,1,2,"PODEMOS-IU-EQUO",1
5,"5126",70,56,55,0,1,"PODEMOS-IU-EQUO",0
19,"19215",168,144,140,0,4,"PODEMOS-IU-EQUO",10
9,"9446",12,7,7,0,0,"PODEMOS-IU-EQUO",1
24,"24139",2183,1548,1525,16,23,"PODEMOS-IU-EQUO",182
37,"37229",135,112,112,0,0,"PODEMOS-IU-EQUO",7
10,"10125",888,635,622,4,13,"PODEMOS-IU-EQUO",69
5,"5089",485,384,376,0,8,"PODEMOS-IU-EQUO",50
19,"19311",82,69,67,0,2,"PODEMOS-IU-EQUO",7
10,"10064",1476,1092,1072,7,20,"PODEMOS-IU-EQUO",75
10,"10105",2512,1644,1620,12,24,"PODEMOS-IU-EQUO",182
19,"19202",8,6,6,0,0,"PODEMOS-IU-EQUO",2
19,"19045",140,120,120,0,0,"PODEMOS-IU-EQUO",4
10,"10029",414,339,333,0,6,"PODEMOS-IU-EQUO",36
16,"16173",205,157,156,0,1,"PODEMOS-IU-EQUO",18
6,"6042",1011,698,687,2,11,"PODEMOS-IU-EQUO",150
35,"35016",297736,192251,190256,1386,1995,"PODEMOS-IU-EQUO",45622
19,"19126",1627,1155,1134,11,21,"PODEMOS-IU-EQUO",238
26,"26027",157,112,108,0,4,"PODEMOS-IU-EQUO",13
19,"19074",72,62,62,0,0,"PODEMOS-IU-EQUO",29
45,"45087",8311,5828,5747,43,81,"PODEMOS-IU-EQUO",612
24,"24209",2769,1888,1865,12,23,"PODEMOS-IU-EQUO",314
19,"19115",24,18,18,0,0,"PODEMOS-IU-EQUO",0
9,"9418",82,62,61,1,1,"PODEMOS-IU-EQUO",3
9,"9194",2020,1472,1459,9,13,"PODEMOS-IU-EQUO",225
10,"10168",312,213,208,0,5,"PODEMOS-IU-EQUO",16
39,"39097",697,371,368,2,3,"PODEMOS-IU-EQUO",20
16,"16237",110,87,87,0,0,"PODEMOS-IU-EQUO",17
19,"19005",84,66,66,0,0,"PODEMOS-IU-EQUO",19
24,"24007",773,550,548,4,2,"PODEMOS-IU-EQUO",140
9,"9238",921,573,561,4,12,"PODEMOS-IU-EQUO",77
39,"39077",236,173,171,1,2,"PODEMOS-IU-EQUO",15
34,"34205",61,50,50,0,0,"PODEMOS-IU-EQUO",3
19,"19264",33,26,26,0,0,"PODEMOS-IU-EQUO",5
13,"13035",984,747,730,7,17,"PODEMOS-IU-EQUO",112
13,"13019",5181,3621,3579,18,42,"PODEMOS-IU-EQUO",777
2,"2056",1718,1296,1274,6,22,"PODEMOS-IU-EQUO",72
42,"42160",254,206,205,0,1,"PODEMOS-IU-EQUO",49
10,"10031",165,135,134,1,1,"PODEMOS-IU-EQUO",11
10,"10079",894,662,648,7,14,"PODEMOS-IU-EQUO",70
45,"45110",1786,1403,1398,5,5,"PODEMOS-IU-EQUO",48
10,"10032",1681,1257,1237,5,20,"PODEMOS-IU-EQUO",119
37,"37330",339,248,246,0,2,"PODEMOS-IU-EQUO",24
13,"13014",492,398,397,1,1,"PODEMOS-IU-EQUO",44
37,"37135",1207,905,899,15,6,"PODEMOS-IU-EQUO",105
42,"42205",89,71,71,2,0,"PODEMOS-IU-EQUO",5
19,"19266",236,188,188,1,0,"PODEMOS-IU-EQUO",13
16,"16211",370,263,263,3,0,"PODEMOS-IU-EQUO",23
34,"34046",41,36,35,0,1,"PODEMOS-IU-EQUO",2
9,"9128",80,63,63,0,0,"PODEMOS-IU-EQUO",10
19,"19048",18,15,15,1,0,"PODEMOS-IU-EQUO",4
13,"13038",1630,1230,1207,7,23,"PODEMOS-IU-EQUO",104
37,"37122",201,154,153,5,1,"PODEMOS-IU-EQUO",6
45,"45112",1922,1247,1211,6,36,"PODEMOS-IU-EQUO",155
16,"16038",38,31,31,0,0,"PODEMOS-IU-EQUO",1
19,"19171",4961,3670,3628,27,42,"PODEMOS-IU-EQUO",815
37,"37205",231,189,182,0,7,"PODEMOS-IU-EQUO",21
9,"9434",1227,922,909,6,13,"PODEMOS-IU-EQUO",182
19,"19132",92,81,81,0,0,"PODEMOS-IU-EQUO",4
24,"24020",456,314,307,4,7,"PODEMOS-IU-EQUO",30
26,"26114",79,66,65,1,1,"PODEMOS-IU-EQUO",4
5,"5134",48,38,38,0,0,"PODEMOS-IU-EQUO",0
35,"35019",32481,19318,19067,123,251,"PODEMOS-IU-EQUO",4034
19,"19281",21,15,15,2,0,"PODEMOS-IU-EQUO",2
2,"2032",276,207,202,1,5,"PODEMOS-IU-EQUO",47
42,"42149",381,277,273,2,4,"PODEMOS-IU-EQUO",45
19,"19244",82,65,64,1,1,"PODEMOS-IU-EQUO",5
24,"24155",471,388,384,6,4,"PODEMOS-IU-EQUO",40
9,"9227",119,91,89,4,2,"PODEMOS-IU-EQUO",19
39,"39040",4292,3208,3166,14,42,"PODEMOS-IU-EQUO",469
38,"38005",5468,3425,3392,18,33,"PODEMOS-IU-EQUO",495
5,"5054",1224,935,924,8,11,"PODEMOS-IU-EQUO",242
37,"37264",65,40,40,0,0,"PODEMOS-IU-EQUO",4
26,"26024",228,181,181,0,0,"PODEMOS-IU-EQUO",24
19,"19233",80,65,63,1,2,"PODEMOS-IU-EQUO",21
42,"42151",34,26,26,0,0,"PODEMOS-IU-EQUO",0
2,"2007",1030,824,818,4,6,"PODEMOS-IU-EQUO",122
16,"16186",456,375,371,0,4,"PODEMOS-IU-EQUO",36
24,"24088",1029,791,789,10,2,"PODEMOS-IU-EQUO",98
34,"34048",73,59,59,1,0,"PODEMOS-IU-EQUO",12
26,"26079",634,520,512,4,8,"PODEMOS-IU-EQUO",56
37,"37207",287,195,193,1,2,"PODEMOS-IU-EQUO",27
37,"37139",205,169,168,2,1,"PODEMOS-IU-EQUO",30
30,"30006",803,691,685,2,6,"PODEMOS-IU-EQUO",69
9,"9311",59,46,45,0,1,"PODEMOS-IU-EQUO",8
38,"38051",7194,5158,5080,31,78,"PODEMOS-IU-EQUO",434
37,"37270",189,152,151,2,1,"PODEMOS-IU-EQUO",4
16,"16209",116,101,101,2,0,"PODEMOS-IU-EQUO",14
5,"5139",74,65,65,0,0,"PODEMOS-IU-EQUO",2
6,"6076",831,611,607,2,4,"PODEMOS-IU-EQUO",148
6,"6117",1424,960,938,4,22,"PODEMOS-IU-EQUO",42
2,"2008",1193,857,847,7,10,"PODEMOS-IU-EQUO",103
16,"16265",20,19,19,0,0,"PODEMOS-IU-EQUO",0
9,"9471",149,114,114,1,0,"PODEMOS-IU-EQUO",24
26,"26015",196,158,157,2,1,"PODEMOS-IU-EQUO",14
19,"19053",2008,1422,1404,10,18,"PODEMOS-IU-EQUO",207
6,"6057",576,479,471,0,8,"PODEMOS-IU-EQUO",22
5,"5187",1754,1323,1303,7,20,"PODEMOS-IU-EQUO",262
10,"10131",12861,8813,8721,52,92,"PODEMOS-IU-EQUO",1209
16,"16074",37,30,30,1,0,"PODEMOS-IU-EQUO",3
2,"2009",19660,14256,14116,127,140,"PODEMOS-IU-EQUO",2551
9,"9325",190,130,129,2,1,"PODEMOS-IU-EQUO",14
45,"45105",392,301,297,3,4,"PODEMOS-IU-EQUO",11
24,"24215",152,113,113,0,0,"PODEMOS-IU-EQUO",6
26,"26071",8491,5834,5761,47,73,"PODEMOS-IU-EQUO",1202
24,"24057",1373,1045,1023,11,22,"PODEMOS-IU-EQUO",177
9,"9045",268,181,181,4,0,"PODEMOS-IU-EQUO",27
2,"2037",22865,14632,14477,91,155,"PODEMOS-IU-EQUO",1814
6,"6074",4791,3513,3449,18,64,"PODEMOS-IU-EQUO",543
37,"37351",281,229,227,0,2,"PODEMOS-IU-EQUO",6
26,"26049",172,125,122,1,3,"PODEMOS-IU-EQUO",16
38,"38022",18450,12334,12160,62,174,"PODEMOS-IU-EQUO",1050
35,"35006",30457,21398,21118,162,280,"PODEMOS-IU-EQUO",4711
13,"13013",7068,5147,5063,25,84,"PODEMOS-IU-EQUO",500
6,"6075",465,383,372,0,11,"PODEMOS-IU-EQUO",27
19,"19310",9,7,7,0,0,"PODEMOS-IU-EQUO",3
9,"9309",301,224,220,0,4,"PODEMOS-IU-EQUO",33
39,"39044",3849,2765,2732,21,33,"PODEMOS-IU-EQUO",544
5,"5238",782,565,563,5,2,"PODEMOS-IU-EQUO",75
34,"34199",1218,918,899,10,19,"PODEMOS-IU-EQUO",140
37,"37083",182,156,155,0,1,"PODEMOS-IU-EQUO",17
39,"39045",367,271,268,1,3,"PODEMOS-IU-EQUO",34
37,"37297",425,328,322,2,6,"PODEMOS-IU-EQUO",12
9,"9442",375,279,277,2,2,"PODEMOS-IU-EQUO",33
9,"9196",149,103,103,1,0,"PODEMOS-IU-EQUO",20
10,"10028",90,73,73,0,0,"PODEMOS-IU-EQUO",9
6,"6077",341,256,249,0,7,"PODEMOS-IU-EQUO",52
37,"37204",276,198,195,1,3,"PODEMOS-IU-EQUO",17
45,"45086",496,351,343,2,8,"PODEMOS-IU-EQUO",34
35,"35010",3558,2341,2301,28,40,"PODEMOS-IU-EQUO",415
34,"34901",1104,825,814,5,11,"PODEMOS-IU-EQUO",59
45,"45008",139,118,118,1,0,"PODEMOS-IU-EQUO",6
13,"13067",351,281,279,0,2,"PODEMOS-IU-EQUO",52
5,"5144",76,55,54,0,1,"PODEMOS-IU-EQUO",1
19,"19179",69,56,56,1,0,"PODEMOS-IU-EQUO",8
30,"30901",10309,7821,7718,43,103,"PODEMOS-IU-EQUO",1216
10,"10075",253,167,166,1,1,"PODEMOS-IU-EQUO",37
16,"16193",66,49,48,0,1,"PODEMOS-IU-EQUO",1
19,"19216",131,98,98,0,0,"PODEMOS-IU-EQUO",34
9,"9073",926,691,686,4,5,"PODEMOS-IU-EQUO",148
30,"30004",1137,870,862,3,8,"PODEMOS-IU-EQUO",91
13,"13086",175,137,134,0,3,"PODEMOS-IU-EQUO",10
16,"16905",1224,920,910,4,10,"PODEMOS-IU-EQUO",167
42,"42062",22,12,12,0,0,"PODEMOS-IU-EQUO",3
19,"19168",292,204,198,1,6,"PODEMOS-IU-EQUO",34
19,"19089",30,22,22,0,0,"PODEMOS-IU-EQUO",2
19,"19018",155,119,118,3,1,"PODEMOS-IU-EQUO",11
16,"16006",120,98,96,3,2,"PODEMOS-IU-EQUO",8
9,"9444",72,58,58,3,0,"PODEMOS-IU-EQUO",4
13,"13018",822,642,640,6,2,"PODEMOS-IU-EQUO",63
19,"19059",77,61,58,1,3,"PODEMOS-IU-EQUO",0
9,"9178",47,35,35,0,0,"PODEMOS-IU-EQUO",4
34,"34120",64214,47193,46683,331,510,"PODEMOS-IU-EQUO",7773
42,"42094",621,444,433,10,11,"PODEMOS-IU-EQUO",87
42,"42202",20,14,13,0,1,"PODEMOS-IU-EQUO",0
37,"37175",403,314,312,6,2,"PODEMOS-IU-EQUO",24
16,"16160",60,44,42,1,2,"PODEMOS-IU-EQUO",1
5,"5131",99,69,69,0,0,"PODEMOS-IU-EQUO",0
26,"26124",807,649,639,7,10,"PODEMOS-IU-EQUO",53
37,"37260",150,116,116,1,0,"PODEMOS-IU-EQUO",18
42,"42174",174,137,135,5,2,"PODEMOS-IU-EQUO",40
45,"45155",355,291,285,0,6,"PODEMOS-IU-EQUO",29
39,"39018",4220,3264,3204,35,60,"PODEMOS-IU-EQUO",758
9,"9445",44,32,32,3,0,"PODEMOS-IU-EQUO",3
5,"5175",159,131,131,1,0,"PODEMOS-IU-EQUO",18
26,"26021",2827,2098,2076,15,22,"PODEMOS-IU-EQUO",213
9,"9378",31,24,23,0,1,"PODEMOS-IU-EQUO",4
9,"9021",56,33,31,1,2,"PODEMOS-IU-EQUO",7
19,"19323",40,31,31,0,0,"PODEMOS-IU-EQUO",4
34,"34140",107,67,67,0,0,"PODEMOS-IU-EQUO",5
19,"19319",4449,3086,3056,18,30,"PODEMOS-IU-EQUO",717
19,"19255",79,63,61,1,2,"PODEMOS-IU-EQUO",6
9,"9123",40,35,35,0,0,"PODEMOS-IU-EQUO",6
13,"13021",434,365,363,4,2,"PODEMOS-IU-EQUO",48
26,"26125",2699,1931,1907,23,24,"PODEMOS-IU-EQUO",152
34,"34060",137,111,108,0,3,"PODEMOS-IU-EQUO",13
10,"10049",3819,3031,2950,18,81,"PODEMOS-IU-EQUO",310
42,"42041",34,25,25,0,0,"PODEMOS-IU-EQUO",1
16,"16258",194,150,150,1,0,"PODEMOS-IU-EQUO",10
10,"10004",704,492,482,9,10,"PODEMOS-IU-EQUO",37
24,"24198",592,412,407,2,5,"PODEMOS-IU-EQUO",52
24,"24097",218,140,139,3,1,"PODEMOS-IU-EQUO",20
35,"35002",23328,15495,15313,94,182,"PODEMOS-IU-EQUO",3653
9,"9316",105,80,80,1,0,"PODEMOS-IU-EQUO",8
24,"24031",215,172,168,0,4,"PODEMOS-IU-EQUO",22
38,"38041",6821,4908,4861,40,47,"PODEMOS-IU-EQUO",826
16,"16041",358,275,271,0,4,"PODEMOS-IU-EQUO",33
37,"37137",105,66,66,0,0,"PODEMOS-IU-EQUO",1
45,"45080",6,6,6,0,0,"PODEMOS-IU-EQUO",0
37,"37123",177,126,126,0,0,"PODEMOS-IU-EQUO",1
9,"9055",52,42,41,1,1,"PODEMOS-IU-EQUO",3
45,"45146",107,84,83,0,1,"PODEMOS-IU-EQUO",5
9,"9437",282,219,218,3,1,"PODEMOS-IU-EQUO",14
16,"16103",261,222,222,0,0,"PODEMOS-IU-EQUO",12
24,"24032",109,91,89,0,2,"PODEMOS-IU-EQUO",11
19,"19221",48,38,37,1,1,"PODEMOS-IU-EQUO",1
26,"26046",1581,1175,1159,4,16,"PODEMOS-IU-EQUO",187
9,"9466",129,97,97,1,0,"PODEMOS-IU-EQUO",6
16,"16151",64,61,59,0,2,"PODEMOS-IU-EQUO",6
19,"19294",29,27,27,0,0,"PODEMOS-IU-EQUO",10
6,"6162",2934,2182,2162,14,20,"PODEMOS-IU-EQUO",169
42,"42132",141,114,114,0,0,"PODEMOS-IU-EQUO",7
37,"37306",259,186,183,1,3,"PODEMOS-IU-EQUO",5
13,"13025",302,244,244,1,0,"PODEMOS-IU-EQUO",13
24,"24197",763,538,533,1,5,"PODEMOS-IU-EQUO",65
37,"37167",173,143,140,2,3,"PODEMOS-IU-EQUO",25
19,"19331",2609,1872,1844,12,28,"PODEMOS-IU-EQUO",290
5,"5213",103,84,82,0,2,"PODEMOS-IU-EQUO",6
24,"24037",360,254,250,2,4,"PODEMOS-IU-EQUO",37
9,"9373",425,287,285,2,2,"PODEMOS-IU-EQUO",19
42,"42006",163,109,107,2,2,"PODEMOS-IU-EQUO",19
34,"34093",85,70,70,0,0,"PODEMOS-IU-EQUO",3
19,"19134",24,15,15,0,0,"PODEMOS-IU-EQUO",3
37,"37336",52,50,50,1,0,"PODEMOS-IU-EQUO",6
37,"37252",112,79,79,0,0,"PODEMOS-IU-EQUO",4
16,"16106",2727,2009,1989,12,20,"PODEMOS-IU-EQUO",212
37,"37307",159,104,103,1,1,"PODEMOS-IU-EQUO",6
9,"9273",52,40,39,2,1,"PODEMOS-IU-EQUO",7
24,"24203",95,69,68,0,1,"PODEMOS-IU-EQUO",11
13,"13080",351,266,266,2,0,"PODEMOS-IU-EQUO",35
9,"9274",1079,848,835,12,13,"PODEMOS-IU-EQUO",128
34,"34080",5560,3723,3665,32,58,"PODEMOS-IU-EQUO",498
37,"37323",516,376,372,5,4,"PODEMOS-IU-EQUO",20
19,"19152",556,390,382,1,8,"PODEMOS-IU-EQUO",66
39,"39054",4493,3376,3334,33,42,"PODEMOS-IU-EQUO",707
9,"9400",317,247,245,1,2,"PODEMOS-IU-EQUO",59
19,"19112",60,46,46,0,0,"PODEMOS-IU-EQUO",6
5,"5005",182,148,147,3,1,"PODEMOS-IU-EQUO",13
2,"2050",98,83,82,0,1,"PODEMOS-IU-EQUO",10
9,"9230",38,32,32,0,0,"PODEMOS-IU-EQUO",2
9,"9083",37,33,33,0,0,"PODEMOS-IU-EQUO",5
19,"19070",74,53,53,0,0,"PODEMOS-IU-EQUO",6
6,"6059",1851,1268,1258,7,10,"PODEMOS-IU-EQUO",145
9,"9326",140,112,111,0,1,"PODEMOS-IU-EQUO",14
24,"24136",540,387,383,4,4,"PODEMOS-IU-EQUO",32
34,"34178",117,103,103,0,0,"PODEMOS-IU-EQUO",11
42,"42168",107,80,80,0,0,"PODEMOS-IU-EQUO",13
5,"5207",692,547,543,0,4,"PODEMOS-IU-EQUO",57
24,"24170",1908,1365,1345,8,20,"PODEMOS-IU-EQUO",318
5,"5007",111,81,80,3,1,"PODEMOS-IU-EQUO",2
19,"19113",485,366,366,3,0,"PODEMOS-IU-EQUO",46
16,"16155",508,398,391,2,7,"PODEMOS-IU-EQUO",32
34,"34161",23,16,16,0,0,"PODEMOS-IU-EQUO",0
37,"37311",227,182,182,3,0,"PODEMOS-IU-EQUO",16
19,"19189",120,91,90,2,1,"PODEMOS-IU-EQUO",18
42,"42034",30,22,22,0,0,"PODEMOS-IU-EQUO",2
9,"9906",1219,902,898,8,4,"PODEMOS-IU-EQUO",136
9,"9117",76,60,60,0,0,"PODEMOS-IU-EQUO",4
45,"45068",160,126,126,0,0,"PODEMOS-IU-EQUO",18
45,"45179",525,391,386,3,5,"PODEMOS-IU-EQUO",34
26,"26029",37,32,32,0,0,"PODEMOS-IU-EQUO",4
2,"2013",119,92,90,0,2,"PODEMOS-IU-EQUO",11
39,"39076",3476,2594,2559,19,35,"PODEMOS-IU-EQUO",420
34,"34025",57,39,39,1,0,"PODEMOS-IU-EQUO",4
42,"42010",19,14,14,1,0,"PODEMOS-IU-EQUO",2
10,"10196",301,225,225,1,0,"PODEMOS-IU-EQUO",19
30,"30024",58746,42036,41731,206,305,"PODEMOS-IU-EQUO",4861
9,"9061",162,124,123,0,1,"PODEMOS-IU-EQUO",5
19,"19191",14,13,12,0,1,"PODEMOS-IU-EQUO",3
13,"13033",1633,1328,1290,4,38,"PODEMOS-IU-EQUO",112
37,"37160",615,434,429,8,5,"PODEMOS-IU-EQUO",28
37,"37024",89,67,67,0,0,"PODEMOS-IU-EQUO",1
9,"9478",41,32,32,1,0,"PODEMOS-IU-EQUO",5
16,"16251",1849,1381,1366,7,15,"PODEMOS-IU-EQUO",125
19,"19251",43,29,28,0,1,"PODEMOS-IU-EQUO",1
34,"34116",62,49,49,0,0,"PODEMOS-IU-EQUO",4
35,"35034",7873,3975,3943,27,32,"PODEMOS-IU-EQUO",1038
19,"19301",40,33,33,1,0,"PODEMOS-IU-EQUO",0
37,"37230",221,159,159,2,0,"PODEMOS-IU-EQUO",15
24,"24172",418,255,250,2,5,"PODEMOS-IU-EQUO",29
5,"5014",5379,4009,3970,18,39,"PODEMOS-IU-EQUO",716
16,"16273",321,242,236,3,6,"PODEMOS-IU-EQUO",14
45,"45165",62718,44420,44006,236,414,"PODEMOS-IU-EQUO",6245
42,"42080",157,117,115,0,2,"PODEMOS-IU-EQUO",7
16,"16194",242,185,179,1,6,"PODEMOS-IU-EQUO",18
24,"24061",1704,1213,1204,9,9,"PODEMOS-IU-EQUO",211
30,"30025",4908,3667,3630,16,37,"PODEMOS-IU-EQUO",450
6,"6156",1175,869,865,8,4,"PODEMOS-IU-EQUO",88
2,"2002",470,394,389,3,5,"PODEMOS-IU-EQUO",25
10,"10062",406,337,331,0,6,"PODEMOS-IU-EQUO",71
38,"38014",1357,935,926,3,9,"PODEMOS-IU-EQUO",129
9,"9419",78,55,55,0,0,"PODEMOS-IU-EQUO",1
13,"13088",610,458,453,6,5,"PODEMOS-IU-EQUO",33
9,"9195",59,36,36,2,0,"PODEMOS-IU-EQUO",8
26,"26101",44,36,35,0,1,"PODEMOS-IU-EQUO",2
37,"37316",744,563,558,3,5,"PODEMOS-IU-EQUO",42
34,"34029",714,587,570,3,17,"PODEMOS-IU-EQUO",35
16,"16022",78,67,66,0,1,"PODEMOS-IU-EQUO",9
26,"26109",81,69,69,0,0,"PODEMOS-IU-EQUO",10
42,"42031",26,21,21,0,0,"PODEMOS-IU-EQUO",2
37,"37359",184,130,129,0,1,"PODEMOS-IU-EQUO",12
6,"6128",4447,2975,2935,26,40,"PODEMOS-IU-EQUO",440
9,"9332",140,106,106,2,0,"PODEMOS-IU-EQUO",12
24,"24902",347,270,269,2,1,"PODEMOS-IU-EQUO",23
9,"9239",52,40,39,0,1,"PODEMOS-IU-EQUO",1
34,"34169",404,287,286,0,1,"PODEMOS-IU-EQUO",24
16,"16116",77,68,68,0,0,"PODEMOS-IU-EQUO",12
19,"19038",28,24,23,0,1,"PODEMOS-IU-EQUO",1
37,"37191",114,78,75,1,3,"PODEMOS-IU-EQUO",1
10,"10111",1325,970,949,2,21,"PODEMOS-IU-EQUO",107
13,"13039",14366,10282,10185,81,97,"PODEMOS-IU-EQUO",1498
24,"24009",322,153,152,2,1,"PODEMOS-IU-EQUO",38
26,"26067",22,15,15,1,0,"PODEMOS-IU-EQUO",2
19,"19160",886,558,552,2,6,"PODEMOS-IU-EQUO",138
2,"2018",829,661,653,1,8,"PODEMOS-IU-EQUO",48
24,"24212",1032,773,760,4,13,"PODEMOS-IU-EQUO",79
37,"37318",208,159,158,1,1,"PODEMOS-IU-EQUO",10
42,"42096",272,171,170,6,1,"PODEMOS-IU-EQUO",25
24,"24176",316,247,244,1,3,"PODEMOS-IU-EQUO",18
6,"6038",805,543,541,2,2,"PODEMOS-IU-EQUO",30
10,"10066",160,122,122,0,0,"PODEMOS-IU-EQUO",13
34,"34076",587,479,479,2,0,"PODEMOS-IU-EQUO",33
26,"26023",469,358,354,0,4,"PODEMOS-IU-EQUO",32
10,"10189",2630,1880,1851,4,29,"PODEMOS-IU-EQUO",281
9,"9041",28,27,27,0,0,"PODEMOS-IU-EQUO",4
5,"5135",425,317,315,5,2,"PODEMOS-IU-EQUO",21
2,"2047",117,88,88,2,0,"PODEMOS-IU-EQUO",5
19,"19109",39,32,32,0,0,"PODEMOS-IU-EQUO",1
24,"24022",330,230,229,0,1,"PODEMOS-IU-EQUO",49
10,"10067",10422,7113,7014,62,99,"PODEMOS-IU-EQUO",923
9,"9288",90,70,70,0,0,"PODEMOS-IU-EQUO",8
6,"6040",1009,648,645,1,3,"PODEMOS-IU-EQUO",38
34,"34225",4921,3588,3559,30,29,"PODEMOS-IU-EQUO",843
38,"38901",1405,900,887,3,13,"PODEMOS-IU-EQUO",144
34,"34077",347,244,238,4,6,"PODEMOS-IU-EQUO",34
9,"9095",84,61,61,0,0,"PODEMOS-IU-EQUO",1
45,"45093",155,129,127,1,2,"PODEMOS-IU-EQUO",6
24,"24089",102747,74428,73688,631,740,"PODEMOS-IU-EQUO",12032
35,"35027",10344,7310,7216,50,94,"PODEMOS-IU-EQUO",1232
9,"9416",53,35,35,0,0,"PODEMOS-IU-EQUO",20
42,"42181",412,313,307,2,6,"PODEMOS-IU-EQUO",48
37,"37168",439,316,311,0,5,"PODEMOS-IU-EQUO",33
5,"5106",35,25,25,0,0,"PODEMOS-IU-EQUO",2
10,"10053",287,215,210,1,5,"PODEMOS-IU-EQUO",11
42,"42044",54,42,39,0,3,"PODEMOS-IU-EQUO",4
9,"9229",198,146,143,0,3,"PODEMOS-IU-EQUO",11
16,"16073",185,164,164,1,0,"PODEMOS-IU-EQUO",7
19,"19163",56,41,40,0,1,"PODEMOS-IU-EQUO",14
2,"2022",351,281,279,1,2,"PODEMOS-IU-EQUO",27
16,"16901",675,506,501,6,5,"PODEMOS-IU-EQUO",50
9,"9200",50,32,31,0,1,"PODEMOS-IU-EQUO",3
19,"19122",96,68,68,1,0,"PODEMOS-IU-EQUO",14
26,"26059",1125,828,812,5,16,"PODEMOS-IU-EQUO",92
6,"6027",676,561,552,2,9,"PODEMOS-IU-EQUO",46
26,"26038",89,68,67,0,1,"PODEMOS-IU-EQUO",9
37,"37020",430,326,321,1,5,"PODEMOS-IU-EQUO",38
10,"10193",1412,1090,1078,6,12,"PODEMOS-IU-EQUO",57
10,"10117",255,135,134,0,1,"PODEMOS-IU-EQUO",11
5,"5220",371,309,301,0,8,"PODEMOS-IU-EQUO",33
34,"34229",68,57,56,1,1,"PODEMOS-IU-EQUO",9
37,"37115",123,89,87,0,2,"PODEMOS-IU-EQUO",3
37,"37049",137,96,96,1,0,"PODEMOS-IU-EQUO",7
24,"24047",783,545,540,2,5,"PODEMOS-IU-EQUO",48
5,"5904",127,88,87,1,1,"PODEMOS-IU-EQUO",22
16,"16206",204,158,157,6,1,"PODEMOS-IU-EQUO",25
42,"42009",78,63,63,0,0,"PODEMOS-IU-EQUO",3
5,"5189",449,351,349,2,2,"PODEMOS-IU-EQUO",65
6,"6120",3389,2502,2478,12,24,"PODEMOS-IU-EQUO",252
10,"10072",859,617,615,5,2,"PODEMOS-IU-EQUO",76
10,"10209",282,179,177,1,2,"PODEMOS-IU-EQUO",27
42,"42197",75,58,56,0,2,"PODEMOS-IU-EQUO",10
10,"10164",737,484,475,3,9,"PODEMOS-IU-EQUO",73
19,"19086",1473,1123,1111,7,12,"PODEMOS-IU-EQUO",150
45,"45106",7439,5613,5534,52,79,"PODEMOS-IU-EQUO",887
16,"16171",1800,1469,1443,8,26,"PODEMOS-IU-EQUO",97
45,"45074",414,327,323,1,4,"PODEMOS-IU-EQUO",39
26,"26145",246,197,197,2,0,"PODEMOS-IU-EQUO",25
37,"37158",246,183,183,0,0,"PODEMOS-IU-EQUO",36
10,"10089",1359,882,868,3,14,"PODEMOS-IU-EQUO",129
30,"30007",6411,4360,4329,24,31,"PODEMOS-IU-EQUO",550
19,"19201",58,49,48,1,1,"PODEMOS-IU-EQUO",6
24,"24182",416,294,290,2,4,"PODEMOS-IU-EQUO",39
16,"16063",97,85,84,1,1,"PODEMOS-IU-EQUO",5
34,"34069",2266,1666,1637,11,29,"PODEMOS-IU-EQUO",258
5,"5029",121,96,94,0,2,"PODEMOS-IU-EQUO",5
5,"5176",235,181,174,4,7,"PODEMOS-IU-EQUO",21
13,"13904",531,400,392,4,8,"PODEMOS-IU-EQUO",54
24,"24151",478,353,352,1,1,"PODEMOS-IU-EQUO",38
9,"9072",316,242,241,0,1,"PODEMOS-IU-EQUO",37
26,"26074",105,86,85,1,1,"PODEMOS-IU-EQUO",8
16,"16082",291,213,212,0,1,"PODEMOS-IU-EQUO",25
6,"6139",553,420,419,1,1,"PODEMOS-IU-EQUO",72
24,"24194",290,212,212,3,0,"PODEMOS-IU-EQUO",22
2,"2041",336,265,260,0,5,"PODEMOS-IU-EQUO",25
37,"37146",117,96,95,1,1,"PODEMOS-IU-EQUO",8
38,"38049",2655,1654,1627,8,27,"PODEMOS-IU-EQUO",240
39,"39006",1711,1307,1287,10,20,"PODEMOS-IU-EQUO",147
16,"16034",180,146,144,2,2,"PODEMOS-IU-EQUO",14
5,"5129",125,88,87,2,1,"PODEMOS-IU-EQUO",4
24,"24183",805,555,549,6,6,"PODEMOS-IU-EQUO",83
24,"24051",423,309,307,0,2,"PODEMOS-IU-EQUO",28
45,"45076",553,368,364,3,4,"PODEMOS-IU-EQUO",47
5,"5030",45,38,38,1,0,"PODEMOS-IU-EQUO",14
16,"16084",48,38,37,1,1,"PODEMOS-IU-EQUO",1
9,"9104",53,42,42,0,0,"PODEMOS-IU-EQUO",3
26,"26172",30,23,23,0,0,"PODEMOS-IU-EQUO",4
37,"37012",154,116,115,1,1,"PODEMOS-IU-EQUO",7
45,"45077",556,428,427,1,1,"PODEMOS-IU-EQUO",46
24,"24141",95,85,84,0,1,"PODEMOS-IU-EQUO",11
6,"6079",652,449,442,4,7,"PODEMOS-IU-EQUO",20
9,"9432",182,145,138,0,7,"PODEMOS-IU-EQUO",30
37,"37026",189,146,146,0,0,"PODEMOS-IU-EQUO",9
35,"35017",25676,15038,14716,94,322,"PODEMOS-IU-EQUO",3837
2,"2029",3282,2467,2445,17,22,"PODEMOS-IU-EQUO",417
9,"9301",625,473,467,2,6,"PODEMOS-IU-EQUO",76
19,"19278",28,26,26,0,0,"PODEMOS-IU-EQUO",0
45,"45078",1379,1129,1119,6,10,"PODEMOS-IU-EQUO",89
9,"9391",361,264,263,3,1,"PODEMOS-IU-EQUO",17
2,"2070",403,332,328,4,4,"PODEMOS-IU-EQUO",29
24,"24103",283,163,157,1,6,"PODEMOS-IU-EQUO",10
39,"39089",143,104,100,1,4,"PODEMOS-IU-EQUO",10
16,"16132",35,27,26,0,1,"PODEMOS-IU-EQUO",2
37,"37028",147,116,112,0,4,"PODEMOS-IU-EQUO",4
24,"24118",126,88,88,1,0,"PODEMOS-IU-EQUO",8
5,"5117",200,174,173,1,1,"PODEMOS-IU-EQUO",13
9,"9483",211,158,157,0,1,"PODEMOS-IU-EQUO",11
6,"6005",1696,1197,1178,1,19,"PODEMOS-IU-EQUO",112
19,"19242",87,65,65,1,0,"PODEMOS-IU-EQUO",7
30,"30037",18793,13150,13003,47,147,"PODEMOS-IU-EQUO",1331
10,"10216",1538,1175,1162,4,13,"PODEMOS-IU-EQUO",139
37,"37372",144,111,108,0,3,"PODEMOS-IU-EQUO",5
5,"5036",123,101,101,1,0,"PODEMOS-IU-EQUO",0
45,"45012",661,510,503,6,7,"PODEMOS-IU-EQUO",107
34,"34136",179,110,110,1,0,"PODEMOS-IU-EQUO",1
24,"24223",2610,1917,1908,39,9,"PODEMOS-IU-EQUO",283
39,"39009",3216,2366,2337,17,29,"PODEMOS-IU-EQUO",390
16,"16181",64,52,52,2,0,"PODEMOS-IU-EQUO",2
16,"16185",43,37,37,0,0,"PODEMOS-IU-EQUO",5
24,"24119",706,488,481,3,7,"PODEMOS-IU-EQUO",73
16,"16133",4389,3358,3316,24,42,"PODEMOS-IU-EQUO",909
10,"10127",4703,3183,3132,21,51,"PODEMOS-IU-EQUO",484
45,"45113",1915,1390,1366,6,24,"PODEMOS-IU-EQUO",106
19,"19172",57,48,47,0,1,"PODEMOS-IU-EQUO",9
42,"42163",50,41,40,0,1,"PODEMOS-IU-EQUO",17
16,"16088",108,88,87,0,1,"PODEMOS-IU-EQUO",14
9,"9270",163,115,115,0,0,"PODEMOS-IU-EQUO",4
9,"9137",174,132,131,3,1,"PODEMOS-IU-EQUO",19
35,"35020",6034,3992,3934,20,58,"PODEMOS-IU-EQUO",473
9,"9066",62,48,47,0,1,"PODEMOS-IU-EQUO",6
38,"38006",39766,20776,20587,139,189,"PODEMOS-IU-EQUO",3757
10,"10083",90,59,59,2,0,"PODEMOS-IU-EQUO",15
9,"9216",387,270,265,1,5,"PODEMOS-IU-EQUO",56
6,"6055",2051,1453,1422,8,31,"PODEMOS-IU-EQUO",132
13,"13007",1271,993,977,8,16,"PODEMOS-IU-EQUO",163
26,"26013",347,249,246,2,3,"PODEMOS-IU-EQUO",50
5,"5088",30,23,23,0,0,"PODEMOS-IU-EQUO",0
42,"42193",14,10,10,0,0,"PODEMOS-IU-EQUO",1
2,"2062",408,297,292,0,5,"PODEMOS-IU-EQUO",27
34,"34139",166,107,106,1,1,"PODEMOS-IU-EQUO",11
45,"45166",1617,1305,1286,8,19,"PODEMOS-IU-EQUO",127
13,"13061",5702,3867,3822,28,45,"PODEMOS-IU-EQUO",474
2,"2035",1960,1483,1465,13,18,"PODEMOS-IU-EQUO",188
26,"26094",83,70,70,0,0,"PODEMOS-IU-EQUO",7
37,"37238",110,87,85,0,2,"PODEMOS-IU-EQUO",16
5,"5218",121,97,97,0,0,"PODEMOS-IU-EQUO",8
45,"45138",1091,877,871,4,6,"PODEMOS-IU-EQUO",75
37,"37280",78,53,53,0,0,"PODEMOS-IU-EQUO",3
13,"13009",1439,1115,1098,9,17,"PODEMOS-IU-EQUO",63
9,"9217",351,251,249,6,2,"PODEMOS-IU-EQUO",53
24,"24226",199,139,137,0,2,"PODEMOS-IU-EQUO",14
26,"26153",13,12,11,0,1,"PODEMOS-IU-EQUO",5
34,"34003",164,122,119,0,3,"PODEMOS-IU-EQUO",12
6,"6148",966,691,678,8,13,"PODEMOS-IU-EQUO",121
39,"39002",3298,2342,2309,13,33,"PODEMOS-IU-EQUO",389
9,"9472",55,45,44,0,1,"PODEMOS-IU-EQUO",2
37,"37209",412,272,270,7,2,"PODEMOS-IU-EQUO",33
45,"45050",457,333,328,1,5,"PODEMOS-IU-EQUO",55
42,"42195",101,62,62,0,0,"PODEMOS-IU-EQUO",5
6,"6104",674,491,487,3,4,"PODEMOS-IU-EQUO",44
5,"5188",45,39,38,0,1,"PODEMOS-IU-EQUO",0
34,"34143",168,123,120,2,3,"PODEMOS-IU-EQUO",8
6,"6058",2026,1433,1416,9,17,"PODEMOS-IU-EQUO",147
45,"45184",200,129,129,0,0,"PODEMOS-IU-EQUO",22
19,"19285",24,21,21,1,0,"PODEMOS-IU-EQUO",1
16,"16001",76,61,61,0,0,"PODEMOS-IU-EQUO",4
10,"10118",286,251,249,1,2,"PODEMOS-IU-EQUO",30
16,"16190",5105,3945,3887,17,58,"PODEMOS-IU-EQUO",322
39,"39084",838,631,624,2,7,"PODEMOS-IU-EQUO",65
26,"26006",1800,1419,1405,8,14,"PODEMOS-IU-EQUO",187
19,"19102",98,79,78,0,1,"PODEMOS-IU-EQUO",8
9,"9084",186,136,135,4,1,"PODEMOS-IU-EQUO",16
37,"37212",104,78,74,0,4,"PODEMOS-IU-EQUO",11
2,"2079",2875,2209,2181,12,28,"PODEMOS-IU-EQUO",753
6,"6105",624,418,417,1,1,"PODEMOS-IU-EQUO",50
34,"34246",67,53,51,0,2,"PODEMOS-IU-EQUO",2
10,"10134",567,401,396,2,5,"PODEMOS-IU-EQUO",17
37,"37339",315,251,251,4,0,"PODEMOS-IU-EQUO",20
5,"5142",99,88,85,0,3,"PODEMOS-IU-EQUO",3
9,"9355",98,75,75,0,0,"PODEMOS-IU-EQUO",0
19,"19087",18,18,18,0,0,"PODEMOS-IU-EQUO",1
9,"9034",276,228,227,2,1,"PODEMOS-IU-EQUO",11
45,"45152",587,458,451,0,7,"PODEMOS-IU-EQUO",35
5,"5061",252,186,184,3,2,"PODEMOS-IU-EQUO",37
37,"37159",90,70,70,1,0,"PODEMOS-IU-EQUO",4
26,"26146",94,73,72,0,1,"PODEMOS-IU-EQUO",11
19,"19327",418,350,348,1,2,"PODEMOS-IU-EQUO",11
16,"16047",232,175,175,2,0,"PODEMOS-IU-EQUO",19
13,"13015",5431,3993,3950,17,43,"PODEMOS-IU-EQUO",413
2,"2040",559,484,483,3,1,"PODEMOS-IU-EQUO",58
19,"19287",148,109,108,0,1,"PODEMOS-IU-EQUO",3
26,"26086",16,15,15,1,0,"PODEMOS-IU-EQUO",0
5,"5192",101,82,79,2,3,"PODEMOS-IU-EQUO",16
10,"10182",136,95,95,0,0,"PODEMOS-IU-EQUO",15
9,"9208",210,136,134,3,2,"PODEMOS-IU-EQUO",11
42,"42200",81,59,58,2,1,"PODEMOS-IU-EQUO",1
24,"24219",516,387,386,4,1,"PODEMOS-IU-EQUO",53
16,"16174",185,145,143,0,2,"PODEMOS-IU-EQUO",9
26,"26052",154,121,117,0,4,"PODEMOS-IU-EQUO",11
42,"42215",773,531,520,7,11,"PODEMOS-IU-EQUO",41
19,"19329",59,50,50,1,0,"PODEMOS-IU-EQUO",4
26,"26053",208,168,163,4,5,"PODEMOS-IU-EQUO",26
24,"24230",426,322,320,5,2,"PODEMOS-IU-EQUO",37
24,"24095",320,234,232,0,2,"PODEMOS-IU-EQUO",30
37,"37039",301,217,213,0,4,"PODEMOS-IU-EQUO",15
37,"37342",259,189,186,0,3,"PODEMOS-IU-EQUO",15
42,"42216",25,23,23,0,0,"PODEMOS-IU-EQUO",1
45,"45121",6796,4743,4692,22,51,"PODEMOS-IU-EQUO",567
9,"9088",66,45,45,0,0,"PODEMOS-IU-EQUO",11
30,"30015",19171,13561,13464,61,97,"PODEMOS-IU-EQUO",1323
16,"16195",497,392,390,1,2,"PODEMOS-IU-EQUO",14
10,"10184",756,613,604,10,9,"PODEMOS-IU-EQUO",84
19,"19105",2334,1753,1739,8,14,"PODEMOS-IU-EQUO",349
16,"16050",245,201,195,1,6,"PODEMOS-IU-EQUO",18
6,"6110",148,108,108,1,0,"PODEMOS-IU-EQUO",5
6,"6157",443,321,316,1,5,"PODEMOS-IU-EQUO",16
9,"9224",162,131,131,1,0,"PODEMOS-IU-EQUO",6
45,"45055",1020,821,790,6,31,"PODEMOS-IU-EQUO",63
5,"5148",25,15,15,0,0,"PODEMOS-IU-EQUO",1
37,"37344",241,175,174,2,1,"PODEMOS-IU-EQUO",4
45,"45089",1495,1102,1094,0,8,"PODEMOS-IU-EQUO",260
34,"34206",866,661,654,4,7,"PODEMOS-IU-EQUO",53
24,"24008",9282,6685,6603,52,82,"PODEMOS-IU-EQUO",905
16,"16067",123,87,87,0,0,"PODEMOS-IU-EQUO",18
6,"6006",4572,3088,3049,26,39,"PODEMOS-IU-EQUO",491
26,"26033",170,132,129,1,3,"PODEMOS-IU-EQUO",19
5,"5133",66,53,53,0,0,"PODEMOS-IU-EQUO",2
10,"10003",569,414,408,1,6,"PODEMOS-IU-EQUO",69
9,"9091",724,500,490,4,10,"PODEMOS-IU-EQUO",44
5,"5151",91,71,71,1,0,"PODEMOS-IU-EQUO",4
16,"16101",154,132,132,0,0,"PODEMOS-IU-EQUO",13
38,"38003",1439,969,952,10,17,"PODEMOS-IU-EQUO",120
19,"19107",294,239,237,0,2,"PODEMOS-IU-EQUO",16
9,"9135",41,31,31,1,0,"PODEMOS-IU-EQUO",2
10,"10096",3408,2440,2391,12,49,"PODEMOS-IU-EQUO",467
5,"5102",1780,1339,1317,3,22,"PODEMOS-IU-EQUO",121
19,"19146",41,35,32,0,3,"PODEMOS-IU-EQUO",11
26,"26056",419,338,332,1,6,"PODEMOS-IU-EQUO",52
19,"19064",70,64,64,2,0,"PODEMOS-IU-EQUO",5
5,"5152",678,554,551,3,3,"PODEMOS-IU-EQUO",26
6,"6068",446,347,345,5,2,"PODEMOS-IU-EQUO",26
39,"39080",3542,2656,2628,20,28,"PODEMOS-IU-EQUO",398
16,"16010",152,115,112,0,3,"PODEMOS-IU-EQUO",2
42,"42042",45,35,35,0,0,"PODEMOS-IU-EQUO",3
34,"34106",109,89,86,2,3,"PODEMOS-IU-EQUO",3
9,"9363",965,737,734,2,3,"PODEMOS-IU-EQUO",62
9,"9136",192,142,137,2,5,"PODEMOS-IU-EQUO",25
19,"19173",45,38,36,0,2,"PODEMOS-IU-EQUO",5
24,"24187",857,603,593,7,10,"PODEMOS-IU-EQUO",61
9,"9094",53,42,42,1,0,"PODEMOS-IU-EQUO",3
13,"13024",898,633,627,3,6,"PODEMOS-IU-EQUO",37
37,"37362",4632,3389,3351,25,38,"PODEMOS-IU-EQUO",513
39,"39081",437,337,332,4,5,"PODEMOS-IU-EQUO",34
37,"37092",1758,1225,1215,8,10,"PODEMOS-IU-EQUO",183
39,"39021",487,381,376,2,5,"PODEMOS-IU-EQUO",47
45,"45125",2305,1865,1841,8,24,"PODEMOS-IU-EQUO",228
6,"6025",5106,3571,3523,44,48,"PODEMOS-IU-EQUO",460
9,"9183",51,41,41,0,0,"PODEMOS-IU-EQUO",2
26,"26093",53,39,38,0,1,"PODEMOS-IU-EQUO",7
6,"6070",7743,5438,5317,39,121,"PODEMOS-IU-EQUO",634
16,"16104",51,41,41,0,0,"PODEMOS-IU-EQUO",5
6,"6010",1105,819,801,5,18,"PODEMOS-IU-EQUO",146
39,"39052",18236,13537,13380,110,157,"PODEMOS-IU-EQUO",2465
5,"5201",523,419,418,1,1,"PODEMOS-IU-EQUO",50
42,"42018",152,117,116,1,1,"PODEMOS-IU-EQUO",10
42,"42071",171,115,115,3,0,"PODEMOS-IU-EQUO",10
45,"45082",1224,1020,1011,8,9,"PODEMOS-IU-EQUO",132
26,"26048",22,22,22,0,0,"PODEMOS-IU-EQUO",4
19,"19011",250,184,184,0,0,"PODEMOS-IU-EQUO",26
26,"26166",141,124,122,0,2,"PODEMOS-IU-EQUO",6
19,"19067",70,52,51,1,1,"PODEMOS-IU-EQUO",14
24,"24133",356,257,257,1,0,"PODEMOS-IU-EQUO",27
45,"45094",387,298,297,1,1,"PODEMOS-IU-EQUO",44
10,"10009",266,201,194,0,7,"PODEMOS-IU-EQUO",15
13,"13028",10418,8075,7976,52,99,"PODEMOS-IU-EQUO",906
26,"26130",203,167,167,1,0,"PODEMOS-IU-EQUO",8
5,"5057",2465,1969,1953,15,16,"PODEMOS-IU-EQUO",132
10,"10192",828,590,584,1,6,"PODEMOS-IU-EQUO",60
37,"37266",82,63,63,2,0,"PODEMOS-IU-EQUO",10
45,"45061",2447,1703,1689,12,14,"PODEMOS-IU-EQUO",218
37,"37141",154,122,122,2,0,"PODEMOS-IU-EQUO",19
2,"2010",1789,1437,1421,11,16,"PODEMOS-IU-EQUO",142
5,"5204",603,456,451,1,5,"PODEMOS-IU-EQUO",48
37,"37309",44,30,30,1,0,"PODEMOS-IU-EQUO",5
37,"37226",155,123,123,2,0,"PODEMOS-IU-EQUO",4
10,"10055",710,505,497,1,8,"PODEMOS-IU-EQUO",78
16,"16061",969,771,764,14,7,"PODEMOS-IU-EQUO",62
37,"37170",1449,994,971,3,23,"PODEMOS-IU-EQUO",91
10,"10056",586,457,452,4,5,"PODEMOS-IU-EQUO",57
42,"42121",64,47,47,0,0,"PODEMOS-IU-EQUO",5
9,"9261",469,332,329,2,3,"PODEMOS-IU-EQUO",42
34,"34216",66,50,50,0,0,"PODEMOS-IU-EQUO",2
10,"10057",143,117,117,1,0,"PODEMOS-IU-EQUO",15
42,"42008",57,43,43,0,0,"PODEMOS-IU-EQUO",5
37,"37228",360,297,295,2,2,"PODEMOS-IU-EQUO",19
38,"38046",9113,6850,6775,40,75,"PODEMOS-IU-EQUO",1638
9,"9141",616,485,483,5,2,"PODEMOS-IU-EQUO",78
42,"42139",23,15,15,1,0,"PODEMOS-IU-EQUO",1
24,"24036",288,184,184,2,0,"PODEMOS-IU-EQUO",33
26,"26168",5340,3774,3717,22,57,"PODEMOS-IU-EQUO",896
13,"13032",1137,841,835,2,6,"PODEMOS-IU-EQUO",78
16,"16191",899,675,671,2,4,"PODEMOS-IU-EQUO",43
9,"9262",163,130,127,1,3,"PODEMOS-IU-EQUO",8
39,"39085",6836,5086,5032,44,54,"PODEMOS-IU-EQUO",811
9,"9277",120,101,99,0,2,"PODEMOS-IU-EQUO",32
6,"6123",4627,3182,3120,18,62,"PODEMOS-IU-EQUO",495
16,"16096",274,232,229,1,3,"PODEMOS-IU-EQUO",19
38,"38011",20570,13831,13698,75,133,"PODEMOS-IU-EQUO",2665
5,"5160",323,256,253,2,3,"PODEMOS-IU-EQUO",13
2,"2053",2998,2231,2189,16,42,"PODEMOS-IU-EQUO",274
19,"19033",64,52,50,1,2,"PODEMOS-IU-EQUO",3
45,"45163",8298,5942,5855,28,87,"PODEMOS-IU-EQUO",920
9,"9235",156,132,131,3,1,"PODEMOS-IU-EQUO",21
35,"35007",511,316,309,2,7,"PODEMOS-IU-EQUO",46
16,"16018",394,318,315,1,3,"PODEMOS-IU-EQUO",15
9,"9265",37,28,28,0,0,"PODEMOS-IU-EQUO",1
5,"5096",80,60,59,0,1,"PODEMOS-IU-EQUO",9
9,"9443",179,128,124,0,4,"PODEMOS-IU-EQUO",15
35,"35025",1797,1261,1245,4,16,"PODEMOS-IU-EQUO",189
42,"42092",56,44,42,1,2,"PODEMOS-IU-EQUO",0
37,"37313",550,386,384,2,2,"PODEMOS-IU-EQUO",19
34,"34071",171,132,132,1,0,"PODEMOS-IU-EQUO",14
5,"5210",87,70,69,0,1,"PODEMOS-IU-EQUO",1
37,"37271",368,297,296,0,1,"PODEMOS-IU-EQUO",9
6,"6078",507,409,404,1,5,"PODEMOS-IU-EQUO",30
10,"10107",1031,801,792,3,9,"PODEMOS-IU-EQUO",140
2,"2055",1127,679,668,6,11,"PODEMOS-IU-EQUO",75
9,"9236",38,32,32,0,0,"PODEMOS-IU-EQUO",1
9,"9375",36,31,31,0,0,"PODEMOS-IU-EQUO",2
24,"24105",1459,1042,1025,16,17,"PODEMOS-IU-EQUO",146
16,"16020",17,10,10,0,0,"PODEMOS-IU-EQUO",1
16,"16113",3077,2225,2202,10,23,"PODEMOS-IU-EQUO",217
24,"24173",951,679,674,9,5,"PODEMOS-IU-EQUO",44
9,"9148",87,70,68,3,2,"PODEMOS-IU-EQUO",11
10,"10016",330,237,235,0,2,"PODEMOS-IU-EQUO",29
24,"24142",25119,17336,17141,154,195,"PODEMOS-IU-EQUO",3502
19,"19075",64,39,39,0,0,"PODEMOS-IU-EQUO",2
42,"42013",34,28,27,0,1,"PODEMOS-IU-EQUO",5
24,"24040",449,329,325,2,4,"PODEMOS-IU-EQUO",53
37,"37148",427,298,295,3,3,"PODEMOS-IU-EQUO",19
19,"19303",43,35,35,0,0,"PODEMOS-IU-EQUO",1
42,"42052",15,13,13,0,0,"PODEMOS-IU-EQUO",3
19,"19117",1579,1135,1123,8,12,"PODEMOS-IU-EQUO",267
6,"6066",1762,1189,1182,2,7,"PODEMOS-IU-EQUO",77
5,"5100",278,227,223,1,4,"PODEMOS-IU-EQUO",39
26,"26173",6,6,6,1,0,"PODEMOS-IU-EQUO",0
34,"34185",63,38,37,2,1,"PODEMOS-IU-EQUO",9
45,"45022",391,285,281,3,4,"PODEMOS-IU-EQUO",24
45,"45101",3756,3020,2984,12,36,"PODEMOS-IU-EQUO",333
19,"19230",505,360,357,3,3,"PODEMOS-IU-EQUO",74
34,"34074",707,540,531,9,9,"PODEMOS-IU-EQUO",48
39,"39029",618,488,481,3,7,"PODEMOS-IU-EQUO",84
9,"9151",448,362,360,6,2,"PODEMOS-IU-EQUO",62
16,"16023",469,335,335,2,0,"PODEMOS-IU-EQUO",85
34,"34170",61,42,42,0,0,"PODEMOS-IU-EQUO",1
24,"24107",236,175,173,0,2,"PODEMOS-IU-EQUO",15
9,"9065",143,122,122,1,0,"PODEMOS-IU-EQUO",17
19,"19305",155,116,115,0,1,"PODEMOS-IU-EQUO",12
9,"9464",35,27,27,0,0,"PODEMOS-IU-EQUO",2
9,"9287",208,158,156,3,2,"PODEMOS-IU-EQUO",33
9,"9152",257,183,183,0,0,"PODEMOS-IU-EQUO",24
5,"5069",73,64,63,0,1,"PODEMOS-IU-EQUO",4
39,"39030",1895,1225,1212,10,13,"PODEMOS-IU-EQUO",262
24,"24010",8386,5708,5632,60,76,"PODEMOS-IU-EQUO",666
9,"9422",17,11,11,0,0,"PODEMOS-IU-EQUO",0
30,"30028",6649,4797,4726,21,71,"PODEMOS-IU-EQUO",966
37,"37236",135,105,103,1,2,"PODEMOS-IU-EQUO",2
37,"37277",75,58,58,0,0,"PODEMOS-IU-EQUO",0
39,"39020",23592,15594,15384,128,210,"PODEMOS-IU-EQUO",4679
34,"34156",50,45,45,0,0,"PODEMOS-IU-EQUO",2
39,"39092",894,626,620,1,6,"PODEMOS-IU-EQUO",80
19,"19333",115,82,82,0,0,"PODEMOS-IU-EQUO",15
30,"30019",25857,17544,17374,125,170,"PODEMOS-IU-EQUO",2952
2,"2061",637,516,511,4,5,"PODEMOS-IU-EQUO",38
19,"19080",65,41,41,0,0,"PODEMOS-IU-EQUO",6
16,"16278",70,55,55,0,0,"PODEMOS-IU-EQUO",3
37,"37237",324,244,240,1,4,"PODEMOS-IU-EQUO",29
16,"16026",82,62,61,2,1,"PODEMOS-IU-EQUO",1
45,"45070",1427,1147,1142,1,5,"PODEMOS-IU-EQUO",172
9,"9199",92,72,71,1,1,"PODEMOS-IU-EQUO",4
37,"37061",225,168,168,1,0,"PODEMOS-IU-EQUO",8
9,"9382",33,28,28,0,0,"PODEMOS-IU-EQUO",2
10,"10115",3544,2705,2647,11,58,"PODEMOS-IU-EQUO",404
6,"6147",354,268,268,0,0,"PODEMOS-IU-EQUO",66
19,"19041",163,129,129,3,0,"PODEMOS-IU-EQUO",31
42,"42007",113,86,86,5,0,"PODEMOS-IU-EQUO",6
19,"19335",55,47,47,0,0,"PODEMOS-IU-EQUO",3
9,"9017",89,68,67,4,1,"PODEMOS-IU-EQUO",0
37,"37005",74,54,54,2,0,"PODEMOS-IU-EQUO",3
10,"10146",1507,1004,977,7,27,"PODEMOS-IU-EQUO",102
10,"10207",504,357,350,6,7,"PODEMOS-IU-EQUO",25
42,"42058",113,92,89,0,3,"PODEMOS-IU-EQUO",5
42,"42019",516,363,356,3,7,"PODEMOS-IU-EQUO",60
39,"39063",967,697,690,9,7,"PODEMOS-IU-EQUO",118
13,"13097",2270,1687,1671,7,16,"PODEMOS-IU-EQUO",169
24,"24112",309,228,227,1,1,"PODEMOS-IU-EQUO",40
16,"16167",316,249,244,1,5,"PODEMOS-IU-EQUO",31
34,"34176",133,102,101,0,1,"PODEMOS-IU-EQUO",8
37,"37364",820,607,598,6,9,"PODEMOS-IU-EQUO",49
30,"30031",492,409,401,0,8,"PODEMOS-IU-EQUO",26
13,"13098",2092,1503,1461,8,42,"PODEMOS-IU-EQUO",122
37,"37065",312,223,222,3,1,"PODEMOS-IU-EQUO",13
6,"6043",665,490,484,2,6,"PODEMOS-IU-EQUO",49
37,"37155",65,57,57,0,0,"PODEMOS-IU-EQUO",7
26,"26005",2381,1598,1577,23,21,"PODEMOS-IU-EQUO",245
34,"34036",211,150,150,0,0,"PODEMOS-IU-EQUO",31
2,"2024",3409,2589,2554,29,35,"PODEMOS-IU-EQUO",452
9,"9294",108,86,82,0,4,"PODEMOS-IU-EQUO",16
37,"37240",945,623,619,5,4,"PODEMOS-IU-EQUO",85
37,"37281",36,33,31,0,2,"PODEMOS-IU-EQUO",5
16,"16016",224,171,168,0,3,"PODEMOS-IU-EQUO",5
34,"34067",127,93,93,1,0,"PODEMOS-IU-EQUO",13
19,"19165",47,41,41,0,0,"PODEMOS-IU-EQUO",12
37,"37116",69,50,50,0,0,"PODEMOS-IU-EQUO",10
24,"24217",135,109,108,1,1,"PODEMOS-IU-EQUO",6
39,"39095",2266,1760,1726,14,34,"PODEMOS-IU-EQUO",319
6,"6090",869,617,602,3,15,"PODEMOS-IU-EQUO",75
9,"9295",61,44,44,0,0,"PODEMOS-IU-EQUO",2
39,"39034",286,188,185,5,3,"PODEMOS-IU-EQUO",17
37,"37241",168,131,131,1,0,"PODEMOS-IU-EQUO",3
45,"45007",696,534,522,3,12,"PODEMOS-IU-EQUO",61
37,"37242",91,74,73,0,1,"PODEMOS-IU-EQUO",3
26,"26072",281,254,254,0,0,"PODEMOS-IU-EQUO",29
24,"24206",1700,1253,1240,12,13,"PODEMOS-IU-EQUO",171
10,"10027",77,69,69,1,0,"PODEMOS-IU-EQUO",5
16,"16231",46,37,37,0,0,"PODEMOS-IU-EQUO",5
9,"9297",323,251,250,6,1,"PODEMOS-IU-EQUO",23
37,"37144",363,277,276,1,1,"PODEMOS-IU-EQUO",17
24,"24181",1493,1054,1045,5,9,"PODEMOS-IU-EQUO",70
24,"24114",3061,2025,1994,9,31,"PODEMOS-IU-EQUO",379
42,"42061",291,214,213,3,1,"PODEMOS-IU-EQUO",38
37,"37117",1494,1067,1048,3,19,"PODEMOS-IU-EQUO",149
16,"16033",1714,1319,1305,6,14,"PODEMOS-IU-EQUO",173
24,"24016",466,270,269,1,1,"PODEMOS-IU-EQUO",22
34,"34233",130,107,107,1,0,"PODEMOS-IU-EQUO",2
5,"5079",68,53,53,0,0,"PODEMOS-IU-EQUO",8
34,"34084",138,109,107,0,2,"PODEMOS-IU-EQUO",5
9,"9389",73,60,60,1,0,"PODEMOS-IU-EQUO",9
26,"26171",176,139,133,1,6,"PODEMOS-IU-EQUO",12
34,"34165",66,58,58,1,0,"PODEMOS-IU-EQUO",0
37,"37368",17,17,17,0,0,"PODEMOS-IU-EQUO",4
39,"39036",969,743,739,2,4,"PODEMOS-IU-EQUO",129
9,"9298",82,70,69,1,1,"PODEMOS-IU-EQUO",4
5,"5226",76,55,54,3,1,"PODEMOS-IU-EQUO",1
10,"10030",465,309,309,1,0,"PODEMOS-IU-EQUO",17
26,"26042",834,635,625,5,10,"PODEMOS-IU-EQUO",81
26,"26075",329,267,264,2,3,"PODEMOS-IU-EQUO",19
34,"34086",103,89,88,0,1,"PODEMOS-IU-EQUO",9
37,"37201",262,187,186,1,1,"PODEMOS-IU-EQUO",17
9,"9390",611,484,482,3,2,"PODEMOS-IU-EQUO",68
2,"2069",11490,8470,8373,41,97,"PODEMOS-IU-EQUO",1018
39,"39068",646,450,445,2,5,"PODEMOS-IU-EQUO",80
37,"37161",136,106,106,1,0,"PODEMOS-IU-EQUO",4
9,"9075",112,91,91,3,0,"PODEMOS-IU-EQUO",11
16,"16130",571,450,448,1,2,"PODEMOS-IU-EQUO",29
26,"26043",365,292,281,1,11,"PODEMOS-IU-EQUO",49
34,"34087",129,103,102,1,1,"PODEMOS-IU-EQUO",8
34,"34045",76,66,66,2,0,"PODEMOS-IU-EQUO",4
16,"16176",38,30,30,0,0,"PODEMOS-IU-EQUO",3
30,"30005",29526,20713,20526,121,187,"PODEMOS-IU-EQUO",2800
9,"9037",111,91,91,0,0,"PODEMOS-IU-EQUO",15
5,"5034",14,13,13,0,0,"PODEMOS-IU-EQUO",4
37,"37121",575,418,413,3,5,"PODEMOS-IU-EQUO",47
37,"37162",204,152,151,0,1,"PODEMOS-IU-EQUO",8
13,"13089",1706,1368,1332,8,36,"PODEMOS-IU-EQUO",107
37,"37358",159,135,133,0,2,"PODEMOS-IU-EQUO",12
19,"19304",219,173,171,3,2,"PODEMOS-IU-EQUO",41
6,"6021",926,645,636,8,9,"PODEMOS-IU-EQUO",34
38,"38052",1273,883,875,2,8,"PODEMOS-IU-EQUO",98
26,"26077",22,22,21,1,1,"PODEMOS-IU-EQUO",1
16,"16177",78,64,64,0,0,"PODEMOS-IU-EQUO",9
5,"5180",86,67,63,3,4,"PODEMOS-IU-EQUO",2
6,"6142",273,205,197,2,8,"PODEMOS-IU-EQUO",19
37,"37331",212,137,135,0,2,"PODEMOS-IU-EQUO",9
45,"45111",65,50,50,0,0,"PODEMOS-IU-EQUO",4
9,"9433",60,48,45,1,3,"PODEMOS-IU-EQUO",12
9,"9255",89,63,62,0,1,"PODEMOS-IU-EQUO",6
9,"9169",95,78,78,0,0,"PODEMOS-IU-EQUO",13
26,"26078",82,70,70,0,0,"PODEMOS-IU-EQUO",7
45,"45046",2412,1667,1654,7,13,"PODEMOS-IU-EQUO",204
16,"16242",317,272,270,1,2,"PODEMOS-IU-EQUO",21
34,"34238",330,268,266,3,2,"PODEMOS-IU-EQUO",34
19,"19009",259,200,195,6,5,"PODEMOS-IU-EQUO",22
37,"37249",43,29,29,0,0,"PODEMOS-IU-EQUO",5
30,"30008",13918,9757,9645,59,112,"PODEMOS-IU-EQUO",1876
9,"9394",715,533,521,3,12,"PODEMOS-IU-EQUO",81
6,"6099",1145,655,638,6,17,"PODEMOS-IU-EQUO",43
34,"34186",52,45,45,0,0,"PODEMOS-IU-EQUO",1
10,"10218",1126,803,795,3,8,"PODEMOS-IU-EQUO",42
10,"10082",1868,1451,1412,11,39,"PODEMOS-IU-EQUO",201
37,"37319",114,78,74,0,4,"PODEMOS-IU-EQUO",15
5,"5232",102,84,79,1,5,"PODEMOS-IU-EQUO",9
19,"19322",31,25,25,0,0,"PODEMOS-IU-EQUO",1
37,"37291",272,207,206,0,1,"PODEMOS-IU-EQUO",23
42,"42117",140,101,99,0,2,"PODEMOS-IU-EQUO",13
26,"26151",448,370,368,1,2,"PODEMOS-IU-EQUO",34
6,"6054",5446,3920,3833,32,87,"PODEMOS-IU-EQUO",358
24,"24055",708,516,512,0,4,"PODEMOS-IU-EQUO",48
6,"6009",204,153,153,0,0,"PODEMOS-IU-EQUO",19
42,"42207",40,33,32,0,1,"PODEMOS-IU-EQUO",5
13,"13008",438,299,295,0,4,"PODEMOS-IU-EQUO",21
37,"37375",700,578,570,4,8,"PODEMOS-IU-EQUO",39
42,"42070",34,27,26,1,1,"PODEMOS-IU-EQUO",5
5,"5039",54,42,41,0,1,"PODEMOS-IU-EQUO",3
2,"2021",1017,784,778,6,6,"PODEMOS-IU-EQUO",94
10,"10130",1761,1300,1277,6,23,"PODEMOS-IU-EQUO",289
34,"34125",86,65,64,0,1,"PODEMOS-IU-EQUO",7
24,"24044",168,119,118,1,1,"PODEMOS-IU-EQUO",19
37,"37018",107,79,79,0,0,"PODEMOS-IU-EQUO",7
9,"9067",437,295,294,6,1,"PODEMOS-IU-EQUO",30
19,"19234",43,33,33,0,0,"PODEMOS-IU-EQUO",3
9,"9903",3221,2304,2281,27,23,"PODEMOS-IU-EQUO",372
6,"6011",24723,16883,16718,137,165,"PODEMOS-IU-EQUO",1955
24,"24158",320,207,203,2,4,"PODEMOS-IU-EQUO",15
10,"10903",826,578,569,3,9,"PODEMOS-IU-EQUO",78
10,"10177",1707,1228,1201,5,27,"PODEMOS-IU-EQUO",168
5,"5186",1575,1225,1194,3,31,"PODEMOS-IU-EQUO",123
37,"37080",225,171,167,0,4,"PODEMOS-IU-EQUO",14
24,"24090",343,235,233,1,2,"PODEMOS-IU-EQUO",31
6,"6149",10295,7651,7536,56,115,"PODEMOS-IU-EQUO",878
10,"10086",320,238,233,1,5,"PODEMOS-IU-EQUO",11
19,"19013",125,108,108,1,0,"PODEMOS-IU-EQUO",23
45,"45149",556,446,440,0,6,"PODEMOS-IU-EQUO",38
19,"19098",19,17,17,0,0,"PODEMOS-IU-EQUO",3
39,"39043",1481,1122,1115,9,7,"PODEMOS-IU-EQUO",152
34,"34052",174,135,133,0,2,"PODEMOS-IU-EQUO",23
13,"13011",4792,3112,3077,14,35,"PODEMOS-IU-EQUO",359
2,"2077",55,47,47,0,0,"PODEMOS-IU-EQUO",8
5,"5236",123,91,90,1,1,"PODEMOS-IU-EQUO",19
24,"24024",692,496,491,4,5,"PODEMOS-IU-EQUO",65
37,"37082",796,551,544,4,7,"PODEMOS-IU-EQUO",59
6,"6150",802,602,596,4,6,"PODEMOS-IU-EQUO",107
10,"10041",1057,795,781,4,14,"PODEMOS-IU-EQUO",85
5,"5092",152,125,122,0,3,"PODEMOS-IU-EQUO",11
19,"19099",298,200,199,6,1,"PODEMOS-IU-EQUO",44
9,"9007",57,39,39,0,0,"PODEMOS-IU-EQUO",0
45,"45051",1590,1171,1152,5,19,"PODEMOS-IU-EQUO",85
19,"19138",255,202,201,2,1,"PODEMOS-IU-EQUO",45
30,"30012",9091,6962,6897,36,65,"PODEMOS-IU-EQUO",1190
45,"45085",1500,1011,999,4,12,"PODEMOS-IU-EQUO",135
42,"42212",69,43,43,1,0,"PODEMOS-IU-EQUO",2
35,"35023",11686,8212,8076,55,136,"PODEMOS-IU-EQUO",1452
30,"30043",24967,18981,18685,101,296,"PODEMOS-IU-EQUO",3212
37,"37255",49,34,34,1,0,"PODEMOS-IU-EQUO",0
9,"9429",56,41,41,0,0,"PODEMOS-IU-EQUO",4
19,"19055",52,41,41,1,0,"PODEMOS-IU-EQUO",6
19,"19178",33,22,22,0,0,"PODEMOS-IU-EQUO",5
19,"19249",32,29,29,0,0,"PODEMOS-IU-EQUO",0
10,"10073",747,524,516,4,8,"PODEMOS-IU-EQUO",62
6,"6107",1581,999,995,8,4,"PODEMOS-IU-EQUO",71
37,"37256",218,156,152,1,4,"PODEMOS-IU-EQUO",8
10,"10090",513,362,353,2,9,"PODEMOS-IU-EQUO",32
42,"42171",127,80,79,0,1,"PODEMOS-IU-EQUO",2
37,"37381",147,114,107,2,7,"PODEMOS-IU-EQUO",13
9,"9132",171,122,122,2,0,"PODEMOS-IU-EQUO",9
5,"5240",3374,2283,2257,7,26,"PODEMOS-IU-EQUO",308
16,"16048",408,313,312,1,1,"PODEMOS-IU-EQUO",33
9,"9086",666,462,459,2,3,"PODEMOS-IU-EQUO",66
24,"24125",462,290,286,4,4,"PODEMOS-IU-EQUO",28
19,"19088",79,61,61,0,0,"PODEMOS-IU-EQUO",7
6,"6138",1047,727,715,5,12,"PODEMOS-IU-EQUO",89
10,"10091",371,287,284,0,3,"PODEMOS-IU-EQUO",35
37,"37258",172,116,115,3,1,"PODEMOS-IU-EQUO",5
6,"6108",2275,1567,1527,11,40,"PODEMOS-IU-EQUO",216
37,"37174",1056,820,812,3,8,"PODEMOS-IU-EQUO",77
19,"19104",14,12,12,1,0,"PODEMOS-IU-EQUO",0
26,"26019",355,274,271,1,3,"PODEMOS-IU-EQUO",31
42,"42036",50,41,41,1,0,"PODEMOS-IU-EQUO",11
34,"34057",471,339,338,1,1,"PODEMOS-IU-EQUO",40
10,"10092",292,236,235,1,1,"PODEMOS-IU-EQUO",15
37,"37087",862,639,635,2,4,"PODEMOS-IU-EQUO",108
19,"19142",265,182,180,3,2,"PODEMOS-IU-EQUO",43
45,"45120",129,104,104,1,0,"PODEMOS-IU-EQUO",9
45,"45188",2785,1960,1938,15,22,"PODEMOS-IU-EQUO",300
24,"24196",2057,1502,1485,9,17,"PODEMOS-IU-EQUO",357
24,"24163",3962,2950,2933,24,17,"PODEMOS-IU-EQUO",507
5,"5099",491,395,386,6,9,"PODEMOS-IU-EQUO",28
26,"26020",476,349,339,3,10,"PODEMOS-IU-EQUO",25
24,"24062",139,98,98,1,0,"PODEMOS-IU-EQUO",18
9,"9361",115,90,89,0,1,"PODEMOS-IU-EQUO",8
6,"6019",2079,1451,1417,8,34,"PODEMOS-IU-EQUO",196
39,"39078",1401,975,963,5,12,"PODEMOS-IU-EQUO",159
37,"37176",133,110,110,0,0,"PODEMOS-IU-EQUO",7
10,"10001",282,225,223,3,2,"PODEMOS-IU-EQUO",25
24,"24029",735,539,535,3,4,"PODEMOS-IU-EQUO",133
9,"9090",54,48,48,0,0,"PODEMOS-IU-EQUO",5
5,"5149",106,77,77,1,0,"PODEMOS-IU-EQUO",9
10,"10002",364,272,270,0,2,"PODEMOS-IU-EQUO",39
5,"5016",6335,4670,4586,41,84,"PODEMOS-IU-EQUO",501
42,"42115",61,47,47,1,0,"PODEMOS-IU-EQUO",6
34,"34154",74,55,53,1,2,"PODEMOS-IU-EQUO",7
10,"10048",233,168,168,0,0,"PODEMOS-IU-EQUO",13
37,"37261",221,163,160,1,3,"PODEMOS-IU-EQUO",18
9,"9013",48,37,37,0,0,"PODEMOS-IU-EQUO",7
24,"24063",374,254,252,2,2,"PODEMOS-IU-EQUO",22
5,"5197",102,85,83,1,2,"PODEMOS-IU-EQUO",9
45,"45156",3410,2751,2711,13,40,"PODEMOS-IU-EQUO",480
39,"39049",322,229,229,0,0,"PODEMOS-IU-EQUO",23
45,"45123",3081,2144,2131,11,13,"PODEMOS-IU-EQUO",486
19,"19184",71,50,48,0,2,"PODEMOS-IU-EQUO",0
37,"37041",78,52,52,0,0,"PODEMOS-IU-EQUO",2
42,"42083",26,20,20,0,0,"PODEMOS-IU-EQUO",3
42,"42130",59,46,45,1,1,"PODEMOS-IU-EQUO",4
16,"16053",426,351,347,5,4,"PODEMOS-IU-EQUO",67
45,"45091",394,269,267,3,2,"PODEMOS-IU-EQUO",20
2,"2045",3665,2895,2855,21,40,"PODEMOS-IU-EQUO",972
16,"16149",148,124,122,2,2,"PODEMOS-IU-EQUO",27
5,"5103",72,52,52,0,0,"PODEMOS-IU-EQUO",8
9,"9182",80,69,67,1,2,"PODEMOS-IU-EQUO",2
45,"45024",1062,793,785,4,8,"PODEMOS-IU-EQUO",46
16,"16259",29,22,21,0,1,"PODEMOS-IU-EQUO",0
24,"24021",1675,1162,1144,8,18,"PODEMOS-IU-EQUO",218
6,"6114",137,112,112,0,0,"PODEMOS-IU-EQUO",10
5,"5198",73,62,62,0,0,"PODEMOS-IU-EQUO",2
10,"10050",1053,846,837,6,9,"PODEMOS-IU-EQUO",30
34,"34018",209,168,164,1,4,"PODEMOS-IU-EQUO",22
42,"42004",2285,1757,1737,15,20,"PODEMOS-IU-EQUO",151
42,"42177",69,60,60,1,0,"PODEMOS-IU-EQUO",3
19,"19148",45,32,31,0,1,"PODEMOS-IU-EQUO",4
10,"10098",378,289,287,1,2,"PODEMOS-IU-EQUO",36
5,"5055",568,456,451,4,5,"PODEMOS-IU-EQUO",46
6,"6161",302,236,235,1,1,"PODEMOS-IU-EQUO",14
9,"9449",86,68,66,0,2,"PODEMOS-IU-EQUO",1
6,"6116",1587,1171,1160,10,11,"PODEMOS-IU-EQUO",100
9,"9228",160,137,136,1,1,"PODEMOS-IU-EQUO",20
16,"16135",134,92,92,2,0,"PODEMOS-IU-EQUO",11
19,"19024",8196,5613,5563,28,50,"PODEMOS-IU-EQUO",1230
37,"37349",117,88,88,0,0,"PODEMOS-IU-EQUO",3
10,"10100",799,578,574,4,4,"PODEMOS-IU-EQUO",94
39,"39042",5915,4530,4474,21,56,"PODEMOS-IU-EQUO",596
34,"34050",200,153,152,0,1,"PODEMOS-IU-EQUO",20
45,"45049",433,305,304,1,1,"PODEMOS-IU-EQUO",35
45,"45026",211,167,166,2,1,"PODEMOS-IU-EQUO",19
16,"16152",38,32,32,0,0,"PODEMOS-IU-EQUO",5
16,"16264",435,366,364,2,2,"PODEMOS-IU-EQUO",13
37,"37140",674,443,439,5,4,"PODEMOS-IU-EQUO",28
37,"37098",333,247,247,1,0,"PODEMOS-IU-EQUO",40
45,"45127",696,514,511,3,3,"PODEMOS-IU-EQUO",97
37,"37225",103,89,86,0,3,"PODEMOS-IU-EQUO",5
37,"37047",180,84,84,0,0,"PODEMOS-IU-EQUO",7
37,"37006",138,103,103,2,0,"PODEMOS-IU-EQUO",20
5,"5252",64,45,45,1,0,"PODEMOS-IU-EQUO",0
42,"42134",2627,1927,1890,19,37,"PODEMOS-IU-EQUO",319
10,"10010",2290,1362,1341,7,21,"PODEMOS-IU-EQUO",166
16,"16154",4871,3547,3509,24,38,"PODEMOS-IU-EQUO",455
45,"45095",689,513,505,0,8,"PODEMOS-IU-EQUO",21
37,"37267",200,156,147,2,9,"PODEMOS-IU-EQUO",25
10,"10147",1278,961,925,7,36,"PODEMOS-IU-EQUO",175
9,"9100",59,45,44,0,1,"PODEMOS-IU-EQUO",2
24,"24003",648,460,453,7,7,"PODEMOS-IU-EQUO",32
10,"10148",32850,22161,21856,177,305,"PODEMOS-IU-EQUO",3762
34,"34215",164,141,140,1,1,"PODEMOS-IU-EQUO",17
42,"42183",111,82,82,2,0,"PODEMOS-IU-EQUO",6
37,"37100",80,61,61,1,0,"PODEMOS-IU-EQUO",1
37,"37310",178,123,123,1,0,"PODEMOS-IU-EQUO",11
34,"34023",5236,3685,3636,30,49,"PODEMOS-IU-EQUO",847
34,"34112",46,38,37,0,1,"PODEMOS-IU-EQUO",2
37,"37008",4266,3216,3197,19,19,"PODEMOS-IU-EQUO",305
19,"19260",42,39,39,1,0,"PODEMOS-IU-EQUO",4
16,"16269",419,336,332,2,4,"PODEMOS-IU-EQUO",22
9,"9101",76,56,55,1,1,"PODEMOS-IU-EQUO",7
13,"13082",25805,16871,16706,120,165,"PODEMOS-IU-EQUO",1794
5,"5254",190,160,159,0,1,"PODEMOS-IU-EQUO",10
37,"37268",112,76,76,0,0,"PODEMOS-IU-EQUO",3
10,"10104",5119,3633,3585,15,48,"PODEMOS-IU-EQUO",403
6,"6106",423,274,272,5,2,"PODEMOS-IU-EQUO",35
42,"42048",66,51,51,0,0,"PODEMOS-IU-EQUO",3
37,"37143",389,301,300,6,1,"PODEMOS-IU-EQUO",24
26,"26062",89,72,71,2,1,"PODEMOS-IU-EQUO",5
16,"16017",366,294,294,2,0,"PODEMOS-IU-EQUO",42
37,"37052",273,209,209,2,0,"PODEMOS-IU-EQUO",20
10,"10059",364,253,248,1,5,"PODEMOS-IU-EQUO",11
19,"19114",37,26,26,0,0,"PODEMOS-IU-EQUO",2
16,"16157",211,179,179,2,0,"PODEMOS-IU-EQUO",14
10,"10013",276,207,200,0,7,"PODEMOS-IU-EQUO",23
45,"45064",3858,2804,2763,20,41,"PODEMOS-IU-EQUO",689
24,"24038",3089,2312,2273,17,39,"PODEMOS-IU-EQUO",529
2,"2054",386,291,290,0,1,"PODEMOS-IU-EQUO",16
24,"24005",378,260,257,2,3,"PODEMOS-IU-EQUO",19
19,"19300",772,595,591,5,4,"PODEMOS-IU-EQUO",162
16,"16005",255,180,178,2,2,"PODEMOS-IU-EQUO",33
19,"19288",21,21,20,0,1,"PODEMOS-IU-EQUO",0
19,"19227",66,44,43,2,1,"PODEMOS-IU-EQUO",4
10,"10106",130,109,108,2,1,"PODEMOS-IU-EQUO",10
37,"37103",436,310,308,8,2,"PODEMOS-IU-EQUO",27
13,"13034",58191,42423,42027,291,396,"PODEMOS-IU-EQUO",6488
16,"16111",171,123,123,1,0,"PODEMOS-IU-EQUO",28
5,"5162",86,66,63,0,3,"PODEMOS-IU-EQUO",11
45,"45031",2723,1835,1822,12,13,"PODEMOS-IU-EQUO",324
42,"42142",50,35,35,1,0,"PODEMOS-IU-EQUO",3
19,"19034",22,16,16,0,0,"PODEMOS-IU-EQUO",1
26,"26031",106,83,83,0,0,"PODEMOS-IU-EQUO",4
42,"42188",50,39,38,0,1,"PODEMOS-IU-EQUO",2
19,"19192",1736,1324,1308,8,16,"PODEMOS-IU-EQUO",102
13,"13036",799,601,595,2,6,"PODEMOS-IU-EQUO",50
10,"10015",675,483,473,3,10,"PODEMOS-IU-EQUO",71
45,"45032",436,283,275,1,8,"PODEMOS-IU-EQUO",47
6,"6125",1743,1285,1269,7,16,"PODEMOS-IU-EQUO",103
34,"34221",179,144,144,3,0,"PODEMOS-IU-EQUO",18
34,"34168",52,47,47,2,0,"PODEMOS-IU-EQUO",5
6,"6080",1924,1412,1392,9,20,"PODEMOS-IU-EQUO",138
19,"19193",20,19,19,1,0,"PODEMOS-IU-EQUO",2
42,"42189",60,46,45,0,1,"PODEMOS-IU-EQUO",5
6,"6035",937,696,681,5,15,"PODEMOS-IU-EQUO",54
5,"5065",471,394,392,4,2,"PODEMOS-IU-EQUO",40
2,"2057",2020,1487,1461,10,26,"PODEMOS-IU-EQUO",304
37,"37273",107,71,71,1,0,"PODEMOS-IU-EQUO",4
10,"10109",1762,1149,1125,14,24,"PODEMOS-IU-EQUO",116
6,"6081",1074,806,792,7,14,"PODEMOS-IU-EQUO",119
34,"34012",357,269,264,5,5,"PODEMOS-IU-EQUO",30
34,"34059",426,347,342,6,5,"PODEMOS-IU-EQUO",28
9,"9108",384,283,279,1,4,"PODEMOS-IU-EQUO",53
37,"37149",68,64,64,0,0,"PODEMOS-IU-EQUO",3
9,"9064",324,271,267,1,4,"PODEMOS-IU-EQUO",21
10,"10110",2300,1623,1574,11,49,"PODEMOS-IU-EQUO",200
2,"2017",838,594,589,1,5,"PODEMOS-IU-EQUO",41
6,"6127",2863,2112,2088,10,24,"PODEMOS-IU-EQUO",169
24,"24211",272,205,205,2,0,"PODEMOS-IU-EQUO",13
37,"37107",10764,7379,7264,56,115,"PODEMOS-IU-EQUO",696
45,"45167",1440,1144,1133,6,11,"PODEMOS-IU-EQUO",104
10,"10018",1689,1101,1081,6,20,"PODEMOS-IU-EQUO",156
19,"19039",61,54,54,1,0,"PODEMOS-IU-EQUO",5
24,"24108",376,280,277,2,3,"PODEMOS-IU-EQUO",28
38,"38016",1223,638,623,3,15,"PODEMOS-IU-EQUO",127
5,"5017",85,82,81,5,1,"PODEMOS-IU-EQUO",7
37,"37150",41,34,34,0,0,"PODEMOS-IU-EQUO",1
16,"16117",1040,787,777,4,10,"PODEMOS-IU-EQUO",99
10,"10203",4558,3120,3079,20,41,"PODEMOS-IU-EQUO",335
35,"35011",24002,15928,15684,95,244,"PODEMOS-IU-EQUO",3535
26,"26034",654,497,489,1,8,"PODEMOS-IU-EQUO",77
2,"2019",2405,1871,1835,12,36,"PODEMOS-IU-EQUO",205
9,"9026",386,301,300,0,1,"PODEMOS-IU-EQUO",50
19,"19147",43,33,33,0,0,"PODEMOS-IU-EQUO",9
26,"26104",13,10,10,0,0,"PODEMOS-IU-EQUO",2
38,"38053",3735,2469,2435,17,34,"PODEMOS-IU-EQUO",309
39,"39091",1926,1493,1476,10,17,"PODEMOS-IU-EQUO",178
39,"39031",1236,878,868,4,10,"PODEMOS-IU-EQUO",116
5,"5072",81,67,67,1,0,"PODEMOS-IU-EQUO",2
16,"16071",20,20,20,0,0,"PODEMOS-IU-EQUO",5
26,"26002",830,632,622,0,10,"PODEMOS-IU-EQUO",60
42,"42055",164,121,121,0,0,"PODEMOS-IU-EQUO",12
45,"45136",5845,4091,4019,25,72,"PODEMOS-IU-EQUO",420
26,"26176",53,44,44,1,0,"PODEMOS-IU-EQUO",3
45,"45003",562,408,402,1,6,"PODEMOS-IU-EQUO",33
26,"26069",236,194,189,0,5,"PODEMOS-IU-EQUO",19
9,"9337",117,92,91,0,1,"PODEMOS-IU-EQUO",15
24,"24214",656,490,485,3,5,"PODEMOS-IU-EQUO",68
19,"19081",29,22,22,1,0,"PODEMOS-IU-EQUO",0
24,"24078",380,289,277,0,12,"PODEMOS-IU-EQUO",34
26,"26141",113,87,82,0,5,"PODEMOS-IU-EQUO",11
19,"19110",56,50,50,0,0,"PODEMOS-IU-EQUO",3
26,"26129",967,775,766,6,9,"PODEMOS-IU-EQUO",67
37,"37181",286,210,207,4,3,"PODEMOS-IU-EQUO",13
13,"13044",2671,1960,1936,13,24,"PODEMOS-IU-EQUO",204
37,"37279",750,522,513,4,9,"PODEMOS-IU-EQUO",38
9,"9289",1451,1014,1000,5,14,"PODEMOS-IU-EQUO",114
42,"42057",164,104,104,2,0,"PODEMOS-IU-EQUO",7
34,"34126",277,200,199,2,1,"PODEMOS-IU-EQUO",25
37,"37019",150,123,120,0,3,"PODEMOS-IU-EQUO",2
5,"5171",74,52,50,1,2,"PODEMOS-IU-EQUO",3
5,"5074",686,564,558,5,6,"PODEMOS-IU-EQUO",32
26,"26004",67,50,50,0,0,"PODEMOS-IU-EQUO",1
10,"10024",695,525,520,3,5,"PODEMOS-IU-EQUO",67
19,"19042",25,24,24,0,0,"PODEMOS-IU-EQUO",5
6,"6088",12616,8436,8313,70,123,"PODEMOS-IU-EQUO",1242
10,"10116",3749,2726,2670,21,56,"PODEMOS-IU-EQUO",502
30,"30001",4582,3620,3594,18,26,"PODEMOS-IU-EQUO",248
42,"42103",575,450,445,1,5,"PODEMOS-IU-EQUO",34
9,"9070",34,26,26,0,0,"PODEMOS-IU-EQUO",6
42,"42154",97,69,69,1,0,"PODEMOS-IU-EQUO",11
16,"16030",24,19,19,0,0,"PODEMOS-IU-EQUO",3
42,"42059",21,15,14,0,1,"PODEMOS-IU-EQUO",0
9,"9339",128,110,110,0,0,"PODEMOS-IU-EQUO",14
37,"37157",78,63,62,0,1,"PODEMOS-IU-EQUO",5
5,"5903",151,104,104,2,0,"PODEMOS-IU-EQUO",11
5,"5125",55,47,47,0,0,"PODEMOS-IU-EQUO",2
34,"34230",15,12,12,0,0,"PODEMOS-IU-EQUO",1
19,"19124",386,260,257,0,3,"PODEMOS-IU-EQUO",48
5,"5077",158,140,139,1,1,"PODEMOS-IU-EQUO",12
37,"37366",43,32,32,0,0,"PODEMOS-IU-EQUO",5
16,"16903",1070,777,765,4,12,"PODEMOS-IU-EQUO",37
10,"10119",620,460,452,1,8,"PODEMOS-IU-EQUO",65
24,"24180",1134,812,800,9,12,"PODEMOS-IU-EQUO",64
19,"19044",304,245,244,0,1,"PODEMOS-IU-EQUO",28
26,"26039",39,35,35,2,0,"PODEMOS-IU-EQUO",3
38,"38023",121908,81147,80333,494,814,"PODEMOS-IU-EQUO",19018
19,"19003",42,35,34,1,1,"PODEMOS-IU-EQUO",13
16,"16032",278,224,221,1,3,"PODEMOS-IU-EQUO",28
24,"24081",140,98,92,0,6,"PODEMOS-IU-EQUO",3
39,"39065",252,191,189,1,2,"PODEMOS-IU-EQUO",38
16,"16172",325,268,267,1,1,"PODEMOS-IU-EQUO",2
19,"19272",72,54,53,1,1,"PODEMOS-IU-EQUO",9
34,"34083",1769,1218,1201,10,17,"PODEMOS-IU-EQUO",163
26,"26040",70,60,60,0,0,"PODEMOS-IU-EQUO",2
37,"37327",185,149,146,3,3,"PODEMOS-IU-EQUO",20
16,"16126",770,634,624,3,10,"PODEMOS-IU-EQUO",82
5,"5905",217,165,164,0,1,"PODEMOS-IU-EQUO",14
37,"37367",201,164,161,0,3,"PODEMOS-IU-EQUO",6
37,"37284",316,246,238,4,8,"PODEMOS-IU-EQUO",36
26,"26041",132,92,91,0,1,"PODEMOS-IU-EQUO",2
45,"45175",664,545,543,5,2,"PODEMOS-IU-EQUO",30
9,"9430",22,18,17,0,1,"PODEMOS-IU-EQUO",1
16,"16272",221,176,175,0,1,"PODEMOS-IU-EQUO",17
24,"24083",1042,727,715,6,12,"PODEMOS-IU-EQUO",114
9,"9345",123,93,91,2,2,"PODEMOS-IU-EQUO",11
9,"9250",269,196,194,1,2,"PODEMOS-IU-EQUO",16
19,"19240",51,44,42,0,2,"PODEMOS-IU-EQUO",8
16,"16128",63,50,50,0,0,"PODEMOS-IU-EQUO",1
19,"19169",40,34,34,0,0,"PODEMOS-IU-EQUO",12
34,"34042",296,237,234,1,3,"PODEMOS-IU-EQUO",12
39,"39037",1987,1516,1503,8,13,"PODEMOS-IU-EQUO",226
45,"45176",3706,2554,2521,22,33,"PODEMOS-IU-EQUO",522
9,"9166",97,81,81,0,0,"PODEMOS-IU-EQUO",6
5,"5081",40,36,36,1,0,"PODEMOS-IU-EQUO",2
37,"37202",978,734,727,10,7,"PODEMOS-IU-EQUO",132
16,"16036",126,109,106,0,3,"PODEMOS-IU-EQUO",28
45,"45010",415,311,310,2,1,"PODEMOS-IU-EQUO",35
13,"13053",14328,10164,10041,72,123,"PODEMOS-IU-EQUO",1438
16,"16908",186,152,152,1,0,"PODEMOS-IU-EQUO",40
5,"5179",214,178,176,1,2,"PODEMOS-IU-EQUO",1
13,"13054",4944,3729,3678,27,51,"PODEMOS-IU-EQUO",296
51,"51001",59125,31093,30737,316,356,"PODEMOS-IU-EQUO",3322
16,"16085",138,113,112,0,1,"PODEMOS-IU-EQUO",12
37,"37246",5304,3993,3949,26,44,"PODEMOS-IU-EQUO",403
37,"37370",328,258,254,1,4,"PODEMOS-IU-EQUO",18
37,"37287",310,213,210,2,3,"PODEMOS-IU-EQUO",14
30,"30036",14698,9859,9734,41,125,"PODEMOS-IU-EQUO",1245
24,"24221",795,543,538,7,5,"PODEMOS-IU-EQUO",68
9,"9122",94,67,66,1,1,"PODEMOS-IU-EQUO",1
2,"2030",3065,2287,2263,6,24,"PODEMOS-IU-EQUO",271
9,"9281",145,114,109,1,5,"PODEMOS-IU-EQUO",8
37,"37233",61,48,47,1,1,"PODEMOS-IU-EQUO",5
26,"26113",35,35,34,0,1,"PODEMOS-IU-EQUO",0
42,"42065",21,18,18,0,0,"PODEMOS-IU-EQUO",3
19,"19243",44,31,31,0,0,"PODEMOS-IU-EQUO",5
16,"16910",91,69,69,1,0,"PODEMOS-IU-EQUO",16
6,"6051",1571,1192,1178,7,14,"PODEMOS-IU-EQUO",61
6,"6097",2362,1750,1727,7,23,"PODEMOS-IU-EQUO",226
19,"19007",459,341,336,0,5,"PODEMOS-IU-EQUO",35
9,"9038",119,100,100,0,0,"PODEMOS-IU-EQUO",12
34,"34089",155,124,124,2,0,"PODEMOS-IU-EQUO",25
45,"45079",369,288,286,3,2,"PODEMOS-IU-EQUO",43
13,"13005",23298,17250,17070,140,180,"PODEMOS-IU-EQUO",3018
9,"9350",469,350,343,2,7,"PODEMOS-IU-EQUO",18
37,"37164",256,191,189,5,2,"PODEMOS-IU-EQUO",42
19,"19049",10,10,9,0,1,"PODEMOS-IU-EQUO",0
9,"9348",148,111,110,2,1,"PODEMOS-IU-EQUO",14
6,"6144",556,431,425,0,6,"PODEMOS-IU-EQUO",68
39,"39070",144,96,94,2,2,"PODEMOS-IU-EQUO",10
19,"19050",16,15,15,0,0,"PODEMOS-IU-EQUO",2
39,"39100",860,633,629,15,4,"PODEMOS-IU-EQUO",63
37,"37304",169,124,124,0,0,"PODEMOS-IU-EQUO",5
10,"10142",832,627,621,5,6,"PODEMOS-IU-EQUO",111
6,"6098",549,385,381,7,4,"PODEMOS-IU-EQUO",26
37,"37091",177,117,116,1,1,"PODEMOS-IU-EQUO",6
16,"16055",691,466,463,2,3,"PODEMOS-IU-EQUO",47
9,"9304",199,157,155,3,2,"PODEMOS-IU-EQUO",10
45,"45081",17875,12656,12533,82,123,"PODEMOS-IU-EQUO",2202
9,"9306",106,82,82,1,0,"PODEMOS-IU-EQUO",6
37,"37335",406,296,290,0,6,"PODEMOS-IU-EQUO",18
19,"19010",8,8,8,0,0,"PODEMOS-IU-EQUO",1
5,"5184",246,183,183,0,0,"PODEMOS-IU-EQUO",26
45,"45114",588,447,447,0,0,"PODEMOS-IU-EQUO",37
16,"16243",407,338,334,3,4,"PODEMOS-IU-EQUO",59
34,"34240",89,64,64,0,0,"PODEMOS-IU-EQUO",7
10,"10084",1345,888,875,4,13,"PODEMOS-IU-EQUO",99
10,"10175",1416,1006,980,4,26,"PODEMOS-IU-EQUO",148
9,"9172",129,103,101,1,2,"PODEMOS-IU-EQUO",13
9,"9352",114,92,92,1,0,"PODEMOS-IU-EQUO",5
42,"42118",23,17,17,0,0,"PODEMOS-IU-EQUO",1
9,"9079",49,45,45,0,0,"PODEMOS-IU-EQUO",3
5,"5122",134,102,101,0,1,"PODEMOS-IU-EQUO",2
9,"9030",112,75,73,1,2,"PODEMOS-IU-EQUO",6
37,"37363",118,88,87,0,1,"PODEMOS-IU-EQUO",8
19,"19052",25,21,21,1,0,"PODEMOS-IU-EQUO",0
9,"9396",156,121,121,0,0,"PODEMOS-IU-EQUO",14
24,"24225",1014,752,739,10,13,"PODEMOS-IU-EQUO",119
5,"5040",66,50,50,1,0,"PODEMOS-IU-EQUO",2
37,"37376",2233,1539,1515,6,24,"PODEMOS-IU-EQUO",136
34,"34192",90,75,72,0,3,"PODEMOS-IU-EQUO",8
45,"45015",606,437,433,2,4,"PODEMOS-IU-EQUO",60
37,"37169",176,127,126,0,1,"PODEMOS-IU-EQUO",7
45,"45183",2220,1444,1428,3,16,"PODEMOS-IU-EQUO",294
37,"37253",135,109,109,2,0,"PODEMOS-IU-EQUO",10
9,"9353",76,57,56,1,1,"PODEMOS-IU-EQUO",10
2,"2036",95,78,78,0,0,"PODEMOS-IU-EQUO",11
5,"5140",111,89,87,0,2,"PODEMOS-IU-EQUO",2
16,"16246",482,361,355,3,6,"PODEMOS-IU-EQUO",17
9,"9218",369,275,275,1,0,"PODEMOS-IU-EQUO",38
19,"19136",18,14,14,0,0,"PODEMOS-IU-EQUO",1
45,"45083",472,368,365,0,3,"PODEMOS-IU-EQUO",34
37,"37034",85,65,65,0,0,"PODEMOS-IU-EQUO",6
10,"10132",396,278,275,0,3,"PODEMOS-IU-EQUO",17
37,"37294",11692,8317,8221,71,96,"PODEMOS-IU-EQUO",1333
9,"9905",384,279,279,2,0,"PODEMOS-IU-EQUO",73
19,"19325",121,83,82,0,1,"PODEMOS-IU-EQUO",6
42,"42211",82,66,66,1,0,"PODEMOS-IU-EQUO",11
26,"26155",160,132,132,0,0,"PODEMOS-IU-EQUO",17
10,"10133",1206,956,945,5,11,"PODEMOS-IU-EQUO",147
13,"13064",1696,1231,1225,9,6,"PODEMOS-IU-EQUO",189
13,"13065",2854,1901,1888,9,13,"PODEMOS-IU-EQUO",162
6,"6151",1070,770,766,3,4,"PODEMOS-IU-EQUO",91
24,"24058",208,155,154,3,1,"PODEMOS-IU-EQUO",12
45,"45150",443,356,354,0,2,"PODEMOS-IU-EQUO",19
45,"45118",1991,1351,1339,6,12,"PODEMOS-IU-EQUO",196
26,"26083",284,205,205,2,0,"PODEMOS-IU-EQUO",29
38,"38034",4049,2855,2807,19,48,"PODEMOS-IU-EQUO",328
2,"2039",984,790,786,10,4,"PODEMOS-IU-EQUO",86
42,"42076",216,179,174,5,5,"PODEMOS-IU-EQUO",27
16,"16003",125,105,104,0,1,"PODEMOS-IU-EQUO",7
19,"19177",76,61,59,0,2,"PODEMOS-IU-EQUO",9
16,"16249",1995,1519,1499,6,20,"PODEMOS-IU-EQUO",160
5,"5239",214,164,162,3,2,"PODEMOS-IU-EQUO",11
37,"37130",172,151,150,0,1,"PODEMOS-IU-EQUO",2
37,"37298",179,127,126,0,1,"PODEMOS-IU-EQUO",9
9,"9356",42,33,32,0,1,"PODEMOS-IU-EQUO",3
26,"26051",239,193,191,1,2,"PODEMOS-IU-EQUO",30
26,"26158",251,214,210,0,4,"PODEMOS-IU-EQUO",16
24,"24193",378,268,265,2,3,"PODEMOS-IU-EQUO",59
42,"42078",1020,717,703,7,14,"PODEMOS-IU-EQUO",94
42,"42035",769,527,516,2,11,"PODEMOS-IU-EQUO",53
37,"37257",52,46,46,0,0,"PODEMOS-IU-EQUO",7
45,"45053",8005,6211,6140,42,71,"PODEMOS-IU-EQUO",684
19,"19274",902,660,651,7,9,"PODEMOS-IU-EQUO",124
34,"34056",1998,1452,1444,13,8,"PODEMOS-IU-EQUO",215
5,"5145",50,40,40,0,0,"PODEMOS-IU-EQUO",5
9,"9358",255,194,190,3,4,"PODEMOS-IU-EQUO",12
37,"37173",1504,1129,1114,4,15,"PODEMOS-IU-EQUO",123
42,"42079",26,18,18,1,0,"PODEMOS-IU-EQUO",0
37,"37299",219,166,163,4,3,"PODEMOS-IU-EQUO",9
13,"13069",660,508,499,7,9,"PODEMOS-IU-EQUO",49
6,"6018",753,535,529,3,6,"PODEMOS-IU-EQUO",105
42,"42173",29281,20286,20035,261,251,"PODEMOS-IU-EQUO",3728
34,"34151",159,104,103,0,1,"PODEMOS-IU-EQUO",10
9,"9314",94,73,70,0,3,"PODEMOS-IU-EQUO",10
9,"9011",65,48,48,0,0,"PODEMOS-IU-EQUO",8
39,"39016",23868,17883,17701,122,182,"PODEMOS-IU-EQUO",3201
5,"5048",118,104,104,0,0,"PODEMOS-IU-EQUO",10
9,"9133",40,32,32,0,0,"PODEMOS-IU-EQUO",8
2,"2042",837,618,611,1,7,"PODEMOS-IU-EQUO",72
34,"34011",397,321,320,5,1,"PODEMOS-IU-EQUO",27
2,"2043",1239,937,927,3,10,"PODEMOS-IU-EQUO",65
34,"34152",125,96,92,1,4,"PODEMOS-IU-EQUO",9
6,"6065",311,236,228,1,8,"PODEMOS-IU-EQUO",18
42,"42127",38,31,31,1,0,"PODEMOS-IU-EQUO",1
45,"45021",2500,1708,1665,12,43,"PODEMOS-IU-EQUO",241
37,"37217",58,45,44,0,1,"PODEMOS-IU-EQUO",6
34,"34058",189,172,172,2,0,"PODEMOS-IU-EQUO",16
42,"42218",82,55,55,0,0,"PODEMOS-IU-EQUO",9
5,"5049",401,272,266,1,6,"PODEMOS-IU-EQUO",24
10,"10047",955,732,727,1,5,"PODEMOS-IU-EQUO",153
30,"30016",151668,102093,101363,484,730,"PODEMOS-IU-EQUO",15650
10,"10094",234,196,196,1,0,"PODEMOS-IU-EQUO",26
13,"13020",4781,3198,3161,31,37,"PODEMOS-IU-EQUO",540
38,"38039",10641,7547,7459,49,88,"PODEMOS-IU-EQUO",760
45,"45190",475,371,366,0,5,"PODEMOS-IU-EQUO",36
9,"9409",111,86,86,4,0,"PODEMOS-IU-EQUO",30
42,"42039",226,138,138,4,0,"PODEMOS-IU-EQUO",23
45,"45090",384,294,293,3,1,"PODEMOS-IU-EQUO",19
6,"6112",393,323,321,2,2,"PODEMOS-IU-EQUO",36
37,"37177",289,220,219,2,1,"PODEMOS-IU-EQUO",26
9,"9362",208,172,171,2,1,"PODEMOS-IU-EQUO",33
24,"24165",354,240,238,2,2,"PODEMOS-IU-EQUO",27
9,"9447",44,41,41,0,0,"PODEMOS-IU-EQUO",2
19,"19220",2302,1519,1501,1,18,"PODEMOS-IU-EQUO",409
16,"16197",59,42,42,0,0,"PODEMOS-IU-EQUO",3
5,"5052",95,77,76,0,1,"PODEMOS-IU-EQUO",2
26,"26126",31,27,27,0,0,"PODEMOS-IU-EQUO",1
39,"39019",2079,1560,1531,10,29,"PODEMOS-IU-EQUO",309
9,"9093",154,121,119,0,2,"PODEMOS-IU-EQUO",16
34,"34017",918,744,736,9,8,"PODEMOS-IU-EQUO",90
16,"16150",97,72,72,0,0,"PODEMOS-IU-EQUO",6
5,"5119",32,22,22,0,0,"PODEMOS-IU-EQUO",3
19,"19196",105,84,81,0,3,"PODEMOS-IU-EQUO",8
42,"42084",25,22,22,1,0,"PODEMOS-IU-EQUO",0
19,"19119",82,72,71,1,1,"PODEMOS-IU-EQUO",10
26,"26035",17,12,11,0,1,"PODEMOS-IU-EQUO",0
38,"38004",4456,3026,2983,23,43,"PODEMOS-IU-EQUO",515
6,"6023",4302,3041,3007,16,34,"PODEMOS-IU-EQUO",318
5,"5153",103,78,77,1,1,"PODEMOS-IU-EQUO",6
37,"37003",115,93,93,0,0,"PODEMOS-IU-EQUO",3
26,"26165",358,304,299,2,5,"PODEMOS-IU-EQUO",38
37,"37305",216,171,170,0,1,"PODEMOS-IU-EQUO",19
26,"26057",48,38,38,0,0,"PODEMOS-IU-EQUO",3
19,"19185",28,21,20,0,1,"PODEMOS-IU-EQUO",6
45,"45025",1205,831,827,2,4,"PODEMOS-IU-EQUO",142
38,"38042",3802,2652,2625,14,27,"PODEMOS-IU-EQUO",328
16,"16056",457,306,305,3,1,"PODEMOS-IU-EQUO",36
19,"19023",124,100,98,2,2,"PODEMOS-IU-EQUO",16
16,"16012",84,72,71,0,1,"PODEMOS-IU-EQUO",6
35,"35029",4152,2530,2498,32,32,"PODEMOS-IU-EQUO",421
45,"45159",90,75,75,0,0,"PODEMOS-IU-EQUO",5
34,"34108",542,421,417,3,4,"PODEMOS-IU-EQUO",41
26,"26152",33,28,28,1,0,"PODEMOS-IU-EQUO",3
16,"16245",419,327,323,7,4,"PODEMOS-IU-EQUO",32
37,"37223",110,85,83,0,2,"PODEMOS-IU-EQUO",2
13,"13078",9041,6325,6266,47,59,"PODEMOS-IU-EQUO",662
2,"2048",1226,981,975,7,6,"PODEMOS-IU-EQUO",82
2,"2049",823,573,564,1,9,"PODEMOS-IU-EQUO",36
6,"6026",837,598,591,0,7,"PODEMOS-IU-EQUO",46
38,"38044",2188,1348,1334,6,14,"PODEMOS-IU-EQUO",87
16,"16153",949,778,772,7,6,"PODEMOS-IU-EQUO",66
38,"38008",5520,3825,3766,17,59,"PODEMOS-IU-EQUO",485
45,"45160",1109,874,864,6,10,"PODEMOS-IU-EQUO",92
19,"19187",48,43,43,0,0,"PODEMOS-IU-EQUO",2
34,"34022",1082,873,861,9,12,"PODEMOS-IU-EQUO",104
19,"19259",30,25,25,1,0,"PODEMOS-IU-EQUO",9
24,"24067",623,388,384,0,4,"PODEMOS-IU-EQUO",19
9,"9189",125,90,87,2,3,"PODEMOS-IU-EQUO",6
19,"19901",41,38,37,0,1,"PODEMOS-IU-EQUO",5
42,"42088",67,47,47,1,0,"PODEMOS-IU-EQUO",1
45,"45027",346,275,272,0,3,"PODEMOS-IU-EQUO",34
37,"37183",414,306,304,0,2,"PODEMOS-IU-EQUO",30
24,"24134",3416,2470,2417,19,53,"PODEMOS-IU-EQUO",458
24,"24034",3394,2380,2342,28,38,"PODEMOS-IU-EQUO",553
39,"39023",6330,4737,4672,25,65,"PODEMOS-IU-EQUO",756
24,"24102",652,470,467,2,3,"PODEMOS-IU-EQUO",55
10,"10011",560,458,448,5,10,"PODEMOS-IU-EQUO",25
10,"10194",542,415,407,2,8,"PODEMOS-IU-EQUO",53
6,"6028",4233,3588,3499,30,89,"PODEMOS-IU-EQUO",253
13,"13030",139,98,96,0,2,"PODEMOS-IU-EQUO",2
16,"16109",44,38,38,1,0,"PODEMOS-IU-EQUO",3
37,"37051",85,66,66,0,0,"PODEMOS-IU-EQUO",3
24,"24205",945,694,685,11,9,"PODEMOS-IU-EQUO",96
16,"16108",49,45,42,0,3,"PODEMOS-IU-EQUO",14
42,"42046",49,39,39,0,0,"PODEMOS-IU-EQUO",16
42,"42021",83,55,55,3,0,"PODEMOS-IU-EQUO",3
10,"10210",543,356,355,1,1,"PODEMOS-IU-EQUO",24
6,"6029",1195,855,841,3,14,"PODEMOS-IU-EQUO",88
9,"9060",145,114,113,2,1,"PODEMOS-IU-EQUO",5
19,"19261",37,25,24,0,1,"PODEMOS-IU-EQUO",1
42,"42090",91,69,67,1,2,"PODEMOS-IU-EQUO",3
35,"35032",3412,2473,2425,17,48,"PODEMOS-IU-EQUO",376
45,"45063",417,310,303,1,7,"PODEMOS-IU-EQUO",35
13,"13083",2423,1693,1653,10,40,"PODEMOS-IU-EQUO",171
5,"5257",132,101,101,0,0,"PODEMOS-IU-EQUO",17
45,"45029",201,171,171,1,0,"PODEMOS-IU-EQUO",24
10,"10058",1021,718,708,2,10,"PODEMOS-IU-EQUO",87
30,"30003",24332,16183,16040,104,143,"PODEMOS-IU-EQUO",2398
19,"19073",23,19,19,0,0,"PODEMOS-IU-EQUO",3
5,"5112",97,71,70,2,1,"PODEMOS-IU-EQUO",14
37,"37354",5240,3823,3771,39,52,"PODEMOS-IU-EQUO",588
26,"26099",1264,1003,991,9,12,"PODEMOS-IU-EQUO",127
9,"9327",26,24,24,0,0,"PODEMOS-IU-EQUO",7
6,"6062",594,441,437,5,4,"PODEMOS-IU-EQUO",36
37,"37187",572,427,423,1,4,"PODEMOS-IU-EQUO",13
6,"6124",1708,1202,1165,8,37,"PODEMOS-IU-EQUO",124
26,"26063",124,94,94,2,0,"PODEMOS-IU-EQUO",9
9,"9328",76,56,56,0,0,"PODEMOS-IU-EQUO",8
16,"16019",214,156,152,0,4,"PODEMOS-IU-EQUO",8
6,"6033",1327,1011,1006,10,5,"PODEMOS-IU-EQUO",77
42,"42011",18,10,10,1,0,"PODEMOS-IU-EQUO",0
42,"42050",31,18,18,0,0,"PODEMOS-IU-EQUO",0
16,"16112",1497,1031,1021,9,10,"PODEMOS-IU-EQUO",135
37,"37188",181,129,129,3,0,"PODEMOS-IU-EQUO",11
5,"5163",1737,1347,1340,4,7,"PODEMOS-IU-EQUO",185
5,"5064",103,83,82,0,1,"PODEMOS-IU-EQUO",0
19,"19116",12,9,9,0,0,"PODEMOS-IU-EQUO",3
10,"10153",309,222,218,0,4,"PODEMOS-IU-EQUO",28
37,"37356",87,67,65,0,2,"PODEMOS-IU-EQUO",2
39,"39057",2330,1671,1645,7,26,"PODEMOS-IU-EQUO",286
10,"10199",165,112,111,1,1,"PODEMOS-IU-EQUO",6
38,"38013",2949,1896,1867,17,29,"PODEMOS-IU-EQUO",212
34,"34072",152,136,135,2,1,"PODEMOS-IU-EQUO",9
37,"37315",96,70,70,0,0,"PODEMOS-IU-EQUO",4
5,"5033",176,144,142,1,2,"PODEMOS-IU-EQUO",8
34,"34028",143,116,113,1,3,"PODEMOS-IU-EQUO",18
42,"42144",436,353,348,2,5,"PODEMOS-IU-EQUO",69
45,"45144",783,620,618,3,2,"PODEMOS-IU-EQUO",76
26,"26136",107,85,85,0,0,"PODEMOS-IU-EQUO",25
42,"42095",1773,1269,1251,15,18,"PODEMOS-IU-EQUO",233
45,"45200",4592,3539,3476,14,63,"PODEMOS-IU-EQUO",311
5,"5164",26,14,14,0,0,"PODEMOS-IU-EQUO",0
5,"5066",453,367,367,5,0,"PODEMOS-IU-EQUO",109
45,"45133",2797,2068,2048,13,20,"PODEMOS-IU-EQUO",258
6,"6082",383,287,286,2,1,"PODEMOS-IU-EQUO",32
37,"37190",215,171,171,1,0,"PODEMOS-IU-EQUO",7
10,"10156",97,73,72,1,1,"PODEMOS-IU-EQUO",14
26,"26066",251,201,194,1,7,"PODEMOS-IU-EQUO",20
10,"10201",173,142,142,2,0,"PODEMOS-IU-EQUO",6
19,"19078",50,44,43,0,1,"PODEMOS-IU-EQUO",10
16,"16276",21,16,16,1,0,"PODEMOS-IU-EQUO",2
2,"2058",337,234,231,0,3,"PODEMOS-IU-EQUO",33
6,"6037",1748,1148,1134,9,14,"PODEMOS-IU-EQUO",88
34,"34122",83,60,60,0,0,"PODEMOS-IU-EQUO",4
10,"10157",263,204,201,0,3,"PODEMOS-IU-EQUO",39
45,"45168",62229,47154,46741,285,413,"PODEMOS-IU-EQUO",7767
26,"26174",146,107,105,2,2,"PODEMOS-IU-EQUO",15
16,"16068",137,98,97,1,1,"PODEMOS-IU-EQUO",4
5,"5167",254,207,202,4,5,"PODEMOS-IU-EQUO",36
45,"45202",3894,2776,2744,14,32,"PODEMOS-IU-EQUO",292
6,"6083",46149,31049,30739,234,310,"PODEMOS-IU-EQUO",5054
42,"42016",18,14,14,0,0,"PODEMOS-IU-EQUO",2
37,"37029",209,137,135,1,2,"PODEMOS-IU-EQUO",7
10,"10051",430,308,296,0,12,"PODEMOS-IU-EQUO",6
45,"45069",1847,1391,1376,6,15,"PODEMOS-IU-EQUO",202
30,"30018",7978,5866,5811,30,55,"PODEMOS-IU-EQUO",689
45,"45157",2128,1456,1427,13,29,"PODEMOS-IU-EQUO",262
37,"37151",148,125,124,2,1,"PODEMOS-IU-EQUO",2
10,"10158",330,269,267,0,2,"PODEMOS-IU-EQUO",20
34,"34174",200,159,154,5,5,"PODEMOS-IU-EQUO",13
5,"5168",3560,2589,2561,19,28,"PODEMOS-IU-EQUO",260
5,"5120",36,26,26,0,0,"PODEMOS-IU-EQUO",2
6,"6039",1840,1469,1437,9,32,"PODEMOS-IU-EQUO",128
5,"5019",44555,33259,32939,277,320,"PODEMOS-IU-EQUO",4570
45,"45169",189,140,138,0,2,"PODEMOS-IU-EQUO",5
16,"16218",191,150,150,3,0,"PODEMOS-IU-EQUO",8
37,"37017",245,182,177,1,5,"PODEMOS-IU-EQUO",13
37,"37250",356,229,228,0,1,"PODEMOS-IU-EQUO",31
19,"19120",101,88,88,1,0,"PODEMOS-IU-EQUO",17
37,"37321",168,132,132,2,0,"PODEMOS-IU-EQUO",18
35,"35012",10382,5443,5392,17,51,"PODEMOS-IU-EQUO",941
19,"19162",68,49,47,0,2,"PODEMOS-IU-EQUO",8
37,"37062",83,65,64,1,1,"PODEMOS-IU-EQUO",0
9,"9413",436,306,302,2,4,"PODEMOS-IU-EQUO",58
42,"42086",36,27,26,2,1,"PODEMOS-IU-EQUO",2
6,"6132",855,587,582,3,5,"PODEMOS-IU-EQUO",112
6,"6087",2110,1583,1561,8,22,"PODEMOS-IU-EQUO",149
45,"45037",1603,1122,1111,5,11,"PODEMOS-IU-EQUO",153
34,"34079",1616,1222,1205,5,17,"PODEMOS-IU-EQUO",173
10,"10206",215,157,157,3,0,"PODEMOS-IU-EQUO",21
9,"9068",29,24,24,0,0,"PODEMOS-IU-EQUO",6
6,"6133",1775,1324,1312,15,12,"PODEMOS-IU-EQUO",79
45,"45071",1835,1426,1408,5,18,"PODEMOS-IU-EQUO",269
34,"34035",111,98,97,0,1,"PODEMOS-IU-EQUO",7
9,"9425",517,384,378,0,6,"PODEMOS-IU-EQUO",89
37,"37239",217,185,183,3,2,"PODEMOS-IU-EQUO",37
5,"5023",168,146,145,1,1,"PODEMOS-IU-EQUO",5
9,"9201",28,18,18,1,0,"PODEMOS-IU-EQUO",0
39,"39003",297,220,215,0,5,"PODEMOS-IU-EQUO",38
10,"10208",123,94,93,1,1,"PODEMOS-IU-EQUO",7
10,"10162",575,437,433,2,4,"PODEMOS-IU-EQUO",54
9,"9114",86,66,66,0,0,"PODEMOS-IU-EQUO",4
42,"42020",4263,2877,2821,35,56,"PODEMOS-IU-EQUO",420
19,"19001",49,42,42,0,0,"PODEMOS-IU-EQUO",3
19,"19043",84,72,72,0,0,"PODEMOS-IU-EQUO",5
26,"26179",41,32,31,0,1,"PODEMOS-IU-EQUO",0
2,"2065",476,394,392,1,2,"PODEMOS-IU-EQUO",46
16,"16902",137,107,107,0,0,"PODEMOS-IU-EQUO",15
16,"16124",1858,1476,1459,12,17,"PODEMOS-IU-EQUO",280
5,"5025",94,79,78,0,1,"PODEMOS-IU-EQUO",2
5,"5076",478,386,378,4,8,"PODEMOS-IU-EQUO",46
45,"45073",298,233,233,1,0,"PODEMOS-IU-EQUO",46
5,"5026",195,166,164,2,2,"PODEMOS-IU-EQUO",25
10,"10026",648,500,492,7,8,"PODEMOS-IU-EQUO",97
5,"5174",68,53,53,2,0,"PODEMOS-IU-EQUO",4
34,"34037",302,218,216,1,2,"PODEMOS-IU-EQUO",20
9,"9175",127,94,93,2,1,"PODEMOS-IU-EQUO",11
34,"34005",851,673,658,4,15,"PODEMOS-IU-EQUO",74
37,"37282",204,149,148,1,1,"PODEMOS-IU-EQUO",9
19,"19167",130,101,99,0,2,"PODEMOS-IU-EQUO",10
5,"5222",147,127,126,1,1,"PODEMOS-IU-EQUO",10
13,"13902",469,367,363,0,4,"PODEMOS-IU-EQUO",45
37,"37068",365,267,267,1,0,"PODEMOS-IU-EQUO",23
35,"35015",9950,5139,5070,29,69,"PODEMOS-IU-EQUO",1200
24,"24082",858,629,614,8,15,"PODEMOS-IU-EQUO",111
9,"9343",93,66,65,0,1,"PODEMOS-IU-EQUO",3
42,"42198",23,16,16,4,0,"PODEMOS-IU-EQUO",1
13,"13049",799,540,531,0,9,"PODEMOS-IU-EQUO",54
34,"34201",193,158,155,1,3,"PODEMOS-IU-EQUO",17
9,"9388",34,27,26,0,1,"PODEMOS-IU-EQUO",6
9,"9249",46,33,33,0,0,"PODEMOS-IU-EQUO",3
19,"19125",41,32,32,0,0,"PODEMOS-IU-EQUO",5
5,"5225",372,285,281,1,4,"PODEMOS-IU-EQUO",26
39,"39005",1380,1053,1046,9,7,"PODEMOS-IU-EQUO",150
45,"45075",143,109,108,0,1,"PODEMOS-IU-EQUO",18
37,"37200",187,136,136,0,0,"PODEMOS-IU-EQUO",6
10,"10076",832,556,541,1,15,"PODEMOS-IU-EQUO",43
45,"45009",524,344,341,2,3,"PODEMOS-IU-EQUO",36
16,"16236",910,656,651,4,5,"PODEMOS-IU-EQUO",36
37,"37070",529,399,392,1,7,"PODEMOS-IU-EQUO",52
5,"5177",158,130,129,0,1,"PODEMOS-IU-EQUO",20
42,"42110",59,45,45,2,0,"PODEMOS-IU-EQUO",9
6,"6003",823,627,616,1,11,"PODEMOS-IU-EQUO",63
37,"37285",403,310,308,2,2,"PODEMOS-IU-EQUO",29
19,"19314",51,36,36,0,0,"PODEMOS-IU-EQUO",1
42,"42158",103,76,76,0,0,"PODEMOS-IU-EQUO",15
16,"16129",95,81,79,0,2,"PODEMOS-IU-EQUO",3
19,"19047",64,55,55,0,0,"PODEMOS-IU-EQUO",19
9,"9251",375,277,274,4,3,"PODEMOS-IU-EQUO",55
42,"42063",49,35,35,0,0,"PODEMOS-IU-EQUO",2
9,"9482",33,28,28,0,0,"PODEMOS-IU-EQUO",5
39,"39067",790,513,505,1,8,"PODEMOS-IU-EQUO",57
26,"26112",236,194,190,1,4,"PODEMOS-IU-EQUO",14
6,"6095",9504,6621,6475,96,146,"PODEMOS-IU-EQUO",1049
9,"9167",58,41,41,1,0,"PODEMOS-IU-EQUO",2
10,"10093",398,317,312,4,5,"PODEMOS-IU-EQUO",35
10,"10078",406,321,314,6,7,"PODEMOS-IU-EQUO",49
16,"16175",5095,3980,3914,35,66,"PODEMOS-IU-EQUO",351
37,"37040",391,299,297,2,2,"PODEMOS-IU-EQUO",25
26,"26010",93,80,80,2,0,"PODEMOS-IU-EQUO",5
24,"24052",158,104,102,0,2,"PODEMOS-IU-EQUO",18
38,"38038",162027,104978,104035,575,943,"PODEMOS-IU-EQUO",22038
37,"37072",168,140,138,0,2,"PODEMOS-IU-EQUO",3
35,"35018",12552,7609,7547,54,62,"PODEMOS-IU-EQUO",1994
19,"19280",3464,2469,2438,14,31,"PODEMOS-IU-EQUO",594
19,"19279",57,55,55,0,0,"PODEMOS-IU-EQUO",3
39,"39099",3114,2308,2281,12,27,"PODEMOS-IU-EQUO",432
37,"37288",262,182,181,4,1,"PODEMOS-IU-EQUO",18
42,"42113",534,409,399,1,10,"PODEMOS-IU-EQUO",38
10,"10217",526,404,402,1,2,"PODEMOS-IU-EQUO",26
6,"6143",3360,2353,2321,12,32,"PODEMOS-IU-EQUO",301
5,"5132",960,669,657,1,12,"PODEMOS-IU-EQUO",112
13,"13003",480,382,380,1,2,"PODEMOS-IU-EQUO",31
13,"13004",1025,807,800,4,7,"PODEMOS-IU-EQUO",63
45,"45145",2565,1695,1675,12,20,"PODEMOS-IU-EQUO",242
34,"34047",1782,1397,1374,12,23,"PODEMOS-IU-EQUO",85
10,"10081",182,142,135,2,7,"PODEMOS-IU-EQUO",19
10,"10172",709,466,465,0,1,"PODEMOS-IU-EQUO",75
9,"9124",1506,1040,1028,6,12,"PODEMOS-IU-EQUO",126
6,"6052",4030,2735,2688,20,47,"PODEMOS-IU-EQUO",264
16,"16087",208,179,177,5,2,"PODEMOS-IU-EQUO",10
37,"37333",224,142,142,1,0,"PODEMOS-IU-EQUO",17
42,"42116",45,39,38,3,1,"PODEMOS-IU-EQUO",2
6,"6159",2329,1351,1318,16,33,"PODEMOS-IU-EQUO",171
9,"9334",50,39,37,0,2,"PODEMOS-IU-EQUO",7
34,"34061",106,82,82,1,0,"PODEMOS-IU-EQUO",9
24,"24042",63,56,56,1,0,"PODEMOS-IU-EQUO",2
34,"34123",1648,1287,1258,12,29,"PODEMOS-IU-EQUO",139
19,"19256",43,36,36,0,0,"PODEMOS-IU-EQUO",3
10,"10188",499,382,374,4,8,"PODEMOS-IU-EQUO",31
34,"34189",56,44,44,1,0,"PODEMOS-IU-EQUO",3
38,"38030",1933,1296,1290,2,6,"PODEMOS-IU-EQUO",146
34,"34241",18,13,13,1,0,"PODEMOS-IU-EQUO",0
9,"9127",56,41,39,0,2,"PODEMOS-IU-EQUO",4
37,"37124",212,146,144,1,2,"PODEMOS-IU-EQUO",19
5,"5087",134,87,85,1,2,"PODEMOS-IU-EQUO",8
37,"37030",85,66,66,0,0,"PODEMOS-IU-EQUO",9
10,"10129",365,275,271,0,4,"PODEMOS-IU-EQUO",42
26,"26025",87,71,70,1,1,"PODEMOS-IU-EQUO",9
24,"24157",2568,1943,1911,22,32,"PODEMOS-IU-EQUO",236
39,"39072",344,198,196,2,2,"PODEMOS-IU-EQUO",26
9,"9438",538,437,433,6,4,"PODEMOS-IU-EQUO",46
45,"45182",1034,806,791,1,15,"PODEMOS-IU-EQUO",118
2,"2075",1670,1321,1304,4,17,"PODEMOS-IU-EQUO",135
9,"9467",64,43,42,1,1,"PODEMOS-IU-EQUO",3
16,"16121",258,202,202,3,0,"PODEMOS-IU-EQUO",41
37,"37292",104,77,77,1,0,"PODEMOS-IU-EQUO",3
34,"34190",56,41,40,2,1,"PODEMOS-IU-EQUO",1
42,"42164",1600,1150,1127,8,23,"PODEMOS-IU-EQUO",152
9,"9173",124,100,99,2,1,"PODEMOS-IU-EQUO",8
9,"9439",1028,752,744,9,8,"PODEMOS-IU-EQUO",136
26,"26014",474,327,324,1,3,"PODEMOS-IU-EQUO",45
19,"19246",46,36,34,2,2,"PODEMOS-IU-EQUO",5
10,"10085",323,235,233,0,2,"PODEMOS-IU-EQUO",19
13,"13010",883,646,634,3,12,"PODEMOS-IU-EQUO",53
16,"16043",95,73,73,1,0,"PODEMOS-IU-EQUO",6
16,"16137",54,32,31,1,1,"PODEMOS-IU-EQUO",2
5,"5041",1001,775,762,8,13,"PODEMOS-IU-EQUO",92
26,"26082",112,87,87,1,0,"PODEMOS-IU-EQUO",10
45,"45016",4204,3146,3105,22,41,"PODEMOS-IU-EQUO",552
37,"37293",115,84,84,1,0,"PODEMOS-IU-EQUO",5
16,"16189",264,206,205,4,1,"PODEMOS-IU-EQUO",17
37,"37211",224,172,172,4,0,"PODEMOS-IU-EQUO",12
24,"24122",1342,930,924,8,6,"PODEMOS-IU-EQUO",118
24,"24227",1607,1127,1116,22,11,"PODEMOS-IU-EQUO",153
10,"10040",441,313,307,4,6,"PODEMOS-IU-EQUO",40
37,"37338",79,65,64,0,1,"PODEMOS-IU-EQUO",7
19,"19214",75,60,58,0,2,"PODEMOS-IU-EQUO",4
19,"19176",237,181,181,0,0,"PODEMOS-IU-EQUO",8
16,"16045",222,172,171,1,1,"PODEMOS-IU-EQUO",27
13,"13012",413,274,273,1,1,"PODEMOS-IU-EQUO",30
9,"9403",94,78,78,1,0,"PODEMOS-IU-EQUO",2
45,"45117",747,606,601,4,5,"PODEMOS-IU-EQUO",39
9,"9130",74,51,50,1,1,"PODEMOS-IU-EQUO",4
16,"16046",245,180,180,1,0,"PODEMOS-IU-EQUO",2
37,"37296",336,259,254,2,5,"PODEMOS-IU-EQUO",10
5,"5141",94,80,80,1,0,"PODEMOS-IU-EQUO",10
37,"37067",3163,2496,2467,31,29,"PODEMOS-IU-EQUO",443
19,"19166",156,120,119,1,1,"PODEMOS-IU-EQUO",26
39,"39014",883,619,614,6,5,"PODEMOS-IU-EQUO",131
39,"39015",839,647,642,4,5,"PODEMOS-IU-EQUO",57
10,"10180",4134,2643,2601,25,42,"PODEMOS-IU-EQUO",290
19,"19326",1841,1280,1272,1,8,"PODEMOS-IU-EQUO",259
5,"5044",266,183,183,1,0,"PODEMOS-IU-EQUO",5
9,"9009",163,133,131,2,2,"PODEMOS-IU-EQUO",10
34,"34147",166,118,117,0,1,"PODEMOS-IU-EQUO",11
5,"5045",91,66,66,0,0,"PODEMOS-IU-EQUO",2
10,"10043",800,562,553,3,9,"PODEMOS-IU-EQUO",86
16,"16192",48,31,30,1,1,"PODEMOS-IU-EQUO",3
19,"19154",68,56,54,0,2,"PODEMOS-IU-EQUO",3
26,"26084",6696,5012,4955,35,57,"PODEMOS-IU-EQUO",809
24,"24093",360,249,248,2,1,"PODEMOS-IU-EQUO",35
5,"5191",121,106,105,1,1,"PODEMOS-IU-EQUO",22
34,"34202",29,18,18,1,0,"PODEMOS-IU-EQUO",1
16,"16143",16,14,14,2,0,"PODEMOS-IU-EQUO",2
6,"6153",20377,14329,14163,103,166,"PODEMOS-IU-EQUO",1720
42,"42172",29,26,26,0,0,"PODEMOS-IU-EQUO",0
24,"24161",285,203,201,3,2,"PODEMOS-IU-EQUO",41
19,"19250",20,17,17,0,0,"PODEMOS-IU-EQUO",3
39,"39046",1404,1001,973,6,28,"PODEMOS-IU-EQUO",215
24,"24027",1211,863,847,8,16,"PODEMOS-IU-EQUO",178
9,"9010",32,23,23,1,0,"PODEMOS-IU-EQUO",0
9,"9406",251,192,191,2,1,"PODEMOS-IU-EQUO",68
9,"9266",91,74,74,0,0,"PODEMOS-IU-EQUO",4
16,"16049",149,111,110,0,1,"PODEMOS-IU-EQUO",4
38,"38037",12864,8287,8163,64,124,"PODEMOS-IU-EQUO",1295
19,"19217",54,40,39,0,1,"PODEMOS-IU-EQUO",3
10,"10137",397,320,317,3,3,"PODEMOS-IU-EQUO",23
45,"45153",1615,1258,1243,7,15,"PODEMOS-IU-EQUO",161
6,"6034",171,121,120,4,1,"PODEMOS-IU-EQUO",7
6,"6063",3015,2268,2246,16,22,"PODEMOS-IU-EQUO",152
13,"13070",760,583,574,11,9,"PODEMOS-IU-EQUO",63
5,"5194",140,119,116,1,3,"PODEMOS-IU-EQUO",11
37,"37343",60,47,47,0,0,"PODEMOS-IU-EQUO",9
26,"26088",37,32,31,0,1,"PODEMOS-IU-EQUO",6
37,"37088",207,163,162,3,1,"PODEMOS-IU-EQUO",9
5,"5261",41,26,26,0,0,"PODEMOS-IU-EQUO",0
13,"13071",39454,26316,26107,183,209,"PODEMOS-IU-EQUO",4994
37,"37301",74,63,63,0,0,"PODEMOS-IU-EQUO",4
37,"37232",390,341,339,1,2,"PODEMOS-IU-EQUO",36
19,"19218",50,33,33,0,0,"PODEMOS-IU-EQUO",3
9,"9408",41,36,36,0,0,"PODEMOS-IU-EQUO",3
5,"5262",357,276,276,1,0,"PODEMOS-IU-EQUO",42
19,"19060",146,119,118,1,1,"PODEMOS-IU-EQUO",58
24,"24096",117,80,79,1,1,"PODEMOS-IU-EQUO",11
39,"39079",8874,6547,6478,47,69,"PODEMOS-IU-EQUO",797
10,"10140",1106,820,808,4,12,"PODEMOS-IU-EQUO",59
19,"19219",13,9,9,0,0,"PODEMOS-IU-EQUO",3
5,"5051",179,145,139,1,6,"PODEMOS-IU-EQUO",15
2,"2044",1105,768,758,7,10,"PODEMOS-IU-EQUO",62
42,"42082",8,8,8,1,0,"PODEMOS-IU-EQUO",2
37,"37345",163,128,128,3,0,"PODEMOS-IU-EQUO",0
30,"30017",11605,8541,8451,46,90,"PODEMOS-IU-EQUO",955
42,"42001",278,212,210,3,2,"PODEMOS-IU-EQUO",25
9,"9269",36,26,26,1,0,"PODEMOS-IU-EQUO",2
6,"6067",1972,1308,1292,8,16,"PODEMOS-IU-EQUO",74
34,"34104",246,185,182,1,3,"PODEMOS-IU-EQUO",9
19,"19183",74,65,65,0,0,"PODEMOS-IU-EQUO",10
10,"10141",263,194,194,0,0,"PODEMOS-IU-EQUO",10
9,"9225",83,55,54,0,1,"PODEMOS-IU-EQUO",2
6,"6022",2651,2089,2054,10,35,"PODEMOS-IU-EQUO",217
37,"37303",190,142,139,1,3,"PODEMOS-IU-EQUO",9
19,"19108",111,97,96,0,1,"PODEMOS-IU-EQUO",20
37,"37221",430,293,290,0,3,"PODEMOS-IU-EQUO",28
9,"9197",144,111,109,1,2,"PODEMOS-IU-EQUO",22
2,"2005",559,424,416,5,8,"PODEMOS-IU-EQUO",43
5,"5215",164,123,122,2,1,"PODEMOS-IU-EQUO",14
2,"2006",579,464,458,3,6,"PODEMOS-IU-EQUO",31
10,"10097",101,75,74,0,1,"PODEMOS-IU-EQUO",6
26,"26001",195,161,157,2,4,"PODEMOS-IU-EQUO",16
16,"16165",61,54,53,0,1,"PODEMOS-IU-EQUO",9
13,"13022",348,260,258,4,2,"PODEMOS-IU-EQUO",14
42,"42098",10,7,7,1,0,"PODEMOS-IU-EQUO",1
42,"42003",67,48,47,0,1,"PODEMOS-IU-EQUO",3
13,"13076",484,400,394,1,6,"PODEMOS-IU-EQUO",26
34,"34211",178,155,152,1,3,"PODEMOS-IU-EQUO",3
34,"34062",171,119,118,2,1,"PODEMOS-IU-EQUO",12
9,"9138",85,72,70,0,2,"PODEMOS-IU-EQUO",2
19,"19065",127,104,104,3,0,"PODEMOS-IU-EQUO",21
24,"24011",203,133,132,0,1,"PODEMOS-IU-EQUO",12
10,"10099",583,378,374,2,4,"PODEMOS-IU-EQUO",24
37,"37348",115,96,95,0,1,"PODEMOS-IU-EQUO",12
35,"35003",5211,2949,2908,13,41,"PODEMOS-IU-EQUO",695
45,"45126",260,176,175,3,1,"PODEMOS-IU-EQUO",32
24,"24202",8008,5367,5276,53,91,"PODEMOS-IU-EQUO",1563
5,"5155",52,44,44,0,0,"PODEMOS-IU-EQUO",10
6,"6056",479,407,399,1,8,"PODEMOS-IU-EQUO",33
16,"16057",75,63,63,0,0,"PODEMOS-IU-EQUO",9
5,"5105",341,249,247,7,2,"PODEMOS-IU-EQUO",47
5,"5056",96,76,76,0,0,"PODEMOS-IU-EQUO",5
9,"9412",790,528,523,4,5,"PODEMOS-IU-EQUO",105
37,"37046",11225,7824,7697,53,127,"PODEMOS-IU-EQUO",1097
13,"13079",12244,8582,8450,72,132,"PODEMOS-IU-EQUO",965
9,"9139",103,87,85,3,2,"PODEMOS-IU-EQUO",13
37,"37350",420,318,314,5,4,"PODEMOS-IU-EQUO",21
39,"39083",1135,679,670,8,9,"PODEMOS-IU-EQUO",103
10,"10054",547,431,421,1,10,"PODEMOS-IU-EQUO",69
9,"9018",24668,17575,17369,111,206,"PODEMOS-IU-EQUO",2876
26,"26095",100,83,82,0,1,"PODEMOS-IU-EQUO",20
34,"34214",183,144,144,0,0,"PODEMOS-IU-EQUO",13
6,"6118",192,145,144,1,1,"PODEMOS-IU-EQUO",8
45,"45195",2141,1635,1606,7,29,"PODEMOS-IU-EQUO",236
24,"24169",2969,2140,2118,13,22,"PODEMOS-IU-EQUO",580
16,"16060",744,565,554,7,11,"PODEMOS-IU-EQUO",62
26,"26167",59,47,46,1,1,"PODEMOS-IU-EQUO",6
26,"26060",84,62,62,2,0,"PODEMOS-IU-EQUO",10
9,"9369",436,319,316,1,3,"PODEMOS-IU-EQUO",38
19,"19188",51,35,35,0,0,"PODEMOS-IU-EQUO",6
37,"37099",73,41,41,0,0,"PODEMOS-IU-EQUO",0
5,"5205",74,57,55,1,2,"PODEMOS-IU-EQUO",2
45,"45028",3649,2701,2673,12,28,"PODEMOS-IU-EQUO",285
2,"2051",1676,1177,1162,6,15,"PODEMOS-IU-EQUO",39
37,"37352",207,153,152,1,1,"PODEMOS-IU-EQUO",16
35,"35031",7259,5037,4942,29,95,"PODEMOS-IU-EQUO",1077
5,"5256",112,100,98,1,2,"PODEMOS-IU-EQUO",5
10,"10103",450,322,318,1,4,"PODEMOS-IU-EQUO",25
45,"45062",1112,878,867,4,11,"PODEMOS-IU-EQUO",61
5,"5108",47,35,35,0,0,"PODEMOS-IU-EQUO",3
24,"24123",746,488,485,2,3,"PODEMOS-IU-EQUO",52
39,"39074",6902,5113,5039,40,74,"PODEMOS-IU-EQUO",767
9,"9473",85,70,65,1,5,"PODEMOS-IU-EQUO",6
30,"30002",9903,7011,6943,28,68,"PODEMOS-IU-EQUO",816
24,"24171",356,197,196,0,1,"PODEMOS-IU-EQUO",27
42,"42089",54,44,44,0,0,"PODEMOS-IU-EQUO",5
6,"6121",3355,2279,2248,8,31,"PODEMOS-IU-EQUO",243
37,"37009",213,172,171,3,1,"PODEMOS-IU-EQUO",14
34,"34163",45,38,38,0,0,"PODEMOS-IU-EQUO",1
45,"45130",317,253,250,1,3,"PODEMOS-IU-EQUO",23
10,"10012",595,466,459,0,7,"PODEMOS-IU-EQUO",54
5,"5110",711,510,505,4,5,"PODEMOS-IU-EQUO",50
9,"9476",62,43,43,0,0,"PODEMOS-IU-EQUO",7
24,"24050",102,77,76,0,1,"PODEMOS-IU-EQUO",4
45,"45097",1046,839,834,4,5,"PODEMOS-IU-EQUO",39
37,"37010",939,708,702,0,6,"PODEMOS-IU-EQUO",97
26,"26134",82,68,68,2,0,"PODEMOS-IU-EQUO",11
42,"42185",26,22,22,0,0,"PODEMOS-IU-EQUO",2
45,"45198",1809,1475,1442,7,33,"PODEMOS-IU-EQUO",127
39,"39087",41985,31178,30805,228,373,"PODEMOS-IU-EQUO",6350
37,"37145",259,190,189,2,1,"PODEMOS-IU-EQUO",8
16,"16158",535,416,413,5,3,"PODEMOS-IU-EQUO",73
45,"45131",282,234,230,0,4,"PODEMOS-IU-EQUO",34
13,"13085",2342,1921,1855,10,66,"PODEMOS-IU-EQUO",186
9,"9144",53,40,40,0,0,"PODEMOS-IU-EQUO",2
10,"10060",967,648,640,2,8,"PODEMOS-IU-EQUO",62
45,"45098",2159,1632,1609,12,23,"PODEMOS-IU-EQUO",151
24,"24207",294,241,238,3,3,"PODEMOS-IU-EQUO",26
6,"6048",849,691,677,7,14,"PODEMOS-IU-EQUO",42
37,"37011",121,91,91,3,0,"PODEMOS-IU-EQUO",9
16,"16212",247,203,202,0,1,"PODEMOS-IU-EQUO",21
45,"45065",271,207,206,1,1,"PODEMOS-IU-EQUO",28
37,"37244",131,98,98,0,0,"PODEMOS-IU-EQUO",20
37,"37314",82,65,65,0,0,"PODEMOS-IU-EQUO",8
37,"37013",119,79,76,0,3,"PODEMOS-IU-EQUO",8
34,"34027",1085,751,741,6,10,"PODEMOS-IU-EQUO",106
10,"10108",219,148,146,0,2,"PODEMOS-IU-EQUO",8
2,"2015",1441,1112,1093,5,19,"PODEMOS-IU-EQUO",97
38,"38050",2462,1624,1604,8,20,"PODEMOS-IU-EQUO",183
42,"42201",22,22,21,0,1,"PODEMOS-IU-EQUO",0
10,"10215",431,311,308,2,3,"PODEMOS-IU-EQUO",33
37,"37357",262,205,203,1,2,"PODEMOS-IU-EQUO",14
42,"42025",1189,844,833,2,11,"PODEMOS-IU-EQUO",100
34,"34234",71,52,50,0,2,"PODEMOS-IU-EQUO",6
39,"39088",69,52,52,0,0,"PODEMOS-IU-EQUO",6
16,"16147",64,45,45,0,0,"PODEMOS-IU-EQUO",3
45,"45033",343,249,243,2,6,"PODEMOS-IU-EQUO",18
37,"37057",215,172,171,1,1,"PODEMOS-IU-EQUO",9
5,"5212",231,164,163,2,1,"PODEMOS-IU-EQUO",3
10,"10034",353,260,257,2,3,"PODEMOS-IU-EQUO",20
6,"6036",5075,3575,3535,35,40,"PODEMOS-IU-EQUO",417
42,"42053",26,19,19,1,0,"PODEMOS-IU-EQUO",0
9,"9283",44,32,31,0,1,"PODEMOS-IU-EQUO",2
34,"34073",185,149,149,0,0,"PODEMOS-IU-EQUO",12
19,"19157",55,46,46,0,0,"PODEMOS-IU-EQUO",8
9,"9421",230,166,163,3,3,"PODEMOS-IU-EQUO",23
16,"16216",315,268,265,1,3,"PODEMOS-IU-EQUO",53
26,"26102",6111,4486,4435,28,51,"PODEMOS-IU-EQUO",609
5,"5067",83,68,67,0,1,"PODEMOS-IU-EQUO",5
37,"37317",304,238,234,1,4,"PODEMOS-IU-EQUO",18
42,"42191",185,136,133,0,3,"PODEMOS-IU-EQUO",15
5,"5118",79,53,53,0,0,"PODEMOS-IU-EQUO",4
16,"16070",30,26,26,1,0,"PODEMOS-IU-EQUO",0
37,"37275",118,70,69,0,1,"PODEMOS-IU-EQUO",5
10,"10065",206,156,155,1,1,"PODEMOS-IU-EQUO",30
6,"6129",577,438,429,0,9,"PODEMOS-IU-EQUO",55
9,"9109",1056,619,595,8,24,"PODEMOS-IU-EQUO",264
42,"42028",75,51,51,0,0,"PODEMOS-IU-EQUO",19
26,"26045",12,12,12,0,0,"PODEMOS-IU-EQUO",0
45,"45191",543,472,468,3,4,"PODEMOS-IU-EQUO",40
26,"26139",54,45,44,0,1,"PODEMOS-IU-EQUO",6
37,"37235",224,153,148,2,5,"PODEMOS-IU-EQUO",13
37,"37347",468,348,346,2,2,"PODEMOS-IU-EQUO",63
13,"13023",8973,6291,6242,44,49,"PODEMOS-IU-EQUO",359
45,"45135",4269,3340,3288,8,52,"PODEMOS-IU-EQUO",703
34,"34091",123,94,93,3,1,"PODEMOS-IU-EQUO",8
45,"45035",281,212,209,1,3,"PODEMOS-IU-EQUO",59
45,"45203",2563,1801,1771,8,30,"PODEMOS-IU-EQUO",289
6,"6085",3428,2453,2414,25,39,"PODEMOS-IU-EQUO",404
5,"5216",220,171,168,0,3,"PODEMOS-IU-EQUO",21
37,"37016",569,406,401,2,5,"PODEMOS-IU-EQUO",47
10,"10113",2338,1679,1638,9,41,"PODEMOS-IU-EQUO",324
37,"37334",76,48,48,1,0,"PODEMOS-IU-EQUO",2
37,"37078",829,674,664,8,10,"PODEMOS-IU-EQUO",74
10,"10901",1174,752,741,4,11,"PODEMOS-IU-EQUO",102
9,"9243",76,59,57,1,2,"PODEMOS-IU-EQUO",12
5,"5021",1914,1483,1464,5,19,"PODEMOS-IU-EQUO",239
39,"39001",2102,1622,1601,18,21,"PODEMOS-IU-EQUO",315
26,"26036",16986,11940,11816,66,124,"PODEMOS-IU-EQUO",1693
9,"9321",1626,1238,1227,8,11,"PODEMOS-IU-EQUO",94
9,"9029",168,131,129,4,2,"PODEMOS-IU-EQUO",26
10,"10069",838,626,615,2,11,"PODEMOS-IU-EQUO",45
39,"39032",1463,1087,1081,7,6,"PODEMOS-IU-EQUO",117
24,"24178",70,59,58,0,1,"PODEMOS-IU-EQUO",6
26,"26142",787,612,606,3,6,"PODEMOS-IU-EQUO",71
26,"26037",128,108,108,2,0,"PODEMOS-IU-EQUO",17
45,"45004",567,410,406,1,4,"PODEMOS-IU-EQUO",53
9,"9384",295,211,206,0,5,"PODEMOS-IU-EQUO",24
16,"16029",99,72,70,0,2,"PODEMOS-IU-EQUO",14
38,"38020",15113,9928,9830,59,98,"PODEMOS-IU-EQUO",1817
37,"37322",2465,1592,1564,8,28,"PODEMOS-IU-EQUO",284
10,"10161",76,53,53,0,0,"PODEMOS-IU-EQUO",5
9,"9292",87,75,73,1,2,"PODEMOS-IU-EQUO",10
24,"24148",1672,1249,1241,23,8,"PODEMOS-IU-EQUO",133
5,"5075",107,72,72,0,0,"PODEMOS-IU-EQUO",6
45,"45171",1361,1035,1023,0,12,"PODEMOS-IU-EQUO",114
16,"16227",113,93,93,0,0,"PODEMOS-IU-EQUO",17
26,"26106",86,72,72,0,0,"PODEMOS-IU-EQUO",14
45,"45072",671,484,483,2,1,"PODEMOS-IU-EQUO",57
42,"42032",146,118,118,0,0,"PODEMOS-IU-EQUO",8
45,"45139",167,139,139,1,0,"PODEMOS-IU-EQUO",9
9,"9338",227,170,169,0,1,"PODEMOS-IU-EQUO",20
19,"19237",47,38,38,0,0,"PODEMOS-IU-EQUO",9
24,"24179",290,197,192,4,5,"PODEMOS-IU-EQUO",34
39,"39064",1345,1031,1015,7,16,"PODEMOS-IU-EQUO",104
42,"42155",167,103,102,1,1,"PODEMOS-IU-EQUO",6
24,"24113",366,293,287,5,6,"PODEMOS-IU-EQUO",11
9,"9033",90,74,74,1,0,"PODEMOS-IU-EQUO",7
16,"16228",172,137,137,4,0,"PODEMOS-IU-EQUO",3
34,"34082",83,74,73,0,1,"PODEMOS-IU-EQUO",0
16,"16031",46,28,28,1,0,"PODEMOS-IU-EQUO",3
35,"35014",11209,6016,5917,42,99,"PODEMOS-IU-EQUO",1567
37,"37198",207,160,157,3,3,"PODEMOS-IU-EQUO",31
16,"16094",127,96,94,0,2,"PODEMOS-IU-EQUO",5
24,"24092",798,606,602,1,4,"PODEMOS-IU-EQUO",88
9,"9387",117,95,90,0,5,"PODEMOS-IU-EQUO",26
6,"6136",1565,1131,1102,11,29,"PODEMOS-IU-EQUO",132
24,"24150",243,172,172,6,0,"PODEMOS-IU-EQUO",28
34,"34232",750,578,564,7,14,"PODEMOS-IU-EQUO",59
45,"45040",1349,846,838,4,8,"PODEMOS-IU-EQUO",147
10,"10165",257,208,207,0,1,"PODEMOS-IU-EQUO",12
9,"9163",582,467,459,2,8,"PODEMOS-IU-EQUO",47
16,"16234",25,18,18,0,0,"PODEMOS-IU-EQUO",4
16,"16004",259,198,197,2,1,"PODEMOS-IU-EQUO",10
19,"19057",76,59,59,1,0,"PODEMOS-IU-EQUO",27
6,"6092",577,415,405,3,10,"PODEMOS-IU-EQUO",24
45,"45041",3752,2633,2597,12,36,"PODEMOS-IU-EQUO",490
34,"34179",28,21,20,0,1,"PODEMOS-IU-EQUO",0
38,"38024",15077,9512,9356,55,156,"PODEMOS-IU-EQUO",1109
9,"9164",157,127,126,0,1,"PODEMOS-IU-EQUO",15
42,"42157",13,10,10,0,0,"PODEMOS-IU-EQUO",0
42,"42023",63,51,51,0,0,"PODEMOS-IU-EQUO",3
13,"13050",493,378,375,3,3,"PODEMOS-IU-EQUO",19
26,"26111",242,180,176,0,4,"PODEMOS-IU-EQUO",45
2,"2068",337,251,246,1,5,"PODEMOS-IU-EQUO",27
37,"37118",123,92,90,0,2,"PODEMOS-IU-EQUO",6
6,"6093",4447,3254,3204,15,50,"PODEMOS-IU-EQUO",208
10,"10213",566,469,463,0,6,"PODEMOS-IU-EQUO",31
24,"24152",464,295,291,1,4,"PODEMOS-IU-EQUO",36
13,"13017",256,200,197,0,3,"PODEMOS-IU-EQUO",18
37,"37119",107,84,82,0,2,"PODEMOS-IU-EQUO",16
5,"5178",368,284,280,0,4,"PODEMOS-IU-EQUO",16
9,"9035",311,227,225,2,2,"PODEMOS-IU-EQUO",49
9,"9048",1467,1048,1033,13,15,"PODEMOS-IU-EQUO",190
6,"6049",1015,725,707,3,18,"PODEMOS-IU-EQUO",88
37,"37071",78,65,64,0,1,"PODEMOS-IU-EQUO",1
24,"24018",174,143,141,0,2,"PODEMOS-IU-EQUO",17
10,"10169",531,420,409,2,11,"PODEMOS-IU-EQUO",33
9,"9211",1441,1056,1039,9,17,"PODEMOS-IU-EQUO",108
10,"10123",578,481,475,1,6,"PODEMOS-IU-EQUO",55
34,"34102",205,169,168,1,1,"PODEMOS-IU-EQUO",12
35,"35026",81091,51953,51195,407,758,"PODEMOS-IU-EQUO",11396
5,"5227",358,253,250,1,3,"PODEMOS-IU-EQUO",43
34,"34903",198,131,131,1,0,"PODEMOS-IU-EQUO",8
19,"19182",38,34,33,0,1,"PODEMOS-IU-EQUO",10
37,"37245",346,261,259,2,2,"PODEMOS-IU-EQUO",20
19,"19090",91,73,73,1,0,"PODEMOS-IU-EQUO",16
10,"10017",825,620,611,3,9,"PODEMOS-IU-EQUO",46
34,"34236",156,120,119,0,1,"PODEMOS-IU-EQUO",5
24,"24184",198,118,117,0,1,"PODEMOS-IU-EQUO",27
37,"37302",290,196,195,2,1,"PODEMOS-IU-EQUO",5
2,"2071",1011,831,825,5,6,"PODEMOS-IU-EQUO",57
5,"5229",82,68,67,0,1,"PODEMOS-IU-EQUO",3
24,"24019",354,272,267,3,5,"PODEMOS-IU-EQUO",62
39,"39038",1452,997,990,8,7,"PODEMOS-IU-EQUO",215
38,"38027",5414,3618,3571,16,47,"PODEMOS-IU-EQUO",407
19,"19318",25,18,18,0,0,"PODEMOS-IU-EQUO",1
10,"10095",338,259,251,1,8,"PODEMOS-IU-EQUO",13
9,"9180",142,107,102,1,5,"PODEMOS-IU-EQUO",16
39,"39039",568,382,379,0,3,"PODEMOS-IU-EQUO",36
9,"9485",55,43,42,0,1,"PODEMOS-IU-EQUO",0
13,"13056",11362,8288,8198,70,90,"PODEMOS-IU-EQUO",1699
37,"37289",232,167,166,3,1,"PODEMOS-IU-EQUO",9
42,"42027",76,61,60,0,1,"PODEMOS-IU-EQUO",10
5,"5230",66,63,62,1,1,"PODEMOS-IU-EQUO",2
9,"9303",86,68,68,0,0,"PODEMOS-IU-EQUO",4
19,"19008",37,28,27,1,1,"PODEMOS-IU-EQUO",10
37,"37373",748,503,499,1,4,"PODEMOS-IU-EQUO",84
26,"26163",136,118,118,0,0,"PODEMOS-IU-EQUO",18
37,"37042",44,28,27,0,1,"PODEMOS-IU-EQUO",0
9,"9226",63,54,54,0,0,"PODEMOS-IU-EQUO",4
26,"26091",161,146,146,0,0,"PODEMOS-IU-EQUO",7
5,"5053",82,57,57,0,0,"PODEMOS-IU-EQUO",1
16,"16277",113,84,83,1,1,"PODEMOS-IU-EQUO",4
45,"45103",397,331,327,3,4,"PODEMOS-IU-EQUO",10
26,"26127",212,181,176,0,5,"PODEMOS-IU-EQUO",15
39,"39050",270,187,186,0,1,"PODEMOS-IU-EQUO",25
42,"42029",137,104,104,2,0,"PODEMOS-IU-EQUO",7
24,"24188",3822,2850,2817,19,33,"PODEMOS-IU-EQUO",369
39,"39041",1760,1370,1354,9,16,"PODEMOS-IU-EQUO",250
37,"37206",94,73,73,3,0,"PODEMOS-IU-EQUO",5
24,"24120",341,246,244,1,2,"PODEMOS-IU-EQUO",34
45,"45147",581,450,446,1,4,"PODEMOS-IU-EQUO",64
5,"5199",40,32,31,0,1,"PODEMOS-IU-EQUO",3
5,"5154",38,33,33,0,0,"PODEMOS-IU-EQUO",4
9,"9366",86,62,62,2,0,"PODEMOS-IU-EQUO",8
26,"26117",2152,1625,1605,10,20,"PODEMOS-IU-EQUO",213
26,"26047",1947,1578,1563,8,15,"PODEMOS-IU-EQUO",138
13,"13060",263,200,194,0,6,"PODEMOS-IU-EQUO",30
42,"42208",22,13,13,2,0,"PODEMOS-IU-EQUO",0
19,"19269",102,81,80,0,1,"PODEMOS-IU-EQUO",24
24,"24056",2883,2040,2003,11,37,"PODEMOS-IU-EQUO",261
5,"5234",49,44,44,2,0,"PODEMOS-IU-EQUO",2
26,"26118",59,48,48,2,0,"PODEMOS-IU-EQUO",12
19,"19283",30,25,25,0,0,"PODEMOS-IU-EQUO",1
24,"24189",5865,3933,3885,31,48,"PODEMOS-IU-EQUO",680
39,"39012",6687,5021,4957,51,64,"PODEMOS-IU-EQUO",1058
37,"37208",76,56,54,1,2,"PODEMOS-IU-EQUO",7
19,"19212",703,543,531,3,12,"PODEMOS-IU-EQUO",68
24,"24121",645,492,487,1,5,"PODEMOS-IU-EQUO",117
26,"26081",16,14,14,0,0,"PODEMOS-IU-EQUO",1
37,"37127",214,154,151,1,3,"PODEMOS-IU-EQUO",23
42,"42119",158,100,99,3,1,"PODEMOS-IU-EQUO",6
42,"42166",59,45,45,0,0,"PODEMOS-IU-EQUO",4
30,"30041",13621,8970,8889,46,81,"PODEMOS-IU-EQUO",1323
39,"39073",9837,7356,7298,31,58,"PODEMOS-IU-EQUO",1231
6,"6103",4796,3265,3220,20,45,"PODEMOS-IU-EQUO",314
34,"34141",177,149,145,2,4,"PODEMOS-IU-EQUO",16
19,"19247",139,102,100,1,2,"PODEMOS-IU-EQUO",19
24,"24159",1806,1386,1366,6,20,"PODEMOS-IU-EQUO",106
26,"26107",94,77,77,2,0,"PODEMOS-IU-EQUO",9
10,"10904",745,507,504,8,3,"PODEMOS-IU-EQUO",51
16,"16093",60,49,47,0,2,"PODEMOS-IU-EQUO",6
30,"30042",1922,1504,1491,7,13,"PODEMOS-IU-EQUO",158
45,"45017",262,204,203,0,1,"PODEMOS-IU-EQUO",24
42,"42167",251,175,172,2,3,"PODEMOS-IU-EQUO",22
9,"9904",478,374,370,5,4,"PODEMOS-IU-EQUO",47
5,"5237",162,130,124,2,6,"PODEMOS-IU-EQUO",1
5,"5093",408,294,292,1,2,"PODEMOS-IU-EQUO",35
19,"19248",78,63,63,0,0,"PODEMOS-IU-EQUO",10
34,"34098",777,551,545,8,6,"PODEMOS-IU-EQUO",98
5,"5043",84,66,66,0,0,"PODEMOS-IU-EQUO",7
16,"16248",859,654,636,5,18,"PODEMOS-IU-EQUO",117
9,"9441",74,65,65,0,0,"PODEMOS-IU-EQUO",1
13,"13901",893,665,655,5,10,"PODEMOS-IU-EQUO",53
37,"37035",190,150,150,2,0,"PODEMOS-IU-EQUO",21
9,"9310",13,9,8,0,1,"PODEMOS-IU-EQUO",3
16,"16095",83,64,63,0,1,"PODEMOS-IU-EQUO",5
34,"34099",60,48,48,0,0,"PODEMOS-IU-EQUO",4
6,"6122",6634,4427,4321,26,106,"PODEMOS-IU-EQUO",476
39,"39075",137376,99899,99048,718,851,"PODEMOS-IU-EQUO",16264
24,"24124",367,244,233,3,11,"PODEMOS-IU-EQUO",27
37,"37380",56,47,45,0,2,"PODEMOS-IU-EQUO",8
37,"37172",888,572,566,3,6,"PODEMOS-IU-EQUO",65
26,"26169",64,60,60,0,0,"PODEMOS-IU-EQUO",5
9,"9232",154,119,116,0,3,"PODEMOS-IU-EQUO",6
26,"26018",10477,8053,7956,65,97,"PODEMOS-IU-EQUO",1352
45,"45019",7377,5307,5251,37,56,"PODEMOS-IU-EQUO",1026
6,"6016",2986,2114,2078,14,36,"PODEMOS-IU-EQUO",166
19,"19017",69,57,57,0,0,"PODEMOS-IU-EQUO",9
37,"37214",129,93,91,0,2,"PODEMOS-IU-EQUO",11
16,"16097",156,124,121,0,3,"PODEMOS-IU-EQUO",11
37,"37037",117,84,82,0,2,"PODEMOS-IU-EQUO",3
34,"34009",31,29,29,1,0,"PODEMOS-IU-EQUO",2
9,"9221",461,343,338,3,5,"PODEMOS-IU-EQUO",85
13,"13068",1061,747,740,4,7,"PODEMOS-IU-EQUO",78
9,"9907",1420,1058,1041,12,17,"PODEMOS-IU-EQUO",246
19,"19058",6793,5258,5218,19,40,"PODEMOS-IU-EQUO",1089
34,"34101",50,41,41,0,0,"PODEMOS-IU-EQUO",3
37,"37382",173,137,137,0,0,"PODEMOS-IU-EQUO",3
42,"42012",35,28,28,0,0,"PODEMOS-IU-EQUO",6
45,"45054",3959,2882,2848,12,34,"PODEMOS-IU-EQUO",266
45,"45154",1493,1079,1074,6,5,"PODEMOS-IU-EQUO",172
9,"9407",28,23,23,0,0,"PODEMOS-IU-EQUO",8
37,"37055",123,98,94,0,4,"PODEMOS-IU-EQUO",6
24,"24071",1006,745,734,10,11,"PODEMOS-IU-EQUO",125
37,"37104",27,22,22,0,0,"PODEMOS-IU-EQUO",0
13,"13087",23137,15677,15480,133,197,"PODEMOS-IU-EQUO",2437
16,"16146",83,57,57,0,0,"PODEMOS-IU-EQUO",1
5,"5242",681,559,558,8,1,"PODEMOS-IU-EQUO",33
9,"9179",41,32,32,1,0,"PODEMOS-IU-EQUO",6
24,"24039",2063,1597,1596,41,1,"PODEMOS-IU-EQUO",173
13,"13001",1254,934,925,6,9,"PODEMOS-IU-EQUO",96
42,"42037",33,25,25,2,0,"PODEMOS-IU-EQUO",0
9,"9360",30,23,23,0,0,"PODEMOS-IU-EQUO",1
26,"26161",8,7,7,0,0,"PODEMOS-IU-EQUO",0
45,"45189",599,470,462,2,8,"PODEMOS-IU-EQUO",82
34,"34107",81,52,51,5,1,"PODEMOS-IU-EQUO",4
42,"42159",37,29,29,0,0,"PODEMOS-IU-EQUO",2
45,"45122",5212,4004,3961,16,43,"PODEMOS-IU-EQUO",619
10,"10185",571,409,405,2,4,"PODEMOS-IU-EQUO",47
13,"13055",665,487,484,2,3,"PODEMOS-IU-EQUO",71
19,"19290",834,561,558,5,3,"PODEMOS-IU-EQUO",143
13,"13072",768,579,572,5,7,"PODEMOS-IU-EQUO",40
35,"35001",4584,3282,3222,26,60,"PODEMOS-IU-EQUO",566
2,"2084",323,231,225,0,6,"PODEMOS-IU-EQUO",21
24,"24129",122,89,89,1,0,"PODEMOS-IU-EQUO",9
2,"2004",612,479,473,5,6,"PODEMOS-IU-EQUO",26
45,"45134",1581,1204,1192,6,12,"PODEMOS-IU-EQUO",186
42,"42148",10,10,10,1,0,"PODEMOS-IU-EQUO",0
26,"26022",198,164,163,1,1,"PODEMOS-IU-EQUO",9
42,"42175",21,16,16,0,0,"PODEMOS-IU-EQUO",0
42,"42219",43,31,30,0,1,"PODEMOS-IU-EQUO",7
9,"9181",300,221,221,0,0,"PODEMOS-IU-EQUO",27
37,"37001",192,151,148,0,3,"PODEMOS-IU-EQUO",15
24,"24175",1832,1314,1297,14,17,"PODEMOS-IU-EQUO",233
10,"10187",438,308,305,1,3,"PODEMOS-IU-EQUO",74
9,"9410",3040,2117,2095,16,22,"PODEMOS-IU-EQUO",592
45,"45023",2177,1571,1556,6,15,"PODEMOS-IU-EQUO",299
13,"13057",1147,961,954,1,7,"PODEMOS-IU-EQUO",66
24,"24054",430,314,313,1,1,"PODEMOS-IU-EQUO",10
24,"24087",631,470,466,7,4,"PODEMOS-IU-EQUO",51
16,"16009",62,51,50,0,1,"PODEMOS-IU-EQUO",7
13,"13074",974,835,828,3,7,"PODEMOS-IU-EQUO",96
37,"37346",273,212,211,1,1,"PODEMOS-IU-EQUO",11
45,"45058",375,311,304,1,7,"PODEMOS-IU-EQUO",51
9,"9027",46,42,41,0,1,"PODEMOS-IU-EQUO",11
34,"34124",60,50,49,0,1,"PODEMOS-IU-EQUO",1
37,"37193",390,279,275,4,4,"PODEMOS-IU-EQUO",34
6,"6160",3153,2176,2146,16,30,"PODEMOS-IU-EQUO",202
10,"10143",154,112,112,0,0,"PODEMOS-IU-EQUO",5
34,"34157",2442,1792,1768,21,24,"PODEMOS-IU-EQUO",281
6,"6024",1172,905,883,4,22,"PODEMOS-IU-EQUO",100
6,"6115",1261,841,832,5,9,"PODEMOS-IU-EQUO",95
9,"9395",138,104,104,0,0,"PODEMOS-IU-EQUO",17
42,"42017",140,113,112,0,1,"PODEMOS-IU-EQUO",26
16,"16011",27,22,22,1,0,"PODEMOS-IU-EQUO",4
30,"30032",2856,2163,2144,6,19,"PODEMOS-IU-EQUO",201
42,"42178",115,83,83,0,0,"PODEMOS-IU-EQUO",4
24,"24167",750,505,499,4,6,"PODEMOS-IU-EQUO",68
19,"19222",110,82,82,0,0,"PODEMOS-IU-EQUO",11
35,"35004",39299,20523,20294,140,229,"PODEMOS-IU-EQUO",4631
19,"19258",90,77,77,0,0,"PODEMOS-IU-EQUO",10
38,"38007",1661,1114,1103,6,11,"PODEMOS-IU-EQUO",130
35,"35030",9250,5413,5326,34,87,"PODEMOS-IU-EQUO",1035
10,"10191",527,405,397,2,8,"PODEMOS-IU-EQUO",69
24,"24001",189,124,122,0,2,"PODEMOS-IU-EQUO",10
45,"45170",228,176,167,0,9,"PODEMOS-IU-EQUO",19
26,"26003",413,331,329,2,2,"PODEMOS-IU-EQUO",20
24,"24066",494,368,366,4,2,"PODEMOS-IU-EQUO",30
45,"45060",173,126,125,1,1,"PODEMOS-IU-EQUO",11
5,"5001",191,148,147,2,1,"PODEMOS-IU-EQUO",9
19,"19027",138,105,105,1,0,"PODEMOS-IU-EQUO",24
9,"9057",145,108,108,0,0,"PODEMOS-IU-EQUO",30
19,"19151",1064,744,726,1,18,"PODEMOS-IU-EQUO",137
26,"26026",1321,1039,1025,6,14,"PODEMOS-IU-EQUO",63
6,"6072",2307,1696,1681,12,15,"PODEMOS-IU-EQUO",152
24,"24168",460,361,359,0,2,"PODEMOS-IU-EQUO",33
16,"16014",602,485,483,0,2,"PODEMOS-IU-EQUO",71
42,"42182",56,43,41,1,2,"PODEMOS-IU-EQUO",1
19,"19111",155,126,126,1,0,"PODEMOS-IU-EQUO",13
13,"13063",3706,2539,2514,33,25,"PODEMOS-IU-EQUO",365
19,"19297",32,24,24,1,0,"PODEMOS-IU-EQUO",0
5,"5124",102,83,81,0,2,"PODEMOS-IU-EQUO",2
24,"24101",397,258,257,3,1,"PODEMOS-IU-EQUO",42
24,"24068",457,344,340,0,4,"PODEMOS-IU-EQUO",48
5,"5059",106,82,81,1,1,"PODEMOS-IU-EQUO",15
45,"45128",2502,1680,1668,6,12,"PODEMOS-IU-EQUO",219
37,"37184",327,255,252,2,3,"PODEMOS-IU-EQUO",17
9,"9019",150,92,90,0,2,"PODEMOS-IU-EQUO",13
9,"9454",43,34,33,0,1,"PODEMOS-IU-EQUO",6
9,"9190",86,58,56,0,2,"PODEMOS-IU-EQUO",14
38,"38009",4127,2915,2868,20,47,"PODEMOS-IU-EQUO",482
9,"9115",92,68,67,0,1,"PODEMOS-IU-EQUO",14
6,"6045",506,379,374,3,5,"PODEMOS-IU-EQUO",17
26,"26108",266,215,213,0,2,"PODEMOS-IU-EQUO",27
24,"24014",7425,5124,5053,32,71,"PODEMOS-IU-EQUO",987
45,"45043",793,657,649,1,8,"PODEMOS-IU-EQUO",51
34,"34113",38,36,36,0,0,"PODEMOS-IU-EQUO",3
24,"24137",1099,783,778,7,5,"PODEMOS-IU-EQUO",155
9,"9248",78,59,59,1,0,"PODEMOS-IU-EQUO",6
37,"37185",591,423,417,2,6,"PODEMOS-IU-EQUO",47
13,"13084",892,701,685,6,16,"PODEMOS-IU-EQUO",66
16,"16110",93,70,70,0,0,"PODEMOS-IU-EQUO",1
26,"26098",88,73,73,1,0,"PODEMOS-IU-EQUO",23
5,"5127",643,519,514,3,5,"PODEMOS-IU-EQUO",56
2,"2067",1158,858,847,6,11,"PODEMOS-IU-EQUO",111
6,"6001",686,522,515,0,7,"PODEMOS-IU-EQUO",67
9,"9206",59,45,45,0,0,"PODEMOS-IU-EQUO",1
10,"10150",346,285,279,3,6,"PODEMOS-IU-EQUO",20
45,"45197",1906,1455,1430,8,25,"PODEMOS-IU-EQUO",70
9,"9103",217,184,183,1,1,"PODEMOS-IU-EQUO",22
6,"6032",68,53,53,1,0,"PODEMOS-IU-EQUO",9
5,"5012",133,105,102,0,3,"PODEMOS-IU-EQUO",4
9,"9374",90,71,70,1,1,"PODEMOS-IU-EQUO",12
39,"39026",1750,1236,1224,11,12,"PODEMOS-IU-EQUO",181
26,"26030",16,16,15,0,1,"PODEMOS-IU-EQUO",0
5,"5113",71,56,56,0,0,"PODEMOS-IU-EQUO",1
9,"9192",55,43,43,0,0,"PODEMOS-IU-EQUO",16
37,"37355",178,142,142,1,0,"PODEMOS-IU-EQUO",20
9,"9022",66,57,57,1,0,"PODEMOS-IU-EQUO",5
38,"38025",6880,4839,4761,30,78,"PODEMOS-IU-EQUO",514
34,"34132",114,89,86,0,3,"PODEMOS-IU-EQUO",17
5,"5114",1345,1067,1044,3,23,"PODEMOS-IU-EQUO",83
5,"5259",124,105,105,1,0,"PODEMOS-IU-EQUO",8
42,"42024",86,61,59,0,2,"PODEMOS-IU-EQUO",3
45,"45020",1290,1037,1026,6,11,"PODEMOS-IU-EQUO",73
30,"30035",18671,13103,12979,54,124,"PODEMOS-IU-EQUO",1911
34,"34181",448,322,319,7,3,"PODEMOS-IU-EQUO",50
10,"10061",1628,1055,1035,8,20,"PODEMOS-IU-EQUO",114
19,"19036",263,229,229,0,0,"PODEMOS-IU-EQUO",24
9,"9329",121,87,87,1,0,"PODEMOS-IU-EQUO",23
39,"39007",417,278,275,2,3,"PODEMOS-IU-EQUO",50
16,"16007",1177,888,880,7,8,"PODEMOS-IU-EQUO",47
37,"37120",99,82,78,0,4,"PODEMOS-IU-EQUO",4
19,"19006",769,547,540,2,7,"PODEMOS-IU-EQUO",110
37,"37025",257,220,220,4,0,"PODEMOS-IU-EQUO",10
13,"13041",244,170,165,1,5,"PODEMOS-IU-EQUO",32
13,"13059",202,160,156,0,4,"PODEMOS-IU-EQUO",25
5,"5136",96,61,60,3,1,"PODEMOS-IU-EQUO",7
16,"16115",44,35,34,0,1,"PODEMOS-IU-EQUO",5
16,"16238",501,428,422,3,6,"PODEMOS-IU-EQUO",35
16,"16051",142,120,119,0,1,"PODEMOS-IU-EQUO",8
24,"24086",270,223,218,0,5,"PODEMOS-IU-EQUO",9
10,"10063",173,139,137,0,2,"PODEMOS-IU-EQUO",20
10,"10155",1126,773,763,5,10,"PODEMOS-IU-EQUO",117
9,"9463",264,195,195,7,0,"PODEMOS-IU-EQUO",28
26,"26138",4588,3290,3247,15,43,"PODEMOS-IU-EQUO",449
19,"19194",98,69,69,1,0,"PODEMOS-IU-EQUO",12
10,"10170",267,210,206,3,4,"PODEMOS-IU-EQUO",23
37,"37218",67,42,41,0,1,"PODEMOS-IU-EQUO",1
39,"39059",7986,5879,5806,45,73,"PODEMOS-IU-EQUO",909
16,"16162",43,35,34,0,1,"PODEMOS-IU-EQUO",0
34,"34031",30,30,29,0,1,"PODEMOS-IU-EQUO",1
5,"5263",173,129,129,1,0,"PODEMOS-IU-EQUO",8
45,"45034",1353,1082,1078,6,4,"PODEMOS-IU-EQUO",197
42,"42068",82,63,60,1,3,"PODEMOS-IU-EQUO",0
9,"9241",202,156,154,4,2,"PODEMOS-IU-EQUO",24
37,"37058",58,45,45,0,0,"PODEMOS-IU-EQUO",0
24,"24041",538,367,366,3,1,"PODEMOS-IU-EQUO",48
19,"19209",40,29,29,1,0,"PODEMOS-IU-EQUO",2
9,"9077",34,27,27,0,0,"PODEMOS-IU-EQUO",4
37,"37219",173,109,108,0,1,"PODEMOS-IU-EQUO",13
5,"5085",35,27,27,0,0,"PODEMOS-IU-EQUO",0
9,"9354",33,29,28,2,1,"PODEMOS-IU-EQUO",2
19,"19022",625,476,469,3,7,"PODEMOS-IU-EQUO",53
24,"24064",1523,1101,1087,3,14,"PODEMOS-IU-EQUO",270
26,"26140",253,208,206,0,2,"PODEMOS-IU-EQUO",49
38,"38017",28437,16239,16075,95,164,"PODEMOS-IU-EQUO",2980
5,"5018",29,22,22,0,0,"PODEMOS-IU-EQUO",2
10,"10159",320,251,250,0,1,"PODEMOS-IU-EQUO",12
9,"9154",137,98,97,2,1,"PODEMOS-IU-EQUO",7
19,"19268",35,24,24,1,0,"PODEMOS-IU-EQUO",6
19,"19267",19,13,13,0,0,"PODEMOS-IU-EQUO",0
19,"19133",83,72,72,0,0,"PODEMOS-IU-EQUO",3
42,"42131",51,37,37,1,0,"PODEMOS-IU-EQUO",3
42,"42085",189,129,127,3,2,"PODEMOS-IU-EQUO",6
45,"45901",771,547,544,3,3,"PODEMOS-IU-EQUO",72
34,"34053",207,170,169,3,1,"PODEMOS-IU-EQUO",12
37,"37022",268,215,215,2,0,"PODEMOS-IU-EQUO",16
9,"9112",109,85,85,0,0,"PODEMOS-IU-EQUO",11
39,"39062",1812,1379,1366,5,13,"PODEMOS-IU-EQUO",162
24,"24213",150,122,122,1,0,"PODEMOS-IU-EQUO",4
10,"10160",229,190,189,2,1,"PODEMOS-IU-EQUO",22
13,"13043",231,180,179,1,1,"PODEMOS-IU-EQUO",6
38,"38019",13200,8123,8047,36,76,"PODEMOS-IU-EQUO",826
42,"42152",78,55,55,0,0,"PODEMOS-IU-EQUO",1
30,"30030",312993,231648,230185,1207,1463,"PODEMOS-IU-EQUO",35120
19,"19097",16,10,10,0,0,"PODEMOS-IU-EQUO",0
37,"37126",29,24,24,0,0,"PODEMOS-IU-EQUO",0
5,"5267",101,72,70,0,2,"PODEMOS-IU-EQUO",25
35,"35013",6625,4896,4781,41,115,"PODEMOS-IU-EQUO",738
16,"16280",192,164,161,1,3,"PODEMOS-IU-EQUO",10
10,"10023",835,616,607,2,9,"PODEMOS-IU-EQUO",38
24,"24079",906,664,658,9,6,"PODEMOS-IU-EQUO",84
34,"34228",83,74,74,1,0,"PODEMOS-IU-EQUO",9
37,"37063",69,59,58,0,1,"PODEMOS-IU-EQUO",3
26,"26143",220,175,173,1,2,"PODEMOS-IU-EQUO",33
13,"13045",674,508,499,1,9,"PODEMOS-IU-EQUO",37
39,"39093",299,229,226,4,3,"PODEMOS-IU-EQUO",45
26,"26178",75,57,55,1,2,"PODEMOS-IU-EQUO",8
42,"42073",75,58,58,0,0,"PODEMOS-IU-EQUO",5
9,"9003",194,147,146,0,1,"PODEMOS-IU-EQUO",36
38,"38033",3702,2505,2464,8,41,"PODEMOS-IU-EQUO",261
24,"24115",54058,37780,37357,308,423,"PODEMOS-IU-EQUO",8668
5,"5902",284,236,232,0,4,"PODEMOS-IU-EQUO",18
42,"42196",10,7,7,0,0,"PODEMOS-IU-EQUO",0
2,"2023",568,486,479,3,7,"PODEMOS-IU-EQUO",47
19,"19199",17,17,17,1,0,"PODEMOS-IU-EQUO",2
9,"9160",85,64,64,0,0,"PODEMOS-IU-EQUO",9
24,"24149",152,120,116,3,4,"PODEMOS-IU-EQUO",7
10,"10163",350,293,290,2,3,"PODEMOS-IU-EQUO",18
6,"6135",1092,846,828,0,18,"PODEMOS-IU-EQUO",61
9,"9202",25,22,22,1,0,"PODEMOS-IU-EQUO",0
10,"10071",139,96,94,0,2,"PODEMOS-IU-EQUO",6
37,"37379",174,133,131,1,2,"PODEMOS-IU-EQUO",7
34,"34081",61,53,52,0,1,"PODEMOS-IU-EQUO",4
5,"5130",90,85,85,0,0,"PODEMOS-IU-EQUO",13
26,"26147",30,28,27,0,1,"PODEMOS-IU-EQUO",6
9,"9318",61,41,41,0,0,"PODEMOS-IU-EQUO",5
45,"45107",3257,2504,2472,15,32,"PODEMOS-IU-EQUO",441
19,"19286",720,547,543,2,4,"PODEMOS-IU-EQUO",98
34,"34038",277,204,203,1,1,"PODEMOS-IU-EQUO",10
9,"9455",45,33,33,0,0,"PODEMOS-IU-EQUO",1
2,"2025",7461,5759,5618,34,141,"PODEMOS-IU-EQUO",852
2,"2026",836,690,679,3,11,"PODEMOS-IU-EQUO",102
9,"9131",462,365,364,2,1,"PODEMOS-IU-EQUO",68
2,"2080",528,406,400,2,6,"PODEMOS-IU-EQUO",38
34,"34055",270,209,207,2,2,"PODEMOS-IU-EQUO",7
45,"45186",3061,2242,2214,11,28,"PODEMOS-IU-EQUO",645
5,"5027",269,229,225,2,4,"PODEMOS-IU-EQUO",33
34,"34039",61,49,47,0,2,"PODEMOS-IU-EQUO",1
26,"26073",97,78,78,0,0,"PODEMOS-IU-EQUO",18
19,"19004",67,53,53,1,0,"PODEMOS-IU-EQUO",2
10,"10121",7978,5517,5429,35,88,"PODEMOS-IU-EQUO",689
34,"34131",59,52,51,0,1,"PODEMOS-IU-EQUO",0
24,"24218",451,330,325,2,5,"PODEMOS-IU-EQUO",58
13,"13051",346,264,264,1,0,"PODEMOS-IU-EQUO",30
45,"45042",187,140,140,0,0,"PODEMOS-IU-EQUO",17
45,"45142",7871,6007,5927,37,80,"PODEMOS-IU-EQUO",759
6,"6017",272,222,221,1,1,"PODEMOS-IU-EQUO",15
5,"5128",354,281,271,2,10,"PODEMOS-IU-EQUO",72
6,"6154",2802,1923,1894,23,29,"PODEMOS-IU-EQUO",157
24,"24094",1385,983,968,11,15,"PODEMOS-IU-EQUO",169
9,"9214",672,427,427,4,0,"PODEMOS-IU-EQUO",109
10,"10077",677,479,472,1,7,"PODEMOS-IU-EQUO",55
2,"2082",101,80,80,1,0,"PODEMOS-IU-EQUO",14
9,"9458",469,343,336,5,7,"PODEMOS-IU-EQUO",84
10,"10198",1143,981,964,6,17,"PODEMOS-IU-EQUO",28
45,"45199",2940,1848,1805,14,43,"PODEMOS-IU-EQUO",405
37,"37286",207,152,145,4,7,"PODEMOS-IU-EQUO",33
6,"6140",630,506,499,3,7,"PODEMOS-IU-EQUO",14
34,"34182",786,606,597,10,9,"PODEMOS-IU-EQUO",53
26,"26087",201,153,149,3,4,"PODEMOS-IU-EQUO",23
19,"19263",26,15,15,1,0,"PODEMOS-IU-EQUO",2
10,"10046",203,168,168,1,0,"PODEMOS-IU-EQUO",22
9,"9050",68,56,55,1,1,"PODEMOS-IU-EQUO",21
37,"37222",93,72,72,0,0,"PODEMOS-IU-EQUO",11
19,"19334",35,31,31,0,0,"PODEMOS-IU-EQUO",1
19,"19002",69,58,57,0,1,"PODEMOS-IU-EQUO",4
45,"45092",232,197,191,0,6,"PODEMOS-IU-EQUO",6
6,"6126",2170,1523,1507,1,16,"PODEMOS-IU-EQUO",150
5,"5195",220,169,169,2,0,"PODEMOS-IU-EQUO",19
9,"9001",27,22,22,0,0,"PODEMOS-IU-EQUO",0
37,"37089",67,56,56,0,0,"PODEMOS-IU-EQUO",3
26,"26149",57,47,46,0,1,"PODEMOS-IU-EQUO",10
16,"16086",890,740,735,6,5,"PODEMOS-IU-EQUO",73
37,"37247",196,163,162,3,1,"PODEMOS-IU-EQUO",12
39,"39069",1972,1510,1489,12,21,"PODEMOS-IU-EQUO",272
10,"10171",344,245,244,0,1,"PODEMOS-IU-EQUO",9
13,"13073",531,399,391,3,8,"PODEMOS-IU-EQUO",26
24,"24074",97,75,75,1,0,"PODEMOS-IU-EQUO",3
19,"19254",45,34,34,0,0,"PODEMOS-IU-EQUO",2
5,"5084",74,53,53,0,0,"PODEMOS-IU-EQUO",6
34,"34237",592,462,452,6,10,"PODEMOS-IU-EQUO",30
24,"24154",1005,673,666,4,7,"PODEMOS-IU-EQUO",94
37,"37074",150,123,120,0,3,"PODEMOS-IU-EQUO",8
38,"38040",5021,3136,3102,14,34,"PODEMOS-IU-EQUO",330
24,"24185",474,357,350,3,7,"PODEMOS-IU-EQUO",49
26,"26150",112,101,95,0,6,"PODEMOS-IU-EQUO",14
10,"10126",1548,1120,1102,8,18,"PODEMOS-IU-EQUO",71
24,"24131",724,511,507,3,4,"PODEMOS-IU-EQUO",43
5,"5214",38,28,28,0,0,"PODEMOS-IU-EQUO",2
16,"16039",392,261,254,1,7,"PODEMOS-IU-EQUO",22
39,"39013",511,402,399,4,3,"PODEMOS-IU-EQUO",34
45,"45116",687,509,505,1,4,"PODEMOS-IU-EQUO",35
9,"9174",794,559,552,4,7,"PODEMOS-IU-EQUO",72
45,"45084",2257,1679,1656,13,23,"PODEMOS-IU-EQUO",246
9,"9014",195,115,114,1,1,"PODEMOS-IU-EQUO",12
45,"45002",2564,1681,1665,17,16,"PODEMOS-IU-EQUO",256
16,"16025",26,23,23,0,0,"PODEMOS-IU-EQUO",1
45,"45181",2315,1674,1640,7,34,"PODEMOS-IU-EQUO",97
2,"2033",1892,1505,1474,6,31,"PODEMOS-IU-EQUO",235
9,"9078",41,30,30,1,0,"PODEMOS-IU-EQUO",2
34,"34092",288,230,226,1,4,"PODEMOS-IU-EQUO",8
16,"16199",30,25,25,1,0,"PODEMOS-IU-EQUO",0
5,"5038",115,83,81,0,2,"PODEMOS-IU-EQUO",8
16,"16078",41429,30053,29775,235,278,"PODEMOS-IU-EQUO",4951
19,"19309",26,21,21,0,0,"PODEMOS-IU-EQUO",8
19,"19277",19,13,13,0,0,"PODEMOS-IU-EQUO",2
6,"6014",6682,4479,4409,14,70,"PODEMOS-IU-EQUO",421
5,"5233",221,191,191,1,0,"PODEMOS-IU-EQUO",20
16,"16089",375,303,303,6,0,"PODEMOS-IU-EQUO",33
26,"26096",245,190,190,1,0,"PODEMOS-IU-EQUO",39
5,"5185",95,82,81,0,1,"PODEMOS-IU-EQUO",5
16,"16042",1157,933,921,4,12,"PODEMOS-IU-EQUO",99
16,"16187",74,55,55,1,0,"PODEMOS-IU-EQUO",7
37,"37032",548,401,399,0,2,"PODEMOS-IU-EQUO",52
10,"10176",371,262,261,0,1,"PODEMOS-IU-EQUO",43
10,"10190",545,406,395,2,11,"PODEMOS-IU-EQUO",39
9,"9159",60,52,51,2,1,"PODEMOS-IU-EQUO",8
37,"37154",140,113,110,3,3,"PODEMOS-IU-EQUO",3
24,"24012",290,207,205,1,2,"PODEMOS-IU-EQUO",25
42,"42030",94,78,78,1,0,"PODEMOS-IU-EQUO",0
10,"10902",721,548,540,4,8,"PODEMOS-IU-EQUO",18
24,"24002",231,173,172,1,1,"PODEMOS-IU-EQUO",10
34,"34094",64,45,44,0,1,"PODEMOS-IU-EQUO",2
9,"9044",46,35,34,1,1,"PODEMOS-IU-EQUO",3
34,"34243",325,252,248,0,4,"PODEMOS-IU-EQUO",23
19,"19324",176,126,125,3,1,"PODEMOS-IU-EQUO",4
24,"24091",645,454,451,1,3,"PODEMOS-IU-EQUO",75
16,"16044",39,30,30,0,0,"PODEMOS-IU-EQUO",1
9,"9098",507,369,362,5,7,"PODEMOS-IU-EQUO",42
34,"34066",59,49,48,0,1,"PODEMOS-IU-EQUO",5
10,"10014",1852,1370,1346,6,24,"PODEMOS-IU-EQUO",141
9,"9908",449,307,306,3,1,"PODEMOS-IU-EQUO",70
37,"37038",788,595,583,4,12,"PODEMOS-IU-EQUO",59
34,"34902",139,106,106,0,0,"PODEMOS-IU-EQUO",10
10,"10178",769,565,553,3,12,"PODEMOS-IU-EQUO",76
42,"42075",83,62,62,0,0,"PODEMOS-IU-EQUO",4
2,"2078",920,675,664,1,11,"PODEMOS-IU-EQUO",157
10,"10087",1687,1218,1212,6,6,"PODEMOS-IU-EQUO",97
9,"9219",27509,19084,18859,146,225,"PODEMOS-IU-EQUO",4805
37,"37254",181,142,141,0,1,"PODEMOS-IU-EQUO",13
9,"9046",29,25,25,0,0,"PODEMOS-IU-EQUO",9
19,"19123",40,32,31,1,1,"PODEMOS-IU-EQUO",4
9,"9428",108,92,91,0,1,"PODEMOS-IU-EQUO",9
10,"10122",218,156,153,3,3,"PODEMOS-IU-EQUO",23
26,"26183",64,49,49,0,0,"PODEMOS-IU-EQUO",6
26,"26164",59,46,45,2,1,"PODEMOS-IU-EQUO",3
9,"9272",282,210,206,3,4,"PODEMOS-IU-EQUO",20
34,"34006",81,67,66,2,1,"PODEMOS-IU-EQUO",6
2,"2011",632,520,516,1,4,"PODEMOS-IU-EQUO",29
24,"24106",248,167,166,1,1,"PODEMOS-IU-EQUO",10
42,"42022",221,173,171,5,2,"PODEMOS-IU-EQUO",9
37,"37340",151,106,106,1,0,"PODEMOS-IU-EQUO",2
6,"6152",1319,945,932,4,13,"PODEMOS-IU-EQUO",130
38,"38047",1777,1198,1170,4,28,"PODEMOS-IU-EQUO",120
34,"34217",1207,937,923,8,14,"PODEMOS-IU-EQUO",179
9,"9143",27,19,18,0,1,"PODEMOS-IU-EQUO",3
42,"42107",74,54,54,3,0,"PODEMOS-IU-EQUO",9
6,"6061",1084,853,837,4,16,"PODEMOS-IU-EQUO",68
24,"24060",602,363,361,3,2,"PODEMOS-IU-EQUO",51
5,"5258",111,95,95,0,0,"PODEMOS-IU-EQUO",10
5,"5095",262,225,223,1,2,"PODEMOS-IU-EQUO",22
35,"35024",13735,8545,8439,77,106,"PODEMOS-IU-EQUO",1856
9,"9177",1121,757,749,9,8,"PODEMOS-IU-EQUO",114
37,"37086",101,72,71,1,1,"PODEMOS-IU-EQUO",4
34,"34149",23,18,18,0,0,"PODEMOS-IU-EQUO",2
16,"16250",76,59,59,0,0,"PODEMOS-IU-EQUO",4
9,"9312",96,78,77,0,1,"PODEMOS-IU-EQUO",12
5,"5209",85,70,70,0,0,"PODEMOS-IU-EQUO",8
9,"9223",45,37,37,0,0,"PODEMOS-IU-EQUO",6
24,"24017",577,426,418,1,8,"PODEMOS-IU-EQUO",54
2,"2031",565,457,455,0,2,"PODEMOS-IU-EQUO",48
37,"37108",99,79,78,0,1,"PODEMOS-IU-EQUO",6
38,"38032",13237,8908,8828,52,80,"PODEMOS-IU-EQUO",1742
37,"37081",930,728,722,3,6,"PODEMOS-IU-EQUO",32
5,"5241",3063,2056,2032,15,24,"PODEMOS-IU-EQUO",319
9,"9062",51,40,39,0,1,"PODEMOS-IU-EQUO",6
9,"9346",92,64,63,1,1,"PODEMOS-IU-EQUO",8
39,"39027",3118,2322,2295,26,27,"PODEMOS-IU-EQUO",331
10,"10183",980,733,728,1,5,"PODEMOS-IU-EQUO",101
26,"26160",709,552,549,2,3,"PODEMOS-IU-EQUO",69
38,"38026",32950,24443,24196,129,247,"PODEMOS-IU-EQUO",3192
19,"19241",43,34,34,1,0,"PODEMOS-IU-EQUO",5
13,"13002",1483,1012,998,3,14,"PODEMOS-IU-EQUO",80
24,"24201",1090,762,759,10,3,"PODEMOS-IU-EQUO",99
6,"6100",935,780,774,1,6,"PODEMOS-IU-EQUO",51
16,"16123",82,61,61,3,0,"PODEMOS-IU-EQUO",10
24,"24145",654,463,461,2,2,"PODEMOS-IU-EQUO",50
10,"10006",1263,978,970,2,8,"PODEMOS-IU-EQUO",60
37,"37138",203,149,148,2,1,"PODEMOS-IU-EQUO",1
19,"19257",3403,2430,2402,19,28,"PODEMOS-IU-EQUO",336
42,"42100",32,30,30,0,0,"PODEMOS-IU-EQUO",2
16,"16239",135,110,105,0,5,"PODEMOS-IU-EQUO",24
26,"26055",39,32,32,0,0,"PODEMOS-IU-EQUO",7
10,"10186",977,795,778,1,17,"PODEMOS-IU-EQUO",72
42,"42128",42,42,41,1,1,"PODEMOS-IU-EQUO",7
6,"6020",1815,1366,1345,10,21,"PODEMOS-IU-EQUO",160
16,"16148",573,504,500,4,4,"PODEMOS-IU-EQUO",30
9,"9025",122,83,83,1,0,"PODEMOS-IU-EQUO",8
16,"16052",547,418,416,2,2,"PODEMOS-IU-EQUO",56
13,"13037",842,661,652,1,9,"PODEMOS-IU-EQUO",52
10,"10019",1498,1063,1054,3,9,"PODEMOS-IU-EQUO",160
19,"19291",1191,879,869,3,10,"PODEMOS-IU-EQUO",148
5,"5245",353,286,285,3,1,"PODEMOS-IU-EQUO",32
6,"6158",13314,9654,9507,67,147,"PODEMOS-IU-EQUO",1630
37,"37015",224,144,144,1,0,"PODEMOS-IU-EQUO",19
37,"37360",225,174,173,1,1,"PODEMOS-IU-EQUO",10
10,"10202",606,473,463,4,10,"PODEMOS-IU-EQUO",61
19,"19061",57,42,42,0,0,"PODEMOS-IU-EQUO",6
24,"24076",1277,956,947,4,9,"PODEMOS-IU-EQUO",198
38,"38028",22103,15036,14844,85,192,"PODEMOS-IU-EQUO",2421
37,"37113",433,334,333,3,1,"PODEMOS-IU-EQUO",20
16,"16139",335,256,255,2,1,"PODEMOS-IU-EQUO",30
10,"10167",314,239,239,1,0,"PODEMOS-IU-EQUO",7
37,"37369",137,95,94,0,1,"PODEMOS-IU-EQUO",18
16,"16140",27,16,16,0,0,"PODEMOS-IU-EQUO",1
6,"6073",733,496,484,8,12,"PODEMOS-IU-EQUO",155
16,"16205",115,88,87,0,1,"PODEMOS-IU-EQUO",25
9,"9275",192,129,129,2,0,"PODEMOS-IU-EQUO",14
34,"34171",968,708,703,5,5,"PODEMOS-IU-EQUO",102
45,"45192",2491,2069,2049,2,20,"PODEMOS-IU-EQUO",156
42,"42192",42,27,27,2,0,"PODEMOS-IU-EQUO",1
37,"37044",466,362,360,2,2,"PODEMOS-IU-EQUO",34
5,"5266",100,86,86,0,0,"PODEMOS-IU-EQUO",0
16,"16170",692,501,493,4,8,"PODEMOS-IU-EQUO",64
37,"37114",84,70,69,2,1,"PODEMOS-IU-EQUO",1
16,"16118",1375,1106,1086,13,20,"PODEMOS-IU-EQUO",137
24,"24156",239,159,158,1,1,"PODEMOS-IU-EQUO",22
10,"10905",656,446,439,2,7,"PODEMOS-IU-EQUO",54
26,"26180",221,173,172,0,1,"PODEMOS-IU-EQUO",18
34,"34231",229,168,167,1,1,"PODEMOS-IU-EQUO",13
30,"30033",10188,7403,7285,68,118,"PODEMOS-IU-EQUO",853
19,"19296",30,19,18,0,1,"PODEMOS-IU-EQUO",2
42,"42043",3791,2727,2682,25,45,"PODEMOS-IU-EQUO",371
34,"34158",288,186,184,3,2,"PODEMOS-IU-EQUO",31
39,"39022",980,721,713,2,8,"PODEMOS-IU-EQUO",67
10,"10145",127,97,95,0,2,"PODEMOS-IU-EQUO",1
42,"42153",14,12,12,0,0,"PODEMOS-IU-EQUO",0
9,"9307",109,81,80,0,1,"PODEMOS-IU-EQUO",10
26,"26177",304,255,254,7,1,"PODEMOS-IU-EQUO",30
19,"19307",27,23,23,0,0,"PODEMOS-IU-EQUO",3
16,"16013",27,24,24,0,0,"PODEMOS-IU-EQUO",5
19,"19223",111,83,83,3,0,"PODEMOS-IU-EQUO",6
6,"6041",460,372,367,0,5,"PODEMOS-IU-EQUO",59
34,"34020",52,39,39,0,0,"PODEMOS-IU-EQUO",4
9,"9368",22,17,17,2,0,"PODEMOS-IU-EQUO",0
5,"5235",124,111,110,0,1,"PODEMOS-IU-EQUO",6
9,"9184",5,4,4,0,0,"PODEMOS-IU-EQUO",1
39,"39053",219,153,152,2,1,"PODEMOS-IU-EQUO",16
34,"34110",88,71,71,1,0,"PODEMOS-IU-EQUO",18
45,"45038",3356,2376,2350,15,26,"PODEMOS-IU-EQUO",476
37,"37215",136,104,103,1,1,"PODEMOS-IU-EQUO",9
34,"34041",90,71,71,1,0,"PODEMOS-IU-EQUO",7
9,"9076",23,17,17,1,0,"PODEMOS-IU-EQUO",0
42,"42120",145,91,89,2,2,"PODEMOS-IU-EQUO",16
6,"6002",4322,2819,2762,22,57,"PODEMOS-IU-EQUO",400
45,"45187",4062,3277,3233,15,44,"PODEMOS-IU-EQUO",355
26,"26123",126,108,107,2,1,"PODEMOS-IU-EQUO",12
26,"26135",164,125,124,1,1,"PODEMOS-IU-EQUO",17
19,"19225",823,623,619,3,4,"PODEMOS-IU-EQUO",118
45,"45006",1406,942,931,4,11,"PODEMOS-IU-EQUO",105
16,"16015",374,263,262,4,1,"PODEMOS-IU-EQUO",23
37,"37324",360,276,275,2,1,"PODEMOS-IU-EQUO",13
26,"26016",28,25,24,1,1,"PODEMOS-IU-EQUO",1
5,"5097",475,317,313,0,4,"PODEMOS-IU-EQUO",29
24,"24084",163,116,116,0,0,"PODEMOS-IU-EQUO",10
26,"26009",401,325,321,4,4,"PODEMOS-IU-EQUO",62
2,"2020",432,365,364,1,1,"PODEMOS-IU-EQUO",37
6,"6130",195,164,158,0,6,"PODEMOS-IU-EQUO",16
37,"37045",26,23,21,0,2,"PODEMOS-IU-EQUO",1
45,"45059",1712,1337,1311,1,26,"PODEMOS-IU-EQUO",60
37,"37278",732,532,528,3,4,"PODEMOS-IU-EQUO",103
34,"34068",27,22,22,0,0,"PODEMOS-IU-EQUO",5
10,"10195",7709,5572,5481,37,91,"PODEMOS-IU-EQUO",623
37,"37312",258,201,200,2,1,"PODEMOS-IU-EQUO",1
19,"19103",251,208,208,2,0,"PODEMOS-IU-EQUO",19
45,"45174",301,237,233,1,4,"PODEMOS-IU-EQUO",10
10,"10211",444,337,336,0,1,"PODEMOS-IU-EQUO",31
16,"16142",136,101,101,1,0,"PODEMOS-IU-EQUO",14
39,"39096",690,487,479,4,8,"PODEMOS-IU-EQUO",35
6,"6031",469,277,272,2,5,"PODEMOS-IU-EQUO",8
26,"26157",296,241,237,4,4,"PODEMOS-IU-EQUO",25
5,"5190",53,42,41,2,1,"PODEMOS-IU-EQUO",2
38,"38048",3901,2667,2637,20,30,"PODEMOS-IU-EQUO",485
42,"42108",12,9,9,1,0,"PODEMOS-IU-EQUO",0
38,"38012",2347,1644,1630,7,14,"PODEMOS-IU-EQUO",295
2,"2014",356,283,280,1,3,"PODEMOS-IU-EQUO",47
37,"37054",250,195,192,1,3,"PODEMOS-IU-EQUO",26
10,"10152",468,340,332,1,8,"PODEMOS-IU-EQUO",29
37,"37231",250,196,193,4,3,"PODEMOS-IU-EQUO",29
9,"9456",130,97,96,0,1,"PODEMOS-IU-EQUO",6
42,"42015",30,20,19,1,1,"PODEMOS-IU-EQUO",0
37,"37234",345,247,247,1,0,"PODEMOS-IU-EQUO",16
19,"19224",93,87,87,0,0,"PODEMOS-IU-EQUO",3
2,"2081",18342,13244,13075,80,169,"PODEMOS-IU-EQUO",1768
9,"9440",91,78,78,2,0,"PODEMOS-IU-EQUO",8
35,"35022",48603,29443,29042,160,401,"PODEMOS-IU-EQUO",6579
37,"37156",4292,2996,2966,24,30,"PODEMOS-IU-EQUO",214
2,"2064",372,325,324,1,1,"PODEMOS-IU-EQUO",24
9,"9036",37,31,30,1,1,"PODEMOS-IU-EQUO",4
37,"37147",193,134,132,1,2,"PODEMOS-IU-EQUO",22
10,"10214",214,181,177,2,4,"PODEMOS-IU-EQUO",18
24,"24028",388,292,288,2,4,"PODEMOS-IU-EQUO",33
9,"9120",38,32,32,1,0,"PODEMOS-IU-EQUO",8
10,"10128",5697,3958,3891,32,67,"PODEMOS-IU-EQUO",475
37,"37060",243,187,187,1,0,"PODEMOS-IU-EQUO",23
45,"45014",4010,2646,2616,22,30,"PODEMOS-IU-EQUO",521
19,"19161",211,159,157,1,2,"PODEMOS-IU-EQUO",24
37,"37361",86,66,66,0,0,"PODEMOS-IU-EQUO",3
9,"9335",88,68,68,0,0,"PODEMOS-IU-EQUO",12
10,"10042",84,63,63,0,0,"PODEMOS-IU-EQUO",12
6,"6060",5786,4146,4071,24,75,"PODEMOS-IU-EQUO",596
38,"38031",28687,21132,20858,104,274,"PODEMOS-IU-EQUO",2534
19,"19040",52,41,39,0,2,"PODEMOS-IU-EQUO",9
16,"16131",130,100,97,2,3,"PODEMOS-IU-EQUO",7
19,"19091",26,20,20,0,0,"PODEMOS-IU-EQUO",0
24,"24210",503,358,356,3,2,"PODEMOS-IU-EQUO",57
13,"13090",1094,843,828,4,15,"PODEMOS-IU-EQUO",46
5,"5165",368,290,281,3,9,"PODEMOS-IU-EQUO",59
9,"9347",143,117,115,2,2,"PODEMOS-IU-EQUO",29
38,"38015",4170,2862,2836,10,26,"PODEMOS-IU-EQUO",311
5,"5101",292,240,236,1,4,"PODEMOS-IU-EQUO",16
16,"16255",140,122,121,0,1,"PODEMOS-IU-EQUO",3
24,"24143",510,358,349,0,9,"PODEMOS-IU-EQUO",78
16,"16100",670,564,559,0,5,"PODEMOS-IU-EQUO",51
10,"10080",366,257,255,1,2,"PODEMOS-IU-EQUO",13
42,"42161",137,102,101,0,1,"PODEMOS-IU-EQUO",12
26,"26044",52,46,46,0,0,"PODEMOS-IU-EQUO",4
37,"37332",68,51,50,0,1,"PODEMOS-IU-EQUO",2
16,"16217",74,62,62,0,0,"PODEMOS-IU-EQUO",4
26,"26011",7321,5133,5083,38,50,"PODEMOS-IU-EQUO",756
9,"9082",39,36,36,0,0,"PODEMOS-IU-EQUO",0
30,"30011",4697,3421,3383,15,38,"PODEMOS-IU-EQUO",371
34,"34204",46,41,41,0,0,"PODEMOS-IU-EQUO",0
16,"16092",158,125,125,1,0,"PODEMOS-IU-EQUO",13
10,"10045",1019,762,755,3,7,"PODEMOS-IU-EQUO",101
38,"38036",6592,4518,4440,45,78,"PODEMOS-IU-EQUO",762
9,"9119",46,28,28,0,0,"PODEMOS-IU-EQUO",3
42,"42125",70,59,59,1,0,"PODEMOS-IU-EQUO",3
9,"9032",109,75,73,0,2,"PODEMOS-IU-EQUO",10
10,"10204",429,331,329,6,2,"PODEMOS-IU-EQUO",59
9,"9198",104,83,82,1,1,"PODEMOS-IU-EQUO",14
2,"2074",5935,4193,4139,32,54,"PODEMOS-IU-EQUO",523
9,"9381",30,24,24,1,0,"PODEMOS-IU-EQUO",2
6,"6089",596,469,461,1,8,"PODEMOS-IU-EQUO",40
9,"9247",24,21,21,1,0,"PODEMOS-IU-EQUO",0
26,"26148",165,135,133,1,2,"PODEMOS-IU-EQUO",22
39,"39061",3478,2695,2677,13,18,"PODEMOS-IU-EQUO",391
10,"10021",5147,3744,3648,31,96,"PODEMOS-IU-EQUO",652
13,"13093",4103,2963,2929,21,34,"PODEMOS-IU-EQUO",330
16,"16163",74,62,62,0,0,"PODEMOS-IU-EQUO",14
45,"45158",2514,1777,1760,11,17,"PODEMOS-IU-EQUO",248
39,"39024",1879,1390,1372,2,18,"PODEMOS-IU-EQUO",272
42,"42156",28,16,16,1,0,"PODEMOS-IU-EQUO",0
42,"42194",170,118,114,1,4,"PODEMOS-IU-EQUO",7
9,"9155",27,20,20,0,0,"PODEMOS-IU-EQUO",0
16,"16027",710,542,538,5,4,"PODEMOS-IU-EQUO",84
5,"5217",56,44,43,0,1,"PODEMOS-IU-EQUO",2
9,"9043",192,137,133,1,4,"PODEMOS-IU-EQUO",18
9,"9113",449,339,332,4,7,"PODEMOS-IU-EQUO",58
5,"5138",306,221,220,1,1,"PODEMOS-IU-EQUO",14
16,"16224",83,66,65,1,1,"PODEMOS-IU-EQUO",15
2,"2063",1463,1073,1060,3,13,"PODEMOS-IU-EQUO",69
5,"5170",50,43,43,0,0,"PODEMOS-IU-EQUO",7
9,"9398",75,56,56,0,0,"PODEMOS-IU-EQUO",0
19,"19198",14,12,12,0,0,"PODEMOS-IU-EQUO",1
9,"9244",46,34,34,1,0,"PODEMOS-IU-EQUO",2
16,"16204",261,199,199,1,0,"PODEMOS-IU-EQUO",27
9,"9246",620,451,444,2,7,"PODEMOS-IU-EQUO",88
45,"45205",6824,4424,4362,22,62,"PODEMOS-IU-EQUO",812
24,"24046",942,637,633,5,4,"PODEMOS-IU-EQUO",89
37,"37132",351,256,253,2,3,"PODEMOS-IU-EQUO",27
45,"45030",478,368,360,2,8,"PODEMOS-IU-EQUO",67
24,"24222",14256,9996,9884,101,112,"PODEMOS-IU-EQUO",2036
34,"34070",154,123,123,2,0,"PODEMOS-IU-EQUO",20
42,"42165",409,271,261,10,10,"PODEMOS-IU-EQUO",30
37,"37337",139,124,124,0,0,"PODEMOS-IU-EQUO",0
34,"34004",5608,4120,4063,43,57,"PODEMOS-IU-EQUO",703
9,"9259",230,186,186,5,0,"PODEMOS-IU-EQUO",13
30,"30014",1567,1174,1160,8,14,"PODEMOS-IU-EQUO",126
19,"19271",46,39,39,0,0,"PODEMOS-IU-EQUO",5
34,"34245",307,209,208,5,1,"PODEMOS-IU-EQUO",10
5,"5221",351,254,250,2,4,"PODEMOS-IU-EQUO",69
6,"6044",28875,19791,19616,145,175,"PODEMOS-IU-EQUO",2532
10,"10138",555,448,446,2,2,"PODEMOS-IU-EQUO",89
9,"9209",4473,3223,3192,20,31,"PODEMOS-IU-EQUO",481
19,"19321",39,30,30,1,0,"PODEMOS-IU-EQUO",4
9,"9405",130,98,96,0,2,"PODEMOS-IU-EQUO",4
24,"24077",225,190,187,2,3,"PODEMOS-IU-EQUO",9
2,"2060",1294,997,983,2,14,"PODEMOS-IU-EQUO",83
45,"45102",3610,2506,2470,14,36,"PODEMOS-IU-EQUO",340
19,"19079",8,8,7,0,1,"PODEMOS-IU-EQUO",0
19,"19174",109,80,79,0,1,"PODEMOS-IU-EQUO",24
37,"37194",251,196,195,1,1,"PODEMOS-IU-EQUO",31
39,"39025",8637,6486,6378,47,108,"PODEMOS-IU-EQUO",1110
13,"13031",2452,1919,1909,11,10,"PODEMOS-IU-EQUO",161
5,"5208",40,36,36,0,0,"PODEMOS-IU-EQUO",6
37,"37036",61,44,43,0,1,"PODEMOS-IU-EQUO",5
10,"10135",1302,981,969,3,12,"PODEMOS-IU-EQUO",73
16,"16156",97,78,77,0,1,"PODEMOS-IU-EQUO",9
10,"10070",718,546,542,1,4,"PODEMOS-IU-EQUO",39
19,"19238",42,28,28,0,0,"PODEMOS-IU-EQUO",2
37,"37199",142,105,105,1,0,"PODEMOS-IU-EQUO",8
6,"6046",1255,1004,995,8,9,"PODEMOS-IU-EQUO",51
42,"42124",64,49,49,0,0,"PODEMOS-IU-EQUO",4
10,"10181",686,533,523,1,10,"PODEMOS-IU-EQUO",71
34,"34180",66,55,55,1,0,"PODEMOS-IU-EQUO",2
10,"10212",1684,1233,1203,7,30,"PODEMOS-IU-EQUO",325
26,"26181",14,14,14,0,0,"PODEMOS-IU-EQUO",0
2,"2027",315,248,246,2,2,"PODEMOS-IU-EQUO",14
45,"45108",509,412,411,1,1,"PODEMOS-IU-EQUO",9
30,"30027",48176,35521,35266,153,255,"PODEMOS-IU-EQUO",5635
6,"6007",1475,1038,1032,1,6,"PODEMOS-IU-EQUO",103
10,"10174",174,135,132,0,3,"PODEMOS-IU-EQUO",11
19,"19130",60145,45531,45085,286,446,"PODEMOS-IU-EQUO",7465
9,"9431",118,98,98,0,0,"PODEMOS-IU-EQUO",12
5,"5080",58,45,43,0,2,"PODEMOS-IU-EQUO",7
13,"13016",664,517,509,4,8,"PODEMOS-IU-EQUO",36
5,"5047",4163,3198,3142,17,56,"PODEMOS-IU-EQUO",362
37,"37378",111,77,75,2,2,"PODEMOS-IU-EQUO",2
9,"9023",1102,818,811,11,7,"PODEMOS-IU-EQUO",166
6,"6094",1485,929,926,2,3,"PODEMOS-IU-EQUO",47
34,"34010",577,440,438,5,2,"PODEMOS-IU-EQUO",36
19,"19203",30,24,24,0,0,"PODEMOS-IU-EQUO",5
19,"19096",91,72,69,0,3,"PODEMOS-IU-EQUO",15
6,"6084",1093,828,818,8,10,"PODEMOS-IU-EQUO",54
37,"37203",158,117,117,0,0,"PODEMOS-IU-EQUO",13
5,"5196",50,37,36,0,1,"PODEMOS-IU-EQUO",3
5,"5070",30,27,27,0,0,"PODEMOS-IU-EQUO",2
9,"9423",27,24,24,0,0,"PODEMOS-IU-EQUO",2
16,"16008",89,69,69,0,0,"PODEMOS-IU-EQUO",14
19,"19020",44,30,30,1,0,"PODEMOS-IU-EQUO",2
45,"45039",224,192,190,0,2,"PODEMOS-IU-EQUO",8
16,"16263",959,722,715,4,7,"PODEMOS-IU-EQUO",100
37,"37251",124,93,92,1,1,"PODEMOS-IU-EQUO",0
42,"42081",145,102,100,1,2,"PODEMOS-IU-EQUO",9
37,"37163",41,34,34,0,0,"PODEMOS-IU-EQUO",8
16,"16909",699,535,532,0,3,"PODEMOS-IU-EQUO",77
34,"34184",57,46,45,0,1,"PODEMOS-IU-EQUO",7
38,"38045",3837,2127,2111,12,16,"PODEMOS-IU-EQUO",396
9,"9417",40,32,32,1,0,"PODEMOS-IU-EQUO",0
45,"45011",278,239,233,1,6,"PODEMOS-IU-EQUO",10
45,"45201",3447,2082,2050,9,32,"PODEMOS-IU-EQUO",433
24,"24229",418,322,319,2,3,"PODEMOS-IU-EQUO",16
42,"42141",112,80,80,0,0,"PODEMOS-IU-EQUO",8
45,"45194",68,54,53,0,1,"PODEMOS-IU-EQUO",2
34,"34015",41,35,35,3,0,"PODEMOS-IU-EQUO",3
13,"13027",3415,2380,2354,4,26,"PODEMOS-IU-EQUO",186
45,"45104",428,324,323,1,1,"PODEMOS-IU-EQUO",59
19,"19159",93,78,77,0,1,"PODEMOS-IU-EQUO",11
5,"5182",786,538,532,2,6,"PODEMOS-IU-EQUO",61
34,"34051",101,88,83,0,5,"PODEMOS-IU-EQUO",7
34,"34133",107,91,90,0,1,"PODEMOS-IU-EQUO",7
37,"37021",79,60,60,0,0,"PODEMOS-IU-EQUO",1
10,"10039",417,291,291,0,0,"PODEMOS-IU-EQUO",33
5,"5090",77,68,68,1,0,"PODEMOS-IU-EQUO",3
10,"10038",87,68,68,0,0,"PODEMOS-IU-EQUO",5
34,"34175",90,72,70,0,2,"PODEMOS-IU-EQUO",9
19,"19213",70,62,61,2,1,"PODEMOS-IU-EQUO",1
6,"6013",265,212,209,3,3,"PODEMOS-IU-EQUO",34
9,"9129",104,83,83,0,0,"PODEMOS-IU-EQUO",8
34,"34032",40,33,33,1,0,"PODEMOS-IU-EQUO",8
24,"24224",616,454,451,4,3,"PODEMOS-IU-EQUO",50
34,"34033",17,17,17,0,0,"PODEMOS-IU-EQUO",1
16,"16247",67,58,58,0,0,"PODEMOS-IU-EQUO",5
26,"26080",472,391,389,0,2,"PODEMOS-IU-EQUO",24
16,"16202",769,564,558,0,6,"PODEMOS-IU-EQUO",80
34,"34001",34,28,28,2,0,"PODEMOS-IU-EQUO",6
26,"26068",80,61,61,1,0,"PODEMOS-IU-EQUO",12
24,"24070",4124,3024,2981,20,43,"PODEMOS-IU-EQUO",923
16,"16271",633,517,516,4,1,"PODEMOS-IU-EQUO",85
2,"2076",329,237,236,1,1,"PODEMOS-IU-EQUO",15
9,"9340",77,49,49,0,0,"PODEMOS-IU-EQUO",1
16,"16141",143,102,102,0,0,"PODEMOS-IU-EQUO",11
37,"37341",53,39,39,0,0,"PODEMOS-IU-EQUO",5
45,"45048",358,278,275,1,3,"PODEMOS-IU-EQUO",16
34,"34242",95,71,68,3,3,"PODEMOS-IU-EQUO",4
6,"6102",1048,843,825,6,18,"PODEMOS-IU-EQUO",69
42,"42187",62,46,45,1,1,"PODEMOS-IU-EQUO",3
19,"19262",135,100,100,0,0,"PODEMOS-IU-EQUO",17
5,"5123",97,73,73,1,0,"PODEMOS-IU-EQUO",10
9,"9424",36,29,29,1,0,"PODEMOS-IU-EQUO",3
6,"6091",3774,2709,2666,23,43,"PODEMOS-IU-EQUO",225
42,"42213",27,21,21,1,0,"PODEMOS-IU-EQUO",1
45,"45018",498,333,330,4,3,"PODEMOS-IU-EQUO",92
34,"34218",461,343,339,2,4,"PODEMOS-IU-EQUO",23
10,"10008",1319,1019,1008,6,11,"PODEMOS-IU-EQUO",113
6,"6012",3267,2300,2277,15,23,"PODEMOS-IU-EQUO",249
37,"37131",185,139,139,0,0,"PODEMOS-IU-EQUO",8
19,"19135",107,90,90,3,0,"PODEMOS-IU-EQUO",4
26,"26119",197,156,155,4,1,"PODEMOS-IU-EQUO",29
13,"13052",6422,4651,4580,46,71,"PODEMOS-IU-EQUO",466
24,"24109",977,633,624,3,9,"PODEMOS-IU-EQUO",138
9,"9380",78,58,58,0,0,"PODEMOS-IU-EQUO",12
9,"9279",174,131,130,3,1,"PODEMOS-IU-EQUO",7
24,"24190",165,123,121,1,2,"PODEMOS-IU-EQUO",6
9,"9308",67,42,42,1,0,"PODEMOS-IU-EQUO",6
9,"9052",29,23,23,0,0,"PODEMOS-IU-EQUO",1
6,"6015",116758,77960,77205,583,755,"PODEMOS-IU-EQUO",10479
5,"5244",50,39,39,1,0,"PODEMOS-IU-EQUO",2
26,"26122",118,102,102,0,0,"PODEMOS-IU-EQUO",18
37,"37128",260,202,196,0,6,"PODEMOS-IU-EQUO",37
37,"37142",586,430,429,1,1,"PODEMOS-IU-EQUO",59
10,"10179",294,231,229,2,2,"PODEMOS-IU-EQUO",46
19,"19071",7840,5537,5489,45,48,"PODEMOS-IU-EQUO",1051
5,"5060",116,95,95,0,0,"PODEMOS-IU-EQUO",5
5,"5008",227,170,168,1,2,"PODEMOS-IU-EQUO",11
34,"34130",212,164,163,1,1,"PODEMOS-IU-EQUO",8
9,"9315",378,245,243,1,2,"PODEMOS-IU-EQUO",61
42,"42190",89,65,64,0,1,"PODEMOS-IU-EQUO",8
26,"26170",446,330,326,2,4,"PODEMOS-IU-EQUO",38
24,"24164",370,218,217,0,1,"PODEMOS-IU-EQUO",27
19,"19265",122,97,95,2,2,"PODEMOS-IU-EQUO",7
5,"5022",1588,1238,1222,5,16,"PODEMOS-IU-EQUO",82
24,"24110",1247,899,892,6,7,"PODEMOS-IU-EQUO",238
45,"45140",1087,833,823,3,10,"PODEMOS-IU-EQUO",92
26,"26132",112,82,82,0,0,"PODEMOS-IU-EQUO",14
16,"16064",684,568,562,4,6,"PODEMOS-IU-EQUO",43
5,"5264",61,38,37,2,1,"PODEMOS-IU-EQUO",5
45,"45180",2727,1966,1940,9,26,"PODEMOS-IU-EQUO",239
39,"39056",2286,1714,1684,8,30,"PODEMOS-IU-EQUO",270
5,"5219",38,30,30,0,0,"PODEMOS-IU-EQUO",4
24,"24104",259,169,169,0,0,"PODEMOS-IU-EQUO",26
34,"34019",125,107,105,0,2,"PODEMOS-IU-EQUO",8
39,"39011",1585,1169,1160,5,9,"PODEMOS-IU-EQUO",148
45,"45036",656,471,469,2,2,"PODEMOS-IU-EQUO",63
26,"26105",2205,1670,1658,12,12,"PODEMOS-IU-EQUO",227
34,"34196",89,68,68,1,0,"PODEMOS-IU-EQUO",4
19,"19239",92,62,62,1,0,"PODEMOS-IU-EQUO",6
5,"5046",44,38,38,1,0,"PODEMOS-IU-EQUO",0
34,"34220",147,126,125,3,1,"PODEMOS-IU-EQUO",7
45,"45047",2606,1666,1647,6,19,"PODEMOS-IU-EQUO",301
34,"34129",179,130,129,1,1,"PODEMOS-IU-EQUO",6
6,"6134",547,335,332,1,3,"PODEMOS-IU-EQUO",23
19,"19150",128,99,99,1,0,"PODEMOS-IU-EQUO",10
24,"24043",134,75,75,1,0,"PODEMOS-IU-EQUO",14
37,"37377",241,201,199,1,2,"PODEMOS-IU-EQUO",10
37,"37195",46,36,36,1,0,"PODEMOS-IU-EQUO",8
42,"42123",164,117,116,4,1,"PODEMOS-IU-EQUO",6
39,"39035",9502,7017,6928,57,89,"PODEMOS-IU-EQUO",1148
26,"26070",183,153,153,1,0,"PODEMOS-IU-EQUO",9
19,"19235",93,71,71,1,0,"PODEMOS-IU-EQUO",11
9,"9074",794,575,569,6,6,"PODEMOS-IU-EQUO",91
16,"16203",9972,7094,7007,34,87,"PODEMOS-IU-EQUO",969
9,"9134",221,161,156,7,5,"PODEMOS-IU-EQUO",47
26,"26162",121,99,99,1,0,"PODEMOS-IU-EQUO",18
10,"10033",423,320,320,0,0,"PODEMOS-IU-EQUO",13
19,"19155",66,56,56,0,0,"PODEMOS-IU-EQUO",7
34,"34223",218,155,155,1,0,"PODEMOS-IU-EQUO",8
24,"24228",660,430,422,6,8,"PODEMOS-IU-EQUO",58
37,"37213",89,74,73,0,1,"PODEMOS-IU-EQUO",12
9,"9330",1507,1108,1092,10,16,"PODEMOS-IU-EQUO",192
37,"37371",272,165,162,1,3,"PODEMOS-IU-EQUO",8
10,"10120",171,121,117,1,4,"PODEMOS-IU-EQUO",11
16,"16072",146,104,103,2,1,"PODEMOS-IU-EQUO",5
2,"2034",1382,1110,1093,7,17,"PODEMOS-IU-EQUO",216
10,"10151",207,165,162,0,3,"PODEMOS-IU-EQUO",8
37,"37248",152,126,125,1,1,"PODEMOS-IU-EQUO",7
9,"9323",61,46,46,1,0,"PODEMOS-IU-EQUO",8
30,"30020",6303,4543,4497,25,46,"PODEMOS-IU-EQUO",672
39,"39033",568,418,415,2,3,"PODEMOS-IU-EQUO",67
9,"9085",475,347,342,2,5,"PODEMOS-IU-EQUO",52
34,"34109",59,48,48,0,0,"PODEMOS-IU-EQUO",8
26,"26007",511,384,375,0,9,"PODEMOS-IU-EQUO",109
37,"37112",161,112,111,2,1,"PODEMOS-IU-EQUO",14
6,"6101",463,381,378,2,3,"PODEMOS-IU-EQUO",24
10,"10166",308,206,204,0,2,"PODEMOS-IU-EQUO",16
6,"6086",1221,814,799,2,15,"PODEMOS-IU-EQUO",94
30,"30029",11864,8125,8058,73,67,"PODEMOS-IU-EQUO",999
38,"38021",1629,1033,1022,9,11,"PODEMOS-IU-EQUO",116
37,"37109",183,129,127,0,2,"PODEMOS-IU-EQUO",1
9,"9427",1419,978,959,8,19,"PODEMOS-IU-EQUO",130
5,"5265",82,66,66,1,0,"PODEMOS-IU-EQUO",3
37,"37101",160,128,125,0,3,"PODEMOS-IU-EQUO",12
42,"42162",2352,1637,1601,16,36,"PODEMOS-IU-EQUO",150
34,"34088",246,193,186,1,7,"PODEMOS-IU-EQUO",26
37,"37027",228,172,171,0,1,"PODEMOS-IU-EQUO",29
10,"10044",1428,1040,1025,5,15,"PODEMOS-IU-EQUO",123
45,"45096",1004,807,799,1,8,"PODEMOS-IU-EQUO",228
9,"9392",53,40,37,1,3,"PODEMOS-IU-EQUO",9
19,"19106",89,59,59,0,0,"PODEMOS-IU-EQUO",7
26,"26154",13,10,10,0,0,"PODEMOS-IU-EQUO",2
24,"24153",232,179,177,2,2,"PODEMOS-IU-EQUO",21
37,"37085",4712,3366,3333,27,33,"PODEMOS-IU-EQUO",443
38,"38043",18892,13089,12928,87,161,"PODEMOS-IU-EQUO",2247
9,"9056",4919,3395,3344,20,51,"PODEMOS-IU-EQUO",512
37,"37243",98,70,70,1,0,"PODEMOS-IU-EQUO",3
2,"2028",126,98,98,0,0,"PODEMOS-IU-EQUO",3
16,"16225",73,57,57,3,0,"PODEMOS-IU-EQUO",4
37,"37102",404,307,305,2,2,"PODEMOS-IU-EQUO",26
19,"19282",163,124,123,0,1,"PODEMOS-IU-EQUO",7
5,"5224",102,86,84,3,2,"PODEMOS-IU-EQUO",9
45,"45115",2552,1999,1966,8,33,"PODEMOS-IU-EQUO",161
16,"16161",57,48,46,0,2,"PODEMOS-IU-EQUO",3
39,"39008",13877,10258,10153,96,105,"PODEMOS-IU-EQUO",2083
45,"45119",3330,2096,2067,15,29,"PODEMOS-IU-EQUO",461
37,"37033",95,68,68,5,0,"PODEMOS-IU-EQUO",7
24,"24100",761,561,555,7,6,"PODEMOS-IU-EQUO",129
26,"26110",152,131,129,0,2,"PODEMOS-IU-EQUO",16
9,"9110",80,63,63,0,0,"PODEMOS-IU-EQUO",1
34,"34227",77,61,61,2,0,"PODEMOS-IU-EQUO",3
5,"5042",153,122,121,0,1,"PODEMOS-IU-EQUO",4
10,"10068",735,570,557,2,13,"PODEMOS-IU-EQUO",95
10,"10136",302,218,215,4,3,"PODEMOS-IU-EQUO",29
45,"45137",1604,1032,1024,4,8,"PODEMOS-IU-EQUO",167
6,"6030",169,137,135,0,2,"PODEMOS-IU-EQUO",2
34,"34213",57,45,44,1,1,"PODEMOS-IU-EQUO",9
16,"16275",11,11,11,1,0,"PODEMOS-IU-EQUO",0
6,"6071",245,206,200,0,6,"PODEMOS-IU-EQUO",6
34,"34134",50,40,40,2,0,"PODEMOS-IU-EQUO",6
39,"39094",848,655,651,3,4,"PODEMOS-IU-EQUO",92
37,"37329",42,34,34,0,0,"PODEMOS-IU-EQUO",1
30,"30034",1129,858,844,7,14,"PODEMOS-IU-EQUO",92
24,"24026",1177,864,849,7,15,"PODEMOS-IU-EQUO",68
37,"37166",214,152,151,2,1,"PODEMOS-IU-EQUO",6
19,"19228",26,20,20,0,0,"PODEMOS-IU-EQUO",7
34,"34063",83,76,75,1,1,"PODEMOS-IU-EQUO",5
30,"30013",7396,5147,5102,32,45,"PODEMOS-IU-EQUO",646
5,"5082",529,432,422,1,10,"PODEMOS-IU-EQUO",52
2,"2012",1835,1476,1453,7,23,"PODEMOS-IU-EQUO",122
13,"13096",7652,5480,5415,19,65,"PODEMOS-IU-EQUO",563
19,"19015",84,69,68,0,1,"PODEMOS-IU-EQUO",8
9,"9213",307,220,218,2,2,"PODEMOS-IU-EQUO",45
45,"45045",1318,905,888,5,17,"PODEMOS-IU-EQUO",112
5,"5073",297,253,252,2,1,"PODEMOS-IU-EQUO",35
30,"30040",732,617,607,2,10,"PODEMOS-IU-EQUO",74
34,"34096",55,42,42,0,0,"PODEMOS-IU-EQUO",4
24,"24080",213,164,161,3,3,"PODEMOS-IU-EQUO",23
19,"19208",43,30,30,0,0,"PODEMOS-IU-EQUO",4
45,"45148",292,223,223,0,0,"PODEMOS-IU-EQUO",10
13,"13066",2506,1971,1947,11,24,"PODEMOS-IU-EQUO",188
37,"37097",39,27,27,1,0,"PODEMOS-IU-EQUO",0
19,"19245",1155,855,835,5,20,"PODEMOS-IU-EQUO",88
39,"39086",358,256,253,0,3,"PODEMOS-IU-EQUO",29
5,"5251",60,42,42,1,0,"PODEMOS-IU-EQUO",3
37,"37069",968,695,689,7,6,"PODEMOS-IU-EQUO",89
39,"39055",1086,824,816,6,8,"PODEMOS-IU-EQUO",86
24,"24099",171,132,132,0,0,"PODEMOS-IU-EQUO",19
16,"16904",472,378,373,4,5,"PODEMOS-IU-EQUO",64
6,"6096",220,176,171,2,5,"PODEMOS-IU-EQUO",36
9,"9102",36,30,30,0,0,"PODEMOS-IU-EQUO",8
37,"37079",77,73,73,1,0,"PODEMOS-IU-EQUO",6
35,"35008",6131,4507,4459,34,48,"PODEMOS-IU-EQUO",852
19,"19037",141,115,114,1,1,"PODEMOS-IU-EQUO",13
9,"9168",290,217,217,3,0,"PODEMOS-IU-EQUO",17
6,"6137",972,744,737,1,7,"PODEMOS-IU-EQUO",68
37,"37073",586,448,438,2,10,"PODEMOS-IU-EQUO",26
42,"42026",24,20,20,0,0,"PODEMOS-IU-EQUO",2
39,"39051",66,57,57,0,0,"PODEMOS-IU-EQUO",11
5,"5083",140,110,105,1,5,"PODEMOS-IU-EQUO",6
6,"6131",1076,843,837,2,6,"PODEMOS-IU-EQUO",175
9,"9302",112,83,83,1,0,"PODEMOS-IU-EQUO",11
26,"26058",154,116,115,0,1,"PODEMOS-IU-EQUO",26
19,"19129",28,26,26,0,0,"PODEMOS-IU-EQUO",3
24,"24033",205,158,157,0,1,"PODEMOS-IU-EQUO",18
38,"38035",9474,5616,5564,36,52,"PODEMOS-IU-EQUO",802
9,"9253",109,94,91,1,3,"PODEMOS-IU-EQUO",9
24,"24146",265,210,207,1,3,"PODEMOS-IU-EQUO",17
19,"19226",43,38,38,0,0,"PODEMOS-IU-EQUO",5
19,"19066",55,48,48,0,0,"PODEMOS-IU-EQUO",7
24,"24069",41,35,35,0,0,"PODEMOS-IU-EQUO",1
37,"37265",220,181,181,0,0,"PODEMOS-IU-EQUO",15
37,"37031",361,269,266,2,3,"PODEMOS-IU-EQUO",19
37,"37353",126,97,97,1,0,"PODEMOS-IU-EQUO",9
37,"37023",1413,1072,1060,5,12,"PODEMOS-IU-EQUO",165
10,"10205",2020,1319,1293,5,26,"PODEMOS-IU-EQUO",275
6,"6141",1719,1201,1189,8,12,"PODEMOS-IU-EQUO",90
16,"16062",24,23,23,0,0,"PODEMOS-IU-EQUO",10
16,"16091",65,53,53,0,0,"PODEMOS-IU-EQUO",12
9,"9902",458,331,327,3,4,"PODEMOS-IU-EQUO",71
5,"5249",105,84,82,0,2,"PODEMOS-IU-EQUO",42
5,"5143",66,51,49,0,2,"PODEMOS-IU-EQUO",10
9,"9276",382,251,240,3,11,"PODEMOS-IU-EQUO",104
22,"22254",1124,801,792,11,9,"PODEMOS-IU-",99
22,"22243",45,28,28,0,0,"PODEMOS-IU-",0
22,"22046",728,566,561,5,5,"PODEMOS-IU-",72
22,"22217",385,287,281,1,6,"PODEMOS-IU-",34
22,"22193",276,225,224,2,1,"PODEMOS-IU-",42
22,"22039",863,671,667,4,4,"PODEMOS-IU-",176
22,"22165",487,364,360,6,4,"PODEMOS-IU-",45
22,"22218",43,33,33,0,0,"PODEMOS-IU-",4
22,"22225",2679,1700,1665,17,35,"PODEMOS-IU-",298
22,"22074",313,228,225,4,3,"PODEMOS-IU-",62
22,"22015",319,234,228,3,6,"PODEMOS-IU-",43
22,"22213",3003,2169,2131,19,38,"PODEMOS-IU-",323
22,"22903",652,514,507,1,7,"PODEMOS-IU-",76
22,"22043",93,66,65,0,1,"PODEMOS-IU-",14
22,"22149",305,228,228,0,0,"PODEMOS-IU-",44
22,"22203",83,67,67,1,0,"PODEMOS-IU-",10
22,"22251",364,284,284,0,0,"PODEMOS-IU-",22
22,"22125",38773,27021,26732,258,289,"PODEMOS-IU-",5651
22,"22078",438,319,316,3,3,"PODEMOS-IU-",109
22,"22106",22,14,14,0,0,"PODEMOS-IU-",2
22,"22909",315,226,225,4,1,"PODEMOS-IU-",35
22,"22188",82,60,59,6,1,"PODEMOS-IU-",13
22,"22084",535,403,399,4,4,"PODEMOS-IU-",98
22,"22024",226,174,171,3,3,"PODEMOS-IU-",49
22,"22164",35,28,28,0,0,"PODEMOS-IU-",3
22,"22189",185,145,144,5,1,"PODEMOS-IU-",19
22,"22230",284,216,216,1,0,"PODEMOS-IU-",45
22,"22087",67,45,45,2,0,"PODEMOS-IU-",0
22,"22102",179,141,138,2,3,"PODEMOS-IU-",25
22,"22114",123,81,81,0,0,"PODEMOS-IU-",7
22,"22086",215,161,159,1,2,"PODEMOS-IU-",40
22,"22094",101,74,74,1,0,"PODEMOS-IU-",10
22,"22105",114,78,77,2,1,"PODEMOS-IU-",14
22,"22160",209,168,168,6,0,"PODEMOS-IU-",44
22,"22052",925,712,710,8,2,"PODEMOS-IU-",108
22,"22128",188,146,144,3,2,"PODEMOS-IU-",13
22,"22042",117,95,92,0,3,"PODEMOS-IU-",17
22,"22072",191,136,135,0,1,"PODEMOS-IU-",37
22,"22025",1071,676,669,18,7,"PODEMOS-IU-",102
22,"22017",866,650,642,5,8,"PODEMOS-IU-",94
22,"22063",169,133,129,1,4,"PODEMOS-IU-",38
22,"22246",76,50,50,0,0,"PODEMOS-IU-",13
22,"22003",137,110,107,1,3,"PODEMOS-IU-",17
22,"22220",166,126,125,2,1,"PODEMOS-IU-",15
22,"22181",92,61,61,2,0,"PODEMOS-IU-",12
22,"22059",1149,807,800,3,7,"PODEMOS-IU-",200
22,"22013",288,216,210,3,6,"PODEMOS-IU-",29
22,"22115",360,257,256,3,1,"PODEMOS-IU-",38
22,"22239",88,72,72,0,0,"PODEMOS-IU-",6
22,"22045",82,65,64,1,1,"PODEMOS-IU-",14
22,"22068",79,60,60,0,0,"PODEMOS-IU-",15
22,"22050",88,77,77,0,0,"PODEMOS-IU-",5
22,"22011",88,71,69,0,2,"PODEMOS-IU-",11
22,"22133",115,81,80,1,1,"PODEMOS-IU-",14
22,"22178",103,82,81,0,1,"PODEMOS-IU-",7
22,"22195",235,182,181,3,1,"PODEMOS-IU-",31
22,"22207",125,72,71,2,1,"PODEMOS-IU-",18
22,"22099",483,379,377,4,2,"PODEMOS-IU-",61
22,"22060",1164,858,850,3,8,"PODEMOS-IU-",177
22,"22136",806,588,588,5,0,"PODEMOS-IU-",78
22,"22212",79,64,62,0,2,"PODEMOS-IU-",14
22,"22233",82,57,57,3,0,"PODEMOS-IU-",2
22,"22142",97,75,74,1,1,"PODEMOS-IU-",16
22,"22158",11995,8197,8126,62,71,"PODEMOS-IU-",1631
22,"22232",93,71,69,1,2,"PODEMOS-IU-",6
22,"22035",234,165,159,3,6,"PODEMOS-IU-",34
22,"22130",10092,6671,6608,59,63,"PODEMOS-IU-",1470
22,"22048",12598,8790,8731,91,59,"PODEMOS-IU-",1400
22,"22151",93,64,64,1,0,"PODEMOS-IU-",11
22,"22028",371,282,280,3,2,"PODEMOS-IU-",61
22,"22082",291,213,212,1,1,"PODEMOS-IU-",23
22,"22057",370,271,270,3,1,"PODEMOS-IU-",60
22,"22089",302,225,223,0,2,"PODEMOS-IU-",44
22,"22156",289,220,220,2,0,"PODEMOS-IU-",33
22,"22085",104,86,86,0,0,"PODEMOS-IU-",16
22,"22250",353,261,258,4,3,"PODEMOS-IU-",77
22,"22175",197,143,142,1,1,"PODEMOS-IU-",24
22,"22200",244,184,182,5,2,"PODEMOS-IU-",42
22,"22209",155,120,120,3,0,"PODEMOS-IU-",38
22,"22095",72,58,58,1,0,"PODEMOS-IU-",14
22,"22229",114,80,80,1,0,"PODEMOS-IU-",16
22,"22112",9566,6354,6305,56,49,"PODEMOS-IU-",1117
22,"22040",144,117,115,1,2,"PODEMOS-IU-",19
22,"22116",1430,1004,994,5,10,"PODEMOS-IU-",119
22,"22905",281,209,209,1,0,"PODEMOS-IU-",23
22,"22007",792,581,581,8,0,"PODEMOS-IU-",67
22,"22054",1542,1091,1077,13,14,"PODEMOS-IU-",280
22,"22245",309,267,261,1,6,"PODEMOS-IU-",17
22,"22111",154,103,102,0,1,"PODEMOS-IU-",9
22,"22155",76,51,51,0,0,"PODEMOS-IU-",8
22,"22249",116,95,95,4,0,"PODEMOS-IU-",26
22,"22228",514,364,360,5,4,"PODEMOS-IU-",73
22,"22055",320,243,238,2,5,"PODEMOS-IU-",24
22,"22044",252,198,197,0,1,"PODEMOS-IU-",50
22,"22253",61,52,52,0,0,"PODEMOS-IU-",8
22,"22126",88,64,64,0,0,"PODEMOS-IU-",2
22,"22206",193,129,128,1,1,"PODEMOS-IU-",26
22,"22064",166,122,121,1,1,"PODEMOS-IU-",28
22,"22009",617,444,441,6,3,"PODEMOS-IU-",114
22,"22019",180,151,150,2,1,"PODEMOS-IU-",29
22,"22081",254,181,181,0,0,"PODEMOS-IU-",15
22,"22242",62,45,44,0,1,"PODEMOS-IU-",0
22,"22162",130,102,102,0,0,"PODEMOS-IU-",5
22,"22032",110,76,74,0,2,"PODEMOS-IU-",17
22,"22016",601,413,411,6,2,"PODEMOS-IU-",82
22,"22204",1114,745,739,12,6,"PODEMOS-IU-",161
22,"22141",117,91,90,1,1,"PODEMOS-IU-",10
22,"22117",2478,1714,1693,22,21,"PODEMOS-IU-",327
22,"22036",92,77,77,0,0,"PODEMOS-IU-",9
22,"22222",530,384,379,3,5,"PODEMOS-IU-",84
22,"22163",425,360,355,0,5,"PODEMOS-IU-",60
22,"22107",112,74,74,0,0,"PODEMOS-IU-",20
22,"22079",118,83,83,1,0,"PODEMOS-IU-",8
22,"22119",1291,942,935,5,7,"PODEMOS-IU-",175
22,"22047",243,205,203,2,2,"PODEMOS-IU-",32
22,"22080",280,197,194,6,3,"PODEMOS-IU-",22
22,"22020",115,86,86,1,0,"PODEMOS-IU-",15
22,"22186",181,130,129,1,1,"PODEMOS-IU-",16
22,"22197",473,354,354,1,0,"PODEMOS-IU-",54
22,"22174",478,379,378,2,1,"PODEMOS-IU-",43
22,"22143",217,143,141,1,2,"PODEMOS-IU-",23
22,"22202",141,119,119,0,0,"PODEMOS-IU-",23
22,"22041",163,134,134,1,0,"PODEMOS-IU-",7
22,"22066",702,502,498,7,4,"PODEMOS-IU-",159
22,"22062",167,116,116,1,0,"PODEMOS-IU-",31
22,"22144",243,188,187,1,1,"PODEMOS-IU-",27
22,"22176",173,134,130,1,4,"PODEMOS-IU-",13
22,"22236",253,200,200,0,0,"PODEMOS-IU-",19
22,"22124",201,144,143,1,1,"PODEMOS-IU-",32
22,"22069",429,333,331,2,2,"PODEMOS-IU-",61
22,"22090",99,71,71,0,0,"PODEMOS-IU-",16
22,"22110",738,531,527,4,4,"PODEMOS-IU-",104
22,"22029",127,100,100,0,0,"PODEMOS-IU-",9
22,"22037",115,86,86,0,0,"PODEMOS-IU-",33
22,"22908",197,142,140,3,2,"PODEMOS-IU-",37
22,"22014",243,192,188,3,4,"PODEMOS-IU-",22
22,"22002",107,95,95,0,0,"PODEMOS-IU-",15
22,"22122",64,57,57,2,0,"PODEMOS-IU-",12
22,"22088",153,110,110,2,0,"PODEMOS-IU-",27
22,"22184",184,155,155,3,0,"PODEMOS-IU-",19
22,"22907",1435,1059,1046,18,13,"PODEMOS-IU-",246
22,"22131",82,63,63,0,0,"PODEMOS-IU-",7
22,"22067",65,50,50,1,0,"PODEMOS-IU-",12
22,"22226",767,570,562,10,8,"PODEMOS-IU-",77
22,"22244",52,38,37,0,1,"PODEMOS-IU-",8
22,"22173",232,152,152,3,0,"PODEMOS-IU-",47
22,"22177",98,75,75,0,0,"PODEMOS-IU-",9
22,"22227",206,163,160,3,3,"PODEMOS-IU-",24
22,"22058",194,164,162,1,2,"PODEMOS-IU-",40
22,"22139",79,64,64,1,0,"PODEMOS-IU-",11
22,"22214",128,106,105,3,1,"PODEMOS-IU-",14
22,"22248",116,92,90,1,2,"PODEMOS-IU-",14
22,"22170",651,498,491,5,7,"PODEMOS-IU-",123
22,"22234",794,552,544,3,8,"PODEMOS-IU-",67
22,"22096",301,240,240,0,0,"PODEMOS-IU-",47
22,"22049",78,64,64,0,0,"PODEMOS-IU-",6
22,"22021",1971,1414,1398,17,16,"PODEMOS-IU-",222
22,"22201",266,188,187,3,1,"PODEMOS-IU-",32
22,"22053",789,520,513,9,7,"PODEMOS-IU-",94
22,"22157",192,129,128,3,1,"PODEMOS-IU-",21
22,"22215",128,96,96,1,0,"PODEMOS-IU-",17
22,"22103",682,508,502,3,6,"PODEMOS-IU-",79
22,"22205",438,322,320,0,2,"PODEMOS-IU-",54
22,"22061",6630,4555,4526,40,29,"PODEMOS-IU-",813
22,"22902",221,159,156,0,3,"PODEMOS-IU-",30
22,"22235",98,76,76,1,0,"PODEMOS-IU-",5
22,"22199",7000,4737,4688,104,49,"PODEMOS-IU-",1034
22,"22077",379,279,273,2,6,"PODEMOS-IU-",31
22,"22252",121,86,81,0,5,"PODEMOS-IU-",11
22,"22223",75,58,58,0,0,"PODEMOS-IU-",22
22,"22187",293,218,216,2,2,"PODEMOS-IU-",64
22,"22127",505,374,371,3,3,"PODEMOS-IU-",78
22,"22012",111,87,86,3,1,"PODEMOS-IU-",11
22,"22027",329,221,218,0,3,"PODEMOS-IU-",28
22,"22083",463,394,390,5,4,"PODEMOS-IU-",42
22,"22008",173,137,133,3,4,"PODEMOS-IU-",20
22,"22901",742,478,470,5,8,"PODEMOS-IU-",131
22,"22076",311,201,199,0,2,"PODEMOS-IU-",39
22,"22221",84,58,58,0,0,"PODEMOS-IU-",16
22,"22075",125,83,83,1,0,"PODEMOS-IU-",18
22,"22022",552,414,408,6,6,"PODEMOS-IU-",74
22,"22018",327,245,244,3,1,"PODEMOS-IU-",43
22,"22051",100,81,81,0,0,"PODEMOS-IU-",13
22,"22208",188,150,145,0,5,"PODEMOS-IU-",52
22,"22247",33,20,20,0,0,"PODEMOS-IU-",5
22,"22023",421,313,309,6,4,"PODEMOS-IU-",29
22,"22904",815,579,575,8,4,"PODEMOS-IU-",97
22,"22167",493,388,381,9,7,"PODEMOS-IU-",57
22,"22006",298,204,204,5,0,"PODEMOS-IU-",60
22,"22150",472,331,330,1,1,"PODEMOS-IU-",79
22,"22906",186,141,139,3,2,"PODEMOS-IU-",24
22,"22001",225,151,151,1,0,"PODEMOS-IU-",14
22,"22190",119,86,85,0,1,"PODEMOS-IU-",21
22,"22137",1069,727,718,3,9,"PODEMOS-IU-",100
22,"22135",189,128,127,0,1,"PODEMOS-IU-",21
22,"22004",135,81,80,0,1,"PODEMOS-IU-",18
22,"22168",23,18,18,0,0,"PODEMOS-IU-",3
22,"22129",183,120,118,1,2,"PODEMOS-IU-",13
22,"22113",495,370,368,4,2,"PODEMOS-IU-",71
22,"22172",556,372,370,6,2,"PODEMOS-IU-",35
22,"22109",261,191,190,1,1,"PODEMOS-IU-",36
22,"22182",250,161,158,1,3,"PODEMOS-IU-",37
50,"50146",187,145,144,3,1,"PODEMOS-IU-",21
50,"50199",334,244,242,3,2,"PODEMOS-IU-",35
44,"44023",17,16,16,0,0,"PODEMOS-IU-",0
44,"44052",77,56,56,0,0,"PODEMOS-IU-",7
50,"50042",15,15,15,1,0,"PODEMOS-IU-",0
50,"50190",695,523,515,3,8,"PODEMOS-IU-",63
50,"50128",26,25,25,1,0,"PODEMOS-IU-",5
50,"50178",293,190,187,0,3,"PODEMOS-IU-",28
44,"44008",1613,1163,1153,6,10,"PODEMOS-IU-",169
50,"50142",26,17,17,0,0,"PODEMOS-IU-",10
44,"44136",49,43,43,1,0,"PODEMOS-IU-",1
44,"44126",329,234,229,4,5,"PODEMOS-IU-",44
50,"50028",78,51,51,0,0,"PODEMOS-IU-",9
50,"50084",77,59,59,2,0,"PODEMOS-IU-",7
44,"44229",152,112,111,3,1,"PODEMOS-IU-",29
44,"44238",2323,1603,1590,5,13,"PODEMOS-IU-",272
50,"50183",331,246,246,3,0,"PODEMOS-IU-",18
50,"50252",5138,3642,3611,24,31,"PODEMOS-IU-",466
50,"50201",448,339,335,7,4,"PODEMOS-IU-",40
44,"44019",67,50,49,0,1,"PODEMOS-IU-",2
44,"44151",190,151,148,0,3,"PODEMOS-IU-",40
44,"44016",482,363,360,2,3,"PODEMOS-IU-",32
44,"44007",173,122,121,4,1,"PODEMOS-IU-",3
44,"44085",52,35,35,0,0,"PODEMOS-IU-",0
44,"44004",408,303,297,0,6,"PODEMOS-IU-",83
44,"44154",256,192,188,3,4,"PODEMOS-IU-",32
50,"50211",249,176,173,0,3,"PODEMOS-IU-",11
44,"44231",38,33,33,0,0,"PODEMOS-IU-",10
50,"50143",566,394,391,6,3,"PODEMOS-IU-",64
50,"50055",3611,2445,2407,22,38,"PODEMOS-IU-",428
44,"44042",123,91,90,0,1,"PODEMOS-IU-",9
50,"50040",89,75,75,0,0,"PODEMOS-IU-",7
50,"50270",38,26,26,0,0,"PODEMOS-IU-",8
50,"50088",302,246,237,5,9,"PODEMOS-IU-",17
50,"50267",602,433,430,8,3,"PODEMOS-IU-",64
50,"50106",134,104,104,0,0,"PODEMOS-IU-",13
44,"44219",194,145,143,1,2,"PODEMOS-IU-",19
44,"44177",115,84,84,1,0,"PODEMOS-IU-",14
50,"50165",1814,1287,1264,26,23,"PODEMOS-IU-",267
50,"50205",90,63,61,0,2,"PODEMOS-IU-",5
50,"50098",174,130,124,0,6,"PODEMOS-IU-",14
50,"50108",48,38,38,0,0,"PODEMOS-IU-",5
50,"50021",30,21,21,0,0,"PODEMOS-IU-",2
44,"44046",49,34,34,1,0,"PODEMOS-IU-",3
50,"50173",182,132,131,1,1,"PODEMOS-IU-",20
50,"50187",69,44,44,0,0,"PODEMOS-IU-",13
44,"44222",131,98,98,0,0,"PODEMOS-IU-",8
50,"50214",27,18,17,0,1,"PODEMOS-IU-",4
44,"44264",248,191,189,1,2,"PODEMOS-IU-",32
44,"44201",495,411,406,0,5,"PODEMOS-IU-",82
44,"44155",1090,793,782,4,11,"PODEMOS-IU-",191
44,"44143",380,307,306,2,1,"PODEMOS-IU-",29
50,"50278",197,145,145,0,0,"PODEMOS-IU-",14
44,"44110",49,42,42,1,0,"PODEMOS-IU-",0
44,"44108",320,222,222,1,0,"PODEMOS-IU-",47
44,"44260",137,91,89,3,2,"PODEMOS-IU-",10
50,"50133",113,80,80,4,0,"PODEMOS-IU-",15
50,"50168",28,27,27,0,0,"PODEMOS-IU-",6
44,"44006",248,185,183,2,2,"PODEMOS-IU-",24
50,"50102",859,658,653,8,5,"PODEMOS-IU-",114
44,"44064",69,49,49,0,0,"PODEMOS-IU-",5
50,"50237",101,74,73,1,1,"PODEMOS-IU-",15
44,"44062",34,25,22,0,3,"PODEMOS-IU-",0
50,"50194",88,63,63,1,0,"PODEMOS-IU-",6
50,"50239",62,50,48,0,2,"PODEMOS-IU-",3
50,"50048",34,29,29,0,0,"PODEMOS-IU-",8
50,"50079",249,175,174,0,1,"PODEMOS-IU-",23
44,"44147",412,298,293,5,5,"PODEMOS-IU-",52
44,"44075",323,248,246,0,2,"PODEMOS-IU-",19
50,"50196",107,87,86,0,1,"PODEMOS-IU-",17
44,"44252",86,65,65,0,0,"PODEMOS-IU-",5
44,"44145",1020,719,709,9,10,"PODEMOS-IU-",130
44,"44103",132,102,102,1,0,"PODEMOS-IU-",11
50,"50066",2621,1862,1851,9,11,"PODEMOS-IU-",399
50,"50164",390,247,246,6,1,"PODEMOS-IU-",39
44,"44217",29,25,25,3,0,"PODEMOS-IU-",2
44,"44194",109,78,73,3,5,"PODEMOS-IU-",13
50,"50253",423,330,328,4,2,"PODEMOS-IU-",30
50,"50081",511,382,378,4,4,"PODEMOS-IU-",49
44,"44121",60,47,47,2,0,"PODEMOS-IU-",6
44,"44167",38,31,31,0,0,"PODEMOS-IU-",5
44,"44263",376,266,263,3,3,"PODEMOS-IU-",52
50,"50030",215,141,140,1,1,"PODEMOS-IU-",33
44,"44227",74,63,62,0,1,"PODEMOS-IU-",2
44,"44080",292,229,223,3,6,"PODEMOS-IU-",56
44,"44017",285,227,223,4,4,"PODEMOS-IU-",30
44,"44112",429,290,290,2,0,"PODEMOS-IU-",45
50,"50005",229,189,189,1,0,"PODEMOS-IU-",12
50,"50169",351,269,265,0,4,"PODEMOS-IU-",42
50,"50007",45,34,34,1,0,"PODEMOS-IU-",8
44,"44213",62,50,50,0,0,"PODEMOS-IU-",2
44,"44011",52,40,38,0,2,"PODEMOS-IU-",5
44,"44043",102,74,72,0,2,"PODEMOS-IU-",10
50,"50265",79,61,61,0,0,"PODEMOS-IU-",16
44,"44099",709,465,462,3,3,"PODEMOS-IU-",86
50,"50072",170,125,125,0,0,"PODEMOS-IU-",14
50,"50006",925,674,657,6,17,"PODEMOS-IU-",100
44,"44029",559,425,424,5,1,"PODEMOS-IU-",54
50,"50276",125,104,103,2,1,"PODEMOS-IU-",11
50,"50192",236,180,180,2,0,"PODEMOS-IU-",20
44,"44063",71,54,54,0,0,"PODEMOS-IU-",14
44,"44148",90,75,73,2,2,"PODEMOS-IU-",6
50,"50170",371,283,280,0,3,"PODEMOS-IU-",17
44,"44240",158,130,129,0,1,"PODEMOS-IU-",11
50,"50272",12904,8880,8819,84,61,"PODEMOS-IU-",1938
50,"50200",511,410,403,2,7,"PODEMOS-IU-",56
50,"50002",143,108,104,1,4,"PODEMOS-IU-",1
44,"44082",89,78,77,0,1,"PODEMOS-IU-",9
50,"50182",3399,2364,2335,21,29,"PODEMOS-IU-",478
50,"50157",290,220,218,3,2,"PODEMOS-IU-",37
50,"50035",72,54,53,1,1,"PODEMOS-IU-",44
50,"50070",60,36,36,0,0,"PODEMOS-IU-",1
44,"44250",19,12,12,0,0,"PODEMOS-IU-",2
50,"50233",106,81,81,0,0,"PODEMOS-IU-",4
44,"44241",533,396,389,0,7,"PODEMOS-IU-",65
44,"44088",29,21,21,0,0,"PODEMOS-IU-",0
44,"44013",11244,7815,7712,82,103,"PODEMOS-IU-",1485
44,"44105",82,64,64,0,0,"PODEMOS-IU-",14
44,"44181",76,57,56,0,1,"PODEMOS-IU-",3
50,"50227",109,79,79,0,0,"PODEMOS-IU-",13
50,"50222",1622,1091,1071,7,20,"PODEMOS-IU-",125
50,"50140",166,115,115,0,0,"PODEMOS-IU-",18
50,"50286",77,50,50,3,0,"PODEMOS-IU-",6
50,"50185",133,108,108,1,0,"PODEMOS-IU-",46
50,"50218",113,91,91,1,0,"PODEMOS-IU-",9
44,"44133",21,15,15,0,0,"PODEMOS-IU-",0
50,"50037",136,98,96,0,2,"PODEMOS-IU-",8
50,"50193",651,514,501,2,13,"PODEMOS-IU-",119
44,"44150",28,22,21,0,1,"PODEMOS-IU-",3
50,"50076",78,66,65,0,1,"PODEMOS-IU-",18
50,"50034",826,567,563,5,4,"PODEMOS-IU-",92
44,"44262",135,108,107,2,1,"PODEMOS-IU-",8
44,"44086",449,342,336,3,6,"PODEMOS-IU-",71
44,"44258",67,47,47,0,0,"PODEMOS-IU-",4
44,"44127",68,51,51,0,0,"PODEMOS-IU-",11
50,"50244",201,162,161,1,1,"PODEMOS-IU-",15
50,"50017",1773,1276,1269,13,7,"PODEMOS-IU-",276
50,"50089",8225,6074,6043,43,31,"PODEMOS-IU-",1155
44,"44005",50,30,30,0,0,"PODEMOS-IU-",0
50,"50063",61,51,51,0,0,"PODEMOS-IU-",3
50,"50221",35,17,17,0,0,"PODEMOS-IU-",0
50,"50163",3689,2702,2680,37,22,"PODEMOS-IU-",603
50,"50141",109,90,90,1,0,"PODEMOS-IU-",14
50,"50259",88,67,66,0,1,"PODEMOS-IU-",2
50,"50204",2436,1785,1770,3,15,"PODEMOS-IU-",325
44,"44211",42,35,35,0,0,"PODEMOS-IU-",7
44,"44031",97,62,62,0,0,"PODEMOS-IU-",2
44,"44038",104,83,82,0,1,"PODEMOS-IU-",10
50,"50118",2165,1552,1540,10,12,"PODEMOS-IU-",234
44,"44055",69,56,56,4,0,"PODEMOS-IU-",4
50,"50903",2214,1602,1585,8,17,"PODEMOS-IU-",387
50,"50247",823,588,581,3,7,"PODEMOS-IU-",69
50,"50273",30,22,22,0,0,"PODEMOS-IU-",1
44,"44060",41,32,32,0,0,"PODEMOS-IU-",5
50,"50036",104,91,90,0,1,"PODEMOS-IU-",16
50,"50202",152,100,99,1,1,"PODEMOS-IU-",7
44,"44101",58,46,46,2,0,"PODEMOS-IU-",4
44,"44179",337,229,226,1,3,"PODEMOS-IU-",48
50,"50136",575,414,410,2,4,"PODEMOS-IU-",25
44,"44137",193,149,148,0,1,"PODEMOS-IU-",13
44,"44224",22,14,14,0,0,"PODEMOS-IU-",0
50,"50068",1982,1348,1335,8,13,"PODEMOS-IU-",191
50,"50111",180,143,143,0,0,"PODEMOS-IU-",35
44,"44182",197,157,157,0,0,"PODEMOS-IU-",12
44,"44164",27,23,23,0,0,"PODEMOS-IU-",4
44,"44268",25,25,24,0,1,"PODEMOS-IU-",2
50,"50044",230,145,145,1,0,"PODEMOS-IU-",20
50,"50258",54,34,34,0,0,"PODEMOS-IU-",3
50,"50096",39,27,27,0,0,"PODEMOS-IU-",8
50,"50100",329,246,241,1,5,"PODEMOS-IU-",26
50,"50288",3387,2415,2398,31,17,"PODEMOS-IU-",384
44,"44047",220,137,132,2,5,"PODEMOS-IU-",18
50,"50228",268,210,208,5,2,"PODEMOS-IU-",9
50,"50268",44,37,37,0,0,"PODEMOS-IU-",11
44,"44089",45,39,39,1,0,"PODEMOS-IU-",4
50,"50116",182,136,132,0,4,"PODEMOS-IU-",21
44,"44014",2521,1896,1867,8,29,"PODEMOS-IU-",451
50,"50041",12,9,9,0,0,"PODEMOS-IU-",1
44,"44114",243,178,173,0,5,"PODEMOS-IU-",28
50,"50255",209,163,163,5,0,"PODEMOS-IU-",15
50,"50045",1243,926,925,6,1,"PODEMOS-IU-",119
44,"44171",178,126,124,2,2,"PODEMOS-IU-",67
50,"50101",864,603,597,8,6,"PODEMOS-IU-",95
44,"44185",99,76,75,0,1,"PODEMOS-IU-",11
44,"44226",140,98,98,2,0,"PODEMOS-IU-",18
50,"50262",1170,896,887,15,9,"PODEMOS-IU-",210
44,"44054",108,85,85,2,0,"PODEMOS-IU-",14
44,"44249",55,44,44,2,0,"PODEMOS-IU-",5
50,"50290",386,283,282,1,1,"PODEMOS-IU-",44
50,"50215",24,19,19,0,0,"PODEMOS-IU-",10
50,"50150",649,402,397,2,5,"PODEMOS-IU-",47
44,"44119",130,92,91,3,1,"PODEMOS-IU-",23
50,"50026",439,335,325,10,10,"PODEMOS-IU-",53
50,"50091",41,36,36,0,0,"PODEMOS-IU-",2
50,"50188",28,25,25,0,0,"PODEMOS-IU-",1
50,"50174",91,69,68,0,1,"PODEMOS-IU-",5
44,"44220",121,84,83,1,1,"PODEMOS-IU-",9
44,"44256",38,34,34,0,0,"PODEMOS-IU-",3
50,"50046",178,133,133,5,0,"PODEMOS-IU-",11
44,"44003",19,17,17,0,0,"PODEMOS-IU-",1
50,"50240",1025,729,718,10,11,"PODEMOS-IU-",114
50,"50020",809,564,559,2,5,"PODEMOS-IU-",80
50,"50047",48,36,36,0,0,"PODEMOS-IU-",5
44,"44146",174,153,152,2,1,"PODEMOS-IU-",9
50,"50016",52,40,40,0,0,"PODEMOS-IU-",8
44,"44135",113,88,87,0,1,"PODEMOS-IU-",7
44,"44218",35,28,28,1,0,"PODEMOS-IU-",2
50,"50257",171,134,134,2,0,"PODEMOS-IU-",23
50,"50179",249,214,213,2,1,"PODEMOS-IU-",17
44,"44251",254,198,191,1,7,"PODEMOS-IU-",5
50,"50261",213,157,157,0,0,"PODEMOS-IU-",43
50,"50105",296,214,211,1,3,"PODEMOS-IU-",36
44,"44033",269,191,190,0,1,"PODEMOS-IU-",22
44,"44184",45,34,34,0,0,"PODEMOS-IU-",2
44,"44207",156,118,115,4,3,"PODEMOS-IU-",20
50,"50160",2238,1546,1528,12,18,"PODEMOS-IU-",289
44,"44165",175,135,133,2,2,"PODEMOS-IU-",12
44,"44044",88,72,71,2,1,"PODEMOS-IU-",3
50,"50038",1502,1121,1111,7,10,"PODEMOS-IU-",189
50,"50134",128,91,89,2,2,"PODEMOS-IU-",3
44,"44066",108,79,74,0,5,"PODEMOS-IU-",10
50,"50149",34,24,24,0,0,"PODEMOS-IU-",0
50,"50131",231,167,165,0,2,"PODEMOS-IU-",13
50,"50093",92,66,66,1,0,"PODEMOS-IU-",14
44,"44087",80,69,67,1,2,"PODEMOS-IU-",7
50,"50235",2339,1664,1648,11,16,"PODEMOS-IU-",348
50,"50138",46,37,37,2,0,"PODEMOS-IU-",6
44,"44002",47,40,40,0,0,"PODEMOS-IU-",13
50,"50181",993,733,720,5,13,"PODEMOS-IU-",140
50,"50153",935,713,708,6,5,"PODEMOS-IU-",116
50,"50225",1570,956,950,3,6,"PODEMOS-IU-",105
50,"50054",58,50,50,0,0,"PODEMOS-IU-",10
50,"50064",437,342,339,0,3,"PODEMOS-IU-",39
44,"44096",161,138,135,3,3,"PODEMOS-IU-",33
50,"50260",33,33,32,0,1,"PODEMOS-IU-",4
44,"44024",27,25,25,0,0,"PODEMOS-IU-",0
44,"44191",764,586,583,6,3,"PODEMOS-IU-",183
50,"50175",1002,695,688,5,7,"PODEMOS-IU-",129
50,"50139",313,241,239,3,2,"PODEMOS-IU-",25
44,"44045",366,274,269,2,5,"PODEMOS-IU-",42
50,"50264",156,115,115,0,0,"PODEMOS-IU-",19
50,"50023",224,175,175,0,0,"PODEMOS-IU-",15
50,"50151",636,499,499,0,0,"PODEMOS-IU-",54
44,"44257",166,123,119,1,4,"PODEMOS-IU-",14
50,"50130",383,240,238,2,2,"PODEMOS-IU-",26
44,"44028",183,151,150,4,1,"PODEMOS-IU-",12
50,"50219",4119,2833,2804,19,29,"PODEMOS-IU-",651
50,"50065",53,43,43,0,0,"PODEMOS-IU-",12
44,"44130",34,24,24,0,0,"PODEMOS-IU-",1
50,"50295",48,43,42,0,1,"PODEMOS-IU-",5
50,"50285",644,436,434,2,2,"PODEMOS-IU-",59
44,"44199",44,41,41,2,0,"PODEMOS-IU-",4
50,"50155",103,80,78,0,2,"PODEMOS-IU-",4
50,"50176",236,165,165,3,0,"PODEMOS-IU-",14
50,"50052",90,68,68,0,0,"PODEMOS-IU-",2
44,"44022",493,323,318,7,5,"PODEMOS-IU-",65
44,"44100",185,153,151,0,2,"PODEMOS-IU-",41
50,"50220",40,32,32,0,0,"PODEMOS-IU-",8
44,"44161",443,314,313,2,1,"PODEMOS-IU-",37
44,"44144",346,248,245,2,3,"PODEMOS-IU-",33
50,"50014",147,94,94,0,0,"PODEMOS-IU-",24
50,"50113",618,489,484,2,5,"PODEMOS-IU-",60
50,"50180",119,99,99,2,0,"PODEMOS-IU-",22
50,"50242",93,75,75,3,0,"PODEMOS-IU-",19
50,"50083",89,75,75,1,0,"PODEMOS-IU-",19
44,"44115",102,90,90,3,0,"PODEMOS-IU-",27
50,"50120",52,40,40,1,0,"PODEMOS-IU-",7
44,"44012",334,263,261,5,2,"PODEMOS-IU-",39
44,"44035",113,90,88,1,2,"PODEMOS-IU-",6
44,"44212",39,37,37,1,0,"PODEMOS-IU-",3
50,"50287",270,191,191,0,0,"PODEMOS-IU-",30
44,"44245",248,179,176,2,3,"PODEMOS-IU-",19
50,"50191",470,310,308,1,2,"PODEMOS-IU-",41
50,"50121",277,216,214,1,2,"PODEMOS-IU-",20
44,"44122",1333,925,913,8,12,"PODEMOS-IU-",159
50,"50263",193,121,121,0,0,"PODEMOS-IU-",18
44,"44123",105,71,70,1,1,"PODEMOS-IU-",12
44,"44168",189,139,138,2,1,"PODEMOS-IU-",13
44,"44156",45,31,31,1,0,"PODEMOS-IU-",1
44,"44235",92,62,60,0,2,"PODEMOS-IU-",9
50,"50078",235,177,173,0,4,"PODEMOS-IU-",30
50,"50122",68,52,52,1,0,"PODEMOS-IU-",9
44,"44169",342,252,252,3,0,"PODEMOS-IU-",32
50,"50003",128,92,91,1,1,"PODEMOS-IU-",6
50,"50095",12323,8628,8550,110,78,"PODEMOS-IU-",1500
50,"50186",42,31,31,0,0,"PODEMOS-IU-",8
44,"44039",221,165,159,0,6,"PODEMOS-IU-",6
44,"44180",70,61,61,0,0,"PODEMOS-IU-",1
44,"44113",71,52,52,0,0,"PODEMOS-IU-",35
44,"44225",107,74,74,1,0,"PODEMOS-IU-",21
44,"44065",60,40,40,0,0,"PODEMOS-IU-",3
44,"44094",113,94,94,0,0,"PODEMOS-IU-",5
50,"50056",409,300,300,3,0,"PODEMOS-IU-",69
50,"50245",88,65,64,0,1,"PODEMOS-IU-",12
50,"50148",316,233,229,4,4,"PODEMOS-IU-",26
44,"44037",453,317,315,0,2,"PODEMOS-IU-",76
50,"50275",108,55,55,0,0,"PODEMOS-IU-",5
50,"50279",86,64,64,0,0,"PODEMOS-IU-",5
44,"44124",77,64,64,3,0,"PODEMOS-IU-",12
50,"50073",2141,1592,1577,7,15,"PODEMOS-IU-",219
50,"50217",446,342,342,1,0,"PODEMOS-IU-",20
50,"50289",51,38,38,0,0,"PODEMOS-IU-",3
50,"50296",396,286,275,4,11,"PODEMOS-IU-",64
44,"44190",71,58,56,0,2,"PODEMOS-IU-",4
50,"50080",33,27,27,0,0,"PODEMOS-IU-",10
50,"50269",285,193,188,0,5,"PODEMOS-IU-",16
50,"50077",221,168,167,1,1,"PODEMOS-IU-",20
50,"50015",96,67,67,0,0,"PODEMOS-IU-",5
44,"44125",61,44,44,0,0,"PODEMOS-IU-",4
50,"50019",55,41,41,0,0,"PODEMOS-IU-",3
50,"50061",202,172,172,3,0,"PODEMOS-IU-",13
50,"50236",102,79,77,0,2,"PODEMOS-IU-",3
50,"50114",116,89,88,0,1,"PODEMOS-IU-",15
50,"50161",106,75,72,0,3,"PODEMOS-IU-",7
50,"50171",106,79,79,0,0,"PODEMOS-IU-",2
44,"44163",126,94,94,1,0,"PODEMOS-IU-",16
50,"50107",947,738,733,4,5,"PODEMOS-IU-",82
50,"50230",1165,833,828,8,5,"PODEMOS-IU-",118
44,"44077",74,60,58,0,2,"PODEMOS-IU-",8
44,"44032",16,11,11,0,0,"PODEMOS-IU-",0
50,"50115",3235,2128,2109,14,19,"PODEMOS-IU-",263
44,"44053",105,78,78,0,0,"PODEMOS-IU-",1
50,"50216",235,186,184,5,2,"PODEMOS-IU-",16
44,"44192",355,280,278,4,2,"PODEMOS-IU-",30
50,"50241",588,415,410,4,5,"PODEMOS-IU-",35
44,"44183",77,50,49,0,1,"PODEMOS-IU-",6
44,"44195",88,60,60,1,0,"PODEMOS-IU-",6
44,"44160",466,304,301,2,3,"PODEMOS-IU-",47
44,"44107",218,152,152,5,0,"PODEMOS-IU-",27
50,"50234",243,189,185,6,4,"PODEMOS-IU-",24
44,"44157",64,48,48,1,0,"PODEMOS-IU-",7
44,"44117",340,271,268,4,3,"PODEMOS-IU-",38
44,"44266",115,90,90,0,0,"PODEMOS-IU-",4
50,"50203",1040,748,739,7,9,"PODEMOS-IU-",184
44,"44174",428,307,304,3,3,"PODEMOS-IU-",27
44,"44090",78,53,53,0,0,"PODEMOS-IU-",4
44,"44001",68,53,52,1,1,"PODEMOS-IU-",10
50,"50282",69,54,54,0,0,"PODEMOS-IU-",6
50,"50090",150,113,112,0,1,"PODEMOS-IU-",6
50,"50031",154,93,93,0,0,"PODEMOS-IU-",18
50,"50001",100,77,77,0,0,"PODEMOS-IU-",6
44,"44084",54,41,41,0,0,"PODEMOS-IU-",2
50,"50053",687,513,510,2,3,"PODEMOS-IU-",36
44,"44128",68,54,54,1,0,"PODEMOS-IU-",5
50,"50008",5097,3457,3417,31,40,"PODEMOS-IU-",910
44,"44175",122,85,84,1,1,"PODEMOS-IU-",11
50,"50293",413,276,275,4,1,"PODEMOS-IU-",60
44,"44118",164,132,131,2,1,"PODEMOS-IU-",6
50,"50117",126,104,103,1,1,"PODEMOS-IU-",17
44,"44197",56,36,36,0,0,"PODEMOS-IU-",5
44,"44216",26555,18997,18737,168,260,"PODEMOS-IU-",3069
50,"50132",751,543,536,0,7,"PODEMOS-IU-",116
50,"50249",302,226,220,0,6,"PODEMOS-IU-",17
50,"50266",122,90,90,0,0,"PODEMOS-IU-",5
44,"44152",64,46,45,0,1,"PODEMOS-IU-",1
44,"44267",70,57,56,0,1,"PODEMOS-IU-",4
50,"50129",235,161,158,2,3,"PODEMOS-IU-",22
50,"50033",66,49,48,0,1,"PODEMOS-IU-",14
50,"50212",40,36,36,0,0,"PODEMOS-IU-",6
50,"50075",80,62,61,1,1,"PODEMOS-IU-",0
50,"50223",920,712,701,4,11,"PODEMOS-IU-",88
44,"44198",182,147,146,4,1,"PODEMOS-IU-",8
50,"50213",94,75,74,0,1,"PODEMOS-IU-",4
44,"44173",101,81,79,2,2,"PODEMOS-IU-",18
44,"44210",746,554,545,3,9,"PODEMOS-IU-",91
50,"50274",71,55,55,0,0,"PODEMOS-IU-",8
44,"44036",25,21,21,0,0,"PODEMOS-IU-",1
44,"44025",6009,4087,3997,25,90,"PODEMOS-IU-",955
50,"50024",571,437,437,6,0,"PODEMOS-IU-",52
50,"50166",255,208,206,2,2,"PODEMOS-IU-",44
50,"50062",1829,1304,1290,16,14,"PODEMOS-IU-",265
50,"50092",299,233,231,0,2,"PODEMOS-IU-",18
44,"44070",53,48,48,0,0,"PODEMOS-IU-",4
50,"50210",38,30,30,1,0,"PODEMOS-IU-",3
44,"44059",544,425,412,9,13,"PODEMOS-IU-",38
50,"50137",1011,772,764,8,8,"PODEMOS-IU-",95
44,"44244",75,47,47,1,0,"PODEMOS-IU-",4
44,"44076",2203,1690,1663,18,27,"PODEMOS-IU-",261
50,"50292",125,102,102,1,0,"PODEMOS-IU-",6
50,"50167",233,183,178,1,5,"PODEMOS-IU-",25
50,"50018",953,656,655,1,1,"PODEMOS-IU-",57
50,"50207",106,93,93,1,0,"PODEMOS-IU-",17
50,"50094",1617,1173,1159,12,14,"PODEMOS-IU-",165
50,"50087",26,17,17,1,0,"PODEMOS-IU-",2
50,"50184",115,85,85,0,0,"PODEMOS-IU-",12
44,"44200",39,26,26,0,0,"PODEMOS-IU-",0
44,"44071",591,398,398,5,0,"PODEMOS-IU-",92
50,"50256",83,53,53,0,0,"PODEMOS-IU-",3
50,"50057",1395,919,907,11,12,"PODEMOS-IU-",93
44,"44178",58,37,37,0,0,"PODEMOS-IU-",2
44,"44142",35,27,27,0,0,"PODEMOS-IU-",3
44,"44092",81,59,57,0,2,"PODEMOS-IU-",12
44,"44237",398,304,301,4,3,"PODEMOS-IU-",31
50,"50283",70,57,57,1,0,"PODEMOS-IU-",6
50,"50231",250,195,192,4,3,"PODEMOS-IU-",25
44,"44239",22,20,20,0,0,"PODEMOS-IU-",5
44,"44018",19,19,19,0,0,"PODEMOS-IU-",0
50,"50099",3083,2148,2132,13,16,"PODEMOS-IU-",266
50,"50154",116,96,96,0,0,"PODEMOS-IU-",5
50,"50277",50,42,41,0,1,"PODEMOS-IU-",7
50,"50250",52,44,44,0,0,"PODEMOS-IU-",11
50,"50206",460,363,357,4,6,"PODEMOS-IU-",62
44,"44187",201,152,149,4,3,"PODEMOS-IU-",16
44,"44203",10,10,10,0,0,"PODEMOS-IU-",0
50,"50027",225,178,177,2,1,"PODEMOS-IU-",22
50,"50271",252,200,197,2,3,"PODEMOS-IU-",14
50,"50284",141,107,104,0,3,"PODEMOS-IU-",15
44,"44056",501,345,342,2,3,"PODEMOS-IU-",35
50,"50162",146,109,105,4,4,"PODEMOS-IU-",7
44,"44247",316,218,215,3,3,"PODEMOS-IU-",42
50,"50238",91,66,66,1,0,"PODEMOS-IU-",12
50,"50902",87,79,79,2,0,"PODEMOS-IU-",4
44,"44131",25,20,20,0,0,"PODEMOS-IU-",7
50,"50069",73,53,53,1,0,"PODEMOS-IU-",8
44,"44232",378,284,276,6,8,"PODEMOS-IU-",28
50,"50297",498961,362043,359558,2748,2485,"PODEMOS-IU-",78527
44,"44034",139,109,108,0,1,"PODEMOS-IU-",11
50,"50144",34,29,29,2,0,"PODEMOS-IU-",5
44,"44141",135,97,96,1,1,"PODEMOS-IU-",19
44,"44061",70,54,51,0,3,"PODEMOS-IU-",8
44,"44116",83,60,60,1,0,"PODEMOS-IU-",4
50,"50022",530,397,390,7,7,"PODEMOS-IU-",25
50,"50013",219,180,180,0,0,"PODEMOS-IU-",24
50,"50198",54,41,41,1,0,"PODEMOS-IU-",2
50,"50197",90,67,67,2,0,"PODEMOS-IU-",2
50,"50208",1774,1207,1195,10,12,"PODEMOS-IU-",177
50,"50039",491,392,390,2,2,"PODEMOS-IU-",88
50,"50124",415,318,317,2,1,"PODEMOS-IU-",16
50,"50135",91,70,70,3,0,"PODEMOS-IU-",13
44,"44027",164,123,123,1,0,"PODEMOS-IU-",22
44,"44208",37,22,22,0,0,"PODEMOS-IU-",2
44,"44265",186,141,138,2,3,"PODEMOS-IU-",7
50,"50074",6366,4230,4165,31,65,"PODEMOS-IU-",751
44,"44010",175,130,128,1,2,"PODEMOS-IU-",22
44,"44243",24,20,20,0,0,"PODEMOS-IU-",2
44,"44228",100,82,82,0,0,"PODEMOS-IU-",5
44,"44221",372,303,300,1,3,"PODEMOS-IU-",63
50,"50243",331,250,246,0,4,"PODEMOS-IU-",12
50,"50009",105,80,80,0,0,"PODEMOS-IU-",5
50,"50051",816,616,614,2,2,"PODEMOS-IU-",36
50,"50043",253,171,171,0,0,"PODEMOS-IU-",24
44,"44149",103,78,78,3,0,"PODEMOS-IU-",13
44,"44074",429,333,326,4,7,"PODEMOS-IU-",16
50,"50082",82,65,64,0,1,"PODEMOS-IU-",6
44,"44204",24,21,21,0,0,"PODEMOS-IU-",3
44,"44093",80,66,66,0,0,"PODEMOS-IU-",14
50,"50281",73,51,50,0,1,"PODEMOS-IU-",4
44,"44176",158,115,114,0,1,"PODEMOS-IU-",13
50,"50032",261,189,189,5,0,"PODEMOS-IU-",41
50,"50172",193,132,129,1,3,"PODEMOS-IU-",15
50,"50189",705,527,519,13,8,"PODEMOS-IU-",83
44,"44138",135,98,94,0,4,"PODEMOS-IU-",11
50,"50126",2371,1573,1559,19,14,"PODEMOS-IU-",150
50,"50232",175,110,110,3,0,"PODEMOS-IU-",30
44,"44193",78,54,54,1,0,"PODEMOS-IU-",10
50,"50029",626,450,450,3,0,"PODEMOS-IU-",47
50,"50123",449,334,331,1,3,"PODEMOS-IU-",31
50,"50294",70,63,63,0,0,"PODEMOS-IU-",5
50,"50071",132,92,92,0,0,"PODEMOS-IU-",5
50,"50104",348,271,269,2,2,"PODEMOS-IU-",12
50,"50119",927,724,713,5,11,"PODEMOS-IU-",56
50,"50109",103,78,78,3,0,"PODEMOS-IU-",17
50,"50298",5333,3949,3902,39,47,"PODEMOS-IU-",608
44,"44129",39,32,32,0,0,"PODEMOS-IU-",6
44,"44048",61,52,52,0,0,"PODEMOS-IU-",6
50,"50067",14119,9909,9819,112,90,"PODEMOS-IU-",1440
50,"50012",100,80,79,2,1,"PODEMOS-IU-",9
44,"44158",1180,876,862,10,14,"PODEMOS-IU-",117
44,"44049",849,616,604,9,12,"PODEMOS-IU-",93
50,"50147",777,552,552,2,0,"PODEMOS-IU-",131
50,"50152",1430,1008,994,14,14,"PODEMOS-IU-",99
50,"50058",66,39,39,0,0,"PODEMOS-IU-",4
44,"44102",30,27,26,0,1,"PODEMOS-IU-",1
44,"44097",142,92,92,0,0,"PODEMOS-IU-",3
50,"50195",54,40,40,0,0,"PODEMOS-IU-",7
44,"44223",72,54,54,0,0,"PODEMOS-IU-",16
44,"44209",833,611,602,6,9,"PODEMOS-IU-",85
50,"50011",122,95,94,1,1,"PODEMOS-IU-",10
50,"50291",96,74,74,0,0,"PODEMOS-IU-",5
44,"44120",222,154,150,2,4,"PODEMOS-IU-",28
44,"44206",114,90,87,0,3,"PODEMOS-IU-",21
50,"50010",68,58,58,0,0,"PODEMOS-IU-",4
50,"50280",332,253,250,0,3,"PODEMOS-IU-",45
44,"44051",2683,1977,1946,17,31,"PODEMOS-IU-",247
44,"44230",155,123,123,2,0,"PODEMOS-IU-",20
50,"50086",187,132,128,2,4,"PODEMOS-IU-",19
44,"44026",90,77,76,0,1,"PODEMOS-IU-",12
44,"44261",739,536,529,6,7,"PODEMOS-IU-",72
50,"50224",72,57,56,2,1,"PODEMOS-IU-",4
44,"44067",114,81,81,1,0,"PODEMOS-IU-",22
44,"44196",131,101,98,2,3,"PODEMOS-IU-",14
50,"50004",522,390,388,0,2,"PODEMOS-IU-",49
44,"44106",155,116,114,5,2,"PODEMOS-IU-",24
44,"44068",659,509,503,3,6,"PODEMOS-IU-",80
44,"44153",1774,1135,1121,5,14,"PODEMOS-IU-",193
50,"50085",167,126,126,1,0,"PODEMOS-IU-",11
44,"44205",700,460,453,4,7,"PODEMOS-IU-",53
50,"50246",41,28,28,0,0,"PODEMOS-IU-",2
50,"50050",98,64,64,2,0,"PODEMOS-IU-",11
50,"50177",308,245,244,4,1,"PODEMOS-IU-",25
44,"44189",56,41,41,0,0,"PODEMOS-IU-",0
50,"50248",508,387,374,2,13,"PODEMOS-IU-",67
50,"50110",367,256,254,0,2,"PODEMOS-IU-",21
44,"44132",60,54,54,1,0,"PODEMOS-IU-",4
44,"44246",1543,1045,1027,12,18,"PODEMOS-IU-",237
50,"50901",138,105,105,0,0,"PODEMOS-IU-",17
44,"44021",107,89,88,0,1,"PODEMOS-IU-",19
50,"50125",360,248,246,3,2,"PODEMOS-IU-",25
50,"50209",2601,1731,1721,13,10,"PODEMOS-IU-",342
44,"44020",24,20,19,1,1,"PODEMOS-IU-",1
50,"50025",4562,3158,3124,31,34,"PODEMOS-IU-",402
44,"44050",3113,2120,2100,25,20,"PODEMOS-IU-",273
44,"44041",56,44,44,1,0,"PODEMOS-IU-",13
50,"50159",665,512,507,2,5,"PODEMOS-IU-",65
44,"44215",159,109,109,2,0,"PODEMOS-IU-",30
44,"44040",201,160,157,1,3,"PODEMOS-IU-",28
44,"44234",61,51,51,1,0,"PODEMOS-IU-",14
50,"50059",769,549,544,8,5,"PODEMOS-IU-",68
50,"50229",62,47,47,2,0,"PODEMOS-IU-",18
44,"44172",301,218,216,4,2,"PODEMOS-IU-",18
44,"44236",63,48,47,0,1,"PODEMOS-IU-",8
44,"44109",108,73,73,0,0,"PODEMOS-IU-",11
44,"44009",809,596,593,7,3,"PODEMOS-IU-",107
50,"50060",172,128,127,1,1,"PODEMOS-IU-",28
44,"44159",38,31,31,1,0,"PODEMOS-IU-",5
50,"50254",180,118,116,1,2,"PODEMOS-IU-",16
44,"44111",92,69,68,0,1,"PODEMOS-IU-",19
50,"50156",215,181,178,2,3,"PODEMOS-IU-",37
50,"50251",8262,5946,5872,44,74,"PODEMOS-IU-",1145
18,"18056",3530,2641,2614,24,27,"PODEMOS-IU-",457
11,"11037",5661,4347,4265,33,82,"PODEMOS-IU-",2589
21,"21010",14687,8293,8220,92,73,"PODEMOS-IU-",1448
18,"18173",8939,5922,5849,42,73,"PODEMOS-IU-",1262
18,"18011",4335,3037,3015,20,22,"PODEMOS-IU-",556
41,"41034",23070,14805,14625,186,180,"PODEMOS-IU-",2952
41,"41037",3213,2376,2342,30,34,"PODEMOS-IU-",758
4,"4062",4504,3534,3490,18,44,"PODEMOS-IU-",321
29,"29062",654,551,545,2,6,"PODEMOS-IU-",27
29,"29092",570,397,390,4,7,"PODEMOS-IU-",107
18,"18185",541,434,432,2,2,"PODEMOS-IU-",80
41,"41901",2682,2107,2086,28,21,"PODEMOS-IU-",397
21,"21037",472,341,336,2,5,"PODEMOS-IU-",50
21,"21020",365,223,222,1,1,"PODEMOS-IU-",27
29,"29100",2433,1684,1667,5,17,"PODEMOS-IU-",180
21,"21040",3170,2129,2071,20,58,"PODEMOS-IU-",270
4,"4070",1584,1184,1179,3,5,"PODEMOS-IU-",90
18,"18024",855,665,654,7,11,"PODEMOS-IU-",119
14,"14011",578,464,462,4,2,"PODEMOS-IU-",33
23,"23027",723,576,572,3,4,"PODEMOS-IU-",20
14,"14039",2604,2062,2021,12,41,"PODEMOS-IU-",226
21,"21059",221,166,163,5,3,"PODEMOS-IU-",21
41,"41052",3013,2116,2064,14,52,"PODEMOS-IU-",378
23,"23075",3298,2564,2541,18,23,"PODEMOS-IU-",304
41,"41016",7355,5248,5175,51,73,"PODEMOS-IU-",1114
14,"14070",1332,986,974,10,12,"PODEMOS-IU-",50
4,"4903",4320,2858,2825,19,33,"PODEMOS-IU-",186
18,"18047",5903,3893,3857,28,36,"PODEMOS-IU-",999
18,"18099",1584,1228,1206,14,22,"PODEMOS-IU-",238
18,"18119",1702,1298,1283,13,15,"PODEMOS-IU-",166
18,"18165",4123,2787,2758,18,29,"PODEMOS-IU-",568
14,"14015",2125,1579,1554,10,25,"PODEMOS-IU-",281
21,"21074",2649,1755,1733,13,22,"PODEMOS-IU-",108
18,"18115",2553,1800,1781,17,19,"PODEMOS-IU-",434
41,"41020",12887,8210,8118,82,92,"PODEMOS-IU-",1164
18,"18089",14719,10163,10099,63,64,"PODEMOS-IU-",1280
41,"41092",7743,5358,5311,55,47,"PODEMOS-IU-",734
18,"18133",2168,1648,1636,6,12,"PODEMOS-IU-",165
18,"18030",576,413,409,6,4,"PODEMOS-IU-",47
29,"29093",2214,1643,1621,3,22,"PODEMOS-IU-",310
18,"18074",262,201,200,2,1,"PODEMOS-IU-",10
4,"4021",185,151,148,1,3,"PODEMOS-IU-",13
18,"18146",965,703,685,9,18,"PODEMOS-IU-",55
4,"4008",505,423,417,5,6,"PODEMOS-IU-",20
41,"41076",2183,1341,1327,19,14,"PODEMOS-IU-",340
29,"29054",41997,28422,28238,189,184,"PODEMOS-IU-",4622
41,"41048",2228,1470,1447,15,23,"PODEMOS-IU-",143
41,"41007",12341,8039,7844,103,195,"PODEMOS-IU-",1944
29,"29084",27359,17843,17627,176,216,"PODEMOS-IU-",2518
41,"41040",10541,7752,7698,68,54,"PODEMOS-IU-",1407
11,"11018",1468,1046,1031,9,15,"PODEMOS-IU-",100
23,"23001",963,801,799,1,2,"PODEMOS-IU-",97
29,"29067",424813,286785,284689,2351,2096,"PODEMOS-IU-",59282
11,"11038",13737,10181,10034,99,147,"PODEMOS-IU-",1126
4,"4082",297,200,200,0,0,"PODEMOS-IU-",13
21,"21034",1188,798,786,8,12,"PODEMOS-IU-",130
18,"18084",4257,3107,3075,26,32,"PODEMOS-IU-",569
41,"41095",41232,27076,26793,315,283,"PODEMOS-IU-",4297
23,"23066",4347,3465,3410,15,55,"PODEMOS-IU-",294
11,"11027",67913,45219,44833,454,386,"PODEMOS-IU-",9927
23,"23045",2132,1260,1247,5,13,"PODEMOS-IU-",321
23,"23084",935,658,653,7,5,"PODEMOS-IU-",40
23,"23018",2325,1668,1653,10,15,"PODEMOS-IU-",274
23,"23004",436,364,358,1,6,"PODEMOS-IU-",35
4,"4045",1757,1309,1288,6,21,"PODEMOS-IU-",127
23,"23032",566,450,448,4,2,"PODEMOS-IU-",54
14,"14021",260178,181773,180348,1872,1425,"PODEMOS-IU-",38254
41,"41053",21259,15147,14853,132,294,"PODEMOS-IU-",2836
18,"18034",505,366,364,1,2,"PODEMOS-IU-",115
4,"4034",160,99,99,2,0,"PODEMOS-IU-",9
41,"41085",4086,3058,3012,22,46,"PODEMOS-IU-",543
41,"41059",34165,24949,24709,196,240,"PODEMOS-IU-",5950
23,"23092",27775,19734,19541,175,193,"PODEMOS-IU-",3292
18,"18151",260,171,170,3,1,"PODEMOS-IU-",30
11,"11013",2312,1547,1518,15,29,"PODEMOS-IU-",244
18,"18122",16114,11098,10945,83,153,"PODEMOS-IU-",1091
4,"4022",347,249,249,7,0,"PODEMOS-IU-",31
18,"18171",2120,1572,1551,9,21,"PODEMOS-IU-",401
29,"29081",261,197,197,1,0,"PODEMOS-IU-",7
29,"29013",1610,1238,1207,9,31,"PODEMOS-IU-",256
29,"29095",3321,2376,2307,24,69,"PODEMOS-IU-",434
29,"29043",2509,1608,1576,18,32,"PODEMOS-IU-",263
21,"21070",6258,4165,4092,48,73,"PODEMOS-IU-",880
14,"14002",10951,7706,7620,83,86,"PODEMOS-IU-",1421
41,"41026",4314,3380,3322,18,58,"PODEMOS-IU-",1455
14,"14029",4178,3047,3009,28,38,"PODEMOS-IU-",388
23,"23020",1590,1370,1349,9,21,"PODEMOS-IU-",427
18,"18042",403,324,322,2,2,"PODEMOS-IU-",68
29,"29028",1237,836,826,6,10,"PODEMOS-IU-",165
18,"18078",732,570,566,2,4,"PODEMOS-IU-",113
21,"21048",305,214,210,4,4,"PODEMOS-IU-",28
21,"21047",1917,1111,1065,15,46,"PODEMOS-IU-",187
23,"23061",7560,5303,5234,29,69,"PODEMOS-IU-",445
4,"4003",17357,11157,11075,64,82,"PODEMOS-IU-",1071
41,"41061",2195,1749,1703,11,46,"PODEMOS-IU-",1196
41,"41054",692,560,546,3,14,"PODEMOS-IU-",102
18,"18018",634,472,468,5,4,"PODEMOS-IU-",61
18,"18132",3291,2524,2494,9,30,"PODEMOS-IU-",536
41,"41071",5586,3724,3661,22,63,"PODEMOS-IU-",893
21,"21006",3368,2182,2146,13,36,"PODEMOS-IU-",372
41,"41049",9299,6896,6771,98,125,"PODEMOS-IU-",1857
41,"41081",29189,20205,20015,196,190,"PODEMOS-IU-",5072
14,"14004",2034,1531,1518,14,13,"PODEMOS-IU-",123
18,"18068",1569,1189,1166,6,23,"PODEMOS-IU-",247
21,"21021",12254,7339,7244,78,95,"PODEMOS-IU-",965
41,"41094",6288,4497,4449,38,48,"PODEMOS-IU-",704
23,"23097",6443,4117,4063,21,54,"PODEMOS-IU-",366
23,"23052",1125,936,922,4,14,"PODEMOS-IU-",52
29,"29901",43826,29318,29107,250,211,"PODEMOS-IU-",5532
41,"41057",269,183,181,0,2,"PODEMOS-IU-",33
29,"29096",2810,1944,1909,31,35,"PODEMOS-IU-",356
21,"21008",2658,1660,1636,10,24,"PODEMOS-IU-",141
4,"4084",341,249,247,2,2,"PODEMOS-IU-",12
23,"23010",14347,9669,9560,86,109,"PODEMOS-IU-",1145
4,"4073",330,234,233,2,1,"PODEMOS-IU-",17
29,"29031",1614,1107,1094,13,13,"PODEMOS-IU-",294
11,"11005",4583,3018,2967,25,51,"PODEMOS-IU-",520
18,"18162",938,698,686,1,12,"PODEMOS-IU-",68
29,"29017",6553,4744,4668,33,76,"PODEMOS-IU-",865
18,"18158",8358,5096,5031,28,65,"PODEMOS-IU-",1188
41,"41005",9068,6366,6281,58,85,"PODEMOS-IU-",1283
21,"21002",15478,10597,10507,94,90,"PODEMOS-IU-",2212
18,"18037",535,402,396,2,6,"PODEMOS-IU-",38
21,"21078",2726,1793,1768,17,25,"PODEMOS-IU-",467
23,"23012",4162,2907,2889,14,18,"PODEMOS-IU-",286
4,"4055",371,310,308,0,2,"PODEMOS-IU-",23
14,"14032",423,334,330,4,4,"PODEMOS-IU-",19
21,"21019",612,400,391,2,9,"PODEMOS-IU-",81
21,"21050",12427,8036,7969,80,67,"PODEMOS-IU-",770
21,"21007",6225,4080,3999,52,81,"PODEMOS-IU-",930
4,"4083",1776,1345,1336,6,9,"PODEMOS-IU-",142
21,"21028",375,277,271,2,6,"PODEMOS-IU-",11
41,"41083",1147,864,856,4,8,"PODEMOS-IU-",139
18,"18178",719,549,544,4,5,"PODEMOS-IU-",39
18,"18111",2765,1949,1936,18,13,"PODEMOS-IU-",445
4,"4029",8859,5834,5790,35,44,"PODEMOS-IU-",656
41,"41093",18554,13978,13874,99,104,"PODEMOS-IU-",2523
14,"14005",6311,4143,4084,72,59,"PODEMOS-IU-",1257
23,"23093",3226,2302,2273,19,29,"PODEMOS-IU-",228
14,"14061",744,595,582,1,13,"PODEMOS-IU-",91
4,"4033",135,97,93,1,4,"PODEMOS-IU-",2
11,"11030",22775,15157,14958,149,199,"PODEMOS-IU-",2672
23,"23060",19003,12924,12812,102,112,"PODEMOS-IU-",1279
18,"18189",776,581,574,4,7,"PODEMOS-IU-",148
41,"41082",3415,2671,2647,16,24,"PODEMOS-IU-",507
18,"18161",212,175,174,3,1,"PODEMOS-IU-",21
23,"23064",1655,1363,1353,1,10,"PODEMOS-IU-",79
4,"4053",12320,8946,8866,70,80,"PODEMOS-IU-",678
18,"18134",5828,3840,3800,36,40,"PODEMOS-IU-",833
18,"18016",307,235,233,0,2,"PODEMOS-IU-",26
29,"29048",1405,1121,1110,8,11,"PODEMOS-IU-",460
41,"41009",1222,812,805,3,7,"PODEMOS-IU-",76
21,"21053",3316,2141,2107,17,34,"PODEMOS-IU-",262
18,"18902",816,632,620,4,12,"PODEMOS-IU-",84
4,"4097",248,189,189,1,0,"PODEMOS-IU-",34
23,"23067",2460,1831,1805,11,26,"PODEMOS-IU-",550
18,"18025",288,220,220,1,0,"PODEMOS-IU-",21
14,"14040",3776,2873,2833,32,40,"PODEMOS-IU-",1348
11,"11029",5430,3039,3000,44,39,"PODEMOS-IU-",736
29,"29079",2416,1788,1764,10,24,"PODEMOS-IU-",295
18,"18145",10491,7538,7477,59,61,"PODEMOS-IU-",1381
18,"18908",801,593,588,3,5,"PODEMOS-IU-",88
23,"23087",11292,8222,8084,59,138,"PODEMOS-IU-",1946
18,"18061",1057,812,804,1,8,"PODEMOS-IU-",181
21,"21023",2124,1298,1264,7,34,"PODEMOS-IU-",196
23,"23048",870,619,613,1,6,"PODEMOS-IU-",58
21,"21009",857,532,523,4,9,"PODEMOS-IU-",121
41,"41019",4691,3089,3056,27,33,"PODEMOS-IU-",567
18,"18901",511,356,355,3,1,"PODEMOS-IU-",85
29,"29006",673,428,420,1,8,"PODEMOS-IU-",37
21,"21022",171,107,105,0,2,"PODEMOS-IU-",16
23,"23057",766,625,619,4,6,"PODEMOS-IU-",219
41,"41056",3687,2841,2812,30,29,"PODEMOS-IU-",548
4,"4052",12274,8372,8306,93,66,"PODEMOS-IU-",1595
21,"21016",1023,746,723,4,23,"PODEMOS-IU-",136
14,"14074",2299,1896,1866,16,30,"PODEMOS-IU-",234
41,"41033",5075,3313,3277,34,36,"PODEMOS-IU-",267
18,"18184",2168,1629,1607,13,22,"PODEMOS-IU-",330
29,"29027",2326,1626,1609,12,17,"PODEMOS-IU-",213
18,"18100",7807,5452,5398,50,54,"PODEMOS-IU-",751
21,"21043",1871,1310,1285,9,25,"PODEMOS-IU-",173
21,"21079",722,494,490,5,4,"PODEMOS-IU-",95
11,"11034",2334,1549,1517,14,32,"PODEMOS-IU-",141
29,"29099",950,693,685,4,8,"PODEMOS-IU-",83
4,"4080",209,162,162,3,0,"PODEMOS-IU-",31
29,"29036",632,423,416,2,7,"PODEMOS-IU-",80
18,"18109",597,411,408,2,3,"PODEMOS-IU-",19
4,"4050",800,558,553,3,5,"PODEMOS-IU-",66
18,"18020",1028,691,686,3,5,"PODEMOS-IU-",80
18,"18048",2387,1683,1662,8,21,"PODEMOS-IU-",338
23,"23015",1374,1029,1019,5,10,"PODEMOS-IU-",93
23,"23043",546,398,396,3,2,"PODEMOS-IU-",31
4,"4019",249,196,196,1,0,"PODEMOS-IU-",20
29,"29011",2900,1822,1803,9,19,"PODEMOS-IU-",201
23,"23026",3586,2620,2585,16,35,"PODEMOS-IU-",182
18,"18076",804,551,549,1,2,"PODEMOS-IU-",49
29,"29023",2081,1354,1340,4,14,"PODEMOS-IU-",158
4,"4058",354,261,259,1,2,"PODEMOS-IU-",56
18,"18022",13432,8491,8407,67,84,"PODEMOS-IU-",2047
41,"41008",1059,749,739,10,10,"PODEMOS-IU-",82
18,"18103",757,579,575,4,4,"PODEMOS-IU-",25
21,"21046",1705,1099,996,16,103,"PODEMOS-IU-",36
23,"23008",1502,1144,1131,9,13,"PODEMOS-IU-",195
18,"18069",502,362,357,0,5,"PODEMOS-IU-",49
29,"29019",878,652,636,3,16,"PODEMOS-IU-",194
29,"29063",323,250,245,1,5,"PODEMOS-IU-",31
23,"23021",524,431,429,0,2,"PODEMOS-IU-",48
29,"29098",1253,917,895,9,22,"PODEMOS-IU-",102
23,"23085",2252,1655,1644,6,11,"PODEMOS-IU-",193
14,"14045",3052,2362,2335,11,27,"PODEMOS-IU-",180
4,"4056",143,113,109,0,4,"PODEMOS-IU-",8
21,"21042",15350,7643,7530,124,113,"PODEMOS-IU-",1193
18,"18038",1066,828,802,1,26,"PODEMOS-IU-",143
18,"18114",609,424,422,8,2,"PODEMOS-IU-",78
18,"18909",579,435,429,0,6,"PODEMOS-IU-",27
14,"14058",7970,5491,5417,66,74,"PODEMOS-IU-",678
21,"21073",1862,1125,1109,8,16,"PODEMOS-IU-",112
23,"23065",1597,1170,1149,2,21,"PODEMOS-IU-",75
21,"21011",3453,2441,2419,15,22,"PODEMOS-IU-",342
23,"23037",502,404,400,6,4,"PODEMOS-IU-",31
41,"41902",4659,2679,2646,23,33,"PODEMOS-IU-",385
23,"23090",1312,1041,1018,5,23,"PODEMOS-IU-",81
21,"21061",5084,3223,3177,28,46,"PODEMOS-IU-",247
14,"14022",4006,2977,2949,17,28,"PODEMOS-IU-",1110
23,"23033",1352,1045,1034,12,11,"PODEMOS-IU-",32
4,"4901",545,395,394,0,1,"PODEMOS-IU-",49
11,"11028",32488,21971,21672,316,299,"PODEMOS-IU-",7708
21,"21076",2121,1458,1437,17,21,"PODEMOS-IU-",295
18,"18177",418,258,256,0,2,"PODEMOS-IU-",16
18,"18116",2850,2059,2025,20,34,"PODEMOS-IU-",325
18,"18002",553,395,393,1,2,"PODEMOS-IU-",20
29,"29904",421,338,335,3,3,"PODEMOS-IU-",37
18,"18915",745,533,525,2,8,"PODEMOS-IU-",63
23,"23051",2758,2171,2144,9,27,"PODEMOS-IU-",163
4,"4044",1547,1166,1156,5,10,"PODEMOS-IU-",146
4,"4013",141378,94872,94288,741,584,"PODEMOS-IU-",15775
29,"29034",467,358,356,0,2,"PODEMOS-IU-",23
29,"29045",1684,1178,1168,8,10,"PODEMOS-IU-",157
23,"23072",1986,1542,1530,7,12,"PODEMOS-IU-",147
18,"18083",247,200,196,0,4,"PODEMOS-IU-",21
41,"41022",4290,2889,2851,21,38,"PODEMOS-IU-",752
29,"29080",6676,4469,4419,35,50,"PODEMOS-IU-",768
18,"18102",8400,5592,5504,44,88,"PODEMOS-IU-",982
14,"14001",3514,2837,2789,28,48,"PODEMOS-IU-",444
29,"29012",9755,6689,6599,71,90,"PODEMOS-IU-",1147
14,"14023",2021,1660,1639,8,21,"PODEMOS-IU-",78
29,"29902",2567,1577,1559,11,18,"PODEMOS-IU-",194
14,"14014",2557,2035,2007,9,28,"PODEMOS-IU-",330
18,"18063",1200,679,675,2,4,"PODEMOS-IU-",35
18,"18905",14618,9789,9682,110,107,"PODEMOS-IU-",1905
29,"29024",386,227,219,2,8,"PODEMOS-IU-",17
29,"29076",2153,1390,1360,10,30,"PODEMOS-IU-",190
41,"41030",514,387,373,3,14,"PODEMOS-IU-",69
23,"23077",620,501,494,3,7,"PODEMOS-IU-",40
29,"29035",1567,1157,1144,11,13,"PODEMOS-IU-",329
18,"18057",5305,3827,3791,27,36,"PODEMOS-IU-",712
29,"29091",8957,6186,6078,56,108,"PODEMOS-IU-",1182
18,"18141",404,285,282,0,3,"PODEMOS-IU-",14
18,"18014",6581,4584,4545,37,39,"PODEMOS-IU-",804
14,"14024",1903,1405,1376,16,29,"PODEMOS-IU-",224
23,"23053",9531,6704,6658,37,46,"PODEMOS-IU-",2523
4,"4002",1039,748,740,2,8,"PODEMOS-IU-",79
11,"11031",76455,49854,49405,535,449,"PODEMOS-IU-",10367
21,"21013",10591,6580,6452,55,128,"PODEMOS-IU-",1248
14,"14068",538,401,398,10,3,"PODEMOS-IU-",70
14,"14072",1048,806,795,6,11,"PODEMOS-IU-",127
21,"21066",498,392,389,3,3,"PODEMOS-IU-",30
11,"11042",1186,868,858,7,10,"PODEMOS-IU-",60
18,"18167",1895,1258,1250,4,8,"PODEMOS-IU-",187
18,"18914",1649,1238,1213,3,25,"PODEMOS-IU-",295
21,"21062",1392,887,879,6,8,"PODEMOS-IU-",43
41,"41043",639,436,427,5,9,"PODEMOS-IU-",71
41,"41903",6757,4562,4504,51,58,"PODEMOS-IU-",564
23,"23038",3587,2794,2770,16,24,"PODEMOS-IU-",385
23,"23076",827,640,630,1,10,"PODEMOS-IU-",64
18,"18168",804,546,543,7,3,"PODEMOS-IU-",90
18,"18027",2570,1711,1700,13,11,"PODEMOS-IU-",387
18,"18164",1836,1146,1126,6,20,"PODEMOS-IU-",107
23,"23039",2204,1596,1558,11,38,"PODEMOS-IU-",172
18,"18066",2107,1392,1384,4,8,"PODEMOS-IU-",277
21,"21068",998,605,592,11,13,"PODEMOS-IU-",36
14,"14016",1337,1072,1060,2,12,"PODEMOS-IU-",136
41,"41074",3012,2282,2257,18,25,"PODEMOS-IU-",626
18,"18010",566,427,421,1,6,"PODEMOS-IU-",87
11,"11004",88783,51500,51015,513,485,"PODEMOS-IU-",8434
18,"18036",3851,2870,2841,17,29,"PODEMOS-IU-",510
14,"14067",3889,2946,2899,29,47,"PODEMOS-IU-",529
4,"4072",313,247,245,2,2,"PODEMOS-IU-",20
14,"14017",10868,7764,7665,71,99,"PODEMOS-IU-",997
4,"4049",5313,3620,3579,18,41,"PODEMOS-IU-",445
41,"41097",3137,2180,2134,18,46,"PODEMOS-IU-",218
4,"4089",742,521,518,1,3,"PODEMOS-IU-",42
11,"11011",1716,1195,1165,12,30,"PODEMOS-IU-",183
29,"29072",3262,2382,2352,17,30,"PODEMOS-IU-",406
21,"21029",1562,1127,1097,14,30,"PODEMOS-IU-",99
41,"41012",3290,2071,2030,20,41,"PODEMOS-IU-",289
14,"14057",6136,4713,4631,47,82,"PODEMOS-IU-",1344
21,"21069",1702,1167,1149,6,18,"PODEMOS-IU-",96
4,"4041",322,240,238,6,2,"PODEMOS-IU-",41
4,"4026",66,54,51,0,3,"PODEMOS-IU-",4
41,"41101",5928,4209,4173,18,36,"PODEMOS-IU-",722
21,"21003",690,471,458,6,13,"PODEMOS-IU-",116
21,"21030",1830,1452,1430,13,22,"PODEMOS-IU-",87
4,"4090",304,238,234,0,4,"PODEMOS-IU-",32
23,"23005",30465,20878,20630,177,248,"PODEMOS-IU-",2650
14,"14018",3709,2697,2653,26,44,"PODEMOS-IU-",544
14,"14019",6464,4967,4909,49,58,"PODEMOS-IU-",1257
11,"11035",13593,8375,8276,90,99,"PODEMOS-IU-",1492
18,"18064",377,291,290,2,1,"PODEMOS-IU-",18
41,"41032",3984,2811,2725,27,86,"PODEMOS-IU-",377
21,"21058",2609,1883,1856,23,27,"PODEMOS-IU-",201
29,"29082",31885,22572,22400,152,172,"PODEMOS-IU-",4415
11,"11032",53874,31273,31008,348,265,"PODEMOS-IU-",6794
18,"18194",2128,1451,1437,9,14,"PODEMOS-IU-",200
11,"11010",6410,4189,4130,88,59,"PODEMOS-IU-",989
4,"4010",576,444,443,3,1,"PODEMOS-IU-",35
29,"29059",2587,1965,1922,14,43,"PODEMOS-IU-",850
18,"18032",246,175,174,2,1,"PODEMOS-IU-",36
23,"23031",747,637,619,0,18,"PODEMOS-IU-",102
18,"18013",4218,3024,2986,15,38,"PODEMOS-IU-",360
4,"4102",13694,8944,8865,50,79,"PODEMOS-IU-",819
11,"11036",689,407,400,3,7,"PODEMOS-IU-",62
18,"18007",781,521,512,5,9,"PODEMOS-IU-",29
4,"4065",363,284,282,7,2,"PODEMOS-IU-",15
29,"29056",1098,757,750,5,7,"PODEMOS-IU-",56
29,"29001",4170,3106,3068,19,38,"PODEMOS-IU-",1003
29,"29090",1688,1144,1134,15,10,"PODEMOS-IU-",81
14,"14051",1397,1018,1000,2,18,"PODEMOS-IU-",91
23,"23101",378,276,271,1,5,"PODEMOS-IU-",26
23,"23035",1106,873,855,1,18,"PODEMOS-IU-",58
23,"23069",5353,4310,4212,27,98,"PODEMOS-IU-",436
18,"18050",1710,1165,1152,3,13,"PODEMOS-IU-",214
41,"41060",15242,10021,9847,86,174,"PODEMOS-IU-",1571
23,"23073",4507,3229,3200,13,29,"PODEMOS-IU-",329
4,"4103",1476,1018,1008,3,10,"PODEMOS-IU-",66
18,"18176",250,191,189,2,2,"PODEMOS-IU-",42
21,"21064",6522,4227,4146,48,81,"PODEMOS-IU-",628
18,"18180",633,410,410,3,0,"PODEMOS-IU-",73
4,"4086",1760,1243,1234,9,9,"PODEMOS-IU-",98
29,"29064",503,348,339,8,9,"PODEMOS-IU-",25
18,"18067",702,469,466,0,3,"PODEMOS-IU-",32
23,"23009",12861,9649,9543,72,106,"PODEMOS-IU-",1038
29,"29065",187,137,136,0,1,"PODEMOS-IU-",11
41,"41028",2003,1524,1511,9,13,"PODEMOS-IU-",410
29,"29010",1651,1278,1237,4,41,"PODEMOS-IU-",156
4,"4009",162,123,122,2,1,"PODEMOS-IU-",15
29,"29032",6657,5031,4977,33,54,"PODEMOS-IU-",1333
41,"41039",31663,22062,21830,193,232,"PODEMOS-IU-",3170
41,"41017",15158,10718,10616,92,102,"PODEMOS-IU-",1895
18,"18163",324,235,233,2,2,"PODEMOS-IU-",30
29,"29055",1796,1354,1336,11,18,"PODEMOS-IU-",243
4,"4902",45437,28936,28699,214,237,"PODEMOS-IU-",3321
4,"4095",714,471,468,5,3,"PODEMOS-IU-",47
21,"21041",113337,72318,71637,748,681,"PODEMOS-IU-",13667
4,"4085",387,304,301,2,3,"PODEMOS-IU-",11
41,"41029",13445,9507,9416,78,91,"PODEMOS-IU-",1847
23,"23047",1629,1258,1250,10,8,"PODEMOS-IU-",162
4,"4048",1503,1090,1085,9,5,"PODEMOS-IU-",121
14,"14013",16796,11830,11616,129,214,"PODEMOS-IU-",1512
23,"23904",2796,1825,1798,8,27,"PODEMOS-IU-",146
18,"18070",288,227,226,0,1,"PODEMOS-IU-",36
29,"29052",224,144,144,3,0,"PODEMOS-IU-",5
4,"4092",2838,2127,2103,10,24,"PODEMOS-IU-",171
4,"4051",436,360,356,1,4,"PODEMOS-IU-",31
29,"29030",805,620,614,4,6,"PODEMOS-IU-",212
4,"4007",734,524,522,1,2,"PODEMOS-IU-",63
18,"18912",1473,994,979,3,15,"PODEMOS-IU-",80
4,"4076",1279,960,944,8,16,"PODEMOS-IU-",124
41,"41086",16170,10162,10088,73,74,"PODEMOS-IU-",2033
4,"4001",1062,823,814,5,9,"PODEMOS-IU-",65
41,"41041",9706,7239,7120,36,119,"PODEMOS-IU-",1121
23,"23041",499,398,394,2,4,"PODEMOS-IU-",25
21,"21065",273,186,184,0,2,"PODEMOS-IU-",12
18,"18028",928,765,758,2,7,"PODEMOS-IU-",77
21,"21056",2895,1990,1906,18,84,"PODEMOS-IU-",464
14,"14055",18557,12950,12764,178,186,"PODEMOS-IU-",1533
29,"29046",2675,1825,1807,14,18,"PODEMOS-IU-",211
4,"4904",1777,1230,1221,12,9,"PODEMOS-IU-",77
4,"4046",858,609,599,7,10,"PODEMOS-IU-",58
14,"14062",1025,806,792,6,14,"PODEMOS-IU-",67
21,"21039",311,225,223,1,2,"PODEMOS-IU-",26
18,"18001",251,168,167,5,1,"PODEMOS-IU-",7
23,"23029",843,628,624,2,4,"PODEMOS-IU-",26
41,"41010",4420,2960,2916,30,44,"PODEMOS-IU-",848
18,"18093",2750,1793,1776,7,17,"PODEMOS-IU-",187
18,"18121",129,98,98,1,0,"PODEMOS-IU-",20
4,"4067",570,441,436,2,5,"PODEMOS-IU-",45
14,"14006",1330,1120,1101,8,19,"PODEMOS-IU-",117
29,"29025",39665,25907,25714,192,193,"PODEMOS-IU-",5487
21,"21026",266,166,159,3,7,"PODEMOS-IU-",27
41,"41064",5596,3517,3456,55,61,"PODEMOS-IU-",491
29,"29066",334,234,233,4,1,"PODEMOS-IU-",56
23,"23003",8688,6326,6257,52,69,"PODEMOS-IU-",428
11,"11017",3212,2233,2203,39,30,"PODEMOS-IU-",383
4,"4078",1078,758,746,8,12,"PODEMOS-IU-",180
18,"18106",425,293,290,0,3,"PODEMOS-IU-",25
18,"18054",849,606,605,7,1,"PODEMOS-IU-",79
18,"18188",1653,1183,1175,5,8,"PODEMOS-IU-",124
14,"14025",2924,2466,2422,14,44,"PODEMOS-IU-",892
18,"18017",18114,11610,11510,77,100,"PODEMOS-IU-",1835
18,"18107",943,663,655,1,8,"PODEMOS-IU-",75
41,"41084",2845,2124,2081,9,43,"PODEMOS-IU-",348
21,"21051",239,174,170,1,4,"PODEMOS-IU-",21
11,"11040",397,307,292,1,15,"PODEMOS-IU-",25
18,"18087",184857,134428,133526,864,902,"PODEMOS-IU-",24004
4,"4075",5196,3735,3706,23,29,"PODEMOS-IU-",268
14,"14073",2891,2079,2016,13,63,"PODEMOS-IU-",309
41,"41089",6493,4398,4331,43,67,"PODEMOS-IU-",1000
41,"41045",5756,3988,3924,53,64,"PODEMOS-IU-",1085
41,"41044",7423,5273,5241,34,32,"PODEMOS-IU-",992
29,"29016",251,188,188,1,0,"PODEMOS-IU-",21
4,"4036",226,175,175,0,0,"PODEMOS-IU-",3
4,"4099",4989,3636,3588,27,48,"PODEMOS-IU-",305
29,"29075",12934,8234,8147,69,87,"PODEMOS-IU-",1522
41,"41070",6032,4312,4258,44,54,"PODEMOS-IU-",1091
23,"23044",4816,3663,3569,27,94,"PODEMOS-IU-",660
18,"18088",1541,1124,1117,5,7,"PODEMOS-IU-",383
14,"14012",6173,4364,4291,35,73,"PODEMOS-IU-",911
4,"4100",8768,5390,5353,32,37,"PODEMOS-IU-",697
11,"11012",99886,70290,69673,693,617,"PODEMOS-IU-",20377
14,"14009",2788,1852,1834,20,18,"PODEMOS-IU-",227
41,"41067",7093,4930,4866,37,64,"PODEMOS-IU-",808
18,"18907",1843,1393,1388,4,5,"PODEMOS-IU-",106
41,"41024",22600,14263,14048,128,215,"PODEMOS-IU-",2166
41,"41035",1108,794,780,7,14,"PODEMOS-IU-",80
21,"21017",3600,2187,2164,26,23,"PODEMOS-IU-",305
21,"21071",203,157,153,4,4,"PODEMOS-IU-",16
4,"4101",4266,2909,2876,26,33,"PODEMOS-IU-",272
29,"29018",2010,1472,1420,9,52,"PODEMOS-IU-",244
14,"14075",572,448,428,1,20,"PODEMOS-IU-",78
11,"11016",14929,9426,9302,123,124,"PODEMOS-IU-",1628
14,"14050",2391,1822,1787,14,35,"PODEMOS-IU-",529
29,"29015",31880,22220,21952,190,268,"PODEMOS-IU-",2873
11,"11006",24455,15750,15587,193,163,"PODEMOS-IU-",2204
23,"23063",3829,2560,2522,21,38,"PODEMOS-IU-",404
18,"18170",330,219,217,0,2,"PODEMOS-IU-",27
21,"21063",2615,2001,1957,22,44,"PODEMOS-IU-",194
14,"14048",1207,884,869,13,15,"PODEMOS-IU-",119
29,"29008",14596,9519,9407,94,112,"PODEMOS-IU-",1084
14,"14020",387,269,264,2,5,"PODEMOS-IU-",21
11,"11003",1261,836,822,7,14,"PODEMOS-IU-",73
11,"11025",4398,2899,2848,51,51,"PODEMOS-IU-",419
4,"4004",425,329,329,0,0,"PODEMOS-IU-",44
29,"29053",1699,1105,1091,14,14,"PODEMOS-IU-",192
41,"41077",8702,5983,5875,29,108,"PODEMOS-IU-",1445
41,"41100",1013,692,673,6,19,"PODEMOS-IU-",57
29,"29086",793,470,470,3,0,"PODEMOS-IU-",55
11,"11007",17964,10038,9856,197,182,"PODEMOS-IU-",1862
11,"11015",62476,38177,37875,488,302,"PODEMOS-IU-",7314
14,"14049",16309,11635,11515,115,120,"PODEMOS-IU-",2308
23,"23901",1154,970,964,3,6,"PODEMOS-IU-",79
11,"11026",4782,3451,3378,26,73,"PODEMOS-IU-",373
23,"23074",3021,2317,2295,11,22,"PODEMOS-IU-",359
14,"14033",1283,971,959,9,12,"PODEMOS-IU-",124
29,"29002",1177,804,789,5,15,"PODEMOS-IU-",75
21,"21038",1095,705,693,4,12,"PODEMOS-IU-",121
29,"29068",7016,4300,4244,35,56,"PODEMOS-IU-",649
41,"41015",5297,3478,3405,41,73,"PODEMOS-IU-",510
23,"23024",12435,9058,8833,55,225,"PODEMOS-IU-",1470
41,"41027",3922,2660,2604,23,56,"PODEMOS-IU-",668
18,"18910",788,541,536,3,5,"PODEMOS-IU-",68
23,"23049",1813,1238,1222,9,16,"PODEMOS-IU-",286
23,"23094",3839,3009,2954,14,55,"PODEMOS-IU-",732
29,"29022",179,137,136,0,1,"PODEMOS-IU-",35
14,"14059",690,533,528,4,5,"PODEMOS-IU-",53
18,"18911",7473,5098,5035,51,63,"PODEMOS-IU-",1000
18,"18039",3490,2406,2378,33,28,"PODEMOS-IU-",162
14,"14031",593,469,459,3,10,"PODEMOS-IU-",48
4,"4030",1119,819,812,5,7,"PODEMOS-IU-",53
41,"41068",13939,9787,9674,72,113,"PODEMOS-IU-",1630
41,"41072",4054,2965,2933,14,32,"PODEMOS-IU-",1261
4,"4064",2771,2001,1988,13,13,"PODEMOS-IU-",341
29,"29004",312,236,233,2,3,"PODEMOS-IU-",19
4,"4088",2454,1660,1650,15,10,"PODEMOS-IU-",201
23,"23011",2170,1515,1496,7,19,"PODEMOS-IU-",287
21,"21027",48,36,35,1,1,"PODEMOS-IU-",3
41,"41006",2740,1782,1768,14,14,"PODEMOS-IU-",196
18,"18040",231,136,133,0,3,"PODEMOS-IU-",42
41,"41018",9480,6523,6455,53,68,"PODEMOS-IU-",1619
14,"14060",4868,3473,3412,41,61,"PODEMOS-IU-",572
18,"18179",538,376,374,6,2,"PODEMOS-IU-",42
18,"18144",781,567,558,4,9,"PODEMOS-IU-",121
4,"4061",638,506,498,4,8,"PODEMOS-IU-",49
18,"18046",1832,1160,1140,6,20,"PODEMOS-IU-",115
29,"29039",2666,1898,1873,22,25,"PODEMOS-IU-",683
18,"18108",850,659,656,3,3,"PODEMOS-IU-",92
18,"18149",5230,3903,3864,20,39,"PODEMOS-IU-",600
18,"18150",6763,4733,4678,21,55,"PODEMOS-IU-",921
18,"18029",1833,1196,1190,12,6,"PODEMOS-IU-",116
4,"4066",13571,8786,8724,50,62,"PODEMOS-IU-",763
18,"18043",123,80,79,1,1,"PODEMOS-IU-",24
29,"29071",934,596,588,3,8,"PODEMOS-IU-",82
23,"23056",3088,2243,2203,15,40,"PODEMOS-IU-",535
23,"23017",1572,1269,1257,4,12,"PODEMOS-IU-",114
4,"4069",4687,3471,3437,27,34,"PODEMOS-IU-",440
11,"11019",1826,1302,1248,7,54,"PODEMOS-IU-",174
23,"23080",1762,1332,1322,4,10,"PODEMOS-IU-",58
14,"14027",7925,5836,5746,58,90,"PODEMOS-IU-",1851
41,"41075",10212,6419,6295,49,124,"PODEMOS-IU-",1046
23,"23014",2559,1971,1942,13,29,"PODEMOS-IU-",387
18,"18044",181,107,107,0,0,"PODEMOS-IU-",6
41,"41079",9294,6670,6580,51,90,"PODEMOS-IU-",1192
4,"4077",295,263,261,2,2,"PODEMOS-IU-",10
41,"41098",5004,3665,3630,26,35,"PODEMOS-IU-",593
23,"23081",1513,1103,1084,10,19,"PODEMOS-IU-",119
41,"41031",1238,825,814,11,11,"PODEMOS-IU-",101
41,"41042",5844,4424,4378,40,46,"PODEMOS-IU-",1250
18,"18072",667,424,420,0,4,"PODEMOS-IU-",59
18,"18192",1538,1151,1123,6,28,"PODEMOS-IU-",207
23,"23099",4769,3359,3309,16,50,"PODEMOS-IU-",418
23,"23002",17428,12820,12644,70,176,"PODEMOS-IU-",1291
29,"29077",199,149,146,2,3,"PODEMOS-IU-",16
41,"41050",5150,3817,3777,19,40,"PODEMOS-IU-",622
11,"11021",6764,4434,4362,52,72,"PODEMOS-IU-",729
11,"11014",16858,10366,10245,153,121,"PODEMOS-IU-",2302
29,"29060",692,510,508,1,2,"PODEMOS-IU-",15
11,"11009",605,414,410,1,4,"PODEMOS-IU-",55
4,"4068",187,154,152,0,2,"PODEMOS-IU-",11
11,"11033",20903,12949,12771,164,178,"PODEMOS-IU-",2295
41,"41055",14954,10068,9945,64,123,"PODEMOS-IU-",1438
4,"4020",288,201,197,0,4,"PODEMOS-IU-",6
41,"41078",2508,1823,1810,19,13,"PODEMOS-IU-",331
23,"23091",729,555,553,5,2,"PODEMOS-IU-",35
29,"29070",40333,25991,25728,214,263,"PODEMOS-IU-",4927
4,"4035",8364,5810,5766,28,44,"PODEMOS-IU-",560
29,"29083",2107,1540,1512,9,28,"PODEMOS-IU-",117
18,"18154",1007,664,660,2,4,"PODEMOS-IU-",40
21,"21015",680,398,393,8,5,"PODEMOS-IU-",62
14,"14054",13697,10315,10109,93,206,"PODEMOS-IU-",1217
18,"18004",714,518,509,2,9,"PODEMOS-IU-",30
29,"29038",17676,11056,10970,141,86,"PODEMOS-IU-",2088
21,"21033",538,373,370,3,3,"PODEMOS-IU-",113
41,"41004",56640,37110,36649,440,461,"PODEMOS-IU-",8159
23,"23088",6089,4558,4472,34,86,"PODEMOS-IU-",1361
29,"29057",357,241,238,1,3,"PODEMOS-IU-",21
23,"23040",1480,1199,1192,2,7,"PODEMOS-IU-",388
21,"21025",4026,2433,2396,30,37,"PODEMOS-IU-",382
18,"18051",1147,817,810,8,7,"PODEMOS-IU-",63
41,"41001",1596,1183,1159,5,24,"PODEMOS-IU-",293
14,"14037",3318,2374,2320,22,54,"PODEMOS-IU-",166
29,"29061",1016,798,769,8,29,"PODEMOS-IU-",251
29,"29014",217,141,140,4,1,"PODEMOS-IU-",27
29,"29050",421,306,302,3,4,"PODEMOS-IU-",37
14,"14046",4485,3268,3208,33,60,"PODEMOS-IU-",1412
29,"29073",1579,1091,1080,7,11,"PODEMOS-IU-",294
29,"29085",144,109,108,0,1,"PODEMOS-IU-",7
21,"21044",17591,10679,10558,118,121,"PODEMOS-IU-",1081
41,"41046",3023,2213,2183,5,30,"PODEMOS-IU-",705
23,"23046",2391,1916,1895,6,21,"PODEMOS-IU-",263
4,"4074",2840,2000,1979,23,21,"PODEMOS-IU-",363
21,"21004",1631,1045,1028,13,17,"PODEMOS-IU-",176
21,"21014",4016,3025,2991,21,34,"PODEMOS-IU-",345
18,"18182",1906,1298,1288,4,10,"PODEMOS-IU-",78
18,"18117",506,383,373,1,10,"PODEMOS-IU-",68
18,"18012",2278,1662,1641,13,21,"PODEMOS-IU-",114
21,"21032",1800,1286,1259,10,27,"PODEMOS-IU-",323
41,"41069",29138,18991,18683,341,308,"PODEMOS-IU-",3851
14,"14056",23581,16120,15958,143,162,"PODEMOS-IU-",2456
18,"18097",960,693,685,5,8,"PODEMOS-IU-",92
14,"14038",32322,22117,21887,179,230,"PODEMOS-IU-",2592
18,"18098",6135,4206,4161,21,45,"PODEMOS-IU-",453
18,"18086",349,274,272,0,2,"PODEMOS-IU-",35
4,"4014",144,117,114,1,3,"PODEMOS-IU-",9
21,"21036",200,141,139,0,2,"PODEMOS-IU-",10
18,"18033",282,201,200,5,1,"PODEMOS-IU-",18
4,"4079",51383,33777,33586,257,191,"PODEMOS-IU-",5334
14,"14026",2067,1424,1405,4,19,"PODEMOS-IU-",185
29,"29042",14016,9368,9192,88,176,"PODEMOS-IU-",1286
29,"29087",376,270,266,1,4,"PODEMOS-IU-",68
21,"21060",11957,7356,7279,88,77,"PODEMOS-IU-",1229
18,"18023",15655,10879,10774,82,105,"PODEMOS-IU-",1263
11,"11041",9866,6477,6402,69,75,"PODEMOS-IU-",918
23,"23079",3717,2825,2801,28,24,"PODEMOS-IU-",231
18,"18071",5579,4044,3985,37,59,"PODEMOS-IU-",855
41,"41096",6161,4553,4476,32,77,"PODEMOS-IU-",1024
14,"14003",1248,939,930,2,9,"PODEMOS-IU-",69
18,"18174",446,330,324,2,6,"PODEMOS-IU-",38
41,"41051",2180,1529,1501,2,28,"PODEMOS-IU-",242
23,"23025",2802,2056,2037,9,19,"PODEMOS-IU-",169
23,"23028",6220,4409,4369,23,40,"PODEMOS-IU-",567
14,"14030",8625,6248,6181,53,67,"PODEMOS-IU-",1423
21,"21057",1041,661,657,12,4,"PODEMOS-IU-",51
21,"21012",316,235,233,2,2,"PODEMOS-IU-",48
14,"14034",308,247,244,2,3,"PODEMOS-IU-",20
29,"29089",3228,2377,2321,10,56,"PODEMOS-IU-",963
21,"21035",9617,6033,5943,76,90,"PODEMOS-IU-",823
18,"18147",3729,2335,2304,16,31,"PODEMOS-IU-",486
18,"18085",720,507,499,3,8,"PODEMOS-IU-",40
18,"18904",775,565,558,1,7,"PODEMOS-IU-",79
21,"21077",1711,1224,1202,3,22,"PODEMOS-IU-",79
41,"41080",1274,910,892,6,18,"PODEMOS-IU-",105
41,"41025",2020,1361,1320,7,41,"PODEMOS-IU-",243
4,"4043",549,465,461,1,4,"PODEMOS-IU-",44
18,"18138",2486,1620,1606,13,14,"PODEMOS-IU-",442
23,"23095",8735,6347,6310,14,37,"PODEMOS-IU-",595
41,"41062",2223,1653,1637,7,16,"PODEMOS-IU-",765
21,"21049",3361,2049,1984,17,65,"PODEMOS-IU-",463
4,"4031",2338,1772,1762,2,10,"PODEMOS-IU-",135
29,"29033",1122,747,730,4,17,"PODEMOS-IU-",83
41,"41073",1707,1055,1041,5,14,"PODEMOS-IU-",159
29,"29903",524,353,349,3,4,"PODEMOS-IU-",46
14,"14053",6006,4285,4232,49,53,"PODEMOS-IU-",937
23,"23058",8678,6532,6461,37,71,"PODEMOS-IU-",1014
29,"29040",1977,1290,1278,12,12,"PODEMOS-IU-",149
14,"14064",320,242,236,2,6,"PODEMOS-IU-",23
29,"29005",4358,2859,2817,28,42,"PODEMOS-IU-",298
21,"21024",492,338,326,6,12,"PODEMOS-IU-",67
41,"41063",2695,1850,1830,13,20,"PODEMOS-IU-",524
4,"4032",5586,3642,3623,23,19,"PODEMOS-IU-",457
18,"18913",813,566,559,2,7,"PODEMOS-IU-",23
4,"4059",1079,723,712,4,11,"PODEMOS-IU-",39
18,"18095",1967,1450,1430,11,20,"PODEMOS-IU-",267
23,"23082",1921,1425,1416,8,9,"PODEMOS-IU-",114
4,"4057",1325,894,884,5,10,"PODEMOS-IU-",84
4,"4006",7022,4792,4749,30,43,"PODEMOS-IU-",347
18,"18183",658,438,434,3,4,"PODEMOS-IU-",37
29,"29041",3175,2090,2045,24,45,"PODEMOS-IU-",561
29,"29058",1450,911,894,4,17,"PODEMOS-IU-",68
18,"18096",341,227,224,3,3,"PODEMOS-IU-",12
11,"11008",17471,10952,10812,128,140,"PODEMOS-IU-",2034
18,"18136",1851,1354,1337,5,17,"PODEMOS-IU-",186
4,"4005",556,437,431,3,6,"PODEMOS-IU-",23
18,"18021",17485,11800,11669,95,131,"PODEMOS-IU-",2332
23,"23054",382,282,281,1,1,"PODEMOS-IU-",8
18,"18059",4180,2907,2870,20,37,"PODEMOS-IU-",639
18,"18137",989,761,760,7,1,"PODEMOS-IU-",45
23,"23055",47167,31479,31198,264,281,"PODEMOS-IU-",6021
18,"18045",1126,756,742,4,14,"PODEMOS-IU-",61
4,"4027",250,159,159,0,0,"PODEMOS-IU-",17
29,"29029",403,298,294,2,4,"PODEMOS-IU-",43
21,"21045",249,180,178,3,2,"PODEMOS-IU-",43
41,"41065",22779,14769,14636,132,133,"PODEMOS-IU-",3317
11,"11901",5648,3676,3631,67,45,"PODEMOS-IU-",523
18,"18082",861,616,611,5,5,"PODEMOS-IU-",68
41,"41087",10237,6923,6774,48,149,"PODEMOS-IU-",1205
18,"18152",944,707,703,0,4,"PODEMOS-IU-",55
41,"41047",10117,7515,7422,74,93,"PODEMOS-IU-",1431
4,"4071",394,338,337,3,1,"PODEMOS-IU-",44
4,"4098",1516,1115,1106,11,9,"PODEMOS-IU-",71
18,"18128",343,270,269,1,1,"PODEMOS-IU-",57
4,"4015",124,96,96,2,0,"PODEMOS-IU-",15
41,"41014",2492,1882,1852,11,30,"PODEMOS-IU-",934
18,"18143",973,742,730,5,12,"PODEMOS-IU-",223
29,"29097",4108,2871,2821,37,50,"PODEMOS-IU-",367
21,"21001",637,462,455,6,7,"PODEMOS-IU-",111
11,"11902",3629,2275,2252,25,23,"PODEMOS-IU-",247
14,"14036",3740,2747,2696,24,51,"PODEMOS-IU-",513
11,"11023",9348,6410,6349,64,61,"PODEMOS-IU-",1213
29,"29020",3267,2408,2359,16,49,"PODEMOS-IU-",930
29,"29009",1468,1069,1045,8,24,"PODEMOS-IU-",299
41,"41090",3523,2576,2512,13,64,"PODEMOS-IU-",522
18,"18112",123,82,82,2,0,"PODEMOS-IU-",13
21,"21075",349,275,270,4,5,"PODEMOS-IU-",18
29,"29088",2714,1829,1800,12,29,"PODEMOS-IU-",289
23,"23006",4660,3687,3647,24,40,"PODEMOS-IU-",258
21,"21031",1199,852,837,6,15,"PODEMOS-IU-",86
29,"29007",27491,19071,18910,153,161,"PODEMOS-IU-",3744
18,"18906",905,664,657,3,7,"PODEMOS-IU-",84
11,"11001",4358,2816,2767,11,49,"PODEMOS-IU-",310
23,"23070",3914,2433,2407,14,26,"PODEMOS-IU-",184
18,"18181",223,174,172,0,2,"PODEMOS-IU-",5
41,"41013",4839,3151,3094,33,57,"PODEMOS-IU-",812
4,"4037",1314,969,955,6,14,"PODEMOS-IU-",107
4,"4081",355,287,287,0,0,"PODEMOS-IU-",23
4,"4011",2765,2119,2096,21,23,"PODEMOS-IU-",328
18,"18135",4568,3009,2961,14,48,"PODEMOS-IU-",310
41,"41058",17395,12556,12332,111,224,"PODEMOS-IU-",2125
41,"41038",100095,67313,66687,760,626,"PODEMOS-IU-",15682
18,"18124",381,277,277,2,0,"PODEMOS-IU-",15
18,"18101",9265,6618,6560,59,58,"PODEMOS-IU-",1370
29,"29044",809,561,561,3,0,"PODEMOS-IU-",45
18,"18148",817,637,634,5,3,"PODEMOS-IU-",66
23,"23007",3087,2205,2187,6,18,"PODEMOS-IU-",176
18,"18175",11670,8200,8097,36,103,"PODEMOS-IU-",1222
29,"29026",1057,751,748,5,3,"PODEMOS-IU-",166
14,"14047",1672,1187,1178,14,9,"PODEMOS-IU-",165
14,"14052",9379,5917,5854,68,63,"PODEMOS-IU-",827
18,"18053",1630,1082,1076,8,6,"PODEMOS-IU-",106
41,"41066",1342,945,927,2,18,"PODEMOS-IU-",188
29,"29047",1117,885,866,1,19,"PODEMOS-IU-",277
23,"23034",2540,1957,1934,14,23,"PODEMOS-IU-",86
29,"29021",161,108,107,4,1,"PODEMOS-IU-",17
18,"18159",995,797,795,2,2,"PODEMOS-IU-",325
18,"18153",8597,6024,5972,40,52,"PODEMOS-IU-",1489
21,"21055",6975,5293,5241,48,52,"PODEMOS-IU-",473
41,"41088",509,360,356,0,4,"PODEMOS-IU-",43
41,"41023",7905,5402,5347,41,55,"PODEMOS-IU-",855
4,"4093",1882,1216,1204,11,12,"PODEMOS-IU-",135
23,"23905",1868,1277,1272,6,5,"PODEMOS-IU-",92
4,"4094",207,144,144,0,0,"PODEMOS-IU-",2
21,"21018",1769,1120,1095,11,25,"PODEMOS-IU-",190
14,"14043",7574,5515,5443,81,72,"PODEMOS-IU-",687
4,"4091",334,268,267,6,1,"PODEMOS-IU-",17
4,"4087",182,135,135,0,0,"PODEMOS-IU-",16
18,"18065",618,496,470,3,26,"PODEMOS-IU-",233
18,"18120",264,209,208,1,1,"PODEMOS-IU-",15
4,"4054",358,285,281,2,4,"PODEMOS-IU-",26
29,"29037",209,158,157,1,1,"PODEMOS-IU-",13
21,"21054",8100,5656,5571,46,85,"PODEMOS-IU-",447
14,"14069",7524,5460,5392,43,68,"PODEMOS-IU-",630
4,"4060",445,348,345,5,3,"PODEMOS-IU-",34
18,"18105",3782,2450,2420,17,30,"PODEMOS-IU-",408
18,"18903",889,669,661,5,8,"PODEMOS-IU-",44
21,"21072",10262,7442,7307,85,135,"PODEMOS-IU-",1336
14,"14063",1046,734,725,2,9,"PODEMOS-IU-",44
18,"18187",557,383,379,0,4,"PODEMOS-IU-",62
23,"23902",2320,1867,1847,4,20,"PODEMOS-IU-",162
4,"4016",2138,1551,1536,9,15,"PODEMOS-IU-",148
14,"14028",314,253,249,1,4,"PODEMOS-IU-",24
23,"23059",5837,4387,4310,40,77,"PODEMOS-IU-",442
23,"23096",2642,2164,2138,9,26,"PODEMOS-IU-",330
4,"4024",3074,2347,2327,20,20,"PODEMOS-IU-",301
14,"14041",3182,2296,2251,33,45,"PODEMOS-IU-",898
4,"4028",221,191,190,1,1,"PODEMOS-IU-",21
29,"29049",2962,2132,2110,5,22,"PODEMOS-IU-",436
18,"18015",434,334,333,0,1,"PODEMOS-IU-",46
18,"18094",2359,1744,1720,14,24,"PODEMOS-IU-",200
18,"18157",1121,815,803,3,12,"PODEMOS-IU-",157
11,"11002",4273,2835,2815,16,20,"PODEMOS-IU-",1331
4,"4017",1296,857,854,5,3,"PODEMOS-IU-",70
21,"21052",4583,2734,2663,22,71,"PODEMOS-IU-",735
41,"41002",1473,1038,1014,9,24,"PODEMOS-IU-",109
18,"18035",1232,992,988,6,4,"PODEMOS-IU-",103
29,"29051",40391,25780,25419,232,361,"PODEMOS-IU-",4293
23,"23030",1238,968,960,3,8,"PODEMOS-IU-",38
11,"11022",48675,26491,26256,270,235,"PODEMOS-IU-",4619
14,"14042",18891,14051,13848,190,203,"PODEMOS-IU-",3314
29,"29003",983,754,743,1,11,"PODEMOS-IU-",117
14,"14010",4027,2850,2807,19,43,"PODEMOS-IU-",319
23,"23071",1715,1290,1278,7,12,"PODEMOS-IU-",111
18,"18127",16635,11440,11332,91,108,"PODEMOS-IU-",2561
23,"23086",11511,7997,7874,91,123,"PODEMOS-IU-",1125
23,"23050",90992,64810,64218,485,592,"PODEMOS-IU-",9465
18,"18193",14343,9951,9847,93,104,"PODEMOS-IU-",2024
14,"14071",929,642,630,2,12,"PODEMOS-IU-",69
11,"11020",165378,109810,108830,1188,980,"PODEMOS-IU-",22806
41,"41091",541987,385251,382091,3298,3160,"PODEMOS-IU-",79912
4,"4018",270,232,229,0,3,"PODEMOS-IU-",34
4,"4023",138,96,95,2,1,"PODEMOS-IU-",9
23,"23098",867,713,701,1,12,"PODEMOS-IU-",59
11,"11039",10018,6186,6109,103,77,"PODEMOS-IU-",765
41,"41102",14655,10183,9919,142,264,"PODEMOS-IU-",2049
14,"14066",5856,4150,4095,48,55,"PODEMOS-IU-",1098
23,"23016",387,321,320,0,1,"PODEMOS-IU-",38
18,"18123",301,228,222,1,6,"PODEMOS-IU-",17
18,"18005",372,262,258,0,4,"PODEMOS-IU-",31
41,"41036",3941,2674,2642,23,32,"PODEMOS-IU-",1127
21,"21067",414,288,287,1,1,"PODEMOS-IU-",71
4,"4063",1096,776,768,2,8,"PODEMOS-IU-",50
4,"4047",2281,1893,1878,11,15,"PODEMOS-IU-",147
29,"29094",57554,38071,37696,339,375,"PODEMOS-IU-",5775
14,"14035",5966,4236,4177,39,59,"PODEMOS-IU-",263
4,"4012",191,161,161,0,0,"PODEMOS-IU-",9
4,"4096",266,209,208,0,1,"PODEMOS-IU-",15
23,"23903",3540,2662,2634,13,28,"PODEMOS-IU-",401
18,"18062",10393,7235,7161,63,74,"PODEMOS-IU-",1263
29,"29074",794,586,581,0,5,"PODEMOS-IU-",58
18,"18003",14022,9938,9820,80,118,"PODEMOS-IU-",2045
18,"18049",595,459,452,3,7,"PODEMOS-IU-",63
11,"11024",6723,4696,4634,44,62,"PODEMOS-IU-",741
23,"23019",1536,1196,1174,2,22,"PODEMOS-IU-",197
41,"41099",3976,2369,2347,12,22,"PODEMOS-IU-",353
41,"41021",21294,13762,13570,145,192,"PODEMOS-IU-",3277
18,"18140",43496,28038,27872,212,166,"PODEMOS-IU-",5569
41,"41003",2333,1693,1671,13,22,"PODEMOS-IU-",217
14,"14008",2839,1905,1895,19,10,"PODEMOS-IU-",187
23,"23042",292,217,213,1,4,"PODEMOS-IU-",11
4,"4038",3084,2140,2126,16,14,"PODEMOS-IU-",322
14,"14044",1604,1172,1165,7,7,"PODEMOS-IU-",97
29,"29069",85684,54130,53621,455,509,"PODEMOS-IU-",8424
41,"41011",15401,10170,9986,111,184,"PODEMOS-IU-",1979
14,"14065",1850,1384,1377,16,7,"PODEMOS-IU-",248
21,"21005",15523,9038,8913,56,125,"PODEMOS-IU-",1317
23,"23062",1454,1141,1128,1,13,"PODEMOS-IU-",65
18,"18079",3441,2442,2411,16,31,"PODEMOS-IU-",576
18,"18006",4130,2904,2864,13,40,"PODEMOS-IU-",322
14,"14007",15207,10558,10417,82,141,"PODEMOS-IU-",1528
18,"18126",1483,1081,1074,15,7,"PODEMOS-IU-",394
31,"31230",106,82,82,1,0,"PODEMOS-IU-EQUO-BATZARRE",18
31,"31237",193,155,153,2,2,"PODEMOS-IU-EQUO-BATZARRE",44
31,"31133",43,28,28,0,0,"PODEMOS-IU-EQUO-BATZARRE",3
31,"31184",62,44,44,3,0,"PODEMOS-IU-EQUO-BATZARRE",6
31,"31122",4773,3520,3506,26,14,"PODEMOS-IU-EQUO-BATZARRE",1295
31,"31240",527,327,326,2,1,"PODEMOS-IU-EQUO-BATZARRE",93
31,"31088",5572,3897,3862,44,35,"PODEMOS-IU-EQUO-BATZARRE",1203
31,"31071",17,16,16,0,0,"PODEMOS-IU-EQUO-BATZARRE",2
31,"31162",47,31,31,0,0,"PODEMOS-IU-EQUO-BATZARRE",7
31,"31089",242,172,170,1,2,"PODEMOS-IU-EQUO-BATZARRE",36
31,"31107",1710,1255,1243,16,12,"PODEMOS-IU-EQUO-BATZARRE",142
31,"31062",1087,830,818,3,12,"PODEMOS-IU-EQUO-BATZARRE",168
31,"31242",260,164,163,1,1,"PODEMOS-IU-EQUO-BATZARRE",55
31,"31056",174,121,120,0,1,"PODEMOS-IU-EQUO-BATZARRE",35
31,"31019",1785,1254,1238,9,16,"PODEMOS-IU-EQUO-BATZARRE",381
31,"31033",49,31,31,1,0,"PODEMOS-IU-EQUO-BATZARRE",13
31,"31178",490,345,342,3,3,"PODEMOS-IU-EQUO-BATZARRE",84
31,"31216",3865,2702,2671,33,31,"PODEMOS-IU-EQUO-BATZARRE",830
31,"31203",40,28,28,0,0,"PODEMOS-IU-EQUO-BATZARRE",2
31,"31140",117,84,84,1,0,"PODEMOS-IU-EQUO-BATZARRE",25
31,"31903",6654,4402,4343,27,59,"PODEMOS-IU-EQUO-BATZARRE",1570
31,"31040",192,139,138,4,1,"PODEMOS-IU-EQUO-BATZARRE",32
31,"31118",164,112,111,1,1,"PODEMOS-IU-EQUO-BATZARRE",35
31,"31067",1922,1312,1294,10,18,"PODEMOS-IU-EQUO-BATZARRE",326
31,"31158",255,180,179,3,1,"PODEMOS-IU-EQUO-BATZARRE",72
31,"31251",3115,2240,2205,15,35,"PODEMOS-IU-EQUO-BATZARRE",592
31,"31234",144,106,106,4,0,"PODEMOS-IU-EQUO-BATZARRE",28
31,"31096",113,82,79,0,3,"PODEMOS-IU-EQUO-BATZARRE",0
31,"31069",832,637,635,3,2,"PODEMOS-IU-EQUO-BATZARRE",160
31,"31255",102,79,79,1,0,"PODEMOS-IU-EQUO-BATZARRE",15
31,"31229",47,35,35,0,0,"PODEMOS-IU-EQUO-BATZARRE",9
31,"31011",693,459,456,8,3,"PODEMOS-IU-EQUO-BATZARRE",150
31,"31105",1507,1167,1142,7,25,"PODEMOS-IU-EQUO-BATZARRE",177
31,"31004",35,21,21,0,0,"PODEMOS-IU-EQUO-BATZARRE",4
31,"31144",796,445,444,6,1,"PODEMOS-IU-EQUO-BATZARRE",118
31,"31063",92,75,73,2,2,"PODEMOS-IU-EQUO-BATZARRE",7
31,"31074",387,286,286,5,0,"PODEMOS-IU-EQUO-BATZARRE",99
31,"31137",205,112,109,6,3,"PODEMOS-IU-EQUO-BATZARRE",27
31,"31093",292,188,188,2,0,"PODEMOS-IU-EQUO-BATZARRE",43
31,"31005",301,212,211,3,1,"PODEMOS-IU-EQUO-BATZARRE",62
31,"31031",220,131,129,0,2,"PODEMOS-IU-EQUO-BATZARRE",24
31,"31262",228,179,178,5,1,"PODEMOS-IU-EQUO-BATZARRE",78
31,"31222",62,36,34,3,2,"PODEMOS-IU-EQUO-BATZARRE",11
31,"31102",143,69,69,0,0,"PODEMOS-IU-EQUO-BATZARRE",16
31,"31245",81,55,55,2,0,"PODEMOS-IU-EQUO-BATZARRE",9
31,"31177",255,169,166,2,3,"PODEMOS-IU-EQUO-BATZARRE",52
31,"31200",761,517,508,3,9,"PODEMOS-IU-EQUO-BATZARRE",171
31,"31136",447,299,298,2,1,"PODEMOS-IU-EQUO-BATZARRE",124
31,"31125",274,194,193,6,1,"PODEMOS-IU-EQUO-BATZARRE",50
31,"31241",133,98,98,2,0,"PODEMOS-IU-EQUO-BATZARRE",20
31,"31058",208,148,144,3,4,"PODEMOS-IU-EQUO-BATZARRE",36
31,"31224",893,671,662,3,9,"PODEMOS-IU-EQUO-BATZARRE",110
31,"31028",212,131,131,0,0,"PODEMOS-IU-EQUO-BATZARRE",46
31,"31235",159,117,115,2,2,"PODEMOS-IU-EQUO-BATZARRE",28
31,"31148",92,69,69,5,0,"PODEMOS-IU-EQUO-BATZARRE",15
31,"31101",1373,973,966,8,7,"PODEMOS-IU-EQUO-BATZARRE",343
31,"31904",1563,1029,1022,23,7,"PODEMOS-IU-EQUO-BATZARRE",318
31,"31209",155,107,106,0,1,"PODEMOS-IU-EQUO-BATZARRE",54
31,"31250",2810,1786,1770,19,16,"PODEMOS-IU-EQUO-BATZARRE",670
31,"31077",5352,3908,3848,41,60,"PODEMOS-IU-EQUO-BATZARRE",751
31,"31008",75,54,54,2,0,"PODEMOS-IU-EQUO-BATZARRE",4
31,"31259",484,291,286,2,5,"PODEMOS-IU-EQUO-BATZARRE",79
31,"31025",766,524,518,6,6,"PODEMOS-IU-EQUO-BATZARRE",164
31,"31155",256,169,167,2,2,"PODEMOS-IU-EQUO-BATZARRE",41
31,"31059",186,131,131,1,0,"PODEMOS-IU-EQUO-BATZARRE",38
31,"31111",95,65,65,2,0,"PODEMOS-IU-EQUO-BATZARRE",14
31,"31901",15459,11119,11026,108,93,"PODEMOS-IU-EQUO-BATZARRE",3647
31,"31117",620,383,375,3,8,"PODEMOS-IU-EQUO-BATZARRE",49
31,"31095",75,59,59,1,0,"PODEMOS-IU-EQUO-BATZARRE",12
31,"31908",1004,686,682,2,4,"PODEMOS-IU-EQUO-BATZARRE",260
31,"31055",257,175,172,2,3,"PODEMOS-IU-EQUO-BATZARRE",50
31,"31090",144,77,77,1,0,"PODEMOS-IU-EQUO-BATZARRE",16
31,"31129",395,234,234,0,0,"PODEMOS-IU-EQUO-BATZARRE",38
31,"31041",1606,1114,1101,15,13,"PODEMOS-IU-EQUO-BATZARRE",358
31,"31201",147715,105455,104658,1007,797,"PODEMOS-IU-EQUO-BATZARRE",29417
31,"31157",3518,2298,2267,23,31,"PODEMOS-IU-EQUO-BATZARRE",565
31,"31006",1927,1350,1332,13,18,"PODEMOS-IU-EQUO-BATZARRE",334
31,"31204",36,28,28,1,0,"PODEMOS-IU-EQUO-BATZARRE",4
31,"31152",1328,924,900,11,24,"PODEMOS-IU-EQUO-BATZARRE",246
31,"31196",38,35,35,1,0,"PODEMOS-IU-EQUO-BATZARRE",12
31,"31075",103,63,63,0,0,"PODEMOS-IU-EQUO-BATZARRE",33
31,"31007",131,87,86,1,1,"PODEMOS-IU-EQUO-BATZARRE",22
31,"31263",233,138,137,2,1,"PODEMOS-IU-EQUO-BATZARRE",40
31,"31156",251,189,188,0,1,"PODEMOS-IU-EQUO-BATZARRE",73
31,"31191",3016,2167,2147,22,20,"PODEMOS-IU-EQUO-BATZARRE",636
31,"31046",57,39,39,1,0,"PODEMOS-IU-EQUO-BATZARRE",3
31,"31199",146,92,89,3,3,"PODEMOS-IU-EQUO-BATZARRE",12
31,"31160",106,89,88,2,1,"PODEMOS-IU-EQUO-BATZARRE",25
31,"31026",144,118,117,0,1,"PODEMOS-IU-EQUO-BATZARRE",17
31,"31066",855,589,579,8,10,"PODEMOS-IU-EQUO-BATZARRE",98
31,"31146",35,30,29,1,1,"PODEMOS-IU-EQUO-BATZARRE",3
31,"31061",54,49,49,0,0,"PODEMOS-IU-EQUO-BATZARRE",5
31,"31168",246,172,171,1,1,"PODEMOS-IU-EQUO-BATZARRE",38
31,"31194",311,217,216,3,1,"PODEMOS-IU-EQUO-BATZARRE",72
31,"31064",1424,1121,1104,3,17,"PODEMOS-IU-EQUO-BATZARRE",232
31,"31121",62,44,43,0,1,"PODEMOS-IU-EQUO-BATZARRE",14
31,"31018",393,292,285,4,7,"PODEMOS-IU-EQUO-BATZARRE",92
31,"31189",1161,720,709,6,11,"PODEMOS-IU-EQUO-BATZARRE",203
31,"31254",1915,1428,1411,3,17,"PODEMOS-IU-EQUO-BATZARRE",322
31,"31143",96,55,54,1,1,"PODEMOS-IU-EQUO-BATZARRE",9
31,"31260",1238,794,788,12,6,"PODEMOS-IU-EQUO-BATZARRE",208
31,"31159",1107,844,833,6,11,"PODEMOS-IU-EQUO-BATZARRE",265
31,"31003",122,87,87,0,0,"PODEMOS-IU-EQUO-BATZARRE",20
31,"31126",358,223,223,2,0,"PODEMOS-IU-EQUO-BATZARRE",68
31,"31103",42,34,34,2,0,"PODEMOS-IU-EQUO-BATZARRE",3
31,"31092",662,439,435,4,4,"PODEMOS-IU-EQUO-BATZARRE",121
31,"31202",4305,2845,2803,31,42,"PODEMOS-IU-EQUO-BATZARRE",749
31,"31223",985,704,698,4,6,"PODEMOS-IU-EQUO-BATZARRE",161
31,"31084",1940,1293,1274,16,19,"PODEMOS-IU-EQUO-BATZARRE",317
31,"31173",861,683,667,3,16,"PODEMOS-IU-EQUO-BATZARRE",95
31,"31175",71,48,48,0,0,"PODEMOS-IU-EQUO-BATZARRE",11
31,"31013",642,406,401,1,5,"PODEMOS-IU-EQUO-BATZARRE",156
31,"31023",6956,5310,5289,85,21,"PODEMOS-IU-EQUO-BATZARRE",1516
31,"31243",306,224,221,2,3,"PODEMOS-IU-EQUO-BATZARRE",80
31,"31124",208,148,148,2,0,"PODEMOS-IU-EQUO-BATZARRE",30
31,"31248",299,165,162,0,3,"PODEMOS-IU-EQUO-BATZARRE",25
31,"31138",932,601,599,2,2,"PODEMOS-IU-EQUO-BATZARRE",137
31,"31171",680,495,486,8,9,"PODEMOS-IU-EQUO-BATZARRE",170
31,"31049",699,469,465,2,4,"PODEMOS-IU-EQUO-BATZARRE",138
31,"31226",591,342,340,2,2,"PODEMOS-IU-EQUO-BATZARRE",113
31,"31091",351,220,217,1,3,"PODEMOS-IU-EQUO-BATZARRE",53
31,"31207",273,182,177,2,5,"PODEMOS-IU-EQUO-BATZARRE",46
31,"31035",59,45,43,0,2,"PODEMOS-IU-EQUO-BATZARRE",5
31,"31150",213,156,155,1,1,"PODEMOS-IU-EQUO-BATZARRE",65
31,"31021",62,39,38,0,1,"PODEMOS-IU-EQUO-BATZARRE",11
31,"31042",2714,1974,1942,22,32,"PODEMOS-IU-EQUO-BATZARRE",237
31,"31012",793,563,555,6,8,"PODEMOS-IU-EQUO-BATZARRE",166
31,"31100",262,170,168,1,2,"PODEMOS-IU-EQUO-BATZARRE",38
31,"31078",2429,1795,1767,15,28,"PODEMOS-IU-EQUO-BATZARRE",429
31,"31072",5279,3734,3679,40,55,"PODEMOS-IU-EQUO-BATZARRE",700
31,"31246",140,111,107,1,4,"PODEMOS-IU-EQUO-BATZARRE",27
31,"31179",502,348,345,0,3,"PODEMOS-IU-EQUO-BATZARRE",66
31,"31106",698,533,529,3,4,"PODEMOS-IU-EQUO-BATZARRE",87
31,"31217",321,226,223,1,3,"PODEMOS-IU-EQUO-BATZARRE",55
31,"31161",338,264,259,2,5,"PODEMOS-IU-EQUO-BATZARRE",103
31,"31221",1214,798,786,12,12,"PODEMOS-IU-EQUO-BATZARRE",216
31,"31134",176,125,124,0,1,"PODEMOS-IU-EQUO-BATZARRE",33
31,"31047",254,191,188,2,3,"PODEMOS-IU-EQUO-BATZARRE",23
31,"31236",1320,865,854,5,11,"PODEMOS-IU-EQUO-BATZARRE",247
31,"31073",294,212,208,2,4,"PODEMOS-IU-EQUO-BATZARRE",50
31,"31258",7879,5707,5666,50,41,"PODEMOS-IU-EQUO-BATZARRE",2075
31,"31014",275,194,192,4,2,"PODEMOS-IU-EQUO-BATZARRE",60
31,"31210",196,152,152,2,0,"PODEMOS-IU-EQUO-BATZARRE",24
31,"31176",2869,2010,1963,33,47,"PODEMOS-IU-EQUO-BATZARRE",407
31,"31132",145,109,109,0,0,"PODEMOS-IU-EQUO-BATZARRE",10
31,"31206",2090,1461,1440,22,21,"PODEMOS-IU-EQUO-BATZARRE",399
31,"31009",677,507,505,5,2,"PODEMOS-IU-EQUO-BATZARRE",199
31,"31252",87,61,61,0,0,"PODEMOS-IU-EQUO-BATZARRE",16
31,"31256",107,59,59,0,0,"PODEMOS-IU-EQUO-BATZARRE",9
31,"31164",568,421,417,5,4,"PODEMOS-IU-EQUO-BATZARRE",79
31,"31905",2843,1983,1966,15,17,"PODEMOS-IU-EQUO-BATZARRE",703
31,"31002",414,288,287,3,1,"PODEMOS-IU-EQUO-BATZARRE",100
31,"31211",27,15,15,1,0,"PODEMOS-IU-EQUO-BATZARRE",0
31,"31182",34,28,28,0,0,"PODEMOS-IU-EQUO-BATZARRE",10
31,"31198",37,25,25,0,0,"PODEMOS-IU-EQUO-BATZARRE",9
31,"31115",165,102,101,1,1,"PODEMOS-IU-EQUO-BATZARRE",25
31,"31193",1426,1024,1013,13,11,"PODEMOS-IU-EQUO-BATZARRE",347
31,"31227",8180,5885,5809,76,76,"PODEMOS-IU-EQUO-BATZARRE",2012
31,"31219",84,66,66,0,0,"PODEMOS-IU-EQUO-BATZARRE",17
31,"31135",106,70,66,2,4,"PODEMOS-IU-EQUO-BATZARRE",4
31,"31024",99,42,42,0,0,"PODEMOS-IU-EQUO-BATZARRE",13
31,"31057",1781,1287,1268,10,19,"PODEMOS-IU-EQUO-BATZARRE",225
31,"31085",480,350,350,2,0,"PODEMOS-IU-EQUO-BATZARRE",153
31,"31170",47,42,42,3,0,"PODEMOS-IU-EQUO-BATZARRE",12
31,"31094",111,82,82,0,0,"PODEMOS-IU-EQUO-BATZARRE",9
31,"31110",91,61,58,1,3,"PODEMOS-IU-EQUO-BATZARRE",21
31,"31098",1903,1428,1419,19,9,"PODEMOS-IU-EQUO-BATZARRE",444
31,"31188",235,161,161,2,0,"PODEMOS-IU-EQUO-BATZARRE",51
31,"31239",322,211,211,5,0,"PODEMOS-IU-EQUO-BATZARRE",36
31,"31142",1403,958,949,10,9,"PODEMOS-IU-EQUO-BATZARRE",189
31,"31083",52,37,37,0,0,"PODEMOS-IU-EQUO-BATZARRE",13
31,"31183",691,544,542,4,2,"PODEMOS-IU-EQUO-BATZARRE",139
31,"31151",66,46,46,1,0,"PODEMOS-IU-EQUO-BATZARRE",16
31,"31051",251,170,170,2,0,"PODEMOS-IU-EQUO-BATZARRE",44
31,"31027",836,532,530,2,2,"PODEMOS-IU-EQUO-BATZARRE",98
31,"31163",2013,1418,1383,13,35,"PODEMOS-IU-EQUO-BATZARRE",272
31,"31017",358,242,239,0,3,"PODEMOS-IU-EQUO-BATZARRE",64
31,"31032",1713,1209,1193,24,16,"PODEMOS-IU-EQUO-BATZARRE",270
31,"31123",647,369,361,5,8,"PODEMOS-IU-EQUO-BATZARRE",91
31,"31167",826,606,596,9,10,"PODEMOS-IU-EQUO-BATZARRE",183
31,"31165",2780,1995,1960,30,35,"PODEMOS-IU-EQUO-BATZARRE",454
31,"31044",289,230,227,1,3,"PODEMOS-IU-EQUO-BATZARRE",45
31,"31043",38,31,30,1,1,"PODEMOS-IU-EQUO-BATZARRE",1
31,"31147",100,82,82,2,0,"PODEMOS-IU-EQUO-BATZARRE",20
31,"31070",2638,1808,1784,20,24,"PODEMOS-IU-EQUO-BATZARRE",460
31,"31001",88,62,62,0,0,"PODEMOS-IU-EQUO-BATZARRE",18
31,"31082",617,371,365,10,6,"PODEMOS-IU-EQUO-BATZARRE",135
31,"31139",159,96,95,0,1,"PODEMOS-IU-EQUO-BATZARRE",24
31,"31190",45,34,32,2,2,"PODEMOS-IU-EQUO-BATZARRE",2
31,"31030",141,100,99,0,1,"PODEMOS-IU-EQUO-BATZARRE",37
31,"31119",39,26,26,0,0,"PODEMOS-IU-EQUO-BATZARRE",8
31,"31187",111,68,63,1,5,"PODEMOS-IU-EQUO-BATZARRE",18
31,"31120",388,250,249,3,1,"PODEMOS-IU-EQUO-BATZARRE",83
31,"31145",172,128,128,4,0,"PODEMOS-IU-EQUO-BATZARRE",11
31,"31130",312,214,213,3,1,"PODEMOS-IU-EQUO-BATZARRE",55
31,"31233",97,74,74,0,0,"PODEMOS-IU-EQUO-BATZARRE",9
31,"31034",37,25,25,0,0,"PODEMOS-IU-EQUO-BATZARRE",7
31,"31038",1339,957,942,11,15,"PODEMOS-IU-EQUO-BATZARRE",239
31,"31257",875,634,625,8,9,"PODEMOS-IU-EQUO-BATZARRE",190
31,"31050",6014,3489,3450,57,39,"PODEMOS-IU-EQUO-BATZARRE",812
31,"31128",359,265,263,0,2,"PODEMOS-IU-EQUO-BATZARRE",74
31,"31906",2562,1800,1779,26,21,"PODEMOS-IU-EQUO-BATZARRE",680
31,"31186",299,195,194,3,1,"PODEMOS-IU-EQUO-BATZARRE",62
31,"31185",494,341,341,1,0,"PODEMOS-IU-EQUO-BATZARRE",58
31,"31131",901,646,638,7,8,"PODEMOS-IU-EQUO-BATZARRE",152
31,"31036",909,636,628,7,8,"PODEMOS-IU-EQUO-BATZARRE",175
31,"31261",231,173,169,3,4,"PODEMOS-IU-EQUO-BATZARRE",41
31,"31060",13744,9400,9320,72,80,"PODEMOS-IU-EQUO-BATZARRE",3421
31,"31149",2305,1461,1441,8,20,"PODEMOS-IU-EQUO-BATZARRE",378
31,"31020",449,228,228,3,0,"PODEMOS-IU-EQUO-BATZARRE",73
31,"31065",1878,1351,1326,20,25,"PODEMOS-IU-EQUO-BATZARRE",316
31,"31080",508,391,385,3,6,"PODEMOS-IU-EQUO-BATZARRE",130
31,"31029",914,638,625,6,13,"PODEMOS-IU-EQUO-BATZARRE",157
31,"31052",96,62,61,0,1,"PODEMOS-IU-EQUO-BATZARRE",21
31,"31086",13188,9713,9642,111,71,"PODEMOS-IU-EQUO-BATZARRE",3257
31,"31192",156,129,127,3,2,"PODEMOS-IU-EQUO-BATZARRE",56
31,"31037",84,66,66,1,0,"PODEMOS-IU-EQUO-BATZARRE",15
31,"31214",91,64,62,1,2,"PODEMOS-IU-EQUO-BATZARRE",15
31,"31108",1855,1368,1348,7,20,"PODEMOS-IU-EQUO-BATZARRE",225
31,"31264",180,105,101,2,4,"PODEMOS-IU-EQUO-BATZARRE",29
31,"31205",427,299,297,4,2,"PODEMOS-IU-EQUO-BATZARRE",82
31,"31265",82,53,53,2,0,"PODEMOS-IU-EQUO-BATZARRE",14
31,"31247",151,114,113,0,1,"PODEMOS-IU-EQUO-BATZARRE",18
31,"31022",518,332,331,4,1,"PODEMOS-IU-EQUO-BATZARRE",88
31,"31166",258,181,181,1,0,"PODEMOS-IU-EQUO-BATZARRE",39
31,"31181",145,112,112,0,0,"PODEMOS-IU-EQUO-BATZARRE",12
31,"31907",10745,8067,8009,116,58,"PODEMOS-IU-EQUO-BATZARRE",2719
31,"31249",1872,1290,1273,14,17,"PODEMOS-IU-EQUO-BATZARRE",260
31,"31197",69,56,56,2,0,"PODEMOS-IU-EQUO-BATZARRE",15
31,"31079",73,54,53,0,1,"PODEMOS-IU-EQUO-BATZARRE",16
31,"31015",1994,1412,1392,25,20,"PODEMOS-IU-EQUO-BATZARRE",340
31,"31097",10410,7082,7002,75,80,"PODEMOS-IU-EQUO-BATZARRE",1808
31,"31902",4405,3092,3061,25,31,"PODEMOS-IU-EQUO-BATZARRE",1020
31,"31045",508,355,350,8,5,"PODEMOS-IU-EQUO-BATZARRE",137
31,"31244",158,87,86,1,1,"PODEMOS-IU-EQUO-BATZARRE",11
31,"31141",110,71,70,1,1,"PODEMOS-IU-EQUO-BATZARRE",16
31,"31113",133,87,86,0,1,"PODEMOS-IU-EQUO-BATZARRE",21
31,"31220",744,583,579,8,4,"PODEMOS-IU-EQUO-BATZARRE",102
31,"31253",129,109,109,0,0,"PODEMOS-IU-EQUO-BATZARRE",42
31,"31114",366,245,241,8,4,"PODEMOS-IU-EQUO-BATZARRE",96
31,"31112",89,62,62,0,0,"PODEMOS-IU-EQUO-BATZARRE",20
31,"31048",176,132,130,4,2,"PODEMOS-IU-EQUO-BATZARRE",13
31,"31104",1834,1257,1235,16,22,"PODEMOS-IU-EQUO-BATZARRE",348
31,"31212",147,102,102,4,0,"PODEMOS-IU-EQUO-BATZARRE",18
31,"31053",523,372,368,1,4,"PODEMOS-IU-EQUO-BATZARRE",101
31,"31039",80,61,60,0,1,"PODEMOS-IU-EQUO-BATZARRE",16
31,"31076",2417,1918,1906,9,12,"PODEMOS-IU-EQUO-BATZARRE",300
31,"31228",486,341,337,2,4,"PODEMOS-IU-EQUO-BATZARRE",105
31,"31010",5705,3718,3680,29,38,"PODEMOS-IU-EQUO-BATZARRE",1283
31,"31081",338,216,212,4,4,"PODEMOS-IU-EQUO-BATZARRE",42
31,"31225",36,27,27,0,0,"PODEMOS-IU-EQUO-BATZARRE",6
31,"31109",1582,1155,1150,9,5,"PODEMOS-IU-EQUO-BATZARRE",379
31,"31238",112,93,93,0,0,"PODEMOS-IU-EQUO-BATZARRE",34
31,"31213",104,52,52,0,0,"PODEMOS-IU-EQUO-BATZARRE",17
31,"31099",62,47,47,2,0,"PODEMOS-IU-EQUO-BATZARRE",6
31,"31215",4676,3284,3240,36,44,"PODEMOS-IU-EQUO-BATZARRE",558
31,"31231",117,76,73,1,3,"PODEMOS-IU-EQUO-BATZARRE",6
31,"31116",62,51,50,1,1,"PODEMOS-IU-EQUO-BATZARRE",3
31,"31016",7608,5474,5413,50,61,"PODEMOS-IU-EQUO-BATZARRE",2273
31,"31174",110,63,63,0,0,"PODEMOS-IU-EQUO-BATZARRE",19
31,"31169",2193,1472,1445,9,27,"PODEMOS-IU-EQUO-BATZARRE",231
31,"31153",2159,1403,1387,12,16,"PODEMOS-IU-EQUO-BATZARRE",441
31,"31127",138,98,95,0,3,"PODEMOS-IU-EQUO-BATZARRE",19
31,"31195",182,130,128,0,2,"PODEMOS-IU-EQUO-BATZARRE",33
31,"31208",2556,1949,1920,16,29,"PODEMOS-IU-EQUO-BATZARRE",475
31,"31068",2885,2060,2027,20,33,"PODEMOS-IU-EQUO-BATZARRE",465
31,"31087",171,128,124,2,4,"PODEMOS-IU-EQUO-BATZARRE",41
31,"31172",373,278,272,3,6,"PODEMOS-IU-EQUO-BATZARRE",71
31,"31232",25155,17648,17450,196,198,"PODEMOS-IU-EQUO-BATZARRE",4179
31,"31154",224,126,126,3,0,"PODEMOS-IU-EQUO-BATZARRE",44
31,"31180",212,154,154,5,0,"PODEMOS-IU-EQUO-BATZARRE",43
31,"31054",462,255,250,4,5,"PODEMOS-IU-EQUO-BATZARRE",68
49,"49142",249,180,179,0,1,"PODEMOS-IU-EQUO-CLIAS",28
49,"49084",287,229,228,4,1,"PODEMOS-IU-EQUO-CLIAS",43
28,"28902",471,363,356,4,7,"PODEMOS-IU-EQUO-CLIAS",89
49,"49262",392,279,274,1,5,"PODEMOS-IU-EQUO-CLIAS",48
49,"49004",126,100,100,4,0,"PODEMOS-IU-EQUO-CLIAS",9
49,"49016",247,176,174,5,2,"PODEMOS-IU-EQUO-CLIAS",18
49,"49136",318,220,218,1,2,"PODEMOS-IU-EQUO-CLIAS",13
49,"49201",302,270,268,3,2,"PODEMOS-IU-EQUO-CLIAS",25
49,"49040",114,101,101,0,0,"PODEMOS-IU-EQUO-CLIAS",9
49,"49164",155,119,115,2,4,"PODEMOS-IU-EQUO-CLIAS",13
49,"49100",295,212,208,5,4,"PODEMOS-IU-EQUO-CLIAS",23
49,"49123",546,391,384,1,7,"PODEMOS-IU-EQUO-CLIAS",50
28,"28092",151841,110916,109954,582,962,"PODEMOS-IU-EQUO-CLIAS",25416
49,"49135",626,434,430,1,4,"PODEMOS-IU-EQUO-CLIAS",57
28,"28181",20386,16155,16069,57,86,"PODEMOS-IU-EQUO-CLIAS",2097
49,"49162",186,142,140,1,2,"PODEMOS-IU-EQUO-CLIAS",20
49,"49053",931,709,699,8,10,"PODEMOS-IU-EQUO-CLIAS",85
49,"49170",102,72,71,0,1,"PODEMOS-IU-EQUO-CLIAS",8
49,"49021",14330,9878,9758,95,120,"PODEMOS-IU-EQUO-CLIAS",1533
49,"49013",246,182,181,2,1,"PODEMOS-IU-EQUO-CLIAS",22
49,"49275",52210,36205,35754,356,451,"PODEMOS-IU-EQUO-CLIAS",6600
28,"28159",589,468,468,5,0,"PODEMOS-IU-EQUO-CLIAS",57
49,"49120",74,53,52,0,1,"PODEMOS-IU-EQUO-CLIAS",2
28,"28096",18354,13310,13205,68,105,"PODEMOS-IU-EQUO-CLIAS",2283
49,"49194",368,218,216,1,2,"PODEMOS-IU-EQUO-CLIAS",23
49,"49076",321,217,217,2,0,"PODEMOS-IU-EQUO-CLIAS",10
49,"49127",2367,1668,1650,16,18,"PODEMOS-IU-EQUO-CLIAS",311
49,"49256",256,204,204,0,0,"PODEMOS-IU-EQUO-CLIAS",29
49,"49129",853,592,574,9,18,"PODEMOS-IU-EQUO-CLIAS",92
49,"49264",578,383,377,5,6,"PODEMOS-IU-EQUO-CLIAS",35
28,"28093",2096,1670,1653,10,17,"PODEMOS-IU-EQUO-CLIAS",238
28,"28058",139342,100637,99753,634,884,"PODEMOS-IU-EQUO-CLIAS",24316
28,"28126",39,29,29,0,0,"PODEMOS-IU-EQUO-CLIAS",1
49,"49184",172,115,112,0,3,"PODEMOS-IU-EQUO-CLIAS",4
28,"28050",4076,2860,2839,21,21,"PODEMOS-IU-EQUO-CLIAS",476
49,"49249",69,58,58,1,0,"PODEMOS-IU-EQUO-CLIAS",5
49,"49251",163,127,121,1,6,"PODEMOS-IU-EQUO-CLIAS",12
49,"49056",300,211,208,2,3,"PODEMOS-IU-EQUO-CLIAS",19
49,"49005",149,91,91,2,0,"PODEMOS-IU-EQUO-CLIAS",3
28,"28154",5408,3806,3767,16,39,"PODEMOS-IU-EQUO-CLIAS",661
28,"28130",28293,21253,21040,116,213,"PODEMOS-IU-EQUO-CLIAS",5623
28,"28100",4196,2987,2955,14,32,"PODEMOS-IU-EQUO-CLIAS",769
49,"49199",254,193,189,3,4,"PODEMOS-IU-EQUO-CLIAS",34
49,"49272",88,70,69,1,1,"PODEMOS-IU-EQUO-CLIAS",4
49,"49086",115,96,91,0,5,"PODEMOS-IU-EQUO-CLIAS",9
49,"49017",251,180,177,1,3,"PODEMOS-IU-EQUO-CLIAS",17
49,"49002",63,51,49,0,2,"PODEMOS-IU-EQUO-CLIAS",2
28,"28016",79,53,51,0,2,"PODEMOS-IU-EQUO-CLIAS",11
49,"49083",52,44,44,2,0,"PODEMOS-IU-EQUO-CLIAS",1
49,"49114",43,34,33,0,1,"PODEMOS-IU-EQUO-CLIAS",5
49,"49258",114,93,91,2,2,"PODEMOS-IU-EQUO-CLIAS",12
49,"49035",226,200,196,3,4,"PODEMOS-IU-EQUO-CLIAS",28
49,"49095",291,221,220,0,1,"PODEMOS-IU-EQUO-CLIAS",24
49,"49133",304,214,213,1,1,"PODEMOS-IU-EQUO-CLIAS",20
28,"28097",119,94,94,0,0,"PODEMOS-IU-EQUO-CLIAS",22
49,"49010",345,279,273,5,6,"PODEMOS-IU-EQUO-CLIAS",54
49,"49153",174,136,132,0,4,"PODEMOS-IU-EQUO-CLIAS",18
28,"28008",1799,1182,1174,4,8,"PODEMOS-IU-EQUO-CLIAS",211
28,"28162",2617,2029,2016,6,13,"PODEMOS-IU-EQUO-CLIAS",314
28,"28099",1748,1290,1283,7,7,"PODEMOS-IU-EQUO-CLIAS",207
28,"28040",15811,10118,10009,56,109,"PODEMOS-IU-EQUO-CLIAS",2457
49,"49266",76,63,61,2,2,"PODEMOS-IU-EQUO-CLIAS",3
28,"28026",6317,4734,4701,33,33,"PODEMOS-IU-EQUO-CLIAS",918
49,"49117",465,330,324,6,6,"PODEMOS-IU-EQUO-CLIAS",37
49,"49216",162,142,142,0,0,"PODEMOS-IU-EQUO-CLIAS",21
28,"28120",1223,892,884,2,8,"PODEMOS-IU-EQUO-CLIAS",144
28,"28148",85454,62367,61884,370,483,"PODEMOS-IU-EQUO-CLIAS",13772
49,"49131",264,194,192,6,2,"PODEMOS-IU-EQUO-CLIAS",13
49,"49081",1382,1016,1003,9,13,"PODEMOS-IU-EQUO-CLIAS",139
49,"49234",412,328,324,0,4,"PODEMOS-IU-EQUO-CLIAS",28
49,"49189",202,142,142,1,0,"PODEMOS-IU-EQUO-CLIAS",11
49,"49052",187,133,132,1,1,"PODEMOS-IU-EQUO-CLIAS",8
28,"28161",48848,35503,35203,210,300,"PODEMOS-IU-EQUO-CLIAS",7384
49,"49250",1245,935,920,7,15,"PODEMOS-IU-EQUO-CLIAS",78
28,"28072",5709,4356,4324,22,32,"PODEMOS-IU-EQUO-CLIAS",813
49,"49034",432,327,325,2,2,"PODEMOS-IU-EQUO-CLIAS",48
28,"28112",161,136,136,1,0,"PODEMOS-IU-EQUO-CLIAS",19
49,"49118",203,161,160,1,1,"PODEMOS-IU-EQUO-CLIAS",9
49,"49231",330,232,232,2,0,"PODEMOS-IU-EQUO-CLIAS",22
49,"49186",261,188,185,0,3,"PODEMOS-IU-EQUO-CLIAS",14
49,"49132",316,235,232,1,3,"PODEMOS-IU-EQUO-CLIAS",11
49,"49270",133,99,99,1,0,"PODEMOS-IU-EQUO-CLIAS",19
28,"28010",9963,7745,7688,25,57,"PODEMOS-IU-EQUO-CLIAS",1523
28,"28116",704,528,523,2,5,"PODEMOS-IU-EQUO-CLIAS",129
49,"49138",234,184,184,3,0,"PODEMOS-IU-EQUO-CLIAS",15
49,"49137",176,139,138,0,1,"PODEMOS-IU-EQUO-CLIAS",10
28,"28044",5826,4445,4409,24,36,"PODEMOS-IU-EQUO-CLIAS",997
49,"49207",239,150,146,0,4,"PODEMOS-IU-EQUO-CLIAS",14
49,"49122",782,526,520,5,6,"PODEMOS-IU-EQUO-CLIAS",87
49,"49240",206,162,161,2,1,"PODEMOS-IU-EQUO-CLIAS",20
49,"49160",49,33,33,0,0,"PODEMOS-IU-EQUO-CLIAS",1
49,"49214",698,525,512,3,13,"PODEMOS-IU-EQUO-CLIAS",51
49,"49183",100,77,77,2,0,"PODEMOS-IU-EQUO-CLIAS",2
28,"28088",261,178,178,0,0,"PODEMOS-IU-EQUO-CLIAS",46
49,"49241",248,177,177,0,0,"PODEMOS-IU-EQUO-CLIAS",3
28,"28051",1541,1163,1149,1,14,"PODEMOS-IU-EQUO-CLIAS",211
49,"49191",272,213,206,2,7,"PODEMOS-IU-EQUO-CLIAS",23
28,"28030",1726,1320,1299,8,21,"PODEMOS-IU-EQUO-CLIAS",319
49,"49044",80,60,58,0,2,"PODEMOS-IU-EQUO-CLIAS",4
49,"49059",94,64,64,0,0,"PODEMOS-IU-EQUO-CLIAS",4
49,"49237",165,119,117,2,2,"PODEMOS-IU-EQUO-CLIAS",10
28,"28157",609,433,430,1,3,"PODEMOS-IU-EQUO-CLIAS",56
28,"28027",1203,872,857,3,15,"PODEMOS-IU-EQUO-CLIAS",153
28,"28002",3007,2091,2074,14,17,"PODEMOS-IU-EQUO-CLIAS",282
49,"49150",139,112,111,1,1,"PODEMOS-IU-EQUO-CLIAS",5
49,"49098",219,167,165,0,2,"PODEMOS-IU-EQUO-CLIAS",14
49,"49158",215,170,166,2,4,"PODEMOS-IU-EQUO-CLIAS",17
49,"49222",380,279,272,0,7,"PODEMOS-IU-EQUO-CLIAS",52
49,"49029",623,495,488,3,7,"PODEMOS-IU-EQUO-CLIAS",41
28,"28117",104,89,89,1,0,"PODEMOS-IU-EQUO-CLIAS",24
49,"49103",414,330,328,5,2,"PODEMOS-IU-EQUO-CLIAS",36
49,"49204",63,51,51,0,0,"PODEMOS-IU-EQUO-CLIAS",4
49,"49261",1537,1048,1033,8,15,"PODEMOS-IU-EQUO-CLIAS",185
28,"28166",320,254,251,2,3,"PODEMOS-IU-EQUO-CLIAS",52
49,"49245",262,176,173,2,3,"PODEMOS-IU-EQUO-CLIAS",36
49,"49067",367,250,249,0,1,"PODEMOS-IU-EQUO-CLIAS",16
28,"28013",40471,28739,28490,188,249,"PODEMOS-IU-EQUO-CLIAS",5963
28,"28004",6234,4202,4167,16,35,"PODEMOS-IU-EQUO-CLIAS",770
49,"49227",315,230,228,2,2,"PODEMOS-IU-EQUO-CLIAS",30
49,"49063",338,272,266,4,6,"PODEMOS-IU-EQUO-CLIAS",24
28,"28171",4239,2848,2820,19,28,"PODEMOS-IU-EQUO-CLIAS",380
28,"28087",3186,2503,2487,19,16,"PODEMOS-IU-EQUO-CLIAS",429
49,"49155",79,61,60,3,1,"PODEMOS-IU-EQUO-CLIAS",3
49,"49043",289,217,213,1,4,"PODEMOS-IU-EQUO-CLIAS",21
28,"28183",1039,743,735,2,8,"PODEMOS-IU-EQUO-CLIAS",226
49,"49093",280,223,222,1,1,"PODEMOS-IU-EQUO-CLIAS",13
49,"49205",382,293,291,2,2,"PODEMOS-IU-EQUO-CLIAS",17
49,"49019",243,188,182,2,6,"PODEMOS-IU-EQUO-CLIAS",19
28,"28901",799,558,554,0,4,"PODEMOS-IU-EQUO-CLIAS",134
28,"28001",61,46,45,0,1,"PODEMOS-IU-EQUO-CLIAS",8
49,"49088",87,61,60,0,1,"PODEMOS-IU-EQUO-CLIAS",2
49,"49007",370,255,249,1,6,"PODEMOS-IU-EQUO-CLIAS",40
49,"49094",224,149,149,2,0,"PODEMOS-IU-EQUO-CLIAS",23
28,"28039",128,98,97,2,1,"PODEMOS-IU-EQUO-CLIAS",18
49,"49126",235,155,154,2,1,"PODEMOS-IU-EQUO-CLIAS",19
49,"49036",506,374,367,2,7,"PODEMOS-IU-EQUO-CLIAS",67
28,"28017",1208,907,899,7,8,"PODEMOS-IU-EQUO-CLIAS",246
28,"28153",697,499,499,1,0,"PODEMOS-IU-EQUO-CLIAS",191
28,"28174",1795,1232,1221,7,11,"PODEMOS-IU-EQUO-CLIAS",174
49,"49064",515,346,338,6,8,"PODEMOS-IU-EQUO-CLIAS",41
49,"49115",184,136,135,0,1,"PODEMOS-IU-EQUO-CLIAS",13
49,"49230",97,72,72,0,0,"PODEMOS-IU-EQUO-CLIAS",6
49,"49179",371,238,237,0,1,"PODEMOS-IU-EQUO-CLIAS",18
49,"49037",185,153,151,0,2,"PODEMOS-IU-EQUO-CLIAS",11
49,"49090",197,143,141,6,2,"PODEMOS-IU-EQUO-CLIAS",11
28,"28059",4323,3171,3157,11,14,"PODEMOS-IU-EQUO-CLIAS",551
49,"49193",467,313,308,4,5,"PODEMOS-IU-EQUO-CLIAS",33
28,"28009",14086,10611,10545,57,66,"PODEMOS-IU-EQUO-CLIAS",1755
28,"28056",863,630,617,4,13,"PODEMOS-IU-EQUO-CLIAS",184
28,"28127",64827,51776,51613,220,163,"PODEMOS-IU-EQUO-CLIAS",6208
49,"49009",393,293,288,2,5,"PODEMOS-IU-EQUO-CLIAS",33
49,"49180",148,103,102,2,1,"PODEMOS-IU-EQUO-CLIAS",16
49,"49265",128,91,91,1,0,"PODEMOS-IU-EQUO-CLIAS",3
49,"49172",527,347,343,1,4,"PODEMOS-IU-EQUO-CLIAS",13
28,"28158",665,537,533,4,4,"PODEMOS-IU-EQUO-CLIAS",91
49,"49232",96,74,74,1,0,"PODEMOS-IU-EQUO-CLIAS",6
28,"28131",12990,9512,9433,38,79,"PODEMOS-IU-EQUO-CLIAS",1859
49,"49181",362,277,276,2,1,"PODEMOS-IU-EQUO-CLIAS",16
28,"28025",420,320,315,4,5,"PODEMOS-IU-EQUO-CLIAS",43
49,"49121",365,273,273,2,0,"PODEMOS-IU-EQUO-CLIAS",44
49,"49026",226,179,176,0,3,"PODEMOS-IU-EQUO-CLIAS",13
28,"28155",506,416,411,0,5,"PODEMOS-IU-EQUO-CLIAS",50
49,"49244",43,29,29,0,0,"PODEMOS-IU-EQUO-CLIAS",2
28,"28129",8030,5986,5941,42,45,"PODEMOS-IU-EQUO-CLIAS",991
28,"28152",16093,12945,12877,58,68,"PODEMOS-IU-EQUO-CLIAS",1702
49,"49173",375,230,221,3,9,"PODEMOS-IU-EQUO-CLIAS",17
49,"49048",124,97,95,0,2,"PODEMOS-IU-EQUO-CLIAS",3
28,"28011",442,317,316,1,1,"PODEMOS-IU-EQUO-CLIAS",66
28,"28146",1787,1205,1194,0,11,"PODEMOS-IU-EQUO-CLIAS",188
49,"49023",967,673,662,10,11,"PODEMOS-IU-EQUO-CLIAS",68
28,"28095",1529,1119,1106,6,13,"PODEMOS-IU-EQUO-CLIAS",253
28,"28150",3087,2294,2277,10,17,"PODEMOS-IU-EQUO-CLIAS",462
49,"49157",206,163,160,2,3,"PODEMOS-IU-EQUO-CLIAS",21
28,"28029",520,408,406,0,2,"PODEMOS-IU-EQUO-CLIAS",97
49,"49197",175,123,123,1,0,"PODEMOS-IU-EQUO-CLIAS",22
28,"28049",58480,45136,44820,242,316,"PODEMOS-IU-EQUO-CLIAS",12076
49,"49174",125,95,92,1,3,"PODEMOS-IU-EQUO-CLIAS",9
28,"28007",124592,94222,93521,491,701,"PODEMOS-IU-EQUO-CLIAS",21020
49,"49255",418,319,316,1,3,"PODEMOS-IU-EQUO-CLIAS",29
49,"49008",460,332,331,5,1,"PODEMOS-IU-EQUO-CLIAS",29
49,"49203",313,240,232,0,8,"PODEMOS-IU-EQUO-CLIAS",4
28,"28163",442,344,339,1,5,"PODEMOS-IU-EQUO-CLIAS",86
28,"28182",210,171,169,0,2,"PODEMOS-IU-EQUO-CLIAS",49
28,"28006",78966,59065,58698,267,367,"PODEMOS-IU-EQUO-CLIAS",10562
28,"28024",151,125,124,1,1,"PODEMOS-IU-EQUO-CLIAS",19
49,"49238",254,194,193,1,1,"PODEMOS-IU-EQUO-CLIAS",12
28,"28021",554,370,364,3,6,"PODEMOS-IU-EQUO-CLIAS",122
49,"49246",227,190,183,2,7,"PODEMOS-IU-EQUO-CLIAS",11
49,"49171",646,514,508,10,6,"PODEMOS-IU-EQUO-CLIAS",60
49,"49268",403,313,309,1,4,"PODEMOS-IU-EQUO-CLIAS",15
28,"28108",3374,2482,2465,10,17,"PODEMOS-IU-EQUO-CLIAS",560
28,"28109",1576,1103,1098,1,5,"PODEMOS-IU-EQUO-CLIAS",188
28,"28151",3142,2235,2199,8,36,"PODEMOS-IU-EQUO-CLIAS",419
49,"49062",122,90,89,0,1,"PODEMOS-IU-EQUO-CLIAS",10
28,"28031",2048,1500,1486,3,14,"PODEMOS-IU-EQUO-CLIAS",184
28,"28121",198,160,158,1,2,"PODEMOS-IU-EQUO-CLIAS",17
49,"49239",663,458,448,3,10,"PODEMOS-IU-EQUO-CLIAS",51
28,"28118",57,46,45,0,1,"PODEMOS-IU-EQUO-CLIAS",10
28,"28094",865,624,622,4,2,"PODEMOS-IU-EQUO-CLIAS",195
49,"49176",667,433,431,1,2,"PODEMOS-IU-EQUO-CLIAS",17
49,"49152",525,339,334,2,5,"PODEMOS-IU-EQUO-CLIAS",44
49,"49190",63,47,45,0,2,"PODEMOS-IU-EQUO-CLIAS",2
49,"49054",894,617,601,13,16,"PODEMOS-IU-EQUO-CLIAS",60
49,"49263",51,36,36,0,0,"PODEMOS-IU-EQUO-CLIAS",0
28,"28082",5683,4324,4286,25,38,"PODEMOS-IU-EQUO-CLIAS",1350
28,"28135",948,713,709,4,4,"PODEMOS-IU-EQUO-CLIAS",168
28,"28020",145,94,94,0,0,"PODEMOS-IU-EQUO-CLIAS",36
49,"49075",137,120,119,0,1,"PODEMOS-IU-EQUO-CLIAS",0
49,"49119",227,169,168,0,1,"PODEMOS-IU-EQUO-CLIAS",36
28,"28156",1019,742,738,3,4,"PODEMOS-IU-EQUO-CLIAS",139
49,"49259",89,66,65,1,1,"PODEMOS-IU-EQUO-CLIAS",1
49,"49080",685,520,514,2,6,"PODEMOS-IU-EQUO-CLIAS",52
49,"49055",102,82,82,2,0,"PODEMOS-IU-EQUO-CLIAS",6
28,"28036",2539,1899,1878,11,21,"PODEMOS-IU-EQUO-CLIAS",504
28,"28048",500,391,387,3,4,"PODEMOS-IU-EQUO-CLIAS",122
49,"49027",140,112,108,1,4,"PODEMOS-IU-EQUO-CLIAS",10
49,"49233",93,58,55,0,3,"PODEMOS-IU-EQUO-CLIAS",0
49,"49166",1227,946,933,6,13,"PODEMOS-IU-EQUO-CLIAS",193
49,"49167",197,147,145,0,2,"PODEMOS-IU-EQUO-CLIAS",21
28,"28086",5154,3530,3493,13,37,"PODEMOS-IU-EQUO-CLIAS",607
28,"28046",4460,3447,3422,16,25,"PODEMOS-IU-EQUO-CLIAS",720
28,"28083",8939,6396,6348,38,48,"PODEMOS-IU-EQUO-CLIAS",1372
28,"28055",916,693,687,5,6,"PODEMOS-IU-EQUO-CLIAS",60
28,"28132",11685,8130,8062,56,68,"PODEMOS-IU-EQUO-CLIAS",1801
28,"28003",173,141,141,0,0,"PODEMOS-IU-EQUO-CLIAS",27
49,"49046",268,203,203,0,0,"PODEMOS-IU-EQUO-CLIAS",21
28,"28104",14040,11151,11096,57,55,"PODEMOS-IU-EQUO-CLIAS",1972
28,"28144",6010,4676,4644,22,32,"PODEMOS-IU-EQUO-CLIAS",826
49,"49041",432,326,322,5,4,"PODEMOS-IU-EQUO-CLIAS",36
28,"28037",1559,1177,1166,5,11,"PODEMOS-IU-EQUO-CLIAS",153
49,"49257",291,190,184,1,6,"PODEMOS-IU-EQUO-CLIAS",25
28,"28062",292,231,226,1,5,"PODEMOS-IU-EQUO-CLIAS",42
49,"49243",111,94,93,0,1,"PODEMOS-IU-EQUO-CLIAS",11
28,"28063",258,194,193,1,1,"PODEMOS-IU-EQUO-CLIAS",47
49,"49209",505,342,341,2,1,"PODEMOS-IU-EQUO-CLIAS",19
49,"49269",229,165,162,1,3,"PODEMOS-IU-EQUO-CLIAS",11
28,"28080",48554,38885,38691,164,194,"PODEMOS-IU-EQUO-CLIAS",4277
28,"28106",76907,52773,52265,385,508,"PODEMOS-IU-EQUO-CLIAS",14191
28,"28028",1755,1353,1344,6,9,"PODEMOS-IU-EQUO-CLIAS",498
49,"49006",154,99,95,0,4,"PODEMOS-IU-EQUO-CLIAS",11
28,"28180",5251,3927,3893,7,34,"PODEMOS-IU-EQUO-CLIAS",613
49,"49177",278,179,177,1,2,"PODEMOS-IU-EQUO-CLIAS",23
49,"49096",170,131,124,2,7,"PODEMOS-IU-EQUO-CLIAS",14
49,"49224",162,112,112,1,0,"PODEMOS-IU-EQUO-CLIAS",20
49,"49011",232,168,165,6,3,"PODEMOS-IU-EQUO-CLIAS",20
28,"28177",10270,8083,8030,36,53,"PODEMOS-IU-EQUO-CLIAS",1078
49,"49225",147,91,90,0,1,"PODEMOS-IU-EQUO-CLIAS",13
28,"28178",1065,824,818,5,6,"PODEMOS-IU-EQUO-CLIAS",143
49,"49101",153,102,99,0,3,"PODEMOS-IU-EQUO-CLIAS",9
28,"28064",129,106,106,2,0,"PODEMOS-IU-EQUO-CLIAS",8
49,"49079",106,93,92,1,1,"PODEMOS-IU-EQUO-CLIAS",8
49,"49220",135,110,109,0,1,"PODEMOS-IU-EQUO-CLIAS",13
28,"28122",513,375,370,2,5,"PODEMOS-IU-EQUO-CLIAS",60
49,"49128",552,423,414,3,9,"PODEMOS-IU-EQUO-CLIAS",44
28,"28073",12549,8788,8701,54,87,"PODEMOS-IU-EQUO-CLIAS",1875
28,"28147",963,722,720,5,2,"PODEMOS-IU-EQUO-CLIAS",146
49,"49012",73,43,43,0,0,"PODEMOS-IU-EQUO-CLIAS",5
28,"28005",134246,99236,98481,583,755,"PODEMOS-IU-EQUO-CLIAS",20960
49,"49146",295,216,213,3,3,"PODEMOS-IU-EQUO-CLIAS",38
49,"49020",289,214,214,2,0,"PODEMOS-IU-EQUO-CLIAS",37
49,"49032",326,259,259,1,0,"PODEMOS-IU-EQUO-CLIAS",15
28,"28071",60,55,53,1,2,"PODEMOS-IU-EQUO-CLIAS",7
49,"49065",1103,836,818,2,18,"PODEMOS-IU-EQUO-CLIAS",58
49,"49069",367,258,254,5,4,"PODEMOS-IU-EQUO-CLIAS",13
49,"49260",755,590,586,8,4,"PODEMOS-IU-EQUO-CLIAS",50
49,"49061",150,114,112,2,2,"PODEMOS-IU-EQUO-CLIAS",13
49,"49018",329,261,256,2,5,"PODEMOS-IU-EQUO-CLIAS",14
28,"28136",647,528,518,2,10,"PODEMOS-IU-EQUO-CLIAS",91
28,"28034",361,274,269,1,5,"PODEMOS-IU-EQUO-CLIAS",42
28,"28167",8356,6158,6106,46,52,"PODEMOS-IU-EQUO-CLIAS",1500
28,"28041",4524,3508,3490,20,18,"PODEMOS-IU-EQUO-CLIAS",586
49,"49022",288,229,225,3,4,"PODEMOS-IU-EQUO-CLIAS",34
28,"28091",5440,3596,3558,24,38,"PODEMOS-IU-EQUO-CLIAS",730
28,"28069",50,44,41,0,3,"PODEMOS-IU-EQUO-CLIAS",12
28,"28125",3002,2180,2163,11,17,"PODEMOS-IU-EQUO-CLIAS",397
49,"49104",343,234,232,0,2,"PODEMOS-IU-EQUO-CLIAS",9
28,"28176",12491,9723,9667,37,56,"PODEMOS-IU-EQUO-CLIAS",1085
28,"28038",4952,3730,3688,34,42,"PODEMOS-IU-EQUO-CLIAS",954
28,"28143",72,57,57,1,0,"PODEMOS-IU-EQUO-CLIAS",2
49,"49047",107,75,75,0,0,"PODEMOS-IU-EQUO-CLIAS",5
49,"49210",471,370,365,1,5,"PODEMOS-IU-EQUO-CLIAS",62
28,"28060",1510,1134,1117,1,17,"PODEMOS-IU-EQUO-CLIAS",230
49,"49228",54,44,43,0,1,"PODEMOS-IU-EQUO-CLIAS",0
49,"49058",307,237,233,0,4,"PODEMOS-IU-EQUO-CLIAS",8
49,"49267",88,73,69,2,4,"PODEMOS-IU-EQUO-CLIAS",9
28,"28076",398,325,317,1,8,"PODEMOS-IU-EQUO-CLIAS",60
28,"28168",1237,884,880,4,4,"PODEMOS-IU-EQUO-CLIAS",201
28,"28057",1458,1097,1088,3,9,"PODEMOS-IU-EQUO-CLIAS",221
28,"28123",57078,45270,44992,215,278,"PODEMOS-IU-EQUO-CLIAS",15314
28,"28119",2092,1590,1582,12,8,"PODEMOS-IU-EQUO-CLIAS",270
49,"49175",230,172,171,1,1,"PODEMOS-IU-EQUO-CLIAS",14
28,"28065",126539,96997,96210,505,787,"PODEMOS-IU-EQUO-CLIAS",25592
49,"49226",255,198,195,0,3,"PODEMOS-IU-EQUO-CLIAS",24
28,"28074",138947,103687,102762,620,925,"PODEMOS-IU-EQUO-CLIAS",25940
28,"28175",863,670,668,5,2,"PODEMOS-IU-EQUO-CLIAS",144
49,"49141",340,248,246,0,2,"PODEMOS-IU-EQUO-CLIAS",28
49,"49139",171,135,135,0,0,"PODEMOS-IU-EQUO-CLIAS",17
28,"28079",2362038,1743924,1733354,8859,10570,"PODEMOS-IU-EQUO-CLIAS",367526
49,"49024",672,459,454,5,5,"PODEMOS-IU-EQUO-CLIAS",50
49,"49028",115,104,103,1,1,"PODEMOS-IU-EQUO-CLIAS",8
49,"49124",253,174,169,1,5,"PODEMOS-IU-EQUO-CLIAS",27
28,"28089",3677,2748,2730,10,18,"PODEMOS-IU-EQUO-CLIAS",465
49,"49116",383,276,269,3,7,"PODEMOS-IU-EQUO-CLIAS",27
49,"49247",443,283,279,2,4,"PODEMOS-IU-EQUO-CLIAS",31
49,"49113",167,137,135,1,2,"PODEMOS-IU-EQUO-CLIAS",5
49,"49151",619,459,456,2,3,"PODEMOS-IU-EQUO-CLIAS",86
28,"28075",5621,4186,4148,26,38,"PODEMOS-IU-EQUO-CLIAS",982
28,"28170",2472,1640,1622,13,18,"PODEMOS-IU-EQUO-CLIAS",310
49,"49038",99,71,65,1,6,"PODEMOS-IU-EQUO-CLIAS",10
28,"28068",10955,8136,8076,49,60,"PODEMOS-IU-EQUO-CLIAS",1415
49,"49168",93,74,74,0,0,"PODEMOS-IU-EQUO-CLIAS",3
49,"49109",619,483,483,11,0,"PODEMOS-IU-EQUO-CLIAS",26
49,"49066",492,336,332,4,4,"PODEMOS-IU-EQUO-CLIAS",25
28,"28066",7182,5422,5371,17,51,"PODEMOS-IU-EQUO-CLIAS",793
49,"49273",187,112,112,0,0,"PODEMOS-IU-EQUO-CLIAS",13
49,"49015",227,179,177,0,2,"PODEMOS-IU-EQUO-CLIAS",13
28,"28045",33328,24620,24434,146,186,"PODEMOS-IU-EQUO-CLIAS",4941
49,"49091",260,193,193,0,0,"PODEMOS-IU-EQUO-CLIAS",16
49,"49154",127,78,77,0,1,"PODEMOS-IU-EQUO-CLIAS",4
49,"49134",172,121,119,0,2,"PODEMOS-IU-EQUO-CLIAS",25
49,"49105",150,109,108,0,1,"PODEMOS-IU-EQUO-CLIAS",6
49,"49143",225,163,162,0,1,"PODEMOS-IU-EQUO-CLIAS",19
49,"49206",840,614,604,9,10,"PODEMOS-IU-EQUO-CLIAS",50
28,"28102",894,644,636,6,8,"PODEMOS-IU-EQUO-CLIAS",106
28,"28042",1173,890,883,3,7,"PODEMOS-IU-EQUO-CLIAS",156
28,"28023",4775,3755,3735,12,20,"PODEMOS-IU-EQUO-CLIAS",906
49,"49271",194,145,141,1,4,"PODEMOS-IU-EQUO-CLIAS",14
28,"28078",38,32,32,0,0,"PODEMOS-IU-EQUO-CLIAS",11
49,"49125",1391,933,918,10,15,"PODEMOS-IU-EQUO-CLIAS",175
49,"49235",443,301,292,0,9,"PODEMOS-IU-EQUO-CLIAS",47
28,"28012",887,664,661,2,3,"PODEMOS-IU-EQUO-CLIAS",98
49,"49099",115,87,87,0,0,"PODEMOS-IU-EQUO-CLIAS",5
28,"28138",60,46,46,0,0,"PODEMOS-IU-EQUO-CLIAS",13
49,"49229",126,93,93,0,0,"PODEMOS-IU-EQUO-CLIAS",9
49,"49085",996,684,680,2,4,"PODEMOS-IU-EQUO-CLIAS",87
49,"49112",126,75,75,0,0,"PODEMOS-IU-EQUO-CLIAS",11
49,"49050",507,342,338,1,4,"PODEMOS-IU-EQUO-CLIAS",33
28,"28169",1448,1122,1113,5,9,"PODEMOS-IU-EQUO-CLIAS",184
49,"49149",390,273,268,3,5,"PODEMOS-IU-EQUO-CLIAS",27
28,"28054",11257,8349,8273,55,76,"PODEMOS-IU-EQUO-CLIAS",1719
28,"28035",1353,1006,998,2,8,"PODEMOS-IU-EQUO-CLIAS",202
49,"49148",260,137,134,1,3,"PODEMOS-IU-EQUO-CLIAS",27
49,"49192",130,110,109,2,1,"PODEMOS-IU-EQUO-CLIAS",4
28,"28084",15859,11156,11058,64,98,"PODEMOS-IU-EQUO-CLIAS",2814
49,"49130",180,143,141,5,2,"PODEMOS-IU-EQUO-CLIAS",14
28,"28164",2993,2183,2168,8,15,"PODEMOS-IU-EQUO-CLIAS",400
28,"28019",1233,893,885,4,8,"PODEMOS-IU-EQUO-CLIAS",169
28,"28043",5921,3803,3759,18,44,"PODEMOS-IU-EQUO-CLIAS",667
28,"28053",6498,4995,4955,28,40,"PODEMOS-IU-EQUO-CLIAS",1046
28,"28134",61008,45177,44904,263,273,"PODEMOS-IU-EQUO-CLIAS",9520
28,"28903",33082,27065,26922,154,143,"PODEMOS-IU-EQUO-CLIAS",5768
49,"49187",1236,896,888,4,8,"PODEMOS-IU-EQUO-CLIAS",79
28,"28110",1944,1478,1463,4,15,"PODEMOS-IU-EQUO-CLIAS",225
49,"49242",447,360,357,5,3,"PODEMOS-IU-EQUO-CLIAS",33
49,"49077",183,103,103,0,0,"PODEMOS-IU-EQUO-CLIAS",3
28,"28124",74,54,54,1,0,"PODEMOS-IU-EQUO-CLIAS",15
49,"49030",86,69,69,0,0,"PODEMOS-IU-EQUO-CLIAS",3
49,"49087",521,322,318,0,4,"PODEMOS-IU-EQUO-CLIAS",9
49,"49169",35,26,26,0,0,"PODEMOS-IU-EQUO-CLIAS",2
49,"49178",705,496,487,4,9,"PODEMOS-IU-EQUO-CLIAS",119
28,"28085",3922,2972,2954,14,18,"PODEMOS-IU-EQUO-CLIAS",553
49,"49236",75,58,58,0,0,"PODEMOS-IU-EQUO-CLIAS",1
49,"49221",245,129,127,1,2,"PODEMOS-IU-EQUO-CLIAS",15
49,"49165",59,51,51,0,0,"PODEMOS-IU-EQUO-CLIAS",4
49,"49111",127,98,96,4,2,"PODEMOS-IU-EQUO-CLIAS",8
49,"49097",85,52,51,0,1,"PODEMOS-IU-EQUO-CLIAS",2
49,"49068",462,310,304,4,6,"PODEMOS-IU-EQUO-CLIAS",23
28,"28140",3007,2276,2256,7,20,"PODEMOS-IU-EQUO-CLIAS",394
28,"28114",150,101,100,1,1,"PODEMOS-IU-EQUO-CLIAS",22
28,"28070",117,91,91,0,0,"PODEMOS-IU-EQUO-CLIAS",23
28,"28173",517,390,388,1,2,"PODEMOS-IU-EQUO-CLIAS",61
49,"49208",394,248,244,2,4,"PODEMOS-IU-EQUO-CLIAS",12
28,"28067",4063,3102,3079,3,23,"PODEMOS-IU-EQUO-CLIAS",571
28,"28137",1664,1232,1220,7,12,"PODEMOS-IU-EQUO-CLIAS",247
49,"49025",173,133,133,1,0,"PODEMOS-IU-EQUO-CLIAS",12
28,"28160",8256,6102,6059,31,43,"PODEMOS-IU-EQUO-CLIAS",1163
28,"28172",9077,6992,6936,31,56,"PODEMOS-IU-EQUO-CLIAS",1212
28,"28141",5823,4297,4262,29,35,"PODEMOS-IU-EQUO-CLIAS",825
28,"28061",21389,16277,16135,67,142,"PODEMOS-IU-EQUO-CLIAS",3184
49,"49145",236,162,157,0,5,"PODEMOS-IU-EQUO-CLIAS",13
49,"49110",348,231,229,0,2,"PODEMOS-IU-EQUO-CLIAS",26
28,"28090",8505,6654,6609,33,45,"PODEMOS-IU-EQUO-CLIAS",1351
49,"49252",320,254,252,5,2,"PODEMOS-IU-EQUO-CLIAS",28
49,"49108",466,346,344,0,2,"PODEMOS-IU-EQUO-CLIAS",39
28,"28145",2431,1760,1736,6,24,"PODEMOS-IU-EQUO-CLIAS",345
49,"49185",157,123,122,2,1,"PODEMOS-IU-EQUO-CLIAS",7
49,"49156",237,184,175,0,9,"PODEMOS-IU-EQUO-CLIAS",21
49,"49042",244,178,176,1,2,"PODEMOS-IU-EQUO-CLIAS",22
49,"49223",752,608,600,4,8,"PODEMOS-IU-EQUO-CLIAS",34
49,"49078",170,141,140,1,1,"PODEMOS-IU-EQUO-CLIAS",20
49,"49031",148,120,119,6,1,"PODEMOS-IU-EQUO-CLIAS",6
49,"49188",112,90,89,1,1,"PODEMOS-IU-EQUO-CLIAS",12
49,"49003",900,612,599,5,13,"PODEMOS-IU-EQUO-CLIAS",48
28,"28047",40914,30019,29788,169,231,"PODEMOS-IU-EQUO-CLIAS",6679
28,"28015",18736,14221,14127,68,94,"PODEMOS-IU-EQUO-CLIAS",2590
28,"28111",596,467,467,3,0,"PODEMOS-IU-EQUO-CLIAS",100
28,"28113",34751,25832,25612,120,220,"PODEMOS-IU-EQUO-CLIAS",6449
28,"28149",5759,4352,4310,25,42,"PODEMOS-IU-EQUO-CLIAS",866
49,"49102",196,143,139,2,4,"PODEMOS-IU-EQUO-CLIAS",9
49,"49163",219,158,154,5,4,"PODEMOS-IU-EQUO-CLIAS",12
49,"49039",338,245,239,3,6,"PODEMOS-IU-EQUO-CLIAS",39
49,"49033",714,508,505,1,3,"PODEMOS-IU-EQUO-CLIAS",50
49,"49107",126,94,93,2,1,"PODEMOS-IU-EQUO-CLIAS",11
28,"28018",3768,2968,2945,26,23,"PODEMOS-IU-EQUO-CLIAS",548
28,"28115",60892,49705,49510,209,195,"PODEMOS-IU-EQUO-CLIAS",4724
49,"49200",949,720,715,10,5,"PODEMOS-IU-EQUO-CLIAS",92
28,"28101",231,187,187,0,0,"PODEMOS-IU-EQUO-CLIAS",44
49,"49071",765,495,490,2,5,"PODEMOS-IU-EQUO-CLIAS",31
28,"28133",5979,4140,4098,18,42,"PODEMOS-IU-EQUO-CLIAS",724
28,"28022",33479,27129,27037,133,92,"PODEMOS-IU-EQUO-CLIAS",2893
49,"49202",187,130,130,4,0,"PODEMOS-IU-EQUO-CLIAS",17
28,"28107",457,312,312,0,0,"PODEMOS-IU-EQUO-CLIAS",45
28,"28014",33085,23626,23466,113,160,"PODEMOS-IU-EQUO-CLIAS",4698
28,"28033",3899,2805,2788,7,17,"PODEMOS-IU-EQUO-CLIAS",439
49,"49159",271,209,205,4,4,"PODEMOS-IU-EQUO-CLIAS",36
49,"49082",359,304,301,6,3,"PODEMOS-IU-EQUO-CLIAS",24
28,"28165",1794,1293,1285,3,8,"PODEMOS-IU-EQUO-CLIAS",154
28,"28052",3855,2626,2587,11,39,"PODEMOS-IU-EQUO-CLIAS",389
49,"49147",263,190,186,0,4,"PODEMOS-IU-EQUO-CLIAS",9
49,"49219",7464,4988,4914,53,74,"PODEMOS-IU-EQUO-CLIAS",752
49,"49092",129,90,89,1,1,"PODEMOS-IU-EQUO-CLIAS",5
28,"28128",444,315,314,0,1,"PODEMOS-IU-EQUO-CLIAS",50
49,"49248",186,151,150,1,1,"PODEMOS-IU-EQUO-CLIAS",16
28,"28032",4762,3428,3401,19,27,"PODEMOS-IU-EQUO-CLIAS",653
49,"49057",109,85,83,1,2,"PODEMOS-IU-EQUO-CLIAS",8
49,"49014",112,91,91,2,0,"PODEMOS-IU-EQUO-CLIAS",8
28,"28179",1432,1040,1037,4,3,"PODEMOS-IU-EQUO-CLIAS",211
33,"33072",1566,1008,994,11,14,"PODEMOS-IU-",249
33,"33077",1192,811,808,5,3,"PODEMOS-IU-",79
33,"33032",11395,7592,7465,90,127,"PODEMOS-IU-",2122
33,"33029",350,181,174,2,7,"PODEMOS-IU-",31
33,"33071",595,433,430,10,3,"PODEMOS-IU-",30
33,"33061",378,202,200,0,2,"PODEMOS-IU-",23
33,"33066",42963,28564,28282,300,282,"PODEMOS-IU-",6492
33,"33065",1102,722,713,7,9,"PODEMOS-IU-",157
33,"33049",6322,4116,4062,43,54,"PODEMOS-IU-",728
33,"33013",446,321,318,3,3,"PODEMOS-IU-",59
33,"33041",7199,4922,4877,52,45,"PODEMOS-IU-",1085
33,"33055",1514,1109,1092,5,17,"PODEMOS-IU-",137
33,"33019",3072,2020,2005,18,15,"PODEMOS-IU-",299
33,"33075",271,154,153,2,1,"PODEMOS-IU-",27
33,"33008",1777,1238,1229,3,9,"PODEMOS-IU-",167
33,"33060",14633,9647,9474,72,173,"PODEMOS-IU-",3000
33,"33046",499,379,367,5,12,"PODEMOS-IU-",30
33,"33068",1093,645,641,4,4,"PODEMOS-IU-",79
33,"33026",8530,5397,5337,48,60,"PODEMOS-IU-",1282
33,"33020",13307,9011,8914,99,97,"PODEMOS-IU-",2456
33,"33028",1276,649,641,4,8,"PODEMOS-IU-",102
33,"33035",11284,7681,7618,70,63,"PODEMOS-IU-",1669
33,"33069",3491,2430,2390,17,40,"PODEMOS-IU-",497
33,"33012",5201,3466,3432,25,34,"PODEMOS-IU-",549
33,"33045",4487,3057,2999,28,58,"PODEMOS-IU-",585
33,"33048",154,95,94,0,1,"PODEMOS-IU-",9
33,"33039",1655,1223,1209,12,14,"PODEMOS-IU-",263
33,"33058",1796,1232,1209,11,23,"PODEMOS-IU-",400
33,"33031",35120,22295,22024,271,271,"PODEMOS-IU-",7385
33,"33022",893,578,567,11,11,"PODEMOS-IU-",140
33,"33005",1449,936,924,11,12,"PODEMOS-IU-",115
33,"33057",1593,1063,1049,16,14,"PODEMOS-IU-",253
33,"33030",895,669,666,9,3,"PODEMOS-IU-",150
33,"33040",4549,2986,2942,35,44,"PODEMOS-IU-",607
33,"33011",11260,6250,6163,83,87,"PODEMOS-IU-",1029
33,"33021",4573,3024,2971,22,53,"PODEMOS-IU-",492
33,"33073",8554,4945,4884,41,61,"PODEMOS-IU-",603
33,"33047",1107,852,843,9,9,"PODEMOS-IU-",88
33,"33051",7061,4640,4587,27,53,"PODEMOS-IU-",755
33,"33038",2303,1584,1559,13,25,"PODEMOS-IU-",435
33,"33015",1540,998,986,8,12,"PODEMOS-IU-",280
33,"33017",3144,2094,2071,35,23,"PODEMOS-IU-",352
33,"33064",234,168,167,1,1,"PODEMOS-IU-",35
33,"33070",3351,2403,2373,26,30,"PODEMOS-IU-",517
33,"33062",400,238,233,2,5,"PODEMOS-IU-",40
33,"33009",905,611,609,3,2,"PODEMOS-IU-",135
33,"33052",721,485,482,3,3,"PODEMOS-IU-",68
33,"33006",1540,1010,1003,5,7,"PODEMOS-IU-",292
33,"33067",784,587,579,9,8,"PODEMOS-IU-",119
33,"33044",178278,125469,124554,1124,915,"PODEMOS-IU-",25227
33,"33042",4306,2988,2970,35,18,"PODEMOS-IU-",709
33,"33027",834,506,498,4,8,"PODEMOS-IU-",87
33,"33014",9037,5999,5938,53,61,"PODEMOS-IU-",1787
33,"33001",1588,887,880,8,7,"PODEMOS-IU-",91
33,"33059",4646,3075,3033,29,42,"PODEMOS-IU-",509
33,"33037",34454,22881,22586,243,295,"PODEMOS-IU-",7747
33,"33078",142,101,99,0,2,"PODEMOS-IU-",21
33,"33024",226679,158750,157564,1209,1186,"PODEMOS-IU-",40800
33,"33002",9995,6765,6672,47,93,"PODEMOS-IU-",1642
33,"33010",1822,1190,1180,17,10,"PODEMOS-IU-",254
33,"33054",1682,1159,1149,12,10,"PODEMOS-IU-",169
33,"33023",3321,2299,2265,31,34,"PODEMOS-IU-",448
33,"33003",646,355,352,9,3,"PODEMOS-IU-",50
33,"33007",1514,946,942,12,4,"PODEMOS-IU-",157
33,"33053",1141,742,732,6,10,"PODEMOS-IU-",184
33,"33076",12258,8106,8031,63,75,"PODEMOS-IU-",1372
33,"33025",9174,5838,5786,57,52,"PODEMOS-IU-",1371
33,"33063",415,320,318,3,2,"PODEMOS-IU-",31
33,"33034",10612,6602,6536,62,66,"PODEMOS-IU-",1054
33,"33036",11542,8062,7987,60,75,"PODEMOS-IU-",1204
33,"33043",683,446,441,2,5,"PODEMOS-IU-",73
33,"33018",2901,2000,1976,18,24,"PODEMOS-IU-",393
33,"33016",19130,13666,13526,125,140,"PODEMOS-IU-",3398
33,"33050",592,387,376,2,11,"PODEMOS-IU-",62
33,"33056",4997,3269,3244,22,25,"PODEMOS-IU-",641
33,"33074",3484,2298,2274,24,24,"PODEMOS-IU-",314
33,"33004",66857,46390,45960,426,430,"PODEMOS-IU-",12252
33,"33033",9873,6512,6431,68,81,"PODEMOS-IU-",1816
47,"47144",78,64,64,1,0,"PODEMOS-IU-EQUO-IZCA",4
47,"47046",118,92,90,1,2,"PODEMOS-IU-EQUO-IZCA",6
47,"47157",515,424,423,1,1,"PODEMOS-IU-EQUO-IZCA",60
47,"47034",72,58,58,3,0,"PODEMOS-IU-EQUO-IZCA",5
47,"47059",97,76,76,2,0,"PODEMOS-IU-EQUO-IZCA",18
47,"47063",103,81,80,1,1,"PODEMOS-IU-EQUO-IZCA",17
47,"47215",53,45,45,0,0,"PODEMOS-IU-EQUO-IZCA",8
47,"47029",57,52,52,0,0,"PODEMOS-IU-EQUO-IZCA",4
47,"47211",47,35,34,0,1,"PODEMOS-IU-EQUO-IZCA",0
47,"47133",2682,2033,2015,16,18,"PODEMOS-IU-EQUO-IZCA",433
47,"47168",29,26,26,1,0,"PODEMOS-IU-EQUO-IZCA",1
47,"47092",110,87,87,0,0,"PODEMOS-IU-EQUO-IZCA",8
47,"47155",3228,2277,2254,18,23,"PODEMOS-IU-EQUO-IZCA",439
47,"47060",258,216,214,1,2,"PODEMOS-IU-EQUO-IZCA",37
47,"47164",378,313,311,1,2,"PODEMOS-IU-EQUO-IZCA",18
47,"47207",278,215,212,3,3,"PODEMOS-IU-EQUO-IZCA",6
47,"47085",16612,11829,11706,114,123,"PODEMOS-IU-EQUO-IZCA",1733
47,"47163",290,230,228,3,2,"PODEMOS-IU-EQUO-IZCA",43
47,"47173",880,644,638,20,6,"PODEMOS-IU-EQUO-IZCA",124
47,"47069",124,105,104,1,1,"PODEMOS-IU-EQUO-IZCA",1
47,"47008",24,19,19,1,0,"PODEMOS-IU-EQUO-IZCA",4
47,"47165",6955,4955,4303,66,652,"PODEMOS-IU-EQUO-IZCA",545
47,"47020",280,234,231,2,3,"PODEMOS-IU-EQUO-IZCA",7
47,"47096",140,110,110,0,0,"PODEMOS-IU-EQUO-IZCA",8
47,"47203",62,53,53,1,0,"PODEMOS-IU-EQUO-IZCA",2
47,"47198",69,50,50,0,0,"PODEMOS-IU-EQUO-IZCA",7
47,"47035",921,717,715,3,2,"PODEMOS-IU-EQUO-IZCA",55
47,"47017",201,158,153,1,5,"PODEMOS-IU-EQUO-IZCA",9
47,"47196",34,27,27,0,0,"PODEMOS-IU-EQUO-IZCA",0
47,"47091",84,71,71,2,0,"PODEMOS-IU-EQUO-IZCA",16
47,"47181",165,135,132,3,3,"PODEMOS-IU-EQUO-IZCA",19
47,"47171",407,303,301,6,2,"PODEMOS-IU-EQUO-IZCA",17
47,"47024",259,208,207,1,1,"PODEMOS-IU-EQUO-IZCA",21
47,"47080",30,22,21,0,1,"PODEMOS-IU-EQUO-IZCA",2
47,"47218",993,743,734,2,9,"PODEMOS-IU-EQUO-IZCA",194
47,"47159",822,644,636,1,8,"PODEMOS-IU-EQUO-IZCA",66
47,"47213",109,82,82,0,0,"PODEMOS-IU-EQUO-IZCA",3
47,"47050",3719,2630,2598,26,32,"PODEMOS-IU-EQUO-IZCA",485
47,"47021",76,64,64,0,0,"PODEMOS-IU-EQUO-IZCA",9
47,"47100",138,117,117,1,0,"PODEMOS-IU-EQUO-IZCA",6
47,"47086",3906,2970,2936,24,34,"PODEMOS-IU-EQUO-IZCA",284
47,"47151",27,24,24,0,0,"PODEMOS-IU-EQUO-IZCA",2
47,"47182",1323,977,967,8,10,"PODEMOS-IU-EQUO-IZCA",125
47,"47153",108,77,77,0,0,"PODEMOS-IU-EQUO-IZCA",10
47,"47137",29,25,25,1,0,"PODEMOS-IU-EQUO-IZCA",3
47,"47142",141,99,97,0,2,"PODEMOS-IU-EQUO-IZCA",3
47,"47128",60,52,51,0,1,"PODEMOS-IU-EQUO-IZCA",4
47,"47156",162,136,133,0,3,"PODEMOS-IU-EQUO-IZCA",13
47,"47124",392,316,311,3,5,"PODEMOS-IU-EQUO-IZCA",36
47,"47065",857,674,669,1,5,"PODEMOS-IU-EQUO-IZCA",39
47,"47007",3769,2765,2736,24,29,"PODEMOS-IU-EQUO-IZCA",558
47,"47143",118,91,90,0,1,"PODEMOS-IU-EQUO-IZCA",5
47,"47104",2836,2182,2121,19,61,"PODEMOS-IU-EQUO-IZCA",174
47,"47169",68,59,59,0,0,"PODEMOS-IU-EQUO-IZCA",4
47,"47214",1409,1087,1062,7,25,"PODEMOS-IU-EQUO-IZCA",125
47,"47180",73,61,60,4,1,"PODEMOS-IU-EQUO-IZCA",5
47,"47039",185,141,140,0,1,"PODEMOS-IU-EQUO-IZCA",14
47,"47078",163,127,125,1,2,"PODEMOS-IU-EQUO-IZCA",6
47,"47225",80,63,63,0,0,"PODEMOS-IU-EQUO-IZCA",2
47,"47077",246,193,191,1,2,"PODEMOS-IU-EQUO-IZCA",10
47,"47095",38,31,31,0,0,"PODEMOS-IU-EQUO-IZCA",4
47,"47184",573,453,451,1,2,"PODEMOS-IU-EQUO-IZCA",51
47,"47082",812,640,628,8,12,"PODEMOS-IU-EQUO-IZCA",75
47,"47172",144,124,122,0,2,"PODEMOS-IU-EQUO-IZCA",27
47,"47079",58,48,47,0,1,"PODEMOS-IU-EQUO-IZCA",2
47,"47212",380,323,322,2,1,"PODEMOS-IU-EQUO-IZCA",14
47,"47073",122,103,101,1,2,"PODEMOS-IU-EQUO-IZCA",2
47,"47230",303,246,242,2,4,"PODEMOS-IU-EQUO-IZCA",19
47,"47123",466,354,352,4,2,"PODEMOS-IU-EQUO-IZCA",66
47,"47199",80,63,63,0,0,"PODEMOS-IU-EQUO-IZCA",9
47,"47014",51,45,45,0,0,"PODEMOS-IU-EQUO-IZCA",2
47,"47161",3918,3145,3126,12,19,"PODEMOS-IU-EQUO-IZCA",344
47,"47071",410,324,321,4,3,"PODEMOS-IU-EQUO-IZCA",65
47,"47093",813,613,600,5,13,"PODEMOS-IU-EQUO-IZCA",100
47,"47058",200,145,143,0,2,"PODEMOS-IU-EQUO-IZCA",19
47,"47097",325,266,265,0,1,"PODEMOS-IU-EQUO-IZCA",32
47,"47150",274,209,205,0,4,"PODEMOS-IU-EQUO-IZCA",39
47,"47018",34,28,28,0,0,"PODEMOS-IU-EQUO-IZCA",2
47,"47094",133,115,114,1,1,"PODEMOS-IU-EQUO-IZCA",10
47,"47135",83,72,72,2,0,"PODEMOS-IU-EQUO-IZCA",0
47,"47106",50,39,39,0,0,"PODEMOS-IU-EQUO-IZCA",2
47,"47200",85,66,66,0,0,"PODEMOS-IU-EQUO-IZCA",12
47,"47001",55,46,46,0,0,"PODEMOS-IU-EQUO-IZCA",5
47,"47099",150,135,135,1,0,"PODEMOS-IU-EQUO-IZCA",6
47,"47145",603,448,441,3,7,"PODEMOS-IU-EQUO-IZCA",73
47,"47183",130,106,105,0,1,"PODEMOS-IU-EQUO-IZCA",5
47,"47119",92,80,79,1,1,"PODEMOS-IU-EQUO-IZCA",10
47,"47010",13729,10549,10454,81,95,"PODEMOS-IU-EQUO-IZCA",1812
47,"47162",74,60,60,0,0,"PODEMOS-IU-EQUO-IZCA",6
47,"47220",165,130,129,0,1,"PODEMOS-IU-EQUO-IZCA",13
47,"47048",188,144,144,1,0,"PODEMOS-IU-EQUO-IZCA",7
47,"47177",105,76,73,1,3,"PODEMOS-IU-EQUO-IZCA",13
47,"47005",549,413,408,2,5,"PODEMOS-IU-EQUO-IZCA",47
47,"47013",100,82,81,1,1,"PODEMOS-IU-EQUO-IZCA",6
47,"47149",42,34,34,3,0,"PODEMOS-IU-EQUO-IZCA",12
47,"47229",210,148,147,1,1,"PODEMOS-IU-EQUO-IZCA",13
47,"47217",1910,1370,1366,1,4,"PODEMOS-IU-EQUO-IZCA",252
47,"47016",69,56,55,0,1,"PODEMOS-IU-EQUO-IZCA",6
47,"47062",163,130,130,0,0,"PODEMOS-IU-EQUO-IZCA",3
47,"47205",384,266,260,0,6,"PODEMOS-IU-EQUO-IZCA",21
47,"47115",281,236,233,3,3,"PODEMOS-IU-EQUO-IZCA",7
47,"47109",179,138,138,2,0,"PODEMOS-IU-EQUO-IZCA",17
47,"47032",152,117,116,1,1,"PODEMOS-IU-EQUO-IZCA",9
47,"47158",889,667,659,8,8,"PODEMOS-IU-EQUO-IZCA",98
47,"47002",23,21,20,1,1,"PODEMOS-IU-EQUO-IZCA",1
47,"47138",241,170,164,1,6,"PODEMOS-IU-EQUO-IZCA",14
47,"47134",165,128,125,1,3,"PODEMOS-IU-EQUO-IZCA",6
47,"47043",297,239,237,0,2,"PODEMOS-IU-EQUO-IZCA",14
47,"47170",33,28,27,2,1,"PODEMOS-IU-EQUO-IZCA",1
47,"47178",172,140,140,3,0,"PODEMOS-IU-EQUO-IZCA",14
47,"47067",174,127,126,0,1,"PODEMOS-IU-EQUO-IZCA",10
47,"47102",291,230,220,1,10,"PODEMOS-IU-EQUO-IZCA",13
47,"47023",2995,2344,2326,18,18,"PODEMOS-IU-EQUO-IZCA",422
47,"47224",87,76,76,0,0,"PODEMOS-IU-EQUO-IZCA",11
47,"47088",103,86,85,1,1,"PODEMOS-IU-EQUO-IZCA",7
47,"47194",298,239,237,2,2,"PODEMOS-IU-EQUO-IZCA",89
47,"47188",111,88,88,3,0,"PODEMOS-IU-EQUO-IZCA",6
47,"47227",61,50,50,0,0,"PODEMOS-IU-EQUO-IZCA",1
47,"47126",50,41,41,0,0,"PODEMOS-IU-EQUO-IZCA",3
47,"47191",108,79,79,0,0,"PODEMOS-IU-EQUO-IZCA",13
47,"47216",115,91,87,0,4,"PODEMOS-IU-EQUO-IZCA",2
47,"47176",219,139,139,1,0,"PODEMOS-IU-EQUO-IZCA",14
47,"47121",544,437,425,6,12,"PODEMOS-IU-EQUO-IZCA",24
47,"47132",45,36,33,1,3,"PODEMOS-IU-EQUO-IZCA",1
47,"47089",148,125,124,0,1,"PODEMOS-IU-EQUO-IZCA",7
47,"47033",196,154,154,1,0,"PODEMOS-IU-EQUO-IZCA",9
47,"47208",58,38,36,1,2,"PODEMOS-IU-EQUO-IZCA",10
47,"47068",34,26,26,0,0,"PODEMOS-IU-EQUO-IZCA",2
47,"47084",1150,887,870,7,17,"PODEMOS-IU-EQUO-IZCA",71
47,"47057",268,197,196,0,1,"PODEMOS-IU-EQUO-IZCA",28
47,"47190",98,80,80,1,0,"PODEMOS-IU-EQUO-IZCA",4
47,"47117",301,233,227,2,6,"PODEMOS-IU-EQUO-IZCA",9
47,"47195",459,345,344,4,1,"PODEMOS-IU-EQUO-IZCA",65
47,"47045",763,575,567,1,8,"PODEMOS-IU-EQUO-IZCA",124
47,"47232",102,77,74,1,3,"PODEMOS-IU-EQUO-IZCA",5
47,"47130",96,72,72,0,0,"PODEMOS-IU-EQUO-IZCA",5
47,"47090",2418,1728,1699,8,29,"PODEMOS-IU-EQUO-IZCA",227
47,"47166",259,204,197,2,7,"PODEMOS-IU-EQUO-IZCA",11
47,"47187",84,61,58,0,3,"PODEMOS-IU-EQUO-IZCA",4
47,"47087",381,301,297,3,4,"PODEMOS-IU-EQUO-IZCA",41
47,"47011",565,461,458,5,3,"PODEMOS-IU-EQUO-IZCA",24
47,"47129",871,664,659,4,5,"PODEMOS-IU-EQUO-IZCA",90
47,"47210",382,282,274,3,8,"PODEMOS-IU-EQUO-IZCA",15
47,"47012",113,93,93,0,0,"PODEMOS-IU-EQUO-IZCA",9
47,"47192",102,83,81,1,2,"PODEMOS-IU-EQUO-IZCA",15
47,"47054",635,507,495,9,12,"PODEMOS-IU-EQUO-IZCA",48
47,"47110",450,350,346,1,4,"PODEMOS-IU-EQUO-IZCA",60
47,"47167",241,204,204,1,0,"PODEMOS-IU-EQUO-IZCA",7
47,"47221",111,94,94,0,0,"PODEMOS-IU-EQUO-IZCA",8
47,"47040",64,53,53,0,0,"PODEMOS-IU-EQUO-IZCA",3
47,"47003",227,180,179,3,1,"PODEMOS-IU-EQUO-IZCA",10
47,"47064",33,28,25,0,3,"PODEMOS-IU-EQUO-IZCA",8
47,"47076",17399,13097,12972,92,125,"PODEMOS-IU-EQUO-IZCA",2612
47,"47147",116,92,92,0,0,"PODEMOS-IU-EQUO-IZCA",6
47,"47036",228,181,181,3,0,"PODEMOS-IU-EQUO-IZCA",10
47,"47027",2745,2036,2018,9,18,"PODEMOS-IU-EQUO-IZCA",366
47,"47081",45,36,35,1,1,"PODEMOS-IU-EQUO-IZCA",6
47,"47103",267,197,192,5,5,"PODEMOS-IU-EQUO-IZCA",21
47,"47038",105,77,77,0,0,"PODEMOS-IU-EQUO-IZCA",10
47,"47116",416,341,339,0,2,"PODEMOS-IU-EQUO-IZCA",35
47,"47219",41,36,34,0,2,"PODEMOS-IU-EQUO-IZCA",2
47,"47231",4401,3299,3277,24,22,"PODEMOS-IU-EQUO-IZCA",587
47,"47051",335,268,263,2,5,"PODEMOS-IU-EQUO-IZCA",42
47,"47004",1181,939,930,7,9,"PODEMOS-IU-EQUO-IZCA",70
47,"47222",83,64,64,1,0,"PODEMOS-IU-EQUO-IZCA",3
47,"47114",4045,2787,2762,26,25,"PODEMOS-IU-EQUO-IZCA",327
47,"47030",993,766,751,6,15,"PODEMOS-IU-EQUO-IZCA",143
47,"47101",1710,1357,1336,16,21,"PODEMOS-IU-EQUO-IZCA",170
47,"47019",85,74,73,0,1,"PODEMOS-IU-EQUO-IZCA",8
47,"47070",37,27,27,0,0,"PODEMOS-IU-EQUO-IZCA",2
47,"47175",6564,4781,4728,39,53,"PODEMOS-IU-EQUO-IZCA",945
47,"47105",183,158,156,0,2,"PODEMOS-IU-EQUO-IZCA",18
47,"47197",876,673,668,8,5,"PODEMOS-IU-EQUO-IZCA",43
47,"47223",157,122,118,2,4,"PODEMOS-IU-EQUO-IZCA",14
47,"47098",576,464,452,4,12,"PODEMOS-IU-EQUO-IZCA",60
47,"47075",4856,3681,3637,24,44,"PODEMOS-IU-EQUO-IZCA",351
47,"47066",1268,981,977,12,4,"PODEMOS-IU-EQUO-IZCA",140
47,"47118",168,127,127,2,0,"PODEMOS-IU-EQUO-IZCA",18
47,"47152",78,60,60,0,0,"PODEMOS-IU-EQUO-IZCA",15
47,"47037",168,138,133,0,5,"PODEMOS-IU-EQUO-IZCA",4
47,"47141",134,111,110,0,1,"PODEMOS-IU-EQUO-IZCA",2
47,"47006",190,136,135,1,1,"PODEMOS-IU-EQUO-IZCA",41
47,"47044",331,293,290,2,3,"PODEMOS-IU-EQUO-IZCA",53
47,"47185",99,73,71,0,2,"PODEMOS-IU-EQUO-IZCA",10
47,"47140",115,102,102,1,0,"PODEMOS-IU-EQUO-IZCA",0
47,"47206",92,80,80,0,0,"PODEMOS-IU-EQUO-IZCA",11
47,"47139",1040,777,767,6,10,"PODEMOS-IU-EQUO-IZCA",96
47,"47026",46,40,40,1,0,"PODEMOS-IU-EQUO-IZCA",2
47,"47047",199,157,156,2,1,"PODEMOS-IU-EQUO-IZCA",9
47,"47228",440,331,331,2,0,"PODEMOS-IU-EQUO-IZCA",33
47,"47052",6576,4988,4944,40,44,"PODEMOS-IU-EQUO-IZCA",977
47,"47049",101,68,68,0,0,"PODEMOS-IU-EQUO-IZCA",9
47,"47031",189,145,145,1,0,"PODEMOS-IU-EQUO-IZCA",6
47,"47041",150,112,110,2,2,"PODEMOS-IU-EQUO-IZCA",7
47,"47174",267,218,215,1,3,"PODEMOS-IU-EQUO-IZCA",50
47,"47112",2587,2015,1988,7,27,"PODEMOS-IU-EQUO-IZCA",145
47,"47127",137,98,97,0,1,"PODEMOS-IU-EQUO-IZCA",14
47,"47179",395,293,287,0,6,"PODEMOS-IU-EQUO-IZCA",43
47,"47122",2032,1563,1535,7,28,"PODEMOS-IU-EQUO-IZCA",240
47,"47186",246129,186191,184733,1198,1458,"PODEMOS-IU-EQUO-IZCA",31897
47,"47061",256,212,211,2,1,"PODEMOS-IU-EQUO-IZCA",19
47,"47028",33,21,21,0,0,"PODEMOS-IU-EQUO-IZCA",3
47,"47160",425,308,303,0,5,"PODEMOS-IU-EQUO-IZCA",50
47,"47009",107,86,85,0,1,"PODEMOS-IU-EQUO-IZCA",11
47,"47113",159,129,128,0,1,"PODEMOS-IU-EQUO-IZCA",11
47,"47131",170,134,128,2,6,"PODEMOS-IU-EQUO-IZCA",9
47,"47022",59,50,49,0,1,"PODEMOS-IU-EQUO-IZCA",2
47,"47042",54,37,37,0,0,"PODEMOS-IU-EQUO-IZCA",7
47,"47111",1020,742,732,7,10,"PODEMOS-IU-EQUO-IZCA",71
47,"47209",41,34,34,0,0,"PODEMOS-IU-EQUO-IZCA",13
47,"47189",152,119,118,0,1,"PODEMOS-IU-EQUO-IZCA",4
47,"47193",1577,1251,1241,7,10,"PODEMOS-IU-EQUO-IZCA",259
47,"47154",152,128,125,1,3,"PODEMOS-IU-EQUO-IZCA",22
47,"47083",80,59,54,1,5,"PODEMOS-IU-EQUO-IZCA",14
47,"47015",200,162,160,0,2,"PODEMOS-IU-EQUO-IZCA",19
47,"47053",119,98,96,0,2,"PODEMOS-IU-EQUO-IZCA",25
47,"47025",120,94,94,1,0,"PODEMOS-IU-EQUO-IZCA",7
47,"47148",442,342,338,2,4,"PODEMOS-IU-EQUO-IZCA",22
47,"47146",255,206,204,1,2,"PODEMOS-IU-EQUO-IZCA",29
47,"47204",256,204,198,0,6,"PODEMOS-IU-EQUO-IZCA",15
47,"47074",149,117,116,2,1,"PODEMOS-IU-EQUO-IZCA",21
47,"47055",203,167,163,0,4,"PODEMOS-IU-EQUO-IZCA",20
47,"47226",156,123,123,0,0,"PODEMOS-IU-EQUO-IZCA",17
47,"47056",87,67,67,0,0,"PODEMOS-IU-EQUO-IZCA",3
47,"47125",58,46,46,0,0,"PODEMOS-IU-EQUO-IZCA",3
40,"40080",59,43,41,0,2,"PODEMOS-IU-EQUO-SEGOVIEMOS",0
40,"40030",473,369,363,3,6,"PODEMOS-IU-EQUO-SEGOVIEMOS",73
40,"40184",258,211,210,2,1,"PODEMOS-IU-EQUO-SEGOVIEMOS",14
40,"40074",255,222,219,2,3,"PODEMOS-IU-EQUO-SEGOVIEMOS",24
40,"40224",22,21,21,0,0,"PODEMOS-IU-EQUO-SEGOVIEMOS",2
40,"40121",280,226,218,3,8,"PODEMOS-IU-EQUO-SEGOVIEMOS",22
40,"40053",83,66,65,0,1,"PODEMOS-IU-EQUO-SEGOVIEMOS",6
40,"40132",56,37,36,1,1,"PODEMOS-IU-EQUO-SEGOVIEMOS",2
40,"40044",145,114,113,2,1,"PODEMOS-IU-EQUO-SEGOVIEMOS",10
40,"40158",17,12,12,0,0,"PODEMOS-IU-EQUO-SEGOVIEMOS",1
40,"40057",1456,1154,1148,7,6,"PODEMOS-IU-EQUO-SEGOVIEMOS",214
40,"40017",92,75,75,0,0,"PODEMOS-IU-EQUO-SEGOVIEMOS",5
40,"40212",27,23,22,2,1,"PODEMOS-IU-EQUO-SEGOVIEMOS",6
40,"40070",149,107,105,1,2,"PODEMOS-IU-EQUO-SEGOVIEMOS",24
40,"40151",46,33,33,0,0,"PODEMOS-IU-EQUO-SEGOVIEMOS",5
40,"40125",87,58,58,1,0,"PODEMOS-IU-EQUO-SEGOVIEMOS",11
40,"40156",322,238,235,1,3,"PODEMOS-IU-EQUO-SEGOVIEMOS",31
40,"40123",147,114,106,0,8,"PODEMOS-IU-EQUO-SEGOVIEMOS",24
40,"40048",38,29,27,0,2,"PODEMOS-IU-EQUO-SEGOVIEMOS",3
40,"40130",130,107,106,1,1,"PODEMOS-IU-EQUO-SEGOVIEMOS",15
40,"40210",106,74,71,0,3,"PODEMOS-IU-EQUO-SEGOVIEMOS",10
40,"40016",58,49,49,0,0,"PODEMOS-IU-EQUO-SEGOVIEMOS",3
40,"40072",211,162,159,1,3,"PODEMOS-IU-EQUO-SEGOVIEMOS",39
40,"40034",84,70,70,0,0,"PODEMOS-IU-EQUO-SEGOVIEMOS",3
40,"40903",86,67,67,0,0,"PODEMOS-IU-EQUO-SEGOVIEMOS",5
40,"40225",1138,883,867,3,16,"PODEMOS-IU-EQUO-SEGOVIEMOS",82
40,"40198",24,19,19,0,0,"PODEMOS-IU-EQUO-SEGOVIEMOS",0
40,"40103",159,125,123,2,2,"PODEMOS-IU-EQUO-SEGOVIEMOS",17
40,"40170",1320,1030,1021,7,9,"PODEMOS-IU-EQUO-SEGOVIEMOS",104
40,"40162",392,303,302,1,1,"PODEMOS-IU-EQUO-SEGOVIEMOS",29
40,"40140",92,69,67,0,2,"PODEMOS-IU-EQUO-SEGOVIEMOS",5
40,"40031",526,398,396,2,2,"PODEMOS-IU-EQUO-SEGOVIEMOS",84
40,"40100",270,213,211,2,2,"PODEMOS-IU-EQUO-SEGOVIEMOS",21
40,"40078",161,125,124,2,1,"PODEMOS-IU-EQUO-SEGOVIEMOS",16
40,"40083",77,59,59,0,0,"PODEMOS-IU-EQUO-SEGOVIEMOS",7
40,"40161",36,28,28,2,0,"PODEMOS-IU-EQUO-SEGOVIEMOS",1
40,"40171",32,23,23,0,0,"PODEMOS-IU-EQUO-SEGOVIEMOS",1
40,"40086",685,561,552,4,9,"PODEMOS-IU-EQUO-SEGOVIEMOS",86
40,"40025",136,117,115,0,2,"PODEMOS-IU-EQUO-SEGOVIEMOS",14
40,"40002",36,32,32,0,0,"PODEMOS-IU-EQUO-SEGOVIEMOS",6
40,"40188",90,72,70,0,2,"PODEMOS-IU-EQUO-SEGOVIEMOS",7
40,"40139",279,202,198,1,4,"PODEMOS-IU-EQUO-SEGOVIEMOS",19
40,"40006",22,18,18,0,0,"PODEMOS-IU-EQUO-SEGOVIEMOS",4
40,"40003",139,107,104,0,3,"PODEMOS-IU-EQUO-SEGOVIEMOS",8
40,"40004",459,356,352,2,4,"PODEMOS-IU-EQUO-SEGOVIEMOS",39
40,"40015",28,26,26,1,0,"PODEMOS-IU-EQUO-SEGOVIEMOS",0
40,"40180",299,246,241,1,5,"PODEMOS-IU-EQUO-SEGOVIEMOS",18
40,"40105",47,42,42,2,0,"PODEMOS-IU-EQUO-SEGOVIEMOS",4
40,"40200",40,31,31,0,0,"PODEMOS-IU-EQUO-SEGOVIEMOS",3
40,"40082",114,84,82,1,2,"PODEMOS-IU-EQUO-SEGOVIEMOS",2
40,"40054",108,90,90,0,0,"PODEMOS-IU-EQUO-SEGOVIEMOS",19
40,"40045",109,85,85,2,0,"PODEMOS-IU-EQUO-SEGOVIEMOS",8
40,"40138",2169,1673,1656,7,17,"PODEMOS-IU-EQUO-SEGOVIEMOS",280
40,"40222",168,145,144,0,1,"PODEMOS-IU-EQUO-SEGOVIEMOS",19
40,"40233",417,314,310,3,4,"PODEMOS-IU-EQUO-SEGOVIEMOS",53
40,"40097",128,93,92,0,1,"PODEMOS-IU-EQUO-SEGOVIEMOS",9
40,"40087",92,71,70,1,1,"PODEMOS-IU-EQUO-SEGOVIEMOS",2
40,"40221",49,39,39,0,0,"PODEMOS-IU-EQUO-SEGOVIEMOS",5
40,"40037",41,29,29,0,0,"PODEMOS-IU-EQUO-SEGOVIEMOS",6
40,"40179",626,503,493,2,10,"PODEMOS-IU-EQUO-SEGOVIEMOS",67
40,"40036",515,421,410,3,11,"PODEMOS-IU-EQUO-SEGOVIEMOS",24
40,"40196",30,25,25,0,0,"PODEMOS-IU-EQUO-SEGOVIEMOS",0
40,"40065",493,373,373,3,0,"PODEMOS-IU-EQUO-SEGOVIEMOS",39
40,"40047",30,25,25,0,0,"PODEMOS-IU-EQUO-SEGOVIEMOS",1
40,"40051",38,34,34,0,0,"PODEMOS-IU-EQUO-SEGOVIEMOS",4
40,"40177",153,125,125,1,0,"PODEMOS-IU-EQUO-SEGOVIEMOS",12
40,"40039",210,156,153,3,3,"PODEMOS-IU-EQUO-SEGOVIEMOS",22
40,"40024",856,651,639,6,12,"PODEMOS-IU-EQUO-SEGOVIEMOS",70
40,"40127",32,25,25,0,0,"PODEMOS-IU-EQUO-SEGOVIEMOS",1
40,"40150",69,61,61,1,0,"PODEMOS-IU-EQUO-SEGOVIEMOS",7
40,"40206",173,135,134,0,1,"PODEMOS-IU-EQUO-SEGOVIEMOS",33
40,"40124",237,182,177,6,5,"PODEMOS-IU-EQUO-SEGOVIEMOS",31
40,"40207",763,599,593,3,6,"PODEMOS-IU-EQUO-SEGOVIEMOS",127
40,"40902",123,99,96,1,3,"PODEMOS-IU-EQUO-SEGOVIEMOS",4
40,"40041",979,725,717,5,8,"PODEMOS-IU-EQUO-SEGOVIEMOS",72
40,"40231",108,90,89,0,1,"PODEMOS-IU-EQUO-SEGOVIEMOS",10
40,"40213",86,65,65,3,0,"PODEMOS-IU-EQUO-SEGOVIEMOS",4
40,"40013",62,49,48,0,1,"PODEMOS-IU-EQUO-SEGOVIEMOS",1
40,"40192",159,117,117,2,0,"PODEMOS-IU-EQUO-SEGOVIEMOS",10
40,"40223",216,163,163,1,0,"PODEMOS-IU-EQUO-SEGOVIEMOS",29
40,"40234",397,298,292,2,6,"PODEMOS-IU-EQUO-SEGOVIEMOS",24
40,"40136",112,88,87,0,1,"PODEMOS-IU-EQUO-SEGOVIEMOS",19
40,"40021",27,27,26,0,1,"PODEMOS-IU-EQUO-SEGOVIEMOS",3
40,"40049",49,43,43,0,0,"PODEMOS-IU-EQUO-SEGOVIEMOS",7
40,"40035",137,105,104,0,1,"PODEMOS-IU-EQUO-SEGOVIEMOS",21
40,"40181",4233,3260,3219,23,41,"PODEMOS-IU-EQUO-SEGOVIEMOS",625
40,"40173",138,99,93,1,6,"PODEMOS-IU-EQUO-SEGOVIEMOS",17
40,"40122",512,395,394,2,1,"PODEMOS-IU-EQUO-SEGOVIEMOS",85
40,"40056",34,28,28,1,0,"PODEMOS-IU-EQUO-SEGOVIEMOS",2
40,"40155",3518,2656,2605,18,51,"PODEMOS-IU-EQUO-SEGOVIEMOS",522
40,"40081",124,94,92,2,2,"PODEMOS-IU-EQUO-SEGOVIEMOS",14
40,"40076",6492,4768,4700,26,68,"PODEMOS-IU-EQUO-SEGOVIEMOS",897
40,"40152",760,592,584,3,8,"PODEMOS-IU-EQUO-SEGOVIEMOS",107
40,"40089",222,167,164,0,3,"PODEMOS-IU-EQUO-SEGOVIEMOS",21
40,"40163",53,44,43,0,1,"PODEMOS-IU-EQUO-SEGOVIEMOS",5
40,"40205",261,202,198,2,4,"PODEMOS-IU-EQUO-SEGOVIEMOS",29
40,"40071",43,39,38,1,1,"PODEMOS-IU-EQUO-SEGOVIEMOS",6
40,"40032",390,289,285,2,4,"PODEMOS-IU-EQUO-SEGOVIEMOS",22
40,"40146",254,197,196,0,1,"PODEMOS-IU-EQUO-SEGOVIEMOS",14
40,"40062",60,51,48,0,3,"PODEMOS-IU-EQUO-SEGOVIEMOS",2
40,"40201",49,42,42,0,0,"PODEMOS-IU-EQUO-SEGOVIEMOS",2
40,"40129",177,148,147,1,1,"PODEMOS-IU-EQUO-SEGOVIEMOS",7
40,"40199",105,84,84,0,0,"PODEMOS-IU-EQUO-SEGOVIEMOS",8
40,"40099",52,44,42,0,2,"PODEMOS-IU-EQUO-SEGOVIEMOS",5
40,"40111",58,49,49,0,0,"PODEMOS-IU-EQUO-SEGOVIEMOS",6
40,"40009",49,43,43,0,0,"PODEMOS-IU-EQUO-SEGOVIEMOS",5
40,"40108",112,82,82,0,0,"PODEMOS-IU-EQUO-SEGOVIEMOS",13
40,"40230",94,68,66,0,2,"PODEMOS-IU-EQUO-SEGOVIEMOS",8
40,"40211",74,64,64,0,0,"PODEMOS-IU-EQUO-SEGOVIEMOS",8
40,"40061",67,55,54,1,1,"PODEMOS-IU-EQUO-SEGOVIEMOS",6
40,"40176",395,306,305,2,1,"PODEMOS-IU-EQUO-SEGOVIEMOS",55
40,"40203",899,722,715,4,7,"PODEMOS-IU-EQUO-SEGOVIEMOS",138
40,"40018",91,72,72,1,0,"PODEMOS-IU-EQUO-SEGOVIEMOS",8
40,"40172",39,34,34,0,0,"PODEMOS-IU-EQUO-SEGOVIEMOS",4
40,"40075",160,139,139,0,0,"PODEMOS-IU-EQUO-SEGOVIEMOS",12
40,"40202",60,46,46,0,0,"PODEMOS-IU-EQUO-SEGOVIEMOS",3
40,"40215",84,60,60,0,0,"PODEMOS-IU-EQUO-SEGOVIEMOS",4
40,"40148",238,188,187,2,1,"PODEMOS-IU-EQUO-SEGOVIEMOS",23
40,"40094",374,279,276,2,3,"PODEMOS-IU-EQUO-SEGOVIEMOS",31
40,"40160",102,71,70,1,1,"PODEMOS-IU-EQUO-SEGOVIEMOS",3
40,"40028",105,91,90,2,1,"PODEMOS-IU-EQUO-SEGOVIEMOS",14
40,"40126",79,56,54,0,2,"PODEMOS-IU-EQUO-SEGOVIEMOS",10
40,"40091",119,97,95,1,2,"PODEMOS-IU-EQUO-SEGOVIEMOS",5
40,"40058",325,277,276,4,1,"PODEMOS-IU-EQUO-SEGOVIEMOS",9
40,"40164",177,139,138,0,1,"PODEMOS-IU-EQUO-SEGOVIEMOS",5
40,"40905",133,103,100,1,3,"PODEMOS-IU-EQUO-SEGOVIEMOS",1
40,"40144",18,14,14,0,0,"PODEMOS-IU-EQUO-SEGOVIEMOS",1
40,"40077",842,632,619,3,13,"PODEMOS-IU-EQUO-SEGOVIEMOS",143
40,"40149",514,375,369,5,6,"PODEMOS-IU-EQUO-SEGOVIEMOS",55
40,"40001",702,560,554,3,6,"PODEMOS-IU-EQUO-SEGOVIEMOS",55
40,"40182",178,133,130,2,3,"PODEMOS-IU-EQUO-SEGOVIEMOS",22
40,"40007",78,63,61,0,2,"PODEMOS-IU-EQUO-SEGOVIEMOS",3
40,"40020",157,118,117,1,1,"PODEMOS-IU-EQUO-SEGOVIEMOS",22
40,"40052",74,60,60,0,0,"PODEMOS-IU-EQUO-SEGOVIEMOS",12
40,"40022",213,164,161,2,3,"PODEMOS-IU-EQUO-SEGOVIEMOS",34
40,"40145",1103,879,870,2,9,"PODEMOS-IU-EQUO-SEGOVIEMOS",156
40,"40131",48,42,42,0,0,"PODEMOS-IU-EQUO-SEGOVIEMOS",4
40,"40143",86,75,74,0,1,"PODEMOS-IU-EQUO-SEGOVIEMOS",5
40,"40118",51,35,34,1,1,"PODEMOS-IU-EQUO-SEGOVIEMOS",3
40,"40088",284,228,224,0,4,"PODEMOS-IU-EQUO-SEGOVIEMOS",33
40,"40906",2003,1569,1550,12,19,"PODEMOS-IU-EQUO-SEGOVIEMOS",315
40,"40214",208,168,168,2,0,"PODEMOS-IU-EQUO-SEGOVIEMOS",16
40,"40093",77,65,65,1,0,"PODEMOS-IU-EQUO-SEGOVIEMOS",13
40,"40079",234,179,179,3,0,"PODEMOS-IU-EQUO-SEGOVIEMOS",26
40,"40168",34,29,29,1,0,"PODEMOS-IU-EQUO-SEGOVIEMOS",8
40,"40195",885,672,669,1,3,"PODEMOS-IU-EQUO-SEGOVIEMOS",71
40,"40141",842,593,584,10,9,"PODEMOS-IU-EQUO-SEGOVIEMOS",59
40,"40120",192,170,166,0,4,"PODEMOS-IU-EQUO-SEGOVIEMOS",25
40,"40084",62,55,52,0,3,"PODEMOS-IU-EQUO-SEGOVIEMOS",8
40,"40165",77,65,64,1,1,"PODEMOS-IU-EQUO-SEGOVIEMOS",9
40,"40194",39602,29382,29042,206,340,"PODEMOS-IU-EQUO-SEGOVIEMOS",4664
40,"40112",2555,1932,1909,8,23,"PODEMOS-IU-EQUO-SEGOVIEMOS",303
40,"40166",253,218,215,1,3,"PODEMOS-IU-EQUO-SEGOVIEMOS",11
40,"40185",863,646,642,3,4,"PODEMOS-IU-EQUO-SEGOVIEMOS",61
40,"40005",30,23,23,0,0,"PODEMOS-IU-EQUO-SEGOVIEMOS",2
40,"40901",384,309,307,4,2,"PODEMOS-IU-EQUO-SEGOVIEMOS",56
40,"40119",169,138,133,1,5,"PODEMOS-IU-EQUO-SEGOVIEMOS",13
40,"40010",121,102,101,1,1,"PODEMOS-IU-EQUO-SEGOVIEMOS",3
40,"40154",20,15,15,0,0,"PODEMOS-IU-EQUO-SEGOVIEMOS",0
40,"40063",7096,5184,5100,36,84,"PODEMOS-IU-EQUO-SEGOVIEMOS",941
40,"40135",283,236,231,2,5,"PODEMOS-IU-EQUO-SEGOVIEMOS",9
40,"40040",2607,1843,1828,19,15,"PODEMOS-IU-EQUO-SEGOVIEMOS",163
40,"40186",42,29,29,0,0,"PODEMOS-IU-EQUO-SEGOVIEMOS",2
40,"40193",229,174,172,3,2,"PODEMOS-IU-EQUO-SEGOVIEMOS",11
40,"40029",35,27,26,0,1,"PODEMOS-IU-EQUO-SEGOVIEMOS",4
40,"40104",265,198,195,0,3,"PODEMOS-IU-EQUO-SEGOVIEMOS",51
40,"40055",37,26,26,0,0,"PODEMOS-IU-EQUO-SEGOVIEMOS",2
40,"40159",142,100,99,1,1,"PODEMOS-IU-EQUO-SEGOVIEMOS",6
40,"40107",100,73,73,1,0,"PODEMOS-IU-EQUO-SEGOVIEMOS",4
40,"40092",118,87,87,1,0,"PODEMOS-IU-EQUO-SEGOVIEMOS",7
40,"40229",36,24,24,0,0,"PODEMOS-IU-EQUO-SEGOVIEMOS",5
40,"40115",101,86,85,1,1,"PODEMOS-IU-EQUO-SEGOVIEMOS",9
40,"40157",47,44,44,0,0,"PODEMOS-IU-EQUO-SEGOVIEMOS",4
40,"40228",510,390,382,1,8,"PODEMOS-IU-EQUO-SEGOVIEMOS",37
40,"40113",425,323,316,0,7,"PODEMOS-IU-EQUO-SEGOVIEMOS",91
40,"40128",129,95,93,0,2,"PODEMOS-IU-EQUO-SEGOVIEMOS",13
40,"40904",357,308,306,3,2,"PODEMOS-IU-EQUO-SEGOVIEMOS",60
40,"40208",766,596,589,3,7,"PODEMOS-IU-EQUO-SEGOVIEMOS",66
40,"40033",58,51,51,0,0,"PODEMOS-IU-EQUO-SEGOVIEMOS",13
40,"40068",26,24,24,0,0,"PODEMOS-IU-EQUO-SEGOVIEMOS",1
40,"40216",759,574,571,3,3,"PODEMOS-IU-EQUO-SEGOVIEMOS",59
40,"40095",477,377,369,0,8,"PODEMOS-IU-EQUO-SEGOVIEMOS",29
40,"40073",401,345,343,3,2,"PODEMOS-IU-EQUO-SEGOVIEMOS",10
40,"40110",349,265,263,3,2,"PODEMOS-IU-EQUO-SEGOVIEMOS",45
40,"40134",731,579,570,1,9,"PODEMOS-IU-EQUO-SEGOVIEMOS",54
40,"40043",1802,1400,1381,8,19,"PODEMOS-IU-EQUO-SEGOVIEMOS",126
40,"40142",53,39,37,0,2,"PODEMOS-IU-EQUO-SEGOVIEMOS",1
40,"40026",119,109,109,0,0,"PODEMOS-IU-EQUO-SEGOVIEMOS",37
40,"40012",269,192,191,2,1,"PODEMOS-IU-EQUO-SEGOVIEMOS",9
40,"40191",215,181,179,1,2,"PODEMOS-IU-EQUO-SEGOVIEMOS",23
40,"40046",89,75,75,1,0,"PODEMOS-IU-EQUO-SEGOVIEMOS",16
40,"40069",83,66,63,0,3,"PODEMOS-IU-EQUO-SEGOVIEMOS",3
40,"40101",877,635,628,8,7,"PODEMOS-IU-EQUO-SEGOVIEMOS",99
40,"40219",587,455,444,5,11,"PODEMOS-IU-EQUO-SEGOVIEMOS",39
40,"40008",44,39,39,1,0,"PODEMOS-IU-EQUO-SEGOVIEMOS",3
40,"40218",92,65,64,1,1,"PODEMOS-IU-EQUO-SEGOVIEMOS",4
40,"40204",167,113,110,1,3,"PODEMOS-IU-EQUO-SEGOVIEMOS",16
40,"40220",66,50,46,1,4,"PODEMOS-IU-EQUO-SEGOVIEMOS",7
40,"40019",36,31,31,1,0,"PODEMOS-IU-EQUO-SEGOVIEMOS",4
40,"40190",53,45,44,0,1,"PODEMOS-IU-EQUO-SEGOVIEMOS",7
40,"40183",130,120,119,2,1,"PODEMOS-IU-EQUO-SEGOVIEMOS",3
40,"40189",512,401,392,2,9,"PODEMOS-IU-EQUO-SEGOVIEMOS",52
40,"40109",73,59,59,1,0,"PODEMOS-IU-EQUO-SEGOVIEMOS",0
40,"40174",349,254,251,2,3,"PODEMOS-IU-EQUO-SEGOVIEMOS",16
40,"40059",110,95,95,1,0,"PODEMOS-IU-EQUO-SEGOVIEMOS",12
40,"40014",58,46,45,0,1,"PODEMOS-IU-EQUO-SEGOVIEMOS",4
40,"40106",201,158,158,2,0,"PODEMOS-IU-EQUO-SEGOVIEMOS",12
40,"40060",82,61,61,0,0,"PODEMOS-IU-EQUO-SEGOVIEMOS",4
40,"40178",98,73,71,1,2,"PODEMOS-IU-EQUO-SEGOVIEMOS",3
1,"1001",1979,1339,1318,7,21,"PP",160
13,"13086",175,137,134,0,3,"PP",67
34,"34027",1085,751,741,6,10,"PP",320
16,"16158",535,416,413,5,3,"PP",190
4,"4017",1296,857,854,5,3,"PP",342
15,"15001",4765,3280,3237,25,43,"PP",1544
18,"18022",13432,8491,8407,67,84,"PP",2114
40,"40231",108,90,89,0,1,"PP",47
45,"45199",2940,1848,1805,14,43,"PP",661
47,"47183",130,106,105,0,1,"PP",58
10,"10153",309,222,218,0,4,"PP",121
13,"13087",23137,15677,15480,133,197,"PP",6305
9,"9238",921,573,561,4,12,"PP",247
4,"4018",270,232,229,0,3,"PP",70
47,"47184",573,453,451,1,2,"PP",246
19,"19192",1736,1324,1308,8,16,"PP",686
1,"1002",8124,5722,5654,31,68,"PP",496
38,"38050",2462,1624,1604,8,20,"PP",604
19,"19193",20,19,19,1,0,"PP",3
13,"13088",610,458,453,6,5,"PP",164
45,"45200",4592,3539,3476,14,63,"PP",1431
34,"34168",52,47,47,2,0,"PP",26
37,"37189",121,88,88,0,0,"PP",45
18,"18161",212,175,174,3,1,"PP",64
16,"16161",57,48,46,0,2,"PP",32
13,"13089",1706,1368,1332,8,36,"PP",640
1,"1003",1190,782,774,2,8,"PP",13
26,"26173",6,6,6,1,0,"PP",3
29,"29010",1651,1278,1237,4,41,"PP",352
25,"25097",84,65,65,3,0,"PP",12
13,"13090",1094,843,828,4,15,"PP",403
49,"49142",249,180,179,0,1,"PP",81
19,"19194",98,69,69,1,0,"PP",30
38,"38052",1273,883,875,2,8,"PP",388
37,"37058",58,45,45,0,0,"PP",28
9,"9241",202,156,154,4,2,"PP",51
34,"34031",30,30,29,0,1,"PP",22
6,"6037",1748,1148,1134,9,14,"PP",540
45,"45202",3894,2776,2744,14,32,"PP",1334
25,"25098",253,151,150,0,1,"PP",9
13,"13091",538,450,446,0,4,"PP",230
40,"40901",384,309,307,4,2,"PP",122
19,"19195",40,32,32,1,0,"PP",12
16,"16163",74,62,62,0,0,"PP",19
9,"9242",80,66,66,2,0,"PP",38
13,"13092",1846,1477,1462,5,15,"PP",726
1,"1004",1399,1008,995,8,13,"PP",130
47,"47186",246129,186191,184733,1198,1458,"PP",75414
38,"38053",3735,2469,2435,17,34,"PP",887
26,"26175",51,41,41,0,0,"PP",21
13,"13093",4103,2963,2929,21,34,"PP",1376
10,"10158",330,269,267,0,2,"PP",78
1,"1006",175,140,140,0,0,"PP",36
16,"16165",61,54,53,0,1,"PP",17
45,"45203",2563,1801,1771,8,30,"PP",626
4,"4021",185,151,148,1,3,"PP",65
25,"25099",1273,761,752,7,9,"PP",65
47,"47187",84,61,58,0,3,"PP",43
46,"46232",895,711,696,5,15,"PP",259
38,"38901",1405,900,887,3,13,"PP",231
13,"13094",304,249,247,1,2,"PP",141
9,"9243",76,59,57,1,2,"PP",26
19,"19197",27,22,22,0,0,"PP",3
7,"7010",4880,3395,3361,32,34,"PP",1193
34,"34034",123,95,95,1,0,"PP",41
13,"13095",85,66,66,0,0,"PP",43
40,"40904",357,308,306,3,2,"PP",157
4,"4022",347,249,249,7,0,"PP",76
49,"49147",263,190,186,0,4,"PP",99
10,"10160",229,190,189,2,1,"PP",56
39,"39001",2102,1622,1601,18,21,"PP",710
1,"1008",786,513,509,11,4,"PP",109
37,"37062",83,65,64,1,1,"PP",44
39,"39002",3298,2342,2309,13,33,"PP",892
13,"13096",7652,5480,5415,19,65,"PP",2440
45,"45205",6824,4424,4362,22,62,"PP",1570
34,"34035",111,98,97,0,1,"PP",51
47,"47188",111,88,88,3,0,"PP",52
40,"40905",133,103,100,1,3,"PP",76
4,"4023",138,96,95,2,1,"PP",49
19,"19198",14,12,12,0,0,"PP",5
13,"13097",2270,1687,1671,7,16,"PP",812
24,"24014",7425,5124,5053,32,71,"PP",1914
1,"1009",1265,849,845,2,4,"PP",62
45,"45901",771,547,544,3,3,"PP",239
1,"1010",2268,1623,1603,11,20,"PP",153
16,"16170",692,501,493,4,8,"PP",208
40,"40906",2003,1569,1550,12,19,"PP",549
25,"25103",135,76,76,4,0,"PP",12
4,"4024",3074,2347,2327,20,20,"PP",866
13,"13098",2092,1503,1461,8,42,"PP",759
29,"29016",251,188,188,1,0,"PP",88
47,"47189",152,119,118,0,1,"PP",76
39,"39003",297,220,215,0,5,"PP",93
9,"9247",24,21,21,1,0,"PP",18
13,"13901",893,665,655,5,10,"PP",302
17,"17032",1721,967,961,10,6,"PP",54
18,"18034",505,366,364,1,2,"PP",101
2,"2065",476,394,392,1,2,"PP",195
19,"19200",71,52,52,1,0,"PP",18
26,"26180",221,173,172,0,1,"PP",97
9,"9248",78,59,59,1,0,"PP",28
1,"1011",235,174,171,4,3,"PP",70
39,"39004",1518,1090,1074,4,16,"PP",447
13,"13902",469,367,363,0,4,"PP",140
37,"37068",365,267,267,1,0,"PP",162
13,"13903",524,419,415,3,4,"PP",264
47,"47190",98,80,80,1,0,"PP",53
34,"34039",61,49,47,0,2,"PP",42
48,"48045",5167,3809,3757,28,52,"PP",194
19,"19201",58,49,48,1,1,"PP",22
47,"47191",108,79,79,0,0,"PP",41
16,"16172",325,268,267,1,1,"PP",155
25,"25105",125,92,92,2,0,"PP",7
1,"1013",712,454,450,0,4,"PP",47
16,"16173",205,157,156,0,1,"PP",77
2,"2067",1158,858,847,6,11,"PP",350
19,"19202",8,6,6,0,0,"PP",1
13,"13904",531,400,392,4,8,"PP",181
46,"46237",7211,5395,5343,42,52,"PP",1544
4,"4028",221,191,190,1,1,"PP",44
34,"34041",90,71,71,1,0,"PP",43
9,"9250",269,196,194,1,2,"PP",103
43,"43023",231,170,169,0,1,"PP",8
39,"39006",1711,1307,1287,10,20,"PP",704
25,"25109",231,163,162,2,1,"PP",12
16,"16174",185,145,143,0,2,"PP",67
29,"29019",878,652,636,3,16,"PP",249
46,"46003",950,791,769,1,22,"PP",300
1,"1014",371,280,272,4,8,"PP",71
26,"26183",64,49,49,0,0,"PP",21
37,"37071",78,65,64,0,1,"PP",18
17,"17035",548,381,379,5,2,"PP",22
4,"4029",8859,5834,5790,35,44,"PP",2195
16,"16175",5095,3980,3914,35,66,"PP",1614
19,"19203",30,24,24,0,0,"PP",9
25,"25110",2766,1628,1602,22,26,"PP",131
10,"10169",531,420,409,2,11,"PP",207
46,"46004",1922,1565,1547,11,18,"PP",491
1,"1016",433,228,226,5,2,"PP",54
19,"19204",148,120,120,0,0,"PP",39
25,"25111",117,72,70,2,2,"PP",8
6,"6050",4106,3134,3075,25,59,"PP",1471
14,"14002",10951,7706,7620,83,86,"PP",1734
10,"10170",267,210,206,3,4,"PP",99
27,"27002",1633,1137,1108,9,29,"PP",536
41,"41005",9068,6366,6281,58,85,"PP",1497
47,"47193",1577,1251,1241,7,10,"PP",444
16,"16176",38,30,30,0,0,"PP",7
16,"16177",78,64,64,0,0,"PP",37
19,"19208",43,30,30,0,0,"PP",18
1,"1017",849,571,565,5,6,"PP",82
39,"39008",13877,10258,10153,96,105,"PP",3539
9,"9253",109,94,91,1,3,"PP",41
4,"4030",1119,819,812,5,7,"PP",319
14,"14003",1248,939,930,2,9,"PP",336
25,"25112",273,192,188,4,4,"PP",28
10,"10171",344,245,244,0,1,"PP",101
27,"27004",1227,760,749,7,11,"PP",451
47,"47194",298,239,237,2,2,"PP",70
9,"9255",89,63,62,0,1,"PP",34
19,"19209",40,29,29,1,0,"PP",13
4,"4031",2338,1772,1762,2,10,"PP",589
1,"1018",1386,939,930,3,9,"PP",132
14,"14004",2034,1531,1518,14,13,"PP",583
12,"12016",1582,1307,1297,6,10,"PP",590
16,"16181",64,52,52,2,0,"PP",34
25,"25113",1168,811,803,8,8,"PP",75
41,"41007",12341,8039,7844,103,195,"PP",1620
34,"34048",73,59,59,1,0,"PP",28
47,"47195",459,345,344,4,1,"PP",110
16,"16185",43,37,37,0,0,"PP",15
9,"9256",354,258,258,2,0,"PP",136
25,"25114",98,72,72,0,0,"PP",2
18,"18042",403,324,322,2,2,"PP",99
14,"14005",6311,4143,4084,72,59,"PP",932
4,"4032",5586,3642,3623,23,19,"PP",1272
1,"1019",150,106,105,1,1,"PP",18
25,"25115",824,489,487,7,2,"PP",37
24,"24022",330,230,229,0,1,"PP",113
1,"1020",327,237,234,3,3,"PP",23
27,"27008",1379,1000,982,9,18,"PP",541
9,"9257",93,81,80,4,1,"PP",58
49,"49158",215,170,166,2,4,"PP",72
39,"39011",1585,1169,1160,5,9,"PP",653
46,"46007",11989,8784,8711,67,73,"PP",3108
43,"43030",427,288,283,1,5,"PP",29
19,"19211",369,289,284,0,5,"PP",139
4,"4033",135,97,93,1,4,"PP",25
18,"18044",181,107,107,0,0,"PP",48
16,"16187",74,55,55,1,0,"PP",29
41,"41009",1222,812,805,3,7,"PP",247
47,"47196",34,27,27,0,0,"PP",23
25,"25118",346,198,189,3,9,"PP",35
16,"16188",91,65,65,0,0,"PP",25
14,"14006",1330,1120,1101,8,19,"PP",496
41,"41010",4420,2960,2916,30,44,"PP",701
39,"39012",6687,5021,4957,51,64,"PP",1801
1,"1021",473,310,309,0,1,"PP",72
37,"37080",225,171,167,0,4,"PP",85
27,"27010",4327,2899,2837,53,62,"PP",1487
29,"29026",1057,751,748,5,3,"PP",245
49,"49160",49,33,33,0,0,"PP",10
27,"27011",2452,1494,1467,19,27,"PP",655
14,"14007",15207,10558,10417,82,141,"PP",3072
10,"10177",1707,1228,1201,5,27,"PP",384
47,"47197",876,673,668,8,5,"PP",354
19,"19324",176,126,125,3,1,"PP",58
49,"49162",186,142,140,1,2,"PP",61
47,"47198",69,50,50,0,0,"PP",34
4,"4035",8364,5810,5766,28,44,"PP",2328
19,"19213",70,62,61,2,1,"PP",32
41,"41011",15401,10170,9986,111,184,"PP",2074
39,"39013",511,402,399,4,3,"PP",264
1,"1022",799,557,544,2,13,"PP",165
18,"18046",1832,1160,1140,6,20,"PP",405
24,"24025",297,228,227,0,1,"PP",140
25,"25120",92002,55658,55214,587,444,"PP",10080
10,"10179",294,231,229,2,2,"PP",98
14,"14008",2839,1905,1895,19,10,"PP",672
25,"25121",644,415,410,8,5,"PP",82
27,"27013",3766,2900,2851,25,49,"PP",1096
18,"18047",5903,3893,3857,28,36,"PP",1143
47,"47199",80,63,63,0,0,"PP",34
1,"1023",267,187,186,1,1,"PP",63
41,"41012",3290,2071,2030,20,41,"PP",619
19,"19215",168,144,140,0,4,"PP",91
27,"27014",3254,2103,2067,21,36,"PP",1014
17,"17046",717,459,458,4,1,"PP",37
7,"7029",4166,2949,2913,37,36,"PP",966
10,"10180",4134,2643,2601,25,42,"PP",1094
1,"1027",416,257,254,3,3,"PP",37
14,"14009",2788,1852,1834,20,18,"PP",582
25,"25122",1915,1208,1197,16,11,"PP",92
34,"34055",270,209,207,2,2,"PP",128
37,"37085",4712,3366,3333,27,33,"PP",1386
27,"27015",4270,2832,2769,33,63,"PP",1544
6,"6062",594,441,437,5,4,"PP",194
43,"43036",843,493,485,4,8,"PP",58
14,"14010",4027,2850,2807,19,43,"PP",784
47,"47200",85,66,66,0,0,"PP",46
1,"1028",1070,716,710,3,6,"PP",204
9,"9266",91,74,74,0,0,"PP",36
46,"46011",7609,5249,5191,26,58,"PP",1983
34,"34056",1998,1452,1444,13,8,"PP",704
10,"10182",136,95,95,0,0,"PP",39
24,"24027",1211,863,847,8,16,"PP",298
39,"39016",23868,17883,17701,122,182,"PP",6859
27,"27017",1003,674,670,4,4,"PP",383
46,"46246",1058,835,823,5,12,"PP",397
25,"25124",166,106,105,1,1,"PP",13
2,"2082",101,80,80,1,0,"PP",32
14,"14011",578,464,462,4,2,"PP",193
49,"49166",1227,946,933,6,13,"PP",373
4,"4041",322,240,238,6,2,"PP",96
19,"19217",54,40,39,0,1,"PP",18
1,"1030",156,129,129,3,0,"PP",42
47,"47203",62,53,53,1,0,"PP",39
6,"6064",841,666,656,2,10,"PP",129
24,"24028",388,292,288,2,4,"PP",117
27,"27019",8111,5773,5680,53,93,"PP",2349
19,"19218",50,33,33,0,0,"PP",16
6,"6065",311,236,228,1,8,"PP",111
9,"9267",111,99,97,1,2,"PP",66
25,"25125",417,250,250,5,0,"PP",32
16,"16195",497,392,390,1,2,"PP",157
49,"49168",93,74,74,0,0,"PP",47
1,"1031",1169,882,863,6,19,"PP",298
25,"25126",290,200,198,2,2,"PP",17
19,"19219",13,9,9,0,0,"PP",1
14,"14012",6173,4364,4291,35,73,"PP",1204
4,"4043",549,465,461,1,4,"PP",224
6,"6066",1762,1189,1182,2,7,"PP",385
43,"43162",4346,2983,2958,21,25,"PP",438
9,"9268",95,68,66,0,2,"PP",29
18,"18053",1630,1082,1076,8,6,"PP",349
41,"41017",15158,10718,10616,92,102,"PP",3524
27,"27021",1753,1090,1056,12,34,"PP",527
34,"34060",137,111,108,0,3,"PP",57
1,"1032",517,361,354,1,7,"PP",83
27,"27022",4833,3022,2954,30,68,"PP",1416
6,"6067",1972,1308,1292,8,16,"PP",563
14,"14013",16796,11830,11616,129,214,"PP",4568
4,"4044",1547,1166,1156,5,10,"PP",490
47,"47205",384,266,260,0,6,"PP",166
46,"46014",3030,2383,2350,20,33,"PP",795
25,"25127",210,136,136,2,0,"PP",3
9,"9270",163,115,115,0,0,"PP",69
39,"39019",2079,1560,1531,10,29,"PP",616
27,"27023",2579,1891,1865,23,26,"PP",1158
19,"19220",2302,1519,1501,1,18,"PP",460
39,"39020",23592,15594,15384,128,210,"PP",4453
14,"14014",2557,2035,2007,9,28,"PP",573
19,"19221",48,38,37,1,1,"PP",21
25,"25128",136,75,75,0,0,"PP",6
27,"27024",1598,1173,1158,8,15,"PP",584
1,"1033",651,484,479,2,5,"PP",103
49,"49171",646,514,508,10,6,"PP",273
46,"46015",7244,5615,5560,40,55,"PP",1791
25,"25129",175,83,83,2,0,"PP",4
34,"34062",171,119,118,2,1,"PP",74
10,"10189",2630,1880,1851,4,29,"PP",657
9,"9272",282,210,206,3,4,"PP",109
4,"4046",858,609,599,7,10,"PP",234
1,"1034",161,124,123,1,1,"PP",13
39,"39021",487,381,376,2,5,"PP",204
14,"14015",2125,1579,1554,10,25,"PP",520
9,"9017",89,68,67,4,1,"PP",27
47,"47207",278,215,212,3,3,"PP",132
37,"37096",214,166,163,2,3,"PP",109
19,"19222",110,82,82,0,0,"PP",38
27,"27026",2397,1503,1471,9,32,"PP",728
6,"6071",245,206,200,0,6,"PP",78
1,"1036",14955,10052,9959,55,93,"PP",1100
39,"39022",980,721,713,2,8,"PP",408
37,"37097",39,27,27,1,0,"PP",18
24,"24033",205,158,157,0,1,"PP",99
27,"27027",1929,1369,1342,11,27,"PP",581
19,"19223",111,83,83,3,0,"PP",36
4,"4047",2281,1893,1878,11,15,"PP",807
14,"14016",1337,1072,1060,2,12,"PP",321
25,"25131",403,248,241,7,7,"PP",30
47,"47208",58,38,36,1,2,"PP",18
9,"9413",436,306,302,2,4,"PP",167
9,"9274",1079,848,835,12,13,"PP",369
19,"19224",93,87,87,0,0,"PP",72
27,"27028",79049,54057,53355,559,702,"PP",21737
46,"46017",32949,23913,23685,142,228,"PP",8551
30,"30021",9099,6095,6045,20,50,"PP",3309
27,"27029",1463,1023,1002,11,21,"PP",514
39,"39023",6330,4737,4672,25,65,"PP",1656
16,"16205",115,88,87,0,1,"PP",49
1,"1037",587,411,408,1,3,"PP",63
41,"41022",4290,2889,2851,21,38,"PP",492
49,"49174",125,95,92,1,3,"PP",58
47,"47209",41,34,34,0,0,"PP",11
25,"25132",136,88,87,0,1,"PP",4
27,"27030",3327,2207,2159,31,48,"PP",1073
16,"16206",204,158,157,6,1,"PP",74
14,"14017",10868,7764,7665,71,99,"PP",2075
1,"1039",209,155,153,0,2,"PP",30
19,"19225",823,623,619,3,4,"PP",203
49,"49175",230,172,171,1,1,"PP",91
27,"27031",15570,10606,10420,118,186,"PP",4522
18,"18063",1200,679,675,2,4,"PP",265
9,"9276",382,251,240,3,11,"PP",54
29,"29039",2666,1898,1873,22,25,"PP",437
14,"14018",3709,2697,2653,26,44,"PP",871
16,"16209",116,101,101,2,0,"PP",49
25,"25134",623,369,366,3,3,"PP",46
34,"34069",2266,1666,1637,11,29,"PP",627
4,"4050",800,558,553,3,5,"PP",190
19,"19226",43,38,38,0,0,"PP",13
49,"49176",667,433,431,1,2,"PP",332
46,"46019",8849,7072,7004,33,68,"PP",2025
10,"10196",301,225,225,1,0,"PP",98
1,"1041",149,103,100,1,3,"PP",40
39,"39025",8637,6486,6378,47,108,"PP",2272
24,"24038",3089,2312,2273,17,39,"PP",768
45,"45030",478,368,360,2,8,"PP",136
4,"4051",436,360,356,1,4,"PP",148
37,"37102",404,307,305,2,2,"PP",167
25,"25135",1028,600,593,10,7,"PP",50
19,"19227",66,44,43,2,1,"PP",15
39,"39026",1750,1236,1224,11,12,"PP",643
34,"34070",154,123,123,2,0,"PP",66
14,"14019",6464,4967,4909,49,58,"PP",1134
1,"1042",904,653,648,6,5,"PP",50
25,"25136",95,64,64,1,0,"PP",9
24,"24039",2063,1597,1596,41,1,"PP",796
9,"9022",66,57,57,1,0,"PP",30
27,"27035",187,122,121,1,1,"PP",35
49,"49178",705,496,487,4,9,"PP",202
19,"19228",26,20,20,0,0,"PP",2
14,"14020",387,269,264,2,5,"PP",87
47,"47211",47,35,34,0,1,"PP",27
1,"1043",2304,1552,1532,13,20,"PP",372
4,"4052",12274,8372,8306,93,66,"PP",2744
25,"25137",8585,5143,5095,56,48,"PP",575
29,"29042",14016,9368,9192,88,176,"PP",3258
39,"39027",3118,2322,2295,26,27,"PP",1087
47,"47212",380,323,322,2,1,"PP",196
46,"46021",23649,17291,17153,100,138,"PP",4790
14,"14021",260178,181773,180348,1872,1425,"PP",71843
19,"19229",66,56,56,0,0,"PP",30
16,"16215",242,172,169,2,3,"PP",50
10,"10200",392,306,302,1,4,"PP",145
29,"29043",2509,1608,1576,18,32,"PP",489
25,"25138",569,363,360,4,3,"PP",51
4,"4053",12320,8946,8866,70,80,"PP",4123
9,"9281",145,114,109,1,5,"PP",49
1,"1044",236,169,167,0,2,"PP",44
19,"19230",505,360,357,3,3,"PP",109
39,"39028",3739,2850,2817,16,33,"PP",1250
47,"47213",109,82,82,0,0,"PP",47
39,"39029",618,488,481,3,7,"PP",252
15,"15041",9568,6828,6710,75,118,"PP",3059
16,"16216",315,268,265,1,3,"PP",106
14,"14022",4006,2977,2949,17,28,"PP",438
27,"27040",3200,2351,2310,21,41,"PP",1373
25,"25139",467,294,291,5,3,"PP",12
34,"34074",707,540,531,9,9,"PP",240
1,"1046",601,432,428,3,4,"PP",99
9,"9283",44,32,31,0,1,"PP",22
32,"32010",388,301,299,3,2,"PP",181
19,"19231",10,9,9,0,0,"PP",9
14,"14023",2021,1660,1639,8,21,"PP",803
6,"6083",46149,31049,30739,234,310,"PP",10978
34,"34076",587,479,479,2,0,"PP",304
39,"39030",1895,1225,1212,10,13,"PP",512
49,"49183",100,77,77,2,0,"PP",54
1,"1047",968,673,668,5,5,"PP",189
27,"27042",1740,1235,1218,12,17,"PP",812
24,"24042",63,56,56,1,0,"PP",32
25,"25140",788,435,430,9,5,"PP",40
9,"9288",90,70,70,0,0,"PP",43
5,"5070",30,27,27,0,0,"PP",10
6,"6085",3428,2453,2414,25,39,"PP",596
49,"49184",172,115,112,0,3,"PP",91
34,"34077",347,244,238,4,6,"PP",88
14,"14024",1903,1405,1376,16,29,"PP",364
47,"47215",53,45,45,0,0,"PP",30
1,"1049",138,109,109,1,0,"PP",16
25,"25141",153,95,95,0,0,"PP",10
27,"27044",2879,1705,1662,27,43,"PP",934
25,"25142",364,229,225,2,4,"PP",17
39,"39031",1236,878,868,4,10,"PP",448
45,"45037",1603,1122,1111,5,11,"PP",486
9,"9289",1451,1014,1000,5,14,"PP",495
39,"39032",1463,1087,1081,7,6,"PP",581
27,"27045",1038,613,603,10,10,"PP",208
14,"14025",2924,2466,2422,14,44,"PP",447
6,"6087",2110,1583,1561,8,22,"PP",644
10,"10206",215,157,157,3,0,"PP",56
1,"1051",3603,2259,2235,17,24,"PP",204
24,"24044",168,119,118,1,1,"PP",63
43,"43058",90,63,63,0,0,"PP",2
29,"29048",1405,1121,1110,8,11,"PP",119
16,"16225",73,57,57,3,0,"PP",35
19,"19234",43,33,33,0,0,"PP",14
34,"34080",5560,3723,3665,32,58,"PP",1705
4,"4058",354,261,259,1,2,"PP",87
25,"25143",84,56,55,0,1,"PP",7
37,"37114",84,70,69,2,1,"PP",41
39,"39033",568,418,415,2,3,"PP",158
6,"6088",12616,8436,8313,70,123,"PP",3194
47,"47217",1910,1370,1366,1,4,"PP",541
19,"19235",93,71,71,1,0,"PP",20
34,"34081",61,53,52,0,1,"PP",34
1,"1052",245,184,181,0,3,"PP",22
14,"14026",2067,1424,1405,4,19,"PP",437
3,"3013",1113,839,836,4,3,"PP",386
9,"9294",108,86,82,0,4,"PP",33
25,"25145",86,65,64,1,1,"PP",3
4,"4059",1079,723,712,4,11,"PP",211
18,"18078",732,570,566,2,4,"PP",152
1,"1053",582,321,320,4,1,"PP",31
27,"27049",1409,921,909,7,12,"PP",562
19,"19237",47,38,38,0,0,"PP",16
37,"37116",69,50,50,0,0,"PP",30
39,"39034",286,188,185,5,3,"PP",115
48,"48074",3312,2330,2309,6,21,"PP",214
16,"16231",46,37,37,0,0,"PP",19
14,"14027",7925,5836,5746,58,90,"PP",1332
27,"27050",2975,2190,2154,16,36,"PP",1275
10,"10210",543,356,355,1,1,"PP",133
4,"4060",445,348,345,5,3,"PP",167
47,"47218",993,743,734,2,9,"PP",231
32,"32018",1247,975,962,9,13,"PP",366
1,"1054",960,654,651,4,3,"PP",50
9,"9297",323,251,250,6,1,"PP",142
19,"19238",42,28,28,0,0,"PP",20
16,"16234",25,18,18,0,0,"PP",2
39,"39035",9502,7017,6928,57,89,"PP",2866
46,"46028",387,330,328,3,2,"PP",118
25,"25149",1385,963,956,6,7,"PP",112
14,"14028",314,253,249,1,4,"PP",77
43,"43063",557,355,349,9,6,"PP",77
34,"34084",138,109,107,0,2,"PP",77
27,"27052",915,676,667,6,9,"PP",293
41,"41036",3941,2674,2642,23,32,"PP",390
1,"1055",838,538,527,8,11,"PP",133
39,"39036",969,743,739,2,4,"PP",349
6,"6093",4447,3254,3204,15,50,"PP",1331
10,"10213",566,469,463,0,6,"PP",242
25,"25150",181,115,113,3,2,"PP",18
9,"9298",82,70,69,1,1,"PP",50
19,"19240",51,44,42,0,2,"PP",21
46,"46029",20613,14964,14879,93,85,"PP",5454
14,"14029",4178,3047,3009,28,38,"PP",985
49,"49191",272,213,206,2,7,"PP",73
27,"27053",537,316,308,3,8,"PP",139
1,"1056",219,136,135,0,1,"PP",26
20,"20016",1520,826,821,2,5,"PP",14
4,"4062",4504,3534,3490,18,44,"PP",1420
32,"32021",947,634,630,5,4,"PP",252
47,"47220",165,130,129,0,1,"PP",77
16,"16238",501,428,422,3,6,"PP",197
49,"49192",130,110,109,2,1,"PP",46
25,"25151",685,425,419,7,6,"PP",37
39,"39037",1987,1516,1503,8,13,"PP",791
19,"19241",43,34,34,1,0,"PP",23
14,"14030",8625,6248,6181,53,67,"PP",1393
39,"39038",1452,997,990,8,7,"PP",408
49,"49193",467,313,308,4,5,"PP",179
4,"4063",1096,776,768,2,8,"PP",291
27,"27056",1248,848,836,9,12,"PP",405
46,"46031",10535,7543,7451,66,92,"PP",2200
16,"16239",135,110,105,0,5,"PP",32
1,"1057",240,201,200,1,1,"PP",30
19,"19242",87,65,65,1,0,"PP",50
9,"9302",112,83,83,1,0,"PP",45
25,"25152",140,86,86,1,0,"PP",11
41,"41039",31663,22062,21830,193,232,"PP",7923
1,"1058",1345,799,793,7,6,"PP",62
16,"16240",102,78,78,0,0,"PP",33
4,"4064",2771,2001,1988,13,13,"PP",946
49,"49194",368,218,216,1,2,"PP",111
20,"20018",11064,6719,6690,41,29,"PP",274
9,"9303",86,68,68,0,0,"PP",48
25,"25153",192,130,128,2,2,"PP",33
15,"15054",32106,21026,20772,259,254,"PP",7216
49,"49197",175,123,123,1,0,"PP",57
14,"14032",423,334,330,4,4,"PP",148
29,"29056",1098,757,750,5,7,"PP",291
16,"16242",317,272,270,1,2,"PP",181
25,"25154",122,74,72,0,2,"PP",9
4,"4065",363,284,282,7,2,"PP",101
9,"9304",199,157,155,3,2,"PP",103
47,"47223",157,122,118,2,4,"PP",51
41,"41041",9706,7239,7120,36,119,"PP",2268
27,"27059",2163,1570,1543,17,27,"PP",957
34,"34091",123,94,93,3,1,"PP",52
1,"1059",186557,126506,125278,798,1228,"PP",28096
14,"14033",1283,971,959,9,12,"PP",218
16,"16243",407,338,334,3,4,"PP",163
34,"34092",288,230,226,1,4,"PP",141
42,"42163",50,41,40,0,1,"PP",11
1,"1060",197,160,157,0,3,"PP",60
25,"25155",647,421,418,0,3,"PP",59
19,"19245",1155,855,835,5,20,"PP",413
4,"4066",13571,8786,8724,50,62,"PP",4360
16,"16244",718,593,587,6,6,"PP",302
47,"47224",87,76,76,0,0,"PP",37
49,"49200",949,720,715,10,5,"PP",361
25,"25156",783,543,537,7,6,"PP",46
6,"6101",463,381,378,2,3,"PP",192
37,"37126",29,24,24,0,0,"PP",20
41,"41042",5844,4424,4378,40,46,"PP",814
39,"39042",5915,4530,4474,21,56,"PP",2082
34,"34093",85,70,70,0,0,"PP",57
9,"9307",109,81,80,0,1,"PP",27
41,"41043",639,436,427,5,9,"PP",74
1,"1061",154,127,127,1,0,"PP",6
19,"19246",46,36,34,2,2,"PP",12
25,"25157",181,115,114,7,1,"PP",21
49,"49201",302,270,268,3,2,"PP",97
24,"24158",320,207,203,2,4,"PP",108
37,"37252",112,79,79,0,0,"PP",58
1,"1062",313,211,210,2,1,"PP",62
4,"4068",187,154,152,0,2,"PP",67
19,"19247",139,102,100,1,2,"PP",36
14,"14035",5966,4236,4177,39,59,"PP",1890
41,"41044",7423,5273,5241,34,32,"PP",1692
43,"43073",83,60,58,0,2,"PP",1
16,"16246",482,361,355,3,6,"PP",198
47,"47225",80,63,63,0,0,"PP",38
29,"29060",692,510,508,1,2,"PP",285
9,"9309",301,224,220,0,4,"PP",123
27,"27065",12444,8261,8056,112,205,"PP",4443
34,"34096",55,42,42,0,0,"PP",24
25,"25158",1620,1019,1012,15,7,"PP",61
1,"1063",1798,1269,1261,19,8,"PP",174
4,"4069",4687,3471,3437,27,34,"PP",1341
16,"16247",67,58,58,0,0,"PP",27
27,"27066",12696,8704,8537,98,167,"PP",3442
47,"47226",156,123,123,0,0,"PP",50
15,"15060",5772,4032,3958,46,74,"PP",1634
14,"14036",3740,2747,2696,24,51,"PP",583
34,"34098",777,551,545,8,6,"PP",213
41,"41045",5756,3988,3924,53,64,"PP",763
19,"19248",78,63,63,0,0,"PP",26
39,"39044",3849,2765,2732,21,33,"PP",1049
6,"6106",423,274,272,5,2,"PP",117
9,"9310",13,9,8,0,1,"PP",1
19,"19249",32,29,29,0,0,"PP",23
37,"37130",172,151,150,0,1,"PP",113
1,"1901",2354,1592,1571,8,21,"PP",324
47,"47227",61,50,50,0,0,"PP",24
45,"45052",2948,2321,2295,16,26,"PP",889
9,"9311",59,46,45,0,1,"PP",13
3,"3025",1270,950,941,2,9,"PP",456
11,"11002",4273,2835,2815,16,20,"PP",195
27,"27902",7205,4829,4754,53,75,"PP",1985
14,"14037",3318,2374,2320,22,54,"PP",836
6,"6107",1581,999,995,8,4,"PP",315
47,"47228",440,331,331,2,0,"PP",165
18,"18097",960,693,685,5,8,"PP",244
25,"25164",376,242,238,4,4,"PP",18
1,"1902",734,514,502,4,12,"PP",127
9,"9312",96,78,77,0,1,"PP",49
19,"19250",20,17,17,0,0,"PP",9
4,"4071",394,338,337,3,1,"PP",94
29,"29063",323,250,245,1,5,"PP",111
39,"39046",1404,1001,973,6,28,"PP",317
43,"43077",463,272,272,5,0,"PP",61
19,"19251",43,29,28,0,1,"PP",17
6,"6109",3919,3139,3012,24,127,"PP",975
16,"16251",1849,1381,1366,7,15,"PP",777
37,"37133",111,78,73,1,5,"PP",38
2,"2001",656,527,523,1,4,"PP",272
16,"16253",337,264,263,2,1,"PP",163
14,"14039",2604,2062,2021,12,41,"PP",626
4,"4072",313,247,245,2,2,"PP",130
39,"39047",1962,1385,1371,10,14,"PP",630
47,"47229",210,148,147,1,1,"PP",77
18,"18099",1584,1228,1206,14,22,"PP",374
3,"3027",157,138,135,0,3,"PP",53
25,"25166",181,110,109,2,1,"PP",19
34,"34102",205,169,168,1,1,"PP",106
19,"19252",69,60,60,0,0,"PP",38
47,"47066",1268,981,977,12,4,"PP",422
46,"46039",2130,1728,1699,8,29,"PP",658
2,"2002",470,394,389,3,5,"PP",180
39,"39048",1716,1329,1312,12,17,"PP",628
25,"25167",230,138,138,3,0,"PP",22
14,"14040",3776,2873,2833,32,40,"PP",614
16,"16254",214,174,170,2,4,"PP",82
28,"28003",173,141,141,0,0,"PP",51
2,"2003",132346,95878,95217,630,661,"PP",38470
26,"26022",198,164,163,1,1,"PP",125
6,"6112",393,323,321,2,2,"PP",129
47,"47230",303,246,242,2,4,"PP",117
9,"9180",142,107,102,1,5,"PP",44
37,"37135",1207,905,899,15,6,"PP",444
19,"19254",45,34,34,0,0,"PP",18
25,"25168",509,354,352,7,2,"PP",49
46,"46255",3174,2448,2424,22,24,"PP",844
14,"14041",3182,2296,2251,33,45,"PP",395
19,"19255",79,63,61,1,2,"PP",32
49,"49210",471,370,365,1,5,"PP",152
2,"2004",612,479,473,5,6,"PP",224
41,"41051",2180,1529,1501,2,28,"PP",498
2,"2005",559,424,416,5,8,"PP",207
28,"28004",6234,4202,4167,16,35,"PP",1785
45,"45058",375,311,304,1,7,"PP",149
6,"6114",137,112,112,0,0,"PP",32
4,"4075",5196,3735,3706,23,29,"PP",1586
25,"25169",173,112,111,3,1,"PP",11
19,"19256",43,36,36,0,0,"PP",23
18,"18102",8400,5592,5504,44,88,"PP",1343
46,"46256",6853,4951,4890,25,61,"PP",1915
14,"14042",18891,14051,13848,190,203,"PP",3811
28,"28005",134246,99236,98481,583,755,"PP",33949
49,"49214",698,525,512,3,13,"PP",260
46,"46041",329,253,252,5,1,"PP",70
47,"47232",102,77,74,1,3,"PP",40
4,"4076",1279,960,944,8,16,"PP",287
9,"9318",61,41,41,0,0,"PP",20
2,"2006",579,464,458,3,6,"PP",222
28,"28006",78966,59065,58698,267,367,"PP",23888
34,"34107",81,52,51,5,1,"PP",35
19,"19257",3403,2430,2402,19,28,"PP",1237
39,"39051",66,57,57,0,0,"PP",27
25,"25171",2185,1416,1410,8,6,"PP",88
48,"48001",5838,3923,3898,28,25,"PP",419
14,"14043",7574,5515,5443,81,72,"PP",1401
2,"2007",1030,824,818,4,6,"PP",260
34,"34108",542,421,417,3,4,"PP",176
4,"4077",295,263,261,2,2,"PP",169
24,"24167",750,505,499,4,6,"PP",213
2,"2008",1193,857,847,7,10,"PP",344
16,"16264",435,366,364,2,2,"PP",200
39,"39052",18236,13537,13380,110,157,"PP",5419
9,"9450",28,22,21,0,1,"PP",10
19,"19258",90,77,77,0,0,"PP",45
46,"46258",2652,2084,2062,16,22,"PP",851
34,"34109",59,48,48,0,0,"PP",38
2,"2009",19660,14256,14116,127,140,"PP",5126
39,"39053",219,153,152,2,1,"PP",77
14,"14044",1604,1172,1165,7,7,"PP",252
25,"25172",1797,1170,1146,10,24,"PP",156
16,"16265",20,19,19,0,0,"PP",9
28,"28007",124592,94222,93521,491,701,"PP",33088
48,"48002",7829,5490,5451,44,39,"PP",256
25,"25173",1705,1156,1143,14,13,"PP",139
19,"19259",30,25,25,1,0,"PP",7
6,"6119",689,501,499,4,2,"PP",203
48,"48094",3161,2094,2073,12,21,"PP",72
9,"9325",190,130,129,2,1,"PP",85
2,"2010",1789,1437,1421,11,16,"PP",627
16,"16269",419,336,332,2,4,"PP",191
4,"4079",51383,33777,33586,257,191,"PP",15024
11,"11011",1716,1195,1165,12,30,"PP",383
18,"18108",850,659,656,3,3,"PP",206
39,"39054",4493,3376,3334,33,42,"PP",1094
41,"41056",3687,2841,2812,30,29,"PP",402
25,"25174",397,280,280,2,0,"PP",32
9,"9326",140,112,111,0,1,"PP",42
48,"48003",14339,9918,9838,53,80,"PP",539
2,"2011",632,520,516,1,4,"PP",238
19,"19260",42,39,39,1,0,"PP",13
48,"48004",335,222,222,0,0,"PP",0
6,"6121",3355,2279,2248,8,31,"PP",959
2,"2012",1835,1476,1453,7,23,"PP",469
39,"39055",1086,824,816,6,8,"PP",471
14,"14046",4485,3268,3208,33,60,"PP",477
25,"25175",186,117,117,1,0,"PP",20
17,"17098",301,192,188,2,4,"PP",15
6,"6122",6634,4427,4321,26,106,"PP",1677
46,"46045",1249,1028,1010,3,18,"PP",312
11,"11013",2312,1547,1518,15,29,"PP",380
24,"24070",4124,3024,2981,20,43,"PP",666
2,"2013",119,92,90,0,2,"PP",51
48,"48005",115,63,61,0,2,"PP",1
16,"16271",633,517,516,4,1,"PP",265
19,"19262",135,100,100,0,0,"PP",57
9,"9327",26,24,24,0,0,"PP",6
43,"43091",132,86,86,0,0,"PP",2
25,"25176",309,216,211,1,5,"PP",37
42,"42049",116,81,81,1,0,"PP",60
14,"14047",1672,1187,1178,14,9,"PP",343
16,"16272",221,176,175,0,1,"PP",116
49,"49224",162,112,112,1,0,"PP",59
9,"9061",162,124,123,0,1,"PP",106
46,"46046",892,675,668,1,7,"PP",267
2,"2014",356,283,280,1,3,"PP",92
48,"48006",290,239,239,2,0,"PP",1
28,"28011",442,317,316,1,1,"PP",136
19,"19263",26,15,15,1,0,"PP",8
16,"16273",321,242,236,3,6,"PP",175
9,"9329",121,87,87,1,0,"PP",27
34,"34120",64214,47193,46683,331,510,"PP",19552
2,"2015",1441,1112,1093,5,19,"PP",483
14,"14048",1207,884,869,13,15,"PP",212
6,"6125",1743,1285,1269,7,16,"PP",504
11,"11015",62476,38177,37875,488,302,"PP",12871
37,"37147",193,134,132,1,2,"PP",62
25,"25179",162,103,103,2,0,"PP",4
28,"28012",887,664,661,2,3,"PP",286
41,"41060",15242,10021,9847,86,174,"PP",3065
48,"48007",364,240,240,5,0,"PP",0
4,"4083",1776,1345,1336,6,9,"PP",463
19,"19264",33,26,26,0,0,"PP",8
16,"16274",121,92,92,0,0,"PP",35
15,"15078",78198,56154,55581,560,573,"PP",21851
6,"6126",2170,1523,1507,1,16,"PP",514
2,"2016",569,413,410,6,3,"PP",189
25,"25180",234,143,143,1,0,"PP",16
34,"34121",187,148,148,3,0,"PP",101
2,"2017",838,594,589,1,5,"PP",252
34,"34122",83,60,60,0,0,"PP",27
19,"19265",122,97,95,2,2,"PP",60
4,"4084",341,249,247,2,2,"PP",115
6,"6128",4447,2975,2935,26,40,"PP",1123
48,"48008",606,424,414,6,10,"PP",22
9,"9332",140,106,106,2,0,"PP",50
25,"25181",172,123,120,4,3,"PP",14
39,"39059",7986,5879,5806,45,73,"PP",2670
4,"4085",387,304,301,2,3,"PP",160
19,"19266",236,188,188,1,0,"PP",115
39,"39060",6679,5196,5121,29,75,"PP",1801
34,"34123",1648,1287,1258,12,29,"PP",637
2,"2018",829,661,653,1,8,"PP",306
41,"41062",2223,1653,1637,7,16,"PP",107
25,"25182",1036,660,655,9,5,"PP",85
14,"14051",1397,1018,1000,2,18,"PP",376
28,"28014",33085,23626,23466,113,160,"PP",8810
15,"15080",1756,1131,1117,11,14,"PP",619
48,"48009",783,586,575,1,11,"PP",20
16,"16278",70,55,55,0,0,"PP",29
9,"9334",50,39,37,0,2,"PP",15
2,"2019",2405,1871,1835,12,36,"PP",662
4,"4086",1760,1243,1234,9,9,"PP",640
39,"39061",3478,2695,2677,13,18,"PP",1418
48,"48010",458,318,317,0,1,"PP",3
49,"49230",97,72,72,0,0,"PP",30
6,"6130",195,164,158,0,6,"PP",54
46,"46050",194,150,149,0,1,"PP",38
11,"11019",1826,1302,1248,7,54,"PP",436
24,"24078",380,289,277,0,12,"PP",117
2,"2020",432,365,364,1,1,"PP",161
14,"14052",9379,5917,5854,68,63,"PP",2039
9,"9337",117,92,91,0,1,"PP",39
41,"41064",5596,3517,3456,55,61,"PP",685
25,"25185",692,400,397,6,3,"PP",37
48,"48011",9673,6468,6423,45,45,"PP",503
19,"19268",35,24,24,1,0,"PP",8
2,"2021",1017,784,778,6,6,"PP",386
29,"29069",85684,54130,53621,455,509,"PP",19870
34,"34126",277,200,199,2,1,"PP",131
46,"46051",8347,6355,6302,24,53,"PP",2784
19,"19269",102,81,80,0,1,"PP",20
37,"37154",140,113,110,3,3,"PP",82
2,"2022",351,281,279,1,2,"PP",166
6,"6133",1775,1324,1312,15,12,"PP",538
14,"14053",6006,4285,4232,49,53,"PP",1142
48,"48012",2049,1527,1512,7,15,"PP",60
24,"24079",906,664,658,9,6,"PP",329
25,"25189",2110,1198,1186,10,12,"PP",120
18,"18122",16114,11098,10945,83,153,"PP",3855
28,"28017",1208,907,899,7,8,"PP",333
37,"37155",65,57,57,0,0,"PP",23
11,"11021",6764,4434,4362,52,72,"PP",1135
41,"41066",1342,945,927,2,18,"PP",175
39,"39063",967,697,690,9,7,"PP",332
34,"34127",93,65,64,1,1,"PP",38
2,"2023",568,486,479,3,7,"PP",234
19,"19270",20,17,17,0,0,"PP",9
14,"14054",13697,10315,10109,93,206,"PP",3912
19,"19271",46,39,39,0,0,"PP",25
11,"11022",48675,26491,26256,270,235,"PP",8250
18,"18123",301,228,222,1,6,"PP",66
25,"25190",262,185,183,0,2,"PP",2
48,"48013",79716,53419,52997,345,422,"PP",6944
9,"9339",128,110,110,0,0,"PP",56
16,"16903",1070,777,765,4,12,"PP",522
39,"39064",1345,1031,1015,7,16,"PP",529
2,"2024",3409,2589,2554,29,35,"PP",941
14,"14055",18557,12950,12764,178,186,"PP",4761
49,"49234",412,328,324,0,4,"PP",158
28,"28018",3768,2968,2945,26,23,"PP",1310
48,"48014",1211,806,801,7,5,"PP",63
34,"34130",212,164,163,1,1,"PP",84
9,"9340",77,49,49,0,0,"PP",36
2,"2025",7461,5759,5618,34,141,"PP",2549
4,"4090",304,238,234,0,4,"PP",76
19,"19272",72,54,53,1,1,"PP",20
2,"2026",836,690,679,3,11,"PP",223
39,"39065",252,191,189,1,2,"PP",82
48,"48015",33581,22727,22528,122,199,"PP",2672
14,"14056",23581,16120,15958,143,162,"PP",4575
25,"25192",743,449,436,2,13,"PP",56
9,"9343",93,66,65,0,1,"PP",48
18,"18126",1483,1081,1074,15,7,"PP",193
39,"39066",872,667,661,4,6,"PP",243
6,"6138",1047,727,715,5,12,"PP",192
2,"2027",315,248,246,2,2,"PP",116
19,"19274",902,660,651,7,9,"PP",246
24,"24082",858,629,614,8,15,"PP",195
16,"16905",1224,920,910,4,10,"PP",346
9,"9345",123,93,91,2,2,"PP",37
48,"48016",5271,3694,3674,24,20,"PP",474
6,"6139",553,420,419,1,1,"PP",133
16,"16906",80,67,67,1,0,"PP",39
14,"14057",6136,4713,4631,47,82,"PP",1268
28,"28020",145,94,94,0,0,"PP",38
25,"25193",759,485,480,2,5,"PP",31
46,"46055",1262,1025,1012,5,13,"PP",315
19,"19277",19,13,13,0,0,"PP",4
43,"43106",810,526,522,7,4,"PP",73
9,"9346",92,64,63,1,1,"PP",36
2,"2028",126,98,98,0,0,"PP",33
41,"41070",6032,4312,4258,44,54,"PP",1208
25,"25194",423,246,244,6,2,"PP",36
48,"48017",13261,8543,8482,42,61,"PP",228
9,"9074",794,575,569,6,6,"PP",220
49,"49238",254,194,193,1,1,"PP",98
46,"46056",182,167,166,1,1,"PP",52
14,"14058",7970,5491,5417,66,74,"PP",1862
4,"4093",1882,1216,1204,11,12,"PP",552
28,"28021",554,370,364,3,6,"PP",135
2,"2029",3282,2467,2445,17,22,"PP",888
19,"19278",28,26,26,0,0,"PP",21
18,"18132",3291,2524,2494,9,30,"PP",439
19,"19279",57,55,55,0,0,"PP",36
43,"43108",1774,1172,1160,14,12,"PP",124
2,"2030",3065,2287,2263,6,24,"PP",733
4,"4094",207,144,144,0,0,"PP",100
25,"25197",133,89,88,1,1,"PP",6
48,"48018",869,522,522,2,0,"PP",6
14,"14059",690,533,528,4,5,"PP",212
28,"28022",33479,27129,27037,133,92,"PP",14235
49,"49239",663,458,448,3,10,"PP",180
20,"20051",6877,4699,4679,34,20,"PP",334
5,"5132",960,669,657,1,12,"PP",334
9,"9348",148,111,110,2,1,"PP",62
39,"39069",1972,1510,1489,12,21,"PP",484
2,"2031",565,457,455,0,2,"PP",190
19,"19280",3464,2469,2438,14,31,"PP",806
34,"34136",179,110,110,1,0,"PP",75
6,"6143",3360,2353,2321,12,32,"PP",672
29,"29079",2416,1788,1764,10,24,"PP",473
48,"48019",3553,2406,2397,18,9,"PP",168
43,"43109",2606,1491,1475,20,16,"PP",238
39,"39070",144,96,94,2,2,"PP",43
41,"41073",1707,1055,1041,5,14,"PP",315
28,"28023",4775,3755,3735,12,20,"PP",1507
46,"46058",1772,1398,1373,15,25,"PP",409
2,"2032",276,207,202,1,5,"PP",61
48,"48020",273626,184710,183628,1185,1082,"PP",31165
15,"15092",6438,3976,3903,28,73,"PP",1931
19,"19281",21,15,15,2,0,"PP",4
2,"2033",1892,1505,1474,6,31,"PP",660
3,"3051",348,296,294,0,2,"PP",118
39,"39071",397,261,256,1,5,"PP",181
9,"9351",62,49,48,1,1,"PP",30
14,"14061",744,595,582,1,13,"PP",164
28,"28024",151,125,124,1,1,"PP",66
24,"24088",1029,791,789,10,2,"PP",393
18,"18136",1851,1354,1337,5,17,"PP",325
19,"19282",163,124,123,0,1,"PP",97
11,"11030",22775,15157,14958,149,199,"PP",5571
25,"25202",104,73,72,0,1,"PP",4
9,"9352",114,92,92,1,0,"PP",44
48,"48021",1336,908,899,1,9,"PP",36
39,"39072",344,198,196,2,2,"PP",130
2,"2034",1382,1110,1093,7,17,"PP",401
34,"34139",166,107,106,1,1,"PP",64
37,"37167",173,143,140,2,3,"PP",38
19,"19283",30,25,25,0,0,"PP",12
2,"2035",1960,1483,1465,13,18,"PP",545
14,"14062",1025,806,792,6,14,"PP",309
11,"11031",76455,49854,49405,535,449,"PP",16614
17,"17004",512,335,334,4,1,"PP",16
48,"48022",2336,1444,1433,6,11,"PP",97
41,"41076",2183,1341,1327,19,14,"PP",353
25,"25203",8931,5003,4955,72,48,"PP",652
4,"4098",1516,1115,1106,11,9,"PP",377
25,"25204",1231,731,724,5,7,"PP",100
34,"34141",177,149,145,2,4,"PP",82
2,"2036",95,78,78,0,0,"PP",49
39,"39073",9837,7356,7298,31,58,"PP",2999
6,"6149",10295,7651,7536,56,115,"PP",2927
9,"9353",76,57,56,1,1,"PP",22
19,"19284",10,10,9,0,1,"PP",3
17,"17005",413,257,252,3,5,"PP",19
41,"41077",8702,5983,5875,29,108,"PP",1333
47,"47089",148,125,124,0,1,"PP",89
14,"14063",1046,734,725,2,9,"PP",301
34,"34143",168,123,120,2,3,"PP",72
46,"46061",342,274,272,1,2,"PP",77
9,"9354",33,29,28,2,1,"PP",15
28,"28027",1203,872,857,3,15,"PP",356
12,"12090",102,86,85,1,1,"PP",56
2,"2037",22865,14632,14477,91,155,"PP",6092
14,"14064",320,242,236,2,6,"PP",90
41,"41078",2508,1823,1810,19,13,"PP",445
6,"6151",1070,770,766,3,4,"PP",217
19,"19285",24,21,21,1,0,"PP",6
39,"39075",137376,99899,99048,718,851,"PP",43755
18,"18141",404,285,282,0,3,"PP",187
19,"19286",720,547,543,2,4,"PP",213
34,"34146",51,40,39,0,1,"PP",21
2,"2038",281,223,223,0,0,"PP",123
49,"49246",227,190,183,2,7,"PP",125
2,"2039",984,790,786,10,4,"PP",328
43,"43116",451,324,317,5,7,"PP",12
48,"48024",995,757,754,7,3,"PP",12
25,"25207",6212,3710,3680,47,30,"PP",293
43,"43117",146,108,105,0,3,"PP",15
9,"9356",42,33,32,0,1,"PP",16
14,"14065",1850,1384,1377,16,7,"PP",448
17,"17008",3639,2191,2171,16,20,"PP",147
28,"28028",1755,1353,1344,6,9,"PP",419
4,"4101",4266,2909,2876,26,33,"PP",1017
19,"19287",148,109,108,0,1,"PP",72
2,"2040",559,484,483,3,1,"PP",207
39,"39076",3476,2594,2559,19,35,"PP",1040
28,"28029",520,408,406,0,2,"PP",173
48,"48025",883,642,637,7,5,"PP",15
17,"17009",4015,2584,2567,14,17,"PP",158
11,"11036",689,407,400,3,7,"PP",153
37,"37173",1504,1129,1114,4,15,"PP",569
45,"45087",8311,5828,5747,43,81,"PP",2775
24,"24094",1385,983,968,11,15,"PP",420
14,"14066",5856,4150,4095,48,55,"PP",1138
6,"6154",2802,1923,1894,23,29,"PP",782
25,"25208",331,183,182,1,1,"PP",8
4,"4102",13694,8944,8865,50,79,"PP",4164
49,"49249",69,58,58,1,0,"PP",47
2,"2041",336,265,260,0,5,"PP",160
39,"39077",236,173,171,1,2,"PP",91
25,"25209",1495,995,978,9,17,"PP",84
2,"2042",837,618,611,1,7,"PP",239
14,"14067",3889,2946,2899,29,47,"PP",958
6,"6155",1874,1218,1202,16,16,"PP",391
46,"46064",509,412,399,1,13,"PP",145
48,"48027",22150,15089,14982,78,107,"PP",1526
18,"18146",965,703,685,9,18,"PP",231
34,"34152",125,96,92,1,4,"PP",43
43,"43120",441,270,267,1,3,"PP",46
41,"41082",3415,2671,2647,16,24,"PP",566
17,"17011",637,444,439,6,5,"PP",23
9,"9361",115,90,89,0,1,"PP",58
19,"19289",28,25,24,1,1,"PP",12
2,"2043",1239,937,927,3,10,"PP",424
29,"29088",2714,1829,1800,12,29,"PP",491
41,"41083",1147,864,856,4,8,"PP",182
17,"17012",1145,703,698,9,5,"PP",74
4,"4901",545,395,394,0,1,"PP",146
2,"2044",1105,768,758,7,10,"PP",279
39,"39079",8874,6547,6478,47,69,"PP",3046
49,"49251",163,127,121,1,6,"PP",64
14,"14068",538,401,398,10,3,"PP",96
9,"9362",208,172,171,2,1,"PP",69
28,"28032",4762,3428,3401,19,27,"PP",1295
19,"19291",1191,879,869,3,10,"PP",387
47,"47015",200,162,160,0,2,"PP",89
41,"41084",2845,2124,2081,9,43,"PP",532
14,"14069",7524,5460,5392,43,68,"PP",1747
48,"48029",8338,5721,5683,37,38,"PP",589
17,"17013",2787,1780,1762,17,18,"PP",221
39,"39080",3542,2656,2628,20,28,"PP",1183
2,"2045",3665,2895,2855,21,40,"PP",819
49,"49252",320,254,252,5,2,"PP",123
29,"29090",1688,1144,1134,15,10,"PP",515
37,"37178",100,76,75,0,1,"PP",49
35,"35028",9776,5476,5401,43,75,"PP",1964
28,"28033",3899,2805,2788,7,17,"PP",1290
9,"9363",965,737,734,2,3,"PP",505
19,"19293",1867,1358,1342,7,16,"PP",448
47,"47016",69,56,55,0,1,"PP",32
6,"6160",3153,2176,2146,16,30,"PP",843
2,"2046",1098,896,878,12,18,"PP",379
14,"14070",1332,986,974,10,12,"PP",489
11,"11041",9866,6477,6402,69,75,"PP",2341
25,"25215",345,240,236,0,4,"PP",32
2,"2047",117,88,88,2,0,"PP",59
6,"6161",302,236,235,1,1,"PP",93
49,"49256",256,204,204,0,0,"PP",132
32,"32088",1622,1018,1002,8,16,"PP",476
25,"25216",226,138,136,1,2,"PP",23
41,"41086",16170,10162,10088,73,74,"PP",2382
9,"9365",29,19,19,0,0,"PP",14
17,"17015",12546,7832,7777,66,55,"PP",451
24,"24099",171,132,132,0,0,"PP",64
19,"19294",29,27,27,0,0,"PP",11
9,"9366",86,62,62,2,0,"PP",32
2,"2048",1226,981,975,7,6,"PP",487
39,"39082",1653,1173,1157,11,16,"PP",698
17,"17016",731,500,496,1,4,"PP",48
6,"6162",2934,2182,2162,14,20,"PP",891
14,"14071",929,642,630,2,12,"PP",189
19,"19296",30,19,18,0,1,"PP",11
11,"11042",1186,868,858,7,10,"PP",293
5,"5001",191,148,147,2,1,"PP",88
14,"14072",1048,806,795,6,11,"PP",176
25,"25217",10625,6319,6260,99,59,"PP",584
9,"9368",22,17,17,2,0,"PP",13
17,"17018",480,327,322,2,5,"PP",11
2,"2049",823,573,564,1,9,"PP",212
39,"39083",1135,679,670,8,9,"PP",282
19,"19297",32,24,24,1,0,"PP",18
2,"2050",98,83,82,0,1,"PP",45
25,"25218",81,64,63,1,1,"PP",0
6,"6902",1667,1121,1113,13,8,"PP",414
46,"46069",162,124,123,0,1,"PP",48
41,"41088",509,360,356,0,4,"PP",91
24,"24101",397,258,257,3,1,"PP",80
25,"25219",141,102,101,0,1,"PP",12
17,"17019",1775,1201,1188,7,13,"PP",58
20,"20067",30828,19984,19882,140,102,"PP",1692
5,"5005",182,148,147,3,1,"PP",80
48,"48033",217,149,149,0,0,"PP",1
19,"19298",65,45,45,0,0,"PP",14
49,"49260",755,590,586,8,4,"PP",296
47,"47019",85,74,73,0,1,"PP",50
2,"2051",1676,1177,1162,6,15,"PP",726
39,"39084",838,631,624,2,7,"PP",384
41,"41089",6493,4398,4331,43,67,"PP",855
25,"25220",1015,634,632,1,2,"PP",94
18,"18154",1007,664,660,2,4,"PP",325
9,"9101",76,56,55,1,1,"PP",36
34,"34161",23,16,16,0,0,"PP",10
17,"17020",3592,2333,2315,20,18,"PP",97
48,"48034",12866,8798,8747,43,51,"PP",1666
5,"5008",227,170,168,1,2,"PP",103
39,"39085",6836,5086,5032,44,54,"PP",2012
26,"26062",89,72,71,2,1,"PP",48
2,"2052",459,372,369,4,3,"PP",156
14,"14074",2299,1896,1866,16,30,"PP",541
19,"19299",97,79,77,1,2,"PP",32
37,"37185",591,423,417,2,6,"PP",206
25,"25221",122,81,81,0,0,"PP",6
5,"5010",152,117,116,1,1,"PP",79
9,"9373",425,287,285,2,2,"PP",224
14,"14075",572,448,428,1,20,"PP",94
18,"18158",8358,5096,5031,28,65,"PP",1008
2,"2053",2998,2231,2189,16,42,"PP",763
39,"39086",358,256,253,0,3,"PP",117
19,"19300",772,595,591,5,4,"PP",224
43,"43132",373,264,261,4,3,"PP",17
9,"9374",90,71,70,1,1,"PP",34
2,"2054",386,291,290,0,1,"PP",162
39,"39087",41985,31178,30805,228,373,"PP",10434
19,"19301",40,33,33,1,0,"PP",22
12,"12003",976,746,736,6,10,"PP",375
42,"42092",56,44,42,1,2,"PP",25
12,"12103",91,69,67,0,2,"PP",49
17,"17023",27269,17209,17032,122,177,"PP",2223
9,"9104",53,42,42,0,0,"PP",35
28,"28039",128,98,97,2,1,"PP",43
47,"47101",1710,1357,1336,16,21,"PP",561
34,"34167",113,94,94,0,0,"PP",55
25,"25223",922,553,543,8,10,"PP",27
5,"5013",868,728,721,6,7,"PP",296
2,"2055",1127,679,668,6,11,"PP",261
9,"9375",36,31,31,0,0,"PP",17
2,"2056",1718,1296,1274,6,22,"PP",579
25,"25224",126,70,70,5,0,"PP",3
15,"15002",23083,16073,15889,159,184,"PP",5382
39,"39088",69,52,52,0,0,"PP",14
28,"28040",15811,10118,10009,56,109,"PP",3386
19,"19302",59,49,49,1,0,"PP",25
45,"45100",188,150,150,0,0,"PP",59
26,"26065",50,43,42,0,1,"PP",31
49,"49021",14330,9878,9758,95,120,"PP",4260
17,"17025",1134,793,787,6,6,"PP",54
29,"29099",950,693,685,4,8,"PP",202
48,"48038",1126,798,794,3,4,"PP",41
9,"9377",632,485,480,1,5,"PP",266
5,"5015",82,61,61,1,0,"PP",23
49,"49265",128,91,91,1,0,"PP",51
24,"24106",248,167,166,1,1,"PP",87
2,"2057",2020,1487,1461,10,26,"PP",385
19,"19303",43,35,35,0,0,"PP",27
39,"39089",143,104,100,1,4,"PP",64
25,"25225",564,356,356,1,0,"PP",31
48,"48039",239,190,188,0,2,"PP",10
15,"15004",4834,3436,3391,30,45,"PP",1253
37,"37191",114,78,75,1,3,"PP",50
28,"28041",4524,3508,3490,20,18,"PP",1380
2,"2058",337,234,231,0,3,"PP",70
45,"45001",1835,1281,1251,3,30,"PP",512
34,"34170",61,42,42,0,0,"PP",30
49,"49267",88,73,69,2,4,"PP",33
15,"15005",24516,15761,15537,213,224,"PP",5273
12,"12006",172,135,133,0,2,"PP",41
18,"18164",1836,1146,1126,6,20,"PP",503
9,"9380",78,58,58,0,0,"PP",35
2,"2059",302,234,232,1,2,"PP",86
29,"29902",2567,1577,1559,11,18,"PP",370
19,"19305",155,116,115,0,1,"PP",62
7,"7009",738,521,510,12,11,"PP",202
2,"2060",1294,997,983,2,14,"PP",506
5,"5168",3560,2589,2561,19,28,"PP",1389
43,"43138",2672,1629,1585,37,44,"PP",295
45,"45002",2564,1681,1665,17,16,"PP",669
15,"15006",5321,3341,3283,49,58,"PP",1694
48,"48040",1281,877,869,3,8,"PP",37
45,"45003",562,408,402,1,6,"PP",206
5,"5019",44555,33259,32939,277,320,"PP",15553
19,"19306",25,20,20,1,0,"PP",15
2,"2061",637,516,511,4,5,"PP",276
42,"42098",10,7,7,1,0,"PP",2
17,"17029",207,127,127,1,0,"PP",8
5,"5021",1914,1483,1464,5,19,"PP",758
39,"39092",894,626,620,1,6,"PP",298
28,"28044",5826,4445,4409,24,36,"PP",1623
48,"48041",693,533,529,3,4,"PP",13
19,"19307",27,23,23,0,0,"PP",16
15,"15007",3303,2262,2246,15,16,"PP",1203
2,"2062",408,297,292,0,5,"PP",129
45,"45004",567,410,406,1,4,"PP",175
18,"18167",1895,1258,1250,4,8,"PP",399
12,"12009",17445,12088,11999,75,89,"PP",4108
39,"39093",299,229,226,4,3,"PP",99
17,"17030",641,400,398,1,2,"PP",62
48,"48042",1369,1068,1053,7,15,"PP",118
15,"15008",5627,4112,4072,36,40,"PP",1795
9,"9384",295,211,206,0,5,"PP",114
34,"34176",133,102,101,0,1,"PP",70
2,"2063",1463,1073,1060,3,13,"PP",421
19,"19308",56,53,53,0,0,"PP",24
24,"24112",309,228,227,1,1,"PP",52
15,"15009",10739,7688,7559,54,129,"PP",3054
18,"18170",330,219,217,0,2,"PP",59
39,"39094",848,655,651,3,4,"PP",321
25,"25232",1397,874,871,12,3,"PP",126
5,"5024",224,169,168,3,1,"PP",93
19,"19309",26,21,21,0,0,"PP",10
2,"2064",372,325,324,1,1,"PP",125
37,"37197",84,57,57,2,0,"PP",30
16,"16031",46,28,28,1,0,"PP",11
45,"45006",1406,942,931,4,11,"PP",366
15,"15010",1887,1168,1150,13,18,"PP",617
5,"5025",94,79,78,0,1,"PP",56
45,"45106",7439,5613,5534,52,79,"PP",2361
12,"12011",4565,3331,3283,20,48,"PP",918
47,"47109",179,138,138,2,0,"PP",53
48,"48044",62774,45594,45399,287,195,"PP",11152
43,"43143",54,47,47,3,0,"PP",0
18,"18171",2120,1572,1551,9,21,"PP",367
45,"45007",696,534,522,3,12,"PP",161
25,"25233",275,178,178,4,0,"PP",20
9,"9387",117,95,90,0,5,"PP",25
17,"17033",5307,3264,3241,29,23,"PP",313
15,"15011",15432,10395,10248,74,147,"PP",4014
2,"2066",234,189,187,1,2,"PP",75
19,"19310",9,7,7,0,0,"PP",2
3,"3076",8467,6238,6157,30,81,"PP",2666
25,"25234",4279,2546,2508,23,38,"PP",270
9,"9388",34,27,26,0,1,"PP",9
9,"9249",46,33,33,0,0,"PP",18
34,"34179",28,21,20,0,1,"PP",15
39,"39096",690,487,479,4,8,"PP",268
16,"16033",1714,1319,1305,6,14,"PP",561
49,"49030",86,69,69,0,0,"PP",55
28,"28047",40914,30019,29788,169,231,"PP",10738
45,"45008",139,118,118,1,0,"PP",58
12,"12013",144,121,119,0,2,"PP",45
19,"19311",82,69,67,0,2,"PP",37
18,"18174",446,330,324,2,6,"PP",124
48,"48046",12611,8836,8794,39,42,"PP",446
5,"5177",158,130,129,0,1,"PP",51
5,"5029",121,96,94,0,2,"PP",64
25,"25239",590,258,256,5,2,"PP",28
7,"7017",851,582,571,7,11,"PP",230
39,"39097",697,371,368,2,3,"PP",226
2,"2068",337,251,246,1,5,"PP",92
15,"15013",6151,4237,4189,48,48,"PP",1753
45,"45009",524,344,341,2,3,"PP",206
19,"19314",51,36,36,0,0,"PP",19
42,"42110",59,45,45,2,0,"PP",22
47,"47031",189,145,145,1,0,"PP",91
2,"2069",11490,8470,8373,41,97,"PP",4158
37,"37202",978,734,727,10,7,"PP",268
15,"15014",4002,2566,2524,28,42,"PP",1351
19,"19317",139,110,109,1,1,"PP",53
28,"28049",58480,45136,44820,242,316,"PP",12947
25,"25240",1383,925,919,16,6,"PP",139
48,"48047",159,111,111,0,0,"PP",1
2,"2070",403,332,328,4,4,"PP",57
39,"39098",1402,1046,1036,8,10,"PP",611
5,"5034",14,13,13,0,0,"PP",8
19,"19318",25,18,18,0,0,"PP",4
39,"39099",3114,2308,2281,12,27,"PP",893
25,"25242",720,456,450,2,6,"PP",46
45,"45011",278,239,233,1,6,"PP",127
24,"24019",354,272,267,3,5,"PP",80
15,"15015",2799,2045,2008,24,37,"PP",832
28,"28050",4076,2860,2839,21,21,"PP",1209
17,"17037",104,69,69,1,0,"PP",5
12,"12015",93,81,78,0,3,"PP",32
5,"5035",100,84,84,0,0,"PP",35
34,"34184",57,46,45,0,1,"PP",32
2,"2071",1011,831,825,5,6,"PP",425
5,"5181",43,34,34,1,0,"PP",18
25,"25243",3646,2193,2167,33,26,"PP",538
2,"2072",1549,1086,1070,2,16,"PP",427
5,"5036",123,101,101,1,0,"PP",84
15,"15016",4749,3058,3020,19,38,"PP",1313
19,"19319",4449,3086,3056,18,30,"PP",1018
15,"15017",19420,13661,13505,175,156,"PP",4345
34,"34185",63,38,37,2,1,"PP",15
24,"24118",126,88,88,1,0,"PP",23
26,"26078",82,70,70,0,0,"PP",31
5,"5037",255,173,172,1,1,"PP",119
28,"28051",1541,1163,1149,1,14,"PP",468
39,"39101",274,197,192,3,5,"PP",47
41,"41096",6161,4553,4476,32,77,"PP",1519
34,"34186",52,45,45,0,0,"PP",29
25,"25244",361,223,220,5,3,"PP",36
15,"15018",1142,741,732,18,9,"PP",218
19,"19321",39,30,30,1,0,"PP",11
48,"48050",191,147,146,0,1,"PP",6
2,"2073",4867,3520,3474,40,46,"PP",1320
45,"45013",1758,1352,1329,8,23,"PP",755
2,"2074",5935,4193,4139,32,54,"PP",1709
7,"7023",3604,2498,2470,49,28,"PP",703
43,"43152",439,323,320,2,3,"PP",13
28,"28052",3855,2626,2587,11,39,"PP",1331
39,"39102",2277,1615,1598,9,17,"PP",762
47,"47034",72,58,58,3,0,"PP",38
48,"48051",213,163,163,0,0,"PP",16
9,"9396",156,121,121,0,0,"PP",81
19,"19322",31,25,25,0,0,"PP",14
7,"7024",6843,3657,3612,38,45,"PP",1158
37,"37207",287,195,193,1,2,"PP",88
15,"15019",25888,16680,16460,186,220,"PP",6624
30,"30009",12433,9586,9503,41,83,"PP",4467
17,"17041",218,130,129,2,1,"PP",11
2,"2075",1670,1321,1304,4,17,"PP",613
24,"24121",645,492,487,1,5,"PP",205
15,"15020",3784,2476,2447,17,29,"PP",1028
9,"9001",27,22,22,0,0,"PP",7
45,"45015",606,437,433,2,4,"PP",172
25,"25248",891,592,586,6,6,"PP",28
2,"2076",329,237,236,1,1,"PP",108
26,"26081",16,14,14,0,0,"PP",11
28,"28054",11257,8349,8273,55,76,"PP",3375
45,"45016",4204,3146,3105,22,41,"PP",1213
17,"17042",419,272,272,2,0,"PP",22
30,"30011",4697,3421,3383,15,38,"PP",1765
15,"15021",5127,3587,3543,38,44,"PP",1542
17,"17043",161,122,117,1,5,"PP",7
45,"45116",687,509,505,1,4,"PP",279
2,"2077",55,47,47,0,0,"PP",23
9,"9129",104,83,83,0,0,"PP",28
25,"25249",182,99,98,1,1,"PP",15
9,"9400",317,247,245,1,2,"PP",89
48,"48053",895,666,662,6,4,"PP",105
5,"5042",153,122,121,0,1,"PP",89
18,"18183",658,438,434,3,4,"PP",186
45,"45017",262,204,203,0,1,"PP",75
9,"9006",59,39,39,0,0,"PP",19
2,"2078",920,675,664,1,11,"PP",229
5,"5043",84,66,66,0,0,"PP",30
15,"15022",5785,3811,3771,33,40,"PP",1683
18,"18184",2168,1629,1607,13,22,"PP",465
17,"17044",6770,4411,4376,33,35,"PP",262
30,"30012",9091,6962,6897,36,65,"PP",2440
19,"19326",1841,1280,1272,1,8,"PP",430
2,"2079",2875,2209,2181,12,28,"PP",606
25,"25250",345,210,204,0,6,"PP",15
5,"5044",266,183,183,1,0,"PP",145
9,"9007",57,39,39,0,0,"PP",30
15,"15023",6419,4348,4261,36,87,"PP",1751
43,"43157",353,268,264,5,4,"PP",25
49,"49041",432,326,322,5,4,"PP",125
5,"5190",53,42,41,2,1,"PP",24
40,"40004",459,356,352,2,4,"PP",178
25,"25251",707,443,442,2,1,"PP",56
2,"2080",528,406,400,2,6,"PP",180
9,"9405",130,98,96,0,2,"PP",60
9,"9009",163,133,131,2,2,"PP",60
15,"15024",4393,3141,3073,32,68,"PP",1516
25,"25252",548,343,342,9,1,"PP",46
37,"37214",129,93,91,0,2,"PP",39
17,"17047",4798,2773,2757,28,16,"PP",493
46,"46089",2132,1602,1574,9,28,"PP",611
7,"7030",1551,1127,1101,13,26,"PP",444
30,"30014",1567,1174,1160,8,14,"PP",444
40,"40132",56,37,36,1,1,"PP",26
5,"5046",44,38,38,1,0,"PP",21
2,"2081",18342,13244,13075,80,169,"PP",5757
9,"9406",251,192,191,2,1,"PP",56
28,"28057",1458,1097,1088,3,9,"PP",419
34,"34204",46,41,41,0,0,"PP",30
45,"45020",1290,1037,1026,6,11,"PP",558
25,"25253",159,105,105,1,0,"PP",10
9,"9010",32,23,23,1,0,"PP",18
42,"42125",70,59,59,1,0,"PP",25
37,"37216",302,252,248,3,4,"PP",140
43,"43160",1276,837,826,8,11,"PP",109
48,"48057",5723,3988,3962,26,26,"PP",78
15,"15027",1536,1182,1155,6,27,"PP",596
45,"45021",2500,1708,1665,12,43,"PP",663
25,"25254",728,457,451,2,6,"PP",68
41,"41902",4659,2679,2646,23,33,"PP",633
26,"26088",37,32,31,0,1,"PP",15
2,"2083",219,191,191,0,0,"PP",84
9,"9011",65,48,48,0,0,"PP",29
24,"24129",122,89,89,1,0,"PP",44
9,"9012",89,64,63,0,1,"PP",30
28,"28059",4323,3171,3157,11,14,"PP",1339
15,"15028",1409,1038,1024,6,14,"PP",293
5,"5049",401,272,266,1,6,"PP",129
7,"7033",27104,15524,15337,174,187,"PP",5436
9,"9408",41,36,36,0,0,"PP",24
25,"25255",417,298,296,2,2,"PP",33
2,"2084",323,231,225,0,6,"PP",122
48,"48058",968,647,646,2,1,"PP",27
45,"45022",391,285,281,3,4,"PP",148
45,"45123",3081,2144,2131,11,13,"PP",647
40,"40009",49,43,43,0,0,"PP",25
19,"19331",2609,1872,1844,12,28,"PP",670
17,"17170",171,125,123,1,2,"PP",4
37,"37218",67,42,41,0,1,"PP",30
2,"2085",322,253,252,2,1,"PP",119
19,"19332",92,71,69,1,2,"PP",37
9,"9013",48,37,37,0,0,"PP",23
30,"30017",11605,8541,8451,46,90,"PP",3997
25,"25901",293,202,202,7,0,"PP",22
15,"15030",200176,143255,142070,1452,1185,"PP",51125
28,"28060",1510,1134,1117,1,17,"PP",290
9,"9014",195,115,114,1,1,"PP",52
40,"40010",121,102,101,1,1,"PP",76
47,"47042",54,37,37,0,0,"PP",18
17,"17052",125,78,78,0,0,"PP",7
42,"42003",67,48,47,0,1,"PP",22
5,"5053",82,57,57,0,0,"PP",39
24,"24131",724,511,507,3,4,"PP",300
2,"2086",2586,1701,1687,7,14,"PP",720
19,"19333",115,82,82,0,0,"PP",35
25,"25902",567,365,356,8,9,"PP",54
12,"12029",702,557,555,4,2,"PP",180
48,"48060",3634,2143,2134,7,9,"PP",60
34,"34211",178,155,152,1,3,"PP",111
2,"2901",2200,1440,1437,7,3,"PP",655
40,"40012",269,192,191,2,1,"PP",110
48,"48061",762,565,561,0,4,"PP",37
15,"15031",23348,16380,16235,191,145,"PP",4778
7,"7037",3197,1934,1917,26,17,"PP",610
25,"25903",236,161,161,3,0,"PP",5
9,"9016",85,60,59,3,1,"PP",25
42,"42004",2285,1757,1737,15,20,"PP",945
12,"12031",3807,2941,2894,24,47,"PP",923
49,"49052",187,133,132,1,1,"PP",78
17,"17055",150,110,109,0,1,"PP",3
15,"15032",3444,2322,2269,30,53,"PP",1307
3,"3001",337,269,268,0,1,"PP",139
40,"40013",62,49,48,0,1,"PP",38
34,"34213",57,45,44,1,1,"PP",27
15,"15033",2472,1863,1845,8,18,"PP",873
45,"45026",211,167,166,2,1,"PP",68
48,"48062",302,237,236,4,1,"PP",3
40,"40014",58,46,45,0,1,"PP",20
9,"9139",103,87,85,3,2,"PP",37
37,"37224",206,183,175,3,8,"PP",119
19,"19335",55,47,47,0,0,"PP",14
3,"3002",3605,2583,2557,15,26,"PP",1008
7,"7039",4839,3136,3060,31,76,"PP",1501
9,"9018",24668,17575,17369,111,206,"PP",6959
16,"16058",103,77,77,0,0,"PP",29
15,"15034",2885,1782,1760,18,22,"PP",655
45,"45027",346,275,272,0,3,"PP",129
28,"28063",258,194,193,1,1,"PP",75
46,"46095",610,467,459,1,8,"PP",220
21,"21014",4016,3025,2991,21,34,"PP",826
7,"7040",280477,173945,172463,1359,1482,"PP",58394
19,"19901",41,38,37,0,1,"PP",21
42,"42008",57,43,43,0,0,"PP",29
3,"3003",450,378,376,2,2,"PP",174
25,"25906",218,125,125,1,0,"PP",9
9,"9414",189,148,146,0,2,"PP",84
9,"9019",150,92,90,0,2,"PP",48
28,"28064",129,106,106,2,0,"PP",53
32,"32001",4986,3488,3443,25,45,"PP",1193
15,"15035",11427,7779,7657,144,122,"PP",2326
40,"40016",58,49,49,0,0,"PP",27
3,"3004",581,438,437,2,1,"PP",149
20,"20001",246,133,132,2,1,"PP",2
34,"34216",66,50,50,0,0,"PP",36
16,"16062",24,23,23,0,0,"PP",5
42,"42009",78,63,63,0,0,"PP",42
47,"47046",118,92,90,1,2,"PP",37
9,"9020",259,196,188,5,8,"PP",102
45,"45029",201,171,171,1,0,"PP",67
30,"30023",3780,2874,2850,12,24,"PP",1231
40,"40017",92,75,75,0,0,"PP",43
25,"25908",226,144,143,3,1,"PP",12
42,"42010",19,14,14,1,0,"PP",9
20,"20002",346,203,203,4,0,"PP",2
15,"15037",4061,2588,2552,19,36,"PP",1186
46,"46097",963,733,728,4,5,"PP",262
43,"43171",14599,9083,9011,72,72,"PP",1548
3,"3005",7769,5917,5866,19,51,"PP",2987
9,"9416",53,35,35,0,0,"PP",10
37,"37229",135,112,112,0,0,"PP",77
46,"46098",2482,1907,1889,11,18,"PP",603
20,"20003",547,308,308,3,0,"PP",1
25,"25909",148,93,92,2,1,"PP",6
32,"32004",1798,1029,1023,4,6,"PP",902
5,"5062",179,148,147,0,1,"PP",97
34,"34218",461,343,339,2,4,"PP",224
42,"42011",18,10,10,1,0,"PP",6
32,"32005",861,662,650,7,12,"PP",447
5,"5063",32,28,27,0,1,"PP",23
15,"15038",2227,1463,1443,25,20,"PP",722
3,"3006",497,384,380,1,4,"PP",134
26,"26100",49,44,43,0,1,"PP",19
30,"30025",4908,3667,3630,16,37,"PP",1486
20,"20004",252,121,121,0,0,"PP",0
16,"16065",388,320,314,2,6,"PP",176
15,"15039",1263,889,875,7,14,"PP",463
25,"25911",451,273,271,7,2,"PP",18
37,"37231",250,196,193,4,3,"PP",89
3,"3007",166,139,137,0,2,"PP",43
32,"32006",1531,1114,1090,10,24,"PP",727
5,"5064",103,83,82,0,1,"PP",71
9,"9023",1102,818,811,11,7,"PP",320
48,"48067",1158,813,810,2,3,"PP",8
40,"40021",27,27,26,0,1,"PP",16
32,"32007",1517,1046,1028,8,18,"PP",519
34,"34221",179,144,144,3,0,"PP",61
20,"20005",1260,738,736,11,2,"PP",40
45,"45133",2797,2068,2048,13,20,"PP",884
15,"15040",2753,1905,1880,5,25,"PP",966
5,"5065",471,394,392,4,2,"PP",236
48,"48068",1550,1130,1118,12,12,"PP",21
9,"9024",156,112,110,1,2,"PP",69
25,"25912",857,547,539,1,8,"PP",103
17,"17064",322,214,211,4,3,"PP",22
3,"3008",168,130,129,0,1,"PP",66
32,"32008",8256,5542,5490,39,52,"PP",2202
46,"46100",286,232,230,1,2,"PP",88
45,"45134",1581,1204,1192,6,12,"PP",571
20,"20007",310,218,218,3,0,"PP",3
9,"9151",448,362,360,6,2,"PP",138
17,"17065",331,230,230,1,0,"PP",4
25,"25913",86,67,67,3,0,"PP",2
9,"9025",122,83,83,1,0,"PP",47
34,"34223",218,155,155,1,0,"PP",109
32,"32009",10803,7303,7227,48,76,"PP",3380
37,"37235",224,153,148,2,5,"PP",75
26,"26001",195,161,157,2,4,"PP",75
3,"3009",46657,35143,34801,223,342,"PP",9678
26,"26103",796,616,610,6,6,"PP",283
9,"9422",17,11,11,0,0,"PP",11
15,"15042",3028,2033,2000,19,33,"PP",1004
40,"40024",856,651,639,6,12,"PP",328
12,"12041",100,81,81,0,0,"PP",46
9,"9026",386,301,300,0,1,"PP",125
3,"3010",325,277,275,1,2,"PP",93
46,"46102",19788,15154,15038,89,116,"PP",3963
15,"15043",5114,3476,3401,47,75,"PP",1520
20,"20008",716,362,361,6,1,"PP",13
9,"9027",46,42,41,0,1,"PP",14
17,"17067",696,467,464,5,3,"PP",16
42,"42151",34,26,26,0,0,"PP",11
32,"32011",932,619,613,1,6,"PP",533
12,"12042",607,520,513,13,7,"PP",334
5,"5072",81,67,67,1,0,"PP",48
40,"40026",119,109,109,0,0,"PP",41
15,"15044",1286,937,927,8,10,"PP",520
45,"45036",656,471,469,2,2,"PP",249
28,"28071",60,55,53,1,2,"PP",29
48,"48071",6087,4294,4254,32,40,"PP",224
46,"46103",1264,1015,984,7,31,"PP",353
3,"3011",7753,5464,5415,27,49,"PP",1878
43,"43902",2743,1551,1531,23,20,"PP",220
42,"42152",78,55,55,0,0,"PP",40
42,"42018",152,117,116,1,1,"PP",74
9,"9029",168,131,129,4,2,"PP",51
32,"32013",2183,1428,1425,8,3,"PP",973
28,"28072",5709,4356,4324,22,32,"PP",1846
18,"18915",745,533,525,2,8,"PP",130
34,"34228",83,74,74,1,0,"PP",35
20,"20010",1499,992,986,9,6,"PP",64
7,"7052",4667,2908,2886,29,22,"PP",904
3,"3012",1085,852,841,3,11,"PP",364
32,"32014",1142,848,834,6,14,"PP",550
48,"48072",977,716,713,4,3,"PP",19
26,"26004",67,50,50,0,0,"PP",40
15,"15046",6332,4377,4262,40,115,"PP",2255
46,"46104",1940,1504,1487,7,17,"PP",572
25,"25017",236,169,167,7,2,"PP",5
9,"9030",112,75,73,1,2,"PP",41
12,"12044",468,419,412,3,7,"PP",150
45,"45038",3356,2376,2350,15,26,"PP",983
40,"40029",35,27,26,0,1,"PP",16
32,"32015",874,575,573,4,2,"PP",393
16,"16078",41429,30053,29775,235,278,"PP",13029
19,"19001",49,42,42,0,0,"PP",34
9,"9427",1419,978,959,8,19,"PP",567
21,"21028",375,277,271,2,6,"PP",65
15,"15047",2429,1576,1549,19,27,"PP",736
9,"9032",109,75,73,0,2,"PP",25
3,"3014",237287,167428,166445,847,983,"PP",62244
26,"26005",2381,1598,1577,23,21,"PP",748
5,"5076",478,386,378,4,8,"PP",200
26,"26006",1800,1419,1405,8,14,"PP",615
9,"9033",90,74,74,1,0,"PP",43
42,"42021",83,55,55,3,0,"PP",40
9,"9428",108,92,91,0,1,"PP",51
36,"36045",24529,17613,17336,129,277,"PP",5475
32,"32017",1244,870,857,6,13,"PP",537
40,"40031",526,398,396,2,2,"PP",125
20,"20013",5415,3602,3579,19,23,"PP",176
17,"17073",1873,1363,1356,15,7,"PP",107
16,"16081",48,34,34,0,0,"PP",12
15,"15048",4839,3456,3414,36,42,"PP",1488
10,"10073",747,524,516,4,8,"PP",218
45,"45040",1349,846,838,4,8,"PP",388
34,"34231",229,168,167,1,1,"PP",106
5,"5078",115,91,89,1,2,"PP",64
9,"9034",276,228,227,2,1,"PP",134
15,"15049",1098,758,752,7,6,"PP",396
5,"5079",68,53,53,0,0,"PP",39
20,"20014",1108,611,609,4,2,"PP",21
3,"3015",12566,9257,9177,39,80,"PP",3964
32,"32019",11537,7975,7861,56,114,"PP",4196
28,"28075",5621,4186,4148,26,38,"PP",1443
37,"37243",98,70,70,1,0,"PP",56
15,"15050",1822,1004,988,13,16,"PP",433
17,"17075",330,205,205,1,0,"PP",17
19,"19004",67,53,53,1,0,"PP",41
9,"9035",311,227,225,2,2,"PP",86
20,"20015",1265,858,851,7,7,"PP",3
9,"9430",22,18,17,0,1,"PP",7
32,"32020",2576,1923,1899,5,24,"PP",1173
26,"26008",1860,1399,1387,5,12,"PP",664
28,"28076",398,325,317,1,8,"PP",139
3,"3016",93,75,75,0,0,"PP",32
45,"45042",187,140,140,0,0,"PP",78
9,"9431",118,98,98,0,0,"PP",59
3,"3017",374,314,307,1,7,"PP",62
10,"10214",214,181,177,2,4,"PP",103
9,"9036",37,31,30,1,1,"PP",19
9,"9166",97,81,81,0,0,"PP",61
48,"48077",3364,2437,2431,18,6,"PP",196
40,"40034",84,70,70,0,0,"PP",35
15,"15052",4314,2889,2838,21,51,"PP",1336
9,"9432",182,145,138,0,7,"PP",63
40,"40035",137,105,104,0,1,"PP",41
45,"45043",793,657,649,1,8,"PP",335
32,"32022",1337,892,881,6,11,"PP",438
28,"28078",38,32,32,0,0,"PP",14
47,"47058",200,145,143,0,2,"PP",68
9,"9037",111,91,91,0,0,"PP",15
26,"26010",93,80,80,2,0,"PP",49
3,"3018",12240,8853,8777,47,76,"PP",3075
37,"37247",196,163,162,3,1,"PP",104
48,"48078",38617,26366,26212,158,154,"PP",3282
16,"16086",890,740,735,6,5,"PP",364
45,"45045",1318,905,888,5,17,"PP",395
15,"15053",7729,5089,5043,49,46,"PP",2135
26,"26011",7321,5133,5083,38,50,"PP",2156
32,"32023",1210,862,849,4,13,"PP",423
17,"17078",336,223,220,6,3,"PP",20
9,"9038",119,100,100,0,0,"PP",40
32,"32024",4821,3320,3254,34,66,"PP",1782
7,"7061",9819,6351,6280,53,71,"PP",2360
26,"26114",79,66,65,1,1,"PP",31
3,"3019",15269,11520,11398,72,122,"PP",4487
46,"46110",21228,15563,15443,86,120,"PP",4660
9,"9169",95,78,78,0,0,"PP",35
17,"17079",64395,41049,40699,342,350,"PP",4281
5,"5085",35,27,27,0,0,"PP",22
32,"32025",1079,791,777,1,14,"PP",454
40,"40037",41,29,29,0,0,"PP",15
45,"45047",2606,1666,1647,6,19,"PP",755
9,"9039",58,46,46,2,0,"PP",34
48,"48080",9976,6820,6763,62,57,"PP",526
20,"20019",9986,6428,6392,48,36,"PP",427
34,"34240",89,64,64,0,0,"PP",44
3,"3020",99,79,79,0,0,"PP",26
17,"17080",138,96,96,1,0,"PP",17
9,"9041",28,27,27,0,0,"PP",12
46,"46111",10930,7931,7828,44,103,"PP",2746
15,"15055",4572,3070,3013,27,57,"PP",1065
48,"48081",1868,1361,1350,4,11,"PP",67
43,"43069",182,136,134,1,2,"PP",14
15,"15056",5722,3869,3818,46,51,"PP",1737
32,"32027",1053,765,749,2,16,"PP",433
45,"45048",358,278,275,1,3,"PP",137
26,"26013",347,249,246,2,3,"PP",82
17,"17081",246,163,162,2,1,"PP",8
3,"3021",5613,4570,4500,26,70,"PP",1811
20,"20020",125,71,69,3,2,"PP",1
9,"9043",192,137,133,1,4,"PP",70
20,"20021",200,100,100,2,0,"PP",1
48,"48082",37605,25134,24938,176,196,"PP",2614
3,"3022",145,125,125,0,0,"PP",58
49,"49082",359,304,301,6,3,"PP",130
15,"15057",12075,8479,8377,66,102,"PP",3738
5,"5088",30,23,23,0,0,"PP",19
45,"45049",433,305,304,1,1,"PP",161
42,"42031",26,21,21,0,0,"PP",17
9,"9044",46,35,34,1,1,"PP",15
26,"26015",196,158,157,2,1,"PP",101
20,"20022",839,473,472,4,1,"PP",13
34,"34094",64,45,44,0,1,"PP",28
21,"21040",3170,2129,2071,20,58,"PP",640
34,"34243",325,252,248,0,4,"PP",143
40,"40043",1802,1400,1381,8,19,"PP",751
45,"45050",457,333,328,1,5,"PP",146
15,"15058",27793,20392,20235,221,157,"PP",7596
48,"48083",6958,4885,4856,40,29,"PP",278
3,"3023",1398,1184,1167,7,17,"PP",444
7,"7902",1064,685,664,15,21,"PP",273
9,"9174",794,559,552,4,7,"PP",276
32,"32031",1069,822,795,4,27,"PP",522
26,"26016",28,25,24,1,1,"PP",11
5,"5092",152,125,122,0,3,"PP",77
9,"9045",268,181,181,4,0,"PP",104
40,"40044",145,114,113,2,1,"PP",58
34,"34245",307,209,208,5,1,"PP",129
15,"15059",10362,7258,7106,91,152,"PP",3474
20,"20023",441,252,251,1,1,"PP",14
9,"9441",74,65,65,0,0,"PP",60
12,"12057",606,487,474,5,13,"PP",169
17,"17202",3791,2280,2263,18,17,"PP",270
3,"3024",3901,3067,3024,11,43,"PP",1386
20,"20024",386,210,209,3,1,"PP",5
28,"28154",5408,3806,3767,16,39,"PP",1448
40,"40045",109,85,85,2,0,"PP",41
9,"9046",29,25,25,0,0,"PP",12
34,"34246",67,53,51,0,2,"PP",30
47,"47064",33,28,25,0,3,"PP",13
15,"15061",5571,3746,3691,27,55,"PP",1931
17,"17085",301,215,214,5,1,"PP",11
21,"21044",17591,10679,10558,118,121,"PP",5216
9,"9176",63,47,46,2,1,"PP",29
42,"42034",30,22,22,0,0,"PP",13
3,"3118",2437,1659,1642,4,17,"PP",822
26,"26018",10477,8053,7956,65,97,"PP",2811
10,"10090",513,362,353,2,9,"PP",160
40,"40046",89,75,75,1,0,"PP",30
46,"46115",378,286,282,1,4,"PP",163
9,"9047",54,47,46,1,1,"PP",29
45,"45053",8005,6211,6140,42,71,"PP",2599
32,"32034",1124,845,839,5,6,"PP",483
5,"5095",262,225,223,1,2,"PP",127
26,"26019",355,274,271,1,3,"PP",118
32,"32035",1442,957,942,3,15,"PP",643
9,"9048",1467,1048,1033,13,15,"PP",456
48,"48086",2050,1414,1401,5,13,"PP",70
3,"3026",1224,949,936,5,13,"PP",298
45,"45054",3959,2882,2848,12,34,"PP",1420
48,"48087",427,344,338,0,6,"PP",39
32,"32036",1345,971,953,14,18,"PP",624
20,"20026",197,145,133,0,12,"PP",0
40,"40048",38,29,27,0,2,"PP",16
5,"5097",475,317,313,0,4,"PP",182
17,"17088",533,368,366,4,2,"PP",16
15,"15064",2194,1592,1556,21,36,"PP",656
45,"45055",1020,821,790,6,31,"PP",389
9,"9444",72,58,58,3,0,"PP",42
32,"32037",728,518,509,6,9,"PP",333
9,"9050",68,56,55,1,1,"PP",24
17,"17206",146,88,86,1,2,"PP",7
12,"12061",373,285,282,3,3,"PP",100
9,"9051",170,130,128,0,2,"PP",80
34,"34904",315,234,230,2,4,"PP",106
5,"5243",85,61,60,0,1,"PP",33
19,"19019",20,18,17,0,1,"PP",10
20,"20028",2237,1373,1365,11,8,"PP",89
15,"15065",7315,5187,5099,42,88,"PP",2284
26,"26021",2827,2098,2076,15,22,"PP",1107
3,"3028",998,818,812,2,6,"PP",316
45,"45056",2201,1260,1243,12,17,"PP",454
32,"32038",436,278,271,2,7,"PP",137
5,"5100",278,227,223,1,4,"PP",109
49,"49091",260,193,193,0,0,"PP",100
15,"15066",4009,2814,2776,33,38,"PP",1549
32,"32039",1262,957,941,6,16,"PP",593
47,"47094",133,115,114,1,1,"PP",64
5,"5101",292,240,236,1,4,"PP",153
20,"20029",4281,2813,2802,19,11,"PP",136
46,"46118",3763,2940,2908,16,32,"PP",1072
9,"9052",29,23,23,0,0,"PP",16
9,"9446",12,7,7,0,0,"PP",4
3,"3029",245,185,183,1,2,"PP",72
17,"17091",407,258,253,5,5,"PP",12
32,"32040",1477,1090,1084,7,6,"PP",683
9,"9054",101,68,66,1,2,"PP",30
15,"15067",8029,5789,5732,37,57,"PP",2008
26,"26023",469,358,354,0,4,"PP",188
26,"26126",31,27,27,0,0,"PP",20
42,"42041",34,25,25,0,0,"PP",14
15,"15068",5049,3185,3129,25,56,"PP",1549
32,"32041",767,524,515,4,9,"PP",326
40,"40053",83,66,65,0,1,"PP",30
46,"46119",780,653,647,5,6,"PP",193
3,"3030",524,448,440,5,8,"PP",110
20,"20030",21423,13960,13898,101,62,"PP",1363
17,"17092",3509,2256,2223,18,33,"PP",225
26,"26127",212,181,176,0,5,"PP",90
42,"42042",45,35,35,0,0,"PP",26
9,"9055",52,42,41,1,1,"PP",21
15,"15069",6745,4910,4850,43,60,"PP",1680
19,"19023",124,100,98,2,2,"PP",43
5,"5104",35,28,28,0,0,"PP",17
26,"26024",228,181,181,0,0,"PP",93
3,"3031",41499,27031,26813,128,218,"PP",10564
9,"9056",4919,3395,3344,20,51,"PP",1597
40,"40054",108,90,90,0,0,"PP",46
20,"20031",176,90,90,0,0,"PP",2
20,"20032",8797,5672,5630,40,42,"PP",441
9,"9449",86,68,66,0,2,"PP",39
32,"32043",2561,1806,1774,9,32,"PP",973
48,"48092",836,618,613,5,5,"PP",37
3,"3125",343,254,251,0,3,"PP",107
3,"3032",108,91,90,1,1,"PP",38
15,"15070",9069,6090,5976,94,114,"PP",1695
40,"40055",37,26,26,0,0,"PP",9
9,"9184",5,4,4,0,0,"PP",2
37,"37265",220,181,181,0,0,"PP",60
40,"40183",130,120,119,2,1,"PP",103
9,"9057",145,108,108,0,0,"PP",47
15,"15071",7951,5255,5178,50,77,"PP",2184
5,"5106",35,25,25,0,0,"PP",22
3,"3127",350,278,273,1,5,"PP",110
3,"3033",117,96,95,0,1,"PP",43
26,"26026",1321,1039,1025,6,14,"PP",536
40,"40056",34,28,28,1,0,"PP",21
48,"48093",893,653,643,7,10,"PP",36
35,"35005",1048,747,737,8,10,"PP",322
20,"20033",868,600,599,1,1,"PP",15
19,"19027",138,105,105,1,0,"PP",44
9,"9058",390,283,279,1,4,"PP",112
16,"16108",49,45,42,0,3,"PP",8
45,"45062",1112,878,867,4,11,"PP",464
26,"26027",157,112,108,0,4,"PP",60
40,"40057",1456,1154,1148,7,6,"PP",434
15,"15072",9574,6637,6562,35,75,"PP",2389
20,"20034",3145,2026,2014,14,12,"PP",80
9,"9059",136488,101469,100463,907,1006,"PP",42251
46,"46122",2704,2082,2063,10,19,"PP",584
15,"15073",21827,14058,13864,126,194,"PP",6249
16,"16109",44,38,38,1,0,"PP",18
3,"3034",1376,1067,1052,5,15,"PP",446
21,"21056",2895,1990,1906,18,84,"PP",451
26,"26028",134,113,112,0,1,"PP",69
17,"17097",196,148,148,3,0,"PP",7
20,"20035",486,337,334,1,3,"PP",9
32,"32048",895,574,569,5,5,"PP",233
9,"9455",45,33,33,0,0,"PP",22
48,"48095",2347,1555,1546,12,9,"PP",158
45,"45063",417,310,303,1,7,"PP",145
9,"9191",38,28,27,0,1,"PP",18
46,"46123",1829,1407,1388,7,19,"PP",390
20,"20036",13210,8518,8475,67,43,"PP",754
45,"45064",3858,2804,2763,20,41,"PP",990
3,"3035",652,547,541,1,6,"PP",181
15,"15074",4037,2841,2796,20,45,"PP",1510
9,"9060",145,114,113,2,1,"PP",74
15,"15075",12336,8830,8725,91,105,"PP",3474
19,"19033",64,52,50,1,2,"PP",31
38,"38011",20570,13831,13698,75,133,"PP",4389
16,"16111",171,123,123,1,0,"PP",50
21,"21058",2609,1883,1856,23,27,"PP",330
10,"10106",130,109,108,2,1,"PP",43
3,"3036",87,81,78,0,3,"PP",30
26,"26030",16,16,15,0,1,"PP",10
16,"16112",1497,1031,1021,9,10,"PP",472
40,"40061",67,55,54,1,1,"PP",33
12,"12072",1101,929,911,11,18,"PP",390
32,"32051",1427,1184,1172,6,12,"PP",823
20,"20037",99,64,64,2,0,"PP",0
17,"17100",194,133,131,3,2,"PP",9
40,"40189",512,401,392,2,9,"PP",162
15,"15076",2611,1758,1739,17,19,"PP",762
26,"26031",106,83,83,0,0,"PP",38
3,"3037",346,282,278,3,4,"PP",66
9,"9062",51,40,39,0,1,"PP",20
20,"20038",387,261,259,0,2,"PP",3
45,"45066",7570,5550,5484,25,66,"PP",2894
47,"47075",4856,3681,3637,24,44,"PP",1942
40,"40062",60,51,48,0,3,"PP",26
17,"17101",559,347,338,2,9,"PP",39
32,"32052",1888,1399,1379,6,20,"PP",866
13,"13036",799,601,595,2,6,"PP",281
9,"9460",176,131,131,1,0,"PP",81
37,"37273",107,71,71,1,0,"PP",49
15,"15077",8261,5186,5103,59,83,"PP",2943
40,"40191",215,181,179,1,2,"PP",108
32,"32053",1438,1158,1144,11,14,"PP",740
3,"3038",355,288,285,3,3,"PP",102
26,"26032",51,41,39,0,2,"PP",14
35,"35009",19905,14185,13961,89,224,"PP",4982
5,"5116",109,89,89,1,0,"PP",65
3,"3039",81,62,61,1,1,"PP",25
45,"45067",2318,1791,1752,19,39,"PP",964
32,"32054",87167,60059,59333,540,726,"PP",24121
17,"17102",571,400,400,6,0,"PP",36
10,"10110",2300,1623,1574,11,49,"PP",709
9,"9064",324,271,267,1,4,"PP",127
5,"5117",200,174,173,1,1,"PP",123
21,"21063",2615,2001,1957,22,44,"PP",362
47,"47077",246,193,191,1,2,"PP",126
26,"26033",170,132,129,1,3,"PP",47
9,"9065",143,122,122,1,0,"PP",61
15,"15079",1540,1027,1007,16,20,"PP",591
3,"3040",254,216,213,2,3,"PP",79
45,"45068",160,126,126,0,0,"PP",38
32,"32055",1280,891,881,7,10,"PP",526
20,"20041",255,123,123,0,0,"PP",2
26,"26034",654,497,489,1,8,"PP",205
32,"32056",1592,1124,1118,7,6,"PP",734
12,"12075",123,88,88,0,0,"PP",34
21,"21064",6522,4227,4146,48,81,"PP",1234
45,"45069",1847,1391,1376,6,15,"PP",650
12,"12076",84,69,69,0,0,"PP",31
5,"5119",32,22,22,0,0,"PP",17
17,"17105",247,147,147,1,0,"PP",13
37,"37277",75,58,58,0,0,"PP",40
3,"3041",5954,4218,4194,22,24,"PP",1535
47,"47078",163,127,125,1,2,"PP",79
32,"32057",565,416,415,4,1,"PP",149
5,"5120",36,26,26,0,0,"PP",16
26,"26035",17,12,11,0,1,"PP",5
15,"15081",1034,791,782,11,9,"PP",558
42,"42056",23,20,20,0,0,"PP",14
45,"45170",228,176,167,0,9,"PP",94
26,"26141",113,87,82,0,5,"PP",52
20,"20042",3228,1967,1958,27,9,"PP",102
48,"48905",2553,1792,1771,12,21,"PP",85
32,"32058",5202,3650,3607,34,43,"PP",1803
40,"40070",149,107,105,1,2,"PP",54
9,"9467",64,43,42,1,1,"PP",27
15,"15082",15180,10841,10726,102,115,"PP",4216
9,"9067",437,295,294,6,1,"PP",175
5,"5122",134,102,101,0,1,"PP",61
9,"9471",149,114,114,1,0,"PP",52
17,"17107",264,167,165,8,2,"PP",10
26,"26037",128,108,108,2,0,"PP",52
35,"35013",6625,4896,4781,41,115,"PP",2384
3,"3042",1393,1010,996,7,14,"PP",443
9,"9068",29,24,24,0,0,"PP",9
3,"3043",2911,2431,2399,13,32,"PP",767
40,"40071",43,39,38,1,1,"PP",22
46,"46130",901,687,683,3,4,"PP",218
45,"45171",1361,1035,1023,0,12,"PP",450
15,"15083",1086,757,746,5,11,"PP",472
9,"9472",55,45,44,0,1,"PP",23
5,"5123",97,73,73,1,0,"PP",40
15,"15084",3260,2218,2191,27,27,"PP",1426
9,"9070",34,26,26,0,0,"PP",11
26,"26038",89,68,67,0,1,"PP",25
47,"47081",45,36,35,1,1,"PP",10
20,"20045",46626,30525,30353,197,172,"PP",4197
42,"42059",21,15,14,0,1,"PP",6
45,"45073",298,233,233,1,0,"PP",114
35,"35014",11209,6016,5917,42,99,"PP",2023
46,"46131",49431,36570,36227,231,343,"PP",13854
17,"17110",1322,856,853,3,3,"PP",109
5,"5125",55,47,47,0,0,"PP",27
32,"32062",811,621,617,6,4,"PP",422
28,"28083",8939,6396,6348,38,48,"PP",2212
28,"28172",9077,6992,6936,31,56,"PP",2957
24,"24180",1134,812,800,9,12,"PP",464
3,"3044",4521,3510,3465,21,45,"PP",1769
40,"40073",401,345,343,3,2,"PP",192
32,"32063",1914,1297,1279,16,18,"PP",620
15,"15085",3332,2280,2247,25,33,"PP",1232
9,"9071",41,35,35,1,0,"PP",17
15,"15086",2869,1970,1950,13,20,"PP",1111
45,"45074",414,327,323,1,4,"PP",156
46,"46132",2150,1803,1784,7,19,"PP",705
3,"3045",210,176,172,0,4,"PP",78
32,"32064",529,389,388,3,1,"PP",276
48,"48908",249,181,181,0,0,"PP",5
40,"40074",255,222,219,2,3,"PP",117
9,"9072",316,242,241,0,1,"PP",88
24,"24181",1493,1054,1045,5,9,"PP",536
35,"35015",9950,5139,5070,29,69,"PP",1330
20,"20047",469,307,304,5,3,"PP",10
26,"26040",70,60,60,0,0,"PP",34
48,"48909",209,161,161,0,0,"PP",0
45,"45075",143,109,108,0,1,"PP",52
17,"17114",23041,13985,13880,135,105,"PP",1025
9,"9073",926,691,686,4,5,"PP",256
3,"3046",1599,1153,1143,8,10,"PP",433
46,"46133",533,415,410,6,5,"PP",140
20,"20048",182,100,98,2,2,"PP",2
28,"28085",3922,2972,2954,14,18,"PP",1167
40,"40076",6492,4768,4700,26,68,"PP",1958
45,"45076",553,368,364,3,4,"PP",170
15,"15088",3519,2304,2270,27,34,"PP",1244
32,"32066",566,418,416,0,2,"PP",331
35,"35016",297736,192251,190256,1386,1995,"PP",64080
24,"24182",416,294,290,2,4,"PP",156
20,"20049",4122,2677,2666,15,11,"PP",130
3,"3047",9207,6309,6226,25,83,"PP",2066
19,"19046",21588,15689,15515,82,174,"PP",4666
9,"9480",110,90,90,1,0,"PP",59
15,"15089",4291,3020,2972,28,48,"PP",1451
32,"32067",1294,837,826,8,11,"PP",463
9,"9211",1441,1056,1039,9,17,"PP",605
5,"5130",90,85,85,0,0,"PP",32
26,"26043",365,292,281,1,11,"PP",110
45,"45077",556,428,427,1,1,"PP",181
9,"9075",112,91,91,3,0,"PP",47
42,"42064",86,68,68,0,0,"PP",29
3,"3048",4847,3719,3683,20,36,"PP",1634
28,"28086",5154,3530,3493,13,37,"PP",1454
9,"9482",33,28,28,0,0,"PP",16
12,"12084",17615,12766,12644,105,122,"PP",4770
9,"9213",307,220,218,2,2,"PP",109
20,"20050",266,170,169,1,1,"PP",4
45,"45078",1379,1129,1119,6,10,"PP",547
13,"13054",4944,3729,3678,27,51,"PP",1947
3,"3049",12088,9121,9027,52,94,"PP",4264
15,"15090",1179,812,804,9,8,"PP",507
9,"9483",211,158,157,0,1,"PP",76
21,"21076",2121,1458,1437,17,21,"PP",302
49,"49117",465,330,324,6,6,"PP",167
6,"6006",4572,3088,3049,26,39,"PP",904
35,"35018",12552,7609,7547,54,62,"PP",2058
9,"9076",23,17,17,1,0,"PP",8
45,"45079",369,288,286,3,2,"PP",132
48,"48913",1248,884,869,10,15,"PP",39
15,"15091",1135,771,760,13,11,"PP",396
32,"32070",548,335,329,3,6,"PP",189
46,"46136",2537,1952,1930,11,22,"PP",628
3,"3050",18652,13325,13234,57,91,"PP",4980
5,"5133",66,53,53,0,0,"PP",31
21,"21077",1711,1224,1202,3,22,"PP",439
9,"9077",34,27,27,0,0,"PP",12
5,"5134",48,38,38,0,0,"PP",29
40,"40080",59,43,41,0,2,"PP",30
26,"26045",12,12,12,0,0,"PP",4
20,"20052",1090,779,776,8,3,"PP",29
37,"37030",85,66,66,0,0,"PP",35
49,"49119",227,169,168,0,1,"PP",53
24,"24187",857,603,593,7,10,"PP",316
40,"40207",763,599,593,3,6,"PP",197
48,"48914",332,272,272,1,0,"PP",0
9,"9078",41,30,30,1,0,"PP",13
26,"26046",1581,1175,1159,4,16,"PP",556
40,"40081",124,94,92,2,2,"PP",48
32,"32072",3821,2705,2667,24,38,"PP",1162
15,"15093",4220,2533,2498,30,35,"PP",1419
24,"24188",3822,2850,2817,19,33,"PP",1269
32,"32073",1315,973,960,5,13,"PP",475
15,"15901",3546,2247,2228,24,19,"PP",917
45,"45081",17875,12656,12533,82,123,"PP",5014
3,"3052",970,769,755,8,14,"PP",352
26,"26047",1947,1578,1563,8,15,"PP",784
40,"40082",114,84,82,1,2,"PP",56
12,"12088",62,59,59,0,0,"PP",36
9,"9902",458,331,327,3,4,"PP",145
32,"32074",1044,710,704,4,6,"PP",417
9,"9079",49,45,45,0,0,"PP",37
5,"5138",306,221,220,1,1,"PP",162
42,"42071",171,115,115,3,0,"PP",74
9,"9082",39,36,36,0,0,"PP",34
26,"26048",22,22,22,0,0,"PP",11
40,"40083",77,59,59,0,0,"PP",45
20,"20055",17475,11073,10997,56,76,"PP",710
3,"3053",7226,5651,5584,32,67,"PP",2274
24,"24189",5865,3933,3885,31,48,"PP",1469
42,"42209",140,107,106,4,1,"PP",61
32,"32075",4217,3089,3044,33,45,"PP",1619
15,"15902",4598,3209,3149,51,60,"PP",1669
45,"45083",472,368,365,0,3,"PP",212
9,"9083",37,33,33,0,0,"PP",25
17,"17124",1607,1027,1007,11,20,"PP",74
16,"16001",76,61,61,0,0,"PP",41
9,"9904",478,374,370,5,4,"PP",181
49,"49122",782,526,520,5,6,"PP",214
46,"46139",4485,3617,3574,18,43,"PP",1361
5,"5140",111,89,87,0,2,"PP",65
32,"32076",2094,1488,1474,20,14,"PP",934
16,"16002",187,158,158,1,0,"PP",89
20,"20056",4082,2589,2570,27,19,"PP",103
4,"4004",425,329,329,0,0,"PP",105
24,"24191",108,79,79,0,0,"PP",38
37,"37296",336,259,254,2,5,"PP",126
32,"32077",1166,791,785,14,6,"PP",386
35,"35023",11686,8212,8076,55,136,"PP",3130
9,"9084",186,136,135,4,1,"PP",78
3,"3054",343,277,275,3,2,"PP",110
32,"32078",1188,855,838,4,17,"PP",539
19,"19055",52,41,41,1,0,"PP",23
9,"9905",384,279,279,2,0,"PP",123
5,"5142",99,88,85,0,3,"PP",53
20,"20057",196,122,122,0,0,"PP",0
46,"46140",344,284,279,0,5,"PP",86
49,"49005",149,91,91,2,0,"PP",48
9,"9085",475,347,342,2,5,"PP",141
3,"3055",5164,3695,3647,21,48,"PP",1877
24,"24193",378,268,265,2,3,"PP",110
32,"32079",1333,950,939,11,11,"PP",507
16,"16142",136,101,101,1,0,"PP",47
35,"35024",13735,8545,8439,77,106,"PP",2250
26,"26051",239,193,191,1,2,"PP",113
40,"40088",284,228,224,0,4,"PP",122
16,"16004",259,198,197,2,1,"PP",116
5,"5144",76,55,54,0,1,"PP",38
32,"32080",328,249,244,5,5,"PP",174
45,"45086",496,351,343,2,8,"PP",173
49,"49006",154,99,95,0,4,"PP",47
9,"9086",666,462,459,2,3,"PP",240
3,"3056",8676,6638,6541,34,97,"PP",2066
35,"35025",1797,1261,1245,4,16,"PP",679
38,"38036",6592,4518,4440,45,78,"PP",1073
40,"40089",222,167,164,0,3,"PP",98
16,"16145",450,363,361,5,2,"PP",125
17,"17129",133,101,101,1,0,"PP",18
20,"20059",8874,5873,5855,29,18,"PP",215
16,"16006",120,98,96,3,2,"PP",47
49,"49007",370,255,249,1,6,"PP",97
46,"46142",787,619,602,1,17,"PP",266
26,"26053",208,168,163,4,5,"PP",74
47,"47092",110,87,87,0,0,"PP",48
3,"3057",182,147,147,1,0,"PP",51
9,"9088",66,45,45,0,0,"PP",18
17,"17130",325,223,222,3,1,"PP",4
20,"20060",88,67,67,2,0,"PP",0
47,"47093",813,613,600,5,13,"PP",261
32,"32082",1243,891,878,1,13,"PP",538
3,"3058",4951,3897,3851,30,46,"PP",2131
10,"10001",282,225,223,3,2,"PP",68
49,"49008",460,332,331,5,1,"PP",183
20,"20061",4273,2601,2590,21,11,"PP",109
45,"45089",1495,1102,1094,0,8,"PP",311
40,"40092",118,87,87,1,0,"PP",56
26,"26054",320,263,260,4,3,"PP",129
46,"46143",4239,3104,3053,14,51,"PP",1105
9,"9090",54,48,48,0,0,"PP",34
3,"3059",20583,15125,15018,63,107,"PP",6308
26,"26055",39,32,32,0,0,"PP",20
37,"37041",78,52,52,0,0,"PP",40
5,"5149",106,77,77,1,0,"PP",48
16,"16008",89,69,69,0,0,"PP",26
19,"19106",89,59,59,0,0,"PP",25
32,"32084",918,641,635,3,6,"PP",352
10,"10003",569,414,408,1,6,"PP",204
20,"20062",973,653,653,11,0,"PP",25
46,"46144",663,532,529,2,3,"PP",284
16,"16009",62,51,50,0,1,"PP",31
9,"9091",724,500,490,4,10,"PP",299
45,"45090",384,294,293,3,1,"PP",134
3,"3060",109,91,91,0,0,"PP",30
49,"49011",232,168,165,6,3,"PP",109
5,"5151",91,71,71,1,0,"PP",47
9,"9093",154,121,119,0,2,"PP",55
32,"32086",2646,1693,1677,13,16,"PP",904
20,"20063",8017,5263,5231,35,32,"PP",182
18,"18013",4218,3024,2986,15,38,"PP",1124
17,"17134",228,162,161,0,1,"PP",2
10,"10005",540,377,362,3,15,"PP",160
40,"40094",374,279,276,2,3,"PP",142
16,"16010",152,115,112,0,3,"PP",79
5,"5153",103,78,77,1,1,"PP",47
16,"16011",27,22,22,1,0,"PP",13
49,"49012",73,43,43,0,0,"PP",24
20,"20064",12503,7803,7755,52,48,"PP",674
3,"3061",1056,776,768,4,8,"PP",415
26,"26057",48,38,38,0,0,"PP",17
40,"40095",477,377,369,0,8,"PP",258
16,"16151",64,61,59,0,2,"PP",34
40,"40222",168,145,144,0,1,"PP",64
5,"5154",38,33,33,0,0,"PP",17
47,"47096",140,110,110,0,0,"PP",63
35,"35029",4152,2530,2498,32,32,"PP",690
17,"17136",178,125,124,0,1,"PP",20
26,"26058",154,116,115,0,1,"PP",63
16,"16012",84,72,71,0,1,"PP",33
10,"10007",629,459,454,5,5,"PP",247
32,"32089",1295,888,878,7,10,"PP",568
40,"40097",128,93,92,0,1,"PP",34
16,"16013",27,24,24,0,0,"PP",13
9,"9095",84,61,61,0,0,"PP",45
20,"20065",3012,1985,1967,12,18,"PP",188
3,"3062",212,169,165,0,4,"PP",81
45,"45093",155,129,127,1,2,"PP",83
17,"17137",3437,2293,2275,19,18,"PP",120
3,"3063",26462,18591,18492,91,99,"PP",5626
10,"10008",1319,1019,1008,6,11,"PP",438
26,"26059",1125,828,812,5,16,"PP",401
32,"32090",774,530,511,4,19,"PP",208
9,"9098",507,369,362,5,7,"PP",169
16,"16014",602,485,483,0,2,"PP",195
42,"42087",49,43,42,0,1,"PP",17
49,"49015",227,179,177,0,2,"PP",105
32,"32091",1838,1368,1362,6,6,"PP",750
46,"46147",16835,11920,11791,61,129,"PP",4312
18,"18017",18114,11610,11510,77,100,"PP",4741
40,"40100",270,213,211,2,2,"PP",128
5,"5157",232,162,159,1,3,"PP",84
26,"26060",84,62,62,2,0,"PP",32
16,"16015",374,263,262,4,1,"PP",167
43,"43006",681,438,437,9,1,"PP",55
16,"16154",4871,3547,3509,24,38,"PP",1639
32,"32092",520,321,320,6,1,"PP",181
9,"9100",59,45,44,0,1,"PP",31
42,"42088",67,47,47,1,0,"PP",33
19,"19070",74,53,53,0,0,"PP",32
24,"24205",945,694,685,11,9,"PP",350
26,"26061",1565,1160,1141,13,19,"PP",454
3,"3064",5015,3660,3611,11,49,"PP",1759
49,"49016",247,176,174,5,2,"PP",90
17,"17139",1364,884,865,8,19,"PP",53
43,"43007",641,456,455,3,1,"PP",41
20,"20068",190,135,135,3,0,"PP",0
17,"17140",670,478,473,5,5,"PP",29
10,"10012",595,466,459,0,7,"PP",151
3,"3065",167284,123032,122305,711,727,"PP",45513
16,"16017",366,294,294,2,0,"PP",133
24,"24004",463,350,348,4,2,"PP",177
49,"49017",251,180,177,1,3,"PP",129
37,"37312",258,201,200,2,1,"PP",122
46,"46149",363,271,268,2,3,"PP",147
9,"9102",36,30,30,0,0,"PP",17
3,"3066",42121,29655,29419,214,236,"PP",9884
20,"20069",147046,100691,100232,836,459,"PP",15555
12,"12102",522,423,418,1,5,"PP",141
40,"40104",265,198,195,0,3,"PP",83
17,"17141",5887,3197,3165,34,32,"PP",511
49,"49018",329,261,256,2,5,"PP",128
37,"37313",550,386,384,2,2,"PP",217
26,"26063",124,94,94,2,0,"PP",50
9,"9103",217,184,183,1,1,"PP",80
20,"20070",1092,748,746,5,2,"PP",10
16,"16018",394,318,315,1,3,"PP",196
16,"16019",214,156,152,0,4,"PP",98
49,"49019",243,188,182,2,6,"PP",84
3,"3067",99,85,85,0,0,"PP",36
6,"6033",1327,1011,1006,10,5,"PP",447
37,"37055",123,98,94,0,4,"PP",64
18,"18159",995,797,795,2,2,"PP",136
47,"47022",59,50,49,0,1,"PP",38
19,"19074",72,62,62,0,0,"PP",10
43,"43010",322,233,227,0,6,"PP",18
26,"26064",2275,1659,1638,17,21,"PP",698
49,"49020",289,214,214,2,0,"PP",104
17,"17143",142,103,99,1,4,"PP",7
20,"20071",14801,9466,9421,60,45,"PP",553
3,"3068",47,44,44,0,0,"PP",32
16,"16020",17,10,10,0,0,"PP",7
45,"45099",3500,2390,2361,9,29,"PP",936
5,"5164",26,14,14,0,0,"PP",10
9,"9105",109,86,81,1,5,"PP",34
34,"34029",714,587,570,3,17,"PP",367
16,"16022",78,67,66,0,1,"PP",28
25,"25096",902,534,525,10,9,"PP",80
43,"43134",282,191,191,4,0,"PP",19
49,"49264",578,383,377,5,6,"PP",242
10,"10017",825,620,611,3,9,"PP",309
36,"36001",2564,1858,1848,5,10,"PP",995
4,"4019",249,196,196,1,0,"PP",61
40,"40107",100,73,73,1,0,"PP",52
16,"16023",469,335,335,2,0,"PP",103
49,"49022",288,229,225,3,4,"PP",87
9,"9239",52,40,39,0,1,"PP",29
47,"47103",267,197,192,5,5,"PP",85
5,"5165",368,290,281,3,9,"PP",140
42,"42095",1773,1269,1251,15,18,"PP",454
5,"5166",185,139,139,1,0,"PP",98
3,"3069",3076,2123,2102,17,21,"PP",854
26,"26066",251,201,194,1,7,"PP",111
40,"40108",112,82,82,0,0,"PP",44
45,"45201",3447,2082,2050,9,32,"PP",702
20,"20073",4677,3014,2995,15,19,"PP",129
26,"26174",146,107,105,2,2,"PP",60
9,"9109",1056,619,595,8,24,"PP",147
17,"17146",2969,1868,1855,8,13,"PP",180
16,"16024",129,98,97,0,1,"PP",34
45,"45102",3610,2506,2470,14,36,"PP",1142
46,"46153",439,355,351,1,4,"PP",104
5,"5167",254,207,202,4,5,"PP",63
16,"16025",26,23,23,0,0,"PP",15
3,"3070",2051,1455,1437,7,18,"PP",664
20,"20074",11592,7954,7914,45,40,"PP",351
49,"49024",672,459,454,5,5,"PP",209
17,"17147",8053,4988,4933,52,55,"PP",448
19,"19196",105,84,81,0,3,"PP",46
9,"9381",30,24,24,1,0,"PP",16
24,"24212",1032,773,760,4,13,"PP",342
43,"43015",112,87,86,0,1,"PP",0
16,"16026",82,62,61,2,1,"PP",29
40,"40903",86,67,67,0,0,"PP",46
26,"26068",80,61,61,1,0,"PP",24
9,"9110",80,63,63,0,0,"PP",40
3,"3071",3982,3048,3012,26,36,"PP",1094
20,"20075",4371,2692,2679,18,13,"PP",167
40,"40111",58,49,49,0,0,"PP",29
25,"25100",211,125,124,1,1,"PP",2
36,"36005",8121,5480,5400,52,80,"PP",2290
16,"16027",710,542,538,5,4,"PP",214
10,"10022",427,349,341,0,8,"PP",133
49,"49025",173,133,133,1,0,"PP",61
3,"3072",348,289,285,0,4,"PP",73
26,"26069",236,194,189,0,5,"PP",109
47,"47026",46,40,40,1,0,"PP",30
10,"10023",835,616,607,2,9,"PP",198
49,"49026",226,179,176,0,3,"PP",98
16,"16029",99,72,70,0,2,"PP",36
45,"45104",428,324,323,1,1,"PP",92
20,"20077",5213,3614,3591,36,23,"PP",222
40,"40112",2555,1932,1909,8,23,"PP",803
9,"9113",449,339,332,4,7,"PP",145
12,"12109",649,532,524,6,8,"PP",196
26,"26070",183,153,153,1,0,"PP",98
42,"42103",575,450,445,1,5,"PP",253
40,"40113",425,323,316,0,7,"PP",99
26,"26071",8491,5834,5761,47,73,"PP",2133
3,"3073",236,200,199,1,1,"PP",76
16,"16030",24,19,19,0,0,"PP",11
5,"5172",123,93,93,1,0,"PP",56
20,"20078",1155,850,846,4,4,"PP",13
36,"36007",1672,1119,1099,8,20,"PP",576
17,"17150",1401,962,951,6,11,"PP",49
26,"26179",41,32,31,0,1,"PP",15
9,"9114",86,66,66,0,0,"PP",38
10,"10025",400,327,318,1,9,"PP",111
12,"12010",259,213,208,2,5,"PP",82
40,"40115",101,86,85,1,1,"PP",40
9,"9115",92,68,67,0,1,"PP",47
3,"3074",1707,1397,1389,4,8,"PP",641
46,"46001",795,601,592,3,9,"PP",274
42,"42106",14,10,10,0,0,"PP",8
49,"49272",88,70,69,1,1,"PP",52
24,"24113",366,293,287,5,6,"PP",156
40,"40118",51,35,34,1,1,"PP",14
3,"3075",147,128,128,0,0,"PP",71
26,"26072",281,254,254,0,0,"PP",112
5,"5174",68,53,53,2,0,"PP",25
16,"16032",278,224,221,1,3,"PP",108
26,"26073",97,78,78,0,0,"PP",32
9,"9117",76,60,60,0,0,"PP",37
23,"23005",30465,20878,20630,177,248,"PP",7869
5,"5175",159,131,131,1,0,"PP",77
46,"46080",998,803,799,7,4,"PP",297
20,"20080",7910,5294,5260,49,34,"PP",410
41,"41002",1473,1038,1014,9,24,"PP",368
47,"47029",57,52,52,0,0,"PP",29
17,"17153",188,133,133,0,0,"PP",6
36,"36010",2847,2102,2076,13,26,"PP",742
4,"4027",250,159,159,0,0,"PP",82
46,"46002",1175,941,932,5,9,"PP",287
45,"45108",509,412,411,1,1,"PP",215
5,"5176",235,181,174,4,7,"PP",86
9,"9119",46,28,28,0,0,"PP",14
34,"34180",66,55,55,1,0,"PP",34
3,"3077",1371,1071,1060,13,11,"PP",471
20,"20081",7470,4856,4833,40,23,"PP",213
43,"43145",4096,2795,2760,19,35,"PP",246
26,"26074",105,86,85,1,1,"PP",40
41,"41003",2333,1693,1671,13,22,"PP",573
26,"26075",329,267,264,2,3,"PP",110
36,"36011",1799,1144,1122,8,22,"PP",664
49,"49031",148,120,119,6,1,"PP",71
10,"10030",465,309,309,1,0,"PP",153
49,"49153",174,136,132,0,4,"PP",70
40,"40121",280,226,218,3,8,"PP",120
34,"34042",296,237,234,1,3,"PP",127
23,"23008",1502,1144,1131,9,13,"PP",249
20,"20901",1437,908,906,2,2,"PP",45
3,"3078",478,389,389,5,0,"PP",205
5,"5178",368,284,280,0,4,"PP",188
26,"26076",129,107,106,0,1,"PP",55
9,"9122",94,67,66,1,1,"PP",48
42,"42111",303,229,227,2,2,"PP",123
40,"40122",512,395,394,2,1,"PP",160
49,"49033",714,508,505,1,3,"PP",280
17,"17157",125,95,95,1,0,"PP",0
5,"5179",214,178,176,1,2,"PP",148
16,"16036",126,109,106,0,3,"PP",31
20,"20902",14156,9664,9613,74,51,"PP",1056
45,"45111",65,50,50,0,0,"PP",21
12,"12115",219,179,177,0,2,"PP",91
24,"24117",434,334,331,1,3,"PP",250
16,"16038",38,31,31,0,0,"PP",21
40,"40123",147,114,106,0,8,"PP",43
3,"3079",18224,13904,13709,80,195,"PP",4866
41,"41006",2740,1782,1768,14,14,"PP",435
28,"28118",57,46,45,0,1,"PP",20
17,"17158",476,276,274,1,2,"PP",41
46,"46161",1483,1188,1173,7,15,"PP",400
37,"37073",586,448,438,2,10,"PP",233
19,"19092",409,306,300,1,6,"PP",138
9,"9123",40,35,35,0,0,"PP",17
45,"45112",1922,1247,1211,6,36,"PP",573
42,"42115",61,47,47,1,0,"PP",34
9,"9124",1506,1040,1028,6,12,"PP",433
46,"46162",1189,938,929,3,9,"PP",360
16,"16040",80,62,62,0,0,"PP",41
3,"3080",1300,1035,1025,3,10,"PP",594
10,"10172",709,466,465,0,1,"PP",197
49,"49035",226,200,196,3,4,"PP",99
40,"40124",237,182,177,6,5,"PP",74
10,"10035",1920,1343,1315,5,28,"PP",385
42,"42116",45,39,38,3,1,"PP",17
20,"20904",95,44,44,2,0,"PP",0
49,"49036",506,374,367,2,7,"PP",183
9,"9125",584,432,430,1,2,"PP",277
29,"29023",2081,1354,1340,4,14,"PP",654
46,"46241",392,299,291,1,8,"PP",86
23,"23012",4162,2907,2889,14,18,"PP",990
40,"40125",87,58,58,1,0,"PP",29
20,"20905",145,100,100,1,0,"PP",0
3,"3081",1436,1084,1075,5,9,"PP",383
26,"26079",634,520,512,4,8,"PP",304
37,"37334",76,48,48,1,0,"PP",31
5,"5184",246,183,183,0,0,"PP",99
16,"16042",1157,933,921,4,12,"PP",344
45,"45114",588,447,447,0,0,"PP",186
26,"26080",472,391,389,0,2,"PP",234
9,"9127",56,41,39,0,2,"PP",29
24,"24224",616,454,451,4,3,"PP",234
40,"40126",79,56,54,0,2,"PP",37
3,"3082",12567,8537,8464,44,73,"PP",3064
46,"46164",11771,8564,8483,64,81,"PP",2767
5,"5185",95,82,81,0,1,"PP",53
45,"45115",2552,1999,1966,8,33,"PP",868
9,"9128",80,63,63,0,0,"PP",27
42,"42118",23,17,17,0,0,"PP",16
34,"34050",200,153,152,0,1,"PP",90
49,"49038",99,71,65,1,6,"PP",36
19,"19097",16,10,10,0,0,"PP",10
16,"16043",95,73,73,1,0,"PP",47
46,"46008",2651,2108,2089,21,19,"PP",623
23,"23015",1374,1029,1019,5,10,"PP",323
20,"20907",118,85,85,2,0,"PP",2
42,"42119",158,100,99,3,1,"PP",64
3,"3083",5586,3971,3928,33,43,"PP",1175
10,"10039",417,291,291,0,0,"PP",135
26,"26082",112,87,87,1,0,"PP",41
6,"6058",2026,1433,1416,9,17,"PP",466
16,"16044",39,30,30,0,0,"PP",17
9,"9259",230,186,186,5,0,"PP",101
16,"16045",222,172,171,1,1,"PP",75
45,"45117",747,606,601,4,5,"PP",236
28,"28123",57078,45270,44992,215,278,"PP",10589
42,"42120",145,91,89,2,2,"PP",42
21,"21001",637,462,455,6,7,"PP",98
10,"10041",1057,795,781,4,14,"PP",322
3,"3084",539,454,446,3,8,"PP",170
36,"36020",2318,1646,1620,18,26,"PP",1045
42,"42121",64,47,47,0,0,"PP",19
40,"40129",177,148,147,1,1,"PP",93
21,"21002",15478,10597,10507,94,90,"PP",3645
3,"3085",272,217,213,0,4,"PP",80
12,"12121",1107,924,893,4,31,"PP",388
16,"16190",5105,3945,3887,17,58,"PP",1966
26,"26083",284,205,205,2,0,"PP",104
16,"16046",245,180,180,1,0,"PP",90
45,"45118",1991,1351,1339,6,12,"PP",591
21,"21003",690,471,458,6,13,"PP",43
9,"9131",462,365,364,2,1,"PP",123
23,"23018",2325,1668,1653,10,15,"PP",326
37,"37083",182,156,155,0,1,"PP",78
28,"28124",74,54,54,1,0,"PP",19
3,"3086",151,135,134,1,1,"PP",37
10,"10043",800,562,553,3,9,"PP",189
26,"26084",6696,5012,4955,35,57,"PP",2207
16,"16047",232,175,175,2,0,"PP",85
21,"21004",1631,1045,1028,13,17,"PP",236
36,"36022",9011,6310,6172,49,138,"PP",1922
16,"16048",408,313,312,1,1,"PP",182
10,"10044",1428,1040,1025,5,15,"PP",250
40,"40131",48,42,42,0,0,"PP",21
45,"45119",3330,2096,2067,15,29,"PP",781
27,"27016",7172,4910,4846,51,64,"PP",2375
3,"3088",5498,4041,3989,29,52,"PP",1519
4,"4038",3084,2140,2126,16,14,"PP",750
17,"17167",2700,1765,1749,37,16,"PP",114
23,"23020",1590,1370,1349,9,21,"PP",354
26,"26086",16,15,15,1,0,"PP",14
9,"9132",171,122,122,2,0,"PP",72
49,"49043",289,217,213,1,4,"PP",97
21,"21005",15523,9038,8913,56,125,"PP",2765
10,"10045",1019,762,755,3,7,"PP",272
26,"26087",201,153,149,3,4,"PP",77
16,"16194",242,185,179,1,6,"PP",50
16,"16049",149,111,110,0,1,"PP",47
40,"40134",731,579,570,1,9,"PP",249
23,"23021",524,431,429,0,2,"PP",128
16,"16050",245,201,195,1,6,"PP",97
12,"12124",1840,1387,1381,33,6,"PP",705
9,"9133",40,32,32,0,0,"PP",15
9,"9134",221,161,156,7,5,"PP",42
49,"49167",197,147,145,0,2,"PP",78
3,"3089",9571,6775,6639,47,136,"PP",2424
49,"49046",268,203,203,0,0,"PP",111
40,"40135",283,236,231,2,5,"PP",120
21,"21007",6225,4080,3999,52,81,"PP",1088
40,"40007",78,63,61,0,2,"PP",43
25,"25038",1545,995,986,17,9,"PP",232
36,"36025",2257,1360,1350,10,10,"PP",826
16,"16051",142,120,119,0,1,"PP",67
17,"17169",2475,1619,1601,11,18,"PP",134
28,"28127",64827,51776,51613,220,163,"PP",25537
21,"21008",2658,1660,1636,10,24,"PP",421
45,"45122",5212,4004,3961,16,43,"PP",1712
3,"3090",17182,12487,12385,74,102,"PP",4419
34,"34206",866,661,654,4,7,"PP",291
13,"13020",4781,3198,3161,31,37,"PP",1095
9,"9135",41,31,31,1,0,"PP",18
34,"34059",426,347,342,6,5,"PP",178
16,"16052",547,418,416,2,2,"PP",178
26,"26089",110582,82972,82186,588,786,"PP",33023
23,"23025",2802,2056,2037,9,19,"PP",846
5,"5196",50,37,36,0,1,"PP",11
42,"42129",681,503,495,3,8,"PP",231
21,"21009",857,532,523,4,9,"PP",125
36,"36027",4430,3137,3101,15,36,"PP",1707
49,"49048",124,97,95,0,2,"PP",65
3,"3091",252,217,215,2,2,"PP",121
45,"45124",2140,1677,1641,10,36,"PP",795
40,"40138",2169,1673,1656,7,17,"PP",753
42,"42130",59,46,45,1,1,"PP",36
9,"9136",192,142,137,2,5,"PP",70
26,"26091",161,146,146,0,0,"PP",107
9,"9137",174,132,131,3,1,"PP",68
46,"46171",16563,12213,12128,85,85,"PP",3679
40,"40139",279,202,198,1,4,"PP",95
10,"10188",499,382,374,4,8,"PP",136
23,"23027",723,576,572,3,4,"PP",186
3,"3092",6743,5254,5178,37,76,"PP",1601
10,"10051",430,308,296,0,12,"PP",156
21,"21011",3453,2441,2419,15,22,"PP",627
40,"40140",92,69,67,0,2,"PP",37
26,"26092",107,92,90,0,2,"PP",54
36,"36029",16077,11617,11471,100,146,"PP",3767
10,"10052",182,130,129,0,1,"PP",85
16,"16056",457,306,305,3,1,"PP",119
25,"25003",3762,2215,2195,22,20,"PP",270
5,"5200",44,31,30,1,1,"PP",20
9,"9138",85,72,70,0,2,"PP",48
41,"41020",12887,8210,8118,82,92,"PP",1818
3,"3093",19683,14633,14484,70,149,"PP",4993
10,"10053",287,215,210,1,5,"PP",109
45,"45126",260,176,175,3,1,"PP",46
40,"40141",842,593,584,10,9,"PP",302
21,"21012",316,235,233,2,2,"PP",81
16,"16057",75,63,63,0,0,"PP",25
26,"26094",83,70,70,0,0,"PP",48
49,"49053",931,709,699,8,10,"PP",313
5,"5201",523,419,418,1,1,"PP",230
17,"17212",141,104,102,0,2,"PP",3
21,"21013",10591,6580,6452,55,128,"PP",2094
12,"12129",1828,1322,1298,11,24,"PP",331
17,"17175",578,321,312,5,9,"PP",45
3,"3094",9080,6440,6396,34,44,"PP",2327
37,"37098",333,247,247,1,0,"PP",83
36,"36031",558,465,459,7,6,"PP",223
26,"26095",100,83,82,0,1,"PP",15
49,"49054",894,617,601,13,16,"PP",275
5,"5204",603,456,451,1,5,"PP",238
6,"6073",733,496,484,8,12,"PP",121
12,"12130",404,340,335,0,5,"PP",253
16,"16060",744,565,554,7,11,"PP",257
4,"4048",1503,1090,1085,9,5,"PP",377
21,"21015",680,398,393,8,5,"PP",57
49,"49055",102,82,82,2,0,"PP",37
3,"3095",4579,3489,3459,25,30,"PP",1075
40,"40143",86,75,74,0,1,"PP",42
10,"10056",586,457,452,4,5,"PP",175
3,"3096",5786,4358,4289,17,69,"PP",1486
37,"37352",207,153,152,1,1,"PP",70
46,"46174",972,764,752,2,12,"PP",234
4,"4049",5313,3620,3579,18,41,"PP",1570
26,"26096",245,190,190,1,0,"PP",83
16,"16061",969,771,764,14,7,"PP",294
39,"39024",1879,1390,1372,2,18,"PP",542
25,"25007",1405,850,841,8,9,"PP",83
28,"28133",5979,4140,4098,18,42,"PP",1746
36,"36033",12298,8968,8788,53,180,"PP",3219
21,"21016",1023,746,723,4,23,"PP",124
10,"10057",143,117,117,1,0,"PP",30
26,"26098",88,73,73,1,0,"PP",32
36,"36034",3475,2403,2367,11,36,"PP",1100
23,"23033",1352,1045,1034,12,11,"PP",422
10,"10058",1021,718,708,2,10,"PP",237
45,"45130",317,253,250,1,3,"PP",124
12,"12132",480,396,389,3,7,"PP",138
49,"49057",109,85,83,1,2,"PP",52
9,"9143",27,19,18,0,1,"PP",15
21,"21017",3600,2187,2164,26,23,"PP",552
5,"5208",40,36,36,0,0,"PP",20
40,"40145",1103,879,870,2,9,"PP",417
3,"3097",993,822,812,6,10,"PP",288
26,"26099",1264,1003,991,9,12,"PP",456
21,"21018",1769,1120,1095,11,25,"PP",218
36,"36035",14433,10333,10188,79,145,"PP",4143
40,"40146",254,197,196,0,1,"PP",103
16,"16064",684,568,562,4,6,"PP",293
5,"5209",85,70,70,0,0,"PP",52
46,"46176",2017,1358,1349,5,9,"PP",495
25,"25009",627,444,440,8,4,"PP",66
45,"45131",282,234,230,0,4,"PP",110
27,"27034",1120,681,672,4,9,"PP",330
9,"9148",87,70,68,3,2,"PP",30
3,"3098",505,393,386,0,7,"PP",103
34,"34220",147,126,125,3,1,"PP",48
19,"19116",12,9,9,0,0,"PP",5
17,"17181",3372,2135,2112,12,23,"PP",258
21,"21019",612,400,391,2,9,"PP",85
23,"23035",1106,873,855,1,18,"PP",323
36,"36036",2518,1827,1801,18,26,"PP",838
26,"26101",44,36,35,0,1,"PP",15
21,"21020",365,223,222,1,1,"PP",79
45,"45132",2197,1645,1632,14,13,"PP",940
16,"16066",2325,1788,1745,19,43,"PP",901
5,"5211",459,345,343,1,2,"PP",225
3,"3099",42319,31083,30801,165,282,"PP",15882
9,"9149",35,24,24,2,0,"PP",13
34,"34072",152,136,135,2,1,"PP",95
36,"36037",2571,1733,1707,11,26,"PP",825
42,"42145",138,108,107,2,1,"PP",52
23,"23037",502,404,400,6,4,"PP",113
3,"3100",503,440,437,0,3,"PP",138
16,"16067",123,87,87,0,0,"PP",52
5,"5212",231,164,163,2,1,"PP",108
21,"21021",12254,7339,7244,78,95,"PP",2721
40,"40150",69,61,61,1,0,"PP",30
21,"21022",171,107,105,0,2,"PP",32
27,"27039",4358,3143,3085,40,58,"PP",1642
23,"23038",3587,2794,2770,16,24,"PP",1219
49,"49181",362,277,276,2,1,"PP",216
5,"5067",83,68,67,0,1,"PP",43
17,"17183",277,180,179,1,1,"PP",12
25,"25012",2334,1322,1310,8,12,"PP",137
10,"10064",1476,1092,1072,7,20,"PP",491
3,"3101",4808,3627,3580,22,47,"PP",926
16,"16068",137,98,97,1,1,"PP",48
9,"9152",257,183,183,0,0,"PP",98
40,"40151",46,33,33,0,0,"PP",22
48,"48069",12798,8679,8612,55,67,"PP",828
10,"10065",206,156,155,1,1,"PP",40
49,"49064",515,346,338,6,8,"PP",197
17,"17184",1254,814,809,6,5,"PP",37
27,"27041",2341,1718,1705,16,13,"PP",998
16,"16070",30,26,26,1,0,"PP",8
9,"9154",137,98,97,2,1,"PP",58
10,"10066",160,122,122,0,0,"PP",54
3,"3102",7229,5492,5414,52,78,"PP",1731
40,"40152",760,592,584,3,8,"PP",211
46,"46024",413,314,313,2,1,"PP",146
45,"45136",5845,4091,4019,25,72,"PP",2027
29,"29046",2675,1825,1807,14,18,"PP",533
42,"42017",140,113,112,0,1,"PP",41
21,"21024",492,338,326,6,12,"PP",77
26,"26104",13,10,10,0,0,"PP",5
28,"28140",3007,2276,2256,7,20,"PP",977
21,"21025",4026,2433,2396,30,37,"PP",794
49,"49065",1103,836,818,2,18,"PP",463
9,"9155",27,20,20,0,0,"PP",15
3,"3103",272,235,234,1,1,"PP",90
16,"16072",146,104,103,2,1,"PP",49
25,"25015",357,219,219,2,0,"PP",30
49,"49066",492,336,332,4,4,"PP",201
18,"18072",667,424,420,0,4,"PP",114
45,"45137",1604,1032,1024,4,8,"PP",330
37,"37362",4632,3389,3351,25,38,"PP",1458
9,"9159",60,52,51,2,1,"PP",35
3,"3104",27103,19953,19787,131,166,"PP",6105
21,"21026",266,166,159,3,7,"PP",29
47,"47135",83,72,72,2,0,"PP",36
16,"16073",185,164,164,1,0,"PP",79
5,"5218",121,97,97,0,0,"PP",55
21,"21027",48,36,35,1,1,"PP",11
49,"49067",367,250,249,0,1,"PP",126
36,"36043",4747,3210,3162,20,48,"PP",1430
16,"16074",37,30,30,1,0,"PP",14
45,"45138",1091,877,871,4,6,"PP",442
26,"26107",94,77,77,2,0,"PP",36
41,"41032",3984,2811,2725,27,86,"PP",755
3,"3105",5373,3911,3828,15,83,"PP",1908
5,"5219",38,30,30,0,0,"PP",18
17,"17188",164,124,124,1,0,"PP",3
5,"5220",371,309,301,0,8,"PP",187
9,"9160",85,64,64,0,0,"PP",39
27,"27047",1629,1106,1089,8,17,"PP",497
37,"37364",820,607,598,6,9,"PP",316
12,"12141",101,83,83,0,0,"PP",44
28,"28144",6010,4676,4644,22,32,"PP",2120
49,"49068",462,310,304,4,6,"PP",214
45,"45139",167,139,139,1,0,"PP",51
21,"21029",1562,1127,1097,14,30,"PP",384
9,"9162",141,101,101,0,0,"PP",35
17,"17190",844,528,528,3,0,"PP",34
16,"16079",30,19,18,0,1,"PP",5
5,"5221",351,254,250,2,4,"PP",94
3,"3106",583,480,478,2,2,"PP",200
10,"10072",859,617,615,5,2,"PP",177
26,"26108",266,215,213,0,2,"PP",120
23,"23045",2132,1260,1247,5,13,"PP",293
21,"21030",1830,1452,1430,13,22,"PP",514
9,"9163",582,467,459,2,8,"PP",218
49,"49189",202,142,142,1,0,"PP",111
12,"12142",158,117,117,1,0,"PP",71
26,"26109",81,69,69,0,0,"PP",31
49,"49071",765,495,490,2,5,"PP",317
40,"40159",142,100,99,1,1,"PP",61
3,"3107",2508,1755,1744,7,11,"PP",578
36,"36046",4036,2971,2921,15,50,"PP",1324
21,"21031",1199,852,837,6,15,"PP",284
45,"45141",884,700,689,3,11,"PP",310
5,"5224",102,86,84,3,2,"PP",54
17,"17191",141,92,89,1,3,"PP",2
26,"26110",152,131,129,0,2,"PP",78
40,"40160",102,71,70,1,1,"PP",53
9,"9164",157,127,126,0,1,"PP",73
12,"12901",3405,2626,2598,23,28,"PP",864
5,"5225",372,285,281,1,4,"PP",186
10,"10076",832,556,541,1,15,"PP",197
46,"46185",378,320,313,2,7,"PP",44
3,"3109",2850,2181,2164,8,17,"PP",924
45,"45142",7871,6007,5927,37,80,"PP",2810
26,"26111",242,180,176,0,4,"PP",55
36,"36048",5331,3653,3603,22,50,"PP",1445
40,"40161",36,28,28,2,0,"PP",22
28,"28146",1787,1205,1194,0,11,"PP",541
21,"21033",538,373,370,3,3,"PP",61
16,"16083",52,33,33,0,0,"PP",20
46,"46186",19068,14599,14474,69,125,"PP",4309
42,"42024",86,61,59,0,2,"PP",37
49,"49076",321,217,217,2,0,"PP",124
18,"18084",4257,3107,3075,26,32,"PP",1180
9,"9167",58,41,41,1,0,"PP",32
3,"3110",291,241,241,1,0,"PP",83
16,"16084",48,38,37,1,1,"PP",13
26,"26112",236,194,190,1,4,"PP",103
10,"10078",406,321,314,6,7,"PP",116
40,"40162",392,303,302,1,1,"PP",193
45,"45144",783,620,618,3,2,"PP",267
16,"16085",138,113,112,0,1,"PP",57
6,"6096",220,176,171,2,5,"PP",94
34,"34236",156,120,119,0,1,"PP",86
37,"37371",272,165,162,1,3,"PP",92
3,"3111",5436,3918,3883,18,35,"PP",1859
21,"21035",9617,6033,5943,76,90,"PP",2070
9,"9168",290,217,217,3,0,"PP",90
19,"19007",459,341,336,0,5,"PP",170
49,"49078",170,141,140,1,1,"PP",73
10,"10079",894,662,648,7,14,"PP",318
23,"23050",90992,64810,64218,485,592,"PP",27903
26,"26113",35,35,34,0,1,"PP",29
29,"29055",1796,1354,1336,11,18,"PP",392
45,"45145",2565,1695,1675,12,20,"PP",774
25,"25025",1353,871,864,16,7,"PP",198
28,"28149",5759,4352,4310,25,42,"PP",1546
10,"10217",526,404,402,1,2,"PP",217
3,"3112",628,511,507,2,4,"PP",221
16,"16087",208,179,177,5,2,"PP",106
34,"34237",592,462,452,6,10,"PP",267
40,"40164",177,139,138,0,1,"PP",100
42,"42162",2352,1637,1601,16,36,"PP",907
21,"21036",200,141,139,0,2,"PP",58
45,"45146",107,84,83,0,1,"PP",60
5,"5231",165,133,133,2,0,"PP",81
25,"25027",976,633,630,7,3,"PP",64
49,"49080",685,520,514,2,6,"PP",229
36,"36052",7292,4999,4907,45,92,"PP",2477
10,"10218",1126,803,795,3,8,"PP",278
3,"3113",4243,3091,3046,10,45,"PP",1201
21,"21037",472,341,336,2,5,"PP",61
28,"28150",3087,2294,2277,10,17,"PP",1000
13,"13006",597,456,447,4,9,"PP",206
26,"26115",19,16,16,0,0,"PP",12
10,"10083",90,59,59,2,0,"PP",28
7,"7064",5315,3475,3434,31,41,"PP",928
9,"9170",205,162,162,1,0,"PP",95
5,"5232",102,84,79,1,5,"PP",50
16,"16089",375,303,303,6,0,"PP",145
17,"17198",429,270,267,2,3,"PP",12
45,"45147",581,450,446,1,4,"PP",169
21,"21039",311,225,223,1,2,"PP",58
3,"3114",1562,1198,1188,9,10,"PP",539
40,"40168",34,29,29,1,0,"PP",14
26,"26117",2152,1625,1605,10,20,"PP",740
9,"9172",129,103,101,1,2,"PP",54
3,"3115",255,222,220,2,2,"PP",95
5,"5234",49,44,44,2,0,"PP",28
29,"29058",1450,911,894,4,17,"PP",293
4,"4067",570,441,436,2,5,"PP",123
25,"25031",52,29,29,0,0,"PP",13
9,"9173",124,100,99,2,1,"PP",61
17,"17199",6853,4147,4122,27,25,"PP",366
26,"26118",59,48,48,2,0,"PP",23
13,"13009",1439,1115,1098,9,17,"PP",635
16,"16092",158,125,125,1,0,"PP",83
9,"9439",1028,752,744,9,8,"PP",274
32,"32029",470,357,352,4,5,"PP",247
5,"5235",124,111,110,0,1,"PP",54
3,"3116",1155,877,875,6,2,"PP",361
28,"28152",16093,12945,12877,58,68,"PP",6298
40,"40170",1320,1030,1021,7,9,"PP",580
47,"47145",603,448,441,3,7,"PP",246
37,"37127",214,154,151,1,3,"PP",54
26,"26119",197,156,155,4,1,"PP",42
5,"5236",123,91,90,1,1,"PP",36
10,"10904",745,507,504,8,3,"PP",190
40,"40171",32,23,23,0,0,"PP",17
45,"45150",443,356,354,0,2,"PP",126
16,"16093",60,49,47,0,2,"PP",31
21,"21042",15350,7643,7530,124,113,"PP",3045
10,"10087",1687,1218,1212,6,6,"PP",527
43,"43074",1754,1170,1157,9,13,"PP",82
17,"17201",135,87,84,0,3,"PP",4
49,"49085",996,684,680,2,4,"PP",356
16,"16094",127,96,94,0,2,"PP",56
16,"16248",859,654,636,5,18,"PP",280
3,"3117",362,318,313,2,5,"PP",122
9,"9175",127,94,93,2,1,"PP",70
16,"16095",83,64,63,0,1,"PP",45
29,"29061",1016,798,769,8,29,"PP",195
36,"36058",4994,3292,3243,33,49,"PP",1188
5,"5238",782,565,563,5,2,"PP",281
45,"45151",578,417,414,0,3,"PP",164
40,"40173",138,99,93,1,6,"PP",39
21,"21043",1871,1310,1285,9,25,"PP",273
45,"45152",587,458,451,0,7,"PP",175
46,"46252",118,99,98,0,1,"PP",54
25,"25163",231,135,132,2,3,"PP",12
10,"10089",1359,882,868,3,14,"PP",222
37,"37256",218,156,152,1,4,"PP",81
49,"49086",115,96,91,0,5,"PP",46
23,"23058",8678,6532,6461,37,71,"PP",2141
49,"49205",382,293,291,2,2,"PP",199
23,"23059",5837,4387,4310,40,77,"PP",1176
9,"9177",1121,757,749,9,8,"PP",367
21,"21045",249,180,178,3,2,"PP",26
17,"17204",572,355,354,4,1,"PP",40
28,"28155",506,416,411,0,5,"PP",160
13,"13016",664,517,509,4,8,"PP",272
49,"49087",521,322,318,0,4,"PP",227
45,"45153",1615,1258,1243,7,15,"PP",586
3,"3119",16636,12281,12194,57,87,"PP",4606
5,"5241",3063,2056,2032,15,24,"PP",977
16,"16097",156,124,121,0,3,"PP",52
26,"26123",126,108,107,2,1,"PP",62
16,"16098",561,456,454,3,2,"PP",167
21,"21046",1705,1099,996,16,103,"PP",534
9,"9178",47,35,35,0,0,"PP",25
5,"5242",681,559,558,8,1,"PP",426
17,"17205",208,157,155,1,2,"PP",3
28,"28156",1019,742,738,3,4,"PP",309
11,"11004",88783,51500,51015,513,485,"PP",18383
46,"46038",327,242,242,3,0,"PP",89
3,"3120",2406,1753,1720,11,33,"PP",765
29,"29064",503,348,339,8,9,"PP",148
23,"23061",7560,5303,5234,29,69,"PP",1915
21,"21047",1917,1111,1065,15,46,"PP",326
9,"9179",41,32,32,1,0,"PP",17
43,"43079",364,248,248,0,0,"PP",15
16,"16099",203,153,147,0,6,"PP",76
23,"23902",2320,1867,1847,4,20,"PP",451
21,"21048",305,214,210,4,4,"PP",51
10,"10094",234,196,196,1,0,"PP",53
3,"3121",21273,14569,14468,62,101,"PP",5755
28,"28157",609,433,430,1,3,"PP",233
16,"16100",670,564,559,0,5,"PP",298
42,"42175",21,16,16,0,0,"PP",15
41,"41050",5150,3817,3777,19,40,"PP",1247
23,"23062",1454,1141,1128,1,13,"PP",439
40,"40219",587,455,444,5,11,"PP",314
16,"16148",573,504,500,4,4,"PP",326
21,"21049",3361,2049,1984,17,65,"PP",468
10,"10095",338,259,251,1,8,"PP",95
26,"26125",2699,1931,1907,23,24,"PP",884
4,"4074",2840,2000,1979,23,21,"PP",679
49,"49092",129,90,89,1,1,"PP",51
3,"3122",42425,30153,29954,154,199,"PP",9296
45,"45156",3410,2751,2711,13,40,"PP",1053
16,"16101",154,132,132,0,0,"PP",63
9,"9181",300,221,221,0,0,"PP",139
13,"13022",348,260,258,4,2,"PP",106
16,"16102",1205,912,905,12,7,"PP",506
40,"40052",74,60,60,0,0,"PP",24
21,"21050",12427,8036,7969,80,67,"PP",3159
19,"19147",43,33,33,0,0,"PP",11
28,"28159",589,468,468,5,0,"PP",217
5,"5246",59,46,44,0,2,"PP",28
3,"3123",7476,5557,5501,29,56,"PP",2141
16,"16103",261,222,222,0,0,"PP",136
10,"10097",101,75,74,0,1,"PP",26
9,"9182",80,69,67,1,2,"PP",47
37,"37003",115,93,93,0,0,"PP",58
49,"49094",224,149,149,2,0,"PP",79
13,"13024",898,633,627,3,6,"PP",298
3,"3124",460,388,384,3,4,"PP",117
45,"45158",2514,1777,1760,11,17,"PP",862
9,"9183",51,41,41,0,0,"PP",25
26,"26128",105,81,81,1,0,"PP",29
19,"19148",45,32,31,0,1,"PP",14
45,"45159",90,75,75,0,0,"PP",40
21,"21052",4583,2734,2663,22,71,"PP",446
17,"17210",551,350,349,9,1,"PP",46
40,"40182",178,133,130,2,3,"PP",59
23,"23066",4347,3465,3410,15,55,"PP",1364
5,"5251",60,42,42,1,0,"PP",25
16,"16104",51,41,41,0,0,"PP",14
6,"6117",1424,960,938,4,22,"PP",448
21,"21053",3316,2141,2107,17,34,"PP",656
26,"26129",967,775,766,6,9,"PP",397
47,"47153",108,77,77,0,0,"PP",49
41,"41054",692,560,546,3,14,"PP",120
19,"19186",81,68,68,0,0,"PP",33
11,"11009",605,414,410,1,4,"PP",180
28,"28161",48848,35503,35203,210,300,"PP",12369
10,"10100",799,578,574,4,4,"PP",165
5,"5252",64,45,45,1,0,"PP",37
11,"11010",6410,4189,4130,88,59,"PP",1036
42,"42182",56,43,41,1,2,"PP",30
26,"26130",203,167,167,1,0,"PP",99
40,"40184",258,211,210,2,1,"PP",144
37,"37006",138,103,103,2,0,"PP",60
45,"45161",13688,9007,8902,32,105,"PP",2936
10,"10101",185,145,141,1,4,"PP",53
9,"9189",125,90,87,2,3,"PP",47
16,"16107",109,86,85,1,1,"PP",38
18,"18107",943,663,655,1,8,"PP",194
21,"21055",6975,5293,5241,48,52,"PP",2683
49,"49097",85,52,51,0,1,"PP",29
17,"17213",5424,3239,3219,24,20,"PP",373
40,"40185",863,646,642,3,4,"PP",363
23,"23069",5353,4310,4212,27,98,"PP",1587
9,"9190",86,58,56,0,2,"PP",28
10,"10103",450,322,318,1,4,"PP",118
47,"47155",3228,2277,2254,18,23,"PP",815
13,"13030",139,98,96,0,2,"PP",44
34,"34112",46,38,37,0,1,"PP",28
3,"3128",4092,2861,2840,10,21,"PP",1195
28,"28163",442,344,339,1,5,"PP",114
45,"45162",669,494,486,2,8,"PP",245
5,"5256",112,100,98,1,2,"PP",52
49,"49099",115,87,87,0,0,"PP",42
46,"46260",2581,2087,2068,22,19,"PP",628
4,"4080",209,162,162,3,0,"PP",75
21,"21057",1041,661,657,12,4,"PP",194
40,"40186",42,29,29,0,0,"PP",17
49,"49222",380,279,272,0,7,"PP",70
46,"46201",64,52,51,1,1,"PP",10
10,"10105",2512,1644,1620,12,24,"PP",730
37,"37009",213,172,171,3,1,"PP",100
3,"3129",1194,957,938,0,19,"PP",421
49,"49100",295,212,208,5,4,"PP",94
9,"9192",55,43,43,0,0,"PP",13
40,"40188",90,72,70,0,2,"PP",41
23,"23072",1986,1542,1530,7,12,"PP",515
18,"18111",2765,1949,1936,18,13,"PP",529
37,"37145",259,190,189,2,1,"PP",90
28,"28010",9963,7745,7688,25,57,"PP",3231
41,"41058",17395,12556,12332,111,224,"PP",3757
3,"3130",48,25,25,0,0,"PP",12
19,"19155",66,56,56,0,0,"PP",20
49,"49101",153,102,99,0,3,"PP",56
11,"11014",16858,10366,10245,153,121,"PP",3204
21,"21059",221,166,163,5,3,"PP",16
10,"10107",1031,801,792,3,9,"PP",260
23,"23073",4507,3229,3200,13,29,"PP",1103
37,"37011",121,91,91,3,0,"PP",41
3,"3131",175,154,147,0,7,"PP",63
4,"4082",297,200,200,0,0,"PP",109
42,"42188",50,39,38,0,1,"PP",17
49,"49102",196,143,139,2,4,"PP",75
9,"9194",2020,1472,1459,9,13,"PP",683
21,"21060",11957,7356,7279,88,77,"PP",2487
40,"40190",53,45,44,0,1,"PP",20
13,"13035",984,747,730,7,17,"PP",254
26,"26136",107,85,85,0,0,"PP",34
23,"23074",3021,2317,2295,11,22,"PP",771
46,"46203",3606,2873,2844,9,29,"PP",757
9,"9195",59,36,36,2,0,"PP",18
37,"37013",119,79,76,0,3,"PP",50
47,"47158",889,667,659,8,8,"PP",221
3,"3132",534,436,435,3,1,"PP",131
42,"42052",15,13,13,0,0,"PP",9
49,"49103",414,330,328,5,2,"PP",205
16,"16115",44,35,34,0,1,"PP",15
26,"26138",4588,3290,3247,15,43,"PP",1532
45,"45166",1617,1305,1286,8,19,"PP",481
3,"3133",41576,25849,25639,127,210,"PP",10720
21,"21062",1392,887,879,6,8,"PP",322
37,"37014",1155,817,808,7,9,"PP",361
16,"16116",77,68,68,0,0,"PP",29
49,"49104",343,234,232,0,2,"PP",159
19,"19037",141,115,114,1,1,"PP",61
28,"28167",8356,6158,6106,46,52,"PP",1763
5,"5263",173,129,129,1,0,"PP",81
37,"37149",68,64,64,0,0,"PP",47
40,"40192",159,117,117,2,0,"PP",54
13,"13039",14366,10282,10185,81,97,"PP",4357
23,"23076",827,640,630,1,10,"PP",240
3,"3134",143,112,111,0,1,"PP",39
17,"17221",4153,2577,2564,27,13,"PP",392
26,"26139",54,45,44,0,1,"PP",30
49,"49105",150,109,108,0,1,"PP",74
9,"9197",144,111,109,1,2,"PP",55
23,"23077",620,501,494,3,7,"PP",169
40,"40193",229,174,172,3,2,"PP",75
45,"45168",62229,47154,46741,285,413,"PP",20309
35,"35011",24002,15928,15684,95,244,"PP",5223
25,"25053",1055,671,661,7,10,"PP",76
17,"17222",101,76,75,0,1,"PP",3
10,"10112",1571,1107,1081,9,26,"PP",534
9,"9198",104,83,82,1,1,"PP",32
16,"16118",1375,1106,1086,13,20,"PP",599
3,"3135",211,170,166,2,4,"PP",36
17,"17223",801,516,506,9,10,"PP",60
37,"37017",245,182,177,1,5,"PP",137
46,"46206",571,453,445,2,8,"PP",140
40,"40194",39602,29382,29042,206,340,"PP",12149
21,"21065",273,186,184,0,2,"PP",83
9,"9199",92,72,71,1,1,"PP",49
48,"48904",3511,2625,2600,22,25,"PP",260
42,"42193",14,10,10,0,0,"PP",8
49,"49108",466,346,344,0,2,"PP",182
21,"21066",498,392,389,3,3,"PP",83
40,"40195",885,672,669,1,3,"PP",359
16,"16121",258,202,202,3,0,"PP",71
16,"16279",203,128,127,1,1,"PP",74
5,"5267",101,72,70,0,2,"PP",30
10,"10115",3544,2705,2647,11,58,"PP",1014
9,"9200",50,32,31,0,1,"PP",17
46,"46207",6676,5106,5040,41,66,"PP",1777
45,"45071",1835,1426,1408,5,18,"PP",511
5,"5901",263,182,180,2,2,"PP",94
26,"26142",787,612,606,3,6,"PP",291
3,"3136",441,338,334,0,4,"PP",137
3,"3137",651,492,489,5,3,"PP",158
16,"16122",249,188,187,0,1,"PP",84
19,"19163",56,41,40,0,1,"PP",17
40,"40196",30,25,25,0,0,"PP",19
41,"41065",22779,14769,14636,132,133,"PP",3023
49,"49110",348,231,229,0,2,"PP",117
38,"38020",15113,9928,9830,59,98,"PP",3301
21,"21068",998,605,592,11,13,"PP",205
26,"26143",220,175,173,1,2,"PP",68
5,"5902",284,236,232,0,4,"PP",135
37,"37020",430,326,321,1,5,"PP",154
9,"9201",28,18,18,1,0,"PP",11
5,"5903",151,104,104,2,0,"PP",49
10,"10117",255,135,134,0,1,"PP",46
16,"16123",82,61,61,3,0,"PP",22
37,"37021",79,60,60,0,0,"PP",35
17,"17227",129,86,85,5,1,"PP",2
9,"9202",25,22,22,1,0,"PP",19
16,"16124",1858,1476,1459,12,17,"PP",633
26,"26144",188,155,155,3,0,"PP",107
21,"21069",1702,1167,1149,6,18,"PP",358
37,"37157",78,63,62,0,1,"PP",28
40,"40199",105,84,84,0,0,"PP",33
3,"3138",3145,2310,2275,9,35,"PP",869
24,"24081",140,98,92,0,6,"PP",70
16,"16125",1667,1249,1231,3,18,"PP",607
21,"21070",6258,4165,4092,48,73,"PP",1013
45,"45173",9520,6938,6864,30,74,"PP",3289
25,"25060",72,46,44,1,2,"PP",8
45,"45174",301,237,233,1,4,"PP",134
49,"49112",126,75,75,0,0,"PP",36
3,"3139",22437,15315,15170,100,145,"PP",5257
26,"26145",246,197,197,2,0,"PP",107
5,"5905",217,165,164,0,1,"PP",114
40,"40201",49,42,42,0,0,"PP",30
9,"9206",59,45,45,0,0,"PP",34
26,"26146",94,73,72,0,1,"PP",42
13,"13049",799,540,531,0,9,"PP",282
6,"6001",686,522,515,0,7,"PP",227
16,"16126",770,634,624,3,10,"PP",289
49,"49113",167,137,135,1,2,"PP",102
13,"13050",493,378,375,3,3,"PP",211
37,"37159",90,70,70,1,0,"PP",37
17,"17230",468,318,317,3,1,"PP",47
3,"3140",26070,18999,18742,174,257,"PP",6567
23,"23086",11511,7997,7874,91,123,"PP",2130
10,"10121",7978,5517,5429,35,88,"PP",2221
45,"45175",664,545,543,5,2,"PP",297
21,"21072",10262,7442,7307,85,135,"PP",1948
26,"26147",30,28,27,0,1,"PP",6
16,"16128",63,50,50,0,0,"PP",31
39,"39067",790,513,505,1,8,"PP",244
9,"9209",4473,3223,3192,20,31,"PP",1616
40,"40202",60,46,46,0,0,"PP",29
21,"21073",1862,1125,1109,8,16,"PP",430
3,"3901",1135,822,817,8,5,"PP",257
16,"16129",95,81,79,0,2,"PP",46
10,"10123",578,481,475,1,6,"PP",147
21,"21074",2649,1755,1733,13,22,"PP",655
45,"45176",3706,2554,2521,22,33,"PP",900
34,"34133",107,91,90,0,1,"PP",66
13,"13053",14328,10164,10041,72,123,"PP",4073
26,"26148",165,135,133,1,2,"PP",54
35,"35017",25676,15038,14716,94,322,"PP",4674
37,"37026",189,146,146,0,0,"PP",68
38,"38026",32950,24443,24196,129,247,"PP",8618
3,"3902",10254,6996,6930,34,66,"PP",3583
45,"45177",2110,1679,1656,3,23,"PP",734
23,"23090",1312,1041,1018,5,23,"PP",483
16,"16131",130,100,97,2,3,"PP",50
37,"37162",204,152,151,0,1,"PP",95
17,"17234",182,115,114,0,1,"PP",13
28,"28176",12491,9723,9667,37,56,"PP",5240
39,"39068",646,450,445,2,5,"PP",189
3,"3903",2494,1880,1865,7,15,"PP",771
21,"21075",349,275,270,4,5,"PP",88
26,"26149",57,47,46,0,1,"PP",12
41,"41072",4054,2965,2933,14,32,"PP",300
10,"10125",888,635,622,4,13,"PP",273
46,"46213",15409,10924,10805,97,119,"PP",4053
13,"13055",665,487,484,2,3,"PP",182
40,"40205",261,202,198,2,4,"PP",108
9,"9214",672,427,427,4,0,"PP",177
16,"16132",35,27,26,0,1,"PP",10
46,"46214",15766,12131,12036,42,95,"PP",3843
23,"23091",729,555,553,5,2,"PP",238
13,"13056",11362,8288,8198,70,90,"PP",2890
3,"3904",1396,1033,1026,4,7,"PP",363
40,"40206",173,135,134,0,1,"PP",59
37,"37289",232,167,166,3,1,"PP",98
38,"38028",22103,15036,14844,85,192,"PP",5434
17,"17902",1357,886,878,13,8,"PP",58
45,"45180",2727,1966,1940,9,26,"PP",987
16,"16133",4389,3358,3316,24,42,"PP",1161
23,"23092",27775,19734,19541,175,193,"PP",7170
14,"14060",4868,3473,3412,41,61,"PP",858
12,"12087",25,18,18,4,0,"PP",11
9,"9215",368,256,256,2,0,"PP",131
17,"17002",556,401,396,0,5,"PP",31
6,"6008",632,525,519,2,6,"PP",150
21,"21078",2726,1793,1768,17,25,"PP",326
26,"26151",448,370,368,1,2,"PP",162
4,"4001",1062,823,814,5,9,"PP",267
13,"13059",202,160,156,0,4,"PP",67
28,"28178",1065,824,818,5,6,"PP",327
49,"49120",74,53,52,0,1,"PP",26
37,"37031",361,269,266,2,3,"PP",158
28,"28179",1432,1040,1037,4,3,"PP",467
34,"34001",34,28,28,2,0,"PP",10
16,"16135",134,92,92,2,0,"PP",47
45,"45182",1034,806,791,1,15,"PP",361
9,"9216",387,270,265,1,5,"PP",131
40,"40208",766,596,589,3,7,"PP",327
19,"19174",109,80,79,0,1,"PP",38
4,"4002",1039,748,740,2,8,"PP",212
6,"6010",1105,819,801,5,18,"PP",236
37,"37032",548,401,399,0,2,"PP",213
40,"40210",106,74,71,0,3,"PP",38
26,"26153",13,12,11,0,1,"PP",1
49,"49121",365,273,273,2,0,"PP",136
16,"16137",54,32,31,1,1,"PP",19
9,"9217",351,251,249,6,2,"PP",123
19,"19175",32,28,28,0,0,"PP",22
28,"28180",5251,3927,3893,7,34,"PP",1449
49,"49244",43,29,29,0,0,"PP",18
4,"4003",17357,11157,11075,64,82,"PP",5581
6,"6012",3267,2300,2277,15,23,"PP",788
40,"40211",74,64,64,0,0,"PP",38
16,"16139",335,256,255,2,1,"PP",141
26,"26154",13,10,10,0,0,"PP",4
23,"23096",2642,2164,2138,9,26,"PP",400
37,"37034",85,65,65,0,0,"PP",25
19,"19053",2008,1422,1404,10,18,"PP",675
9,"9218",369,275,275,1,0,"PP",113
34,"34004",5608,4120,4063,43,57,"PP",1895
6,"6150",802,602,596,4,6,"PP",168
19,"19176",237,181,181,0,0,"PP",115
25,"25072",5850,3493,3444,29,49,"PP",453
49,"49245",262,176,173,2,3,"PP",81
16,"16140",27,16,16,0,0,"PP",7
46,"46218",1060,910,885,7,25,"PP",386
40,"40212",27,23,22,2,1,"PP",9
37,"37035",190,150,150,2,0,"PP",80
18,"18004",714,518,509,2,9,"PP",242
28,"28181",20386,16155,16069,57,86,"PP",8307
9,"9219",27509,19084,18859,146,225,"PP",5752
34,"34005",851,673,658,4,15,"PP",335
40,"40213",86,65,65,3,0,"PP",32
9,"9220",75,56,54,1,2,"PP",31
16,"16141",143,102,102,0,0,"PP",41
4,"4005",556,437,431,3,6,"PP",181
34,"34006",81,67,66,2,1,"PP",46
45,"45186",3061,2242,2214,11,28,"PP",931
42,"42213",27,21,21,1,0,"PP",15
23,"23098",867,713,701,1,12,"PP",280
49,"49125",1391,933,918,10,15,"PP",377
47,"47012",113,93,93,0,0,"PP",58
10,"10135",1302,981,969,3,12,"PP",466
34,"34009",31,29,29,1,0,"PP",24
25,"25075",117,72,72,2,0,"PP",3
46,"46219",127,112,112,1,0,"PP",53
16,"16143",16,14,14,2,0,"PP",7
40,"40214",208,168,168,2,0,"PP",87
37,"37037",117,84,82,0,2,"PP",47
26,"26158",251,214,210,0,4,"PP",131
19,"19179",69,56,56,1,0,"PP",24
4,"4006",7022,4792,4749,30,43,"PP",2161
10,"10136",302,218,215,4,3,"PP",81
26,"26052",154,121,117,0,4,"PP",69
40,"40215",84,60,60,0,0,"PP",42
37,"37038",788,595,583,4,12,"PP",270
42,"42216",25,23,23,0,0,"PP",13
26,"26160",709,552,549,2,3,"PP",269
18,"18007",781,521,512,5,9,"PP",142
45,"45188",2785,1960,1938,15,22,"PP",669
49,"49127",2367,1668,1650,16,18,"PP",671
4,"4007",734,524,522,1,2,"PP",163
40,"40216",759,574,571,3,3,"PP",256
9,"9223",45,37,37,0,0,"PP",21
19,"19181",56,42,42,0,0,"PP",29
16,"16146",83,57,57,0,0,"PP",37
18,"18010",566,427,421,1,6,"PP",108
10,"10138",555,448,446,2,2,"PP",101
9,"9224",162,131,131,1,0,"PP",76
34,"34011",397,321,320,5,1,"PP",160
13,"13070",760,583,574,11,9,"PP",268
26,"26161",8,7,7,0,0,"PP",7
10,"10139",114,82,78,1,4,"PP",37
43,"43161",17197,10481,10400,95,81,"PP",1152
4,"4008",505,423,417,5,6,"PP",261
45,"45189",599,470,462,2,8,"PP",203
25,"25078",998,628,627,7,1,"PP",59
40,"40218",92,65,64,1,1,"PP",48
9,"9225",83,55,54,0,1,"PP",31
26,"26162",121,99,99,1,0,"PP",39
18,"18147",3729,2335,2304,16,31,"PP",666
28,"28031",2048,1500,1486,3,14,"PP",718
41,"41016",7355,5248,5175,51,73,"PP",1686
36,"36026",20137,13779,13596,141,183,"PP",5852
38,"38039",10641,7547,7459,49,88,"PP",3285
49,"49129",853,592,574,9,18,"PP",234
4,"4009",162,123,122,2,1,"PP",62
6,"6021",926,645,636,8,9,"PP",354
37,"37042",44,28,27,0,1,"PP",21
40,"40220",66,50,46,1,4,"PP",20
26,"26163",136,118,118,0,0,"PP",48
9,"9226",63,54,54,0,0,"PP",36
45,"45191",543,472,468,3,4,"PP",198
4,"4010",576,444,443,3,1,"PP",120
16,"16149",148,124,122,2,2,"PP",31
29,"29001",4170,3106,3068,19,38,"PP",554
25,"25081",308,189,189,2,0,"PP",20
5,"5152",678,554,551,3,3,"PP",390
23,"23904",2796,1825,1798,8,27,"PP",563
43,"43001",691,441,439,4,2,"PP",39
46,"46223",7801,5950,5899,34,51,"PP",2060
16,"16150",97,72,72,0,0,"PP",36
10,"10143",154,112,112,0,0,"PP",52
37,"37044",466,362,360,2,2,"PP",186
24,"24098",1193,842,831,11,11,"PP",215
18,"18014",6581,4584,4545,37,39,"PP",1589
29,"29002",1177,804,789,5,15,"PP",269
4,"4011",2765,2119,2096,21,23,"PP",690
25,"25082",285,186,178,5,8,"PP",11
46,"46067",1753,1418,1393,1,25,"PP",502
47,"47017",201,158,153,1,5,"PP",117
34,"34018",209,168,164,1,4,"PP",83
45,"45193",613,504,497,1,7,"PP",282
10,"10144",975,746,735,3,11,"PP",310
13,"13077",3489,2205,2152,18,53,"PP",894
49,"49132",316,235,232,1,3,"PP",153
24,"24001",189,124,122,0,2,"PP",67
26,"26165",358,304,299,2,5,"PP",129
9,"9228",160,137,136,1,1,"PP",79
4,"4012",191,161,161,0,0,"PP",70
6,"6025",5106,3571,3523,44,48,"PP",1172
25,"25085",148,107,107,0,0,"PP",25
16,"16152",38,32,32,0,0,"PP",22
29,"29003",983,754,743,1,11,"PP",190
45,"45194",68,54,53,0,1,"PP",24
30,"30020",6303,4543,4497,25,46,"PP",2441
16,"16153",949,778,772,7,6,"PP",350
9,"9229",198,146,143,0,3,"PP",83
49,"49133",304,214,213,1,1,"PP",111
26,"26166",141,124,122,0,2,"PP",91
4,"4013",141378,94872,94288,741,584,"PP",38809
49,"49134",172,121,119,0,2,"PP",63
38,"38044",2188,1348,1334,6,14,"PP",642
13,"13079",12244,8582,8450,72,132,"PP",3451
6,"6027",676,561,552,2,9,"PP",280
9,"9230",38,32,32,0,0,"PP",26
24,"24002",231,173,172,1,1,"PP",81
10,"10147",1278,961,925,7,36,"PP",234
29,"29004",312,236,233,2,3,"PP",84
34,"34022",1082,873,861,9,12,"PP",376
40,"40225",1138,883,867,3,16,"PP",470
43,"43128",907,587,577,5,10,"PP",39
17,"17138",928,637,633,4,4,"PP",89
4,"4014",144,117,114,1,3,"PP",18
29,"29005",4358,2859,2817,28,42,"PP",1163
16,"16155",508,398,391,2,7,"PP",224
26,"26168",5340,3774,3717,22,57,"PP",1328
46,"46226",41,36,35,0,1,"PP",4
34,"34023",5236,3685,3636,30,49,"PP",1201
43,"43129",4580,2844,2805,23,39,"PP",337
9,"9231",69,38,38,1,0,"PP",21
40,"40228",510,390,382,1,8,"PP",233
46,"46070",16950,12765,12676,61,89,"PP",4657
9,"9232",154,119,116,0,3,"PP",57
16,"16156",97,78,77,0,1,"PP",35
4,"4015",124,96,96,2,0,"PP",32
18,"18020",1028,691,686,3,5,"PP",213
29,"29006",673,428,420,1,8,"PP",147
43,"43130",195,127,127,1,0,"PP",14
37,"37051",85,66,66,0,0,"PP",40
26,"26169",64,60,60,0,0,"PP",35
34,"34024",31,21,21,1,0,"PP",13
10,"10150",346,285,279,3,6,"PP",79
18,"18021",17485,11800,11669,95,131,"PP",3708
45,"45197",1906,1455,1430,8,25,"PP",616
25,"25092",130,98,95,2,3,"PP",5
40,"40229",36,24,24,0,0,"PP",13
16,"16157",211,179,179,2,0,"PP",95
45,"45198",1809,1475,1442,7,33,"PP",732
10,"10151",207,165,162,0,3,"PP",79
13,"13085",2342,1921,1855,10,66,"PP",829
4,"4016",2138,1551,1536,9,15,"PP",684
26,"26170",446,330,326,2,4,"PP",186
9,"9235",156,132,131,3,1,"PP",63
9,"9236",38,32,32,0,0,"PP",29
40,"40230",94,68,66,0,2,"PP",22
10,"10152",468,340,332,1,8,"PP",137
46,"46150",1831,1341,1333,7,8,"PP",568
37,"37314",82,65,65,0,0,"PP",47
37,"37187",572,427,423,1,4,"PP",243
24,"24141",95,85,84,0,1,"PP",34
10,"10015",675,483,473,3,10,"PP",179
43,"43133",5666,3397,3356,27,41,"PP",441
18,"18023",15655,10879,10774,82,105,"PP",4070
35,"35034",7873,3975,3943,27,32,"PP",1252
16,"16159",220,159,159,0,0,"PP",90
25,"25094",137,98,95,1,3,"PP",18
37,"37056",37,30,29,0,1,"PP",25
26,"26172",30,23,23,0,0,"PP",7
16,"16160",60,44,42,1,2,"PP",31
10,"10154",181,131,129,0,2,"PP",52
18,"18024",855,665,654,7,11,"PP",217
47,"47102",291,230,220,1,10,"PP",113
43,"43011",1077,743,737,2,6,"PP",82
5,"5014",5379,4009,3970,18,39,"PP",1688
24,"24210",503,358,356,3,2,"PP",152
28,"28108",3374,2482,2465,10,17,"PP",886
42,"42094",621,444,433,10,11,"PP",175
6,"6035",937,696,681,5,15,"PP",376
37,"37316",744,563,558,3,5,"PP",364
40,"40234",397,298,292,2,6,"PP",125
10,"10155",1126,773,763,5,10,"PP",281
46,"46230",13960,10351,10241,54,110,"PP",3103
43,"43135",340,235,234,1,1,"PP",21
18,"18025",288,220,220,1,0,"PP",60
24,"24008",9282,6685,6603,52,82,"PP",3449
10,"10156",97,73,72,1,1,"PP",18
16,"16162",43,35,34,0,1,"PP",22
9,"9378",31,24,23,0,1,"PP",7
10,"10018",1689,1101,1081,6,20,"PP",323
17,"17026",544,370,367,5,3,"PP",27
46,"46075",150,130,123,1,7,"PP",42
43,"43014",14251,8737,8624,101,113,"PP",953
7,"7008",5692,3956,3913,26,43,"PP",1357
18,"18163",324,235,233,2,2,"PP",92
24,"24107",236,175,173,0,2,"PP",74
49,"49143",225,163,162,0,1,"PP",107
6,"6038",805,543,541,2,2,"PP",213
10,"10157",263,204,201,0,3,"PP",89
4,"4020",288,201,197,0,4,"PP",97
34,"34032",40,33,33,1,0,"PP",18
37,"37059",124,94,93,1,1,"PP",48
40,"40902",123,99,96,1,3,"PP",77
18,"18028",928,765,758,2,7,"PP",356
49,"49145",236,162,157,0,5,"PP",106
17,"17027",2821,1896,1889,17,7,"PP",138
18,"18913",813,566,559,2,7,"PP",332
24,"24010",8386,5708,5632,60,76,"PP",2680
7,"7050",3348,2156,2139,19,17,"PP",1212
17,"17028",293,205,204,6,1,"PP",17
43,"43016",3416,2335,2309,15,26,"PP",227
49,"49268",403,313,309,1,4,"PP",222
16,"16166",243,176,174,1,2,"PP",73
10,"10159",320,251,250,0,1,"PP",111
37,"37061",225,168,168,1,0,"PP",96
37,"37320",95,72,72,0,0,"PP",49
45,"45103",397,331,327,3,4,"PP",183
18,"18029",1833,1196,1190,12,6,"PP",304
45,"45204",632,488,487,1,1,"PP",236
6,"6040",1009,648,645,1,3,"PP",201
17,"17148",1515,981,972,4,9,"PP",92
18,"18030",576,413,409,6,4,"PP",156
28,"28112",161,136,136,1,0,"PP",45
9,"9244",46,34,34,1,0,"PP",19
16,"16167",316,249,244,1,5,"PP",82
29,"29014",217,141,140,4,1,"PP",43
46,"46234",348,279,275,3,4,"PP",108
25,"25101",561,364,358,2,6,"PP",8
37,"37063",69,59,58,0,1,"PP",27
16,"16169",58,37,37,3,0,"PP",15
10,"10161",76,53,53,0,0,"PP",25
18,"18168",804,546,543,7,3,"PP",178
26,"26178",75,57,55,1,2,"PP",23
9,"9246",620,451,444,2,7,"PP",199
5,"5023",168,146,145,1,1,"PP",95
34,"34036",211,150,150,0,0,"PP",51
19,"19199",17,17,17,1,0,"PP",4
18,"18032",246,175,174,2,1,"PP",68
10,"10162",575,437,433,2,4,"PP",143
6,"6043",665,490,484,2,6,"PP",186
48,"48043",4423,3118,3108,17,10,"PP",247
10,"10163",350,293,290,2,3,"PP",153
9,"9386",54,39,38,1,1,"PP",26
43,"43019",1381,862,846,12,16,"PP",117
6,"6044",28875,19791,19616,145,175,"PP",8078
34,"34037",302,218,216,1,2,"PP",135
46,"46079",318,241,232,1,9,"PP",123
34,"34178",117,103,103,0,0,"PP",71
37,"37324",360,276,275,2,1,"PP",164
16,"16228",172,137,137,4,0,"PP",95
41,"41001",1596,1183,1159,5,24,"PP",274
6,"6045",506,379,374,3,5,"PP",159
34,"34038",277,204,203,1,1,"PP",128
4,"4026",66,54,51,0,3,"PP",36
16,"16171",1800,1469,1443,8,26,"PP",752
29,"29017",6553,4744,4668,33,76,"PP",1153
17,"17152",10737,6308,6252,45,56,"PP",1156
46,"46236",972,818,809,2,9,"PP",249
49,"49273",187,112,112,0,0,"PP",77
37,"37199",142,105,105,1,0,"PP",37
5,"5026",195,166,164,2,2,"PP",97
5,"5027",269,229,225,2,4,"PP",129
10,"10165",257,208,207,0,1,"PP",104
24,"24016",466,270,269,1,1,"PP",146
43,"43022",1497,897,889,14,8,"PP",217
41,"41091",541987,385251,382091,3298,3160,"PP",129961
23,"23006",4660,3687,3647,24,40,"PP",887
10,"10028",90,73,73,0,0,"PP",31
10,"10166",308,206,204,0,2,"PP",132
17,"17034",6931,4166,4150,29,16,"PP",442
19,"19088",79,61,61,0,0,"PP",36
6,"6047",849,639,628,2,11,"PP",251
49,"49152",525,339,334,2,5,"PP",189
23,"23007",3087,2205,2187,6,18,"PP",703
37,"37328",186,135,131,1,4,"PP",49
24,"24115",54058,37780,37357,308,423,"PP",12647
18,"18036",3851,2870,2841,17,29,"PP",1145
10,"10167",314,239,239,1,0,"PP",125
9,"9389",73,60,60,1,0,"PP",35
24,"24017",577,426,418,1,8,"PP",225
28,"28048",500,391,387,3,4,"PP",116
6,"6048",849,691,677,7,14,"PP",274
5,"5030",45,38,38,1,0,"PP",8
37,"37201",262,187,186,1,1,"PP",86
10,"10168",312,213,208,0,5,"PP",92
9,"9251",375,277,274,4,3,"PP",142
6,"6049",1015,725,707,3,18,"PP",287
27,"27001",2370,1281,1256,13,25,"PP",835
47,"47192",102,83,81,1,2,"PP",42
24,"24018",174,143,141,0,2,"PP",99
34,"34045",76,66,66,2,0,"PP",43
30,"30005",29526,20713,20526,121,187,"PP",9978
7,"7019",187,133,129,2,4,"PP",85
41,"41093",18554,13978,13874,99,104,"PP",5769
49,"49154",127,78,77,0,1,"PP",30
34,"34182",786,606,597,10,9,"PP",296
18,"18038",1066,828,802,1,26,"PP",219
9,"9391",361,264,263,3,1,"PP",145
18,"18177",418,258,256,0,2,"PP",115
48,"48048",557,395,393,5,2,"PP",10
18,"18039",3490,2406,2378,33,28,"PP",798
27,"27003",1876,1344,1320,12,24,"PP",790
36,"36014",1942,1459,1444,9,15,"PP",861
29,"29022",179,137,136,0,1,"PP",26
46,"46239",442,340,338,3,2,"PP",151
34,"34046",41,36,35,0,1,"PP",17
7,"7021",230,177,174,2,3,"PP",74
43,"43027",161,118,116,15,2,"PP",7
23,"23010",14347,9669,9560,86,109,"PP",3767
41,"41095",41232,27076,26793,315,283,"PP",6836
46,"46240",210,164,161,1,3,"PP",77
17,"17038",366,234,232,6,2,"PP",16
49,"49156",237,184,175,0,9,"PP",99
37,"37074",150,123,120,0,3,"PP",56
27,"27005",2595,1846,1816,13,30,"PP",922
5,"5182",786,538,532,2,6,"PP",308
30,"30007",6411,4360,4329,24,31,"PP",2100
43,"43150",1281,937,923,6,14,"PP",123
49,"49157",206,163,160,2,3,"PP",81
37,"37077",261,226,223,1,3,"PP",86
43,"43028",2688,1659,1639,6,20,"PP",188
18,"18179",538,376,374,6,2,"PP",150
6,"6054",5446,3920,3833,32,87,"PP",1732
17,"17039",1759,1159,1145,14,14,"PP",93
24,"24119",706,488,481,3,7,"PP",199
5,"5038",115,83,81,0,2,"PP",66
43,"43029",310,213,211,3,2,"PP",8
37,"37078",829,674,664,8,10,"PP",325
41,"41008",1059,749,739,10,10,"PP",101
27,"27007",2805,2133,2078,38,55,"PP",1307
12,"12118",72,55,53,0,2,"PP",25
16,"16186",456,375,371,0,4,"PP",175
19,"19210",21,19,18,1,1,"PP",15
29,"29024",386,227,219,2,8,"PP",62
5,"5039",54,42,41,0,1,"PP",32
6,"6055",2051,1453,1422,8,31,"PP",643
10,"10175",1416,1006,980,4,26,"PP",389
37,"37079",77,73,73,1,0,"PP",40
46,"46242",333,267,266,0,1,"PP",154
29,"29025",39665,25907,25714,192,193,"PP",9080
9,"9258",172,141,139,5,2,"PP",89
24,"24023",263,188,188,1,0,"PP",106
34,"34190",56,41,40,2,1,"PP",26
19,"19323",40,31,31,0,0,"PP",9
40,"40127",32,25,25,0,0,"PP",19
6,"6056",479,407,399,1,8,"PP",156
4,"4034",160,99,99,2,0,"PP",56
43,"43031",1458,1020,1014,15,6,"PP",77
46,"46086",82,70,69,1,1,"PP",7
34,"34051",101,88,83,0,5,"PP",51
19,"19212",703,543,531,3,12,"PP",284
18,"18045",1126,756,742,4,14,"PP",233
37,"37209",412,272,270,7,2,"PP",87
43,"43032",517,332,329,5,3,"PP",30
46,"46243",138,115,112,1,3,"PP",46
12,"12120",177,152,152,0,0,"PP",79
25,"25119",2248,1449,1442,15,7,"PP",123
5,"5187",1754,1323,1303,7,20,"PP",552
12,"12021",4436,3381,3332,27,49,"PP",1052
37,"37081",930,728,722,3,6,"PP",348
47,"47036",228,181,181,3,0,"PP",94
24,"24122",1342,930,924,8,6,"PP",407
34,"34052",174,135,133,0,2,"PP",78
46,"46009",3121,2459,2427,8,32,"PP",762
37,"37082",796,551,544,4,7,"PP",249
27,"27012",1355,736,729,5,7,"PP",350
19,"19214",75,60,58,0,2,"PP",33
43,"43033",765,531,530,4,1,"PP",54
6,"6059",1851,1268,1258,7,10,"PP",498
47,"47118",168,127,127,2,0,"PP",64
9,"9261",469,332,329,2,3,"PP",143
37,"37338",79,65,64,0,1,"PP",41
24,"24123",746,488,485,2,3,"PP",218
9,"9403",94,78,78,1,0,"PP",47
4,"4036",226,175,175,0,0,"PP",86
9,"9262",163,130,127,1,3,"PP",79
43,"43034",477,350,342,9,8,"PP",49
34,"34053",207,170,169,3,1,"PP",102
47,"47037",168,138,133,0,5,"PP",91
39,"39014",883,619,614,6,5,"PP",258
37,"37340",151,106,106,1,0,"PP",79
34,"34201",193,158,155,1,3,"PP",87
4,"4037",1314,969,955,6,14,"PP",365
9,"9265",37,28,28,0,0,"PP",19
16,"16192",48,31,30,1,1,"PP",10
41,"41101",5928,4209,4173,18,36,"PP",1283
5,"5045",91,66,66,0,0,"PP",46
10,"10181",686,533,523,1,10,"PP",177
41,"41013",4839,3151,3094,33,57,"PP",478
12,"12025",136,104,104,0,0,"PP",55
43,"43158",85,52,52,1,0,"PP",4
18,"18049",595,459,452,3,7,"PP",165
42,"42124",64,49,49,0,0,"PP",26
49,"49165",59,51,51,0,0,"PP",28
24,"24229",418,322,319,2,3,"PP",182
34,"34202",29,18,18,1,0,"PP",12
18,"18188",1653,1183,1175,5,8,"PP",355
24,"24125",462,290,286,4,4,"PP",153
16,"16193",66,49,48,0,1,"PP",17
10,"10183",980,733,728,1,5,"PP",287
41,"41014",2492,1882,1852,11,30,"PP",191
12,"12026",881,678,663,13,15,"PP",314
5,"5047",4163,3198,3142,17,56,"PP",1295
27,"27018",3467,2086,2059,20,27,"PP",805
41,"41901",2682,2107,2086,28,21,"PP",170
5,"5048",118,104,104,0,0,"PP",57
34,"34057",471,339,338,1,1,"PP",174
41,"41015",5297,3478,3405,41,73,"PP",798
46,"46012",896,682,663,1,19,"PP",257
24,"24127",296,226,215,4,11,"PP",127
5,"5194",140,119,116,1,3,"PP",62
29,"29031",1614,1107,1094,13,13,"PP",156
18,"18051",1147,817,810,8,7,"PP",224
19,"19330",71,63,63,2,0,"PP",26
42,"42037",33,25,25,2,0,"PP",19
36,"36901",4103,3153,3102,19,51,"PP",857
46,"46247",1006,714,710,3,4,"PP",352
27,"27020",3524,2816,2761,28,55,"PP",1806
34,"34058",189,172,172,2,0,"PP",87
24,"24029",735,539,535,3,4,"PP",168
46,"46013",17383,13569,13483,82,86,"PP",4344
16,"16196",633,508,503,2,5,"PP",193
29,"29032",6657,5031,4977,33,54,"PP",1195
35,"35001",4584,3282,3222,26,60,"PP",1347
38,"38003",1439,969,952,10,17,"PP",335
5,"5051",179,145,139,1,6,"PP",84
41,"41903",6757,4562,4504,51,58,"PP",1173
10,"10186",977,795,778,1,17,"PP",337
29,"29033",1122,747,730,4,17,"PP",232
34,"34208",51,42,42,0,0,"PP",32
16,"16197",59,42,42,0,0,"PP",12
24,"24130",438,323,321,4,2,"PP",159
15,"15029",5688,3590,3544,32,46,"PP",1762
41,"41018",9480,6523,6455,53,68,"PP",1060
43,"43041",216,152,151,0,1,"PP",43
9,"9269",36,26,26,1,0,"PP",18
18,"18054",849,606,605,7,1,"PP",262
16,"16198",1348,981,971,10,10,"PP",348
29,"29034",467,358,356,0,2,"PP",191
37,"37091",177,117,116,1,1,"PP",76
10,"10050",1053,846,837,6,9,"PP",433
24,"24031",215,172,168,0,4,"PP",74
46,"46249",9288,6746,6676,56,70,"PP",2446
34,"34210",103,90,90,0,0,"PP",59
7,"7036",26955,18578,18433,148,145,"PP",6413
16,"16199",30,25,25,1,0,"PP",17
43,"43042",2129,1439,1437,12,2,"PP",195
4,"4045",1757,1309,1288,6,21,"PP",268
24,"24032",109,91,89,0,2,"PP",40
6,"6069",3065,2053,2035,14,18,"PP",694
45,"45024",1062,793,785,4,8,"PP",467
6,"6070",7743,5438,5317,39,121,"PP",1655
17,"17054",370,236,236,1,0,"PP",26
18,"18057",5305,3827,3791,27,36,"PP",1231
29,"29035",1567,1157,1144,11,13,"PP",212
16,"16202",769,564,558,0,6,"PP",255
49,"49172",527,347,343,1,4,"PP",262
23,"23028",6220,4409,4369,23,40,"PP",1469
43,"43166",1584,1029,1022,6,7,"PP",153
9,"9273",52,40,39,2,1,"PP",23
7,"7038",2010,1424,1412,18,12,"PP",552
18,"18059",4180,2907,2870,20,37,"PP",709
43,"43044",3963,2671,2640,33,31,"PP",537
46,"46016",1061,870,856,5,14,"PP",236
12,"12032",23525,17093,16966,104,127,"PP",6361
9,"9412",790,528,523,4,5,"PP",269
26,"26025",87,71,70,1,1,"PP",29
45,"45060",173,126,125,1,1,"PP",26
6,"6072",2307,1696,1681,12,15,"PP",704
16,"16203",9972,7094,7007,34,87,"PP",2821
34,"34214",183,144,144,0,0,"PP",60
43,"43167",375,277,275,9,2,"PP",27
29,"29037",209,158,157,1,1,"PP",86
5,"5057",2465,1969,1953,15,16,"PP",857
18,"18903",889,669,661,5,8,"PP",277
10,"10192",828,590,584,1,6,"PP",298
43,"43045",149,110,110,2,0,"PP",1
49,"49173",375,230,221,3,9,"PP",142
12,"12033",1919,1437,1404,19,33,"PP",534
10,"10055",710,505,497,1,8,"PP",245
42,"42135",72,52,52,1,0,"PP",24
34,"34215",164,141,140,1,1,"PP",65
43,"43046",99,68,65,1,3,"PP",6
18,"18062",10393,7235,7161,63,74,"PP",2389
10,"10193",1412,1090,1078,6,12,"PP",576
23,"23031",747,637,619,0,18,"PP",98
10,"10194",542,415,407,2,8,"PP",175
9,"9275",192,129,129,2,0,"PP",77
6,"6074",4791,3513,3449,18,64,"PP",1253
5,"5059",106,82,81,1,1,"PP",36
43,"43047",4161,2359,2341,27,18,"PP",418
46,"46018",608,515,511,0,4,"PP",238
32,"32002",2017,1413,1398,16,15,"PP",669
24,"24036",288,184,184,2,0,"PP",68
37,"37100",80,61,61,1,0,"PP",48
6,"6075",465,383,372,0,11,"PP",90
41,"41023",7905,5402,5347,41,55,"PP",1546
18,"18064",377,291,290,2,1,"PP",120
6,"6076",831,611,607,2,4,"PP",220
10,"10195",7709,5572,5481,37,91,"PP",2719
37,"37101",160,128,125,0,3,"PP",90
43,"43048",805,525,513,8,12,"PP",118
27,"27032",3275,2128,2096,22,32,"PP",1132
43,"43049",728,464,461,4,3,"PP",22
7,"7043",3389,2290,2252,26,38,"PP",1014
42,"42141",112,80,80,0,0,"PP",43
16,"16211",370,263,263,3,0,"PP",118
27,"27033",623,415,409,8,6,"PP",209
6,"6077",341,256,249,0,7,"PP",58
49,"49177",278,179,177,1,2,"PP",78
29,"29040",1977,1290,1278,12,12,"PP",472
46,"46020",3760,2916,2866,22,50,"PP",1059
9,"9277",120,101,99,0,2,"PP",26
41,"41025",2020,1361,1320,7,41,"PP",462
10,"10197",123,90,89,0,1,"PP",44
37,"37103",436,310,308,8,2,"PP",175
6,"6078",507,409,404,1,5,"PP",256
9,"9279",174,131,130,3,1,"PP",85
10,"10198",1143,981,964,6,17,"PP",505
12,"12037",17,16,14,0,2,"PP",4
43,"43092",7036,4226,4185,39,41,"PP",800
6,"6079",652,449,442,4,7,"PP",177
5,"5210",87,70,69,0,1,"PP",46
34,"34071",171,132,132,1,0,"PP",91
42,"42012",35,28,28,0,0,"PP",10
16,"16213",36,34,34,0,0,"PP",12
40,"40020",157,118,117,1,1,"PP",52
9,"9418",82,62,61,1,1,"PP",43
18,"18067",702,469,466,0,3,"PP",181
6,"6080",1924,1412,1392,9,20,"PP",499
41,"41026",4314,3380,3322,18,58,"PP",347
41,"41027",3922,2660,2604,23,56,"PP",721
9,"9280",28,20,20,0,0,"PP",15
37,"37106",258,165,162,0,3,"PP",98
27,"27038",935,679,671,7,8,"PP",302
24,"24142",25119,17336,17141,154,195,"PP",5452
28,"28136",647,528,518,2,10,"PP",231
47,"47049",101,68,68,0,0,"PP",36
20,"20006",259,143,143,3,0,"PP",3
42,"42014",64,43,43,1,0,"PP",25
6,"6081",1074,806,792,7,14,"PP",202
10,"10201",173,142,142,2,0,"PP",57
26,"26102",6111,4486,4435,28,51,"PP",2064
37,"37107",10764,7379,7264,56,115,"PP",3813
41,"41028",2003,1524,1511,9,13,"PP",369
5,"5213",103,84,82,0,2,"PP",52
34,"34073",185,149,149,0,0,"PP",74
7,"7048",17252,10055,9984,105,71,"PP",3140
42,"42148",10,10,10,1,0,"PP",8
30,"30027",48176,35521,35266,153,255,"PP",15732
18,"18069",502,362,357,0,5,"PP",139
10,"10202",606,473,463,4,10,"PP",156
4,"4054",358,285,281,2,4,"PP",139
12,"12040",117608,85588,84946,496,642,"PP",28784
36,"36039",15401,10871,10609,71,262,"PP",3979
17,"17066",26562,15223,15087,150,136,"PP",2445
21,"21023",2124,1298,1264,7,34,"PP",310
12,"12137",36,23,23,0,0,"PP",7
10,"10203",4558,3120,3079,20,41,"PP",1401
16,"16217",74,62,62,0,0,"PP",35
7,"7049",1480,1003,993,14,10,"PP",414
47,"47051",335,268,263,2,5,"PP",110
4,"4055",371,310,308,0,2,"PP",109
47,"47214",1409,1087,1062,7,25,"PP",551
9,"9287",208,158,156,3,2,"PP",49
19,"19232",71,57,57,1,0,"PP",40
24,"24077",225,190,187,2,3,"PP",90
41,"41030",514,387,373,3,14,"PP",112
43,"43097",393,291,289,1,2,"PP",18
25,"25014",260,165,165,5,0,"PP",11
43,"43178",1350,856,844,5,12,"PP",120
23,"23041",499,398,394,2,4,"PP",178
10,"10204",429,331,329,6,2,"PP",153
43,"43056",854,480,470,5,10,"PP",66
16,"16219",89,71,71,0,0,"PP",22
27,"27043",1295,805,793,9,12,"PP",439
4,"4056",143,113,109,0,4,"PP",70
41,"41031",1238,825,814,11,11,"PP",165
6,"6086",1221,814,799,2,15,"PP",300
34,"34079",1616,1222,1205,5,17,"PP",480
20,"20009",11452,7388,7345,62,43,"PP",636
26,"26003",413,331,329,2,2,"PP",208
36,"36042",17891,12212,12003,93,209,"PP",4210
16,"16224",83,66,65,1,1,"PP",28
49,"49186",261,188,185,0,3,"PP",127
47,"47216",115,91,87,0,4,"PP",62
24,"24146",265,210,207,1,3,"PP",124
4,"4057",1325,894,884,5,10,"PP",287
24,"24148",1672,1249,1241,23,8,"PP",679
15,"15045",3770,2184,2157,14,27,"PP",1312
18,"18074",262,201,200,2,1,"PP",76
5,"5074",686,564,558,5,6,"PP",307
9,"9425",517,384,378,0,6,"PP",141
28,"28143",72,57,57,1,0,"PP",34
10,"10207",504,357,350,6,7,"PP",150
24,"24046",942,637,633,5,4,"PP",258
16,"16227",113,93,93,0,0,"PP",48
5,"5075",107,72,72,0,0,"PP",46
9,"9292",87,75,73,1,2,"PP",30
17,"17189",1516,1076,1070,5,6,"PP",25
6,"6089",596,469,461,1,8,"PP",179
10,"10208",123,94,93,1,1,"PP",33
30,"30032",2856,2163,2144,6,19,"PP",1061
10,"10071",139,96,94,0,2,"PP",44
10,"10209",282,179,177,1,2,"PP",57
24,"24047",783,545,540,2,5,"PP",293
37,"37115",123,89,87,0,2,"PP",71
27,"27048",2140,1502,1467,20,35,"PP",694
34,"34082",83,74,73,0,1,"PP",41
29,"29050",421,306,302,3,4,"PP",97
29,"29072",3262,2382,2352,17,30,"PP",686
43,"43905",14392,8444,8393,45,51,"PP",1884
49,"49188",112,90,89,1,1,"PP",51
7,"7055",7442,4604,4553,42,51,"PP",2041
43,"43061",45,30,29,0,1,"PP",2
9,"9295",61,44,44,0,0,"PP",35
47,"47055",203,167,163,0,4,"PP",71
6,"6091",3774,2709,2666,23,43,"PP",1184
24,"24049",1483,1054,1048,6,6,"PP",441
42,"42022",221,173,171,5,2,"PP",115
18,"18079",3441,2442,2411,16,31,"PP",369
19,"19003",42,35,34,1,1,"PP",5
30,"30033",10188,7403,7285,68,118,"PP",3513
25,"25148",219,124,124,0,0,"PP",13
34,"34083",1769,1218,1201,10,17,"PP",653
10,"10211",444,337,336,0,1,"PP",114
41,"41035",1108,794,780,7,14,"PP",276
18,"18082",861,616,611,5,5,"PP",244
29,"29051",40391,25780,25419,232,361,"PP",10197
40,"40032",390,289,285,2,4,"PP",150
29,"29052",224,144,144,3,0,"PP",62
37,"37118",123,92,90,0,2,"PP",48
10,"10212",1684,1233,1203,7,30,"PP",344
19,"19239",92,62,62,1,0,"PP",35
24,"24151",478,353,352,1,1,"PP",191
5,"5080",58,45,43,0,2,"PP",26
4,"4061",638,506,498,4,8,"PP",111
24,"24051",423,309,307,0,2,"PP",179
16,"16237",110,87,87,0,0,"PP",42
43,"43064",2015,1310,1296,23,14,"PP",165
41,"41037",3213,2376,2342,30,34,"PP",321
18,"18083",247,200,196,0,4,"PP",94
6,"6094",1485,929,926,2,3,"PP",279
12,"12902",2158,1504,1489,14,15,"PP",627
16,"16908",186,152,152,1,0,"PP",49
30,"30035",18671,13103,12979,54,124,"PP",6426
34,"34234",71,52,50,0,2,"PP",33
9,"9301",625,473,467,2,6,"PP",207
6,"6095",9504,6621,6475,96,146,"PP",2025
27,"27054",1190,881,860,9,21,"PP",478
27,"27055",1293,826,809,6,17,"PP",407
34,"34087",129,103,102,1,1,"PP",58
24,"24052",158,104,102,0,2,"PP",45
24,"24153",232,179,177,2,2,"PP",77
7,"7060",2568,1677,1653,16,24,"PP",619
25,"25024",351,226,223,2,3,"PP",10
10,"10215",431,311,308,2,3,"PP",95
29,"29054",41997,28422,28238,189,184,"PP",11795
10,"10216",1538,1175,1162,4,13,"PP",494
37,"37121",575,418,413,3,5,"PP",174
13,"13002",1483,1012,998,3,14,"PP",510
19,"19129",28,26,26,0,0,"PP",17
18,"18085",720,507,499,3,8,"PP",172
6,"6097",2362,1750,1727,7,23,"PP",634
24,"24053",442,286,280,1,6,"PP",168
46,"46187",1306,1017,1000,0,17,"PP",370
27,"27057",11169,7551,7386,79,165,"PP",3424
18,"18086",349,274,272,0,2,"PP",35
47,"47222",83,64,64,1,0,"PP",34
48,"48079",427,305,304,2,1,"PP",12
30,"30037",18793,13150,13003,47,147,"PP",6996
6,"6098",549,385,381,7,4,"PP",134
17,"17196",220,150,150,4,0,"PP",17
45,"45046",2412,1667,1654,7,13,"PP",697
37,"37123",177,126,126,0,0,"PP",97
19,"19243",44,31,31,0,0,"PP",18
24,"24054",430,314,313,1,1,"PP",194
41,"41040",10541,7752,7698,68,54,"PP",3086
39,"39040",4292,3208,3166,14,42,"PP",1451
12,"12052",578,452,435,3,17,"PP",227
30,"30038",15411,10847,10767,46,80,"PP",5254
37,"37124",212,146,144,1,2,"PP",78
46,"46032",5653,4402,4361,33,41,"PP",1351
6,"6099",1145,655,638,6,17,"PP",219
29,"29057",357,241,238,1,3,"PP",75
27,"27060",2598,1690,1665,19,25,"PP",880
10,"10219",1276,796,790,7,6,"PP",316
49,"49081",1382,1016,1003,9,13,"PP",427
37,"37374",1166,935,919,9,16,"PP",474
43,"43070",238,192,191,1,1,"PP",14
9,"9306",106,82,82,1,0,"PP",50
49,"49199",254,193,189,3,4,"PP",86
34,"34241",18,13,13,1,0,"PP",8
28,"28151",3142,2235,2199,8,36,"PP",804
18,"18089",14719,10163,10099,63,64,"PP",4034
46,"46033",191,156,155,0,1,"PP",78
10,"10901",1174,752,741,4,11,"PP",287
37,"37125",228,161,156,0,5,"PP",79
39,"39041",1760,1370,1354,9,16,"PP",552
10,"10902",721,548,540,4,8,"PP",227
46,"46112",536,455,450,2,5,"PP",209
36,"36054",10993,7476,7363,67,113,"PP",2955
37,"37251",124,93,92,1,1,"PP",58
7,"7065",2083,1346,1328,9,18,"PP",544
6,"6102",1048,843,825,6,18,"PP",322
10,"10903",826,578,569,3,9,"PP",164
46,"46034",1758,1390,1379,4,11,"PP",441
27,"27063",1737,1226,1186,14,40,"PP",544
10,"10085",323,235,233,0,2,"PP",119
12,"12056",282,236,231,1,5,"PP",74
25,"25032",64,44,44,1,0,"PP",2
46,"46250",578719,442973,440154,2541,2819,"PP",159079
24,"24057",1373,1045,1023,11,22,"PP",401
9,"9308",67,42,42,1,0,"PP",23
18,"18094",2359,1744,1720,14,24,"PP",739
17,"17083",2940,1895,1876,16,19,"PP",174
30,"30041",13621,8970,8889,46,81,"PP",3719
36,"36056",5076,3584,3515,30,69,"PP",1868
37,"37253",135,109,109,2,0,"PP",52
24,"24058",208,155,154,3,1,"PP",82
6,"6104",674,491,487,3,4,"PP",127
37,"37128",260,202,196,0,6,"PP",84
10,"10905",656,446,439,2,7,"PP",174
19,"19136",18,14,14,0,0,"PP",4
46,"46251",2462,1997,1956,6,41,"PP",659
17,"17084",238,146,144,5,2,"PP",6
24,"24159",1806,1386,1366,6,20,"PP",815
30,"30042",1922,1504,1491,7,13,"PP",710
47,"47063",103,81,80,1,1,"PP",41
37,"37129",251,204,201,3,3,"PP",86
32,"32032",8059,5708,5608,58,100,"PP",3030
36,"36057",236673,169244,167605,1366,1639,"PP",52297
46,"46036",564,383,378,5,5,"PP",183
27,"27901",2386,1596,1569,25,27,"PP",936
49,"49204",63,51,51,0,0,"PP",37
43,"43075",89,61,60,1,1,"PP",2
4,"4070",1584,1184,1179,3,5,"PP",529
34,"34099",60,48,48,0,0,"PP",35
12,"12058",71,63,62,1,1,"PP",33
42,"42168",107,80,80,0,0,"PP",40
24,"24160",684,483,474,6,9,"PP",237
13,"13014",492,398,397,1,1,"PP",180
5,"5239",214,164,162,3,2,"PP",83
36,"36059",4882,3137,3085,28,52,"PP",1812
24,"24060",602,363,361,3,2,"PP",181
9,"9442",375,279,277,2,2,"PP",137
39,"39045",367,271,268,1,3,"PP",148
34,"34100",142,108,108,1,0,"PP",58
46,"46037",1122,936,923,4,13,"PP",311
9,"9443",179,128,124,0,4,"PP",84
16,"16250",76,59,59,0,0,"PP",41
14,"14038",32322,22117,21887,179,230,"PP",8878
28,"28001",61,46,45,0,1,"PP",30
6,"6108",2275,1567,1527,11,40,"PP",545
17,"17087",225,152,149,2,3,"PP",10
41,"41047",10117,7515,7422,74,93,"PP",2654
18,"18098",6135,4206,4161,21,45,"PP",1516
25,"25036",184,112,111,4,1,"PP",22
25,"25165",285,179,176,2,3,"PP",16
37,"37132",351,256,253,2,3,"PP",121
46,"46116",13159,10193,10135,53,58,"PP",3563
49,"49207",239,150,146,0,4,"PP",79
24,"24061",1704,1213,1204,9,9,"PP",474
34,"34101",50,41,41,0,0,"PP",23
19,"19018",155,119,118,3,1,"PP",74
12,"12060",446,368,364,4,4,"PP",169
6,"6110",148,108,108,1,0,"PP",48
34,"34903",198,131,131,1,0,"PP",88
9,"9445",44,32,32,3,0,"PP",17
28,"28002",3007,2091,2074,14,17,"PP",910
5,"5099",491,395,386,6,9,"PP",172
47,"47149",42,34,34,3,0,"PP",14
5,"5148",25,15,15,0,0,"PP",10
37,"37175",403,314,312,6,2,"PP",189
24,"24062",139,98,98,1,0,"PP",35
4,"4073",330,234,233,2,1,"PP",101
11,"11005",4583,3018,2967,25,51,"PP",695
9,"9315",378,245,243,1,2,"PP",99
18,"18100",7807,5452,5398,50,54,"PP",1504
6,"6111",500,337,337,1,0,"PP",90
40,"40051",38,34,34,0,0,"PP",19
47,"47176",219,139,139,1,0,"PP",82
37,"37176",133,110,110,0,0,"PP",62
43,"43122",106,77,77,4,0,"PP",4
13,"13072",768,579,572,5,7,"PP",292
12,"12063",41,29,29,1,0,"PP",3
24,"24063",374,254,252,2,2,"PP",144
48,"48089",3306,2341,2329,20,12,"PP",139
9,"9316",105,80,80,1,0,"PP",42
49,"49209",505,342,341,2,1,"PP",207
34,"34104",246,185,182,1,3,"PP",122
11,"11006",24455,15750,15587,193,163,"PP",4655
46,"46040",1078,888,878,7,10,"PP",322
37,"37136",652,440,435,3,5,"PP",171
16,"16258",194,150,150,1,0,"PP",90
38,"38004",4456,3026,2983,23,43,"PP",946
49,"49093",280,223,222,1,1,"PP",102
19,"19021",1030,759,744,7,15,"PP",339
12,"12064",91,82,81,2,1,"PP",24
9,"9317",19,16,16,0,0,"PP",6
11,"11007",17964,10038,9856,197,182,"PP",3386
38,"38005",5468,3425,3392,18,33,"PP",991
24,"24064",1523,1101,1087,3,14,"PP",329
37,"37137",105,66,66,0,0,"PP",59
18,"18103",757,579,575,4,4,"PP",211
39,"39050",270,187,186,0,1,"PP",102
11,"11008",17471,10952,10812,128,140,"PP",3231
6,"6115",1261,841,832,5,9,"PP",333
32,"32042",1579,1094,1081,12,13,"PP",641
41,"41052",3013,2116,2064,14,52,"PP",415
25,"25170",266,169,167,1,2,"PP",12
6,"6116",1587,1171,1160,10,11,"PP",473
49,"49216",162,142,142,0,0,"PP",53
46,"46257",5571,4266,4224,25,42,"PP",1317
41,"41053",21259,15147,14853,132,294,"PP",3678
18,"18105",3782,2450,2420,17,30,"PP",562
37,"37139",205,169,168,2,1,"PP",83
43,"43084",526,363,361,10,2,"PP",25
42,"42043",3791,2727,2682,25,45,"PP",1483
37,"37005",74,54,54,2,0,"PP",35
9,"9321",1626,1238,1227,8,11,"PP",574
49,"49219",7464,4988,4914,53,74,"PP",2134
35,"35030",9250,5413,5326,34,87,"PP",1864
48,"48032",5743,4065,4048,29,17,"PP",323
35,"35004",39299,20523,20294,140,229,"PP",5427
6,"6901",2118,1559,1546,23,13,"PP",602
23,"23067",2460,1831,1805,11,26,"PP",544
12,"12068",48,36,35,1,1,"PP",17
4,"4078",1078,758,746,8,12,"PP",243
37,"37141",154,122,122,2,0,"PP",44
6,"6118",192,145,144,1,1,"PP",46
46,"46121",105,95,94,0,1,"PP",45
46,"46043",136,124,124,0,0,"PP",68
49,"49220",135,110,109,0,1,"PP",41
16,"16266",368,264,259,1,5,"PP",182
28,"28008",1799,1182,1174,4,8,"PP",519
9,"9451",238,191,190,0,1,"PP",67
13,"13028",10418,8075,7976,52,99,"PP",3768
37,"37142",586,430,429,1,1,"PP",187
34,"34110",88,71,71,1,0,"PP",28
14,"14045",3052,2362,2335,11,27,"PP",578
49,"49221",245,129,127,1,2,"PP",66
17,"17096",179,106,105,1,1,"PP",4
24,"24169",2969,2140,2118,13,22,"PP",575
43,"43088",1996,1271,1255,7,16,"PP",157
6,"6120",3389,2502,2478,12,24,"PP",903
12,"12069",66,49,48,0,1,"PP",17
46,"46044",4218,3222,3158,18,64,"PP",1132
5,"5007",111,81,80,3,1,"PP",67
24,"24170",1908,1365,1345,8,20,"PP",434
37,"37143",389,301,300,6,1,"PP",154
37,"37269",447,326,324,1,2,"PP",148
47,"47073",122,103,101,1,2,"PP",69
16,"16270",162,137,137,0,0,"PP",92
41,"41057",269,183,181,0,2,"PP",59
5,"5257",132,101,101,0,0,"PP",56
12,"12070",522,406,401,0,5,"PP",168
24,"24171",356,197,196,0,1,"PP",108
5,"5110",711,510,505,4,5,"PP",274
42,"42048",66,51,51,0,0,"PP",36
5,"5112",97,71,70,2,1,"PP",41
34,"34114",207,144,144,0,0,"PP",115
40,"40059",110,95,95,1,0,"PP",56
26,"26029",37,32,32,0,0,"PP",17
32,"32049",760,510,507,9,3,"PP",280
24,"24207",294,241,238,3,3,"PP",105
17,"17216",165,110,110,1,0,"PP",7
37,"37010",939,708,702,0,6,"PP",324
37,"37270",189,152,151,2,1,"PP",89
4,"4081",355,287,287,0,0,"PP",67
6,"6123",4627,3182,3120,18,62,"PP",1006
47,"47074",149,117,116,2,1,"PP",39
9,"9456",130,97,96,0,1,"PP",50
24,"24071",1006,745,734,10,11,"PP",309
45,"45065",271,207,206,1,1,"PP",92
29,"29008",14596,9519,9407,94,112,"PP",3657
24,"24172",418,255,250,2,5,"PP",147
40,"40019",36,31,31,1,0,"PP",15
6,"6124",1708,1202,1165,8,37,"PP",430
5,"5114",1345,1067,1044,3,23,"PP",435
37,"37146",117,96,95,1,1,"PP",71
41,"41059",34165,24949,24709,196,240,"PP",6979
49,"49225",147,91,90,0,1,"PP",57
46,"46125",847,689,684,5,5,"PP",224
5,"5115",523,378,373,0,5,"PP",243
10,"10108",219,148,146,0,2,"PP",81
49,"49226",255,198,195,0,3,"PP",91
46,"46262",223,162,159,2,3,"PP",76
5,"5261",41,26,26,0,0,"PP",20
24,"24073",478,332,328,2,4,"PP",140
19,"19036",263,229,229,0,0,"PP",118
9,"9330",1507,1108,1092,10,16,"PP",483
10,"10109",1762,1149,1125,14,24,"PP",468
42,"42189",60,46,45,0,1,"PP",25
24,"24174",486,343,342,4,1,"PP",162
48,"48901",4839,3459,3426,32,33,"PP",322
11,"11016",14929,9426,9302,123,124,"PP",3440
16,"16275",11,11,11,1,0,"PP",5
24,"24074",97,75,75,1,0,"PP",51
41,"41061",2195,1749,1703,11,46,"PP",176
14,"14050",2391,1822,1787,14,35,"PP",558
6,"6127",2863,2112,2088,10,24,"PP",941
13,"13038",1630,1230,1207,7,23,"PP",372
48,"48902",19008,12566,12447,76,119,"PP",1086
12,"12074",785,652,648,5,4,"PP",266
42,"42053",26,19,19,1,0,"PP",18
25,"25052",1555,1027,1016,14,11,"PP",68
16,"16276",21,16,16,1,0,"PP",8
43,"43096",99,81,80,1,1,"PP",2
18,"18117",506,383,373,1,10,"PP",107
11,"11017",3212,2233,2203,39,30,"PP",587
24,"24076",1277,956,947,4,9,"PP",346
17,"17103",4954,2877,2850,25,27,"PP",329
49,"49228",54,44,43,0,1,"PP",30
40,"40068",26,24,24,0,0,"PP",17
6,"6129",577,438,429,0,9,"PP",150
16,"16277",113,84,83,1,1,"PP",63
11,"11018",1468,1046,1031,9,15,"PP",402
37,"37276",143,104,103,1,1,"PP",66
29,"29067",424813,286785,284689,2351,2096,"PP",96359
38,"38017",28437,16239,16075,95,164,"PP",5299
39,"39091",1926,1493,1476,10,17,"PP",774
18,"18119",1702,1298,1283,13,15,"PP",456
12,"12107",355,303,299,4,4,"PP",125
9,"9335",88,68,68,0,0,"PP",24
34,"34124",60,50,49,0,1,"PP",32
43,"43098",343,235,233,5,2,"PP",18
19,"19040",52,41,39,0,2,"PP",10
42,"42055",164,121,121,0,0,"PP",66
45,"45070",1427,1147,1142,1,5,"PP",538
10,"10114",953,665,660,3,5,"PP",119
13,"13042",920,652,648,2,4,"PP",308
28,"28015",18736,14221,14127,68,94,"PP",5133
34,"34125",86,65,64,0,1,"PP",42
18,"18120",264,209,208,1,1,"PP",44
4,"4087",182,135,135,0,0,"PP",64
5,"5121",249,185,185,4,0,"PP",85
46,"46904",792,610,603,8,7,"PP",171
28,"28080",48554,38885,38691,164,194,"PP",20354
39,"39062",1812,1379,1366,5,13,"PP",759
43,"43099",306,228,226,4,2,"PP",10
26,"26036",16986,11940,11816,66,124,"PP",5324
49,"49231",330,232,232,2,0,"PP",134
35,"35012",10382,5443,5392,17,51,"PP",2432
16,"16280",192,164,161,1,3,"PP",90
25,"25186",213,124,122,3,2,"PP",10
9,"9338",227,170,169,0,1,"PP",65
28,"28016",79,53,51,0,2,"PP",19
49,"49232",96,74,74,1,0,"PP",42
47,"47162",74,60,60,0,0,"PP",35
29,"29070",40333,25991,25728,214,263,"PP",7997
42,"42058",113,92,89,0,3,"PP",55
46,"46052",499,421,417,2,4,"PP",162
43,"43100",3301,2183,2172,24,11,"PP",289
29,"29071",934,596,588,3,8,"PP",211
4,"4088",2454,1660,1650,15,10,"PP",593
6,"6134",547,335,332,1,3,"PP",140
16,"16902",137,107,107,0,0,"PP",53
5,"5124",102,83,81,0,2,"PP",57
25,"25058",4357,2624,2595,20,29,"PP",215
23,"23082",1921,1425,1416,8,9,"PP",578
12,"12079",399,316,314,2,2,"PP",154
37,"37156",4292,2996,2966,24,30,"PP",1669
24,"24080",213,164,161,3,3,"PP",83
4,"4089",742,521,518,1,3,"PP",248
6,"6135",1092,846,828,0,18,"PP",421
23,"23084",935,658,653,7,5,"PP",225
49,"49028",115,104,103,1,1,"PP",83
37,"37022",268,215,215,2,0,"PP",140
12,"12080",1932,1598,1570,10,28,"PP",521
9,"9473",85,70,65,1,5,"PP",43
10,"10119",620,460,452,1,8,"PP",152
47,"47003",227,180,179,3,1,"PP",115
6,"6136",1565,1131,1102,11,29,"PP",360
11,"11023",9348,6410,6349,64,61,"PP",1407
17,"17112",190,127,125,2,2,"PP",10
46,"46210",330,277,277,2,0,"PP",102
18,"18124",381,277,277,2,0,"PP",173
16,"16904",472,378,373,4,5,"PP",158
25,"25191",334,205,204,4,1,"PP",32
46,"46054",11293,8477,8409,47,68,"PP",2617
34,"34131",59,52,51,0,1,"PP",45
49,"49235",443,301,292,0,9,"PP",128
6,"6137",972,744,737,1,7,"PP",262
11,"11024",6723,4696,4634,44,62,"PP",1338
47,"47004",1181,939,930,7,9,"PP",396
9,"9478",41,32,32,1,0,"PP",13
40,"40075",160,139,139,0,0,"PP",69
4,"4091",334,268,267,6,1,"PP",63
43,"43104",1783,1157,1142,10,15,"PP",62
18,"18127",16635,11440,11332,91,108,"PP",2919
37,"37160",615,434,429,8,5,"PP",206
11,"11025",4398,2899,2848,51,51,"PP",530
41,"41069",29138,18991,18683,341,308,"PP",5466
43,"43105",162,123,122,2,1,"PP",7
24,"24083",1042,727,715,6,12,"PP",244
48,"48910",2909,1950,1937,10,13,"PP",205
4,"4092",2838,2127,2103,10,24,"PP",868
28,"28174",1795,1232,1221,7,11,"PP",585
49,"49237",165,119,117,2,2,"PP",64
6,"6003",823,627,616,1,11,"PP",206
17,"17115",282,183,183,1,0,"PP",17
46,"46238",13282,9786,9721,61,65,"PP",3145
24,"24084",163,116,116,0,0,"PP",53
6,"6140",630,506,499,3,7,"PP",320
26,"26042",834,635,625,5,10,"PP",251
46,"46134",2357,1725,1712,14,13,"PP",516
29,"29075",12934,8234,8147,69,87,"PP",3342
42,"42202",20,14,13,0,1,"PP",11
6,"6141",1719,1201,1189,8,12,"PP",483
29,"29076",2153,1390,1360,10,30,"PP",333
16,"16909",699,535,532,0,3,"PP",178
34,"34134",50,40,40,2,0,"PP",23
41,"41071",5586,3724,3661,22,63,"PP",833
37,"37287",310,213,210,2,3,"PP",130
6,"6005",1696,1197,1178,1,19,"PP",318
10,"10124",852,665,655,2,10,"PP",209
9,"9347",143,117,115,2,2,"PP",56
5,"5131",99,69,69,0,0,"PP",57
46,"46057",487,321,317,1,4,"PP",158
34,"34135",399,293,289,0,4,"PP",158
16,"16910",91,69,69,1,0,"PP",24
26,"26044",52,46,46,0,0,"PP",20
40,"40078",161,125,124,2,1,"PP",55
43,"43149",686,447,443,8,4,"PP",56
19,"19049",10,10,9,0,1,"PP",2
28,"28087",3186,2503,2487,19,16,"PP",1188
18,"18133",2168,1648,1636,6,12,"PP",808
10,"10126",1548,1120,1102,8,18,"PP",503
4,"4095",714,471,468,5,3,"PP",176
18,"18134",5828,3840,3800,36,40,"PP",1296
37,"37164",256,191,189,5,2,"PP",81
11,"11028",32488,21971,21672,316,299,"PP",3690
24,"24087",631,470,466,7,4,"PP",287
6,"6007",1475,1038,1032,1,6,"PP",261
9,"9350",469,350,343,2,7,"PP",236
11,"11029",5430,3039,3000,44,39,"PP",654
49,"49241",248,177,177,0,0,"PP",124
19,"19050",16,15,15,0,0,"PP",4
18,"18135",4568,3009,2961,14,48,"PP",897
45,"45080",6,6,6,0,0,"PP",4
37,"37165",33,26,25,0,1,"PP",18
41,"41074",3012,2282,2257,18,25,"PP",529
46,"46215",1436,1154,1143,5,11,"PP",236
35,"35020",6034,3992,3934,20,58,"PP",1286
4,"4096",266,209,208,0,1,"PP",78
6,"6145",922,696,694,5,2,"PP",283
37,"37166",214,152,151,2,1,"PP",93
43,"43111",2044,1291,1275,9,16,"PP",198
34,"34137",27,23,22,0,1,"PP",9
49,"49242",447,360,357,5,3,"PP",198
6,"6146",1084,838,830,1,8,"PP",221
41,"41097",3137,2180,2134,18,46,"PP",553
41,"41075",10212,6419,6295,49,124,"PP",2327
20,"20053",4774,2973,2953,13,20,"PP",169
46,"46059",1261,1035,1019,9,16,"PP",238
17,"17003",104,67,66,0,1,"PP",2
4,"4097",248,189,189,1,0,"PP",71
24,"24089",102747,74428,73688,631,740,"PP",30509
28,"28025",420,320,315,4,5,"PP",182
6,"6147",354,268,268,0,0,"PP",43
49,"49243",111,94,93,0,1,"PP",65
25,"25070",823,554,549,15,5,"PP",48
35,"35021",14924,10477,10370,45,107,"PP",4134
37,"37168",439,316,311,0,5,"PP",171
37,"37292",104,77,77,1,0,"PP",52
18,"18137",989,761,760,7,1,"PP",380
46,"46060",9369,7052,6993,42,59,"PP",2474
29,"29082",31885,22572,22400,152,172,"PP",8043
47,"47171",407,303,301,6,2,"PP",171
24,"24090",343,235,233,1,2,"PP",130
6,"6148",966,691,678,8,13,"PP",180
18,"18138",2486,1620,1606,13,14,"PP",360
47,"47010",13729,10549,10454,81,95,"PP",3920
37,"37169",176,127,126,0,1,"PP",56
43,"43114",392,271,268,2,3,"PP",6
28,"28091",5440,3596,3558,24,38,"PP",1451
37,"37294",11692,8317,8221,71,96,"PP",3433
42,"42211",82,66,66,1,0,"PP",35
28,"28026",6317,4734,4701,33,33,"PP",2104
13,"13063",3706,2539,2514,33,25,"PP",1079
18,"18140",43496,28038,27872,212,166,"PP",9429
24,"24091",645,454,451,1,3,"PP",231
26,"26049",172,125,122,1,3,"PP",69
49,"49004",126,100,100,4,0,"PP",47
17,"17006",1127,686,682,1,4,"PP",48
4,"4099",4989,3636,3588,27,48,"PP",1670
43,"43115",143,100,98,2,2,"PP",2
39,"39074",6902,5113,5039,40,74,"PP",2431
48,"48023",600,455,452,0,3,"PP",17
25,"25206",260,150,150,5,0,"PP",5
17,"17125",130,80,80,0,0,"PP",3
40,"40086",685,561,552,4,9,"PP",259
11,"11034",2334,1549,1517,14,32,"PP",384
17,"17007",1731,1191,1182,7,9,"PP",67
37,"37171",409,317,310,2,7,"PP",194
9,"9355",98,75,75,0,0,"PP",65
9,"9906",1219,902,898,8,4,"PP",470
4,"4100",8768,5390,5353,32,37,"PP",2332
34,"34147",166,118,117,0,1,"PP",80
41,"41079",9294,6670,6580,51,90,"PP",1312
17,"17126",311,236,234,0,2,"PP",5
6,"6152",1319,945,932,4,13,"PP",326
11,"11035",13593,8375,8276,90,99,"PP",2853
49,"49247",443,283,279,2,4,"PP",161
18,"18006",4130,2904,2864,13,40,"PP",1174
49,"49248",186,151,150,1,1,"PP",78
41,"41080",1274,910,892,6,18,"PP",256
29,"29085",144,109,108,0,1,"PP",41
42,"42079",26,18,18,1,0,"PP",16
29,"29086",793,470,470,3,0,"PP",174
18,"18144",781,567,558,4,9,"PP",221
43,"43118",419,311,308,5,3,"PP",25
9,"9221",461,343,338,3,5,"PP",114
12,"12093",178,137,136,2,1,"PP",60
36,"36023",8395,5965,5884,41,81,"PP",2493
34,"34149",23,18,18,0,0,"PP",9
34,"34010",577,440,438,5,2,"PP",243
9,"9358",255,194,190,3,4,"PP",126
48,"48026",1140,830,823,5,7,"PP",10
17,"17010",336,224,224,3,0,"PP",6
34,"34151",159,104,103,0,1,"PP",61
18,"18145",10491,7538,7477,59,61,"PP",2739
9,"9360",30,23,23,0,0,"PP",13
11,"11037",5661,4347,4265,33,82,"PP",448
28,"28030",1726,1320,1299,8,21,"PP",517
41,"41081",29189,20205,20015,196,190,"PP",3340
29,"29087",376,270,266,1,4,"PP",65
4,"4103",1476,1018,1008,3,10,"PP",469
6,"6019",2079,1451,1417,8,34,"PP",453
5,"5147",159,128,124,5,4,"PP",82
37,"37301",74,63,63,0,0,"PP",39
10,"10047",955,732,727,1,5,"PP",176
19,"19145",46,41,41,1,0,"PP",31
24,"24197",763,538,533,1,5,"PP",254
46,"46065",1579,1174,1163,8,11,"PP",356
11,"11038",13737,10181,10034,99,147,"PP",3949
39,"39078",1401,975,963,5,12,"PP",406
6,"6157",443,321,316,1,5,"PP",158
24,"24096",117,80,79,1,1,"PP",39
6,"6020",1815,1366,1345,10,21,"PP",509
18,"18192",1538,1151,1123,6,28,"PP",333
37,"37089",67,56,56,0,0,"PP",26
12,"12027",17283,12015,11888,89,127,"PP",4148
49,"49047",107,75,75,0,0,"PP",47
19,"19290",834,561,558,5,3,"PP",212
48,"48028",717,543,537,3,6,"PP",9
29,"29089",3228,2377,2321,10,56,"PP",393
25,"25211",680,386,379,4,7,"PP",42
37,"37177",289,220,219,2,1,"PP",124
6,"6158",13314,9654,9507,67,147,"PP",3442
4,"4902",45437,28936,28699,214,237,"PP",15123
34,"34155",129,104,103,2,1,"PP",37
19,"19061",57,42,42,0,0,"PP",23
46,"46066",1263,1024,1018,9,6,"PP",316
43,"43123",70482,44051,43675,345,376,"PP",6982
49,"49130",180,143,141,5,2,"PP",78
47,"47177",105,76,73,1,3,"PP",28
43,"43164",301,205,204,2,1,"PP",48
24,"24199",424,302,301,0,1,"PP",136
11,"11040",397,307,292,1,15,"PP",59
17,"17014",64,48,48,1,0,"PP",4
46,"46145",21990,16337,16187,93,150,"PP",5248
19,"19184",71,50,48,0,2,"PP",31
42,"42084",25,22,22,1,0,"PP",18
4,"4903",4320,2858,2825,19,33,"PP",1678
39,"39081",437,337,332,4,5,"PP",227
29,"29091",8957,6186,6078,56,108,"PP",2409
41,"41085",4086,3058,3012,22,46,"PP",1009
10,"10006",1263,978,970,2,8,"PP",391
38,"38042",3802,2652,2625,14,27,"PP",958
40,"40221",49,39,39,0,0,"PP",17
43,"43125",933,680,677,14,3,"PP",83
48,"48031",332,233,231,1,2,"PP",2
29,"29092",570,397,390,4,7,"PP",76
18,"18150",6763,4733,4678,21,55,"PP",1411
37,"37180",75,56,56,0,0,"PP",35
4,"4904",1777,1230,1221,12,9,"PP",751
34,"34157",2442,1792,1768,21,24,"PP",878
49,"49257",291,190,184,1,6,"PP",83
28,"28034",361,274,269,1,5,"PP",147
37,"37181",286,210,207,4,3,"PP",121
46,"46068",346,276,266,6,10,"PP",97
18,"18151",260,171,170,3,1,"PP",42
47,"47070",37,27,27,0,0,"PP",24
40,"40223",216,163,163,1,0,"PP",70
43,"43126",1177,782,772,4,10,"PP",89
28,"28131",12990,9512,9433,38,79,"PP",3945
34,"34158",288,186,184,3,2,"PP",66
43,"43127",743,528,527,2,1,"PP",50
37,"37182",75,56,55,0,1,"PP",38
41,"41087",10237,6923,6774,48,149,"PP",2234
5,"5002",1963,1422,1390,3,32,"PP",560
18,"18152",944,707,703,0,4,"PP",118
34,"34159",357,253,248,4,5,"PP",89
10,"10009",266,201,194,0,7,"PP",112
19,"19067",70,52,51,1,1,"PP",16
11,"11902",3629,2275,2252,25,23,"PP",895
29,"29094",57554,38071,37696,339,375,"PP",14248
37,"37309",44,30,30,1,0,"PP",15
34,"34160",139,115,114,3,1,"PP",31
45,"45095",689,513,505,0,8,"PP",273
5,"5058",78,49,48,0,1,"PP",23
17,"17057",968,641,636,11,5,"PP",38
9,"9369",436,319,316,1,3,"PP",134
18,"18153",8597,6024,5972,40,52,"PP",1843
6,"6903",2021,1377,1360,12,17,"PP",511
10,"10148",32850,22161,21856,177,305,"PP",8605
28,"28036",2539,1899,1878,11,21,"PP",630
5,"5158",367,290,286,6,4,"PP",170
28,"28104",14040,11151,11096,57,55,"PP",4232
9,"9415",268,175,175,2,0,"PP",105
45,"45196",1400,1047,1033,5,14,"PP",446
37,"37311",227,182,182,3,0,"PP",96
29,"29095",3321,2376,2307,24,69,"PP",582
7,"7001",3573,2531,2497,21,34,"PP",841
9,"9372",212,176,176,4,0,"PP",81
12,"12001",1051,821,800,4,21,"PP",335
24,"24206",1700,1253,1240,12,13,"PP",446
47,"47099",150,135,135,1,0,"PP",80
17,"17021",131,86,85,4,1,"PP",2
49,"49261",1537,1048,1033,8,15,"PP",427
34,"34163",45,38,38,0,0,"PP",24
35,"35032",3412,2473,2425,17,48,"PP",1218
46,"46071",464,383,377,0,6,"PP",136
24,"24103",283,163,157,1,6,"PP",100
7,"7003",11761,6631,6541,55,90,"PP",2375
46,"46072",3611,2871,2821,23,50,"PP",987
6,"6031",469,277,272,2,5,"PP",142
45,"45163",8298,5942,5855,28,87,"PP",2384
34,"34165",66,58,58,1,0,"PP",52
47,"47021",76,64,64,0,0,"PP",33
10,"10014",1852,1370,1346,6,24,"PP",578
5,"5012",133,105,102,0,3,"PP",70
17,"17022",6910,4207,4184,58,23,"PP",314
49,"49263",51,36,36,0,0,"PP",33
38,"38049",2655,1654,1627,8,27,"PP",637
49,"49138",234,184,184,3,0,"PP",109
16,"16212",247,203,202,0,1,"PP",93
49,"49059",94,64,64,0,0,"PP",41
39,"39057",2330,1671,1645,7,26,"PP",678
40,"40105",47,42,42,2,0,"PP",20
7,"7045",1295,947,936,5,11,"PP",259
18,"18066",2107,1392,1384,4,8,"PP",305
28,"28107",457,312,312,0,0,"PP",97
42,"42093",37,29,28,1,1,"PP",22
7,"7005",6710,4127,4090,25,37,"PP",1361
12,"12004",4170,3125,3088,19,37,"PP",1174
17,"17024",268,153,152,1,1,"PP",21
37,"37188",181,129,129,3,0,"PP",61
24,"24007",773,550,548,4,2,"PP",149
49,"49141",340,248,246,0,2,"PP",129
12,"12104",6933,5411,5342,25,69,"PP",2153
47,"47023",2995,2344,2326,18,18,"PP",948
46,"46073",1092,888,884,6,4,"PP",309
37,"37357",262,205,203,1,2,"PP",114
12,"12105",848,644,638,2,6,"PP",378
25,"25011",5243,2796,2767,23,29,"PP",358
34,"34169",404,287,286,0,1,"PP",179
7,"7006",5178,3366,3329,52,37,"PP",857
18,"18162",938,698,686,1,12,"PP",281
46,"46152",96,68,68,0,0,"PP",33
6,"6036",5075,3575,3535,35,40,"PP",1274
46,"46074",2696,2069,2038,14,31,"PP",554
15,"15003",1803,1227,1210,9,17,"PP",714
5,"5016",6335,4670,4586,41,84,"PP",2513
43,"43013",4411,2750,2739,19,11,"PP",319
29,"29011",2900,1822,1803,9,19,"PP",425
17,"17145",1482,967,956,8,11,"PP",65
10,"10019",1498,1063,1054,3,9,"PP",472
19,"19304",219,173,171,3,2,"PP",48
5,"5214",38,28,28,0,0,"PP",8
25,"25226",253,155,152,3,3,"PP",12
43,"43136",10351,6279,6218,63,61,"PP",672
47,"47024",259,208,207,1,1,"PP",98
5,"5017",85,82,81,5,1,"PP",47
45,"45101",3756,3020,2984,12,36,"PP",1657
47,"47104",2836,2182,2121,19,61,"PP",1178
12,"12007",746,651,636,3,15,"PP",291
28,"28042",1173,890,883,3,7,"PP",436
25,"25227",652,402,400,4,2,"PP",22
5,"5018",29,22,22,0,0,"PP",10
9,"9423",27,24,24,0,0,"PP",18
36,"36040",2575,1709,1680,15,29,"PP",821
37,"37109",183,129,127,0,2,"PP",91
23,"23040",1480,1199,1192,2,7,"PP",271
34,"34033",17,17,17,0,0,"PP",12
37,"37193",390,279,275,4,4,"PP",117
28,"28043",5921,3803,3759,18,44,"PP",1669
10,"10021",5147,3744,3648,31,96,"PP",1071
47,"47105",183,158,156,0,2,"PP",68
46,"46154",808,636,631,5,5,"PP",306
18,"18165",4123,2787,2758,18,29,"PP",660
30,"30029",11864,8125,8058,73,67,"PP",3492
40,"40154",20,15,15,0,0,"PP",8
24,"24109",977,633,624,3,9,"PP",206
43,"43139",2039,1218,1191,8,27,"PP",98
34,"34175",90,72,70,0,2,"PP",48
37,"37194",251,196,195,1,1,"PP",92
12,"12008",222,193,192,1,1,"PP",87
42,"42100",32,30,30,0,0,"PP",17
49,"49269",229,165,162,1,3,"PP",91
9,"9382",33,28,28,0,0,"PP",21
19,"19081",29,22,22,1,0,"PP",17
37,"37321",168,132,132,2,0,"PP",61
46,"46233",3860,2859,2817,10,42,"PP",1033
49,"49270",133,99,99,1,0,"PP",35
37,"37195",46,36,36,1,0,"PP",7
5,"5022",1588,1238,1222,5,16,"PP",824
43,"43140",2367,1550,1532,4,18,"PP",223
17,"17149",364,248,248,0,0,"PP",5
43,"43903",2392,1324,1313,10,11,"PP",147
46,"46078",28017,20288,20143,132,145,"PP",5590
10,"10024",695,525,520,3,5,"PP",274
28,"28045",33328,24620,24434,146,186,"PP",9359
49,"49271",194,145,141,1,4,"PP",65
43,"43141",106,68,67,0,1,"PP",9
17,"17031",168,97,97,3,0,"PP",10
42,"42105",50,45,45,0,0,"PP",40
7,"7013",6881,4693,4587,39,106,"PP",2362
5,"5173",60,49,49,0,0,"PP",37
37,"37065",312,223,222,3,1,"PP",148
46,"46157",2980,2321,2298,10,23,"PP",1006
28,"28046",4460,3447,3422,16,25,"PP",1464
17,"17151",174,111,110,3,1,"PP",19
36,"36008",21762,15447,15262,128,185,"PP",4697
19,"19086",1473,1123,1111,7,12,"PP",486
28,"28074",138947,103687,102762,620,925,"PP",29905
37,"37241",168,131,131,1,0,"PP",100
37,"37198",207,160,157,3,3,"PP",61
10,"10026",648,500,492,7,8,"PP",176
23,"23004",436,364,358,1,6,"PP",183
7,"7015",20991,12552,12433,184,119,"PP",4148
30,"30002",9903,7011,6943,28,68,"PP",3674
12,"12111",360,305,299,3,6,"PP",120
28,"28114",150,101,100,1,1,"PP",50
43,"43144",1247,842,836,6,6,"PP",93
20,"20079",17886,11860,11799,91,61,"PP",878
46,"46158",1026,811,795,6,16,"PP",268
42,"42107",74,54,54,3,0,"PP",28
12,"12012",2685,2234,2202,13,32,"PP",794
24,"24114",3061,2025,1994,9,31,"PP",621
18,"18035",1232,992,988,6,4,"PP",420
18,"18173",8939,5922,5849,42,73,"PP",1670
28,"28115",60892,49705,49510,209,195,"PP",27523
6,"6046",1255,1004,995,8,9,"PP",409
37,"37069",968,695,689,7,6,"PP",325
7,"7016",2809,1865,1836,23,29,"PP",578
37,"37327",185,149,146,3,3,"PP",61
37,"37200",187,136,136,0,0,"PP",72
49,"49275",52210,36205,35754,356,451,"PP",15370
46,"46159",22857,16840,16697,128,143,"PP",5016
38,"38024",15077,9512,9356,55,156,"PP",3878
10,"10029",414,339,333,0,6,"PP",98
17,"17154",92,67,66,0,1,"PP",0
28,"28116",704,528,523,2,5,"PP",187
40,"40120",192,170,166,0,4,"PP",71
41,"41092",7743,5358,5311,55,47,"PP",1072
19,"19089",30,22,22,0,0,"PP",4
34,"34181",448,322,319,7,3,"PP",92
14,"14001",3514,2837,2789,28,48,"PP",968
37,"37369",137,95,94,0,1,"PP",53
24,"24219",516,387,386,4,1,"PP",195
5,"5033",176,144,142,1,2,"PP",89
36,"36012",3732,2751,2717,9,34,"PP",1220
9,"9390",611,484,482,3,2,"PP",220
17,"17155",14515,8393,8330,65,63,"PP",879
10,"10031",165,135,134,1,1,"PP",60
24,"24116",417,314,309,1,5,"PP",159
47,"47112",2587,2015,1988,7,27,"PP",1151
37,"37329",42,34,34,0,0,"PP",26
19,"19090",91,73,73,1,0,"PP",31
23,"23009",12861,9649,9543,72,106,"PP",4019
36,"36013",2344,1536,1514,11,22,"PP",859
45,"45010",415,311,310,2,1,"PP",123
10,"10032",1681,1257,1237,5,20,"PP",562
24,"24221",795,543,538,7,5,"PP",275
20,"20017",8559,5478,5435,24,43,"PP",272
46,"46083",15422,11179,11049,86,130,"PP",4042
7,"7020",3581,2542,2502,43,40,"PP",751
6,"6051",1571,1192,1178,7,14,"PP",506
29,"29021",161,108,107,4,1,"PP",47
47,"47032",152,117,116,1,1,"PP",83
34,"34088",246,193,186,1,7,"PP",81
9,"9392",53,40,37,1,3,"PP",11
41,"41094",6288,4497,4449,38,48,"PP",1394
24,"24154",1005,673,666,4,7,"PP",279
37,"37372",144,111,108,0,3,"PP",57
39,"39100",860,633,629,15,4,"PP",344
12,"12116",58,49,49,0,0,"PP",26
48,"48049",549,416,416,1,0,"PP",11
6,"6052",4030,2735,2688,20,47,"PP",1341
18,"18178",719,549,544,4,5,"PP",223
6,"6053",602,454,444,3,10,"PP",109
19,"19095",12,9,9,0,0,"PP",7
17,"17159",643,413,406,3,7,"PP",41
47,"47033",196,154,154,1,0,"PP",85
9,"9394",715,533,521,3,12,"PP",211
37,"37205",231,189,182,0,7,"PP",75
46,"46006",4523,3665,3623,20,42,"PP",1465
5,"5183",138,111,110,0,1,"PP",84
17,"17160",14747,9189,9129,65,60,"PP",937
27,"27006",2564,1659,1637,17,22,"PP",871
10,"10173",577,400,399,5,1,"PP",175
12,"12017",161,130,128,0,2,"PP",71
9,"9395",138,104,104,0,0,"PP",62
24,"24120",341,246,244,1,2,"PP",145
25,"25245",435,289,280,5,9,"PP",31
10,"10174",174,135,132,0,3,"PP",69
16,"16041",358,275,271,0,4,"PP",137
34,"34189",56,44,44,1,0,"PP",28
25,"25030",135,74,72,1,2,"PP",0
23,"23014",2559,1971,1942,13,29,"PP",656
10,"10037",76232,55104,54464,418,640,"PP",23333
46,"46085",11081,7938,7866,46,72,"PP",2860
45,"45014",4010,2646,2616,22,30,"PP",818
12,"12018",287,246,242,1,4,"PP",84
18,"18181",223,174,172,0,2,"PP",128
37,"37335",406,296,290,0,6,"PP",165
37,"37208",76,56,54,1,2,"PP",40
27,"27009",2097,1533,1507,12,26,"PP",956
36,"36018",3240,2198,2170,10,28,"PP",1245
19,"19052",25,21,21,1,0,"PP",5
5,"5040",66,50,50,1,0,"PP",38
34,"34192",90,75,72,0,3,"PP",50
18,"18182",1906,1298,1288,4,10,"PP",423
5,"5186",1575,1225,1194,3,31,"PP",691
48,"48052",1562,1160,1150,4,10,"PP",32
30,"30010",6869,5194,5142,21,52,"PP",2643
5,"5041",1001,775,762,8,13,"PP",467
7,"7026",31074,18280,18135,168,145,"PP",5843
43,"43154",130,101,100,0,1,"PP",5
41,"41099",3976,2369,2347,12,22,"PP",527
28,"28122",513,375,370,2,5,"PP",161
23,"23016",387,321,320,0,1,"PP",88
39,"39043",1481,1122,1115,9,7,"PP",654
40,"40128",129,95,93,0,2,"PP",48
37,"37211",224,172,172,4,0,"PP",101
46,"46165",7129,5436,5388,25,48,"PP",1858
37,"37337",139,124,124,0,0,"PP",103
49,"49084",287,229,228,4,1,"PP",96
34,"34196",89,68,68,1,0,"PP",40
43,"43155",22873,14209,14082,153,127,"PP",1854
23,"23017",1572,1269,1257,4,12,"PP",408
7,"7027",20769,13097,12987,100,110,"PP",4707
37,"37212",104,78,74,0,4,"PP",30
28,"28055",916,693,687,5,6,"PP",327
46,"46244",58771,42137,41867,270,270,"PP",14376
36,"36021",12073,8447,8342,89,105,"PP",3193
19,"19099",298,200,199,6,1,"PP",78
6,"6060",5786,4146,4071,24,75,"PP",1448
10,"10042",84,63,63,0,0,"PP",21
41,"41100",1013,692,673,6,19,"PP",190
40,"40130",130,107,106,1,1,"PP",61
18,"18185",541,434,432,2,2,"PP",160
28,"28056",863,630,617,4,13,"PP",228
49,"49164",155,119,115,2,4,"PP",41
49,"49163",219,158,154,5,4,"PP",94
42,"42123",164,117,116,4,1,"PP",63
47,"47119",92,80,79,1,1,"PP",44
45,"45018",498,333,330,4,3,"PP",101
17,"17166",522,374,367,1,7,"PP",26
24,"24124",367,244,233,3,11,"PP",137
23,"23019",1536,1196,1174,2,22,"PP",353
48,"48055",2668,1872,1849,11,23,"PP",81
19,"19327",418,350,348,1,2,"PP",258
45,"45019",7377,5307,5251,37,56,"PP",1763
46,"46167",364,266,264,0,2,"PP",106
24,"24161",285,203,201,3,2,"PP",105
47,"47038",105,77,77,0,0,"PP",37
19,"19216",131,98,98,0,0,"PP",30
28,"28125",3002,2180,2163,11,17,"PP",998
25,"25123",193,134,131,2,3,"PP",1
19,"19142",265,182,180,3,2,"PP",45
37,"37341",53,39,39,0,0,"PP",23
12,"12123",48,40,40,3,0,"PP",18
5,"5192",101,82,79,2,3,"PP",41
43,"43159",81,59,59,0,0,"PP",2
24,"24230",426,322,320,5,2,"PP",166
47,"47121",544,437,425,6,12,"PP",186
40,"40006",22,18,18,0,0,"PP",9
17,"17168",380,260,258,0,2,"PP",13
45,"45121",6796,4743,4692,22,51,"PP",2240
17,"17049",3117,2092,2072,14,20,"PP",98
34,"34205",61,50,50,0,0,"PP",30
46,"46090",1637,1391,1367,3,24,"PP",496
42,"42127",38,31,31,1,0,"PP",21
47,"47122",2032,1563,1535,7,28,"PP",699
28,"28058",139342,100637,99753,634,884,"PP",27325
37,"37217",58,45,44,0,1,"PP",20
48,"48088",136,102,102,0,0,"PP",3
38,"38038",162027,104978,104035,575,943,"PP",33326
35,"35026",81091,51953,51195,407,758,"PP",17654
46,"46091",118,94,94,0,0,"PP",57
40,"40008",44,39,39,1,0,"PP",24
5,"5195",220,169,169,2,0,"PP",100
42,"42128",42,42,41,1,1,"PP",21
17,"17050",652,453,453,3,0,"PP",24
10,"10048",233,168,168,0,0,"PP",102
17,"17207",2375,1590,1579,11,11,"PP",63
49,"49208",394,248,244,2,4,"PP",189
24,"24164",370,218,217,0,1,"PP",114
37,"37302",290,196,195,2,1,"PP",110
19,"19107",294,239,237,0,2,"PP",120
24,"24902",347,270,269,2,1,"PP",134
24,"24030",4277,3038,3007,11,31,"PP",1056
10,"10049",3819,3031,2950,18,81,"PP",1115
9,"9409",111,86,86,4,0,"PP",25
45,"45023",2177,1571,1556,6,15,"PP",566
42,"42001",278,212,210,3,2,"PP",91
9,"9410",3040,2117,2095,16,22,"PP",614
5,"5052",95,77,76,0,1,"PP",59
48,"48059",400,294,291,0,3,"PP",10
7,"7035",1524,1078,1055,8,23,"PP",434
37,"37219",173,109,108,0,1,"PP",66
5,"5197",102,85,83,1,2,"PP",53
10,"10096",3408,2440,2391,12,49,"PP",746
49,"49170",102,72,71,0,1,"PP",35
5,"5198",73,62,62,0,0,"PP",47
28,"28129",8030,5986,5941,42,45,"PP",2445
19,"19108",111,97,96,0,1,"PP",36
49,"49050",507,342,338,1,4,"PP",215
28,"28061",21389,16277,16135,67,142,"PP",6649
37,"37221",430,293,290,0,3,"PP",154
43,"43165",577,436,433,3,3,"PP",23
18,"18901",511,356,355,3,1,"PP",134
5,"5054",1224,935,924,8,11,"PP",371
45,"45125",2305,1865,1841,8,24,"PP",771
46,"46093",2118,1647,1624,4,23,"PP",657
45,"45059",1712,1337,1311,1,26,"PP",753
37,"37348",115,96,95,0,1,"PP",66
5,"5055",568,456,451,4,5,"PP",256
45,"45025",1205,831,827,2,4,"PP",301
43,"43043",3130,2053,2036,18,17,"PP",253
10,"10190",545,406,395,2,11,"PP",135
17,"17173",180,132,131,0,1,"PP",6
19,"19334",35,31,31,0,0,"PP",13
29,"29036",632,423,416,2,7,"PP",96
5,"5056",96,76,76,0,0,"PP",50
42,"42006",163,109,107,2,2,"PP",52
46,"46094",20540,15378,15234,102,144,"PP",4904
42,"42132",141,114,114,0,0,"PP",69
5,"5155",52,44,44,0,0,"PP",18
25,"25043",807,501,497,11,4,"PP",20
42,"42181",412,313,307,2,6,"PP",98
16,"16106",2727,2009,1989,12,20,"PP",907
19,"19110",56,50,50,0,0,"PP",32
10,"10191",527,405,397,2,8,"PP",157
41,"41021",21294,13762,13570,145,192,"PP",3049
25,"25905",375,249,246,3,3,"PP",40
10,"10054",547,431,421,1,10,"PP",158
24,"24134",3416,2470,2417,19,53,"PP",634
42,"42007",113,86,86,5,0,"PP",51
18,"18904",775,565,558,1,7,"PP",160
43,"43168",96,57,57,3,0,"PP",1
24,"24034",3394,2380,2342,28,38,"PP",640
34,"34066",59,49,48,0,1,"PP",31
28,"28162",2617,2029,2016,6,13,"PP",908
19,"19111",155,126,126,1,0,"PP",74
37,"37099",73,41,41,0,0,"PP",34
5,"5108",47,35,35,0,0,"PP",19
10,"10102",529,411,405,5,6,"PP",158
47,"47071",410,324,321,4,3,"PP",142
24,"24136",540,387,383,4,4,"PP",230
18,"18905",14618,9789,9682,110,107,"PP",2842
12,"12034",1424,1065,1035,3,30,"PP",352
37,"37226",155,123,123,2,0,"PP",95
47,"47128",60,52,51,0,1,"PP",45
17,"17058",177,101,100,3,1,"PP",10
38,"38009",4127,2915,2868,20,47,"PP",1085
42,"42139",23,15,15,1,0,"PP",10
45,"45129",131,92,92,0,0,"PP",40
30,"30022",16913,11371,11214,93,157,"PP",5343
37,"37228",360,297,295,2,2,"PP",141
5,"5060",116,95,95,0,0,"PP",71
28,"28065",126539,96997,96210,505,787,"PP",28270
15,"15036",57885,39471,39096,417,375,"PP",14349
43,"43089",292,190,186,0,4,"PP",17
34,"34217",1207,937,923,8,14,"PP",365
7,"7042",10666,6680,6613,64,67,"PP",2037
18,"18906",905,664,657,3,7,"PP",293
17,"17060",424,268,266,5,2,"PP",48
47,"47129",871,664,659,4,5,"PP",282
48,"48065",3281,2271,2237,8,34,"PP",135
5,"5061",252,186,184,3,2,"PP",58
12,"12036",581,426,421,10,5,"PP",199
9,"9021",56,33,31,1,2,"PP",14
37,"37186",104,85,85,2,0,"PP",53
37,"37054",250,195,192,1,3,"PP",86
7,"7044",8439,5681,5543,48,138,"PP",2544
17,"17061",156,104,103,1,1,"PP",11
18,"18907",1843,1393,1388,4,5,"PP",548
47,"47047",199,157,156,2,1,"PP",115
23,"23034",2540,1957,1934,14,23,"PP",603
9,"9417",40,32,32,1,0,"PP",28
17,"17062",5958,3463,3441,22,22,"PP",394
28,"28067",4063,3102,3079,3,23,"PP",1168
26,"26135",164,125,124,1,1,"PP",67
35,"35008",6131,4507,4459,34,48,"PP",1625
43,"43050",2505,1507,1496,12,11,"PP",262
43,"43173",100,53,51,0,2,"PP",2
34,"34233",130,107,107,1,0,"PP",78
45,"45031",2723,1835,1822,12,13,"PP",792
10,"10061",1628,1055,1035,8,20,"PP",348
40,"40148",238,188,187,2,1,"PP",98
18,"18909",579,435,429,0,6,"PP",172
7,"7046",15797,9127,9043,86,84,"PP",3087
42,"42013",34,28,27,0,1,"PP",13
37,"37232",390,341,339,1,2,"PP",206
17,"17063",162,111,109,0,2,"PP",5
9,"9419",78,55,55,0,0,"PP",45
17,"17182",263,181,181,6,0,"PP",37
24,"24040",449,329,325,2,4,"PP",133
46,"46099",901,689,684,1,5,"PP",227
43,"43052",938,628,621,12,7,"PP",53
19,"19117",1579,1135,1123,8,12,"PP",319
13,"13037",842,661,652,1,9,"PP",310
34,"34222",120,87,87,3,0,"PP",72
28,"28068",10955,8136,8076,49,60,"PP",3590
18,"18910",788,541,536,3,5,"PP",199
5,"5066",453,367,367,5,0,"PP",106
18,"18911",7473,5098,5035,51,63,"PP",1532
18,"18068",1569,1189,1166,6,23,"PP",456
47,"47132",45,36,33,1,3,"PP",27
46,"46022",15365,11093,10997,59,96,"PP",3446
43,"43053",191,144,143,3,1,"PP",9
43,"43176",785,523,520,4,3,"PP",35
37,"37234",345,247,247,1,0,"PP",131
9,"9421",230,166,163,3,3,"PP",78
47,"47050",3719,2630,2598,26,32,"PP",917
19,"19038",28,24,23,0,1,"PP",15
46,"46101",860,716,705,3,11,"PP",232
19,"19118",11,9,9,0,0,"PP",0
35,"35010",3558,2341,2301,28,40,"PP",640
42,"42015",30,20,19,1,1,"PP",15
43,"43177",299,231,230,6,1,"PP",21
5,"5069",73,64,63,0,1,"PP",50
28,"28138",60,46,46,0,0,"PP",22
28,"28070",117,91,91,0,0,"PP",48
18,"18912",1473,994,979,3,15,"PP",252
42,"42016",18,14,14,0,0,"PP",8
30,"30028",6649,4797,4726,21,71,"PP",1469
24,"24176",316,247,244,1,3,"PP",142
19,"19160",886,558,552,2,6,"PP",219
42,"42192",42,27,27,2,0,"PP",7
19,"19161",211,159,157,1,2,"PP",58
37,"37361",86,66,66,0,0,"PP",48
24,"24145",654,463,461,2,2,"PP",173
9,"9466",129,97,97,1,0,"PP",69
5,"5216",220,171,168,0,3,"PP",116
34,"34225",4921,3588,3559,30,29,"PP",1072
17,"17068",245,158,156,1,2,"PP",3
47,"47052",6576,4988,4944,40,44,"PP",1604
5,"5169",226,187,185,1,2,"PP",128
45,"45169",189,140,138,0,2,"PP",56
7,"7051",5215,3171,3134,39,37,"PP",1230
43,"43901",8737,4703,4639,62,64,"PP",549
17,"17186",3788,2554,2526,27,28,"PP",180
47,"47134",165,128,125,1,3,"PP",69
6,"6132",855,587,582,3,5,"PP",151
5,"5073",297,253,252,2,1,"PP",157
34,"34227",77,61,61,2,0,"PP",41
30,"30030",312993,231648,230185,1207,1463,"PP",109773
26,"26106",86,72,72,0,0,"PP",27
40,"40155",3518,2656,2605,18,51,"PP",875
17,"17069",374,256,251,0,5,"PP",43
42,"42019",516,363,356,3,7,"PP",162
19,"19122",96,68,68,1,0,"PP",30
10,"10069",838,626,615,2,11,"PP",235
40,"40028",105,91,90,2,1,"PP",53
46,"46182",1266,929,922,6,7,"PP",248
49,"49109",619,483,483,11,0,"PP",283
7,"7053",1188,926,918,16,8,"PP",359
40,"40156",322,238,235,1,3,"PP",129
17,"17070",111,76,76,2,0,"PP",2
20,"20011",1658,1219,1210,7,9,"PP",31
23,"23043",546,398,396,3,2,"PP",159
47,"47053",119,98,96,0,2,"PP",42
48,"48073",6910,4306,4271,31,35,"PP",183
42,"42154",97,69,69,1,0,"PP",25
40,"40157",47,44,44,0,0,"PP",21
49,"49187",1236,896,888,4,8,"PP",475
47,"47054",635,507,495,9,12,"PP",279
42,"42020",4263,2877,2821,35,56,"PP",1273
7,"7054",22334,12814,12708,99,106,"PP",4950
17,"17071",1134,778,774,10,4,"PP",41
46,"46105",16190,11323,11206,44,117,"PP",4111
45,"45039",224,192,190,0,2,"PP",102
34,"34129",179,130,129,1,1,"PP",95
19,"19166",156,120,119,1,1,"PP",56
40,"40158",17,12,12,0,0,"PP",10
5,"5904",127,88,87,1,1,"PP",51
49,"49069",367,258,254,5,4,"PP",162
42,"42156",28,16,16,1,0,"PP",8
37,"37242",91,74,73,0,1,"PP",37
5,"5077",158,140,139,1,1,"PP",76
5,"5222",147,127,126,1,1,"PP",80
46,"46184",26505,20428,20223,115,205,"PP",6196
19,"19124",386,260,257,0,3,"PP",106
45,"45140",1087,833,823,3,10,"PP",321
46,"46106",1535,1150,1140,10,10,"PP",463
24,"24150",243,172,172,6,0,"PP",91
42,"42157",13,10,10,0,0,"PP",9
37,"37367",201,164,161,0,3,"PP",115
12,"12046",191,151,150,2,1,"PP",50
30,"30034",1129,858,844,7,14,"PP",436
17,"17074",510,337,335,2,2,"PP",39
42,"42023",63,51,51,0,0,"PP",30
28,"28145",2431,1760,1736,6,24,"PP",577
25,"25021",2607,1490,1481,20,9,"PP",143
34,"34232",750,578,564,7,14,"PP",273
7,"7057",7169,4719,4659,47,60,"PP",2067
45,"45041",3752,2633,2597,12,36,"PP",1058
15,"15087",5769,3766,3722,42,44,"PP",1658
19,"19168",292,204,198,1,6,"PP",82
23,"23047",1629,1258,1250,10,8,"PP",372
7,"7058",2791,2060,2034,13,26,"PP",768
19,"19005",84,66,66,0,0,"PP",24
47,"47056",87,67,67,0,0,"PP",46
37,"37244",131,98,98,0,0,"PP",58
46,"46107",1900,1516,1504,5,12,"PP",558
5,"5081",40,36,36,1,0,"PP",26
23,"23060",19003,12924,12812,102,112,"PP",4195
46,"46212",1620,1150,1124,9,26,"PP",379
23,"23087",11292,8222,8084,59,138,"PP",2654
40,"40203",899,722,715,4,7,"PP",270
10,"10077",677,479,472,1,7,"PP",183
46,"46108",469,378,375,1,3,"PP",162
37,"37245",346,261,259,2,2,"PP",130
17,"17076",124,86,84,3,2,"PP",7
12,"12050",1305,1015,1000,6,15,"PP",367
17,"17077",548,369,368,1,1,"PP",33
5,"5082",529,432,422,1,10,"PP",251
42,"42160",254,206,205,0,1,"PP",80
5,"5228",174,121,120,0,1,"PP",105
23,"23049",1813,1238,1222,9,16,"PP",255
19,"19006",769,547,540,2,7,"PP",205
48,"48911",380,276,272,1,4,"PP",2
42,"42026",24,20,20,0,0,"PP",10
47,"47085",16612,11829,11706,114,123,"PP",4897
47,"47167",241,204,204,1,0,"PP",103
52,"52001",53306,27373,27012,267,361,"PP",13478
17,"17195",329,237,234,0,3,"PP",8
5,"5083",140,110,105,1,5,"PP",67
36,"36050",7561,5280,5188,25,92,"PP",1829
32,"32069",4308,3221,3164,27,57,"PP",1247
40,"40036",515,421,410,3,11,"PP",264
9,"9433",60,48,45,1,3,"PP",22
40,"40079",234,179,179,3,0,"PP",85
12,"12085",4976,3236,3209,16,27,"PP",1257
10,"10080",366,257,255,1,2,"PP",111
5,"5084",74,53,53,0,0,"PP",34
7,"7062",7513,4273,4219,52,54,"PP",1365
10,"10081",182,142,135,2,7,"PP",70
36,"36051",14267,9638,9493,71,145,"PP",4421
19,"19008",37,28,27,1,1,"PP",8
34,"34238",330,268,266,3,2,"PP",111
37,"37249",43,29,29,0,0,"PP",17
42,"42028",75,51,51,0,0,"PP",19
17,"17197",132,102,101,1,1,"PP",6
10,"10082",1868,1451,1412,11,39,"PP",508
47,"47143",118,91,90,0,1,"PP",65
26,"26012",23,23,23,1,0,"PP",16
7,"7063",1418,1043,1033,6,10,"PP",453
24,"24156",239,159,158,1,1,"PP",92
16,"16088",108,88,87,0,1,"PP",33
32,"32026",2704,1929,1896,22,33,"PP",810
5,"5086",80,67,67,2,0,"PP",53
19,"19009",259,200,195,6,5,"PP",86
9,"9437",282,219,218,3,1,"PP",115
19,"19133",83,72,72,0,0,"PP",26
37,"37250",356,229,228,0,1,"PP",105
5,"5087",134,87,85,1,2,"PP",61
42,"42069",1536,1036,1019,6,17,"PP",427
30,"30039",19277,13165,13054,75,111,"PP",6324
12,"12053",2034,1655,1633,6,22,"PP",645
23,"23053",9531,6704,6658,37,46,"PP",1170
32,"32028",1610,1211,1189,16,22,"PP",857
26,"26014",474,327,324,1,3,"PP",130
9,"9438",538,437,433,6,4,"PP",193
42,"42030",94,78,78,1,0,"PP",58
19,"19134",24,15,15,0,0,"PP",5
24,"24157",2568,1943,1911,22,32,"PP",879
9,"9903",3221,2304,2281,27,23,"PP",1011
7,"7025",472,355,351,1,4,"PP",168
5,"5089",485,384,376,0,8,"PP",196
30,"30040",732,617,607,2,10,"PP",302
34,"34242",95,71,68,3,3,"PP",39
29,"29059",2587,1965,1922,14,43,"PP",341
47,"47144",78,64,64,1,0,"PP",42
19,"19011",250,184,184,0,0,"PP",66
45,"45149",556,446,440,0,6,"PP",232
42,"42166",59,45,45,0,0,"PP",30
37,"37377",241,201,199,1,2,"PP",125
5,"5090",77,68,68,1,0,"PP",38
49,"49083",52,44,44,2,0,"PP",32
13,"13062",574,453,448,3,5,"PP",197
43,"43072",105,74,72,0,2,"PP",15
37,"37378",111,77,75,2,2,"PP",41
27,"27064",1581,1097,1068,12,29,"PP",640
28,"28153",697,499,499,1,0,"PP",113
10,"10010",2290,1362,1341,7,21,"PP",475
37,"37254",181,142,141,0,1,"PP",79
9,"9440",91,78,78,2,0,"PP",35
49,"49203",313,240,232,0,8,"PP",133
42,"42033",48,45,45,1,0,"PP",37
42,"42032",146,118,118,0,0,"PP",82
5,"5237",162,130,124,2,6,"PP",100
25,"25033",1096,729,723,4,6,"PP",47
37,"37379",174,133,131,1,2,"PP",62
26,"26017",381,293,293,5,0,"PP",79
10,"10088",204,131,128,1,3,"PP",68
25,"25034",2326,1361,1340,15,21,"PP",155
19,"19138",255,202,201,2,1,"PP",70
40,"40172",39,34,34,0,0,"PP",20
5,"5093",408,294,292,1,2,"PP",169
19,"19016",65,49,49,0,0,"PP",17
46,"46114",569,461,458,1,3,"PP",208
5,"5094",139,116,116,1,0,"PP",94
16,"16249",1995,1519,1499,6,20,"PP",662
37,"37255",49,34,34,1,0,"PP",24
17,"17203",153,99,99,0,0,"PP",4
19,"19139",29,19,18,0,1,"PP",8
16,"16096",274,232,229,1,3,"PP",93
26,"26121",25,22,22,0,0,"PP",11
19,"19017",69,57,57,0,0,"PP",30
37,"37381",147,114,107,2,7,"PP",62
43,"43076",439,300,299,0,1,"PP",8
17,"17086",1729,1068,1059,8,9,"PP",201
17,"17128",308,205,203,3,2,"PP",16
5,"5240",3374,2283,2257,7,26,"PP",1163
12,"12059",231,189,188,2,1,"PP",71
30,"30901",10309,7821,7718,43,103,"PP",3552
37,"37257",52,46,46,0,0,"PP",30
19,"19057",76,59,59,1,0,"PP",12
42,"42215",773,531,520,7,11,"PP",265
15,"15062",5887,3747,3701,36,46,"PP",1934
42,"42036",50,41,41,1,0,"PP",9
13,"13068",1061,747,740,4,7,"PP",324
5,"5096",80,60,59,0,1,"PP",20
46,"46194",15567,11156,11044,86,112,"PP",3629
37,"37382",173,137,137,0,0,"PP",82
19,"19115",24,18,18,0,0,"PP",11
24,"24162",1683,1257,1246,13,11,"PP",439
19,"19143",1738,1306,1297,12,9,"PP",584
25,"25037",375,247,246,5,1,"PP",40
41,"41048",2228,1470,1447,15,23,"PP",395
30,"30902",7975,5318,5273,24,45,"PP",2341
38,"38001",20228,11032,10936,47,96,"PP",3323
40,"40049",49,43,43,0,0,"PP",26
36,"36061",8606,6232,6133,41,99,"PP",3360
49,"49128",552,423,414,3,9,"PP",212
49,"49090",197,143,141,6,2,"PP",77
42,"42173",29281,20286,20035,261,251,"PP",7369
37,"37259",44,28,28,0,0,"PP",19
24,"24163",3962,2950,2933,24,17,"PP",1186
17,"17089",5543,3349,3326,22,23,"PP",281
19,"19020",44,30,30,1,0,"PP",20
42,"42038",36,28,28,1,0,"PP",23
17,"17132",1298,884,877,12,7,"PP",84
34,"34154",74,55,53,1,2,"PP",34
34,"34012",357,269,264,5,5,"PP",134
43,"43080",239,183,181,0,2,"PP",17
37,"37344",241,175,174,2,1,"PP",88
19,"19183",74,65,65,0,0,"PP",21
47,"47067",174,127,126,0,1,"PP",91
23,"23063",3829,2560,2522,21,38,"PP",741
17,"17090",545,370,368,4,2,"PP",23
37,"37261",221,163,160,1,3,"PP",100
9,"9447",44,41,41,0,0,"PP",21
24,"24165",354,240,238,2,2,"PP",138
5,"5102",1780,1339,1317,3,22,"PP",720
48,"48090",6001,4345,4295,28,50,"PP",327
43,"43081",593,400,395,3,5,"PP",26
47,"47068",34,26,26,0,0,"PP",17
10,"10187",438,308,305,1,3,"PP",88
40,"40180",299,246,241,1,5,"PP",142
35,"35002",23328,15495,15313,94,182,"PP",4942
16,"16259",29,22,21,0,1,"PP",13
34,"34106",109,89,86,2,3,"PP",58
17,"17209",630,443,438,7,5,"PP",25
5,"5103",72,52,52,0,0,"PP",32
9,"9448",212,169,165,0,4,"PP",119
37,"37263",342,237,229,0,8,"PP",115
46,"46197",1942,1527,1514,5,13,"PP",350
10,"10098",378,289,287,1,2,"PP",134
24,"24166",1407,1013,993,8,20,"PP",448
47,"47152",78,60,60,0,0,"PP",16
12,"12097",63,49,49,0,0,"PP",22
5,"5249",105,84,82,0,2,"PP",21
37,"37264",65,40,40,0,0,"PP",25
35,"35003",5211,2949,2908,13,41,"PP",1024
46,"46120",1113,903,875,2,28,"PP",315
10,"10099",583,378,374,2,4,"PP",131
5,"5105",341,249,247,7,2,"PP",93
17,"17093",891,563,560,6,3,"PP",57
17,"17094",1059,602,600,4,2,"PP",74
28,"28160",8256,6102,6059,31,43,"PP",2562
46,"46042",3380,2799,2755,20,44,"PP",1151
19,"19024",8196,5613,5563,28,50,"PP",1817
37,"37349",117,88,88,0,0,"PP",61
37,"37046",11225,7824,7697,53,127,"PP",3434
28,"28101",231,187,187,0,0,"PP",67
24,"24202",8008,5367,5276,53,91,"PP",1417
42,"42086",36,27,26,2,1,"PP",16
37,"37307",159,104,103,1,1,"PP",72
45,"45160",1109,874,864,6,10,"PP",452
13,"13027",3415,2380,2354,4,26,"PP",1047
38,"38008",5520,3825,3766,17,59,"PP",1448
5,"5107",62,39,39,0,0,"PP",31
24,"24168",460,361,359,0,2,"PP",168
5,"5253",86,70,68,0,2,"PP",39
42,"42045",301,206,197,2,9,"PP",108
19,"19188",51,35,35,0,0,"PP",21
28,"28102",894,644,636,6,8,"PP",204
25,"25087",60,43,43,0,0,"PP",0
37,"37267",200,156,147,2,9,"PP",56
13,"13046",724,529,525,1,4,"PP",227
36,"36032",3630,2587,2535,16,52,"PP",1200
34,"34067",127,93,93,1,0,"PP",45
37,"37007",437,314,306,3,8,"PP",152
47,"47154",152,128,125,1,3,"PP",60
5,"5254",190,160,159,0,1,"PP",88
5,"5109",450,352,339,4,13,"PP",183
32,"32047",1784,1255,1244,9,11,"PP",824
46,"46200",1903,1561,1539,3,22,"PP",541
14,"14073",2891,2079,2016,13,63,"PP",521
10,"10011",560,458,448,5,10,"PP",131
17,"17214",705,423,419,2,4,"PP",39
26,"26131",35,33,33,1,0,"PP",22
19,"19032",165,126,124,1,2,"PP",51
23,"23070",3914,2433,2407,14,26,"PP",1019
37,"37268",112,76,76,0,0,"PP",54
24,"24069",41,35,35,0,0,"PP",30
38,"38047",1777,1198,1170,4,28,"PP",454
11,"11012",99886,70290,69673,693,617,"PP",22985
17,"17215",2087,1481,1466,7,15,"PP",103
38,"38010",4008,2733,2661,19,72,"PP",960
19,"19154",68,56,54,0,2,"PP",45
13,"13032",1137,841,835,2,6,"PP",357
5,"5160",323,256,253,2,3,"PP",185
28,"28164",2993,2183,2168,8,15,"PP",952
42,"42185",26,22,22,0,0,"PP",13
29,"29007",27491,19071,18910,153,161,"PP",6656
26,"26134",82,68,68,2,0,"PP",39
38,"38048",3901,2667,2637,20,30,"PP",884
5,"5161",579,459,447,3,12,"PP",260
47,"47156",162,136,133,0,3,"PP",76
17,"17099",81,57,57,1,0,"PP",13
5,"5113",71,56,56,0,0,"PP",40
46,"46202",16947,12814,12710,79,104,"PP",4315
25,"25048",1651,1051,1040,11,11,"PP",122
32,"32050",2433,1829,1814,12,15,"PP",1156
35,"35033",6398,4340,4266,19,74,"PP",1684
46,"46124",787,653,642,4,11,"PP",243
13,"13034",58191,42423,42027,291,396,"PP",19605
42,"42142",50,35,35,1,0,"PP",22
42,"42200",81,59,58,2,1,"PP",40
43,"43024",1537,993,983,8,10,"PP",169
42,"42051",20,14,14,1,0,"PP",12
37,"37272",141,107,104,0,3,"PP",59
9,"9458",469,343,336,5,7,"PP",96
17,"17218",582,404,401,1,3,"PP",24
47,"47157",515,424,423,1,1,"PP",184
12,"12073",152,119,117,0,2,"PP",50
25,"25050",3233,1936,1912,25,24,"PP",190
19,"19156",970,704,699,4,5,"PP",363
10,"10062",406,337,331,0,6,"PP",63
21,"21061",5084,3223,3177,28,46,"PP",1035
38,"38014",1357,935,926,3,9,"PP",329
46,"46047",532,446,437,2,9,"PP",134
37,"37104",27,22,22,0,0,"PP",10
24,"24173",951,679,674,9,5,"PP",369
37,"37203",158,117,117,0,0,"PP",55
28,"28166",320,254,251,2,3,"PP",89
9,"9463",264,195,195,7,0,"PP",90
5,"5262",357,276,276,1,0,"PP",123
23,"23075",3298,2564,2541,18,23,"PP",856
46,"46126",5556,4449,4405,24,44,"PP",1318
19,"19159",93,78,77,0,1,"PP",51
37,"37274",118913,85506,84764,566,742,"PP",39627
43,"43094",2143,1395,1375,13,20,"PP",127
24,"24211",272,205,205,2,0,"PP",110
12,"12005",8062,5829,5754,64,75,"PP",1937
28,"28109",1576,1103,1098,1,5,"PP",561
37,"37317",304,238,234,1,4,"PP",140
42,"42191",185,136,133,0,3,"PP",58
29,"29100",2433,1684,1667,5,17,"PP",412
40,"40065",493,373,373,3,0,"PP",189
5,"5118",79,53,53,0,0,"PP",34
43,"43054",2812,1755,1739,16,16,"PP",143
5,"5264",61,38,37,2,1,"PP",22
46,"46127",2692,2120,2091,18,29,"PP",737
38,"38016",1223,638,623,3,15,"PP",200
16,"16117",1040,787,777,4,10,"PP",313
9,"9464",35,27,27,0,0,"PP",21
37,"37016",569,406,401,2,5,"PP",189
36,"36004",10161,6939,6844,63,95,"PP",2762
37,"37319",114,78,74,0,4,"PP",33
40,"40110",349,265,263,3,2,"PP",121
16,"16218",191,150,150,3,0,"PP",65
46,"46076",575,454,443,0,11,"PP",209
5,"5265",82,66,66,1,0,"PP",43
9,"9066",62,48,47,0,1,"PP",17
29,"29013",1610,1238,1207,9,31,"PP",268
41,"41063",2695,1850,1830,13,20,"PP",307
40,"40069",83,66,63,0,3,"PP",46
5,"5266",100,86,86,0,0,"PP",69
46,"46128",1597,1290,1250,5,40,"PP",481
36,"36041",13434,9297,9181,66,116,"PP",3992
19,"19233",80,65,63,1,2,"PP",24
25,"25055",169,105,104,4,1,"PP",11
24,"24177",476,325,322,3,3,"PP",188
47,"47079",58,48,47,0,1,"PP",36
17,"17224",314,190,188,2,2,"PP",18
49,"49185",157,123,122,2,1,"PP",64
38,"38019",13200,8123,8047,36,76,"PP",2731
20,"20043",1739,1090,1088,9,2,"PP",43
12,"12077",4605,3439,3382,15,57,"PP",1139
23,"23080",1762,1332,1322,4,10,"PP",400
24,"24178",70,59,58,0,1,"PP",39
13,"13044",2671,1960,1936,13,24,"PP",870
48,"48906",766,547,544,0,3,"PP",17
12,"12078",325,235,233,0,2,"PP",119
23,"23081",1513,1103,1084,10,19,"PP",265
19,"19041",163,129,129,3,0,"PP",26
17,"17109",696,422,419,1,3,"PP",21
37,"37363",118,88,87,0,1,"PP",36
25,"25057",208,141,140,0,1,"PP",30
13,"13045",674,508,499,1,9,"PP",260
20,"20044",367,236,236,0,0,"PP",6
47,"47080",30,22,21,0,1,"PP",15
28,"28082",5683,4324,4286,25,38,"PP",1442
19,"19042",25,24,24,0,0,"PP",8
48,"48907",348,266,266,2,0,"PP",6
40,"40072",211,162,159,1,3,"PP",50
18,"18003",14022,9938,9820,80,118,"PP",3252
45,"45072",671,484,483,2,1,"PP",221
17,"17226",867,549,546,8,3,"PP",118
43,"43060",2860,1950,1926,12,24,"PP",176
37,"37281",36,33,31,0,2,"PP",16
10,"10118",286,251,249,1,2,"PP",97
24,"24179",290,197,192,4,5,"PP",75
17,"17111",880,590,586,7,4,"PP",34
43,"43142",1100,698,688,5,10,"PP",55
37,"37365",172,134,133,1,1,"PP",85
46,"46053",553,445,436,2,9,"PP",105
6,"6090",869,617,602,3,15,"PP",228
38,"38022",18450,12334,12160,62,174,"PP",5442
26,"26039",39,35,35,2,0,"PP",19
5,"5126",70,56,55,0,1,"PP",45
37,"37282",204,149,148,1,1,"PP",77
43,"43021",357,232,231,6,1,"PP",13
17,"17228",288,179,176,1,3,"PP",9
19,"19044",304,245,244,0,1,"PP",153
23,"23085",2252,1655,1644,6,11,"PP",414
42,"42060",38,21,19,1,2,"PP",15
37,"37158",246,183,183,0,0,"PP",76
10,"10120",171,121,117,1,4,"PP",64
9,"9476",62,43,43,0,0,"PP",19
47,"47082",812,640,628,8,12,"PP",369
19,"19045",140,120,120,0,0,"PP",90
5,"5127",643,519,514,3,5,"PP",258
28,"28084",15859,11156,11058,64,98,"PP",3359
42,"42061",291,214,213,3,1,"PP",93
24,"24218",451,330,325,2,5,"PP",152
15,"15012",3627,2659,2602,28,57,"PP",1413
5,"5128",354,281,271,2,10,"PP",85
42,"42062",22,12,12,0,0,"PP",4
49,"49075",137,120,119,0,1,"PP",72
49,"49206",840,614,604,9,10,"PP",313
26,"26041",132,92,91,0,1,"PP",65
12,"12082",9617,7324,7231,46,93,"PP",2945
5,"5129",125,88,87,2,1,"PP",76
42,"42201",22,22,21,0,1,"PP",12
25,"25062",750,486,482,1,4,"PP",50
49,"49114",43,34,33,0,1,"PP",13
10,"10137",397,320,317,3,3,"PP",131
13,"13069",660,508,499,7,9,"PP",200
12,"12014",184,144,143,2,1,"PP",59
18,"18175",11670,8200,8097,36,103,"PP",2690
10,"10122",218,156,153,3,3,"PP",61
12,"12083",93,79,76,0,3,"PP",31
17,"17233",2260,1528,1514,23,14,"PP",103
23,"23088",6089,4558,4472,34,86,"PP",965
16,"16130",571,450,448,1,2,"PP",171
16,"16035",261,203,198,4,5,"PP",63
42,"42063",49,35,35,0,0,"PP",19
17,"17116",354,228,224,3,4,"PP",11
47,"47084",1150,887,870,7,17,"PP",421
24,"24183",805,555,549,6,6,"PP",241
19,"19047",64,55,55,0,0,"PP",20
37,"37286",207,152,145,4,7,"PP",46
19,"19060",146,119,118,1,1,"PP",22
24,"24086",270,223,218,0,5,"PP",143
47,"47141",134,111,110,0,1,"PP",84
21,"21034",1188,798,786,8,12,"PP",231
42,"42204",54,38,38,1,0,"PP",17
17,"17117",14353,8469,8426,49,43,"PP",984
42,"42065",21,18,18,0,0,"PP",8
38,"38027",5414,3618,3571,16,47,"PP",1412
37,"37331",212,137,135,0,2,"PP",95
42,"42113",534,409,399,1,10,"PP",235
47,"47168",29,26,26,1,0,"PP",19
5,"5229",82,68,67,0,1,"PP",45
42,"42161",137,102,101,0,1,"PP",68
49,"49240",206,162,161,2,1,"PP",96
47,"47086",3906,2970,2936,24,34,"PP",1279
17,"17118",12711,7567,7515,42,52,"PP",775
42,"42068",82,63,60,1,3,"PP",34
17,"17001",587,404,398,2,6,"PP",17
9,"9485",55,43,42,0,1,"PP",35
47,"47007",3769,2765,2736,24,29,"PP",902
42,"42205",89,71,71,2,0,"PP",35
6,"6144",556,431,425,0,6,"PP",124
10,"10127",4703,3183,3132,21,51,"PP",1129
37,"37029",209,137,135,1,2,"PP",59
9,"9901",371,263,259,4,4,"PP",139
38,"38029",1517,744,734,1,10,"PP",294
17,"17119",74,54,54,0,0,"PP",0
32,"32071",1476,1010,1005,3,5,"PP",575
43,"43110",259,175,175,6,0,"PP",16
17,"17903",897,568,563,2,5,"PP",39
46,"46137",270,210,207,4,3,"PP",88
37,"37290",141,113,113,0,0,"PP",53
17,"17120",786,517,512,8,5,"PP",48
5,"5135",425,317,315,5,2,"PP",198
42,"42070",34,27,26,1,1,"PP",8
28,"28089",3677,2748,2730,10,18,"PP",1187
18,"18043",123,80,79,1,1,"PP",35
19,"19096",91,72,69,0,3,"PP",33
38,"38030",1933,1296,1290,2,6,"PP",339
43,"43112",279,175,174,0,1,"PP",5
37,"37291",272,207,206,0,1,"PP",96
17,"17121",224,140,140,1,0,"PP",7
5,"5136",96,61,60,3,1,"PP",30
48,"48915",362,227,226,0,1,"PP",4
28,"28090",8505,6654,6609,33,45,"PP",2674
46,"46138",343,275,272,1,3,"PP",114
43,"43153",10688,6675,6615,39,60,"PP",991
46,"46216",5053,4109,4090,14,19,"PP",1663
23,"23095",8735,6347,6310,14,37,"PP",2634
47,"47088",103,86,85,1,1,"PP",54
45,"45183",2220,1444,1428,3,16,"PP",551
49,"49002",63,51,49,0,2,"PP",23
6,"6011",24723,16883,16718,137,165,"PP",7761
17,"17123",354,266,263,0,3,"PP",11
19,"19098",19,17,17,0,0,"PP",5
34,"34140",107,67,67,0,0,"PP",40
37,"37293",115,84,84,1,0,"PP",48
5,"5139",74,65,65,0,0,"PP",50
24,"24190",165,123,121,1,2,"PP",75
10,"10132",396,278,275,0,3,"PP",84
36,"36019",1625,1042,1029,9,13,"PP",368
19,"19013",125,108,108,1,0,"PP",30
32,"32030",999,736,726,3,10,"PP",250
42,"42073",75,58,58,0,0,"PP",27
12,"12100",1333,1065,1047,10,18,"PP",437
37,"37225",103,89,86,0,3,"PP",50
28,"28092",151841,110916,109954,582,962,"PP",36419
35,"35022",48603,29443,29042,160,401,"PP",9295
37,"37170",1449,994,971,3,23,"PP",542
10,"10133",1206,956,945,5,11,"PP",146
6,"6013",265,212,209,3,3,"PP",32
25,"25073",582,328,324,8,4,"PP",16
47,"47172",144,124,122,0,2,"PP",54
45,"45185",7700,5771,5691,20,80,"PP",2178
5,"5141",94,80,80,1,0,"PP",43
42,"42076",216,179,174,5,5,"PP",83
26,"26050",113,88,85,0,3,"PP",49
42,"42212",69,43,43,1,0,"PP",25
6,"6014",6682,4479,4409,14,70,"PP",2202
47,"47090",2418,1728,1699,8,29,"PP",790
28,"28093",2096,1670,1653,10,17,"PP",820
46,"46062",4631,3511,3474,27,37,"PP",1402
10,"10134",567,401,396,2,5,"PP",221
6,"6015",116758,77960,77205,583,755,"PP",35531
5,"5143",66,51,49,0,2,"PP",29
45,"45085",1500,1011,999,4,12,"PP",548
38,"38035",9474,5616,5564,36,52,"PP",1947
12,"12092",111,91,90,0,1,"PP",52
5,"5191",121,106,105,1,1,"PP",39
6,"6016",2986,2114,2078,14,36,"PP",722
37,"37172",888,572,566,3,6,"PP",335
42,"42078",1020,717,703,7,14,"PP",362
20,"20058",755,529,525,3,4,"PP",43
29,"29029",403,298,294,2,4,"PP",132
45,"45187",4062,3277,3233,15,44,"PP",1343
47,"47091",84,71,71,2,0,"PP",29
9,"9907",1420,1058,1041,12,17,"PP",363
28,"28094",865,624,622,4,2,"PP",222
28,"28106",76907,52773,52265,385,508,"PP",13982
11,"11003",1261,836,822,7,14,"PP",295
7,"7031",23833,14836,14707,124,129,"PP",5362
6,"6017",272,222,221,1,1,"PP",133
17,"17048",6241,3831,3801,36,30,"PP",552
5,"5145",50,40,40,0,0,"PP",24
42,"42080",157,117,115,0,2,"PP",71
17,"17217",354,265,263,2,2,"PP",14
25,"25910",100,63,61,2,2,"PP",1
37,"37300",566,398,395,0,3,"PP",169
19,"19288",21,21,20,0,1,"PP",11
9,"9908",449,307,306,3,1,"PP",142
49,"49044",80,60,58,0,2,"PP",26
19,"19059",77,61,58,1,3,"PP",34
19,"19105",2334,1753,1739,8,14,"PP",668
40,"40091",119,97,95,1,2,"PP",55
6,"6156",1175,869,865,8,4,"PP",342
42,"42217",31,25,24,0,1,"PP",6
23,"23024",12435,9058,8833,55,225,"PP",3206
37,"37039",301,217,213,0,4,"PP",112
16,"16007",1177,888,880,7,8,"PP",482
28,"28902",471,363,356,4,7,"PP",165
47,"47175",6564,4781,4728,39,53,"PP",1590
37,"37072",168,140,138,0,2,"PP",102
12,"12095",959,749,742,8,7,"PP",259
10,"10002",364,272,270,0,2,"PP",99
49,"49009",393,293,288,2,5,"PP",180
43,"43039",99,66,66,0,0,"PP",6
10,"10185",571,409,405,2,4,"PP",175
29,"29065",187,137,136,0,1,"PP",69
39,"39018",4220,3264,3204,35,60,"PP",846
23,"23903",3540,2662,2634,13,28,"PP",889
7,"7034",1008,743,734,7,9,"PP",277
17,"17051",218,145,142,1,3,"PP",11
17,"17133",1255,805,796,9,9,"PP",33
40,"40093",77,65,65,1,0,"PP",34
35,"35027",10344,7310,7216,50,94,"PP",2922
12,"12096",777,587,577,6,10,"PP",188
42,"42083",26,20,20,0,0,"PP",13
28,"28097",119,94,94,0,0,"PP",23
10,"10141",263,194,194,0,0,"PP",101
10,"10142",832,627,621,5,6,"PP",192
47,"47095",38,31,31,0,0,"PP",22
24,"24097",218,140,139,3,1,"PP",70
17,"17208",995,594,590,8,4,"PP",41
12,"12127",75,55,55,0,0,"PP",17
47,"47124",392,316,311,3,5,"PP",146
13,"13075",211,164,161,1,3,"PP",97
38,"38041",6821,4908,4861,40,47,"PP",1525
6,"6023",4302,3041,3007,16,34,"PP",1018
34,"34156",50,45,45,0,0,"PP",36
49,"49131",264,194,192,6,2,"PP",104
19,"19064",70,64,64,2,0,"PP",39
37,"37305",216,171,170,0,1,"PP",88
28,"28099",1748,1290,1283,7,7,"PP",650
9,"9094",53,42,42,1,0,"PP",22
9,"9227",119,91,89,4,2,"PP",32
5,"5199",40,32,31,0,1,"PP",26
26,"26164",59,46,45,2,1,"PP",16
19,"19065",127,104,104,3,0,"PP",42
17,"17135",362,253,253,1,0,"PP",34
28,"28100",4196,2987,2955,14,32,"PP",1109
46,"46224",159,121,121,0,0,"PP",52
42,"42085",189,129,127,3,2,"PP",91
24,"24201",1090,762,759,10,3,"PP",325
12,"12098",580,451,447,5,4,"PP",210
37,"37306",259,186,183,1,3,"PP",110
34,"34019",125,107,105,0,2,"PP",59
24,"24133",356,257,257,1,0,"PP",142
19,"19066",55,48,48,0,0,"PP",31
13,"13026",438,345,343,2,2,"PP",112
37,"37223",110,85,83,0,2,"PP",49
49,"49013",246,182,181,2,1,"PP",93
13,"13078",9041,6325,6266,47,59,"PP",2806
38,"38007",1661,1114,1103,6,11,"PP",443
23,"23029",843,628,624,2,4,"PP",295
47,"47097",325,266,265,0,1,"PP",109
18,"18016",307,235,233,0,2,"PP",80
5,"5156",256,160,159,1,1,"PP",78
12,"12099",539,416,403,7,13,"PP",193
40,"40099",52,44,42,0,2,"PP",25
25,"25005",279,175,175,4,0,"PP",18
19,"19187",48,43,43,0,0,"PP",21
45,"45127",696,514,511,3,3,"PP",280
46,"46173",1328,1069,1057,4,12,"PP",374
47,"47180",73,61,60,4,1,"PP",29
43,"43086",5249,3271,3244,37,27,"PP",234
25,"25102",707,420,407,6,13,"PP",54
45,"45005",238,193,192,3,1,"PP",91
35,"35031",7259,5037,4942,29,95,"PP",2177
46,"46235",21579,15929,15763,113,166,"PP",4518
47,"47098",576,464,452,4,12,"PP",227
40,"40101",877,635,628,8,7,"PP",191
37,"37310",178,123,123,1,0,"PP",49
37,"37183",414,306,304,0,2,"PP",146
13,"13081",636,480,472,9,8,"PP",188
25,"25088",96,73,72,0,1,"PP",3
34,"34068",27,22,22,0,0,"PP",15
17,"17177",549,332,331,1,1,"PP",31
16,"16016",224,171,168,0,3,"PP",96
18,"18018",634,472,468,5,4,"PP",148
45,"45096",1004,807,799,1,8,"PP",320
19,"19189",120,91,90,2,1,"PP",41
19,"19071",7840,5537,5489,45,48,"PP",2128
5,"5159",252,165,164,0,1,"PP",134
19,"19113",485,366,366,3,0,"PP",143
47,"47181",165,135,132,3,3,"PP",52
42,"42089",54,44,44,0,0,"PP",24
37,"37052",273,209,209,2,0,"PP",105
24,"24005",378,260,257,2,3,"PP",159
18,"18157",1121,815,803,3,12,"PP",294
41,"41024",22600,14263,14048,128,215,"PP",4070
45,"45097",1046,839,834,4,5,"PP",397
17,"17178",1059,654,650,7,4,"PP",50
10,"10013",276,207,200,0,7,"PP",100
24,"24037",360,254,250,2,4,"PP",142
19,"19190",2369,1760,1745,10,15,"PP",664
13,"13084",892,701,685,6,16,"PP",315
10,"10059",364,253,248,1,5,"PP",98
47,"47100",138,117,117,1,0,"PP",64
43,"43131",4647,2934,2916,21,18,"PP",557
46,"46211",1745,1387,1378,8,9,"PP",529
5,"5162",86,66,63,0,3,"PP",26
17,"17142",2550,1806,1797,30,9,"PP",177
29,"29097",4108,2871,2821,37,50,"PP",675
47,"47130",96,72,72,0,0,"PP",35
28,"28038",4952,3730,3688,34,42,"PP",1345
38,"38012",2347,1644,1630,7,14,"PP",495
12,"12113",83,67,66,3,1,"PP",36
30,"30004",1137,870,862,3,8,"PP",417
5,"5226",76,55,54,3,1,"PP",46
17,"17193",4216,2555,2525,16,30,"PP",282
28,"28165",1794,1293,1285,3,8,"PP",672
6,"6034",171,121,120,4,1,"PP",58
46,"46151",728,550,541,0,9,"PP",158
10,"10016",330,237,235,0,2,"PP",68
5,"5163",1737,1347,1340,4,7,"PP",709
24,"24209",2769,1888,1865,12,23,"PP",825
37,"37315",96,70,70,0,0,"PP",52
40,"40233",417,314,310,3,4,"PP",140
40,"40149",514,375,369,5,6,"PP",211
29,"29009",1468,1069,1045,8,24,"PP",181
49,"49179",371,238,237,0,1,"PP",152
43,"43148",90275,59182,58757,388,425,"PP",10874
40,"40177",153,125,125,1,0,"PP",73
37,"37246",5304,3993,3949,26,44,"PP",1802
17,"17036",2717,1730,1716,15,14,"PP",129
17,"17144",206,141,141,3,0,"PP",13
38,"38051",7194,5158,5080,31,78,"PP",2353
19,"19076",27,19,19,0,0,"PP",16
46,"46178",4637,3405,3381,27,24,"PP",1245
20,"20072",4728,2902,2886,21,16,"PP",250
47,"47185",99,73,71,0,2,"PP",33
37,"37057",215,172,171,1,1,"PP",121
49,"49180",148,103,102,2,1,"PP",49
29,"29044",809,561,561,3,0,"PP",240
46,"46204",6681,5256,5202,32,54,"PP",1548
37,"37359",184,130,129,0,1,"PP",92
7,"7007",421,296,293,2,3,"PP",101
37,"37108",99,79,78,0,1,"PP",41
6,"6082",383,287,286,2,1,"PP",93
46,"46023",327,280,278,2,2,"PP",104
10,"10111",1325,970,949,2,21,"PP",396
19,"19078",50,44,43,0,1,"PP",5
40,"40109",73,59,59,1,0,"PP",39
42,"42096",272,171,170,6,1,"PP",101
5,"5215",164,123,122,2,1,"PP",74
43,"43055",1975,1384,1379,21,5,"PP",88
37,"37318",208,159,158,1,1,"PP",92
17,"17185",2265,1420,1404,15,16,"PP",75
10,"10020",1604,1185,1169,9,16,"PP",453
19,"19119",82,72,71,1,1,"PP",33
42,"42149",381,277,273,2,4,"PP",116
43,"43137",1868,1254,1242,11,12,"PP",134
45,"45035",281,212,209,1,3,"PP",73
18,"18071",5579,4044,3985,37,59,"PP",1067
19,"19267",19,13,13,0,0,"PP",8
47,"47160",425,308,303,0,5,"PP",162
6,"6039",1840,1469,1437,9,32,"PP",386
25,"25228",3035,1933,1921,26,12,"PP",214
47,"47025",120,94,94,1,0,"PP",52
34,"34174",200,159,154,5,5,"PP",109
38,"38018",4402,3058,3011,16,47,"PP",1173
26,"26176",53,44,44,1,0,"PP",35
43,"43057",38,25,25,1,0,"PP",1
28,"28111",596,467,467,3,0,"PP",191
23,"23001",963,801,799,1,2,"PP",335
20,"20076",6990,4666,4648,29,18,"PP",340
6,"6131",1076,843,837,2,6,"PP",172
5,"5170",50,43,43,0,0,"PP",25
11,"11020",165378,109810,108830,1188,980,"PP",35994
24,"24110",1247,899,892,6,7,"PP",237
6,"6041",460,372,367,0,5,"PP",154
26,"26177",304,255,254,7,1,"PP",140
7,"7011",27721,17817,17720,139,97,"PP",6343
17,"17187",631,445,441,2,4,"PP",16
5,"5171",74,52,50,1,2,"PP",32
23,"23002",17428,12820,12644,70,176,"PP",4186
47,"47106",50,39,39,0,0,"PP",26
36,"36006",11520,8529,8396,63,133,"PP",3831
18,"18121",129,98,98,1,0,"PP",29
46,"46208",1112,887,881,4,6,"PP",300
19,"19082",85,64,64,0,0,"PP",16
43,"43018",408,325,320,3,5,"PP",13
12,"12110",234,176,173,0,3,"PP",49
23,"23003",8688,6326,6257,52,69,"PP",2324
24,"24215",152,113,113,0,0,"PP",82
28,"28113",34751,25832,25612,120,220,"PP",7658
24,"24226",199,139,137,0,2,"PP",101
40,"40002",36,32,32,0,0,"PP",20
18,"18033",282,201,200,5,1,"PP",60
37,"37240",945,623,619,5,4,"PP",258
49,"49149",390,273,268,3,5,"PP",164
47,"47137",29,25,25,1,0,"PP",17
37,"37323",516,376,372,5,4,"PP",218
7,"7014",7320,4163,4116,45,47,"PP",1072
47,"47028",33,21,21,0,0,"PP",15
19,"19123",40,32,31,1,1,"PP",15
19,"19043",84,72,72,0,0,"PP",42
25,"25019",4572,2726,2698,34,28,"PP",435
25,"25059",805,527,523,7,4,"PP",145
10,"10164",737,484,475,3,9,"PP",179
49,"49150",139,112,111,1,1,"PP",65
10,"10027",77,69,69,1,0,"PP",22
24,"24015",2265,1649,1635,18,14,"PP",868
40,"40200",40,31,31,0,0,"PP",13
25,"25104",130,76,74,1,2,"PP",7
36,"36009",4503,3056,3001,15,55,"PP",1584
37,"37325",89,62,62,0,0,"PP",42
25,"25020",289,206,205,3,1,"PP",28
7,"7056",5026,3410,3375,32,35,"PP",1124
19,"19087",18,18,18,0,0,"PP",9
41,"41068",13939,9787,9674,72,113,"PP",2253
26,"26181",14,14,14,0,0,"PP",9
49,"49151",619,459,456,2,3,"PP",194
29,"29018",2010,1472,1420,9,52,"PP",369
12,"12112",99,79,78,3,1,"PP",36
10,"10075",253,167,166,1,1,"PP",50
40,"40119",169,138,133,1,5,"PP",77
47,"47111",1020,742,732,7,10,"PP",307
47,"47030",993,766,751,6,15,"PP",366
37,"37086",101,72,71,1,1,"PP",44
24,"24194",290,212,212,3,0,"PP",45
49,"49236",75,58,58,0,0,"PP",37
16,"16034",180,146,144,2,2,"PP",69
21,"21032",1800,1286,1259,10,27,"PP",373
17,"17192",144,96,93,1,3,"PP",9
37,"37070",529,399,392,1,7,"PP",197
28,"28126",39,29,29,0,0,"PP",19
29,"29030",805,620,614,4,6,"PP",48
37,"37087",862,639,635,2,4,"PP",269
5,"5193",193,167,164,1,3,"PP",90
43,"43146",39,29,28,0,1,"PP",1
25,"25023",4531,2782,2763,30,19,"PP",429
18,"18128",343,270,269,1,1,"PP",111
18,"18037",535,402,396,2,6,"PP",160
9,"9120",38,32,32,1,0,"PP",11
39,"39007",417,278,275,2,3,"PP",146
5,"5227",358,253,250,1,3,"PP",120
37,"37330",339,248,246,0,2,"PP",135
43,"43025",600,408,404,2,4,"PP",56
17,"17194",80,55,54,0,1,"PP",1
43,"43147",524,381,373,4,8,"PP",36
13,"13071",39454,26316,26107,183,209,"PP",8382
13,"13001",1254,934,925,6,9,"PP",342
24,"24901",889,636,623,5,13,"PP",238
46,"46195",1962,1531,1516,11,15,"PP",492
34,"34103",98,77,76,0,1,"PP",54
19,"19170",193,135,135,0,0,"PP",61
5,"5180",86,67,63,3,4,"PP",51
10,"10033",423,320,320,0,0,"PP",197
19,"19091",26,20,20,0,0,"PP",12
47,"47113",159,129,128,0,1,"PP",63
47,"47006",190,136,135,1,1,"PP",43
49,"49155",79,61,60,3,1,"PP",43
39,"39039",568,382,379,0,3,"PP",212
17,"17901",987,623,620,9,3,"PP",36
37,"37122",201,154,153,5,1,"PP",61
46,"46109",6150,4625,4556,25,69,"PP",1558
10,"10034",353,260,257,2,3,"PP",116
46,"46005",22918,16958,16827,102,131,"PP",4678
23,"23011",2170,1515,1496,7,19,"PP",326
26,"26077",22,22,21,1,1,"PP",15
36,"36015",4153,2721,2677,23,44,"PP",1160
18,"18040",231,136,133,0,3,"PP",34
24,"24020",456,314,307,4,7,"PP",133
45,"45113",1915,1390,1366,6,24,"PP",765
37,"37332",68,51,50,0,1,"PP",35
37,"37333",224,142,142,1,0,"PP",67
47,"47114",4045,2787,2762,26,25,"PP",1302
47,"47142",141,99,97,0,2,"PP",58
46,"46084",1576,1263,1242,5,21,"PP",487
24,"24223",2610,1917,1908,39,9,"PP",823
30,"30008",13918,9757,9645,59,112,"PP",4106
35,"35019",32481,19318,19067,123,251,"PP",6800
12,"12117",3585,2727,2677,20,50,"PP",958
10,"10036",329,241,238,1,3,"PP",70
28,"28120",1223,892,884,2,8,"PP",353
36,"36016",1143,721,711,3,10,"PP",543
36,"36053",5684,4099,4050,38,49,"PP",1618
21,"21038",1095,705,693,4,12,"PP",245
24,"24055",708,516,512,0,4,"PP",270
47,"47060",258,216,214,1,2,"PP",97
39,"39010",631,480,475,7,5,"PP",189
49,"49037",185,153,151,0,2,"PP",89
36,"36017",17782,12411,12240,117,171,"PP",5945
20,"20906",119,87,87,1,0,"PP",1
17,"17161",992,726,721,10,5,"PP",44
28,"28121",198,160,158,1,2,"PP",77
47,"47035",921,717,715,3,2,"PP",373
19,"19010",8,8,8,0,0,"PP",2
40,"40041",979,725,717,5,8,"PP",345
10,"10145",127,97,95,0,2,"PP",39
28,"28062",292,231,226,1,5,"PP",118
37,"37376",2233,1539,1515,6,24,"PP",878
10,"10038",87,68,68,0,0,"PP",43
17,"17162",150,86,86,1,0,"PP",10
41,"41098",5004,3665,3630,26,35,"PP",1424
47,"47116",416,341,339,0,2,"PP",185
47,"47117",301,233,227,2,6,"PP",121
37,"37336",52,50,50,1,0,"PP",28
17,"17163",2626,1764,1747,10,17,"PP",74
49,"49039",338,245,239,3,6,"PP",95
17,"17200",613,424,422,5,2,"PP",24
47,"47062",163,130,130,0,0,"PP",96
38,"38032",13237,8908,8828,52,80,"PP",3083
46,"46191",1937,1530,1505,5,25,"PP",596
13,"13080",351,266,266,2,0,"PP",138
24,"24203",95,69,68,0,1,"PP",45
38,"38045",3837,2127,2111,12,16,"PP",605
37,"37049",137,96,96,1,0,"PP",53
5,"5188",45,39,38,0,1,"PP",27
10,"10040",441,313,307,4,6,"PP",119
46,"46087",120,98,97,0,1,"PP",28
9,"9130",74,51,50,1,1,"PP",37
19,"19325",121,83,82,0,1,"PP",55
5,"5189",449,351,349,2,2,"PP",185
12,"12022",344,265,262,2,3,"PP",110
34,"34199",1218,918,899,10,19,"PP",369
13,"13064",1696,1231,1225,9,6,"PP",443
49,"49040",114,101,101,0,0,"PP",41
46,"46096",274,209,209,1,0,"PP",65
17,"17165",656,439,435,3,4,"PP",28
24,"24228",660,430,422,6,8,"PP",243
37,"37339",315,251,251,4,0,"PP",159
46,"46166",8155,6320,6251,30,69,"PP",2073
12,"12024",143,125,124,0,1,"PP",42
37,"37213",89,74,73,0,1,"PP",46
48,"48085",10338,7190,7153,39,37,"PP",469
25,"25074",178,132,128,6,4,"PP",7
13,"13066",2506,1971,1947,11,24,"PP",918
43,"43035",254,156,155,2,1,"PP",24
37,"37036",61,44,43,0,1,"PP",30
6,"6061",1084,853,837,4,16,"PP",264
12,"12122",796,637,627,0,10,"PP",305
18,"18187",557,383,379,0,4,"PP",94
46,"46245",511,420,415,0,5,"PP",139
13,"13015",5431,3993,3950,17,43,"PP",1752
25,"25035",398,249,247,2,2,"PP",29
42,"42035",769,527,516,2,11,"PP",291
46,"46193",8788,6925,6871,50,54,"PP",1875
49,"49058",307,237,233,0,4,"PP",124
17,"17180",8295,4958,4935,36,23,"PP",386
34,"34902",139,106,106,0,0,"PP",75
16,"16005",255,180,178,2,2,"PP",89
15,"15025",1061,629,622,6,7,"PP",329
5,"5259",124,105,105,1,0,"PP",66
6,"6063",3015,2268,2246,16,22,"PP",834
26,"26171",176,139,133,1,6,"PP",79
48,"48097",1297,900,894,8,6,"PP",73
37,"37271",368,297,296,0,1,"PP",159
45,"45109",2883,2271,2214,9,57,"PP",1224
18,"18050",1710,1165,1152,3,13,"PP",369
46,"46168",1938,1495,1486,2,9,"PP",473
10,"10092",292,236,235,1,1,"PP",73
21,"21006",3368,2182,2146,13,36,"PP",381
46,"46254",1000,785,779,6,6,"PP",334
10,"10184",756,613,604,10,9,"PP",275
39,"39017",569,398,391,4,7,"PP",248
10,"10046",203,168,168,1,0,"PP",58
26,"26020",476,349,339,3,10,"PP",207
30,"30015",19171,13561,13464,61,97,"PP",6506
42,"42144",436,353,348,2,5,"PP",146
25,"25010",211,113,113,2,0,"PP",4
25,"25196",113,57,57,0,0,"PP",6
28,"28175",863,670,668,5,2,"PP",288
18,"18176",250,191,189,2,2,"PP",21
28,"28117",104,89,89,1,0,"PP",38
46,"46169",32247,24214,24053,154,161,"PP",7031
5,"5244",50,39,39,1,0,"PP",30
41,"41049",9299,6896,6771,98,125,"PP",1384
16,"16147",64,45,45,0,0,"PP",19
43,"43175",554,363,360,5,3,"PP",63
28,"28137",1664,1232,1220,7,12,"PP",489
30,"30016",151668,102093,101363,484,730,"PP",45138
40,"40136",112,88,87,0,1,"PP",40
25,"25039",277,181,180,3,1,"PP",11
49,"49169",35,26,26,0,0,"PP",11
37,"37345",163,128,128,3,0,"PP",73
46,"46170",3417,2714,2688,10,26,"PP",1038
46,"46196",147,125,125,1,0,"PP",66
17,"17171",165,117,116,2,1,"PP",9
12,"12126",24464,18533,18331,113,202,"PP",6161
23,"23026",3586,2620,2585,16,35,"PP",1065
25,"25001",144,73,73,0,0,"PP",3
16,"16053",426,351,347,5,4,"PP",115
10,"10004",704,492,482,9,10,"PP",192
47,"47151",27,24,24,0,0,"PP",18
42,"42054",19,16,16,0,0,"PP",5
43,"43082",365,290,286,5,4,"PP",23
16,"16055",691,466,463,2,3,"PP",216
37,"37346",273,212,211,1,1,"PP",144
21,"21010",14687,8293,8220,92,73,"PP",2926
36,"36028",4102,2913,2868,17,45,"PP",1435
37,"37092",1758,1225,1215,8,10,"PP",478
17,"17172",454,300,297,0,3,"PP",13
25,"25002",482,316,314,2,2,"PP",29
12,"12128",1393,1090,1072,10,18,"PP",313
30,"30019",25857,17544,17374,125,170,"PP",8518
37,"37347",468,348,346,2,2,"PP",154
42,"42178",115,83,83,0,0,"PP",57
47,"47043",297,239,237,0,2,"PP",123
19,"19109",39,32,32,0,0,"PP",26
26,"26093",53,39,38,0,1,"PP",14
47,"47125",58,46,46,0,0,"PP",32
27,"27025",2831,2152,2110,17,42,"PP",1045
28,"28130",28293,21253,21040,116,213,"PP",5788
19,"19150",128,99,99,1,0,"PP",53
47,"47126",50,41,41,0,0,"PP",31
25,"25904",148,112,111,2,1,"PP",10
17,"17174",178,99,97,2,2,"PP",4
23,"23042",292,217,213,1,4,"PP",99
10,"10068",735,570,557,2,13,"PP",236
24,"24066",494,368,366,4,2,"PP",235
49,"49095",291,221,220,0,1,"PP",108
43,"43004",6281,3993,3929,38,64,"PP",593
6,"6026",837,598,591,0,7,"PP",285
36,"36030",4175,2832,2785,27,47,"PP",1210
34,"34063",83,76,75,1,1,"PP",46
25,"25004",571,376,373,3,3,"PP",35
43,"43085",226,180,180,1,0,"PP",12
42,"42134",2627,1927,1890,19,37,"PP",757
49,"49096",170,131,124,2,7,"PP",54
23,"23030",1238,968,960,3,8,"PP",272
25,"25044",188,122,120,7,2,"PP",28
45,"45061",2447,1703,1689,12,14,"PP",687
18,"18061",1057,812,804,1,8,"PP",321
12,"12140",1143,939,930,6,9,"PP",333
43,"43904",2900,1602,1573,32,29,"PP",221
43,"43059",252,188,188,2,0,"PP",5
28,"28171",4239,2848,2820,19,28,"PP",1437
45,"45172",689,530,522,2,8,"PP",249
24,"24068",457,344,340,0,4,"PP",101
5,"5205",74,57,55,1,2,"PP",37
45,"45128",2502,1680,1668,6,12,"PP",648
5,"5206",30,22,20,1,2,"PP",6
9,"9141",616,485,483,5,2,"PP",194
45,"45028",3649,2701,2673,12,28,"PP",1080
9,"9454",43,34,33,0,1,"PP",14
40,"40058",325,277,276,4,1,"PP",195
25,"25133",706,432,427,8,5,"PP",52
34,"34230",15,12,12,0,0,"PP",8
49,"49056",300,211,208,2,3,"PP",101
23,"23032",566,450,448,4,2,"PP",74
13,"13082",25805,16871,16706,120,165,"PP",8403
5,"5207",692,547,543,0,4,"PP",249
13,"13083",2423,1693,1653,10,40,"PP",894
18,"18109",597,411,408,2,3,"PP",204
40,"40103",159,125,123,2,2,"PP",52
47,"47210",382,282,274,3,8,"PP",162
42,"42140",16,12,12,0,0,"PP",12
37,"37353",126,97,97,1,0,"PP",52
35,"35006",30457,21398,21118,162,280,"PP",6418
19,"19073",23,19,19,0,0,"PP",7
23,"23071",1715,1290,1278,7,12,"PP",504
37,"37354",5240,3823,3771,39,52,"PP",1582
16,"16110",93,70,70,0,0,"PP",60
41,"41090",3523,2576,2512,13,64,"PP",700
29,"29096",2810,1944,1909,31,35,"PP",403
42,"42090",91,69,67,1,2,"PP",36
28,"28134",61008,45177,44904,263,273,"PP",15667
16,"16082",291,213,212,0,1,"PP",82
25,"25238",204,140,138,4,2,"PP",9
43,"43172",344,211,209,4,2,"PP",24
25,"25177",368,226,226,0,0,"PP",21
37,"37355",178,142,142,1,0,"PP",78
6,"6002",4322,2819,2762,22,57,"PP",1071
29,"29041",3175,2090,2045,24,45,"PP",504
16,"16236",910,656,651,4,5,"PP",376
48,"48076",308,218,217,2,1,"PP",9
25,"25022",104,79,79,0,0,"PP",2
40,"40176",395,306,305,2,1,"PP",122
46,"46081",10134,7771,7702,41,69,"PP",2853
15,"15051",4638,3182,3153,44,29,"PP",1051
43,"43051",8512,5418,5366,32,52,"PP",986
12,"12134",141,95,94,0,1,"PP",35
47,"47048",188,144,144,1,0,"PP",85
46,"46177",4690,3579,3526,19,53,"PP",952
49,"49061",150,114,112,2,2,"PP",48
47,"47131",170,134,128,2,6,"PP",61
12,"12038",167,120,118,2,2,"PP",66
10,"10199",165,112,111,1,1,"PP",49
47,"47166",259,204,197,2,7,"PP",112
47,"47221",111,94,94,0,0,"PP",61
37,"37120",99,82,78,0,4,"PP",49
24,"24196",2057,1502,1485,9,17,"PP",496
42,"42174",174,137,135,5,2,"PP",29
18,"18011",4335,3037,3015,20,22,"PP",990
12,"12135",35719,26016,25793,196,223,"PP",8279
10,"10063",173,139,137,0,2,"PP",68
49,"49062",122,90,89,0,1,"PP",49
18,"18115",2553,1800,1781,17,19,"PP",467
37,"37027",228,172,171,0,1,"PP",93
28,"28148",85454,62367,61884,370,483,"PP",20741
24,"24041",538,367,366,3,1,"PP",180
12,"12136",2635,2201,2171,18,30,"PP",1160
28,"28903",33082,27065,26922,154,143,"PP",9445
45,"45034",1353,1082,1078,6,4,"PP",443
42,"42190",89,65,64,0,1,"PP",22
18,"18116",2850,2059,2025,20,34,"PP",774
40,"40022",213,164,161,2,3,"PP",64
28,"28069",50,44,41,0,3,"PP",15
37,"37015",224,144,144,1,0,"PP",74
46,"46902",364,306,303,0,3,"PP",59
25,"25013",2146,1240,1226,16,14,"PP",207
37,"37275",118,70,69,0,1,"PP",35
19,"19132",92,81,81,0,0,"PP",46
46,"46179",2165,1760,1737,16,23,"PP",675
18,"18027",2570,1711,1700,13,11,"PP",385
37,"37360",225,174,173,1,1,"PP",91
19,"19039",61,54,54,1,0,"PP",32
34,"34171",968,708,703,5,5,"PP",373
6,"6084",1093,828,818,8,10,"PP",382
24,"24144",695,470,465,2,5,"PP",221
16,"16071",20,20,20,0,0,"PP",8
37,"37236",135,105,103,1,2,"PP",58
6,"6009",204,153,153,0,0,"PP",70
46,"46903",6065,4790,4763,18,27,"PP",1712
25,"25183",499,326,323,7,3,"PP",21
46,"46180",682,553,549,0,4,"PP",139
10,"10067",10422,7113,7014,62,99,"PP",2899
17,"17106",140,103,102,0,1,"PP",6
10,"10205",2020,1319,1293,5,26,"PP",421
16,"16119",169,127,127,0,0,"PP",55
5,"5217",56,44,43,0,1,"PP",29
26,"26105",2205,1670,1658,12,12,"PP",659
46,"46025",2499,1953,1934,8,19,"PP",597
24,"24011",203,133,132,0,1,"PP",14
47,"47161",3918,3145,3126,12,19,"PP",1690
12,"12108",456,378,371,2,7,"PP",153
38,"38031",28687,21132,20858,104,274,"PP",8647
25,"25130",195,113,112,2,1,"PP",4
28,"28141",5823,4297,4262,29,35,"PP",1739
42,"42153",14,12,12,0,0,"PP",9
46,"46129",524,420,412,4,8,"PP",94
25,"25016",2107,1268,1259,14,9,"PP",122
29,"29047",1117,885,866,1,19,"PP",117
37,"37238",110,87,85,0,2,"PP",35
37,"37239",217,185,183,3,2,"PP",80
46,"46190",48947,35638,35419,211,219,"PP",10510
37,"37019",150,123,120,0,3,"PP",95
37,"37033",95,68,68,5,0,"PP",33
6,"6042",1011,698,687,2,11,"PP",209
10,"10070",718,546,542,1,4,"PP",281
46,"46026",1204,1015,1004,3,11,"PP",386
34,"34229",68,57,56,1,1,"PP",37
49,"49202",187,130,130,4,0,"PP",69
23,"23055",47167,31479,31198,264,281,"PP",10244
9,"9003",194,147,146,0,1,"PP",56
47,"47044",331,293,290,2,3,"PP",112
49,"49233",93,58,55,0,3,"PP",38
42,"42167",251,175,172,2,3,"PP",90
23,"23056",3088,2243,2203,15,40,"PP",603
46,"46183",5993,4443,4381,19,62,"PP",1903
23,"23044",4816,3663,3569,27,94,"PP",1248
42,"42155",167,103,102,1,1,"PP",77
13,"13047",5760,4295,4224,23,71,"PP",1820
20,"20012",147,99,98,5,1,"PP",4
41,"41067",7093,4930,4866,37,64,"PP",1578
19,"19002",69,58,57,0,1,"PP",24
12,"12091",177,113,112,0,1,"PP",65
39,"39095",2266,1760,1726,14,34,"PP",658
42,"42197",75,58,56,0,2,"PP",34
37,"37366",43,32,32,0,0,"PP",21
45,"45107",3257,2504,2472,15,32,"PP",1016
25,"25146",227,140,140,3,0,"PP",15
41,"41034",23070,14805,14625,186,180,"PP",3214
49,"49029",623,495,488,3,7,"PP",303
24,"24217",135,109,108,1,1,"PP",56
42,"42198",23,16,16,4,0,"PP",8
20,"20046",1223,739,737,5,2,"PP",47
47,"47164",378,313,311,1,2,"PP",179
19,"19167",130,101,99,0,2,"PP",59
21,"21071",203,157,153,4,4,"PP",50
24,"24050",102,77,76,0,1,"PP",49
47,"47139",1040,777,767,6,10,"PP",369
19,"19125",41,32,32,0,0,"PP",17
39,"39005",1380,1053,1046,9,7,"PP",525
43,"43062",281,217,215,2,2,"PP",39
36,"36047",2454,1633,1621,13,12,"PP",952
37,"37298",179,127,126,0,1,"PP",78
34,"34901",1104,825,814,5,11,"PP",486
40,"40174",349,254,251,2,3,"PP",174
37,"37284",316,246,238,4,8,"PP",105
13,"13051",346,264,264,1,0,"PP",117
47,"47065",857,674,669,1,5,"PP",328
17,"17232",152,92,91,1,1,"PP",4
41,"41102",14655,10183,9919,142,264,"PP",2516
42,"42172",29,26,26,0,0,"PP",21
13,"13017",256,200,197,0,3,"PP",100
34,"34116",62,49,49,0,0,"PP",33
23,"23101",378,276,271,1,5,"PP",71
46,"46253",115,82,82,0,0,"PP",22
43,"43078",846,543,531,8,12,"PP",72
24,"24095",320,234,232,0,2,"PP",129
37,"37025",257,220,220,4,0,"PP",116
23,"23048",870,619,613,1,6,"PP",308
28,"28147",963,722,720,5,2,"PP",279
38,"38025",6880,4839,4761,30,78,"PP",1839
37,"37370",328,258,254,1,4,"PP",157
45,"45143",1170,881,874,4,7,"PP",400
45,"45154",1493,1079,1074,6,5,"PP",434
30,"30026",15734,10007,9901,51,106,"PP",4822
43,"43038",21366,13061,12943,111,118,"PP",2454
6,"6004",1600,1212,1207,2,5,"PP",426
32,"32068",1415,982,978,5,4,"PP",561
40,"40077",842,632,619,3,13,"PP",206
37,"37040",391,299,297,2,2,"PP",135
40,"40178",98,73,71,1,2,"PP",58
11,"11027",67913,45219,44833,454,386,"PP",16620
40,"40204",167,113,110,1,3,"PP",67
12,"12125",216,180,177,0,3,"PP",87
38,"38015",4170,2862,2836,10,26,"PP",1122
40,"40163",53,44,43,0,1,"PP",29
24,"24184",198,118,117,0,1,"PP",55
43,"43026",782,524,520,6,4,"PP",51
47,"47123",466,354,352,4,2,"PP",170
37,"37163",41,34,34,0,0,"PP",18
28,"28177",10270,8083,8030,36,53,"PP",3566
34,"34089",155,124,124,2,0,"PP",71
5,"5230",66,63,62,1,1,"PP",47
23,"23051",2758,2171,2144,9,27,"PP",784
19,"19130",60145,45531,45085,286,446,"PP",18871
42,"42027",76,61,60,0,1,"PP",31
39,"39009",3216,2366,2337,17,29,"PP",1017
24,"24185",474,357,350,3,7,"PP",148
13,"13005",23298,17250,17070,140,180,"PP",6380
18,"18194",2128,1451,1437,9,14,"PP",324
43,"43068",520,330,326,7,4,"PP",73
13,"13057",1147,961,954,1,7,"PP",467
24,"24155",471,388,384,6,4,"PP",174
18,"18087",184857,134428,133526,864,902,"PP",57523
23,"23052",1125,936,922,4,14,"PP",299
40,"40039",210,156,153,3,3,"PP",97
18,"18088",1541,1124,1117,5,7,"PP",227
25,"25029",1655,1042,1029,15,13,"PP",88
19,"19185",28,21,20,0,1,"PP",7
23,"23093",3226,2302,2273,19,29,"PP",486
25,"25069",451,247,246,4,1,"PP",24
47,"47169",68,59,59,0,0,"PP",47
47,"47008",24,19,19,1,0,"PP",13
19,"19051",67,63,63,0,0,"PP",37
34,"34049",359,266,260,1,6,"PP",126
13,"13007",1271,993,977,8,16,"PP",383
27,"27061",1027,753,732,6,21,"PP",370
42,"42164",1600,1150,1127,8,23,"PP",530
5,"5233",221,191,191,1,0,"PP",129
10,"10084",1345,888,875,4,13,"PP",336
13,"13008",438,299,295,0,4,"PP",153
21,"21079",722,494,490,5,4,"PP",137
17,"17211",830,581,580,10,1,"PP",25
13,"13043",231,180,179,1,1,"PP",95
19,"19162",68,49,47,0,2,"PP",15
10,"10130",1761,1300,1277,6,23,"PP",410
16,"16091",65,53,53,0,0,"PP",12
36,"36055",13620,9580,9400,62,180,"PP",4150
42,"42165",409,271,261,10,10,"PP",121
14,"14034",308,247,244,2,3,"PP",110
7,"7901",610,462,459,7,3,"PP",242
29,"29093",2214,1643,1621,3,22,"PP",503
27,"27062",605,447,444,1,3,"PP",247
21,"21054",8100,5656,5571,46,85,"PP",2841
19,"19135",107,90,90,3,0,"PP",53
46,"46217",878,691,676,4,15,"PP",225
10,"10131",12861,8813,8721,52,92,"PP",4012
13,"13010",883,646,634,3,12,"PP",304
40,"40015",28,26,26,1,0,"PP",16
47,"47127",137,98,97,0,1,"PP",52
11,"11901",5648,3676,3631,67,45,"PP",858
49,"49027",140,112,108,1,4,"PP",70
45,"45195",2141,1635,1606,7,29,"PP",579
34,"34177",179,149,149,2,0,"PP",85
45,"45184",200,129,129,0,0,"PP",27
19,"19015",84,69,68,0,1,"PP",28
18,"18095",1967,1450,1430,11,20,"PP",377
49,"49003",900,612,599,5,13,"PP",348
46,"46113",2457,1804,1782,6,22,"PP",708
48,"48084",22449,14670,14553,90,117,"PP",1546
6,"6105",624,418,417,1,1,"PP",177
46,"46192",761,576,570,5,6,"PP",171
10,"10149",421,283,280,1,3,"PP",123
7,"7041",2044,1486,1451,13,35,"PP",630
26,"26120",1454,1139,1126,7,13,"PP",522
7,"7028",899,601,595,7,6,"PP",214
47,"47146",255,206,204,1,2,"PP",65
13,"13013",7068,5147,5063,25,84,"PP",2490
47,"47147",116,92,92,0,0,"PP",60
18,"18096",341,227,224,3,3,"PP",69
37,"37297",425,328,322,2,6,"PP",179
25,"25047",1014,675,674,8,1,"PP",46
40,"40087",92,71,70,1,1,"PP",52
25,"25089",105,60,59,0,1,"PP",0
37,"37380",56,47,45,0,2,"PP",13
42,"42171",127,80,79,0,1,"PP",57
20,"20025",1143,765,760,8,5,"PP",6
47,"47173",880,644,638,20,6,"PP",200
28,"28183",1039,743,735,2,8,"PP",265
24,"24093",360,249,248,2,1,"PP",117
18,"18143",973,742,730,5,12,"PP",163
24,"24104",259,169,169,0,0,"PP",80
49,"49223",752,608,600,4,8,"PP",399
5,"5258",111,95,95,0,0,"PP",48
26,"26122",118,102,102,0,0,"PP",40
40,"40047",30,25,25,0,0,"PP",14
25,"25093",640,403,395,7,8,"PP",40
19,"19034",22,16,16,0,0,"PP",7
37,"37230",221,159,159,2,0,"PP",74
35,"35007",511,316,309,2,7,"PP",118
37,"37024",89,67,67,0,0,"PP",41
34,"34086",103,89,88,0,1,"PP",43
37,"37119",107,84,82,0,2,"PP",29
6,"6018",753,535,529,3,6,"PP",141
37,"37012",154,116,115,1,1,"PP",66
7,"7032",20034,12824,12710,110,114,"PP",4029
38,"38037",12864,8287,8163,64,124,"PP",3029
9,"9314",94,73,70,0,3,"PP",25
25,"25077",463,256,253,6,3,"PP",20
13,"13018",822,642,640,6,2,"PP",252
23,"23901",1154,970,964,3,6,"PP",351
24,"24105",1459,1042,1025,16,17,"PP",396
46,"46082",4918,3745,3712,33,33,"PP",1146
29,"29053",1699,1105,1091,14,14,"PP",416
43,"43065",399,252,251,3,1,"PP",20
12,"12094",847,674,665,5,9,"PP",140
32,"32083",835,559,550,4,9,"PP",339
19,"19182",38,34,33,0,1,"PP",11
20,"20039",2111,1480,1472,14,8,"PP",24
43,"43121",599,354,348,1,6,"PP",18
46,"46117",495,402,399,5,3,"PP",131
37,"37233",61,48,47,1,1,"PP",18
30,"30006",803,691,685,2,6,"PP",392
43,"43095",2474,1575,1551,17,24,"PP",187
10,"10140",1106,820,808,4,12,"PP",407
46,"46048",3452,2749,2713,14,36,"PP",824
37,"37148",427,298,295,3,3,"PP",182
14,"14049",16309,11635,11515,115,120,"PP",3246
29,"29066",334,234,233,4,1,"PP",76
13,"13073",531,399,391,3,8,"PP",198
18,"18012",2278,1662,1641,13,21,"PP",697
28,"28158",665,537,533,4,4,"PP",281
5,"5245",353,286,285,3,1,"PP",141
42,"42176",29,25,25,0,0,"PP",20
39,"39049",322,229,229,0,0,"PP",108
45,"45057",222,180,177,1,3,"PP",97
46,"46092",276,192,189,0,3,"PP",108
46,"46231",2421,1721,1708,14,13,"PP",438
45,"45135",4269,3340,3288,8,52,"PP",1321
13,"13040",868,678,672,4,6,"PP",284
19,"19022",625,476,469,3,7,"PP",266
29,"29012",9755,6689,6599,71,90,"PP",1842
37,"37002",139,87,86,0,1,"PP",42
5,"5247",241,138,138,1,0,"PP",79
45,"45157",2128,1456,1427,13,29,"PP",704
21,"21051",239,174,170,1,4,"PP",49
18,"18149",5230,3903,3864,20,39,"PP",1585
18,"18070",288,227,226,0,1,"PP",85
23,"23065",1597,1170,1149,2,21,"PP",432
23,"23905",1868,1277,1272,6,5,"PP",488
9,"9411",151,102,101,0,1,"PP",46
37,"37138",203,149,148,2,1,"PP",87
16,"16263",959,722,715,4,7,"PP",270
40,"40181",4233,3260,3219,23,41,"PP",1061
24,"24065",2138,1503,1472,15,31,"PP",597
43,"43083",144,109,108,0,1,"PP",21
38,"38006",39766,20776,20587,139,189,"PP",7284
46,"46198",839,684,674,4,10,"PP",160
47,"47178",172,140,140,3,0,"PP",77
37,"37004",30,21,21,0,0,"PP",14
25,"25042",208,123,121,1,2,"PP",19
37,"37152",418,290,286,2,4,"PP",158
45,"45148",292,223,223,0,0,"PP",128
47,"47170",33,28,27,2,1,"PP",12
18,"18902",816,632,620,4,12,"PP",191
32,"32059",1790,1283,1263,7,20,"PP",708
46,"46155",1029,833,822,4,11,"PP",258
28,"28170",2472,1640,1622,13,18,"PP",625
10,"10146",1507,1004,977,7,27,"PP",384
37,"37047",180,84,84,0,0,"PP",58
21,"21067",414,288,287,1,1,"PP",47
25,"25086",522,346,341,2,5,"PP",6
49,"49014",112,91,91,2,0,"PP",51
40,"40224",22,21,21,0,0,"PP",16
32,"32045",2443,1715,1690,14,25,"PP",954
40,"40142",53,39,37,0,2,"PP",17
16,"16204",261,199,199,1,0,"PP",86
42,"42195",101,62,62,0,0,"PP",32
40,"40198",24,19,19,0,0,"PP",15
43,"43101",145,104,102,3,2,"PP",7
32,"32060",832,583,576,8,7,"PP",193
37,"37196",75,64,64,0,0,"PP",31
29,"29015",31880,22220,21952,190,268,"PP",8109
28,"28073",12549,8788,8701,54,87,"PP",2861
41,"41055",14954,10068,9945,64,123,"PP",3182
49,"49135",626,434,430,1,4,"PP",205
19,"19031",15,9,9,0,0,"PP",5
19,"19152",556,390,382,1,8,"PP",166
42,"42183",111,82,82,2,0,"PP",69
19,"19112",60,46,46,0,0,"PP",29
12,"12101",358,279,275,3,4,"PP",101
23,"23097",6443,4117,4063,21,54,"PP",1471
47,"47002",23,21,20,1,1,"PP",12
46,"46148",1513,1160,1146,7,14,"PP",450
25,"25046",422,279,275,2,4,"PP",35
37,"37008",4266,3216,3197,19,19,"PP",1741
10,"10104",5119,3633,3585,15,48,"PP",1572
43,"43170",868,566,562,5,4,"PP",43
49,"49136",318,220,218,1,2,"PP",147
28,"28037",1559,1177,1166,5,11,"PP",468
30,"30043",24967,18981,18685,101,296,"PP",8513
47,"47020",280,234,231,2,3,"PP",145
16,"16003",125,105,104,0,1,"PP",45
40,"40018",91,72,72,1,0,"PP",43
12,"12002",110,99,98,1,1,"PP",12
37,"37144",363,277,276,1,1,"PP",164
38,"38023",121908,81147,80333,494,814,"PP",23539
19,"19114",37,26,26,0,0,"PP",11
6,"6092",577,415,405,3,10,"PP",150
9,"9429",56,41,41,0,0,"PP",27
42,"42108",12,9,9,1,0,"PP",6
29,"29074",794,586,581,0,5,"PP",178
37,"37368",17,17,17,0,0,"PP",8
42,"42187",62,46,45,1,1,"PP",35
19,"19191",14,13,12,0,1,"PP",4
9,"9208",210,136,134,3,2,"PP",82
34,"34132",114,89,86,0,3,"PP",43
24,"24152",464,295,291,1,4,"PP",181
37,"37285",403,310,308,2,2,"PP",173
47,"47083",80,59,54,1,5,"PP",27
49,"49126",235,155,154,2,1,"PP",81
43,"43119",799,470,468,8,2,"PP",59
48,"48056",966,705,700,5,5,"PP",13
36,"36060",30323,21399,21162,164,237,"PP",7688
9,"9407",28,23,23,0,0,"PP",10
5,"5260",105,90,90,0,0,"PP",64
43,"43093",3919,2461,2434,47,27,"PP",281
25,"25049",151,110,108,1,2,"PP",9
45,"45165",62718,44420,44006,236,414,"PP",19148
38,"38013",2949,1896,1867,17,29,"PP",706
29,"29098",1253,917,895,9,22,"PP",259
25,"25063",87,58,58,1,0,"PP",11
49,"49250",1245,935,920,7,15,"PP",468
47,"47140",115,102,102,1,0,"PP",70
47,"47057",268,197,196,0,1,"PP",119
51,"51001",59125,31093,30737,316,356,"PP",15956
42,"42159",37,29,29,0,0,"PP",17
43,"43107",383,238,237,7,1,"PP",9
13,"13019",5181,3621,3579,18,42,"PP",1387
47,"47076",17399,13097,12972,92,125,"PP",4590
46,"46263",251,214,212,0,2,"PP",55
46,"46221",352,305,304,0,1,"PP",115
45,"45155",355,291,285,0,6,"PP",115
29,"29077",199,149,146,2,3,"PP",46
17,"17220",796,538,536,5,2,"PP",37
25,"25064",108,68,68,2,0,"PP",6
49,"49034",432,327,325,2,2,"PP",180
25,"25071",49,31,31,0,0,"PP",1
17,"17225",214,139,139,3,0,"PP",15
14,"14031",593,469,459,3,10,"PP",155
12,"12106",1158,955,942,8,13,"PP",252
36,"36002",3147,2193,2169,20,24,"PP",1107
45,"45167",1440,1144,1133,6,11,"PP",553
25,"25200",329,213,213,0,0,"PP",7
16,"16039",392,261,254,1,7,"PP",115
49,"49266",76,63,61,2,2,"PP",30
46,"46205",14313,10932,10834,51,98,"PP",3564
28,"28088",261,178,178,0,0,"PP",55
25,"25068",556,346,341,11,5,"PP",24
28,"28119",2092,1590,1582,12,8,"PP",725
29,"29045",1684,1178,1168,8,10,"PP",487
7,"7022",11545,7385,7306,88,79,"PP",2872
37,"37060",243,187,187,1,0,"PP",68
41,"41029",13445,9507,9416,78,91,"PP",2676
49,"49023",967,673,662,10,11,"PP",369
42,"42097",23,14,11,0,3,"PP",1
47,"47133",2682,2033,2015,16,18,"PP",697
45,"45181",2315,1674,1640,7,34,"PP",811
17,"17040",537,347,345,3,2,"PP",13
29,"29068",7016,4300,4244,35,56,"PP",1571
26,"26140",253,208,206,0,2,"PP",98
49,"49146",295,216,213,3,3,"PP",103
28,"28079",2362038,1743924,1733354,8859,10570,"PP",696804
19,"19173",45,38,36,0,2,"PP",14
19,"19244",82,65,64,1,1,"PP",41
26,"26002",830,632,622,0,10,"PP",293
28,"28169",1448,1122,1113,5,9,"PP",479
24,"24043",134,75,75,1,0,"PP",29
37,"37018",107,79,79,0,0,"PP",47
18,"18914",1649,1238,1213,3,25,"PP",245
25,"25056",235,143,143,2,0,"PP",7
12,"12055",104,83,82,3,1,"PP",30
24,"24213",150,122,122,1,0,"PP",80
20,"20054",447,286,284,2,2,"PP",6
29,"29903",524,353,349,3,4,"PP",91
9,"9424",36,29,29,1,0,"PP",20
18,"18002",553,395,393,1,2,"PP",101
13,"13067",351,281,279,0,2,"PP",96
28,"28173",517,390,388,1,2,"PP",170
42,"42057",164,104,104,2,0,"PP",69
12,"12119",148,95,93,0,2,"PP",57
10,"10176",371,262,261,0,1,"PP",76
43,"43071",921,613,607,6,6,"PP",100
43,"43005",3626,2157,2138,29,19,"PP",258
34,"34003",164,122,119,0,3,"PP",80
37,"37280",78,53,53,0,0,"PP",42
10,"10116",3749,2726,2670,21,56,"PP",803
21,"21041",113337,72318,71637,748,681,"PP",23987
10,"10086",320,238,233,1,5,"PP",118
17,"17095",19555,11537,11428,89,109,"PP",1714
26,"26167",59,47,46,1,1,"PP",32
30,"30031",492,409,401,0,8,"PP",244
32,"32061",1081,812,809,4,3,"PP",458
45,"45105",392,301,297,3,4,"PP",146
24,"24024",692,496,491,4,5,"PP",284
19,"19165",47,41,41,0,0,"PP",13
46,"46209",1933,1445,1415,5,30,"PP",511
42,"42196",10,7,7,0,0,"PP",6
29,"29049",2962,2132,2110,5,22,"PP",482
43,"43102",480,332,324,3,8,"PP",22
46,"46027",943,780,771,5,9,"PP",306
43,"43169",450,370,367,10,3,"PP",14
48,"48064",606,447,445,4,2,"PP",9
12,"12045",345,268,259,1,9,"PP",73
47,"47110",450,350,346,1,4,"PP",139
13,"13048",504,390,387,2,3,"PP",170
18,"18005",372,262,258,0,4,"PP",37
43,"43020",2215,1508,1497,9,11,"PP",150
43,"43103",880,547,545,4,2,"PP",69
43,"43906",2102,1364,1346,15,18,"PP",188
32,"32033",737,478,476,3,2,"PP",308
16,"16191",899,675,671,2,4,"PP",318
47,"47138",241,170,164,1,6,"PP",83
48,"48035",413,293,292,1,1,"PP",3
42,"42184",57,43,43,0,0,"PP",22
24,"24026",1177,864,849,7,15,"PP",530
29,"29073",1579,1091,1080,7,11,"PP",262
39,"39058",810,559,557,2,2,"PP",185
43,"43017",124,101,101,1,0,"PP",2
30,"30013",7396,5147,5102,32,45,"PP",1769
41,"41046",3023,2213,2183,5,30,"PP",322
29,"29062",654,551,545,2,6,"PP",224
37,"37131",185,139,139,0,0,"PP",77
46,"46063",1756,1367,1345,15,22,"PP",413
46,"46141",439,351,342,2,9,"PP",174
6,"6032",68,53,53,1,0,"PP",24
12,"12133",59,53,52,0,1,"PP",28
46,"46228",2348,1815,1794,7,21,"PP",688
48,"48036",24073,16076,15971,86,105,"PP",1394
25,"25076",145,81,81,2,0,"PP",3
49,"49262",392,279,274,1,5,"PP",154
19,"19126",1627,1155,1134,11,21,"PP",430
47,"47013",100,82,81,1,1,"PP",27
19,"19329",59,50,50,1,0,"PP",23
47,"47039",185,141,140,0,1,"PP",65
19,"19104",14,12,12,1,0,"PP",6
37,"37215",136,104,103,1,1,"PP",55
37,"37161",136,106,106,1,0,"PP",70
47,"47005",549,413,408,2,5,"PP",198
12,"12049",441,322,312,1,10,"PP",67
29,"29020",3267,2408,2359,16,49,"PP",475
37,"37343",60,47,47,0,0,"PP",16
40,"40106",201,158,158,2,0,"PP",80
18,"18015",434,334,333,0,1,"PP",109
26,"26124",807,649,639,7,10,"PP",341
19,"19169",40,34,34,0,0,"PP",8
30,"30036",14698,9859,9734,41,125,"PP",5109
10,"10093",398,317,312,4,5,"PP",66
41,"41038",100095,67313,66687,760,626,"PP",16395
42,"42218",82,55,55,0,0,"PP",31
43,"43066",158,100,98,5,2,"PP",11
37,"37190",215,171,171,1,0,"PP",112
9,"9063",209,168,167,2,1,"PP",107
19,"19157",55,46,46,0,0,"PP",20
19,"19048",18,15,15,1,0,"PP",9
43,"43012",3534,2559,2548,34,11,"PP",328
25,"25230",1558,1008,993,13,15,"PP",144
30,"30003",24332,16183,16040,104,143,"PP",6748
45,"45082",1224,1020,1011,8,9,"PP",460
45,"45190",475,371,366,0,5,"PP",162
46,"46135",9680,7682,7634,36,48,"PP",2745
25,"25067",719,467,460,7,7,"PP",91
45,"45179",525,391,386,3,5,"PP",189
6,"6022",2651,2089,2054,10,35,"PP",652
18,"18148",817,637,634,5,3,"PP",275
49,"49079",106,93,92,1,1,"PP",59
13,"13074",974,835,828,3,7,"PP",360
40,"40179",626,503,493,2,10,"PP",243
24,"24198",592,412,407,2,5,"PP",106
20,"20040",15289,9444,9373,66,71,"PP",587
24,"24021",1675,1162,1144,8,18,"PP",445
46,"46049",281,232,224,0,8,"PP",119
34,"34047",1782,1397,1374,12,23,"PP",865
49,"49118",203,161,160,1,1,"PP",92
19,"19172",57,48,47,0,1,"PP",23
34,"34017",918,744,736,9,8,"PP",381
29,"29080",6676,4469,4419,35,50,"PP",1342
42,"42177",69,60,60,1,0,"PP",29
18,"18056",3530,2641,2614,24,27,"PP",805
18,"18180",633,410,410,3,0,"PP",72
42,"42117",140,101,99,0,2,"PP",50
13,"13058",4100,2986,2954,25,32,"PP",1321
25,"25201",112,73,72,3,1,"PP",8
42,"42046",49,39,39,0,0,"PP",10
6,"6024",1172,905,883,4,22,"PP",355
43,"43002",1801,1156,1128,7,28,"PP",155
42,"42029",137,104,104,2,0,"PP",65
10,"10129",365,275,271,0,4,"PP",80
26,"26152",33,28,28,1,0,"PP",18
18,"18001",251,168,167,5,1,"PP",56
13,"13060",263,200,194,0,6,"PP",75
46,"46077",7496,5909,5827,45,82,"PP",1278
47,"47009",107,86,85,0,1,"PP",39
28,"28019",1233,893,885,4,8,"PP",286
9,"9112",109,85,85,0,0,"PP",41
37,"37112",161,112,111,2,1,"PP",64
40,"40005",30,23,23,0,0,"PP",19
9,"9196",149,103,103,1,0,"PP",48
49,"49042",244,178,176,1,2,"PP",105
24,"24225",1014,752,739,10,13,"PP",357
28,"28035",1353,1006,998,2,8,"PP",395
24,"24214",656,490,485,3,5,"PP",215
12,"12139",318,237,233,0,4,"PP",114
23,"23054",382,282,281,1,1,"PP",89
37,"37140",674,443,439,5,4,"PP",265
12,"12020",118,105,105,0,0,"PP",74
6,"6103",4796,3265,3220,20,45,"PP",1220
42,"42044",54,42,39,0,3,"PP",30
19,"19151",1064,744,726,1,18,"PP",299
37,"37322",2465,1592,1564,8,28,"PP",603
34,"34020",52,39,39,0,0,"PP",23
12,"12048",251,185,182,0,3,"PP",80
47,"47027",2745,2036,2018,9,18,"PP",709
10,"10091",371,287,284,0,3,"PP",129
16,"16901",675,506,501,6,5,"PP",266
19,"19054",192,164,164,1,0,"PP",93
29,"29083",2107,1540,1512,9,28,"PP",540
10,"10178",769,565,553,3,12,"PP",263
26,"26155",160,132,132,0,0,"PP",58
11,"11033",20903,12949,12771,164,178,"PP",4114
25,"25205",566,382,372,8,10,"PP",37
49,"49111",127,98,96,4,2,"PP",56
43,"43156",3946,2524,2470,28,54,"PP",461
12,"12114",198,144,144,1,0,"PP",62
25,"25006",340,201,200,6,1,"PP",23
6,"6030",169,137,135,0,2,"PP",61
37,"37067",3163,2496,2467,31,29,"PP",970
19,"19177",76,61,59,0,2,"PP",20
26,"26157",296,241,237,4,4,"PP",132
24,"24092",798,606,602,1,4,"PP",286
24,"24059",880,536,535,4,1,"PP",219
29,"29084",27359,17843,17627,176,216,"PP",6148
7,"7002",6341,4295,4255,39,40,"PP",1525
37,"37260",150,116,116,1,0,"PP",44
19,"19153",22,17,17,0,0,"PP",1
49,"49227",315,230,228,2,2,"PP",111
42,"42194",170,118,114,1,4,"PP",65
19,"19121",246,199,194,1,5,"PP",83
37,"37117",1494,1067,1048,3,19,"PP",403
37,"37283",123,92,90,0,2,"PP",47
6,"6153",20377,14329,14163,103,166,"PP",5529
47,"47182",1323,977,967,8,10,"PP",408
25,"25222",66,52,52,1,0,"PP",11
18,"18065",618,496,470,3,26,"PP",45
49,"49137",176,139,138,0,1,"PP",76
28,"28066",7182,5422,5371,17,51,"PP",2734
18,"18112",123,82,82,2,0,"PP",28
32,"32065",657,463,454,3,9,"PP",238
48,"48096",6577,4794,4728,31,66,"PP",293
39,"39056",2286,1714,1684,8,30,"PP",744
23,"23039",2204,1596,1558,11,38,"PP",522
37,"37342",259,189,186,0,3,"PP",101
34,"34224",47,37,37,1,0,"PP",20
43,"43124",482,308,307,2,1,"PP",27
19,"19058",6793,5258,5218,19,40,"PP",1814
49,"49088",87,61,60,0,1,"PP",41
28,"28095",1529,1119,1106,6,13,"PP",485
46,"46229",948,762,758,0,4,"PP",305
37,"37088",207,163,162,3,1,"PP",79
47,"47040",64,53,53,0,0,"PP",33
28,"28901",799,558,554,0,4,"PP",186
43,"43174",138,102,100,1,2,"PP",3
32,"32087",1765,1363,1343,13,20,"PP",838
19,"19080",65,41,41,0,0,"PP",25
49,"49115",184,136,135,0,1,"PP",78
42,"42207",40,33,32,0,1,"PP",18
45,"45110",1786,1403,1398,5,5,"PP",659
46,"46030",800,627,614,5,13,"PP",222
28,"28096",18354,13310,13205,68,105,"PP",5196
45,"45088",2115,1351,1338,4,13,"PP",505
47,"47204",256,204,198,0,6,"PP",105
49,"49116",383,276,269,3,7,"PP",160
29,"29081",261,197,197,1,0,"PP",104
36,"36038",66390,47750,47273,449,477,"PP",17474
37,"37358",159,135,133,0,2,"PP",75
32,"32003",885,654,649,5,5,"PP",392
46,"46227",905,711,702,1,9,"PP",161
18,"18048",2387,1683,1662,8,21,"PP",383
46,"46181",16955,12313,12148,95,165,"PP",4299
37,"37113",433,334,333,3,1,"PP",145
43,"43163",25248,15802,15663,104,139,"PP",2404
43,"43040",330,257,255,5,2,"PP",20
25,"25079",299,198,193,2,5,"PP",22
9,"9108",384,283,279,1,4,"PP",92
20,"20903",4330,2756,2734,28,22,"PP",164
26,"26056",419,338,332,1,6,"PP",151
28,"28013",40471,28739,28490,188,249,"PP",10670
24,"24009",322,153,152,2,1,"PP",65
24,"24175",1832,1314,1297,14,17,"PP",523
37,"37248",152,126,125,1,1,"PP",84
40,"40033",58,51,51,0,0,"PP",19
9,"9434",1227,922,909,6,13,"PP",341
10,"10060",967,648,640,2,8,"PP",257
46,"46261",1725,1356,1337,5,19,"PP",536
37,"37192",356,231,227,2,4,"PP",85
40,"40025",136,117,115,0,2,"PP",76
30,"30018",7978,5866,5811,30,55,"PP",2531
12,"12065",188,169,169,2,0,"PP",97
43,"43151",107,90,89,0,1,"PP",9
48,"48030",606,441,439,1,2,"PP",9
42,"42131",51,37,37,1,0,"PP",22
34,"34061",106,82,82,1,0,"PP",48
25,"25045",57,40,40,0,0,"PP",6
18,"18076",804,551,549,1,2,"PP",108
49,"49107",126,94,93,2,1,"PP",40
37,"37151",148,125,124,2,1,"PP",99
37,"37045",26,23,21,0,2,"PP",8
48,"48091",1121,771,765,7,6,"PP",34
38,"38043",18892,13089,12928,87,161,"PP",4531
46,"46172",5042,3504,3477,22,27,"PP",1215
43,"43003",324,217,217,3,0,"PP",34
40,"40040",2607,1843,1828,19,15,"PP",1013
49,"49124",253,174,169,1,5,"PP",89
24,"24137",1099,783,778,7,5,"PP",250
23,"23094",3839,3009,2954,14,55,"PP",599
6,"6142",273,205,197,2,8,"PP",43
19,"19261",37,25,24,0,1,"PP",17
37,"37278",732,532,528,3,4,"PP",170
26,"26007",511,384,375,0,9,"PP",134
37,"37023",1413,1072,1060,5,12,"PP",403
7,"7012",1876,1369,1353,13,16,"PP",438
47,"47001",55,46,46,0,0,"PP",35
47,"47061",256,212,211,2,1,"PP",94
17,"17082",417,255,253,2,2,"PP",30
32,"32044",876,643,634,2,9,"PP",327
48,"48063",372,279,277,2,2,"PP",9
24,"24067",623,388,384,0,4,"PP",255
30,"30001",4582,3620,3594,18,26,"PP",1979
25,"25231",486,330,330,4,0,"PP",31
46,"46225",337,290,281,5,9,"PP",109
29,"29901",43826,29318,29107,250,211,"PP",11010
45,"45120",129,104,104,1,0,"PP",39
47,"47159",822,644,636,1,8,"PP",275
37,"37373",748,503,499,1,4,"PP",150
24,"24108",376,280,277,2,3,"PP",164
6,"6028",4233,3588,3499,30,89,"PP",1475
12,"12131",63,52,52,0,0,"PP",38
6,"6029",1195,855,841,3,14,"PP",200
37,"37050",66,52,52,0,0,"PP",29
17,"17176",124,92,92,1,0,"PP",7
49,"49098",219,167,165,0,2,"PP",105
24,"24227",1607,1127,1116,22,11,"PP",486
36,"36049",6804,4960,4860,36,100,"PP",1954
20,"20027",2814,1761,1750,15,11,"PP",31
28,"28132",11685,8130,8062,56,68,"PP",2554
19,"19075",64,39,39,0,0,"PP",25
40,"40144",18,14,14,0,0,"PP",9
38,"38046",9113,6850,6775,40,75,"PP",2175
37,"37184",327,255,252,2,3,"PP",139
24,"24102",652,470,467,2,3,"PP",193
13,"13065",2854,1901,1888,9,13,"PP",1032
47,"47011",565,461,458,5,3,"PP",285
37,"37134",230,168,165,0,3,"PP",68
12,"12039",833,717,710,4,7,"PP",304
13,"13031",2452,1919,1909,11,10,"PP",884
38,"38034",4049,2855,2807,19,48,"PP",1143
40,"40063",7096,5184,5100,36,84,"PP",2251
43,"43090",1076,565,558,6,7,"PP",94
12,"12043",570,449,442,2,7,"PP",200
49,"49159",271,209,205,4,4,"PP",90
28,"28182",210,171,169,0,2,"PP",57
27,"27051",8108,5503,5424,62,79,"PP",2378
43,"43907",4374,2793,2783,24,10,"PP",402
23,"23046",2391,1916,1895,6,21,"PP",508
47,"47148",442,342,338,2,4,"PP",172
43,"43009",1403,918,905,14,13,"PP",52
34,"34025",57,39,39,1,0,"PP",25
45,"45164",182,162,160,1,2,"PP",89
40,"40060",82,61,61,0,0,"PP",45
30,"30024",58746,42036,41731,206,305,"PP",19227
49,"49148",260,137,134,1,3,"PP",56
40,"40165",77,65,64,1,1,"PP",33
42,"42050",31,18,18,0,0,"PP",16
47,"47165",6955,4955,4303,66,652,"PP",2149
42,"42158",103,76,76,0,0,"PP",34
46,"46188",672,544,537,8,7,"PP",167
32,"32081",2077,1517,1500,14,17,"PP",770
46,"46220",48410,34644,34292,279,352,"PP",9588
43,"43037",16781,10376,10265,71,111,"PP",1691
49,"49139",171,135,135,0,0,"PP",63
48,"48037",673,481,478,5,3,"PP",14
34,"34028",143,116,113,1,3,"PP",74
13,"13041",244,170,165,1,5,"PP",67
49,"49229",126,93,93,0,0,"PP",44
46,"46163",1866,1504,1480,8,24,"PP",489
37,"37179",209,180,180,0,0,"PP",112
19,"19127",89,64,64,0,0,"PP",46
37,"37237",324,244,240,1,4,"PP",90
46,"46160",1913,1452,1436,1,16,"PP",329
49,"49077",183,103,103,0,0,"PP",68
42,"42025",1189,844,833,2,11,"PP",364
7,"7047",2246,1517,1482,18,35,"PP",488
13,"13025",302,244,244,1,0,"PP",129
46,"46146",1654,1304,1278,7,26,"PP",446
25,"25051",1527,931,920,11,11,"PP",75
37,"37222",93,72,72,0,0,"PP",42
6,"6159",2329,1351,1318,16,33,"PP",359
16,"16063",97,85,84,1,1,"PP",42
46,"46175",456,389,387,3,2,"PP",150
39,"39015",839,647,642,4,5,"PP",368
6,"6057",576,479,471,0,8,"PP",242
24,"24056",2883,2040,2003,11,37,"PP",785
45,"45033",343,249,243,2,6,"PP",120
24,"24143",510,358,349,0,9,"PP",123
24,"24222",14256,9996,9884,101,112,"PP",3216
47,"47041",150,112,110,2,2,"PP",66
37,"37090",52,43,43,0,0,"PP",25
12,"12028",12586,9733,9676,62,57,"PP",3720
6,"6068",446,347,345,5,2,"PP",121
47,"47045",763,575,567,1,8,"PP",198
47,"47163",290,230,228,3,2,"PP",76
18,"18908",801,593,588,3,5,"PP",171
26,"26067",22,15,15,1,0,"PP",7
34,"34015",41,35,35,3,0,"PP",23
42,"42219",43,31,30,0,1,"PP",11
27,"27058",3495,2510,2480,30,30,"PP",1459
47,"47059",97,76,76,2,0,"PP",29
48,"48070",544,362,362,4,0,"PP",6
36,"36003",9980,7191,7110,67,81,"PP",3141
13,"13023",8973,6291,6242,44,49,"PP",4069
6,"6100",935,780,774,1,6,"PP",363
42,"42206",8,8,8,1,0,"PP",4
11,"11032",53874,31273,31008,348,265,"PP",9182
12,"12089",4328,3078,3020,15,58,"PP",1324
49,"49123",546,391,384,1,7,"PP",183
9,"9140",124,80,79,0,1,"PP",36
49,"49255",418,319,316,1,3,"PP",210
28,"28135",948,713,709,4,4,"PP",321
32,"32012",784,505,497,2,8,"PP",267
23,"23079",3717,2825,2801,28,24,"PP",1055
28,"28053",6498,4995,4955,28,40,"PP",1794
37,"37375",700,578,570,4,8,"PP",205
38,"38002",956,702,696,21,6,"PP",197
46,"46088",166,125,125,4,0,"PP",46
25,"25161",360,219,218,2,1,"PP",11
24,"24149",152,120,116,3,4,"PP",77
13,"13052",6422,4651,4580,46,71,"PP",2302
37,"37150",41,34,34,0,0,"PP",33
26,"26132",112,82,82,0,0,"PP",37
28,"28009",14086,10611,10545,57,66,"PP",4394
19,"19103",251,208,208,2,0,"PP",91
24,"24012",290,207,205,1,2,"PP",112
40,"40001",702,560,554,3,6,"PP",289
25,"25247",123,66,66,1,0,"PP",15
49,"49190",63,47,45,0,2,"PP",24
25,"25008",1124,715,702,10,13,"PP",96
9,"9398",75,56,56,0,0,"PP",31
29,"29904",421,338,335,3,3,"PP",24
47,"47014",51,45,45,0,0,"PP",26
47,"47231",4401,3299,3277,24,22,"PP",1175
27,"27037",1065,750,740,11,10,"PP",443
25,"25040",10546,6367,6300,61,67,"PP",851
7,"7004",3854,2574,2547,30,27,"PP",871
25,"25061",83,46,46,0,0,"PP",3
24,"24006",472,353,347,0,6,"PP",176
47,"47150",274,209,205,0,4,"PP",107
46,"46035",6822,5202,5142,43,60,"PP",1403
29,"29027",2326,1626,1609,12,17,"PP",626
24,"24216",723,522,518,1,4,"PP",321
41,"41033",5075,3313,3277,34,36,"PP",1031
38,"38021",1629,1033,1022,9,11,"PP",352
43,"43008",307,156,154,6,2,"PP",33
41,"41004",56640,37110,36649,440,461,"PP",9194
24,"24139",2183,1548,1525,16,23,"PP",730
11,"11026",4782,3451,3378,26,73,"PP",1225
16,"16113",3077,2225,2202,10,23,"PP",1079
12,"12081",608,486,480,5,6,"PP",198
40,"40003",139,107,104,0,3,"PP",78
29,"29028",1237,836,826,6,10,"PP",202
48,"48075",1996,1364,1359,6,5,"PP",80
42,"42081",145,102,100,1,2,"PP",52
12,"12067",537,435,427,0,8,"PP",189
25,"25210",1108,685,677,3,8,"PP",73
7,"7018",382,272,269,1,3,"PP",78
23,"23057",766,625,619,4,6,"PP",117
47,"47206",92,80,80,0,0,"PP",33
17,"17056",1715,1120,1106,16,14,"PP",69
18,"18106",425,293,290,0,3,"PP",96
39,"39090",756,553,542,0,11,"PP",231
28,"28168",1237,884,880,4,4,"PP",386
34,"34113",38,36,36,0,0,"PP",22
37,"37279",750,522,513,4,9,"PP",270
19,"19178",33,22,22,0,0,"PP",6
37,"37204",276,198,195,1,3,"PP",123
16,"16255",140,122,121,0,1,"PP",58
13,"13004",1025,807,800,4,7,"PP",381
45,"45192",2491,2069,2049,2,20,"PP",954
26,"26150",112,101,95,0,6,"PP",48
9,"9323",61,46,46,1,0,"PP",27
47,"47115",281,236,233,3,3,"PP",155
37,"37206",94,73,73,3,0,"PP",34
16,"16134",4371,3288,3254,20,34,"PP",1427
24,"24003",648,460,453,7,7,"PP",235
49,"49010",345,279,273,5,6,"PP",85
45,"45098",2159,1632,1609,12,23,"PP",1123
49,"49063",338,272,266,4,6,"PP",145
37,"37299",219,166,163,4,3,"PP",89
36,"36024",16455,11971,11781,109,190,"PP",6811
47,"47174",267,218,215,1,3,"PP",89
47,"47219",41,36,34,0,2,"PP",12
45,"45051",1590,1171,1152,5,19,"PP",497
45,"45091",394,269,267,3,2,"PP",95
18,"18101",9265,6618,6560,59,58,"PP",2274
48,"48066",348,258,258,1,0,"PP",5
37,"37262",78,64,63,0,1,"PP",52
46,"46156",2080,1697,1675,10,22,"PP",611
12,"12071",1274,992,979,3,13,"PP",405
41,"41019",4691,3089,3056,27,33,"PP",822
26,"26009",401,325,321,4,4,"PP",143
46,"46189",467,393,390,2,3,"PP",98
37,"37110",113,86,86,1,0,"PP",44
19,"19120",101,88,88,1,0,"PP",50
13,"13011",4792,3112,3077,14,35,"PP",1087
40,"40166",253,218,215,1,3,"PP",142
12,"12138",19061,13010,12847,129,163,"PP",3890
48,"48054",24171,16797,16711,118,86,"PP",2217
42,"42075",83,62,62,0,0,"PP",35
13,"13012",413,274,273,1,1,"PP",93
40,"40084",62,55,52,0,3,"PP",29
37,"37303",190,142,139,1,3,"PP",63
9,"9328",76,56,56,0,0,"PP",31
16,"16245",419,327,323,7,4,"PP",152
43,"43067",552,397,393,2,4,"PP",27
37,"37001",192,151,148,0,3,"PP",78
23,"23099",4769,3359,3309,16,50,"PP",1364
11,"11001",4358,2816,2767,11,49,"PP",737
19,"19171",4961,3670,3628,27,42,"PP",1057
24,"24100",761,561,555,7,6,"PP",259
6,"6113",2721,2004,1971,7,33,"PP",710
37,"37350",420,318,314,5,4,"PP",204
11,"11039",10018,6186,6109,103,77,"PP",2348
27,"27046",1530,1022,1007,9,15,"PP",428
7,"7059",2996,2053,2013,17,40,"PP",884
28,"28128",444,315,314,0,1,"PP",132
13,"13033",1633,1328,1290,4,38,"PP",458
9,"9144",53,40,40,0,0,"PP",28
28,"28110",1944,1478,1463,4,15,"PP",656
25,"25041",568,347,344,4,3,"PP",41
42,"42082",8,8,8,1,0,"PP",4
19,"19079",8,8,7,0,1,"PP",7
46,"46259",491,396,393,4,3,"PP",145
38,"38033",3702,2505,2464,8,41,"PP",929
37,"37258",172,116,115,3,1,"PP",59
18,"18189",776,581,574,4,7,"PP",178
49,"49032",326,259,259,1,0,"PP",161
47,"47179",395,293,287,0,6,"PP",133
37,"37266",82,63,63,2,0,"PP",39
25,"25212",233,154,153,6,1,"PP",15
24,"24132",615,379,375,1,4,"PP",192
19,"19102",98,79,78,0,1,"PP",41
46,"46010",935,729,723,4,6,"PP",242
13,"13029",84,71,71,0,0,"PP",33
47,"47069",124,105,104,1,1,"PP",53
13,"13076",484,400,394,1,6,"PP",206
46,"46222",384,307,304,1,3,"PP",61
47,"47018",34,28,28,0,0,"PP",25
45,"45012",661,510,503,6,7,"PP",252
49,"49258",114,93,91,2,2,"PP",46
37,"37304",169,124,124,0,0,"PP",87
17,"17164",3982,2363,2350,11,13,"PP",142
20,"20066",454,236,234,1,2,"PP",0
48,"48903",1835,1361,1351,7,10,"PP",169
42,"42208",22,13,13,2,0,"PP",8
13,"13061",5702,3867,3822,28,45,"PP",1598
10,"10113",2338,1679,1638,9,41,"PP",518
29,"29038",17676,11056,10970,141,86,"PP",3061
37,"37288",262,182,181,4,1,"PP",94
32,"32085",10716,7279,7152,66,127,"PP",3541
18,"18114",609,424,422,8,2,"PP",124
49,"49259",89,66,65,1,1,"PP",53
47,"47087",381,301,297,3,4,"PP",125
13,"13021",434,365,363,4,2,"PP",163
48,"48912",2308,1707,1679,14,28,"PP",84
46,"46248",4897,3596,3544,18,52,"PP",1416
18,"18193",14343,9951,9847,93,104,"PP",3271
43,"43113",393,279,278,5,1,"PP",30
19,"19146",41,35,32,0,3,"PP",8
25,"25907",494,266,265,6,1,"PP",34
42,"42039",226,138,138,4,0,"PP",53
32,"32046",1160,787,779,4,8,"PP",430
45,"45092",232,197,191,0,6,"PP",114
45,"45032",436,283,275,1,8,"PP",93
37,"37351",281,229,227,0,2,"PP",122
10,"10128",5697,3958,3891,32,67,"PP",1488
37,"37028",147,116,112,0,4,"PP",81
46,"46199",5718,4314,4266,28,48,"PP",1579
13,"13003",480,382,380,1,2,"PP",189
37,"37174",1056,820,812,3,8,"PP",412
38,"38040",5021,3136,3102,14,34,"PP",1507
18,"18093",2750,1793,1776,7,17,"PP",705
37,"37356",87,67,65,0,2,"PP",36
23,"23064",1655,1363,1353,1,10,"PP",601
12,"12051",471,339,335,1,4,"PP",260
32,"32016",790,550,543,2,7,"PP",241
45,"45084",2257,1679,1656,13,23,"PP",665
36,"36044",2541,1674,1646,7,28,"PP",756
16,"16189",264,206,205,4,1,"PP",120
45,"45094",387,298,297,1,1,"PP",138
40,"40030",473,369,363,3,6,"PP",146
8,"8101",174621,113632,112942,847,690,"PP",18585
8,"8241",73,52,52,0,0,"PP",7
8,"8219",15422,10701,10619,98,82,"PP",1149
8,"8250",7061,4480,4448,48,32,"PP",670
8,"8174",392,283,279,3,4,"PP",19
8,"8132",383,213,212,4,1,"PP",21
8,"8121",86351,57040,56655,446,385,"PP",8206
8,"8185",188,123,122,2,1,"PP",19
8,"8224",820,557,551,2,6,"PP",46
8,"8091",5244,3611,3584,17,27,"PP",336
8,"8103",625,395,395,2,0,"PP",45
8,"8118",17547,12183,12108,105,75,"PP",1358
8,"8007",6483,4281,4250,33,31,"PP",327
8,"8200",61409,41278,41024,312,254,"PP",5287
8,"8077",34508,24070,23956,127,114,"PP",4304
8,"8060",144,87,87,0,0,"PP",16
8,"8245",78562,50821,50538,384,283,"PP",8025
8,"8205",59828,43344,43140,367,204,"PP",6273
8,"8011",1756,1087,1082,16,5,"PP",51
8,"8059",347,195,195,2,0,"PP",12
8,"8157",8382,5823,5789,45,34,"PP",715
8,"8116",578,387,383,2,4,"PP",19
8,"8163",18641,11801,11729,68,72,"PP",1932
8,"8106",7279,4871,4845,40,26,"PP",582
8,"8308",131,87,87,1,0,"PP",2
8,"8240",9348,6512,6483,38,29,"PP",489
8,"8204",3055,2094,2082,17,12,"PP",155
8,"8273",2333,1654,1637,10,17,"PP",113
8,"8217",24989,17765,17661,114,104,"PP",2303
8,"8304",812,562,558,3,4,"PP",29
8,"8223",1852,1182,1171,12,11,"PP",102
8,"8117",2450,1602,1594,11,8,"PP",119
8,"8158",3082,2054,2041,21,13,"PP",179
8,"8210",4329,2624,2594,31,30,"PP",197
8,"8063",453,337,336,4,1,"PP",12
8,"8114",18292,12102,12009,72,93,"PP",1462
8,"8181",7887,5178,5144,48,34,"PP",626
8,"8110",13315,8457,8368,73,89,"PP",977
8,"8016",1831,1136,1129,19,7,"PP",83
8,"8122",1698,1080,1073,5,7,"PP",90
8,"8176",156,109,107,2,2,"PP",19
8,"8172",20326,13875,13802,92,73,"PP",1652
8,"8230",7635,5177,5121,54,56,"PP",743
8,"8140",4774,3118,3098,23,20,"PP",286
8,"8036",163,105,104,1,1,"PP",7
8,"8037",1864,1242,1230,14,12,"PP",65
8,"8081",339,222,221,3,1,"PP",9
8,"8076",16169,10652,10563,75,89,"PP",1264
8,"8152",114,80,79,0,1,"PP",3
8,"8133",128,72,72,0,0,"PP",18
8,"8199",663,456,453,14,3,"PP",33
8,"8254",1739,1159,1156,10,3,"PP",33
8,"8256",650,484,484,5,0,"PP",50
8,"8120",6835,4708,4688,44,20,"PP",648
8,"8042",2231,1565,1558,17,7,"PP",232
8,"8159",14096,9393,9347,76,46,"PP",1069
8,"8113",52035,32351,32150,254,201,"PP",3396
8,"8232",1775,1183,1176,6,7,"PP",83
8,"8901",227,148,145,1,3,"PP",4
8,"8108",5016,3501,3474,21,27,"PP",587
8,"8019",1136351,768170,764030,5799,4140,"PP",116255
8,"8285",10224,6396,6342,52,54,"PP",364
8,"8904",10553,6623,6579,52,44,"PP",1013
8,"8282",6578,4714,4690,45,24,"PP",503
8,"8188",115,78,78,0,0,"PP",8
8,"8294",1966,1287,1280,17,7,"PP",93
8,"8244",5851,4095,4058,36,37,"PP",382
8,"8062",956,619,618,4,1,"PP",62
8,"8150",255,186,186,1,0,"PP",10
8,"8228",301,199,197,6,2,"PP",17
8,"8090",128,101,101,2,0,"PP",8
8,"8104",679,432,430,3,2,"PP",29
8,"8258",830,557,551,6,6,"PP",21
8,"8295",10870,6972,6918,51,54,"PP",922
8,"8064",1847,1245,1230,9,15,"PP",66
8,"8209",6773,4410,4382,29,28,"PP",738
8,"8220",2356,1690,1683,18,7,"PP",69
8,"8903",214,166,165,0,1,"PP",4
8,"8291",4536,2975,2965,21,10,"PP",314
8,"8299",391,244,244,5,0,"PP",15
8,"8229",535,357,354,9,3,"PP",30
8,"8006",11470,7210,7132,60,78,"PP",835
8,"8213",6319,3950,3935,37,15,"PP",352
8,"8109",216,162,161,0,1,"PP",11
8,"8191",5239,3454,3438,27,16,"PP",289
8,"8046",13290,9054,9000,103,54,"PP",851
8,"8030",5122,3482,3466,21,16,"PP",414
8,"8067",5739,3616,3577,47,39,"PP",264
8,"8182",2811,1799,1789,22,10,"PP",200
8,"8052",141,88,88,0,0,"PP",7
8,"8092",3736,2369,2342,13,27,"PP",192
8,"8253",131,81,81,2,0,"PP",0
8,"8080",34,26,26,3,0,"PP",5
8,"8246",1665,1086,1078,9,8,"PP",44
8,"8023",6734,4350,4323,35,27,"PP",538
8,"8127",2225,1349,1334,14,15,"PP",154
8,"8073",61814,42275,42025,294,250,"PP",6067
8,"8255",134,78,78,0,0,"PP",0
8,"8905",2346,1689,1681,26,8,"PP",147
8,"8281",4802,3343,3318,17,25,"PP",339
8,"8259",6637,4611,4577,39,34,"PP",414
8,"8155",6730,4353,4320,39,33,"PP",484
8,"8102",28296,18466,18367,172,99,"PP",2071
8,"8026",188,134,134,0,0,"PP",12
8,"8041",10343,6645,6582,57,63,"PP",1092
8,"8207",1865,1407,1402,19,5,"PP",60
8,"8009",9180,6207,6192,50,15,"PP",783
8,"8056",42140,28129,27977,257,152,"PP",5275
8,"8051",17948,12140,12076,102,64,"PP",1208
8,"8296",1777,1237,1231,7,6,"PP",171
8,"8283",5963,3670,3642,24,28,"PP",273
8,"8131",704,471,468,7,3,"PP",24
8,"8196",19233,12733,12671,94,62,"PP",1685
8,"8137",262,188,187,2,1,"PP",12
8,"8125",25081,16406,16329,164,77,"PP",1984
8,"8201",442,278,278,4,0,"PP",17
8,"8029",3480,2472,2460,25,12,"PP",320
8,"8010",4168,2631,2606,20,25,"PP",193
8,"8242",219,153,153,4,0,"PP",12
8,"8307",48295,32010,31798,195,212,"PP",3428
8,"8171",2103,1288,1280,12,8,"PP",90
8,"8130",95,56,55,0,1,"PP",5
8,"8277",157,108,107,0,1,"PP",8
8,"8215",2588,1663,1647,16,16,"PP",138
8,"8162",2047,1400,1392,7,8,"PP",157
8,"8027",687,486,485,2,1,"PP",38
8,"8263",20972,13710,13583,149,127,"PP",1903
8,"8902",3761,2570,2558,31,12,"PP",317
8,"8278",4779,3161,3148,20,13,"PP",150
8,"8226",891,648,645,6,3,"PP",40
8,"8145",2599,1774,1761,11,13,"PP",134
8,"8267",6461,4265,4245,51,20,"PP",396
8,"8276",237,165,165,2,0,"PP",10
8,"8286",2879,1802,1797,14,5,"PP",245
8,"8100",2001,1395,1380,25,15,"PP",79
8,"8038",1487,959,954,15,5,"PP",64
8,"8167",5910,4081,4051,40,30,"PP",464
8,"8164",913,618,609,7,9,"PP",40
8,"8144",717,447,437,5,10,"PP",45
8,"8129",462,319,316,3,3,"PP",14
8,"8094",1559,1112,1097,14,15,"PP",98
8,"8135",6677,4813,4775,51,38,"PP",703
8,"8147",16967,11220,11138,65,82,"PP",1123
8,"8175",3347,2080,2064,20,16,"PP",187
8,"8189",127,90,89,3,1,"PP",5
8,"8032",1981,1319,1311,11,8,"PP",138
8,"8268",1005,665,659,4,6,"PP",60
8,"8187",152377,102805,102199,805,606,"PP",11691
8,"8119",6180,4155,4123,28,32,"PP",544
8,"8290",1507,1118,1110,12,8,"PP",69
8,"8151",466,288,287,2,1,"PP",19
8,"8031",2322,1552,1537,6,15,"PP",170
8,"8050",141,99,99,2,0,"PP",2
8,"8095",73,48,47,0,1,"PP",2
8,"8065",1176,797,784,10,13,"PP",63
8,"8292",1072,730,725,6,5,"PP",70
8,"8088",11899,8149,8097,69,52,"PP",720
8,"8212",488,319,316,0,3,"PP",21
8,"8203",2390,1466,1456,8,10,"PP",164
8,"8221",12368,8798,8763,67,35,"PP",1284
8,"8214",6872,4699,4675,47,24,"PP",484
8,"8022",12212,7210,7155,66,55,"PP",548
8,"8287",1048,736,735,2,1,"PP",32
8,"8227",2326,1508,1487,20,21,"PP",121
8,"8218",8009,5105,5075,59,30,"PP",492
8,"8206",728,523,515,5,8,"PP",32
8,"8233",1871,1153,1140,16,13,"PP",45
8,"8070",266,194,191,2,3,"PP",7
8,"8005",6205,4187,4167,22,20,"PP",461
8,"8146",1286,885,881,12,4,"PP",108
8,"8301",48557,32715,32533,253,182,"PP",4654
8,"8003",7084,4839,4803,39,36,"PP",694
8,"8166",991,631,625,7,6,"PP",53
8,"8165",1649,1100,1085,9,15,"PP",106
8,"8193",944,601,596,12,5,"PP",71
8,"8284",12097,7157,7089,59,68,"PP",779
8,"8269",2673,1788,1776,14,12,"PP",100
8,"8270",18490,12343,12274,93,69,"PP",1969
8,"8170",450,276,274,7,2,"PP",22
8,"8148",2233,1491,1483,7,8,"PP",229
8,"8264",4325,2929,2908,26,21,"PP",436
8,"8054",8998,6172,6129,44,43,"PP",743
8,"8089",33850,22230,22096,170,134,"PP",3324
8,"8234",3200,2128,2114,21,14,"PP",198
8,"8111",218,185,184,3,1,"PP",12
8,"8105",9630,6394,6339,49,55,"PP",1013
8,"8044",4141,2739,2726,15,13,"PP",310
8,"8289",4338,2912,2898,27,14,"PP",221
8,"8072",10259,6462,6422,42,40,"PP",829
8,"8001",8907,6316,6269,46,47,"PP",865
8,"8249",266,211,209,2,2,"PP",7
8,"8237",1643,1105,1096,8,9,"PP",57
8,"8068",6718,4373,4343,33,30,"PP",614
8,"8087",152,121,121,2,0,"PP",8
8,"8082",1139,711,708,4,3,"PP",110
8,"8136",11450,7703,7641,84,62,"PP",1201
8,"8128",563,375,372,2,3,"PP",22
8,"8251",4984,3257,3241,17,16,"PP",364
8,"8190",256,168,165,2,3,"PP",17
8,"8098",2381,1544,1534,5,10,"PP",181
8,"8248",5419,3566,3546,45,20,"PP",382
8,"8084",1142,773,768,14,5,"PP",60
8,"8069",3169,2161,2148,32,13,"PP",256
8,"8086",13582,8612,8557,75,55,"PP",996
8,"8083",1675,1146,1144,9,2,"PP",32
8,"8252",24570,17009,16901,145,108,"PP",2454
8,"8169",47759,32651,32439,243,212,"PP",4209
8,"8107",11502,7510,7445,67,65,"PP",1123
8,"8272",151,90,90,1,0,"PP",0
8,"8231",20564,13037,12952,96,85,"PP",1656
8,"8298",26471,16674,16591,139,83,"PP",1320
8,"8168",358,231,231,5,0,"PP",65
8,"8085",1000,662,658,5,4,"PP",59
8,"8208",5732,3976,3952,30,24,"PP",450
8,"8194",25660,15045,14941,122,104,"PP",2440
8,"8247",961,637,634,4,3,"PP",29
8,"8123",19140,13557,13484,106,73,"PP",1174
8,"8161",11144,6994,6938,73,56,"PP",923
8,"8053",2788,1605,1591,8,14,"PP",179
8,"8015",155409,99368,98735,820,633,"PP",16445
8,"8045",73,37,35,0,2,"PP",0
8,"8303",274,193,192,2,1,"PP",5
8,"8074",10611,6728,6679,52,49,"PP",898
8,"8154",696,494,488,5,6,"PP",45
8,"8293",219,168,167,0,1,"PP",6
8,"8274",4665,3028,3009,26,19,"PP",251
8,"8008",190,110,110,5,0,"PP",9
8,"8039",362,266,266,0,0,"PP",14
8,"8071",240,163,162,5,1,"PP",7
8,"8002",201,130,124,0,6,"PP",8
8,"8049",1293,790,779,3,11,"PP",54
8,"8139",175,132,132,2,0,"PP",1
8,"8043",3201,2056,2041,9,15,"PP",275
8,"8260",18335,12325,12263,106,62,"PP",1639
8,"8211",33081,23576,23413,226,163,"PP",3173
8,"8093",27,21,21,0,0,"PP",0
8,"8156",10891,7322,7259,43,63,"PP",914
8,"8033",12813,8564,8509,63,55,"PP",961
8,"8216",25,15,15,1,0,"PP",0
8,"8025",1490,981,978,4,3,"PP",111
8,"8279",153025,101133,100621,840,512,"PP",12355
8,"8180",26613,17585,17490,153,95,"PP",2387
8,"8149",993,569,567,10,2,"PP",40
8,"8192",5678,3729,3707,35,22,"PP",297
8,"8096",42622,28797,28615,263,182,"PP",3588
8,"8018",2636,1690,1675,23,15,"PP",109
8,"8040",10710,6845,6802,51,43,"PP",829
8,"8035",12547,7877,7828,51,49,"PP",950
8,"8012",1672,1075,1061,17,14,"PP",63
8,"8271",70,48,48,0,0,"PP",2
8,"8239",453,304,302,3,2,"PP",27
8,"8197",7648,5020,5000,37,20,"PP",875
8,"8047",3899,2292,2260,16,32,"PP",329
8,"8243",162,113,113,7,0,"PP",3
8,"8134",810,541,538,7,3,"PP",52
8,"8288",1659,1004,994,7,10,"PP",118
8,"8099",749,487,485,2,2,"PP",34
8,"8222",1895,1358,1351,14,7,"PP",115
8,"8153",538,386,385,2,1,"PP",24
8,"8004",223,165,164,2,1,"PP",0
8,"8066",1365,926,921,8,5,"PP",119
8,"8280",97,66,66,2,0,"PP",2
8,"8034",763,538,537,1,1,"PP",46
8,"8265",1553,1028,1018,11,10,"PP",34
8,"8024",386,243,236,0,7,"PP",18
8,"8195",82,63,63,0,0,"PP",4
8,"8014",1962,1366,1359,15,7,"PP",117
8,"8236",1527,1006,999,4,7,"PP",105
8,"8300",5678,3983,3964,35,19,"PP",490
8,"8055",519,331,327,4,4,"PP",22
8,"8177",40,30,30,0,0,"PP",2
8,"8257",107,71,71,0,0,"PP",1
8,"8048",582,419,417,4,2,"PP",30
8,"8198",4411,2972,2954,23,18,"PP",275
8,"8097",1021,715,712,8,3,"PP",34
8,"8115",3799,2589,2572,17,17,"PP",298
8,"8305",27339,17960,17809,147,151,"PP",1756
8,"8179",579,396,396,5,0,"PP",28
8,"8079",343,256,255,4,1,"PP",12
8,"8013",1224,802,793,9,9,"PP",64
8,"8028",1024,648,644,4,4,"PP",97
8,"8266",43030,30192,30039,229,153,"PP",4071
8,"8225",92,66,66,4,0,"PP",2
8,"8202",12680,8341,8278,75,63,"PP",811
8,"8078",219,112,111,3,1,"PP",6
8,"8124",36804,24782,24632,184,150,"PP",2922
8,"8075",3883,2479,2467,14,12,"PP",358
8,"8275",247,179,179,4,0,"PP",7
8,"8184",53822,34744,34545,264,199,"PP",4627
8,"8126",8748,5927,5895,56,32,"PP",681
8,"8306",506,299,297,5,2,"PP",32
8,"8112",12911,7790,7723,74,67,"PP",661
8,"8057",60,45,44,1,1,"PP",0
8,"8017",2762,1701,1688,9,13,"PP",117
8,"8262",6836,4175,4144,50,31,"PP",444
8,"8143",2682,1718,1707,17,11,"PP",202
8,"8138",4248,2638,2618,27,20,"PP",184
8,"8235",3686,2488,2470,16,18,"PP",182
8,"8141",4563,2953,2929,34,24,"PP",259
8,"8261",2327,1499,1493,11,6,"PP",209
8,"8302",9218,5946,5891,82,55,"PP",834
8,"8238",14531,10378,10325,98,53,"PP",1146
8,"8178",435,309,308,4,1,"PP",31
8,"8297",134,85,84,0,1,"PP",5
8,"8160",327,208,208,1,0,"PP",11
8,"8058",1730,1102,1095,6,7,"PP",131
8,"8061",1497,986,983,14,3,"PP",127
8,"8142",133,103,101,5,2,"PP",2
8,"8020",4926,3523,3502,33,21,"PP",360
8,"8183",4550,2809,2796,20,13,"PP",152
8,"8021",70,49,46,0,3,"PP",5
33,"33034",10612,6602,6536,62,66,"PP-FORO",2842
33,"33065",1102,722,713,7,9,"PP-FORO",308
33,"33002",9995,6765,6672,47,93,"PP-FORO",2201
33,"33013",446,321,318,3,3,"PP-FORO",146
33,"33026",8530,5397,5337,48,60,"PP-FORO",1953
33,"33009",905,611,609,3,2,"PP-FORO",246
33,"33040",4549,2986,2942,35,44,"PP-FORO",1067
33,"33041",7199,4922,4877,52,45,"PP-FORO",1792
33,"33061",378,202,200,0,2,"PP-FORO",83
33,"33020",13307,9011,8914,99,97,"PP-FORO",2526
33,"33042",4306,2988,2970,35,18,"PP-FORO",1080
33,"33021",4573,3024,2971,22,53,"PP-FORO",1164
33,"33015",1540,998,986,8,12,"PP-FORO",348
33,"33062",400,238,233,2,5,"PP-FORO",76
33,"33019",3072,2020,2005,18,15,"PP-FORO",921
33,"33059",4646,3075,3033,29,42,"PP-FORO",1518
33,"33060",14633,9647,9474,72,173,"PP-FORO",2189
33,"33001",1588,887,880,8,7,"PP-FORO",445
33,"33068",1093,645,641,4,4,"PP-FORO",248
33,"33063",415,320,318,3,2,"PP-FORO",174
33,"33036",11542,8062,7987,60,75,"PP-FORO",3210
33,"33052",721,485,482,3,3,"PP-FORO",157
33,"33051",7061,4640,4587,27,53,"PP-FORO",1926
33,"33039",1655,1223,1209,12,14,"PP-FORO",411
33,"33069",3491,2430,2390,17,40,"PP-FORO",892
33,"33030",895,669,666,9,3,"PP-FORO",296
33,"33012",5201,3466,3432,25,34,"PP-FORO",1593
33,"33014",9037,5999,5938,53,61,"PP-FORO",1795
33,"33044",178278,125469,124554,1124,915,"PP-FORO",50887
33,"33037",34454,22881,22586,243,295,"PP-FORO",5678
33,"33010",1822,1190,1180,17,10,"PP-FORO",381
33,"33046",499,379,367,5,12,"PP-FORO",217
33,"33067",784,587,579,9,8,"PP-FORO",163
33,"33024",226679,158750,157564,1209,1186,"PP-FORO",51127
33,"33072",1566,1008,994,11,14,"PP-FORO",323
33,"33045",4487,3057,2999,28,58,"PP-FORO",1075
33,"33028",1276,649,641,4,8,"PP-FORO",243
33,"33022",893,578,567,11,11,"PP-FORO",142
33,"33055",1514,1109,1092,5,17,"PP-FORO",449
33,"33047",1107,852,843,9,9,"PP-FORO",457
33,"33074",3484,2298,2274,24,24,"PP-FORO",975
33,"33031",35120,22295,22024,271,271,"PP-FORO",5571
33,"33057",1593,1063,1049,16,14,"PP-FORO",293
33,"33025",9174,5838,5786,57,52,"PP-FORO",2019
33,"33071",595,433,430,10,3,"PP-FORO",148
33,"33048",154,95,94,0,1,"PP-FORO",46
33,"33070",3351,2403,2373,26,30,"PP-FORO",912
33,"33058",1796,1232,1209,11,23,"PP-FORO",242
33,"33050",592,387,376,2,11,"PP-FORO",161
33,"33006",1540,1010,1003,5,7,"PP-FORO",261
33,"33016",19130,13666,13526,125,140,"PP-FORO",5016
33,"33038",2303,1584,1559,13,25,"PP-FORO",413
33,"33078",142,101,99,0,2,"PP-FORO",39
33,"33017",3144,2094,2071,35,23,"PP-FORO",837
33,"33064",234,168,167,1,1,"PP-FORO",51
33,"33023",3321,2299,2265,31,34,"PP-FORO",854
33,"33011",11260,6250,6163,83,87,"PP-FORO",2884
33,"33027",834,506,498,4,8,"PP-FORO",174
33,"33029",350,181,174,2,7,"PP-FORO",50
33,"33008",1777,1238,1229,3,9,"PP-FORO",557
33,"33033",9873,6512,6431,68,81,"PP-FORO",1856
33,"33073",8554,4945,4884,41,61,"PP-FORO",2361
33,"33077",1192,811,808,5,3,"PP-FORO",485
33,"33053",1141,742,732,6,10,"PP-FORO",181
33,"33035",11284,7681,7618,70,63,"PP-FORO",2727
33,"33075",271,154,153,2,1,"PP-FORO",59
33,"33003",646,355,352,9,3,"PP-FORO",154
33,"33005",1449,936,924,11,12,"PP-FORO",405
33,"33043",683,446,441,2,5,"PP-FORO",151
33,"33054",1682,1159,1149,12,10,"PP-FORO",454
33,"33049",6322,4116,4062,43,54,"PP-FORO",1537
33,"33056",4997,3269,3244,22,25,"PP-FORO",1424
33,"33004",66857,46390,45960,426,430,"PP-FORO",15145
33,"33018",2901,2000,1976,18,24,"PP-FORO",871
33,"33076",12258,8106,8031,63,75,"PP-FORO",3672
33,"33007",1514,946,942,12,4,"PP-FORO",376
33,"33066",42963,28564,28282,300,282,"PP-FORO",9813
33,"33032",11395,7592,7465,90,127,"PP-FORO",1962
22,"22008",173,137,133,3,4,"PP-PAR",72
44,"44029",559,425,424,5,1,"PP-PAR",151
44,"44096",161,138,135,3,3,"PP-PAR",49
50,"50175",1002,695,688,5,7,"PP-PAR",214
50,"50143",566,394,391,6,3,"PP-PAR",156
22,"22217",385,287,281,1,6,"PP-PAR",103
44,"44105",82,64,64,0,0,"PP-PAR",23
22,"22230",284,216,216,1,0,"PP-PAR",80
50,"50294",70,63,63,0,0,"PP-PAR",32
50,"50278",197,145,145,0,0,"PP-PAR",77
44,"44247",316,218,215,3,3,"PP-PAR",84
44,"44257",166,123,119,1,4,"PP-PAR",53
44,"44114",243,178,173,0,5,"PP-PAR",74
22,"22077",379,279,273,2,6,"PP-PAR",100
22,"22049",78,64,64,0,0,"PP-PAR",34
22,"22003",137,110,107,1,3,"PP-PAR",46
50,"50256",83,53,53,0,0,"PP-PAR",39
22,"22189",185,145,144,5,1,"PP-PAR",59
22,"22013",288,216,210,3,6,"PP-PAR",77
44,"44263",376,266,263,3,3,"PP-PAR",90
22,"22184",184,155,155,3,0,"PP-PAR",77
44,"44187",201,152,149,4,3,"PP-PAR",80
22,"22115",360,257,256,3,1,"PP-PAR",122
44,"44049",849,616,604,9,12,"PP-PAR",264
50,"50017",1773,1276,1269,13,7,"PP-PAR",442
44,"44050",3113,2120,2100,25,20,"PP-PAR",947
50,"50022",530,397,390,7,7,"PP-PAR",207
50,"50032",261,189,189,5,0,"PP-PAR",66
50,"50043",253,171,171,0,0,"PP-PAR",70
50,"50083",89,75,75,1,0,"PP-PAR",14
44,"44017",285,227,223,4,4,"PP-PAR",89
44,"44010",175,130,128,1,2,"PP-PAR",54
50,"50237",101,74,73,1,1,"PP-PAR",33
44,"44227",74,63,62,0,1,"PP-PAR",36
50,"50142",26,17,17,0,0,"PP-PAR",2
50,"50263",193,121,121,0,0,"PP-PAR",43
50,"50228",268,210,208,5,2,"PP-PAR",119
22,"22199",7000,4737,4688,104,49,"PP-PAR",1368
44,"44108",320,222,222,1,0,"PP-PAR",95
44,"44154",256,192,188,3,4,"PP-PAR",96
44,"44080",292,229,223,3,6,"PP-PAR",71
22,"22218",43,33,33,0,0,"PP-PAR",12
22,"22202",141,119,119,0,0,"PP-PAR",37
22,"22213",3003,2169,2131,19,38,"PP-PAR",843
50,"50243",331,250,246,0,4,"PP-PAR",121
44,"44152",64,46,45,0,1,"PP-PAR",37
44,"44236",63,48,47,0,1,"PP-PAR",29
44,"44024",27,25,25,0,0,"PP-PAR",18
22,"22908",197,142,140,3,2,"PP-PAR",44
50,"50061",202,172,172,3,0,"PP-PAR",86
44,"44135",113,88,87,0,1,"PP-PAR",43
50,"50213",94,75,74,0,1,"PP-PAR",56
44,"44074",429,333,326,4,7,"PP-PAR",163
50,"50080",33,27,27,0,0,"PP-PAR",7
22,"22128",188,146,144,3,2,"PP-PAR",65
44,"44021",107,89,88,0,1,"PP-PAR",44
50,"50202",152,100,99,1,1,"PP-PAR",54
22,"22221",84,58,58,0,0,"PP-PAR",23
44,"44246",1543,1045,1027,12,18,"PP-PAR",366
22,"22020",115,86,86,1,0,"PP-PAR",36
50,"50078",235,177,173,0,4,"PP-PAR",58
44,"44110",49,42,42,1,0,"PP-PAR",29
50,"50002",143,108,104,1,4,"PP-PAR",72
44,"44261",739,536,529,6,7,"PP-PAR",214
50,"50089",8225,6074,6043,43,31,"PP-PAR",2163
44,"44147",412,298,293,5,5,"PP-PAR",121
44,"44122",1333,925,913,8,12,"PP-PAR",383
50,"50234",243,189,185,6,4,"PP-PAR",87
50,"50216",235,186,184,5,2,"PP-PAR",101
50,"50063",61,51,51,0,0,"PP-PAR",20
44,"44130",34,24,24,0,0,"PP-PAR",15
50,"50074",6366,4230,4165,31,65,"PP-PAR",1247
22,"22131",82,63,63,0,0,"PP-PAR",17
50,"50255",209,163,163,5,0,"PP-PAR",23
44,"44210",746,554,545,3,9,"PP-PAR",205
44,"44222",131,98,98,0,0,"PP-PAR",52
22,"22083",463,394,390,5,4,"PP-PAR",175
44,"44164",27,23,23,0,0,"PP-PAR",13
50,"50174",91,69,68,0,1,"PP-PAR",42
44,"44158",1180,876,862,10,14,"PP-PAR",367
50,"50050",98,64,64,2,0,"PP-PAR",15
50,"50241",588,415,410,4,5,"PP-PAR",206
44,"44094",113,94,94,0,0,"PP-PAR",62
44,"44003",19,17,17,0,0,"PP-PAR",10
44,"44220",121,84,83,1,1,"PP-PAR",53
50,"50013",219,180,180,0,0,"PP-PAR",69
22,"22019",180,151,150,2,1,"PP-PAR",44
44,"44048",61,52,52,0,0,"PP-PAR",27
50,"50157",290,220,218,3,2,"PP-PAR",84
50,"50071",132,92,92,0,0,"PP-PAR",75
44,"44172",301,218,216,4,2,"PP-PAR",131
50,"50040",89,75,75,0,0,"PP-PAR",36
44,"44052",77,56,56,0,0,"PP-PAR",33
50,"50047",48,36,36,0,0,"PP-PAR",10
50,"50230",1165,833,828,8,5,"PP-PAR",360
50,"50172",193,132,129,1,3,"PP-PAR",61
44,"44119",130,92,91,3,1,"PP-PAR",24
50,"50119",927,724,713,5,11,"PP-PAR",321
22,"22085",104,86,86,0,0,"PP-PAR",25
44,"44004",408,303,297,0,6,"PP-PAR",133
22,"22204",1114,745,739,12,6,"PP-PAR",324
50,"50227",109,79,79,0,0,"PP-PAR",40
50,"50085",167,126,126,1,0,"PP-PAR",71
22,"22156",289,220,220,2,0,"PP-PAR",77
44,"44168",189,139,138,2,1,"PP-PAR",82
50,"50099",3083,2148,2132,13,16,"PP-PAR",782
50,"50079",249,175,174,0,1,"PP-PAR",75
50,"50248",508,387,374,2,13,"PP-PAR",139
44,"44266",115,90,90,0,0,"PP-PAR",61
50,"50087",26,17,17,1,0,"PP-PAR",9
22,"22249",116,95,95,4,0,"PP-PAR",24
50,"50137",1011,772,764,8,8,"PP-PAR",308
22,"22223",75,58,58,0,0,"PP-PAR",8
22,"22080",280,197,194,6,3,"PP-PAR",102
44,"44151",190,151,148,0,3,"PP-PAR",60
44,"44229",152,112,111,3,1,"PP-PAR",43
50,"50004",522,390,388,0,2,"PP-PAR",146
22,"22015",319,234,228,3,6,"PP-PAR",95
44,"44051",2683,1977,1946,17,31,"PP-PAR",853
44,"44084",54,41,41,0,0,"PP-PAR",20
44,"44249",55,44,44,2,0,"PP-PAR",20
22,"22051",100,81,81,0,0,"PP-PAR",38
44,"44226",140,98,98,2,0,"PP-PAR",41
50,"50107",947,738,733,4,5,"PP-PAR",306
50,"50233",106,81,81,0,0,"PP-PAR",46
44,"44035",113,90,88,1,2,"PP-PAR",51
44,"44260",137,91,89,3,2,"PP-PAR",44
44,"44148",90,75,73,2,2,"PP-PAR",26
50,"50139",313,241,239,3,2,"PP-PAR",120
50,"50171",106,79,79,0,0,"PP-PAR",47
22,"22081",254,181,181,0,0,"PP-PAR",98
44,"44267",70,57,56,0,1,"PP-PAR",33
50,"50084",77,59,59,2,0,"PP-PAR",26
50,"50212",40,36,36,0,0,"PP-PAR",13
50,"50264",156,115,115,0,0,"PP-PAR",29
50,"50140",166,115,115,0,0,"PP-PAR",62
22,"22170",651,498,491,5,7,"PP-PAR",203
22,"22162",130,102,102,0,0,"PP-PAR",46
44,"44099",709,465,462,3,3,"PP-PAR",111
50,"50007",45,34,34,1,0,"PP-PAR",14
22,"22226",767,570,562,10,8,"PP-PAR",208
22,"22017",866,650,642,5,8,"PP-PAR",256
50,"50288",3387,2415,2398,31,17,"PP-PAR",940
22,"22050",88,77,77,0,0,"PP-PAR",42
50,"50179",249,214,213,2,1,"PP-PAR",102
44,"44093",80,66,66,0,0,"PP-PAR",21
22,"22186",181,130,129,1,1,"PP-PAR",46
22,"22901",742,478,470,5,8,"PP-PAR",139
50,"50196",107,87,86,0,1,"PP-PAR",12
50,"50232",175,110,110,3,0,"PP-PAR",47
44,"44161",443,314,313,2,1,"PP-PAR",158
44,"44144",346,248,245,2,3,"PP-PAR",82
44,"44165",175,135,133,2,2,"PP-PAR",75
50,"50170",371,283,280,0,3,"PP-PAR",104
50,"50053",687,513,510,2,3,"PP-PAR",219
44,"44038",104,83,82,0,1,"PP-PAR",35
50,"50200",511,410,403,2,7,"PP-PAR",88
44,"44071",591,398,398,5,0,"PP-PAR",178
22,"22007",792,581,581,8,0,"PP-PAR",289
22,"22909",315,226,225,4,1,"PP-PAR",76
22,"22252",121,86,81,0,5,"PP-PAR",29
44,"44020",24,20,19,1,1,"PP-PAR",12
50,"50042",15,15,15,1,0,"PP-PAR",11
50,"50293",413,276,275,4,1,"PP-PAR",91
44,"44129",39,32,32,0,0,"PP-PAR",11
50,"50102",859,658,653,8,5,"PP-PAR",234
44,"44042",123,91,90,0,1,"PP-PAR",43
50,"50253",423,330,328,4,2,"PP-PAR",174
50,"50098",174,130,124,0,6,"PP-PAR",50
44,"44167",38,31,31,0,0,"PP-PAR",12
22,"22203",83,67,67,1,0,"PP-PAR",32
22,"22127",505,374,371,3,3,"PP-PAR",110
50,"50026",439,335,325,10,10,"PP-PAR",108
22,"22229",114,80,80,1,0,"PP-PAR",29
44,"44039",221,165,159,0,6,"PP-PAR",109
44,"44046",49,34,34,1,0,"PP-PAR",13
50,"50274",71,55,55,0,0,"PP-PAR",28
50,"50291",96,74,74,0,0,"PP-PAR",43
22,"22114",123,81,81,0,0,"PP-PAR",43
50,"50206",460,363,357,4,6,"PP-PAR",158
50,"50023",224,175,175,0,0,"PP-PAR",96
22,"22069",429,333,331,2,2,"PP-PAR",138
44,"44243",24,20,20,0,0,"PP-PAR",12
50,"50095",12323,8628,8550,110,78,"PP-PAR",2666
44,"44198",182,147,146,4,1,"PP-PAR",82
44,"44106",155,116,114,5,2,"PP-PAR",41
22,"22172",556,372,370,6,2,"PP-PAR",196
50,"50272",12904,8880,8819,84,61,"PP-PAR",2562
22,"22079",118,83,83,1,0,"PP-PAR",28
44,"44239",22,20,20,0,0,"PP-PAR",13
50,"50180",119,99,99,2,0,"PP-PAR",38
50,"50252",5138,3642,3611,24,31,"PP-PAR",1665
50,"50262",1170,896,887,15,9,"PP-PAR",230
50,"50903",2214,1602,1585,8,17,"PP-PAR",546
44,"44240",158,130,129,0,1,"PP-PAR",59
50,"50025",4562,3158,3124,31,34,"PP-PAR",1316
22,"22214",128,106,105,3,1,"PP-PAR",56
50,"50056",409,300,300,3,0,"PP-PAR",108
44,"44019",67,50,49,0,1,"PP-PAR",24
22,"22103",682,508,502,3,6,"PP-PAR",156
50,"50177",308,245,244,4,1,"PP-PAR",110
44,"44125",61,44,44,0,0,"PP-PAR",22
50,"50146",187,145,144,3,1,"PP-PAR",54
22,"22090",99,71,71,0,0,"PP-PAR",28
44,"44055",69,56,56,4,0,"PP-PAR",29
44,"44142",35,27,27,0,0,"PP-PAR",14
50,"50277",50,42,41,0,1,"PP-PAR",27
44,"44136",49,43,43,1,0,"PP-PAR",28
22,"22042",117,95,92,0,3,"PP-PAR",39
44,"44159",38,31,31,1,0,"PP-PAR",19
44,"44077",74,60,58,0,2,"PP-PAR",16
22,"22220",166,126,125,2,1,"PP-PAR",46
22,"22247",33,20,20,0,0,"PP-PAR",4
50,"50260",33,33,32,0,1,"PP-PAR",19
22,"22903",652,514,507,1,7,"PP-PAR",200
50,"50104",348,271,269,2,2,"PP-PAR",108
44,"44268",25,25,24,0,1,"PP-PAR",7
22,"22907",1435,1059,1046,18,13,"PP-PAR",358
50,"50055",3611,2445,2407,22,38,"PP-PAR",897
22,"22016",601,413,411,6,2,"PP-PAR",139
50,"50258",54,34,34,0,0,"PP-PAR",19
50,"50100",329,246,241,1,5,"PP-PAR",100
44,"44123",105,71,70,1,1,"PP-PAR",38
44,"44179",337,229,226,1,3,"PP-PAR",93
22,"22175",197,143,142,1,1,"PP-PAR",56
22,"22111",154,103,102,0,1,"PP-PAR",51
22,"22023",421,313,309,6,4,"PP-PAR",141
50,"50111",180,143,143,0,0,"PP-PAR",63
44,"44251",254,198,191,1,7,"PP-PAR",132
50,"50295",48,43,42,0,1,"PP-PAR",18
50,"50160",2238,1546,1528,12,18,"PP-PAR",428
50,"50014",147,94,94,0,0,"PP-PAR",35
44,"44059",544,425,412,9,13,"PP-PAR",219
50,"50120",52,40,40,1,0,"PP-PAR",11
22,"22036",92,77,77,0,0,"PP-PAR",46
50,"50011",122,95,94,1,1,"PP-PAR",27
22,"22122",64,57,57,2,0,"PP-PAR",26
50,"50178",293,190,187,0,3,"PP-PAR",62
44,"44219",194,145,143,1,2,"PP-PAR",79
50,"50106",134,104,104,0,0,"PP-PAR",42
50,"50021",30,21,21,0,0,"PP-PAR",14
50,"50167",233,183,178,1,5,"PP-PAR",101
44,"44034",139,109,108,0,1,"PP-PAR",62
50,"50208",1774,1207,1195,10,12,"PP-PAR",402
22,"22130",10092,6671,6608,59,63,"PP-PAR",2128
50,"50240",1025,729,718,10,11,"PP-PAR",244
50,"50198",54,41,41,1,0,"PP-PAR",20
50,"50211",249,176,173,0,3,"PP-PAR",92
50,"50054",58,50,50,0,0,"PP-PAR",23
22,"22045",82,65,64,1,1,"PP-PAR",19
50,"50201",448,339,335,7,4,"PP-PAR",126
44,"44185",99,76,75,0,1,"PP-PAR",50
50,"50150",649,402,397,2,5,"PP-PAR",187
22,"22009",617,444,441,6,3,"PP-PAR",117
22,"22125",38773,27021,26732,258,289,"PP-PAR",9018
22,"22137",1069,727,718,3,9,"PP-PAR",235
50,"50044",230,145,145,1,0,"PP-PAR",46
50,"50051",816,616,614,2,2,"PP-PAR",234
50,"50118",2165,1552,1540,10,12,"PP-PAR",517
50,"50244",201,162,161,1,1,"PP-PAR",81
44,"44160",466,304,301,2,3,"PP-PAR",153
22,"22095",72,58,58,1,0,"PP-PAR",17
44,"44176",158,115,114,0,1,"PP-PAR",43
50,"50902",87,79,79,2,0,"PP-PAR",50
44,"44169",342,252,252,3,0,"PP-PAR",102
50,"50284",141,107,104,0,3,"PP-PAR",42
50,"50076",78,66,65,0,1,"PP-PAR",17
44,"44218",35,28,28,1,0,"PP-PAR",21
22,"22234",794,552,544,3,8,"PP-PAR",223
50,"50203",1040,748,739,7,9,"PP-PAR",216
22,"22044",252,198,197,0,1,"PP-PAR",57
44,"44043",102,74,72,0,2,"PP-PAR",35
44,"44252",86,65,65,0,0,"PP-PAR",44
44,"44174",428,307,304,3,3,"PP-PAR",139
22,"22112",9566,6354,6305,56,49,"PP-PAR",2502
50,"50242",93,75,75,3,0,"PP-PAR",28
50,"50138",46,37,37,2,0,"PP-PAR",24
50,"50286",77,50,50,3,0,"PP-PAR",18
50,"50163",3689,2702,2680,37,22,"PP-PAR",931
50,"50265",79,61,61,0,0,"PP-PAR",29
44,"44141",135,97,96,1,1,"PP-PAR",41
50,"50135",91,70,70,3,0,"PP-PAR",30
22,"22168",23,18,18,0,0,"PP-PAR",2
22,"22906",186,141,139,3,2,"PP-PAR",39
50,"50221",35,17,17,0,0,"PP-PAR",5
22,"22055",320,243,238,2,5,"PP-PAR",99
50,"50266",122,90,90,0,0,"PP-PAR",49
50,"50077",221,168,167,1,1,"PP-PAR",62
50,"50287",270,191,191,0,0,"PP-PAR",89
50,"50236",102,79,77,0,2,"PP-PAR",47
22,"22113",495,370,368,4,2,"PP-PAR",129
22,"22243",45,28,28,0,0,"PP-PAR",12
50,"50195",54,40,40,0,0,"PP-PAR",19
44,"44201",495,411,406,0,5,"PP-PAR",121
50,"50124",415,318,317,2,1,"PP-PAR",174
44,"44146",174,153,152,2,1,"PP-PAR",57
44,"44224",22,14,14,0,0,"PP-PAR",6
22,"22094",101,74,74,1,0,"PP-PAR",28
44,"44156",45,31,31,1,0,"PP-PAR",23
22,"22075",125,83,83,1,0,"PP-PAR",18
22,"22057",370,271,270,3,1,"PP-PAR",55
44,"44018",19,19,19,0,0,"PP-PAR",18
50,"50122",68,52,52,1,0,"PP-PAR",26
50,"50223",920,712,701,4,11,"PP-PAR",219
22,"22178",103,82,81,0,1,"PP-PAR",33
50,"50261",213,157,157,0,0,"PP-PAR",32
50,"50231",250,195,192,4,3,"PP-PAR",78
50,"50285",644,436,434,2,2,"PP-PAR",175
44,"44221",372,303,300,1,3,"PP-PAR",144
44,"44011",52,40,38,0,2,"PP-PAR",16
44,"44228",100,82,82,0,0,"PP-PAR",41
22,"22058",194,164,162,1,2,"PP-PAR",46
44,"44177",115,84,84,1,0,"PP-PAR",29
44,"44037",453,317,315,0,2,"PP-PAR",144
22,"22062",167,116,116,1,0,"PP-PAR",51
50,"50067",14119,9909,9819,112,90,"PP-PAR",3955
50,"50066",2621,1862,1851,9,11,"PP-PAR",745
50,"50123",449,334,331,1,3,"PP-PAR",95
50,"50156",215,181,178,2,3,"PP-PAR",53
50,"50197",90,67,67,2,0,"PP-PAR",41
44,"44181",76,57,56,0,1,"PP-PAR",37
22,"22116",1430,1004,994,5,10,"PP-PAR",409
44,"44190",71,58,56,0,2,"PP-PAR",30
44,"44223",72,54,54,0,0,"PP-PAR",28
22,"22176",173,134,130,1,4,"PP-PAR",76
44,"44060",41,32,32,0,0,"PP-PAR",22
44,"44092",81,59,57,0,2,"PP-PAR",26
44,"44149",103,78,78,3,0,"PP-PAR",33
50,"50280",332,253,250,0,3,"PP-PAR",76
50,"50218",113,91,91,1,0,"PP-PAR",52
50,"50188",28,25,25,0,0,"PP-PAR",15
50,"50270",38,26,26,0,0,"PP-PAR",10
22,"22177",98,75,75,0,0,"PP-PAR",35
44,"44116",83,60,60,1,0,"PP-PAR",36
44,"44013",11244,7815,7712,82,103,"PP-PAR",2922
50,"50081",511,382,378,4,4,"PP-PAR",176
44,"44126",329,234,229,4,5,"PP-PAR",99
44,"44089",45,39,39,1,0,"PP-PAR",21
44,"44217",29,25,25,3,0,"PP-PAR",9
50,"50082",82,65,64,0,1,"PP-PAR",33
22,"22160",209,168,168,6,0,"PP-PAR",57
44,"44150",28,22,21,0,1,"PP-PAR",10
50,"50115",3235,2128,2109,14,19,"PP-PAR",826
22,"22110",738,531,527,4,4,"PP-PAR",196
50,"50129",235,161,158,2,3,"PP-PAR",67
44,"44036",25,21,21,0,0,"PP-PAR",16
50,"50189",705,527,519,13,8,"PP-PAR",244
44,"44022",493,323,318,7,5,"PP-PAR",115
44,"44153",1774,1135,1121,5,14,"PP-PAR",464
50,"50108",48,38,38,0,0,"PP-PAR",15
22,"22181",92,61,61,2,0,"PP-PAR",28
22,"22143",217,143,141,1,2,"PP-PAR",73
50,"50031",154,93,93,0,0,"PP-PAR",35
22,"22167",493,388,381,9,7,"PP-PAR",169
50,"50001",100,77,77,0,0,"PP-PAR",52
22,"22006",298,204,204,5,0,"PP-PAR",60
44,"44054",108,85,85,2,0,"PP-PAR",44
50,"50191",470,310,308,1,2,"PP-PAR",133
50,"50282",69,54,54,0,0,"PP-PAR",28
50,"50093",92,66,66,1,0,"PP-PAR",26
22,"22029",127,100,100,0,0,"PP-PAR",48
44,"44115",102,90,90,3,0,"PP-PAR",32
50,"50249",302,226,220,0,6,"PP-PAR",146
44,"44128",68,54,54,1,0,"PP-PAR",21
22,"22087",67,45,45,2,0,"PP-PAR",29
50,"50181",993,733,720,5,13,"PP-PAR",298
44,"44067",114,81,81,1,0,"PP-PAR",31
44,"44241",533,396,389,0,7,"PP-PAR",169
50,"50128",26,25,25,1,0,"PP-PAR",12
22,"22124",201,144,143,1,1,"PP-PAR",50
44,"44045",366,274,269,2,5,"PP-PAR",124
22,"22136",806,588,588,5,0,"PP-PAR",263
44,"44230",155,123,123,2,0,"PP-PAR",36
22,"22141",117,91,90,1,1,"PP-PAR",51
22,"22251",364,284,284,0,0,"PP-PAR",150
22,"22046",728,566,561,5,5,"PP-PAR",220
50,"50182",3399,2364,2335,21,29,"PP-PAR",902
44,"44056",501,345,342,2,3,"PP-PAR",201
44,"44097",142,92,92,0,0,"PP-PAR",55
50,"50065",53,43,43,0,0,"PP-PAR",15
44,"44025",6009,4087,3997,25,90,"PP-PAR",1094
50,"50096",39,27,27,0,0,"PP-PAR",11
44,"44209",833,611,602,6,9,"PP-PAR",281
50,"50186",42,31,31,0,0,"PP-PAR",9
44,"44180",70,61,61,0,0,"PP-PAR",34
22,"22239",88,72,72,0,0,"PP-PAR",41
22,"22200",244,184,182,5,2,"PP-PAR",62
50,"50105",296,214,211,1,3,"PP-PAR",88
44,"44053",105,78,78,0,0,"PP-PAR",37
44,"44086",449,342,336,3,6,"PP-PAR",124
50,"50251",8262,5946,5872,44,74,"PP-PAR",2282
44,"44232",378,284,276,6,8,"PP-PAR",134
44,"44199",44,41,41,2,0,"PP-PAR",16
50,"50035",72,54,53,1,1,"PP-PAR",5
44,"44111",92,69,68,0,1,"PP-PAR",13
44,"44100",185,153,151,0,2,"PP-PAR",43
50,"50235",2339,1664,1648,11,16,"PP-PAR",600
44,"44047",220,137,132,2,5,"PP-PAR",76
22,"22047",243,205,203,2,2,"PP-PAR",93
22,"22032",110,76,74,0,2,"PP-PAR",20
44,"44163",126,94,94,1,0,"PP-PAR",38
50,"50057",1395,919,907,11,12,"PP-PAR",402
22,"22018",327,245,244,3,1,"PP-PAR",95
50,"50204",2436,1785,1770,3,15,"PP-PAR",441
44,"44178",58,37,37,0,0,"PP-PAR",25
44,"44200",39,26,26,0,0,"PP-PAR",23
50,"50132",751,543,536,0,7,"PP-PAR",210
50,"50015",96,67,67,0,0,"PP-PAR",19
22,"22228",514,364,360,5,4,"PP-PAR",123
22,"22022",552,414,408,6,6,"PP-PAR",117
44,"44088",29,21,21,0,0,"PP-PAR",16
50,"50019",55,41,41,0,0,"PP-PAR",20
44,"44250",19,12,12,0,0,"PP-PAR",6
22,"22099",483,379,377,4,2,"PP-PAR",152
22,"22244",52,38,37,0,1,"PP-PAR",15
44,"44113",71,52,52,0,0,"PP-PAR",4
50,"50037",136,98,96,0,2,"PP-PAR",47
50,"50016",52,40,40,0,0,"PP-PAR",17
50,"50267",602,433,430,8,3,"PP-PAR",137
22,"22001",225,151,151,1,0,"PP-PAR",87
22,"22245",309,267,261,1,6,"PP-PAR",150
50,"50281",73,51,50,0,1,"PP-PAR",36
50,"50092",299,233,231,0,2,"PP-PAR",89
44,"44109",108,73,73,0,0,"PP-PAR",26
50,"50219",4119,2833,2804,19,29,"PP-PAR",831
22,"22207",125,72,71,2,1,"PP-PAR",20
44,"44120",222,154,150,2,4,"PP-PAR",67
44,"44014",2521,1896,1867,8,29,"PP-PAR",626
44,"44138",135,98,94,0,4,"PP-PAR",51
44,"44026",90,77,76,0,1,"PP-PAR",39
22,"22025",1071,676,669,18,7,"PP-PAR",272
44,"44204",24,21,21,0,0,"PP-PAR",7
50,"50048",34,29,29,0,0,"PP-PAR",9
50,"50038",1502,1121,1111,7,10,"PP-PAR",362
50,"50144",34,29,29,2,0,"PP-PAR",12
44,"44090",78,53,53,0,0,"PP-PAR",44
50,"50134",128,91,89,2,2,"PP-PAR",44
50,"50269",285,193,188,0,5,"PP-PAR",106
22,"22190",119,86,85,0,1,"PP-PAR",21
22,"22041",163,134,134,1,0,"PP-PAR",73
44,"44005",50,30,30,0,0,"PP-PAR",16
44,"44216",26555,18997,18737,168,260,"PP-PAR",8125
44,"44009",809,596,593,7,3,"PP-PAR",217
44,"44076",2203,1690,1663,18,27,"PP-PAR",619
50,"50168",28,27,27,0,0,"PP-PAR",12
22,"22144",243,188,187,1,1,"PP-PAR",93
50,"50070",60,36,36,0,0,"PP-PAR",12
50,"50008",5097,3457,3417,31,40,"PP-PAR",947
50,"50114",116,89,88,0,1,"PP-PAR",32
22,"22164",35,28,28,0,0,"PP-PAR",14
50,"50039",491,392,390,2,2,"PP-PAR",136
44,"44175",122,85,84,1,1,"PP-PAR",43
50,"50117",126,104,103,1,1,"PP-PAR",47
22,"22052",925,712,710,8,2,"PP-PAR",257
44,"44206",114,90,87,0,3,"PP-PAR",36
22,"22117",2478,1714,1693,22,21,"PP-PAR",723
50,"50147",777,552,552,2,0,"PP-PAR",174
22,"22165",487,364,360,6,4,"PP-PAR",176
50,"50009",105,80,80,0,0,"PP-PAR",51
44,"44032",16,11,11,0,0,"PP-PAR",2
50,"50148",316,233,229,4,4,"PP-PAR",92
22,"22068",79,60,60,0,0,"PP-PAR",19
50,"50222",1622,1091,1071,7,20,"PP-PAR",405
50,"50027",225,178,177,2,1,"PP-PAR",66
44,"44068",659,509,503,3,6,"PP-PAR",217
50,"50159",665,512,507,2,5,"PP-PAR",228
22,"22195",235,182,181,3,1,"PP-PAR",83
22,"22905",281,209,209,1,0,"PP-PAR",100
22,"22208",188,150,145,0,5,"PP-PAR",32
44,"44033",269,191,190,0,1,"PP-PAR",100
44,"44082",89,78,77,0,1,"PP-PAR",30
50,"50292",125,102,102,1,0,"PP-PAR",66
44,"44107",218,152,152,5,0,"PP-PAR",49
50,"50126",2371,1573,1559,19,14,"PP-PAR",775
50,"50220",40,32,32,0,0,"PP-PAR",8
44,"44196",131,101,98,2,3,"PP-PAR",33
50,"50073",2141,1592,1577,7,15,"PP-PAR",726
44,"44044",88,72,71,2,1,"PP-PAR",47
44,"44184",45,34,34,0,0,"PP-PAR",26
22,"22105",114,78,77,2,1,"PP-PAR",28
22,"22151",93,64,64,1,0,"PP-PAR",35
22,"22109",261,191,190,1,1,"PP-PAR",79
50,"50273",30,22,22,0,0,"PP-PAR",14
22,"22054",1542,1091,1077,13,14,"PP-PAR",357
44,"44208",37,22,22,0,0,"PP-PAR",11
44,"44023",17,16,16,0,0,"PP-PAR",15
44,"44256",38,34,34,0,0,"PP-PAR",15
22,"22067",65,50,50,1,0,"PP-PAR",6
50,"50012",100,80,79,2,1,"PP-PAR",24
22,"22250",353,261,258,4,3,"PP-PAR",83
50,"50194",88,63,63,1,0,"PP-PAR",36
50,"50121",277,216,214,1,2,"PP-PAR",97
44,"44085",52,35,35,0,0,"PP-PAR",31
44,"44231",38,33,33,0,0,"PP-PAR",14
22,"22225",2679,1700,1665,17,35,"PP-PAR",748
44,"44002",47,40,40,0,0,"PP-PAR",12
44,"44143",380,307,306,2,1,"PP-PAR",120
50,"50254",180,118,116,1,2,"PP-PAR",55
22,"22035",234,165,159,3,6,"PP-PAR",31
50,"50151",636,499,499,0,0,"PP-PAR",188
44,"44075",323,248,246,0,2,"PP-PAR",148
50,"50166",255,208,206,2,2,"PP-PAR",88
50,"50169",351,269,265,0,4,"PP-PAR",120
50,"50020",809,564,559,2,5,"PP-PAR",234
50,"50247",823,588,581,3,7,"PP-PAR",261
50,"50003",128,92,91,1,1,"PP-PAR",34
50,"50075",80,62,61,1,1,"PP-PAR",46
22,"22043",93,66,65,0,1,"PP-PAR",35
22,"22082",291,213,212,1,1,"PP-PAR",93
44,"44131",25,20,20,0,0,"PP-PAR",6
50,"50245",88,65,64,0,1,"PP-PAR",26
50,"50193",651,514,501,2,13,"PP-PAR",159
50,"50024",571,437,437,6,0,"PP-PAR",133
22,"22021",1971,1414,1398,17,16,"PP-PAR",449
44,"44070",53,48,48,0,0,"PP-PAR",34
50,"50152",1430,1008,994,14,14,"PP-PAR",464
50,"50214",27,18,17,0,1,"PP-PAR",10
22,"22253",61,52,52,0,0,"PP-PAR",20
44,"44121",60,47,47,2,0,"PP-PAR",29
22,"22235",98,76,76,1,0,"PP-PAR",36
22,"22215",128,96,96,1,0,"PP-PAR",28
44,"44258",67,47,47,0,0,"PP-PAR",29
44,"44155",1090,793,782,4,11,"PP-PAR",201
44,"44132",60,54,54,1,0,"PP-PAR",31
22,"22254",1124,801,792,11,9,"PP-PAR",279
50,"50005",229,189,189,1,0,"PP-PAR",111
22,"22173",232,152,152,3,0,"PP-PAR",46
22,"22158",11995,8197,8126,62,71,"PP-PAR",2735
44,"44245",248,179,176,2,3,"PP-PAR",90
50,"50205",90,63,61,0,2,"PP-PAR",15
22,"22072",191,136,135,0,1,"PP-PAR",40
50,"50290",386,283,282,1,1,"PP-PAR",116
22,"22206",193,129,128,1,1,"PP-PAR",28
22,"22193",276,225,224,2,1,"PP-PAR",93
22,"22074",313,228,225,4,3,"PP-PAR",70
22,"22102",179,141,138,2,3,"PP-PAR",46
50,"50110",367,256,254,0,2,"PP-PAR",110
44,"44235",92,62,60,0,2,"PP-PAR",32
50,"50133",113,80,80,4,0,"PP-PAR",27
44,"44213",62,50,50,0,0,"PP-PAR",35
44,"44195",88,60,60,1,0,"PP-PAR",30
22,"22133",115,81,80,1,1,"PP-PAR",19
44,"44102",30,27,26,0,1,"PP-PAR",18
44,"44203",10,10,10,0,0,"PP-PAR",7
44,"44173",101,81,79,2,2,"PP-PAR",40
22,"22053",789,520,513,9,7,"PP-PAR",196
44,"44183",77,50,49,0,1,"PP-PAR",16
50,"50062",1829,1304,1290,16,14,"PP-PAR",423
44,"44117",340,271,268,4,3,"PP-PAR",96
22,"22205",438,322,320,0,2,"PP-PAR",86
44,"44103",132,102,102,1,0,"PP-PAR",62
22,"22024",226,174,171,3,3,"PP-PAR",35
22,"22061",6630,4555,4526,40,29,"PP-PAR",1733
44,"44062",34,25,22,0,3,"PP-PAR",15
50,"50289",51,38,38,0,0,"PP-PAR",21
50,"50018",953,656,655,1,1,"PP-PAR",251
50,"50059",769,549,544,8,5,"PP-PAR",228
50,"50155",103,80,78,0,2,"PP-PAR",36
44,"44041",56,44,44,1,0,"PP-PAR",18
22,"22197",473,354,354,1,0,"PP-PAR",143
50,"50229",62,47,47,2,0,"PP-PAR",11
44,"44237",398,304,301,4,3,"PP-PAR",144
44,"44194",109,78,73,3,5,"PP-PAR",36
22,"22163",425,360,355,0,5,"PP-PAR",133
44,"44031",97,62,62,0,0,"PP-PAR",30
50,"50153",935,713,708,6,5,"PP-PAR",222
50,"50187",69,44,44,0,0,"PP-PAR",19
22,"22246",76,50,50,0,0,"PP-PAR",18
50,"50279",86,64,64,0,0,"PP-PAR",13
50,"50064",437,342,339,0,3,"PP-PAR",128
50,"50052",90,68,68,0,0,"PP-PAR",45
50,"50149",34,24,24,0,0,"PP-PAR",19
50,"50072",170,125,125,0,0,"PP-PAR",67
22,"22212",79,64,62,0,2,"PP-PAR",14
50,"50209",2601,1731,1721,13,10,"PP-PAR",625
44,"44264",248,191,189,1,2,"PP-PAR",63
50,"50250",52,44,44,0,0,"PP-PAR",19
22,"22904",815,579,575,8,4,"PP-PAR",263
50,"50030",215,141,140,1,1,"PP-PAR",60
22,"22233",82,57,57,3,0,"PP-PAR",26
50,"50033",66,49,48,0,1,"PP-PAR",21
44,"44192",355,280,278,4,2,"PP-PAR",134
44,"44265",186,141,138,2,3,"PP-PAR",88
22,"22135",189,128,127,0,1,"PP-PAR",57
44,"44006",248,185,183,2,2,"PP-PAR",79
22,"22066",702,502,498,7,4,"PP-PAR",140
50,"50192",236,180,180,2,0,"PP-PAR",71
22,"22248",116,92,90,1,2,"PP-PAR",25
44,"44127",68,51,51,0,0,"PP-PAR",18
22,"22119",1291,942,935,5,7,"PP-PAR",378
22,"22222",530,384,379,3,5,"PP-PAR",136
44,"44066",108,79,74,0,5,"PP-PAR",30
22,"22028",371,282,280,3,2,"PP-PAR",101
44,"44001",68,53,52,1,1,"PP-PAR",26
50,"50041",12,9,9,0,0,"PP-PAR",2
50,"50190",695,523,515,3,8,"PP-PAR",181
22,"22084",535,403,399,4,4,"PP-PAR",153
50,"50141",109,90,90,1,0,"PP-PAR",54
44,"44016",482,363,360,2,3,"PP-PAR",160
50,"50207",106,93,93,1,0,"PP-PAR",37
50,"50210",38,30,30,1,0,"PP-PAR",14
22,"22209",155,120,120,3,0,"PP-PAR",21
22,"22187",293,218,216,2,2,"PP-PAR",83
22,"22012",111,87,86,3,1,"PP-PAR",45
44,"44197",56,36,36,0,0,"PP-PAR",21
22,"22059",1149,807,800,3,7,"PP-PAR",256
50,"50094",1617,1173,1159,12,14,"PP-PAR",492
50,"50283",70,57,57,1,0,"PP-PAR",30
44,"44012",334,263,261,5,2,"PP-PAR",140
22,"22048",12598,8790,8731,91,59,"PP-PAR",3182
44,"44028",183,151,150,4,1,"PP-PAR",80
22,"22011",88,71,69,0,2,"PP-PAR",34
44,"44065",60,40,40,0,0,"PP-PAR",30
44,"44182",197,157,157,0,0,"PP-PAR",71
22,"22236",253,200,200,0,0,"PP-PAR",82
50,"50068",1982,1348,1335,8,13,"PP-PAR",522
50,"50165",1814,1287,1264,26,23,"PP-PAR",355
44,"44007",173,122,121,4,1,"PP-PAR",70
22,"22155",76,51,51,0,0,"PP-PAR",26
22,"22174",478,379,378,2,1,"PP-PAR",201
50,"50125",360,248,246,3,2,"PP-PAR",131
50,"50086",187,132,128,2,4,"PP-PAR",29
50,"50006",925,674,657,6,17,"PP-PAR",222
50,"50060",172,128,127,1,1,"PP-PAR",51
22,"22014",243,192,188,3,4,"PP-PAR",70
44,"44193",78,54,54,1,0,"PP-PAR",21
50,"50296",396,286,275,4,11,"PP-PAR",51
22,"22078",438,319,316,3,3,"PP-PAR",74
22,"22157",192,129,128,3,1,"PP-PAR",37
50,"50183",331,246,246,3,0,"PP-PAR",119
50,"50069",73,53,53,1,0,"PP-PAR",8
50,"50131",231,167,165,0,2,"PP-PAR",76
50,"50130",383,240,238,2,2,"PP-PAR",95
50,"50034",826,567,563,5,4,"PP-PAR",201
22,"22037",115,86,86,0,0,"PP-PAR",34
44,"44124",77,64,64,3,0,"PP-PAR",15
44,"44171",178,126,124,2,2,"PP-PAR",26
44,"44212",39,37,37,1,0,"PP-PAR",15
50,"50090",150,113,112,0,1,"PP-PAR",71
50,"50271",252,200,197,2,3,"PP-PAR",106
44,"44211",42,35,35,0,0,"PP-PAR",15
50,"50161",106,75,72,0,3,"PP-PAR",37
44,"44063",71,54,54,0,0,"PP-PAR",18
22,"22096",301,240,240,0,0,"PP-PAR",94
22,"22004",135,81,80,0,1,"PP-PAR",33
50,"50109",103,78,78,3,0,"PP-PAR",32
44,"44087",80,69,67,1,2,"PP-PAR",31
50,"50162",146,109,105,4,4,"PP-PAR",41
44,"44205",700,460,453,4,7,"PP-PAR",206
50,"50215",24,19,19,0,0,"PP-PAR",7
44,"44244",75,47,47,1,0,"PP-PAR",26
50,"50173",182,132,131,1,1,"PP-PAR",74
50,"50045",1243,926,925,6,1,"PP-PAR",442
50,"50113",618,489,484,2,5,"PP-PAR",172
50,"50185",133,108,108,1,0,"PP-PAR",32
44,"44064",69,49,49,0,0,"PP-PAR",28
50,"50136",575,414,410,2,4,"PP-PAR",252
22,"22107",112,74,74,0,0,"PP-PAR",32
44,"44191",764,586,583,6,3,"PP-PAR",170
22,"22064",166,122,121,1,1,"PP-PAR",41
22,"22086",215,161,159,1,2,"PP-PAR",62
44,"44133",21,15,15,0,0,"PP-PAR",5
22,"22242",62,45,44,0,1,"PP-PAR",26
50,"50276",125,104,103,2,1,"PP-PAR",46
44,"44112",429,290,290,2,0,"PP-PAR",131
44,"44207",156,118,115,4,3,"PP-PAR",38
22,"22040",144,117,115,1,2,"PP-PAR",53
44,"44137",193,149,148,0,1,"PP-PAR",92
50,"50010",68,58,58,0,0,"PP-PAR",46
50,"50116",182,136,132,0,4,"PP-PAR",71
50,"50298",5333,3949,3902,39,47,"PP-PAR",1489
22,"22076",311,201,199,0,2,"PP-PAR",84
44,"44157",64,48,48,1,0,"PP-PAR",22
22,"22063",169,133,129,1,4,"PP-PAR",51
22,"22201",266,188,187,3,1,"PP-PAR",45
22,"22182",250,161,158,1,3,"PP-PAR",57
44,"44101",58,46,46,2,0,"PP-PAR",17
50,"50239",62,50,48,0,2,"PP-PAR",35
22,"22902",221,159,156,0,3,"PP-PAR",72
22,"22139",79,64,64,1,0,"PP-PAR",40
22,"22232",93,71,69,1,2,"PP-PAR",37
22,"22126",88,64,64,0,0,"PP-PAR",40
50,"50224",72,57,56,2,1,"PP-PAR",36
22,"22188",82,60,59,6,1,"PP-PAR",16
44,"44061",70,54,51,0,3,"PP-PAR",26
44,"44145",1020,719,709,9,10,"PP-PAR",299
50,"50058",66,39,39,0,0,"PP-PAR",21
44,"44118",164,132,131,2,1,"PP-PAR",61
22,"22149",305,228,228,0,0,"PP-PAR",90
50,"50028",78,51,51,0,0,"PP-PAR",16
44,"44234",61,51,51,1,0,"PP-PAR",20
50,"50101",864,603,597,8,6,"PP-PAR",201
50,"50238",91,66,66,1,0,"PP-PAR",32
44,"44189",56,41,41,0,0,"PP-PAR",19
50,"50088",302,246,237,5,9,"PP-PAR",105
50,"50199",334,244,242,3,2,"PP-PAR",89
44,"44027",164,123,123,1,0,"PP-PAR",50
50,"50091",41,36,36,0,0,"PP-PAR",21
22,"22227",206,163,160,3,3,"PP-PAR",52
50,"50154",116,96,96,0,0,"PP-PAR",64
50,"50297",498961,362043,359558,2748,2485,"PP-PAR",121660
50,"50164",390,247,246,6,1,"PP-PAR",96
50,"50268",44,37,37,0,0,"PP-PAR",18
44,"44238",2323,1603,1590,5,13,"PP-PAR",347
44,"44008",1613,1163,1153,6,10,"PP-PAR",395
22,"22129",183,120,118,1,2,"PP-PAR",61
50,"50259",88,67,66,0,1,"PP-PAR",44
22,"22150",472,331,330,1,1,"PP-PAR",118
44,"44262",135,108,107,2,1,"PP-PAR",47
22,"22106",22,14,14,0,0,"PP-PAR",5
50,"50176",236,165,165,3,0,"PP-PAR",65
50,"50046",178,133,133,5,0,"PP-PAR",74
44,"44215",159,109,109,2,0,"PP-PAR",36
50,"50036",104,91,90,0,1,"PP-PAR",35
50,"50257",171,134,134,2,0,"PP-PAR",44
50,"50184",115,85,85,0,0,"PP-PAR",46
22,"22089",302,225,223,0,2,"PP-PAR",89
22,"22088",153,110,110,2,0,"PP-PAR",40
44,"44225",107,74,74,1,0,"PP-PAR",21
50,"50901",138,105,105,0,0,"PP-PAR",42
50,"50225",1570,956,950,3,6,"PP-PAR",477
50,"50217",446,342,342,1,0,"PP-PAR",135
22,"22027",329,221,218,0,3,"PP-PAR",94
50,"50275",108,55,55,0,0,"PP-PAR",35
50,"50246",41,28,28,0,0,"PP-PAR",21
22,"22060",1164,858,850,3,8,"PP-PAR",291
50,"50029",626,450,450,3,0,"PP-PAR",112
44,"44040",201,160,157,1,3,"PP-PAR",62
22,"22039",863,671,667,4,4,"PP-PAR",232
22,"22002",107,95,95,0,0,"PP-PAR",41
22,"22142",97,75,74,1,1,"PP-PAR",48
37,"37161",136,106,106,1,0,"PREPAL",0
37,"37008",4266,3216,3197,19,19,"PREPAL",1
37,"37143",389,301,300,6,1,"PREPAL",0
37,"37001",192,151,148,0,3,"PREPAL",0
24,"24036",288,184,184,2,0,"PREPAL",0
37,"37142",586,430,429,1,1,"PREPAL",0
24,"24067",623,388,384,0,4,"PREPAL",0
37,"37352",207,153,152,1,1,"PREPAL",0
37,"37269",447,326,324,1,2,"PREPAL",1
49,"49207",239,150,146,0,4,"PREPAL",1
24,"24183",805,555,549,6,6,"PREPAL",1
49,"49129",853,592,574,9,18,"PREPAL",0
24,"24148",1672,1249,1241,23,8,"PREPAL",0
49,"49250",1245,935,920,7,15,"PREPAL",2
37,"37344",241,175,174,2,1,"PREPAL",0
49,"49209",505,342,341,2,1,"PREPAL",0
37,"37260",150,116,116,1,0,"PREPAL",0
37,"37198",207,160,157,3,3,"PREPAL",1
49,"49251",163,127,121,1,6,"PREPAL",0
37,"37284",316,246,238,4,8,"PREPAL",0
37,"37031",361,269,266,2,3,"PREPAL",1
37,"37253",135,109,109,2,0,"PREPAL",1
37,"37209",412,272,270,7,2,"PREPAL",0
49,"49232",96,74,74,1,0,"PREPAL",0
37,"37264",65,40,40,0,0,"PREPAL",0
49,"49094",224,149,149,2,0,"PREPAL",0
49,"49075",137,120,119,0,1,"PREPAL",1
24,"24179",290,197,192,4,5,"PREPAL",0
49,"49115",184,136,135,0,1,"PREPAL",0
49,"49132",316,235,232,1,3,"PREPAL",1
24,"24066",494,368,366,4,2,"PREPAL",0
24,"24193",378,268,265,2,3,"PREPAL",0
49,"49103",414,330,328,5,2,"PREPAL",1
49,"49108",466,346,344,0,2,"PREPAL",0
24,"24170",1908,1365,1345,8,20,"PREPAL",0
24,"24205",945,694,685,11,9,"PREPAL",0
37,"37207",287,195,193,1,2,"PREPAL",0
49,"49258",114,93,91,2,2,"PREPAL",0
49,"49164",155,119,115,2,4,"PREPAL",0
37,"37296",336,259,254,2,5,"PREPAL",0
37,"37174",1056,820,812,3,8,"PREPAL",2
24,"24227",1607,1127,1116,22,11,"PREPAL",0
24,"24191",108,79,79,0,0,"PREPAL",1
37,"37096",214,166,163,2,3,"PREPAL",0
37,"37297",425,328,322,2,6,"PREPAL",0
37,"37046",11225,7824,7697,53,127,"PREPAL",7
49,"49086",115,96,91,0,5,"PREPAL",0
37,"37125",228,161,156,0,5,"PREPAL",0
49,"49128",552,423,414,3,9,"PREPAL",1
37,"37275",118,70,69,0,1,"PREPAL",0
37,"37310",178,123,123,1,0,"PREPAL",0
24,"24223",2610,1917,1908,39,9,"PREPAL",3
37,"37189",121,88,88,0,0,"PREPAL",0
49,"49009",393,293,288,2,5,"PREPAL",0
37,"37057",215,172,171,1,1,"PREPAL",0
37,"37345",163,128,128,3,0,"PREPAL",0
49,"49175",230,172,171,1,1,"PREPAL",0
49,"49257",291,190,184,1,6,"PREPAL",0
24,"24228",660,430,422,6,8,"PREPAL",1
49,"49220",135,110,109,0,1,"PREPAL",0
49,"49109",619,483,483,11,0,"PREPAL",1
37,"37325",89,62,62,0,0,"PREPAL",0
24,"24025",297,228,227,0,1,"PREPAL",1
49,"49005",149,91,91,2,0,"PREPAL",0
37,"37175",403,314,312,6,2,"PREPAL",0
37,"37307",159,104,103,1,1,"PREPAL",0
24,"24074",97,75,75,1,0,"PREPAL",0
37,"37173",1504,1129,1114,4,15,"PREPAL",0
37,"37063",69,59,58,0,1,"PREPAL",0
49,"49169",35,26,26,0,0,"PREPAL",0
37,"37314",82,65,65,0,0,"PREPAL",0
49,"49216",162,142,142,0,0,"PREPAL",0
49,"49200",949,720,715,10,5,"PREPAL",0
24,"24213",150,122,122,1,0,"PREPAL",1
49,"49181",362,277,276,2,1,"PREPAL",0
24,"24022",330,230,229,0,1,"PREPAL",0
24,"24110",1247,899,892,6,7,"PREPAL",0
49,"49046",268,203,203,0,0,"PREPAL",0
37,"37311",227,182,182,3,0,"PREPAL",0
24,"24028",388,292,288,2,4,"PREPAL",0
49,"49157",206,163,160,2,3,"PREPAL",0
49,"49170",102,72,71,0,1,"PREPAL",0
37,"37315",96,70,70,0,0,"PREPAL",0
24,"24071",1006,745,734,10,11,"PREPAL",0
24,"24156",239,159,158,1,1,"PREPAL",0
49,"49204",63,51,51,0,0,"PREPAL",0
49,"49082",359,304,301,6,3,"PREPAL",0
37,"37380",56,47,45,0,2,"PREPAL",0
24,"24019",354,272,267,3,5,"PREPAL",0
24,"24095",320,234,232,0,2,"PREPAL",1
24,"24082",858,629,614,8,15,"PREPAL",0
24,"24032",109,91,89,0,2,"PREPAL",0
49,"49052",187,133,132,1,1,"PREPAL",0
49,"49230",97,72,72,0,0,"PREPAL",0
37,"37306",259,186,183,1,3,"PREPAL",0
49,"49092",129,90,89,1,1,"PREPAL",0
49,"49047",107,75,75,0,0,"PREPAL",0
37,"37135",1207,905,899,15,6,"PREPAL",0
37,"37107",10764,7379,7264,56,115,"PREPAL",6
37,"37292",104,77,77,1,0,"PREPAL",0
49,"49121",365,273,273,2,0,"PREPAL",0
37,"37127",214,154,151,1,3,"PREPAL",0
49,"49261",1537,1048,1033,8,15,"PREPAL",1
24,"24190",165,123,121,1,2,"PREPAL",1
37,"37372",144,111,108,0,3,"PREPAL",0
24,"24222",14256,9996,9884,101,112,"PREPAL",16
37,"37079",77,73,73,1,0,"PREPAL",0
49,"49248",186,151,150,1,1,"PREPAL",0
37,"37140",674,443,439,5,4,"PREPAL",1
24,"24034",3394,2380,2342,28,38,"PREPAL",0
37,"37091",177,117,116,1,1,"PREPAL",0
37,"37187",572,427,423,1,4,"PREPAL",0
24,"24076",1277,956,947,4,9,"PREPAL",4
49,"49017",251,180,177,1,3,"PREPAL",0
37,"37206",94,73,73,3,0,"PREPAL",0
49,"49148",260,137,134,1,3,"PREPAL",1
24,"24201",1090,762,759,10,3,"PREPAL",0
24,"24196",2057,1502,1485,9,17,"PREPAL",1
37,"37300",566,398,395,0,3,"PREPAL",2
24,"24091",645,454,451,1,3,"PREPAL",0
24,"24068",457,344,340,0,4,"PREPAL",1
37,"37082",796,551,544,4,7,"PREPAL",0
49,"49016",247,176,174,5,2,"PREPAL",0
37,"37021",79,60,60,0,0,"PREPAL",0
49,"49154",127,78,77,0,1,"PREPAL",0
37,"37055",123,98,94,0,4,"PREPAL",0
37,"37223",110,85,83,0,2,"PREPAL",0
37,"37248",152,126,125,1,1,"PREPAL",0
37,"37250",356,229,228,0,1,"PREPAL",0
37,"37376",2233,1539,1515,6,24,"PREPAL",1
24,"24113",366,293,287,5,6,"PREPAL",1
37,"37130",172,151,150,0,1,"PREPAL",0
37,"37035",190,150,150,2,0,"PREPAL",0
24,"24124",367,244,233,3,11,"PREPAL",0
49,"49246",227,190,183,2,7,"PREPAL",0
24,"24063",374,254,252,2,2,"PREPAL",0
37,"37261",221,163,160,1,3,"PREPAL",0
37,"37041",78,52,52,0,0,"PREPAL",0
37,"37097",39,27,27,1,0,"PREPAL",0
37,"37358",159,135,133,0,2,"PREPAL",0
37,"37180",75,56,56,0,0,"PREPAL",1
37,"37204",276,198,195,1,3,"PREPAL",0
24,"24015",2265,1649,1635,18,14,"PREPAL",3
24,"24185",474,357,350,3,7,"PREPAL",0
24,"24056",2883,2040,2003,11,37,"PREPAL",1
24,"24044",168,119,118,1,1,"PREPAL",0
37,"37069",968,695,689,7,6,"PREPAL",1
49,"49079",106,93,92,1,1,"PREPAL",1
37,"37313",550,386,384,2,2,"PREPAL",1
37,"37103",436,310,308,8,2,"PREPAL",0
37,"37322",2465,1592,1564,8,28,"PREPAL",1
37,"37132",351,256,253,2,3,"PREPAL",2
49,"49165",59,51,51,0,0,"PREPAL",0
24,"24087",631,470,466,7,4,"PREPAL",0
37,"37157",78,63,62,0,1,"PREPAL",0
24,"24121",645,492,487,1,5,"PREPAL",0
37,"37205",231,189,182,0,7,"PREPAL",0
37,"37290",141,113,113,0,0,"PREPAL",0
37,"37109",183,129,127,0,2,"PREPAL",0
49,"49139",171,135,135,0,0,"PREPAL",0
37,"37286",207,152,145,4,7,"PREPAL",0
49,"49153",174,136,132,0,4,"PREPAL",0
37,"37201",262,187,186,1,1,"PREPAL",0
37,"37133",111,78,73,1,5,"PREPAL",1
49,"49040",114,101,101,0,0,"PREPAL",0
37,"37320",95,72,72,0,0,"PREPAL",0
37,"37334",76,48,48,1,0,"PREPAL",0
37,"37293",115,84,84,1,0,"PREPAL",0
24,"24061",1704,1213,1204,9,9,"PREPAL",1
37,"37301",74,63,63,0,0,"PREPAL",0
49,"49208",394,248,244,2,4,"PREPAL",0
37,"37302",290,196,195,2,1,"PREPAL",0
37,"37148",427,298,295,3,3,"PREPAL",1
49,"49091",260,193,193,0,0,"PREPAL",0
24,"24142",25119,17336,17141,154,195,"PREPAL",21
24,"24164",370,218,217,0,1,"PREPAL",0
37,"37014",1155,817,808,7,9,"PREPAL",0
37,"37217",58,45,44,0,1,"PREPAL",0
37,"37177",289,220,219,2,1,"PREPAL",0
37,"37167",173,143,140,2,3,"PREPAL",0
24,"24004",463,350,348,4,2,"PREPAL",0
37,"37193",390,279,275,4,4,"PREPAL",0
49,"49240",206,162,161,2,1,"PREPAL",0
37,"37155",65,57,57,0,0,"PREPAL",0
49,"49078",170,141,140,1,1,"PREPAL",0
24,"24115",54058,37780,37357,308,423,"PREPAL",14
37,"37073",586,448,438,2,10,"PREPAL",0
37,"37279",750,522,513,4,9,"PREPAL",0
24,"24064",1523,1101,1087,3,14,"PREPAL",1
37,"37219",173,109,108,0,1,"PREPAL",0
49,"49011",232,168,165,6,3,"PREPAL",0
37,"37303",190,142,139,1,3,"PREPAL",1
49,"49023",967,673,662,10,11,"PREPAL",0
37,"37190",215,171,171,1,0,"PREPAL",0
24,"24211",272,205,205,2,0,"PREPAL",1
24,"24187",857,603,593,7,10,"PREPAL",2
49,"49259",89,66,65,1,1,"PREPAL",0
24,"24047",783,545,540,2,5,"PREPAL",0
49,"49054",894,617,601,13,16,"PREPAL",1
49,"49036",506,374,367,2,7,"PREPAL",0
37,"37276",143,104,103,1,1,"PREPAL",0
37,"37151",148,125,124,2,1,"PREPAL",0
37,"37124",212,146,144,1,2,"PREPAL",0
37,"37003",115,93,93,0,0,"PREPAL",0
37,"37026",189,146,146,0,0,"PREPAL",0
37,"37078",829,674,664,8,10,"PREPAL",0
37,"37222",93,72,72,0,0,"PREPAL",0
37,"37277",75,58,58,0,0,"PREPAL",0
37,"37036",61,44,43,0,1,"PREPAL",0
49,"49158",215,170,166,2,4,"PREPAL",0
49,"49256",256,204,204,0,0,"PREPAL",0
49,"49037",185,153,151,0,2,"PREPAL",0
37,"37112",161,112,111,2,1,"PREPAL",0
37,"37348",115,96,95,0,1,"PREPAL",0
49,"49095",291,221,220,0,1,"PREPAL",0
24,"24109",977,633,624,3,9,"PREPAL",3
49,"49159",271,209,205,4,4,"PREPAL",0
24,"24167",750,505,499,4,6,"PREPAL",1
24,"24901",889,636,623,5,13,"PREPAL",2
24,"24096",117,80,79,1,1,"PREPAL",0
37,"37019",150,123,120,0,3,"PREPAL",0
37,"37090",52,43,43,0,0,"PREPAL",0
37,"37108",99,79,78,0,1,"PREPAL",0
49,"49034",432,327,325,2,2,"PREPAL",0
37,"37252",112,79,79,0,0,"PREPAL",0
37,"37331",212,137,135,0,2,"PREPAL",0
24,"24189",5865,3933,3885,31,48,"PREPAL",4
49,"49275",52210,36205,35754,356,451,"PREPAL",74
49,"49018",329,261,256,2,5,"PREPAL",0
37,"37243",98,70,70,1,0,"PREPAL",0
49,"49110",348,231,229,0,2,"PREPAL",0
49,"49015",227,179,177,0,2,"PREPAL",0
37,"37309",44,30,30,1,0,"PREPAL",0
24,"24038",3089,2312,2273,17,39,"PREPAL",0
49,"49241",248,177,177,0,0,"PREPAL",0
37,"37038",788,595,583,4,12,"PREPAL",1
49,"49249",69,58,58,1,0,"PREPAL",0
49,"49224",162,112,112,1,0,"PREPAL",0
49,"49127",2367,1668,1650,16,18,"PREPAL",5
24,"24080",213,164,161,3,3,"PREPAL",1
37,"37338",79,65,64,0,1,"PREPAL",0
37,"37065",312,223,222,3,1,"PREPAL",0
49,"49098",219,167,165,0,2,"PREPAL",0
37,"37050",66,52,52,0,0,"PREPAL",0
37,"37379",174,133,131,1,2,"PREPAL",1
49,"49090",197,143,141,6,2,"PREPAL",0
24,"24210",503,358,356,3,2,"PREPAL",0
49,"49004",126,100,100,4,0,"PREPAL",0
49,"49264",578,383,377,5,6,"PREPAL",1
49,"49234",412,328,324,0,4,"PREPAL",0
37,"37115",123,89,87,0,2,"PREPAL",0
37,"37067",3163,2496,2467,31,29,"PREPAL",2
49,"49150",139,112,111,1,1,"PREPAL",0
24,"24206",1700,1253,1240,12,13,"PREPAL",0
37,"37339",315,251,251,4,0,"PREPAL",1
24,"24092",798,606,602,1,4,"PREPAL",2
24,"24137",1099,783,778,7,5,"PREPAL",1
24,"24070",4124,3024,2981,20,43,"PREPAL",2
49,"49099",115,87,87,0,0,"PREPAL",0
37,"37181",286,210,207,4,3,"PREPAL",0
49,"49022",288,229,225,3,4,"PREPAL",0
49,"49053",931,709,699,8,10,"PREPAL",1
37,"37270",189,152,151,2,1,"PREPAL",0
37,"37238",110,87,85,0,2,"PREPAL",0
37,"37229",135,112,112,0,0,"PREPAL",1
37,"37062",83,65,64,1,1,"PREPAL",0
49,"49125",1391,933,918,10,15,"PREPAL",0
49,"49194",368,218,216,1,2,"PREPAL",0
24,"24053",442,286,280,1,6,"PREPAL",0
37,"37234",345,247,247,1,0,"PREPAL",0
37,"37070",529,399,392,1,7,"PREPAL",0
37,"37025",257,220,220,4,0,"PREPAL",0
24,"24182",416,294,290,2,4,"PREPAL",0
49,"49138",234,184,184,3,0,"PREPAL",0
49,"49008",460,332,331,5,1,"PREPAL",0
49,"49225",147,91,90,0,1,"PREPAL",0
24,"24176",316,247,244,1,3,"PREPAL",0
37,"37030",85,66,66,0,0,"PREPAL",0
49,"49183",100,77,77,2,0,"PREPAL",0
37,"37342",259,189,186,0,3,"PREPAL",0
24,"24162",1683,1257,1246,13,11,"PREPAL",2
37,"37369",137,95,94,0,1,"PREPAL",0
49,"49059",94,64,64,0,0,"PREPAL",0
24,"24230",426,322,320,5,2,"PREPAL",0
37,"37216",302,252,248,3,4,"PREPAL",0
37,"37254",181,142,141,0,1,"PREPAL",0
37,"37268",112,76,76,0,0,"PREPAL",0
37,"37134",230,168,165,0,3,"PREPAL",0
49,"49242",447,360,357,5,3,"PREPAL",0
49,"49061",150,114,112,2,2,"PREPAL",1
24,"24163",3962,2950,2933,24,17,"PREPAL",1
37,"37371",272,165,162,1,3,"PREPAL",0
37,"37202",978,734,727,10,7,"PREPAL",1
37,"37072",168,140,138,0,2,"PREPAL",0
49,"49141",340,248,246,0,2,"PREPAL",0
37,"37343",60,47,47,0,0,"PREPAL",0
37,"37218",67,42,41,0,1,"PREPAL",0
49,"49168",93,74,74,0,0,"PREPAL",0
49,"49265",128,91,91,1,0,"PREPAL",1
37,"37274",118913,85506,84764,566,742,"PREPAL",110
49,"49133",304,214,213,1,1,"PREPAL",0
24,"24103",283,163,157,1,6,"PREPAL",0
37,"37317",304,238,234,1,4,"PREPAL",0
37,"37359",184,130,129,0,1,"PREPAL",0
24,"24008",9282,6685,6603,52,82,"PREPAL",5
24,"24146",265,210,207,1,3,"PREPAL",0
37,"37163",41,34,34,0,0,"PREPAL",0
49,"49096",170,131,124,2,7,"PREPAL",0
37,"37336",52,50,50,1,0,"PREPAL",0
37,"37118",123,92,90,0,2,"PREPAL",1
37,"37346",273,212,211,1,1,"PREPAL",0
37,"37332",68,51,50,0,1,"PREPAL",0
24,"24097",218,140,139,3,1,"PREPAL",0
24,"24198",592,412,407,2,5,"PREPAL",0
49,"49058",307,237,233,0,4,"PREPAL",0
24,"24010",8386,5708,5632,60,76,"PREPAL",6
37,"37146",117,96,95,1,1,"PREPAL",0
37,"37351",281,229,227,0,2,"PREPAL",0
37,"37099",73,41,41,0,0,"PREPAL",0
37,"37165",33,26,25,0,1,"PREPAL",0
24,"24119",706,488,481,3,7,"PREPAL",0
37,"37077",261,226,223,1,3,"PREPAL",0
37,"37092",1758,1225,1215,8,10,"PREPAL",0
24,"24065",2138,1503,1472,15,31,"PREPAL",1
37,"37347",468,348,346,2,2,"PREPAL",0
24,"24173",951,679,674,9,5,"PREPAL",0
49,"49077",183,103,103,0,0,"PREPAL",0
24,"24160",684,483,474,6,9,"PREPAL",1
49,"49085",996,684,680,2,4,"PREPAL",2
24,"24001",189,124,122,0,2,"PREPAL",0
37,"37004",30,21,21,0,0,"PREPAL",0
37,"37361",86,66,66,0,0,"PREPAL",0
37,"37138",203,149,148,2,1,"PREPAL",0
37,"37305",216,171,170,0,1,"PREPAL",2
24,"24011",203,133,132,0,1,"PREPAL",0
49,"49065",1103,836,818,2,18,"PREPAL",0
49,"49268",403,313,309,1,4,"PREPAL",0
37,"37018",107,79,79,0,0,"PREPAL",0
24,"24177",476,325,322,3,3,"PREPAL",0
37,"37139",205,169,168,2,1,"PREPAL",0
24,"24129",122,89,89,1,0,"PREPAL",0
24,"24184",198,118,117,0,1,"PREPAL",0
37,"37349",117,88,88,0,0,"PREPAL",1
37,"37136",652,440,435,3,5,"PREPAL",0
37,"37113",433,334,333,3,1,"PREPAL",0
37,"37052",273,209,209,2,0,"PREPAL",0
37,"37080",225,171,167,0,4,"PREPAL",0
24,"24037",360,254,250,2,4,"PREPAL",0
24,"24207",294,241,238,3,3,"PREPAL",0
49,"49117",465,330,324,6,6,"PREPAL",0
24,"24229",418,322,319,2,3,"PREPAL",0
49,"49014",112,91,91,2,0,"PREPAL",0
24,"24002",231,173,172,1,1,"PREPAL",0
37,"37224",206,183,175,3,8,"PREPAL",0
49,"49271",194,145,141,1,4,"PREPAL",0
37,"37272",141,107,104,0,3,"PREPAL",0
24,"24094",1385,983,968,11,15,"PREPAL",3
24,"24141",95,85,84,0,1,"PREPAL",0
37,"37258",172,116,115,3,1,"PREPAL",0
49,"49028",115,104,103,1,1,"PREPAL",0
49,"49123",546,391,384,1,7,"PREPAL",1
24,"24112",309,228,227,1,1,"PREPAL",0
24,"24123",746,488,485,2,3,"PREPAL",0
37,"37211",224,172,172,4,0,"PREPAL",0
49,"49203",313,240,232,0,8,"PREPAL",0
24,"24003",648,460,453,7,7,"PREPAL",0
37,"37365",172,134,133,1,1,"PREPAL",1
49,"49192",130,110,109,2,1,"PREPAL",0
37,"37039",301,217,213,0,4,"PREPAL",0
49,"49029",623,495,488,3,7,"PREPAL",1
37,"37129",251,204,201,3,3,"PREPAL",0
49,"49056",300,211,208,2,3,"PREPAL",0
37,"37051",85,66,66,0,0,"PREPAL",0
24,"24102",652,470,467,2,3,"PREPAL",1
49,"49124",253,174,169,1,5,"PREPAL",0
37,"37228",360,297,295,2,2,"PREPAL",0
37,"37083",182,156,155,0,1,"PREPAL",0
49,"49069",367,258,254,5,4,"PREPAL",0
49,"49137",176,139,138,0,1,"PREPAL",0
37,"37171",409,317,310,2,7,"PREPAL",0
24,"24033",205,158,157,0,1,"PREPAL",0
24,"24089",102747,74428,73688,631,740,"PREPAL",85
49,"49223",752,608,600,4,8,"PREPAL",1
37,"37354",5240,3823,3771,39,52,"PREPAL",5
37,"37010",939,708,702,0,6,"PREPAL",0
37,"37058",58,45,45,0,0,"PREPAL",0
37,"37186",104,85,85,2,0,"PREPAL",0
49,"49219",7464,4988,4914,53,74,"PREPAL",2
37,"37247",196,163,162,3,1,"PREPAL",0
24,"24214",656,490,485,3,5,"PREPAL",0
24,"24154",1005,673,666,4,7,"PREPAL",1
49,"49262",392,279,274,1,5,"PREPAL",0
37,"37368",17,17,17,0,0,"PREPAL",0
49,"49087",521,322,318,0,4,"PREPAL",0
49,"49114",43,34,33,0,1,"PREPAL",1
49,"49126",235,155,154,2,1,"PREPAL",0
24,"24131",724,511,507,3,4,"PREPAL",1
49,"49064",515,346,338,6,8,"PREPAL",0
49,"49080",685,520,514,2,6,"PREPAL",0
24,"24139",2183,1548,1525,16,23,"PREPAL",1
37,"37370",328,258,254,1,4,"PREPAL",1
37,"37245",346,261,259,2,2,"PREPAL",0
24,"24051",423,309,307,0,2,"PREPAL",0
37,"37285",403,310,308,2,2,"PREPAL",1
49,"49237",165,119,117,2,2,"PREPAL",0
24,"24209",2769,1888,1865,12,23,"PREPAL",1
49,"49178",705,496,487,4,9,"PREPAL",0
37,"37170",1449,994,971,3,23,"PREPAL",1
24,"24136",540,387,383,4,4,"PREPAL",0
49,"49102",196,143,139,2,4,"PREPAL",1
37,"37071",78,65,64,0,1,"PREPAL",0
37,"37147",193,134,132,1,2,"PREPAL",0
37,"37027",228,172,171,0,1,"PREPAL",0
24,"24018",174,143,141,0,2,"PREPAL",0
49,"49021",14330,9878,9758,95,120,"PREPAL",14
24,"24052",158,104,102,0,2,"PREPAL",0
24,"24073",478,332,328,2,4,"PREPAL",0
37,"37176",133,110,110,0,0,"PREPAL",0
37,"37288",262,182,181,4,1,"PREPAL",0
37,"37089",67,56,56,0,0,"PREPAL",0
24,"24062",139,98,98,1,0,"PREPAL",0
37,"37106",258,165,162,0,3,"PREPAL",0
49,"49033",714,508,505,1,3,"PREPAL",0
24,"24106",248,167,166,1,1,"PREPAL",0
24,"24174",486,343,342,4,1,"PREPAL",0
49,"49026",226,179,176,0,3,"PREPAL",0
49,"49039",338,245,239,3,6,"PREPAL",1
37,"37299",219,166,163,4,3,"PREPAL",0
24,"24157",2568,1943,1911,22,32,"PREPAL",2
49,"49071",765,495,490,2,5,"PREPAL",0
49,"49006",154,99,95,0,4,"PREPAL",0
37,"37123",177,126,126,0,0,"PREPAL",0
49,"49130",180,143,141,5,2,"PREPAL",0
37,"37122",201,154,153,5,1,"PREPAL",0
37,"37262",78,64,63,0,1,"PREPAL",0
49,"49266",76,63,61,2,2,"PREPAL",0
49,"49177",278,179,177,1,2,"PREPAL",1
37,"37054",250,195,192,1,3,"PREPAL",0
24,"24134",3416,2470,2417,19,53,"PREPAL",8
37,"37235",224,153,148,2,5,"PREPAL",0
49,"49214",698,525,512,3,13,"PREPAL",1
49,"49093",280,223,222,1,1,"PREPAL",0
24,"24212",1032,773,760,4,13,"PREPAL",0
49,"49267",88,73,69,2,4,"PREPAL",0
49,"49229",126,93,93,0,0,"PREPAL",0
37,"37374",1166,935,919,9,16,"PREPAL",0
49,"49012",73,43,43,0,0,"PREPAL",0
37,"37012",154,116,115,1,1,"PREPAL",1
37,"37056",37,30,29,0,1,"PREPAL",0
37,"37152",418,290,286,2,4,"PREPAL",0
49,"49199",254,193,189,3,4,"PREPAL",0
37,"37166",214,152,151,2,1,"PREPAL",0
24,"24055",708,516,512,0,4,"PREPAL",0
24,"24224",616,454,451,4,3,"PREPAL",0
37,"37375",700,578,570,4,8,"PREPAL",0
37,"37184",327,255,252,2,3,"PREPAL",0
49,"49041",432,326,322,5,4,"PREPAL",0
49,"49260",755,590,586,8,4,"PREPAL",0
37,"37237",324,244,240,1,4,"PREPAL",0
37,"37032",548,401,399,0,2,"PREPAL",0
37,"37362",4632,3389,3351,25,38,"PREPAL",6
49,"49243",111,94,93,0,1,"PREPAL",0
37,"37265",220,181,181,0,0,"PREPAL",0
24,"24023",263,188,188,1,0,"PREPAL",1
24,"24012",290,207,205,1,2,"PREPAL",1
37,"37312",258,201,200,2,1,"PREPAL",0
37,"37037",117,84,82,0,2,"PREPAL",0
24,"24168",460,361,359,0,2,"PREPAL",1
24,"24181",1493,1054,1045,5,9,"PREPAL",0
37,"37028",147,116,112,0,4,"PREPAL",0
37,"37121",575,418,413,3,5,"PREPAL",1
37,"37102",404,307,305,2,2,"PREPAL",0
24,"24203",95,69,68,0,1,"PREPAL",0
37,"37098",333,247,247,1,0,"PREPAL",0
37,"37182",75,56,55,0,1,"PREPAL",0
37,"37049",137,96,96,1,0,"PREPAL",0
37,"37197",84,57,57,2,0,"PREPAL",0
37,"37059",124,94,93,1,1,"PREPAL",0
37,"37087",862,639,635,2,4,"PREPAL",2
24,"24101",397,258,257,3,1,"PREPAL",0
24,"24058",208,155,154,3,1,"PREPAL",0
37,"37364",820,607,598,6,9,"PREPAL",0
49,"49084",287,229,228,4,1,"PREPAL",1
37,"37156",4292,2996,2966,24,30,"PREPAL",4
24,"24226",199,139,137,0,2,"PREPAL",0
37,"37183",414,306,304,0,2,"PREPAL",2
49,"49233",93,58,55,0,3,"PREPAL",0
49,"49174",125,95,92,1,3,"PREPAL",0
49,"49025",173,133,133,1,0,"PREPAL",0
37,"37022",268,215,215,2,0,"PREPAL",0
24,"24159",1806,1386,1366,6,20,"PREPAL",3
49,"49111",127,98,96,4,2,"PREPAL",0
37,"37282",204,149,148,1,1,"PREPAL",1
49,"49221",245,129,127,1,2,"PREPAL",0
24,"24216",723,522,518,1,4,"PREPAL",0
37,"37162",204,152,151,0,1,"PREPAL",0
37,"37040",391,299,297,2,2,"PREPAL",0
49,"49167",197,147,145,0,2,"PREPAL",0
49,"49163",219,158,154,5,4,"PREPAL",1
37,"37353",126,97,97,1,0,"PREPAL",0
37,"37009",213,172,171,3,1,"PREPAL",0
37,"37185",591,423,417,2,6,"PREPAL",2
49,"49100",295,212,208,5,4,"PREPAL",0
37,"37242",91,74,73,0,1,"PREPAL",0
37,"37367",201,164,161,0,3,"PREPAL",0
49,"49227",315,230,228,2,2,"PREPAL",0
49,"49180",148,103,102,2,1,"PREPAL",0
49,"49030",86,69,69,0,0,"PREPAL",0
49,"49186",261,188,185,0,3,"PREPAL",0
37,"37363",118,88,87,0,1,"PREPAL",0
37,"37381",147,114,107,2,7,"PREPAL",0
37,"37203",158,117,117,0,0,"PREPAL",0
37,"37159",90,70,70,1,0,"PREPAL",0
49,"49190",63,47,45,0,2,"PREPAL",0
24,"24006",472,353,347,0,6,"PREPAL",1
37,"37341",53,39,39,0,0,"PREPAL",0
37,"37145",259,190,189,2,1,"PREPAL",1
37,"37382",173,137,137,0,0,"PREPAL",0
37,"37289",232,167,166,3,1,"PREPAL",0
37,"37230",221,159,159,2,0,"PREPAL",0
49,"49044",80,60,58,0,2,"PREPAL",0
49,"49166",1227,946,933,6,13,"PREPAL",0
37,"37215",136,104,103,1,1,"PREPAL",0
24,"24219",516,387,386,4,1,"PREPAL",1
37,"37329",42,34,34,0,0,"PREPAL",0
24,"24017",577,426,418,1,8,"PREPAL",0
37,"37356",87,67,65,0,2,"PREPAL",0
49,"49050",507,342,338,1,4,"PREPAL",1
49,"49149",390,273,268,3,5,"PREPAL",1
24,"24105",1459,1042,1025,16,17,"PREPAL",1
24,"24084",163,116,116,0,0,"PREPAL",0
37,"37088",207,163,162,3,1,"PREPAL",0
37,"37120",99,82,78,0,4,"PREPAL",0
37,"37287",310,213,210,2,3,"PREPAL",1
24,"24029",735,539,535,3,4,"PREPAL",0
24,"24069",41,35,35,0,0,"PREPAL",0
37,"37100",80,61,61,1,0,"PREPAL",0
37,"37232",390,341,339,1,2,"PREPAL",0
49,"49226",255,198,195,0,3,"PREPAL",0
24,"24197",763,538,533,1,5,"PREPAL",3
37,"37316",744,563,558,3,5,"PREPAL",2
49,"49062",122,90,89,0,1,"PREPAL",0
37,"37233",61,48,47,1,1,"PREPAL",0
37,"37061",225,168,168,1,0,"PREPAL",1
24,"24117",434,334,331,1,3,"PREPAL",0
24,"24133",356,257,257,1,0,"PREPAL",0
49,"49122",782,526,520,5,6,"PREPAL",2
24,"24041",538,367,366,3,1,"PREPAL",0
49,"49057",109,85,83,1,2,"PREPAL",0
49,"49247",443,283,279,2,4,"PREPAL",0
49,"49201",302,270,268,3,2,"PREPAL",0
49,"49235",443,301,292,0,9,"PREPAL",0
49,"49104",343,234,232,0,2,"PREPAL",1
49,"49156",237,184,175,0,9,"PREPAL",2
37,"37304",169,124,124,0,0,"PREPAL",0
37,"37178",100,76,75,0,1,"PREPAL",0
24,"24130",438,323,321,4,2,"PREPAL",2
24,"24144",695,470,465,2,5,"PREPAL",1
49,"49206",840,614,604,9,10,"PREPAL",0
37,"37137",105,66,66,0,0,"PREPAL",0
49,"49118",203,161,160,1,1,"PREPAL",0
24,"24108",376,280,277,2,3,"PREPAL",0
49,"49119",227,169,168,0,1,"PREPAL",0
37,"37333",224,142,142,1,0,"PREPAL",0
24,"24021",1675,1162,1144,8,18,"PREPAL",2
37,"37044",466,362,360,2,2,"PREPAL",0
24,"24199",424,302,301,0,1,"PREPAL",0
24,"24024",692,496,491,4,5,"PREPAL",1
49,"49020",289,214,214,2,0,"PREPAL",0
49,"49107",126,94,93,2,1,"PREPAL",0
37,"37110",113,86,86,1,0,"PREPAL",0
24,"24145",654,463,461,2,2,"PREPAL",0
49,"49171",646,514,508,10,6,"PREPAL",0
24,"24132",615,379,375,1,4,"PREPAL",0
24,"24088",1029,791,789,10,2,"PREPAL",1
24,"24221",795,543,538,7,5,"PREPAL",1
24,"24127",296,226,215,4,11,"PREPAL",1
49,"49238",254,194,193,1,1,"PREPAL",0
37,"37357",262,205,203,1,2,"PREPAL",0
37,"37213",89,74,73,0,1,"PREPAL",0
37,"37366",43,32,32,0,0,"PREPAL",0
49,"49120",74,53,52,0,1,"PREPAL",0
24,"24202",8008,5367,5276,53,91,"PREPAL",5
24,"24171",356,197,196,0,1,"PREPAL",1
49,"49172",527,347,343,1,4,"PREPAL",0
24,"24005",378,260,257,2,3,"PREPAL",0
49,"49113",167,137,135,1,2,"PREPAL",0
24,"24178",70,59,58,0,1,"PREPAL",0
37,"37195",46,36,36,1,0,"PREPAL",0
49,"49002",63,51,49,0,2,"PREPAL",0
37,"37298",179,127,126,0,1,"PREPAL",0
37,"37328",186,135,131,1,4,"PREPAL",0
37,"37327",185,149,146,3,3,"PREPAL",0
37,"37068",365,267,267,1,0,"PREPAL",0
37,"37266",82,63,63,2,0,"PREPAL",0
37,"37047",180,84,84,0,0,"PREPAL",0
49,"49173",375,230,221,3,9,"PREPAL",0
24,"24100",761,561,555,7,6,"PREPAL",0
37,"37029",209,137,135,1,2,"PREPAL",0
24,"24169",2969,2140,2118,13,22,"PREPAL",1
37,"37196",75,64,64,0,0,"PREPAL",0
49,"49097",85,52,51,0,1,"PREPAL",0
37,"37378",111,77,75,2,2,"PREPAL",0
24,"24079",906,664,658,9,6,"PREPAL",2
49,"49202",187,130,130,4,0,"PREPAL",0
37,"37020",430,326,321,1,5,"PREPAL",2
24,"24149",152,120,116,3,4,"PREPAL",0
37,"37221",430,293,290,0,3,"PREPAL",0
37,"37281",36,33,31,0,2,"PREPAL",0
37,"37240",945,623,619,5,4,"PREPAL",0
49,"49055",102,82,82,2,0,"PREPAL",0
37,"37324",360,276,275,2,1,"PREPAL",0
37,"37241",168,131,131,1,0,"PREPAL",1
49,"49188",112,90,89,1,1,"PREPAL",0
37,"37104",27,22,22,0,0,"PREPAL",0
49,"49024",672,459,454,5,5,"PREPAL",1
37,"37319",114,78,74,0,4,"PREPAL",0
37,"37236",135,105,103,1,2,"PREPAL",1
37,"37330",339,248,246,0,2,"PREPAL",2
24,"24007",773,550,548,4,2,"PREPAL",0
24,"24040",449,329,325,2,4,"PREPAL",0
49,"49273",187,112,112,0,0,"PREPAL",0
37,"37101",160,128,125,0,3,"PREPAL",0
49,"49239",663,458,448,3,10,"PREPAL",0
37,"37144",363,277,276,1,1,"PREPAL",1
24,"24153",232,179,177,2,2,"PREPAL",0
49,"49142",249,180,179,0,1,"PREPAL",1
37,"37085",4712,3366,3333,27,33,"PREPAL",2
37,"37340",151,106,106,1,0,"PREPAL",0
49,"49205",382,293,291,2,2,"PREPAL",1
37,"37005",74,54,54,2,0,"PREPAL",0
49,"49147",263,190,186,0,4,"PREPAL",0
49,"49042",244,178,176,1,2,"PREPAL",0
37,"37086",101,72,71,1,1,"PREPAL",0
37,"37271",368,297,296,0,1,"PREPAL",2
24,"24151",478,353,352,1,1,"PREPAL",0
37,"37024",89,67,67,0,0,"PREPAL",0
49,"49236",75,58,58,0,0,"PREPAL",0
37,"37355",178,142,142,1,0,"PREPAL",0
49,"49019",243,188,182,2,6,"PREPAL",0
49,"49191",272,213,206,2,7,"PREPAL",0
49,"49088",87,61,60,0,1,"PREPAL",0
24,"24152",464,295,291,1,4,"PREPAL",0
37,"37119",107,84,82,0,2,"PREPAL",0
37,"37263",342,237,229,0,8,"PREPAL",0
49,"49031",148,120,119,6,1,"PREPAL",0
37,"37160",615,434,429,8,5,"PREPAL",0
24,"24122",1342,930,924,8,6,"PREPAL",0
49,"49068",462,310,304,4,6,"PREPAL",0
37,"37169",176,127,126,0,1,"PREPAL",0
49,"49263",51,36,36,0,0,"PREPAL",0
24,"24039",2063,1597,1596,41,1,"PREPAL",0
37,"37259",44,28,28,0,0,"PREPAL",0
37,"37273",107,71,71,1,0,"PREPAL",0
49,"49081",1382,1016,1003,9,13,"PREPAL",0
37,"37045",26,23,21,0,2,"PREPAL",0
37,"37192",356,231,227,2,4,"PREPAL",0
24,"24026",1177,864,849,7,15,"PREPAL",4
24,"24116",417,314,309,1,5,"PREPAL",2
37,"37013",119,79,76,0,3,"PREPAL",0
49,"49136",318,220,218,1,2,"PREPAL",2
49,"49155",79,61,60,3,1,"PREPAL",0
24,"24086",270,223,218,0,5,"PREPAL",0
37,"37335",406,296,290,0,6,"PREPAL",0
49,"49038",99,71,65,1,6,"PREPAL",0
37,"37251",124,93,92,1,1,"PREPAL",1
37,"37126",29,24,24,0,0,"PREPAL",0
24,"24093",360,249,248,2,1,"PREPAL",0
49,"49193",467,313,308,4,5,"PREPAL",1
49,"49244",43,29,29,0,0,"PREPAL",0
49,"49131",264,194,192,6,2,"PREPAL",0
49,"49151",619,459,456,2,3,"PREPAL",0
37,"37131",185,139,139,0,0,"PREPAL",0
24,"24059",880,536,535,4,1,"PREPAL",0
49,"49143",225,163,162,0,1,"PREPAL",0
37,"37002",139,87,86,0,1,"PREPAL",1
37,"37191",114,78,75,1,3,"PREPAL",0
37,"37150",41,34,34,0,0,"PREPAL",0
37,"37016",569,406,401,2,5,"PREPAL",0
37,"37015",224,144,144,1,0,"PREPAL",1
24,"24155",471,388,384,6,4,"PREPAL",0
37,"37164",256,191,189,5,2,"PREPAL",0
37,"37249",43,29,29,0,0,"PREPAL",0
37,"37172",888,572,566,3,6,"PREPAL",4
49,"49245",262,176,173,2,3,"PREPAL",0
24,"24166",1407,1013,993,8,20,"PREPAL",0
24,"24042",63,56,56,1,0,"PREPAL",0
49,"49210",471,370,365,1,5,"PREPAL",2
24,"24031",215,172,168,0,4,"PREPAL",0
49,"49269",229,165,162,1,3,"PREPAL",0
37,"37017",245,182,177,1,5,"PREPAL",0
49,"49146",295,216,213,3,3,"PREPAL",0
24,"24188",3822,2850,2817,19,33,"PREPAL",2
24,"24120",341,246,244,1,2,"PREPAL",0
24,"24098",1193,842,831,11,11,"PREPAL",0
37,"37291",272,207,206,0,1,"PREPAL",0
24,"24014",7425,5124,5053,32,71,"PREPAL",2
37,"37208",76,56,54,1,2,"PREPAL",0
49,"49066",492,336,332,4,4,"PREPAL",0
49,"49116",383,276,269,3,7,"PREPAL",0
49,"49179",371,238,237,0,1,"PREPAL",0
37,"37255",49,34,34,1,0,"PREPAL",0
24,"24218",451,330,325,2,5,"PREPAL",0
24,"24150",243,172,172,6,0,"PREPAL",0
49,"49222",380,279,272,0,7,"PREPAL",2
49,"49189",202,142,142,1,0,"PREPAL",0
49,"49112",126,75,75,0,0,"PREPAL",1
24,"24016",466,270,269,1,1,"PREPAL",1
49,"49176",667,433,431,1,2,"PREPAL",0
49,"49145",236,162,157,0,5,"PREPAL",1
49,"49135",626,434,430,1,4,"PREPAL",2
37,"37244",131,98,98,0,0,"PREPAL",0
49,"49185",157,123,122,2,1,"PREPAL",0
37,"37256",218,156,152,1,4,"PREPAL",0
24,"24114",3061,2025,1994,9,31,"PREPAL",1
49,"49003",900,612,599,5,13,"PREPAL",0
37,"37318",208,159,158,1,1,"PREPAL",0
37,"37350",420,318,314,5,4,"PREPAL",1
49,"49270",133,99,99,1,0,"PREPAL",0
49,"49027",140,112,108,1,4,"PREPAL",0
37,"37007",437,314,306,3,8,"PREPAL",1
37,"37323",516,376,372,5,4,"PREPAL",1
24,"24217",135,109,108,1,1,"PREPAL",0
37,"37158",246,183,183,0,0,"PREPAL",0
24,"24027",1211,863,847,8,16,"PREPAL",1
24,"24057",1373,1045,1023,11,22,"PREPAL",0
37,"37128",260,202,196,0,6,"PREPAL",0
24,"24054",430,314,313,1,1,"PREPAL",3
37,"37199",142,105,105,1,0,"PREPAL",0
37,"37212",104,78,74,0,4,"PREPAL",0
37,"37246",5304,3993,3949,26,44,"PREPAL",4
37,"37179",209,180,180,0,0,"PREPAL",0
24,"24043",134,75,75,1,0,"PREPAL",0
49,"49272",88,70,69,1,1,"PREPAL",0
37,"37231",250,196,193,4,3,"PREPAL",0
24,"24050",102,77,76,0,1,"PREPAL",0
49,"49152",525,339,334,2,5,"PREPAL",0
24,"24081",140,98,92,0,6,"PREPAL",0
37,"37154",140,113,110,3,3,"PREPAL",1
24,"24225",1014,752,739,10,13,"PREPAL",0
49,"49032",326,259,259,1,0,"PREPAL",1
37,"37225",103,89,86,0,3,"PREPAL",0
24,"24161",285,203,201,3,2,"PREPAL",0
37,"37117",1494,1067,1048,3,19,"PREPAL",0
24,"24078",380,289,277,0,12,"PREPAL",0
49,"49231",330,232,232,2,0,"PREPAL",0
49,"49013",246,182,181,2,1,"PREPAL",0
24,"24125",462,290,286,4,4,"PREPAL",0
24,"24077",225,190,187,2,3,"PREPAL",0
24,"24049",1483,1054,1048,6,6,"PREPAL",0
37,"37149",68,64,64,0,0,"PREPAL",0
37,"37074",150,123,120,0,3,"PREPAL",0
49,"49197",175,123,123,1,0,"PREPAL",0
37,"37321",168,132,132,2,0,"PREPAL",0
37,"37278",732,532,528,3,4,"PREPAL",0
49,"49067",367,250,249,0,1,"PREPAL",1
24,"24090",343,235,233,1,2,"PREPAL",1
49,"49043",289,217,213,1,4,"PREPAL",0
49,"49007",370,255,249,1,6,"PREPAL",0
24,"24060",602,363,361,3,2,"PREPAL",0
37,"37188",181,129,129,3,0,"PREPAL",0
49,"49035",226,200,196,3,4,"PREPAL",0
49,"49063",338,272,266,4,6,"PREPAL",1
37,"37239",217,185,183,3,2,"PREPAL",1
24,"24143",510,358,349,0,9,"PREPAL",0
24,"24215",152,113,113,0,0,"PREPAL",0
49,"49255",418,319,316,1,3,"PREPAL",0
37,"37034",85,65,65,0,0,"PREPAL",0
37,"37337",139,124,124,0,0,"PREPAL",0
49,"49160",49,33,33,0,0,"PREPAL",0
49,"49162",186,142,140,1,2,"PREPAL",0
49,"49010",345,279,273,5,6,"PREPAL",0
49,"49184",172,115,112,0,3,"PREPAL",0
37,"37283",123,92,90,0,2,"PREPAL",0
24,"24099",171,132,132,0,0,"PREPAL",0
37,"37360",225,174,173,1,1,"PREPAL",0
49,"49101",153,102,99,0,3,"PREPAL",0
37,"37033",95,68,68,5,0,"PREPAL",0
37,"37267",200,156,147,2,9,"PREPAL",1
37,"37226",155,123,123,2,0,"PREPAL",0
37,"37081",930,728,722,3,6,"PREPAL",0
24,"24165",354,240,238,2,2,"PREPAL",0
37,"37006",138,103,103,2,0,"PREPAL",0
49,"49134",172,121,119,0,2,"PREPAL",0
49,"49187",1236,896,888,4,8,"PREPAL",0
24,"24180",1134,812,800,9,12,"PREPAL",0
24,"24118",126,88,88,1,0,"PREPAL",1
37,"37194",251,196,195,1,1,"PREPAL",0
49,"49083",52,44,44,2,0,"PREPAL",0
24,"24009",322,153,152,2,1,"PREPAL",0
24,"24083",1042,727,715,6,12,"PREPAL",1
24,"24194",290,212,212,3,0,"PREPAL",0
49,"49076",321,217,217,2,0,"PREPAL",1
37,"37373",748,503,499,1,4,"PREPAL",0
24,"24158",320,207,203,2,4,"PREPAL",0
37,"37377",241,201,199,1,2,"PREPAL",0
37,"37011",121,91,91,3,0,"PREPAL",0
37,"37060",243,187,187,1,0,"PREPAL",0
24,"24030",4277,3038,3007,11,31,"PREPAL",0
24,"24172",418,255,250,2,5,"PREPAL",0
37,"37168",439,316,311,0,5,"PREPAL",0
24,"24020",456,314,307,4,7,"PREPAL",0
37,"37141",154,122,122,2,0,"PREPAL",0
49,"49105",150,109,108,0,1,"PREPAL",0
49,"49228",54,44,43,0,1,"PREPAL",0
37,"37257",52,46,46,0,0,"PREPAL",0
37,"37116",69,50,50,0,0,"PREPAL",0
37,"37114",84,70,69,2,1,"PREPAL",0
37,"37280",78,53,53,0,0,"PREPAL",0
49,"49048",124,97,95,0,2,"PREPAL",1
24,"24175",1832,1314,1297,14,17,"PREPAL",0
49,"49252",320,254,252,5,2,"PREPAL",0
37,"37023",1413,1072,1060,5,12,"PREPAL",0
37,"37294",11692,8317,8221,71,96,"PREPAL",7
24,"24902",347,270,269,2,1,"PREPAL",0
24,"24046",942,637,633,5,4,"PREPAL",3
24,"24107",236,175,173,0,2,"PREPAL",0
37,"37214",129,93,91,0,2,"PREPAL",1
24,"24104",259,169,169,0,0,"PREPAL",0
37,"37042",44,28,27,0,1,"PREPAL",0
37,"37200",187,136,136,0,0,"PREPAL",0
43,"43053",191,144,143,3,1,"PSC-PSOE",13
17,"17169",2475,1619,1601,11,18,"PSC-PSOE",212
8,"8182",2811,1799,1789,22,10,"PSC-PSOE",413
25,"25163",231,135,132,2,3,"PSC-PSOE",1
43,"43162",4346,2983,2958,21,25,"PSC-PSOE",464
25,"25191",334,205,204,4,1,"PSC-PSOE",16
8,"8119",6180,4155,4123,28,32,"PSC-PSOE",634
17,"17082",417,255,253,2,2,"PSC-PSOE",2
43,"43061",45,30,29,0,1,"PSC-PSOE",3
43,"43906",2102,1364,1346,15,18,"PSC-PSOE",125
17,"17173",180,132,131,0,1,"PSC-PSOE",17
43,"43048",805,525,513,8,12,"PSC-PSOE",54
17,"17102",571,400,400,6,0,"PSC-PSOE",24
17,"17193",4216,2555,2525,16,30,"PSC-PSOE",319
25,"25156",783,543,537,7,6,"PSC-PSOE",48
8,"8016",1831,1136,1129,19,7,"PSC-PSOE",141
17,"17130",325,223,222,3,1,"PSC-PSOE",2
43,"43025",600,408,404,2,4,"PSC-PSOE",105
8,"8150",255,186,186,1,0,"PSC-PSOE",5
43,"43121",599,354,348,1,6,"PSC-PSOE",22
8,"8158",3082,2054,2041,21,13,"PSC-PSOE",327
17,"17168",380,260,258,0,2,"PSC-PSOE",23
8,"8240",9348,6512,6483,38,29,"PSC-PSOE",1023
8,"8002",201,130,124,0,6,"PSC-PSOE",1
8,"8200",61409,41278,41024,312,254,"PSC-PSOE",9717
25,"25056",235,143,143,2,0,"PSC-PSOE",13
8,"8178",435,309,308,4,1,"PSC-PSOE",30
25,"25051",1527,931,920,11,11,"PSC-PSOE",67
8,"8901",227,148,145,1,3,"PSC-PSOE",3
8,"8042",2231,1565,1558,17,7,"PSC-PSOE",228
25,"25115",824,489,487,7,2,"PSC-PSOE",32
8,"8149",993,569,567,10,2,"PSC-PSOE",19
8,"8046",13290,9054,9000,103,54,"PSC-PSOE",1032
25,"25230",1558,1008,993,13,15,"PSC-PSOE",149
8,"8206",728,523,515,5,8,"PSC-PSOE",79
8,"8210",4329,2624,2594,31,30,"PSC-PSOE",231
8,"8080",34,26,26,3,0,"PSC-PSOE",1
25,"25111",117,72,70,2,2,"PSC-PSOE",1
25,"25052",1555,1027,1016,14,11,"PSC-PSOE",79
17,"17118",12711,7567,7515,42,52,"PSC-PSOE",1124
8,"8041",10343,6645,6582,57,63,"PSC-PSOE",1736
8,"8183",4550,2809,2796,20,13,"PSC-PSOE",287
25,"25121",644,415,410,8,5,"PSC-PSOE",127
8,"8268",1005,665,659,4,6,"PSC-PSOE",119
43,"43003",324,217,217,3,0,"PSC-PSOE",28
25,"25050",3233,1936,1912,25,24,"PSC-PSOE",161
43,"43056",854,480,470,5,10,"PSC-PSOE",27
8,"8236",1527,1006,999,4,7,"PSC-PSOE",80
8,"8298",26471,16674,16591,139,83,"PSC-PSOE",1551
8,"8063",453,337,336,4,1,"PSC-PSOE",19
8,"8052",141,88,88,0,0,"PSC-PSOE",4
17,"17092",3509,2256,2223,18,33,"PSC-PSOE",302
17,"17172",454,300,297,0,3,"PSC-PSOE",15
8,"8130",95,56,55,0,1,"PSC-PSOE",0
25,"25129",175,83,83,2,0,"PSC-PSOE",1
43,"43015",112,87,86,0,1,"PSC-PSOE",1
43,"43030",427,288,283,1,5,"PSC-PSOE",25
17,"17044",6770,4411,4376,33,35,"PSC-PSOE",387
17,"17101",559,347,338,2,9,"PSC-PSOE",41
43,"43029",310,213,211,3,2,"PSC-PSOE",4
25,"25254",728,457,451,2,6,"PSC-PSOE",55
8,"8064",1847,1245,1230,9,15,"PSC-PSOE",101
43,"43067",552,397,393,2,4,"PSC-PSOE",48
8,"8290",1507,1118,1110,12,8,"PSC-PSOE",77
43,"43156",3946,2524,2470,28,54,"PSC-PSOE",366
17,"17073",1873,1363,1356,15,7,"PSC-PSOE",53
8,"8250",7061,4480,4448,48,32,"PSC-PSOE",1172
43,"43079",364,248,248,0,0,"PSC-PSOE",23
43,"43116",451,324,317,5,7,"PSC-PSOE",35
8,"8015",155409,99368,98735,820,633,"PSC-PSOE",20303
43,"43147",524,381,373,4,8,"PSC-PSOE",21
17,"17222",101,76,75,0,1,"PSC-PSOE",3
25,"25059",805,527,523,7,4,"PSC-PSOE",159
8,"8106",7279,4871,4845,40,26,"PSC-PSOE",664
17,"17205",208,157,155,1,2,"PSC-PSOE",6
17,"17081",246,163,162,2,1,"PSC-PSOE",12
25,"25008",1124,715,702,10,13,"PSC-PSOE",46
43,"43045",149,110,110,2,0,"PSC-PSOE",10
25,"25153",192,130,128,2,2,"PSC-PSOE",12
17,"17145",1482,967,956,8,11,"PSC-PSOE",77
25,"25089",105,60,59,0,1,"PSC-PSOE",2
8,"8141",4563,2953,2929,34,24,"PSC-PSOE",360
8,"8237",1643,1105,1096,8,9,"PSC-PSOE",97
25,"25905",375,249,246,3,3,"PSC-PSOE",13
17,"17099",81,57,57,1,0,"PSC-PSOE",3
43,"43020",2215,1508,1497,9,11,"PSC-PSOE",297
43,"43068",520,330,326,7,4,"PSC-PSOE",97
8,"8905",2346,1689,1681,26,8,"PSC-PSOE",177
17,"17187",631,445,441,2,4,"PSC-PSOE",34
8,"8117",2450,1602,1594,11,8,"PSC-PSOE",167
17,"17100",194,133,131,3,2,"PSC-PSOE",7
25,"25023",4531,2782,2763,30,19,"PSC-PSOE",288
8,"8076",16169,10652,10563,75,89,"PSC-PSOE",1961
8,"8039",362,266,266,0,0,"PSC-PSOE",16
17,"17215",2087,1481,1466,7,15,"PSC-PSOE",158
17,"17076",124,86,84,3,2,"PSC-PSOE",2
8,"8187",152377,102805,102199,805,606,"PSC-PSOE",19015
25,"25034",2326,1361,1340,15,21,"PSC-PSOE",82
8,"8249",266,211,209,2,2,"PSC-PSOE",12
8,"8104",679,432,430,3,2,"PSC-PSOE",26
17,"17026",544,370,367,5,3,"PSC-PSOE",20
43,"43165",577,436,433,3,3,"PSC-PSOE",42
43,"43093",3919,2461,2434,47,27,"PSC-PSOE",390
17,"17063",162,111,109,0,2,"PSC-PSOE",1
8,"8118",17547,12183,12108,105,75,"PSC-PSOE",1255
8,"8006",11470,7210,7132,60,78,"PSC-PSOE",777
17,"17089",5543,3349,3326,22,23,"PSC-PSOE",382
17,"17050",652,453,453,3,0,"PSC-PSOE",18
8,"8215",2588,1663,1647,16,16,"PSC-PSOE",189
25,"25021",2607,1490,1481,20,9,"PSC-PSOE",186
17,"17094",1059,602,600,4,2,"PSC-PSOE",43
25,"25004",571,376,373,3,3,"PSC-PSOE",36
43,"43024",1537,993,983,8,10,"PSC-PSOE",167
43,"43078",846,543,531,8,12,"PSC-PSOE",65
8,"8019",1136351,768170,764030,5799,4140,"PSC-PSOE",107621
25,"25067",719,467,460,7,7,"PSC-PSOE",27
43,"43095",2474,1575,1551,17,24,"PSC-PSOE",208
8,"8146",1286,885,881,12,4,"PSC-PSOE",160
43,"43113",393,279,278,5,1,"PSC-PSOE",27
17,"17221",4153,2577,2564,27,13,"PSC-PSOE",399
8,"8189",127,90,89,3,1,"PSC-PSOE",4
25,"25225",564,356,356,1,0,"PSC-PSOE",12
8,"8192",5678,3729,3707,35,22,"PSC-PSOE",378
8,"8127",2225,1349,1334,14,15,"PSC-PSOE",229
25,"25038",1545,995,986,17,9,"PSC-PSOE",64
43,"43171",14599,9083,9011,72,72,"PSC-PSOE",1807
8,"8218",8009,5105,5075,59,30,"PSC-PSOE",942
25,"25043",807,501,497,11,4,"PSC-PSOE",40
43,"43133",5666,3397,3356,27,41,"PSC-PSOE",514
25,"25244",361,223,220,5,3,"PSC-PSOE",27
8,"8066",1365,926,921,8,5,"PSC-PSOE",131
17,"17014",64,48,48,1,0,"PSC-PSOE",7
17,"17134",228,162,161,0,1,"PSC-PSOE",5
25,"25253",159,105,105,1,0,"PSC-PSOE",5
8,"8296",1777,1237,1231,7,6,"PSC-PSOE",76
17,"17152",10737,6308,6252,45,56,"PSC-PSOE",1012
17,"17012",1145,703,698,9,5,"PSC-PSOE",64
25,"25079",299,198,193,2,5,"PSC-PSOE",10
25,"25096",902,534,525,10,9,"PSC-PSOE",45
8,"8191",5239,3454,3438,27,16,"PSC-PSOE",607
25,"25069",451,247,246,4,1,"PSC-PSOE",17
17,"17024",268,153,152,1,1,"PSC-PSOE",4
43,"43070",238,192,191,1,1,"PSC-PSOE",18
17,"17040",537,347,345,3,2,"PSC-PSOE",13
8,"8028",1024,648,644,4,4,"PSC-PSOE",116
25,"25114",98,72,72,0,0,"PSC-PSOE",1
25,"25170",266,169,167,1,2,"PSC-PSOE",14
25,"25216",226,138,136,1,2,"PSC-PSOE",0
8,"8294",1966,1287,1280,17,7,"PSC-PSOE",81
25,"25224",126,70,70,5,0,"PSC-PSOE",3
8,"8050",141,99,99,2,0,"PSC-PSOE",1
43,"43012",3534,2559,2548,34,11,"PSC-PSOE",265
17,"17220",796,538,536,5,2,"PSC-PSOE",26
25,"25161",360,219,218,2,1,"PSC-PSOE",21
8,"8247",961,637,634,4,3,"PSC-PSOE",30
17,"17123",354,266,263,0,3,"PSC-PSOE",6
43,"43167",375,277,275,9,2,"PSC-PSOE",9
43,"43031",1458,1020,1014,15,6,"PSC-PSOE",121
25,"25197",133,89,88,1,1,"PSC-PSOE",4
25,"25031",52,29,29,0,0,"PSC-PSOE",2
25,"25012",2334,1322,1310,8,12,"PSC-PSOE",174
17,"17121",224,140,140,1,0,"PSC-PSOE",8
8,"8132",383,213,212,4,1,"PSC-PSOE",14
17,"17161",992,726,721,10,5,"PSC-PSOE",31
25,"25073",582,328,324,8,4,"PSC-PSOE",14
8,"8219",15422,10701,10619,98,82,"PSC-PSOE",1128
25,"25071",49,31,31,0,0,"PSC-PSOE",0
8,"8081",339,222,221,3,1,"PSC-PSOE",5
17,"17197",132,102,101,1,1,"PSC-PSOE",9
17,"17062",5958,3463,3441,22,22,"PSC-PSOE",474
17,"17181",3372,2135,2112,12,23,"PSC-PSOE",225
25,"25166",181,110,109,2,1,"PSC-PSOE",3
25,"25209",1495,995,978,9,17,"PSC-PSOE",93
25,"25110",2766,1628,1602,22,26,"PSC-PSOE",239
17,"17232",152,92,91,1,1,"PSC-PSOE",5
8,"8185",188,123,122,2,1,"PSC-PSOE",6
8,"8131",704,471,468,7,3,"PSC-PSOE",44
25,"25070",823,554,549,15,5,"PSC-PSOE",52
43,"43153",10688,6675,6615,39,60,"PSC-PSOE",1053
8,"8167",5910,4081,4051,40,30,"PSC-PSOE",809
43,"43107",383,238,237,7,1,"PSC-PSOE",18
8,"8162",2047,1400,1392,7,8,"PSC-PSOE",180
8,"8126",8748,5927,5895,56,32,"PSC-PSOE",772
8,"8032",1981,1319,1311,11,8,"PSC-PSOE",159
25,"25104",130,76,74,1,2,"PSC-PSOE",4
8,"8196",19233,12733,12671,94,62,"PSC-PSOE",3302
8,"8264",4325,2929,2908,26,21,"PSC-PSOE",232
8,"8072",10259,6462,6422,42,40,"PSC-PSOE",764
17,"17228",288,179,176,1,3,"PSC-PSOE",15
17,"17033",5307,3264,3241,29,23,"PSC-PSOE",385
25,"25190",262,185,183,0,2,"PSC-PSOE",24
8,"8254",1739,1159,1156,10,3,"PSC-PSOE",32
25,"25131",403,248,241,7,7,"PSC-PSOE",38
8,"8169",47759,32651,32439,243,212,"PSC-PSOE",7733
25,"25221",122,81,81,0,0,"PSC-PSOE",7
25,"25086",522,346,341,2,5,"PSC-PSOE",32
17,"17216",165,110,110,1,0,"PSC-PSOE",3
25,"25908",226,144,143,3,1,"PSC-PSOE",19
25,"25157",181,115,114,7,1,"PSC-PSOE",2
8,"8306",506,299,297,5,2,"PSC-PSOE",19
8,"8151",466,288,287,2,1,"PSC-PSOE",9
43,"43163",25248,15802,15663,104,139,"PSC-PSOE",2734
17,"17188",164,124,124,1,0,"PSC-PSOE",3
17,"17202",3791,2280,2263,18,17,"PSC-PSOE",310
8,"8073",61814,42275,42025,294,250,"PSC-PSOE",11258
25,"25907",494,266,265,6,1,"PSC-PSOE",8
8,"8044",4141,2739,2726,15,13,"PSC-PSOE",450
25,"25201",112,73,72,3,1,"PSC-PSOE",4
17,"17213",5424,3239,3219,24,20,"PSC-PSOE",371
8,"8217",24989,17765,17661,114,104,"PSC-PSOE",4021
8,"8904",10553,6623,6579,52,44,"PSC-PSOE",1843
8,"8285",10224,6396,6342,52,54,"PSC-PSOE",759
43,"43055",1975,1384,1379,21,5,"PSC-PSOE",149
8,"8295",10870,6972,6918,51,54,"PSC-PSOE",1219
8,"8157",8382,5823,5789,45,34,"PSC-PSOE",1057
17,"17052",125,78,78,0,0,"PSC-PSOE",4
25,"25239",590,258,256,5,2,"PSC-PSOE",20
17,"17048",6241,3831,3801,36,30,"PSC-PSOE",620
25,"25176",309,216,211,1,5,"PSC-PSOE",5
25,"25179",162,103,103,2,0,"PSC-PSOE",5
8,"8095",73,48,47,0,1,"PSC-PSOE",4
17,"17084",238,146,144,5,2,"PSC-PSOE",10
17,"17194",80,55,54,0,1,"PSC-PSOE",1
43,"43065",399,252,251,3,1,"PSC-PSOE",32
25,"25194",423,246,244,6,2,"PSC-PSOE",7
25,"25911",451,273,271,7,2,"PSC-PSOE",9
43,"43038",21366,13061,12943,111,118,"PSC-PSOE",1814
8,"8037",1864,1242,1230,14,12,"PSC-PSOE",58
43,"43039",99,66,66,0,0,"PSC-PSOE",3
25,"25125",417,250,250,5,0,"PSC-PSOE",7
43,"43174",138,102,100,1,2,"PSC-PSOE",3
8,"8099",749,487,485,2,2,"PSC-PSOE",68
17,"17064",322,214,211,4,3,"PSC-PSOE",25
8,"8283",5963,3670,3642,24,28,"PSC-PSOE",319
25,"25138",569,363,360,4,3,"PSC-PSOE",31
8,"8017",2762,1701,1688,9,13,"PSC-PSOE",232
25,"25112",273,192,188,4,4,"PSC-PSOE",18
17,"17901",987,623,620,9,3,"PSC-PSOE",50
25,"25097",84,65,65,3,0,"PSC-PSOE",1
25,"25152",140,86,86,1,0,"PSC-PSOE",4
8,"8133",128,72,72,0,0,"PSC-PSOE",2
25,"25226",253,155,152,3,3,"PSC-PSOE",9
8,"8302",9218,5946,5891,82,55,"PSC-PSOE",1379
25,"25180",234,143,143,1,0,"PSC-PSOE",6
17,"17030",641,400,398,1,2,"PSC-PSOE",34
8,"8134",810,541,538,7,3,"PSC-PSOE",44
8,"8148",2233,1491,1483,7,8,"PSC-PSOE",228
25,"25049",151,110,108,1,2,"PSC-PSOE",4
8,"8125",25081,16406,16329,164,77,"PSC-PSOE",3314
17,"17088",533,368,366,4,2,"PSC-PSOE",14
17,"17009",4015,2584,2567,14,17,"PSC-PSOE",168
17,"17217",354,265,263,2,2,"PSC-PSOE",13
25,"25212",233,154,153,6,1,"PSC-PSOE",9
43,"43164",301,205,204,2,1,"PSC-PSOE",46
8,"8253",131,81,81,2,0,"PSC-PSOE",2
25,"25124",166,106,105,1,1,"PSC-PSOE",1
43,"43001",691,441,439,4,2,"PSC-PSOE",50
43,"43051",8512,5418,5366,32,52,"PSC-PSOE",1064
17,"17227",129,86,85,5,1,"PSC-PSOE",6
43,"43089",292,190,186,0,4,"PSC-PSOE",28
17,"17233",2260,1528,1514,23,14,"PSC-PSOE",104
43,"43178",1350,856,844,5,12,"PSC-PSOE",89
8,"8177",40,30,30,0,0,"PSC-PSOE",1
25,"25183",499,326,323,7,3,"PSC-PSOE",28
8,"8108",5016,3501,3474,21,27,"PSC-PSOE",516
17,"17136",178,125,124,0,1,"PSC-PSOE",8
17,"17903",897,568,563,2,5,"PSC-PSOE",43
17,"17068",245,158,156,1,2,"PSC-PSOE",15
8,"8082",1139,711,708,4,3,"PSC-PSOE",108
17,"17004",512,335,334,4,1,"PSC-PSOE",26
17,"17029",207,127,127,1,0,"PSC-PSOE",11
8,"8233",1871,1153,1140,16,13,"PSC-PSOE",55
43,"43112",279,175,174,0,1,"PSC-PSOE",14
25,"25172",1797,1170,1146,10,24,"PSC-PSOE",74
8,"8043",3201,2056,2041,9,15,"PSC-PSOE",332
8,"8083",1675,1146,1144,9,2,"PSC-PSOE",43
17,"17225",214,139,139,3,0,"PSC-PSOE",3
8,"8097",1021,715,712,8,3,"PSC-PSOE",61
17,"17174",178,99,97,2,2,"PSC-PSOE",1
8,"8124",36804,24782,24632,184,150,"PSC-PSOE",5562
17,"17195",329,237,234,0,3,"PSC-PSOE",19
8,"8053",2788,1605,1591,8,14,"PSC-PSOE",269
25,"25182",1036,660,655,9,5,"PSC-PSOE",96
43,"43086",5249,3271,3244,37,27,"PSC-PSOE",401
17,"17105",247,147,147,1,0,"PSC-PSOE",5
8,"8058",1730,1102,1095,6,7,"PSC-PSOE",167
25,"25143",84,56,55,0,1,"PSC-PSOE",7
17,"17119",74,54,54,0,0,"PSC-PSOE",4
8,"8213",6319,3950,3935,37,15,"PSC-PSOE",508
8,"8271",70,48,48,0,0,"PSC-PSOE",0
43,"43096",99,81,80,1,1,"PSC-PSOE",9
8,"8230",7635,5177,5121,54,56,"PSC-PSOE",678
8,"8143",2682,1718,1707,17,11,"PSC-PSOE",325
17,"17035",548,381,379,5,2,"PSC-PSOE",12
25,"25902",567,365,356,8,9,"PSC-PSOE",15
43,"43041",216,152,151,0,1,"PSC-PSOE",18
8,"8277",157,108,107,0,1,"PSC-PSOE",5
43,"43115",143,100,98,2,2,"PSC-PSOE",11
17,"17218",582,404,401,1,3,"PSC-PSOE",11
17,"17010",336,224,224,3,0,"PSC-PSOE",6
25,"25029",1655,1042,1029,15,13,"PSC-PSOE",133
25,"25046",422,279,275,2,4,"PSC-PSOE",18
17,"17125",130,80,80,0,0,"PSC-PSOE",1
17,"17176",124,92,92,1,0,"PSC-PSOE",10
25,"25233",275,178,178,4,0,"PSC-PSOE",26
8,"8291",4536,2975,2965,21,10,"PSC-PSOE",409
8,"8059",347,195,195,2,0,"PSC-PSOE",4
8,"8100",2001,1395,1380,25,15,"PSC-PSOE",36
17,"17203",153,99,99,0,0,"PSC-PSOE",6
17,"17085",301,215,214,5,1,"PSC-PSOE",9
8,"8060",144,87,87,0,0,"PSC-PSOE",0
25,"25175",186,117,117,1,0,"PSC-PSOE",2
8,"8224",820,557,551,2,6,"PSC-PSOE",54
25,"25909",148,93,92,2,1,"PSC-PSOE",2
43,"43090",1076,565,558,6,7,"PSC-PSOE",145
43,"43172",344,211,209,4,2,"PSC-PSOE",7
43,"43008",307,156,154,6,2,"PSC-PSOE",44
8,"8034",763,538,537,1,1,"PSC-PSOE",24
25,"25048",1651,1051,1040,11,11,"PSC-PSOE",100
43,"43076",439,300,299,0,1,"PSC-PSOE",21
17,"17042",419,272,272,2,0,"PSC-PSOE",14
25,"25243",3646,2193,2167,33,26,"PSC-PSOE",429
17,"17091",407,258,253,5,5,"PSC-PSOE",12
25,"25901",293,202,202,7,0,"PSC-PSOE",19
25,"25017",236,169,167,7,2,"PSC-PSOE",14
43,"43136",10351,6279,6218,63,61,"PSC-PSOE",904
17,"17171",165,117,116,2,1,"PSC-PSOE",6
43,"43072",105,74,72,0,2,"PSC-PSOE",3
25,"25154",122,74,72,0,2,"PSC-PSOE",2
43,"43059",252,188,188,2,0,"PSC-PSOE",11
43,"43132",373,264,261,4,3,"PSC-PSOE",22
25,"25009",627,444,440,8,4,"PSC-PSOE",31
17,"17209",630,443,438,7,5,"PSC-PSOE",35
25,"25169",173,112,111,3,1,"PSC-PSOE",10
43,"43119",799,470,468,8,2,"PSC-PSOE",53
25,"25174",397,280,280,2,0,"PSC-PSOE",35
43,"43037",16781,10376,10265,71,111,"PSC-PSOE",1785
17,"17167",2700,1765,1749,37,16,"PSC-PSOE",220
43,"43074",1754,1170,1157,9,13,"PSC-PSOE",101
8,"8113",52035,32351,32150,254,201,"PSC-PSOE",4366
17,"17007",1731,1191,1182,7,9,"PSC-PSOE",84
43,"43010",322,233,227,0,6,"PSC-PSOE",28
43,"43092",7036,4226,4185,39,41,"PSC-PSOE",684
43,"43134",282,191,191,4,0,"PSC-PSOE",23
17,"17143",142,103,99,1,4,"PSC-PSOE",5
17,"17206",146,88,86,1,2,"PSC-PSOE",3
8,"8282",6578,4714,4690,45,24,"PSC-PSOE",429
25,"25210",1108,685,677,3,8,"PSC-PSOE",93
43,"43175",554,363,360,5,3,"PSC-PSOE",26
17,"17182",263,181,181,6,0,"PSC-PSOE",47
8,"8145",2599,1774,1761,11,13,"PSC-PSOE",221
8,"8007",6483,4281,4250,33,31,"PSC-PSOE",372
8,"8159",14096,9393,9347,76,46,"PSC-PSOE",1653
43,"43013",4411,2750,2739,19,11,"PSC-PSOE",252
8,"8078",219,112,111,3,1,"PSC-PSOE",1
17,"17025",1134,793,787,6,6,"PSC-PSOE",53
43,"43026",782,524,520,6,4,"PSC-PSOE",45
43,"43094",2143,1395,1375,13,20,"PSC-PSOE",196
43,"43149",686,447,443,8,4,"PSC-PSOE",115
8,"8202",12680,8341,8278,75,63,"PSC-PSOE",1244
17,"17207",2375,1590,1579,11,11,"PSC-PSOE",60
25,"25904",148,112,111,2,1,"PSC-PSOE",10
8,"8025",1490,981,978,4,3,"PSC-PSOE",98
17,"17070",111,76,76,2,0,"PSC-PSOE",2
8,"8175",3347,2080,2064,20,16,"PSC-PSOE",183
25,"25044",188,122,120,7,2,"PSC-PSOE",5
25,"25218",81,64,63,1,1,"PSC-PSOE",2
17,"17083",2940,1895,1876,16,19,"PSC-PSOE",257
43,"43073",83,60,58,0,2,"PSC-PSOE",1
8,"8035",12547,7877,7828,51,49,"PSC-PSOE",978
17,"17001",587,404,398,2,6,"PSC-PSOE",23
17,"17196",220,150,150,4,0,"PSC-PSOE",6
8,"8005",6205,4187,4167,22,20,"PSC-PSOE",298
8,"8276",237,165,165,2,0,"PSC-PSOE",8
25,"25128",136,75,75,0,0,"PSC-PSOE",5
43,"43023",231,170,169,0,1,"PSC-PSOE",40
43,"43028",2688,1659,1639,6,20,"PSC-PSOE",266
8,"8094",1559,1112,1097,14,15,"PSC-PSOE",128
25,"25010",211,113,113,2,0,"PSC-PSOE",9
43,"43011",1077,743,737,2,6,"PSC-PSOE",50
8,"8214",6872,4699,4675,47,24,"PSC-PSOE",443
43,"43138",2672,1629,1585,37,44,"PSC-PSOE",216
17,"17160",14747,9189,9129,65,60,"PSC-PSOE",1648
25,"25030",135,74,72,1,2,"PSC-PSOE",4
17,"17080",138,96,96,1,0,"PSC-PSOE",4
43,"43069",182,136,134,1,2,"PSC-PSOE",20
8,"8232",1775,1183,1176,6,7,"PSC-PSOE",136
8,"8011",1756,1087,1082,16,5,"PSC-PSOE",29
8,"8286",2879,1802,1797,14,5,"PSC-PSOE",328
43,"43139",2039,1218,1191,8,27,"PSC-PSOE",80
8,"8300",5678,3983,3964,35,19,"PSC-PSOE",537
8,"8109",216,162,161,0,1,"PSC-PSOE",0
8,"8012",1672,1075,1061,17,14,"PSC-PSOE",78
17,"17041",218,130,129,2,1,"PSC-PSOE",14
43,"43043",3130,2053,2036,18,17,"PSC-PSOE",308
8,"8207",1865,1407,1402,19,5,"PSC-PSOE",43
43,"43126",1177,782,772,4,10,"PSC-PSOE",74
8,"8069",3169,2161,2148,32,13,"PSC-PSOE",231
8,"8096",42622,28797,28615,263,182,"PSC-PSOE",5260
25,"25016",2107,1268,1259,14,9,"PSC-PSOE",146
25,"25181",172,123,120,4,3,"PSC-PSOE",12
25,"25040",10546,6367,6300,61,67,"PSC-PSOE",1001
8,"8297",134,85,84,0,1,"PSC-PSOE",4
8,"8180",26613,17585,17490,153,95,"PSC-PSOE",3746
25,"25126",290,200,198,2,2,"PSC-PSOE",31
43,"43150",1281,937,923,6,14,"PSC-PSOE",61
8,"8093",27,21,21,0,0,"PSC-PSOE",0
25,"25081",308,189,189,2,0,"PSC-PSOE",12
8,"8009",9180,6207,6192,50,15,"PSC-PSOE",671
43,"43046",99,68,65,1,3,"PSC-PSOE",4
25,"25906",218,125,125,1,0,"PSC-PSOE",20
17,"17902",1357,886,878,13,8,"PSC-PSOE",63
8,"8226",891,648,645,6,3,"PSC-PSOE",43
17,"17006",1127,686,682,1,4,"PSC-PSOE",49
8,"8121",86351,57040,56655,446,385,"PSC-PSOE",10242
8,"8153",538,386,385,2,1,"PSC-PSOE",19
17,"17019",1775,1201,1188,7,13,"PSC-PSOE",111
17,"17032",1721,967,961,10,6,"PSC-PSOE",109
8,"8303",274,193,192,2,1,"PSC-PSOE",16
17,"17139",1364,884,865,8,19,"PSC-PSOE",81
17,"17110",1322,856,853,3,3,"PSC-PSOE",130
17,"17226",867,549,546,8,3,"PSC-PSOE",69
43,"43006",681,438,437,9,1,"PSC-PSOE",90
17,"17058",177,101,100,3,1,"PSC-PSOE",1
17,"17214",705,423,419,2,4,"PSC-PSOE",26
8,"8140",4774,3118,3098,23,20,"PSC-PSOE",468
8,"8223",1852,1182,1171,12,11,"PSC-PSOE",94
17,"17020",3592,2333,2315,20,18,"PSC-PSOE",131
43,"43007",641,456,455,3,1,"PSC-PSOE",25
25,"25134",623,369,366,3,3,"PSC-PSOE",31
43,"43034",477,350,342,9,8,"PSC-PSOE",41
8,"8101",174621,113632,112942,847,690,"PSC-PSOE",29889
25,"25148",219,124,124,0,0,"PSC-PSOE",2
25,"25251",707,443,442,2,1,"PSC-PSOE",29
8,"8211",33081,23576,23413,226,163,"PSC-PSOE",4731
43,"43131",4647,2934,2916,21,18,"PSC-PSOE",565
8,"8252",24570,17009,16901,145,108,"PSC-PSOE",3516
17,"17140",670,478,473,5,5,"PSC-PSOE",44
43,"43130",195,127,127,1,0,"PSC-PSOE",17
43,"43118",419,311,308,5,3,"PSC-PSOE",27
25,"25203",8931,5003,4955,72,48,"PSC-PSOE",804
17,"17148",1515,981,972,4,9,"PSC-PSOE",115
17,"17065",331,230,230,1,0,"PSC-PSOE",5
43,"43040",330,257,255,5,2,"PSC-PSOE",15
43,"43140",2367,1550,1532,4,18,"PSC-PSOE",321
25,"25186",213,124,122,3,2,"PSC-PSOE",2
8,"8138",4248,2638,2618,27,20,"PSC-PSOE",256
8,"8248",5419,3566,3546,45,20,"PSC-PSOE",412
8,"8194",25660,15045,14941,122,104,"PSC-PSOE",3439
25,"25910",100,63,61,2,2,"PSC-PSOE",4
25,"25093",640,403,395,7,8,"PSC-PSOE",41
25,"25136",95,64,64,1,0,"PSC-PSOE",1
43,"43177",299,231,230,6,1,"PSC-PSOE",23
43,"43146",39,29,28,0,1,"PSC-PSOE",2
25,"25150",181,115,113,3,2,"PSC-PSOE",3
8,"8199",663,456,453,14,3,"PSC-PSOE",35
17,"17075",330,205,205,1,0,"PSC-PSOE",7
25,"25041",568,347,344,4,3,"PSC-PSOE",39
25,"25099",1273,761,752,7,9,"PSC-PSOE",47
8,"8171",2103,1288,1280,12,8,"PSC-PSOE",54
17,"17155",14515,8393,8330,65,63,"PSC-PSOE",1552
8,"8170",450,276,274,7,2,"PSC-PSOE",19
17,"17036",2717,1730,1716,15,14,"PSC-PSOE",166
8,"8023",6734,4350,4323,35,27,"PSC-PSOE",429
25,"25063",87,58,58,1,0,"PSC-PSOE",19
25,"25137",8585,5143,5095,56,48,"PSC-PSOE",718
43,"43106",810,526,522,7,4,"PSC-PSOE",66
25,"25077",463,256,253,6,3,"PSC-PSOE",16
25,"25011",5243,2796,2767,23,29,"PSC-PSOE",324
43,"43120",441,270,267,1,3,"PSC-PSOE",46
43,"43161",17197,10481,10400,95,81,"PSC-PSOE",1457
8,"8092",3736,2369,2342,13,27,"PSC-PSOE",241
43,"43080",239,183,181,0,2,"PSC-PSOE",13
17,"17132",1298,884,877,12,7,"PSC-PSOE",56
25,"25078",998,628,627,7,1,"PSC-PSOE",39
8,"8174",392,283,279,3,4,"PSC-PSOE",18
8,"8008",190,110,110,5,0,"PSC-PSOE",4
17,"17158",476,276,274,1,2,"PSC-PSOE",29
8,"8902",3761,2570,2558,31,12,"PSC-PSOE",299
17,"17117",14353,8469,8426,49,43,"PSC-PSOE",1489
17,"17090",545,370,368,4,2,"PSC-PSOE",24
8,"8256",650,484,484,5,0,"PSC-PSOE",39
25,"25102",707,420,407,6,13,"PSC-PSOE",46
25,"25022",104,79,79,0,0,"PSC-PSOE",3
17,"17183",277,180,179,1,1,"PSC-PSOE",7
43,"43122",106,77,77,4,0,"PSC-PSOE",7
8,"8307",48295,32010,31798,195,212,"PSC-PSOE",5559
8,"8216",25,15,15,1,0,"PSC-PSOE",0
25,"25227",652,402,400,4,2,"PSC-PSOE",37
8,"8040",10710,6845,6802,51,43,"PSC-PSOE",775
43,"43110",259,175,175,6,0,"PSC-PSOE",22
25,"25076",145,81,81,2,0,"PSC-PSOE",11
8,"8026",188,134,134,0,0,"PSC-PSOE",4
25,"25013",2146,1240,1226,16,14,"PSC-PSOE",250
8,"8284",12097,7157,7089,59,68,"PSC-PSOE",1103
17,"17013",2787,1780,1762,17,18,"PSC-PSOE",276
8,"8071",240,163,162,5,1,"PSC-PSOE",13
8,"8262",6836,4175,4144,50,31,"PSC-PSOE",712
8,"8136",11450,7703,7641,84,62,"PSC-PSOE",1570
25,"25228",3035,1933,1921,26,12,"PSC-PSOE",227
43,"43152",439,323,320,2,3,"PSC-PSOE",50
17,"17135",362,253,253,1,0,"PSC-PSOE",21
25,"25903",236,161,161,3,0,"PSC-PSOE",11
25,"25082",285,186,178,5,8,"PSC-PSOE",25
43,"43124",482,308,307,2,1,"PSC-PSOE",37
25,"25014",260,165,165,5,0,"PSC-PSOE",8
25,"25053",1055,671,661,7,10,"PSC-PSOE",73
43,"43002",1801,1156,1128,7,28,"PSC-PSOE",263
8,"8163",18641,11801,11729,68,72,"PSC-PSOE",2432
17,"17054",370,236,236,1,0,"PSC-PSOE",26
17,"17211",830,581,580,10,1,"PSC-PSOE",31
8,"8273",2333,1654,1637,10,17,"PSC-PSOE",111
17,"17003",104,67,66,0,1,"PSC-PSOE",6
8,"8260",18335,12325,12263,106,62,"PSC-PSOE",2305
8,"8164",913,618,609,7,9,"PSC-PSOE",47
8,"8220",2356,1690,1683,18,7,"PSC-PSOE",45
17,"17162",150,86,86,1,0,"PSC-PSOE",6
25,"25057",208,141,140,0,1,"PSC-PSOE",22
8,"8193",944,601,596,12,5,"PSC-PSOE",38
8,"8274",4665,3028,3009,26,19,"PSC-PSOE",694
43,"43071",921,613,607,6,6,"PSC-PSOE",48
8,"8029",3480,2472,2460,25,12,"PSC-PSOE",180
17,"17078",336,223,220,6,3,"PSC-PSOE",5
25,"25039",277,181,180,3,1,"PSC-PSOE",18
8,"8165",1649,1100,1085,9,15,"PSC-PSOE",163
17,"17018",480,327,322,2,5,"PSC-PSOE",29
43,"43027",161,118,116,15,2,"PSC-PSOE",2
8,"8288",1659,1004,994,7,10,"PSC-PSOE",189
43,"43127",743,528,527,2,1,"PSC-PSOE",20
8,"8234",3200,2128,2114,21,14,"PSC-PSOE",192
8,"8208",5732,3976,3952,30,24,"PSC-PSOE",617
17,"17184",1254,814,809,6,5,"PSC-PSOE",33
25,"25120",92002,55658,55214,587,444,"PSC-PSOE",8846
8,"8014",1962,1366,1359,15,7,"PSC-PSOE",130
17,"17043",161,122,117,1,5,"PSC-PSOE",4
25,"25045",57,40,40,0,0,"PSC-PSOE",17
25,"25037",375,247,246,5,1,"PSC-PSOE",12
8,"8289",4338,2912,2898,27,14,"PSC-PSOE",267
25,"25249",182,99,98,1,1,"PSC-PSOE",4
43,"43102",480,332,324,3,8,"PSC-PSOE",71
25,"25033",1096,729,723,4,6,"PSC-PSOE",58
17,"17201",135,87,84,0,3,"PSC-PSOE",1
25,"25220",1015,634,632,1,2,"PSC-PSOE",56
17,"17138",928,637,633,4,4,"PSC-PSOE",142
43,"43142",1100,698,688,5,10,"PSC-PSOE",59
43,"43060",2860,1950,1926,12,24,"PSC-PSOE",271
8,"8304",812,562,558,3,4,"PSC-PSOE",41
43,"43143",54,47,47,3,0,"PSC-PSOE",7
43,"43170",868,566,562,5,4,"PSC-PSOE",58
25,"25206",260,150,150,5,0,"PSC-PSOE",7
25,"25133",706,432,427,8,5,"PSC-PSOE",29
8,"8091",5244,3611,3584,17,27,"PSC-PSOE",564
43,"43075",89,61,60,1,1,"PSC-PSOE",4
8,"8251",4984,3257,3241,17,16,"PSC-PSOE",708
43,"43021",357,232,231,6,1,"PSC-PSOE",18
25,"25047",1014,675,674,8,1,"PSC-PSOE",51
17,"17060",424,268,266,5,2,"PSC-PSOE",24
43,"43035",254,156,155,2,1,"PSC-PSOE",8
25,"25035",398,249,247,2,2,"PSC-PSOE",22
17,"17008",3639,2191,2171,16,20,"PSC-PSOE",206
25,"25192",743,449,436,2,13,"PSC-PSOE",24
8,"8279",153025,101133,100621,840,512,"PSC-PSOE",18130
8,"8261",2327,1499,1493,11,6,"PSC-PSOE",136
17,"17150",1401,962,951,6,11,"PSC-PSOE",69
25,"25193",759,485,480,2,5,"PSC-PSOE",21
17,"17230",468,318,317,3,1,"PSC-PSOE",42
17,"17175",578,321,312,5,9,"PSC-PSOE",74
25,"25165",285,179,176,2,3,"PSC-PSOE",8
17,"17129",133,101,101,1,0,"PSC-PSOE",8
8,"8280",97,66,66,2,0,"PSC-PSOE",1
43,"43159",81,59,59,0,0,"PSC-PSOE",7
8,"8116",578,387,383,2,4,"PSC-PSOE",19
8,"8293",219,168,167,0,1,"PSC-PSOE",13
8,"8018",2636,1690,1675,23,15,"PSC-PSOE",266
43,"43064",2015,1310,1296,23,14,"PSC-PSOE",129
8,"8103",625,395,395,2,0,"PSC-PSOE",24
8,"8010",4168,2631,2606,20,25,"PSC-PSOE",261
25,"25219",141,102,101,0,1,"PSC-PSOE",0
43,"43082",365,290,286,5,4,"PSC-PSOE",32
17,"17115",282,183,183,1,0,"PSC-PSOE",9
25,"25094",137,98,95,1,3,"PSC-PSOE",6
8,"8308",131,87,87,1,0,"PSC-PSOE",2
25,"25240",1383,925,919,16,6,"PSC-PSOE",86
25,"25024",351,226,223,2,3,"PSC-PSOE",34
17,"17049",3117,2092,2072,14,20,"PSC-PSOE",205
8,"8144",717,447,437,5,10,"PSC-PSOE",36
25,"25020",289,206,205,3,1,"PSC-PSOE",14
8,"8077",34508,24070,23956,127,114,"PSC-PSOE",5374
17,"17011",637,444,439,6,5,"PSC-PSOE",35
43,"43057",38,25,25,1,0,"PSC-PSOE",2
8,"8172",20326,13875,13802,92,73,"PSC-PSOE",1925
25,"25202",104,73,72,0,1,"PSC-PSOE",13
8,"8201",442,278,278,4,0,"PSC-PSOE",15
25,"25912",857,547,539,1,8,"PSC-PSOE",130
43,"43108",1774,1172,1160,14,12,"PSC-PSOE",119
43,"43135",340,235,234,1,1,"PSC-PSOE",12
25,"25064",108,68,68,2,0,"PSC-PSOE",1
17,"17144",206,141,141,3,0,"PSC-PSOE",7
8,"8038",1487,959,954,15,5,"PSC-PSOE",97
8,"8065",1176,797,784,10,13,"PSC-PSOE",62
25,"25167",230,138,138,3,0,"PSC-PSOE",0
25,"25168",509,354,352,7,2,"PSC-PSOE",21
8,"8079",343,256,255,4,1,"PSC-PSOE",17
8,"8062",956,619,618,4,1,"PSC-PSOE",67
25,"25255",417,298,296,2,2,"PSC-PSOE",26
43,"43123",70482,44051,43675,345,376,"PSC-PSOE",7284
17,"17066",26562,15223,15087,150,136,"PSC-PSOE",2256
17,"17103",4954,2877,2850,25,27,"PSC-PSOE",453
17,"17146",2969,1868,1855,8,13,"PSC-PSOE",241
25,"25127",210,136,136,2,0,"PSC-PSOE",8
17,"17002",556,401,396,0,5,"PSC-PSOE",28
25,"25098",253,151,150,0,1,"PSC-PSOE",12
8,"8190",256,168,165,2,3,"PSC-PSOE",11
8,"8161",11144,6994,6938,73,56,"PSC-PSOE",1134
25,"25027",976,633,630,7,3,"PSC-PSOE",32
8,"8244",5851,4095,4058,36,37,"PSC-PSOE",551
43,"43155",22873,14209,14082,153,127,"PSC-PSOE",2070
43,"43145",4096,2795,2760,19,35,"PSC-PSOE",481
25,"25158",1620,1019,1012,15,7,"PSC-PSOE",61
17,"17210",551,350,349,9,1,"PSC-PSOE",19
8,"8245",78562,50821,50538,384,283,"PSC-PSOE",14750
25,"25002",482,316,314,2,2,"PSC-PSOE",20
43,"43016",3416,2335,2309,15,26,"PSC-PSOE",534
17,"17147",8053,4988,4933,52,55,"PSC-PSOE",668
17,"17067",696,467,464,5,3,"PSC-PSOE",46
25,"25055",169,105,104,4,1,"PSC-PSOE",5
17,"17116",354,228,224,3,4,"PSC-PSOE",12
17,"17096",179,106,105,1,1,"PSC-PSOE",1
17,"17015",12546,7832,7777,66,55,"PSC-PSOE",488
17,"17151",174,111,110,3,1,"PSC-PSOE",8
8,"8205",59828,43344,43140,367,204,"PSC-PSOE",3782
43,"43052",938,628,621,12,7,"PSC-PSOE",67
8,"8123",19140,13557,13484,106,73,"PSC-PSOE",2138
8,"8287",1048,736,735,2,1,"PSC-PSOE",53
17,"17137",3437,2293,2275,19,18,"PSC-PSOE",159
43,"43099",306,228,226,4,2,"PSC-PSOE",21
17,"17016",731,500,496,1,4,"PSC-PSOE",22
17,"17199",6853,4147,4122,27,25,"PSC-PSOE",424
17,"17224",314,190,188,2,2,"PSC-PSOE",12
25,"25118",346,198,189,3,9,"PSC-PSOE",10
8,"8070",266,194,191,2,3,"PSC-PSOE",8
25,"25238",204,140,138,4,2,"PSC-PSOE",6
25,"25001",144,73,73,0,0,"PSC-PSOE",7
43,"43141",106,68,67,0,1,"PSC-PSOE",9
17,"17109",696,422,419,1,3,"PSC-PSOE",20
25,"25231",486,330,330,4,0,"PSC-PSOE",23
43,"43018",408,325,320,3,5,"PSC-PSOE",10
8,"8056",42140,28129,27977,257,152,"PSC-PSOE",4582
17,"17056",1715,1120,1106,16,14,"PSC-PSOE",50
8,"8030",5122,3482,3466,21,16,"PSC-PSOE",238
25,"25087",60,43,43,0,0,"PSC-PSOE",5
17,"17057",968,641,636,11,5,"PSC-PSOE",46
25,"25173",1705,1156,1143,14,13,"PSC-PSOE",261
17,"17124",1607,1027,1007,11,20,"PSC-PSOE",131
43,"43160",1276,837,826,8,11,"PSC-PSOE",145
8,"8166",991,631,625,7,6,"PSC-PSOE",81
8,"8181",7887,5178,5144,48,34,"PSC-PSOE",665
25,"25088",96,73,72,0,1,"PSC-PSOE",2
25,"25250",345,210,204,0,6,"PSC-PSOE",14
8,"8086",13582,8612,8557,75,55,"PSC-PSOE",1391
43,"43047",4161,2359,2341,27,18,"PSC-PSOE",559
17,"17111",880,590,586,7,4,"PSC-PSOE",29
17,"17120",786,517,512,8,5,"PSC-PSOE",30
25,"25132",136,88,87,0,1,"PSC-PSOE",11
17,"17198",429,270,267,2,3,"PSC-PSOE",17
8,"8085",1000,662,658,5,4,"PSC-PSOE",40
43,"43905",14392,8444,8393,45,51,"PSC-PSOE",1355
8,"8241",73,52,52,0,0,"PSC-PSOE",0
43,"43166",1584,1029,1022,6,7,"PSC-PSOE",138
17,"17055",150,110,109,0,1,"PSC-PSOE",7
8,"8036",163,105,104,1,1,"PSC-PSOE",5
17,"17190",844,528,528,3,0,"PSC-PSOE",26
8,"8255",134,78,78,0,0,"PSC-PSOE",0
8,"8197",7648,5020,5000,37,20,"PSC-PSOE",465
17,"17178",1059,654,650,7,4,"PSC-PSOE",56
43,"43157",353,268,264,5,4,"PSC-PSOE",20
8,"8047",3899,2292,2260,16,32,"PSC-PSOE",411
17,"17021",131,86,85,4,1,"PSC-PSOE",6
17,"17112",190,127,125,2,2,"PSC-PSOE",6
43,"43117",146,108,105,0,3,"PSC-PSOE",12
8,"8024",386,243,236,0,7,"PSC-PSOE",24
43,"43085",226,180,180,1,0,"PSC-PSOE",29
17,"17114",23041,13985,13880,135,105,"PSC-PSOE",1676
43,"43105",162,123,122,2,1,"PSC-PSOE",10
8,"8184",53822,34744,34545,264,199,"PSC-PSOE",7081
17,"17154",92,67,66,0,1,"PSC-PSOE",10
17,"17192",144,96,93,1,3,"PSC-PSOE",9
8,"8102",28296,18466,18367,172,99,"PSC-PSOE",2247
43,"43063",557,355,349,9,6,"PSC-PSOE",34
17,"17128",308,205,203,3,2,"PSC-PSOE",19
25,"25222",66,52,52,1,0,"PSC-PSOE",2
17,"17061",156,104,103,1,1,"PSC-PSOE",0
25,"25177",368,226,226,0,0,"PSC-PSOE",17
8,"8022",12212,7210,7155,66,55,"PSC-PSOE",737
43,"43081",593,400,395,3,5,"PSC-PSOE",24
8,"8212",488,319,316,0,3,"PSC-PSOE",10
43,"43019",1381,862,846,12,16,"PSC-PSOE",109
43,"43137",1868,1254,1242,11,12,"PSC-PSOE",177
8,"8267",6461,4265,4245,51,20,"PSC-PSOE",740
43,"43125",933,680,677,14,3,"PSC-PSOE",108
25,"25062",750,486,482,1,4,"PSC-PSOE",36
8,"8209",6773,4410,4382,29,28,"PSC-PSOE",560
8,"8090",128,101,101,2,0,"PSC-PSOE",7
8,"8227",2326,1508,1487,20,21,"PSC-PSOE",153
25,"25141",153,95,95,0,0,"PSC-PSOE",0
25,"25006",340,201,200,6,1,"PSC-PSOE",34
25,"25146",227,140,140,3,0,"PSC-PSOE",2
8,"8281",4802,3343,3318,17,25,"PSC-PSOE",242
43,"43169",450,370,367,10,3,"PSC-PSOE",26
17,"17163",2626,1764,1747,10,17,"PSC-PSOE",91
8,"8051",17948,12140,12076,102,64,"PSC-PSOE",1746
8,"8055",519,331,327,4,4,"PSC-PSOE",22
25,"25247",123,66,66,1,0,"PSC-PSOE",9
8,"8229",535,357,354,9,3,"PSC-PSOE",9
17,"17157",125,95,95,1,0,"PSC-PSOE",0
8,"8269",2673,1788,1776,14,12,"PSC-PSOE",84
43,"43148",90275,59182,58757,388,425,"PSC-PSOE",10139
17,"17077",548,369,368,1,1,"PSC-PSOE",26
8,"8188",115,78,78,0,0,"PSC-PSOE",4
43,"43902",2743,1551,1531,23,20,"PSC-PSOE",409
17,"17037",104,69,69,1,0,"PSC-PSOE",0
25,"25211",680,386,379,4,7,"PSC-PSOE",27
17,"17031",168,97,97,3,0,"PSC-PSOE",0
17,"17133",1255,805,796,9,9,"PSC-PSOE",33
17,"17051",218,145,142,1,3,"PSC-PSOE",6
8,"8903",214,166,165,0,1,"PSC-PSOE",4
8,"8147",16967,11220,11138,65,82,"PSC-PSOE",1839
43,"43054",2812,1755,1739,16,16,"PSC-PSOE",170
8,"8257",107,71,71,0,0,"PSC-PSOE",2
25,"25200",329,213,213,0,0,"PSC-PSOE",24
8,"8120",6835,4708,4688,44,20,"PSC-PSOE",149
43,"43109",2606,1491,1475,20,16,"PSC-PSOE",231
43,"43088",1996,1271,1255,7,16,"PSC-PSOE",75
25,"25036",184,112,111,4,1,"PSC-PSOE",16
17,"17185",2265,1420,1404,15,16,"PSC-PSOE",155
8,"8001",8907,6316,6269,46,47,"PSC-PSOE",1293
8,"8139",175,132,132,2,0,"PSC-PSOE",19
43,"43083",144,109,108,0,1,"PSC-PSOE",6
43,"43904",2900,1602,1573,32,29,"PSC-PSOE",257
8,"8027",687,486,485,2,1,"PSC-PSOE",67
8,"8122",1698,1080,1073,5,7,"PSC-PSOE",152
8,"8068",6718,4373,4343,33,30,"PSC-PSOE",557
17,"17106",140,103,102,0,1,"PSC-PSOE",8
25,"25151",685,425,419,7,6,"PSC-PSOE",24
8,"8299",391,244,244,5,0,"PSC-PSOE",17
8,"8231",20564,13037,12952,96,85,"PSC-PSOE",2355
17,"17071",1134,778,774,10,4,"PSC-PSOE",34
17,"17204",572,355,354,4,1,"PSC-PSOE",47
43,"43062",281,217,215,2,2,"PSC-PSOE",32
43,"43017",124,101,101,1,0,"PSC-PSOE",6
8,"8228",301,199,197,6,2,"PSC-PSOE",14
25,"25185",692,400,397,6,3,"PSC-PSOE",49
43,"43044",3963,2671,2640,33,31,"PSC-PSOE",473
17,"17186",3788,2554,2526,27,28,"PSC-PSOE",430
8,"8246",1665,1086,1078,9,8,"PSC-PSOE",41
25,"25142",364,229,225,2,4,"PSC-PSOE",11
8,"8110",13315,8457,8368,73,89,"PSC-PSOE",1597
43,"43058",90,63,63,0,0,"PSC-PSOE",2
8,"8155",6730,4353,4320,39,33,"PSC-PSOE",675
17,"17034",6931,4166,4150,29,16,"PSC-PSOE",553
43,"43097",393,291,289,1,2,"PSC-PSOE",33
17,"17027",2821,1896,1889,17,7,"PSC-PSOE",177
25,"25189",2110,1198,1186,10,12,"PSC-PSOE",133
25,"25005",279,175,175,4,0,"PSC-PSOE",12
43,"43004",6281,3993,3929,38,64,"PSC-PSOE",478
17,"17149",364,248,248,0,0,"PSC-PSOE",9
8,"8075",3883,2479,2467,14,12,"PSC-PSOE",297
17,"17095",19555,11537,11428,89,109,"PSC-PSOE",2248
43,"43154",130,101,100,0,1,"PSC-PSOE",8
17,"17200",613,424,422,5,2,"PSC-PSOE",41
43,"43168",96,57,57,3,0,"PSC-PSOE",4
8,"8275",247,179,179,4,0,"PSC-PSOE",8
43,"43049",728,464,461,4,3,"PSC-PSOE",26
25,"25242",720,456,450,2,6,"PSC-PSOE",35
8,"8114",18292,12102,12009,72,93,"PSC-PSOE",2451
25,"25058",4357,2624,2595,20,29,"PSC-PSOE",214
8,"8031",2322,1552,1537,6,15,"PSC-PSOE",194
17,"17189",1516,1076,1070,5,6,"PSC-PSOE",79
25,"25223",922,553,543,8,10,"PSC-PSOE",29
25,"25103",135,76,76,4,0,"PSC-PSOE",1
8,"8045",73,37,35,0,2,"PSC-PSOE",2
25,"25215",345,240,236,0,4,"PSC-PSOE",21
25,"25015",357,219,219,2,0,"PSC-PSOE",12
43,"43111",2044,1291,1275,9,16,"PSC-PSOE",192
25,"25245",435,289,280,5,9,"PSC-PSOE",59
25,"25204",1231,731,724,5,7,"PSC-PSOE",100
8,"8258",830,557,551,6,6,"PSC-PSOE",17
8,"8242",219,153,153,4,0,"PSC-PSOE",6
8,"8021",70,49,46,0,3,"PSC-PSOE",5
17,"17028",293,205,204,6,1,"PSC-PSOE",3
25,"25149",1385,963,956,6,7,"PSC-PSOE",94
17,"17126",311,236,234,0,2,"PSC-PSOE",3
8,"8292",1072,730,725,6,5,"PSC-PSOE",109
8,"8168",358,231,231,5,0,"PSC-PSOE",9
8,"8020",4926,3523,3502,33,21,"PSC-PSOE",343
8,"8238",14531,10378,10325,98,53,"PSC-PSOE",1134
8,"8003",7084,4839,4803,39,36,"PSC-PSOE",374
8,"8105",9630,6394,6339,49,55,"PSC-PSOE",1716
25,"25155",647,421,418,0,3,"PSC-PSOE",38
25,"25060",72,46,44,1,2,"PSC-PSOE",0
25,"25025",1353,871,864,16,7,"PSC-PSOE",146
43,"43032",517,332,329,5,3,"PSC-PSOE",68
8,"8266",43030,30192,30039,229,153,"PSC-PSOE",5626
25,"25232",1397,874,871,12,3,"PSC-PSOE",111
43,"43036",843,493,485,4,8,"PSC-PSOE",60
17,"17170",171,125,123,1,2,"PSC-PSOE",0
8,"8239",453,304,302,3,2,"PSC-PSOE",15
8,"8049",1293,790,779,3,11,"PSC-PSOE",34
25,"25135",1028,600,593,10,7,"PSC-PSOE",72
8,"8089",33850,22230,22096,170,134,"PSC-PSOE",4813
43,"43091",132,86,86,0,0,"PSC-PSOE",2
17,"17069",374,256,251,0,5,"PSC-PSOE",10
8,"8088",11899,8149,8097,69,52,"PSC-PSOE",846
8,"8054",8998,6172,6129,44,43,"PSC-PSOE",961
25,"25105",125,92,92,2,0,"PSC-PSOE",2
43,"43005",3626,2157,2138,29,19,"PSC-PSOE",319
8,"8084",1142,773,768,14,5,"PSC-PSOE",67
8,"8204",3055,2094,2082,17,12,"PSC-PSOE",323
8,"8176",156,109,107,2,2,"PSC-PSOE",1
8,"8135",6677,4813,4775,51,38,"PSC-PSOE",1116
25,"25145",86,65,64,1,1,"PSC-PSOE",3
17,"17223",801,516,506,9,10,"PSC-PSOE",58
43,"43151",107,90,89,0,1,"PSC-PSOE",2
43,"43042",2129,1439,1437,12,2,"PSC-PSOE",120
8,"8107",11502,7510,7445,67,65,"PSC-PSOE",1216
25,"25007",1405,850,841,8,9,"PSC-PSOE",94
25,"25196",113,57,57,0,0,"PSC-PSOE",4
8,"8033",12813,8564,8509,63,55,"PSC-PSOE",1190
43,"43903",2392,1324,1313,10,11,"PSC-PSOE",202
17,"17164",3982,2363,2350,11,13,"PSC-PSOE",265
8,"8203",2390,1466,1456,8,10,"PSC-PSOE",143
25,"25003",3762,2215,2195,22,20,"PSC-PSOE",188
43,"43098",343,235,233,5,2,"PSC-PSOE",15
25,"25085",148,107,107,0,0,"PSC-PSOE",7
25,"25171",2185,1416,1410,8,6,"PSC-PSOE",190
17,"17234",182,115,114,0,1,"PSC-PSOE",16
43,"43066",158,100,98,5,2,"PSC-PSOE",9
43,"43014",14251,8737,8624,101,113,"PSC-PSOE",1291
25,"25032",64,44,44,1,0,"PSC-PSOE",0
8,"8270",18490,12343,12274,93,69,"PSC-PSOE",1548
8,"8128",563,375,372,2,3,"PSC-PSOE",56
25,"25207",6212,3710,3680,47,30,"PSC-PSOE",344
25,"25164",376,242,238,4,4,"PSC-PSOE",16
8,"8235",3686,2488,2470,16,18,"PSC-PSOE",188
17,"17208",995,594,590,8,4,"PSC-PSOE",31
25,"25252",548,343,342,9,1,"PSC-PSOE",19
25,"25113",1168,811,803,8,8,"PSC-PSOE",72
17,"17079",64395,41049,40699,342,350,"PSC-PSOE",5243
25,"25139",467,294,291,5,3,"PSC-PSOE",20
25,"25068",556,346,341,11,5,"PSC-PSOE",22
8,"8137",262,188,187,2,1,"PSC-PSOE",19
25,"25074",178,132,128,6,4,"PSC-PSOE",10
25,"25042",208,123,121,1,2,"PSC-PSOE",9
43,"43050",2505,1507,1496,12,11,"PSC-PSOE",272
17,"17086",1729,1068,1059,8,9,"PSC-PSOE",188
17,"17165",656,439,435,3,4,"PSC-PSOE",39
8,"8156",10891,7322,7259,43,63,"PSC-PSOE",963
43,"43128",907,587,577,5,10,"PSC-PSOE",113
25,"25205",566,382,372,8,10,"PSC-PSOE",28
43,"43129",4580,2844,2805,23,39,"PSC-PSOE",308
8,"8272",151,90,90,1,0,"PSC-PSOE",2
8,"8222",1895,1358,1351,14,7,"PSC-PSOE",127
25,"25140",788,435,430,9,5,"PSC-PSOE",24
8,"8111",218,185,184,3,1,"PSC-PSOE",1
17,"17180",8295,4958,4935,36,23,"PSC-PSOE",477
8,"8129",462,319,316,3,3,"PSC-PSOE",17
25,"25092",130,98,95,2,3,"PSC-PSOE",2
8,"8154",696,494,488,5,6,"PSC-PSOE",53
8,"8004",223,165,164,2,1,"PSC-PSOE",7
8,"8305",27339,17960,17809,147,151,"PSC-PSOE",2656
8,"8057",60,45,44,1,1,"PSC-PSOE",2
43,"43100",3301,2183,2172,24,11,"PSC-PSOE",331
17,"17177",549,332,331,1,1,"PSC-PSOE",18
8,"8278",4779,3161,3148,20,13,"PSC-PSOE",117
17,"17153",188,133,133,0,0,"PSC-PSOE",6
25,"25130",195,113,112,2,1,"PSC-PSOE",8
25,"25122",1915,1208,1197,16,11,"PSC-PSOE",101
43,"43084",526,363,361,10,2,"PSC-PSOE",42
8,"8087",152,121,121,2,0,"PSC-PSOE",4
17,"17038",366,234,232,6,2,"PSC-PSOE",7
17,"17022",6910,4207,4184,58,23,"PSC-PSOE",574
17,"17023",27269,17209,17032,122,177,"PSC-PSOE",3356
43,"43077",463,272,272,5,0,"PSC-PSOE",102
43,"43033",765,531,530,4,1,"PSC-PSOE",56
8,"8112",12911,7790,7723,74,67,"PSC-PSOE",1022
8,"8243",162,113,113,7,0,"PSC-PSOE",1
25,"25061",83,46,46,0,0,"PSC-PSOE",5
43,"43104",1783,1157,1142,10,15,"PSC-PSOE",153
17,"17212",141,104,102,0,2,"PSC-PSOE",2
25,"25208",331,183,182,1,1,"PSC-PSOE",13
43,"43176",785,523,520,4,3,"PSC-PSOE",24
17,"17159",643,413,406,3,7,"PSC-PSOE",22
17,"17098",301,192,188,2,4,"PSC-PSOE",18
17,"17039",1759,1159,1145,14,14,"PSC-PSOE",142
8,"8067",5739,3616,3577,47,39,"PSC-PSOE",369
17,"17141",5887,3197,3165,34,32,"PSC-PSOE",427
43,"43907",4374,2793,2783,24,10,"PSC-PSOE",805
43,"43158",85,52,52,1,0,"PSC-PSOE",0
17,"17097",196,148,148,3,0,"PSC-PSOE",4
43,"43101",145,104,102,3,2,"PSC-PSOE",5
8,"8263",20972,13710,13583,149,127,"PSC-PSOE",2802
43,"43114",392,271,268,2,3,"PSC-PSOE",19
8,"8225",92,66,66,4,0,"PSC-PSOE",0
25,"25100",211,125,124,1,1,"PSC-PSOE",13
17,"17046",717,459,458,4,1,"PSC-PSOE",51
43,"43173",100,53,51,0,2,"PSC-PSOE",2
25,"25119",2248,1449,1442,15,7,"PSC-PSOE",130
8,"8142",133,103,101,5,2,"PSC-PSOE",6
17,"17107",264,167,165,8,2,"PSC-PSOE",4
43,"43103",880,547,545,4,2,"PSC-PSOE",78
8,"8259",6637,4611,4577,39,34,"PSC-PSOE",557
25,"25123",193,134,131,2,3,"PSC-PSOE",8
17,"17191",141,92,89,1,3,"PSC-PSOE",2
17,"17093",891,563,560,6,3,"PSC-PSOE",41
43,"43009",1403,918,905,14,13,"PSC-PSOE",113
8,"8074",10611,6728,6679,52,49,"PSC-PSOE",1087
8,"8195",82,63,63,0,0,"PSC-PSOE",0
17,"17087",225,152,149,2,3,"PSC-PSOE",5
8,"8115",3799,2589,2572,17,17,"PSC-PSOE",458
25,"25075",117,72,72,2,0,"PSC-PSOE",3
8,"8152",114,80,79,0,1,"PSC-PSOE",2
8,"8013",1224,802,793,9,9,"PSC-PSOE",63
8,"8160",327,208,208,1,0,"PSC-PSOE",8
25,"25913",86,67,67,3,0,"PSC-PSOE",5
25,"25019",4572,2726,2698,34,28,"PSC-PSOE",392
8,"8061",1497,986,983,14,3,"PSC-PSOE",141
8,"8301",48557,32715,32533,253,182,"PSC-PSOE",8086
17,"17047",4798,2773,2757,28,16,"PSC-PSOE",324
25,"25109",231,163,162,2,1,"PSC-PSOE",5
25,"25101",561,364,358,2,6,"PSC-PSOE",27
8,"8098",2381,1544,1534,5,10,"PSC-PSOE",165
25,"25248",891,592,586,6,6,"PSC-PSOE",19
17,"17005",413,257,252,3,5,"PSC-PSOE",20
8,"8179",579,396,396,5,0,"PSC-PSOE",38
8,"8265",1553,1028,1018,11,10,"PSC-PSOE",55
8,"8198",4411,2972,2954,23,18,"PSC-PSOE",237
25,"25234",4279,2546,2508,23,38,"PSC-PSOE",330
43,"43901",8737,4703,4639,62,64,"PSC-PSOE",835
17,"17074",510,337,335,2,2,"PSC-PSOE",41
25,"25217",10625,6319,6260,99,59,"PSC-PSOE",703
25,"25072",5850,3493,3444,29,49,"PSC-PSOE",353
17,"17142",2550,1806,1797,30,9,"PSC-PSOE",173
43,"43022",1497,897,889,14,8,"PSC-PSOE",140
17,"17166",522,374,367,1,7,"PSC-PSOE",4
8,"8048",582,419,417,4,2,"PSC-PSOE",38
8,"8221",12368,8798,8763,67,35,"PSC-PSOE",1055
43,"43144",1247,842,836,6,6,"PSC-PSOE",71
32,"32084",918,641,635,3,6,"PSdeG-PSOE",169
36,"36025",2257,1360,1350,10,10,"PSdeG-PSOE",182
15,"15061",5571,3746,3691,27,55,"PSdeG-PSOE",841
15,"15074",4037,2841,2796,20,45,"PSdeG-PSOE",457
27,"27060",2598,1690,1665,19,25,"PSdeG-PSOE",350
36,"36005",8121,5480,5400,52,80,"PSdeG-PSOE",1434
15,"15027",1536,1182,1155,6,27,"PSdeG-PSOE",251
15,"15058",27793,20392,20235,221,157,"PSdeG-PSOE",4030
15,"15028",1409,1038,1024,6,14,"PSdeG-PSOE",266
32,"32043",2561,1806,1774,9,32,"PSdeG-PSOE",347
27,"27044",2879,1705,1662,27,43,"PSdeG-PSOE",337
36,"36901",4103,3153,3102,19,51,"PSdeG-PSOE",1137
27,"27025",2831,2152,2110,17,42,"PSdeG-PSOE",371
27,"27020",3524,2816,2761,28,55,"PSdeG-PSOE",565
32,"32048",895,574,569,5,5,"PSdeG-PSOE",222
32,"32053",1438,1158,1144,11,14,"PSdeG-PSOE",181
32,"32038",436,278,271,2,7,"PSdeG-PSOE",81
15,"15044",1286,937,927,8,10,"PSdeG-PSOE",185
15,"15901",3546,2247,2228,24,19,"PSdeG-PSOE",588
32,"32032",8059,5708,5608,58,100,"PSdeG-PSOE",1073
36,"36037",2571,1733,1707,11,26,"PSdeG-PSOE",289
36,"36054",10993,7476,7363,67,113,"PSdeG-PSOE",1579
27,"27008",1379,1000,982,9,18,"PSdeG-PSOE",223
32,"32060",832,583,576,8,7,"PSdeG-PSOE",199
32,"32079",1333,950,939,11,11,"PSdeG-PSOE",251
27,"27031",15570,10606,10420,118,186,"PSdeG-PSOE",2566
15,"15056",5722,3869,3818,46,51,"PSdeG-PSOE",991
15,"15016",4749,3058,3020,19,38,"PSdeG-PSOE",1161
15,"15003",1803,1227,1210,9,17,"PSdeG-PSOE",267
36,"36049",6804,4960,4860,36,100,"PSdeG-PSOE",838
27,"27046",1530,1022,1007,9,15,"PSdeG-PSOE",344
32,"32090",774,530,511,4,19,"PSdeG-PSOE",74
32,"32017",1244,870,857,6,13,"PSdeG-PSOE",200
27,"27027",1929,1369,1342,11,27,"PSdeG-PSOE",408
15,"15045",3770,2184,2157,14,27,"PSdeG-PSOE",403
32,"32014",1142,848,834,6,14,"PSdeG-PSOE",139
32,"32073",1315,973,960,5,13,"PSdeG-PSOE",287
36,"36045",24529,17613,17336,129,277,"PSdeG-PSOE",4330
32,"32007",1517,1046,1028,8,18,"PSdeG-PSOE",212
36,"36026",20137,13779,13596,141,183,"PSdeG-PSOE",2531
27,"27001",2370,1281,1256,13,25,"PSdeG-PSOE",199
32,"32047",1784,1255,1244,9,11,"PSdeG-PSOE",207
32,"32078",1188,855,838,4,17,"PSdeG-PSOE",172
36,"36001",2564,1858,1848,5,10,"PSdeG-PSOE",364
27,"27003",1876,1344,1320,12,24,"PSdeG-PSOE",254
27,"27901",2386,1596,1569,25,27,"PSdeG-PSOE",326
27,"27019",8111,5773,5680,53,93,"PSdeG-PSOE",1352
36,"36017",17782,12411,12240,117,171,"PSdeG-PSOE",2663
15,"15048",4839,3456,3414,36,42,"PSdeG-PSOE",750
27,"27028",79049,54057,53355,559,702,"PSdeG-PSOE",12628
15,"15033",2472,1863,1845,8,18,"PSdeG-PSOE",367
15,"15046",6332,4377,4262,40,115,"PSdeG-PSOE",806
15,"15071",7951,5255,5178,50,77,"PSdeG-PSOE",1143
27,"27043",1295,805,793,9,12,"PSdeG-PSOE",178
27,"27002",1633,1137,1108,9,29,"PSdeG-PSOE",349
32,"32089",1295,888,878,7,10,"PSdeG-PSOE",181
15,"15077",8261,5186,5103,59,83,"PSdeG-PSOE",1089
32,"32087",1765,1363,1343,13,20,"PSdeG-PSOE",248
27,"27004",1227,760,749,7,11,"PSdeG-PSOE",182
36,"36031",558,465,459,7,6,"PSdeG-PSOE",66
27,"27056",1248,848,836,9,12,"PSdeG-PSOE",190
15,"15079",1540,1027,1007,16,20,"PSdeG-PSOE",199
32,"32083",835,559,550,4,9,"PSdeG-PSOE",125
15,"15085",3332,2280,2247,25,33,"PSdeG-PSOE",428
32,"32077",1166,791,785,14,6,"PSdeG-PSOE",223
36,"36009",4503,3056,3001,15,55,"PSdeG-PSOE",629
27,"27051",8108,5503,5424,62,79,"PSdeG-PSOE",1106
32,"32029",470,357,352,4,5,"PSdeG-PSOE",51
32,"32004",1798,1029,1023,4,6,"PSdeG-PSOE",51
27,"27057",11169,7551,7386,79,165,"PSdeG-PSOE",1735
36,"36051",14267,9638,9493,71,145,"PSdeG-PSOE",1788
15,"15057",12075,8479,8377,66,102,"PSdeG-PSOE",1718
15,"15065",7315,5187,5099,42,88,"PSdeG-PSOE",1027
15,"15089",4291,3020,2972,28,48,"PSdeG-PSOE",597
32,"32012",784,505,497,2,8,"PSdeG-PSOE",121
36,"36042",17891,12212,12003,93,209,"PSdeG-PSOE",2533
36,"36030",4175,2832,2785,27,47,"PSdeG-PSOE",596
32,"32045",2443,1715,1690,14,25,"PSdeG-PSOE",403
36,"36006",11520,8529,8396,63,133,"PSdeG-PSOE",1545
36,"36033",12298,8968,8788,53,180,"PSdeG-PSOE",2138
15,"15047",2429,1576,1549,19,27,"PSdeG-PSOE",411
32,"32052",1888,1399,1379,6,20,"PSdeG-PSOE",242
36,"36021",12073,8447,8342,89,105,"PSdeG-PSOE",1803
15,"15035",11427,7779,7657,144,122,"PSdeG-PSOE",1681
36,"36014",1942,1459,1444,9,15,"PSdeG-PSOE",257
15,"15041",9568,6828,6710,75,118,"PSdeG-PSOE",1438
15,"15052",4314,2889,2838,21,51,"PSdeG-PSOE",885
32,"32075",4217,3089,3044,33,45,"PSdeG-PSOE",623
32,"32063",1914,1297,1279,16,18,"PSdeG-PSOE",321
32,"32086",2646,1693,1677,13,16,"PSdeG-PSOE",350
32,"32088",1622,1018,1002,8,16,"PSdeG-PSOE",287
32,"32092",520,321,320,6,1,"PSdeG-PSOE",52
32,"32054",87167,60059,59333,540,726,"PSdeG-PSOE",14662
27,"27066",12696,8704,8537,98,167,"PSdeG-PSOE",2191
32,"32033",737,478,476,3,2,"PSdeG-PSOE",94
27,"27032",3275,2128,2096,22,32,"PSdeG-PSOE",437
27,"27039",4358,3143,3085,40,58,"PSdeG-PSOE",569
27,"27065",12444,8261,8056,112,205,"PSdeG-PSOE",1654
15,"15040",2753,1905,1880,5,25,"PSdeG-PSOE",442
32,"32037",728,518,509,6,9,"PSdeG-PSOE",97
15,"15036",57885,39471,39096,417,375,"PSdeG-PSOE",8356
27,"27062",605,447,444,1,3,"PSdeG-PSOE",132
36,"36053",5684,4099,4050,38,49,"PSdeG-PSOE",693
32,"32024",4821,3320,3254,34,66,"PSdeG-PSOE",683
32,"32019",11537,7975,7861,56,114,"PSdeG-PSOE",1681
15,"15064",2194,1592,1556,21,36,"PSdeG-PSOE",473
15,"15067",8029,5789,5732,37,57,"PSdeG-PSOE",1228
15,"15054",32106,21026,20772,259,254,"PSdeG-PSOE",4156
32,"32085",10716,7279,7152,66,127,"PSdeG-PSOE",1745
15,"15024",4393,3141,3073,32,68,"PSdeG-PSOE",810
32,"32009",10803,7303,7227,48,76,"PSdeG-PSOE",1996
36,"36039",15401,10871,10609,71,262,"PSdeG-PSOE",1974
15,"15020",3784,2476,2447,17,29,"PSdeG-PSOE",605
32,"32044",876,643,634,2,9,"PSdeG-PSOE",119
32,"32041",767,524,515,4,9,"PSdeG-PSOE",106
36,"36018",3240,2198,2170,10,28,"PSdeG-PSOE",441
15,"15072",9574,6637,6562,35,75,"PSdeG-PSOE",1638
27,"27012",1355,736,729,5,7,"PSdeG-PSOE",271
36,"36043",4747,3210,3162,20,48,"PSdeG-PSOE",759
32,"32036",1345,971,953,14,18,"PSdeG-PSOE",130
36,"36036",2518,1827,1801,18,26,"PSdeG-PSOE",379
32,"32006",1531,1114,1090,10,24,"PSdeG-PSOE",184
15,"15002",23083,16073,15889,159,184,"PSdeG-PSOE",3214
27,"27037",1065,750,740,11,10,"PSdeG-PSOE",199
32,"32067",1294,837,826,8,11,"PSdeG-PSOE",167
15,"15039",1263,889,875,7,14,"PSdeG-PSOE",165
32,"32068",1415,982,978,5,4,"PSdeG-PSOE",224
32,"32022",1337,892,881,6,11,"PSdeG-PSOE",243
15,"15090",1179,812,804,9,8,"PSdeG-PSOE",116
32,"32002",2017,1413,1398,16,15,"PSdeG-PSOE",417
36,"36029",16077,11617,11471,100,146,"PSdeG-PSOE",2020
36,"36024",16455,11971,11781,109,190,"PSdeG-PSOE",1855
32,"32034",1124,845,839,5,6,"PSdeG-PSOE",193
15,"15075",12336,8830,8725,91,105,"PSdeG-PSOE",1705
15,"15066",4009,2814,2776,33,38,"PSdeG-PSOE",508
27,"27049",1409,921,909,7,12,"PSdeG-PSOE",191
36,"36038",66390,47750,47273,449,477,"PSdeG-PSOE",10559
27,"27038",935,679,671,7,8,"PSdeG-PSOE",246
32,"32069",4308,3221,3164,27,57,"PSdeG-PSOE",921
15,"15015",2799,2045,2008,24,37,"PSdeG-PSOE",402
32,"32008",8256,5542,5490,39,52,"PSdeG-PSOE",1305
32,"32023",1210,862,849,4,13,"PSdeG-PSOE",259
32,"32003",885,654,649,5,5,"PSdeG-PSOE",131
15,"15083",1086,757,746,5,11,"PSdeG-PSOE",111
27,"27045",1038,613,603,10,10,"PSdeG-PSOE",303
27,"27006",2564,1659,1637,17,22,"PSdeG-PSOE",410
36,"36044",2541,1674,1646,7,28,"PSdeG-PSOE",274
27,"27021",1753,1090,1056,12,34,"PSdeG-PSOE",265
32,"32040",1477,1090,1084,7,6,"PSdeG-PSOE",206
32,"32080",328,249,244,5,5,"PSdeG-PSOE",33
36,"36035",14433,10333,10188,79,145,"PSdeG-PSOE",2132
27,"27034",1120,681,672,4,9,"PSdeG-PSOE",211
36,"36048",5331,3653,3603,22,50,"PSdeG-PSOE",764
27,"27005",2595,1846,1816,13,30,"PSdeG-PSOE",339
15,"15093",4220,2533,2498,30,35,"PSdeG-PSOE",478
32,"32027",1053,765,749,2,16,"PSdeG-PSOE",187
15,"15038",2227,1463,1443,25,20,"PSdeG-PSOE",343
27,"27042",1740,1235,1218,12,17,"PSdeG-PSOE",262
15,"15053",7729,5089,5043,49,46,"PSdeG-PSOE",1166
27,"27015",4270,2832,2769,33,63,"PSdeG-PSOE",612
27,"27018",3467,2086,2059,20,27,"PSdeG-PSOE",755
32,"32066",566,418,416,0,2,"PSdeG-PSOE",56
15,"15073",21827,14058,13864,126,194,"PSdeG-PSOE",2339
27,"27030",3327,2207,2159,31,48,"PSdeG-PSOE",502
32,"32031",1069,822,795,4,27,"PSdeG-PSOE",132
32,"32057",565,416,415,4,1,"PSdeG-PSOE",188
15,"15018",1142,741,732,18,9,"PSdeG-PSOE",258
15,"15060",5772,4032,3958,46,74,"PSdeG-PSOE",941
15,"15902",4598,3209,3149,51,60,"PSdeG-PSOE",674
27,"27061",1027,753,732,6,21,"PSdeG-PSOE",219
27,"27048",2140,1502,1467,20,35,"PSdeG-PSOE",494
15,"15080",1756,1131,1117,11,14,"PSdeG-PSOE",291
32,"32046",1160,787,779,4,8,"PSdeG-PSOE",174
27,"27017",1003,674,670,4,4,"PSdeG-PSOE",161
15,"15049",1098,758,752,7,6,"PSdeG-PSOE",97
36,"36023",8395,5965,5884,41,81,"PSdeG-PSOE",991
32,"32074",1044,710,704,4,6,"PSdeG-PSOE",158
15,"15078",78198,56154,55581,560,573,"PSdeG-PSOE",11244
15,"15032",3444,2322,2269,30,53,"PSdeG-PSOE",387
15,"15019",25888,16680,16460,186,220,"PSdeG-PSOE",3755
15,"15070",9069,6090,5976,94,114,"PSdeG-PSOE",1750
15,"15092",6438,3976,3903,28,73,"PSdeG-PSOE",1052
32,"32059",1790,1283,1263,7,20,"PSdeG-PSOE",324
36,"36034",3475,2403,2367,11,36,"PSdeG-PSOE",504
27,"27902",7205,4829,4754,53,75,"PSdeG-PSOE",1007
27,"27010",4327,2899,2837,53,62,"PSdeG-PSOE",582
36,"36022",9011,6310,6172,49,138,"PSdeG-PSOE",1316
15,"15068",5049,3185,3129,25,56,"PSdeG-PSOE",648
15,"15001",4765,3280,3237,25,43,"PSdeG-PSOE",583
15,"15004",4834,3436,3391,30,45,"PSdeG-PSOE",777
32,"32065",657,463,454,3,9,"PSdeG-PSOE",130
27,"27022",4833,3022,2954,30,68,"PSdeG-PSOE",759
27,"27023",2579,1891,1865,23,26,"PSdeG-PSOE",442
36,"36016",1143,721,711,3,10,"PSdeG-PSOE",76
15,"15043",5114,3476,3401,47,75,"PSdeG-PSOE",729
32,"32062",811,621,617,6,4,"PSdeG-PSOE",118
32,"32056",1592,1124,1118,7,6,"PSdeG-PSOE",262
27,"27053",537,316,308,3,8,"PSdeG-PSOE",136
32,"32016",790,550,543,2,7,"PSdeG-PSOE",254
36,"36061",8606,6232,6133,41,99,"PSdeG-PSOE",1056
36,"36028",4102,2913,2868,17,45,"PSdeG-PSOE",638
32,"32061",1081,812,809,4,3,"PSdeG-PSOE",229
32,"32005",861,662,650,7,12,"PSdeG-PSOE",111
15,"15014",4002,2566,2524,28,42,"PSdeG-PSOE",546
15,"15051",4638,3182,3153,44,29,"PSdeG-PSOE",766
15,"15022",5785,3811,3771,33,40,"PSdeG-PSOE",712
36,"36013",2344,1536,1514,11,22,"PSdeG-PSOE",264
27,"27033",623,415,409,8,6,"PSdeG-PSOE",119
15,"15037",4061,2588,2552,19,36,"PSdeG-PSOE",568
32,"32072",3821,2705,2667,24,38,"PSdeG-PSOE",692
15,"15055",4572,3070,3013,27,57,"PSdeG-PSOE",785
36,"36046",4036,2971,2921,15,50,"PSdeG-PSOE",688
27,"27016",7172,4910,4846,51,64,"PSdeG-PSOE",1119
36,"36019",1625,1042,1029,9,13,"PSdeG-PSOE",422
27,"27029",1463,1023,1002,11,21,"PSdeG-PSOE",250
32,"32039",1262,957,941,6,16,"PSdeG-PSOE",161
27,"27014",3254,2103,2067,21,36,"PSdeG-PSOE",541
15,"15007",3303,2262,2246,15,16,"PSdeG-PSOE",589
32,"32049",760,510,507,9,3,"PSdeG-PSOE",145
36,"36010",2847,2102,2076,13,26,"PSdeG-PSOE",531
15,"15017",19420,13661,13505,175,156,"PSdeG-PSOE",3075
32,"32081",2077,1517,1500,14,17,"PSdeG-PSOE",384
32,"32028",1610,1211,1189,16,22,"PSdeG-PSOE",152
32,"32013",2183,1428,1425,8,3,"PSdeG-PSOE",221
32,"32010",388,301,299,3,2,"PSdeG-PSOE",64
32,"32020",2576,1923,1899,5,24,"PSdeG-PSOE",406
15,"15023",6419,4348,4261,36,87,"PSdeG-PSOE",1100
36,"36047",2454,1633,1621,13,12,"PSdeG-PSOE",434
15,"15005",24516,15761,15537,213,224,"PSdeG-PSOE",3401
15,"15012",3627,2659,2602,28,57,"PSdeG-PSOE",488
32,"32050",2433,1829,1814,12,15,"PSdeG-PSOE",366
27,"27052",915,676,667,6,9,"PSdeG-PSOE",265
15,"15087",5769,3766,3722,42,44,"PSdeG-PSOE",881
15,"15081",1034,791,782,11,9,"PSdeG-PSOE",95
36,"36057",236673,169244,167605,1366,1639,"PSdeG-PSOE",40205
32,"32071",1476,1010,1005,3,5,"PSdeG-PSOE",261
15,"15091",1135,771,760,13,11,"PSdeG-PSOE",144
15,"15010",1887,1168,1150,13,18,"PSdeG-PSOE",267
15,"15076",2611,1758,1739,17,19,"PSdeG-PSOE",334
15,"15025",1061,629,622,6,7,"PSdeG-PSOE",172
32,"32070",548,335,329,3,6,"PSdeG-PSOE",81
32,"32051",1427,1184,1172,6,12,"PSdeG-PSOE",219
36,"36011",1799,1144,1122,8,22,"PSdeG-PSOE",259
32,"32042",1579,1094,1081,12,13,"PSdeG-PSOE",242
36,"36020",2318,1646,1620,18,26,"PSdeG-PSOE",299
27,"27035",187,122,121,1,1,"PSdeG-PSOE",46
27,"27026",2397,1503,1471,9,32,"PSdeG-PSOE",430
27,"27055",1293,826,809,6,17,"PSdeG-PSOE",254
32,"32021",947,634,630,5,4,"PSdeG-PSOE",231
27,"27013",3766,2900,2851,25,49,"PSdeG-PSOE",665
15,"15086",2869,1970,1950,13,20,"PSdeG-PSOE",366
15,"15006",5321,3341,3283,49,58,"PSdeG-PSOE",641
27,"27059",2163,1570,1543,17,27,"PSdeG-PSOE",273
27,"27040",3200,2351,2310,21,41,"PSdeG-PSOE",556
32,"32076",2094,1488,1474,20,14,"PSdeG-PSOE",286
32,"32064",529,389,388,3,1,"PSdeG-PSOE",53
15,"15069",6745,4910,4850,43,60,"PSdeG-PSOE",1132
36,"36050",7561,5280,5188,25,92,"PSdeG-PSOE",1365
36,"36027",4430,3137,3101,15,36,"PSdeG-PSOE",621
15,"15088",3519,2304,2270,27,34,"PSdeG-PSOE",441
15,"15050",1822,1004,988,13,16,"PSdeG-PSOE",310
15,"15082",15180,10841,10726,102,115,"PSdeG-PSOE",1965
15,"15011",15432,10395,10248,74,147,"PSdeG-PSOE",2019
27,"27041",2341,1718,1705,16,13,"PSdeG-PSOE",333
36,"36052",7292,4999,4907,45,92,"PSdeG-PSOE",1144
36,"36055",13620,9580,9400,62,180,"PSdeG-PSOE",1811
36,"36003",9980,7191,7110,67,81,"PSdeG-PSOE",1258
36,"36015",4153,2721,2677,23,44,"PSdeG-PSOE",737
36,"36060",30323,21399,21162,164,237,"PSdeG-PSOE",4981
36,"36056",5076,3584,3515,30,69,"PSdeG-PSOE",619
36,"36002",3147,2193,2169,20,24,"PSdeG-PSOE",422
36,"36012",3732,2751,2717,9,34,"PSdeG-PSOE",723
15,"15059",10362,7258,7106,91,152,"PSdeG-PSOE",1510
36,"36008",21762,15447,15262,128,185,"PSdeG-PSOE",2492
15,"15021",5127,3587,3543,38,44,"PSdeG-PSOE",849
15,"15042",3028,2033,2000,19,33,"PSdeG-PSOE",439
36,"36004",10161,6939,6844,63,95,"PSdeG-PSOE",1158
36,"36040",2575,1709,1680,15,29,"PSdeG-PSOE",374
27,"27050",2975,2190,2154,16,36,"PSdeG-PSOE",410
15,"15013",6151,4237,4189,48,48,"PSdeG-PSOE",875
32,"32025",1079,791,777,1,14,"PSdeG-PSOE",153
32,"32091",1838,1368,1362,6,6,"PSdeG-PSOE",456
32,"32018",1247,975,962,9,13,"PSdeG-PSOE",399
27,"27054",1190,881,860,9,21,"PSdeG-PSOE",204
15,"15029",5688,3590,3544,32,46,"PSdeG-PSOE",903
32,"32035",1442,957,942,3,15,"PSdeG-PSOE",146
27,"27058",3495,2510,2480,30,30,"PSdeG-PSOE",588
15,"15084",3260,2218,2191,27,27,"PSdeG-PSOE",378
27,"27007",2805,2133,2078,38,55,"PSdeG-PSOE",383
32,"32058",5202,3650,3607,34,43,"PSdeG-PSOE",719
32,"32026",2704,1929,1896,22,33,"PSdeG-PSOE",567
36,"36059",4882,3137,3085,28,52,"PSdeG-PSOE",515
27,"27011",2452,1494,1467,19,27,"PSdeG-PSOE",465
15,"15009",10739,7688,7559,54,129,"PSdeG-PSOE",1756
32,"32015",874,575,573,4,2,"PSdeG-PSOE",93
32,"32011",932,619,613,1,6,"PSdeG-PSOE",36
15,"15030",200176,143255,142070,1452,1185,"PSdeG-PSOE",31476
15,"15031",23348,16380,16235,191,145,"PSdeG-PSOE",4251
27,"27047",1629,1106,1089,8,17,"PSdeG-PSOE",274
32,"32055",1280,891,881,7,10,"PSdeG-PSOE",166
15,"15008",5627,4112,4072,36,40,"PSdeG-PSOE",901
36,"36058",4994,3292,3243,33,49,"PSdeG-PSOE",812
32,"32001",4986,3488,3443,25,45,"PSdeG-PSOE",595
27,"27064",1581,1097,1068,12,29,"PSdeG-PSOE",199
15,"15062",5887,3747,3701,36,46,"PSdeG-PSOE",671
36,"36032",3630,2587,2535,16,52,"PSdeG-PSOE",657
15,"15034",2885,1782,1760,18,22,"PSdeG-PSOE",733
32,"32082",1243,891,878,1,13,"PSdeG-PSOE",211
27,"27063",1737,1226,1186,14,40,"PSdeG-PSOE",352
27,"27024",1598,1173,1158,8,15,"PSdeG-PSOE",368
36,"36007",1672,1119,1099,8,20,"PSdeG-PSOE",294
27,"27009",2097,1533,1507,12,26,"PSdeG-PSOE",295
36,"36041",13434,9297,9181,66,116,"PSdeG-PSOE",1798
32,"32030",999,736,726,3,10,"PSdeG-PSOE",363
48,"48015",33581,22727,22528,122,199,"PSE-EE (PSOE)",4427
48,"48082",37605,25134,24938,176,196,"PSE-EE (PSOE)",4583
1,"1055",838,538,527,8,11,"PSE-EE (PSOE)",42
48,"48040",1281,877,869,3,8,"PSE-EE (PSOE)",33
48,"48047",159,111,111,0,0,"PSE-EE (PSOE)",0
48,"48053",895,666,662,6,4,"PSE-EE (PSOE)",36
1,"1008",786,513,509,11,4,"PSE-EE (PSOE)",37
20,"20026",197,145,133,0,12,"PSE-EE (PSOE)",1
48,"48910",2909,1950,1937,10,13,"PSE-EE (PSOE)",298
48,"48909",209,161,161,0,0,"PSE-EE (PSOE)",0
20,"20048",182,100,98,2,2,"PSE-EE (PSOE)",3
20,"20070",1092,748,746,5,2,"PSE-EE (PSOE)",19
20,"20054",447,286,284,2,2,"PSE-EE (PSOE)",0
48,"48056",966,705,700,5,5,"PSE-EE (PSOE)",9
1,"1014",371,280,272,4,8,"PSE-EE (PSOE)",37
48,"48063",372,279,277,2,2,"PSE-EE (PSOE)",4
1,"1004",1399,1008,995,8,13,"PSE-EE (PSOE)",71
48,"48076",308,218,217,2,1,"PSE-EE (PSOE)",4
48,"48046",12611,8836,8794,39,42,"PSE-EE (PSOE)",610
1,"1032",517,361,354,1,7,"PSE-EE (PSOE)",48
1,"1009",1265,849,845,2,4,"PSE-EE (PSOE)",76
20,"20901",1437,908,906,2,2,"PSE-EE (PSOE)",100
20,"20081",7470,4856,4833,40,23,"PSE-EE (PSOE)",549
48,"48096",6577,4794,4728,31,66,"PSE-EE (PSOE)",518
48,"48030",606,441,439,1,2,"PSE-EE (PSOE)",4
48,"48011",9673,6468,6423,45,45,"PSE-EE (PSOE)",859
48,"48057",5723,3988,3962,26,26,"PSE-EE (PSOE)",82
20,"20044",367,236,236,0,0,"PSE-EE (PSOE)",14
1,"1059",186557,126506,125278,798,1228,"PSE-EE (PSOE)",21553
20,"20056",4082,2589,2570,27,19,"PSE-EE (PSOE)",107
20,"20033",868,600,599,1,1,"PSE-EE (PSOE)",24
1,"1062",313,211,210,2,1,"PSE-EE (PSOE)",23
20,"20037",99,64,64,2,0,"PSE-EE (PSOE)",0
48,"48049",549,416,416,1,0,"PSE-EE (PSOE)",0
1,"1028",1070,716,710,3,6,"PSE-EE (PSOE)",97
48,"48012",2049,1527,1512,7,15,"PSE-EE (PSOE)",44
1,"1042",904,653,648,6,5,"PSE-EE (PSOE)",28
20,"20074",11592,7954,7914,45,40,"PSE-EE (PSOE)",702
48,"48097",1297,900,894,8,6,"PSE-EE (PSOE)",96
48,"48041",693,533,529,3,4,"PSE-EE (PSOE)",14
20,"20014",1108,611,609,4,2,"PSE-EE (PSOE)",25
20,"20058",755,529,525,3,4,"PSE-EE (PSOE)",83
1,"1027",416,257,254,3,3,"PSE-EE (PSOE)",7
20,"20015",1265,858,851,7,7,"PSE-EE (PSOE)",6
1,"1010",2268,1623,1603,11,20,"PSE-EE (PSOE)",102
48,"48070",544,362,362,4,0,"PSE-EE (PSOE)",0
1,"1044",236,169,167,0,2,"PSE-EE (PSOE)",20
48,"48087",427,344,338,0,6,"PSE-EE (PSOE)",27
48,"48066",348,258,258,1,0,"PSE-EE (PSOE)",0
1,"1001",1979,1339,1318,7,21,"PSE-EE (PSOE)",205
20,"20077",5213,3614,3591,36,23,"PSE-EE (PSOE)",541
48,"48043",4423,3118,3108,17,10,"PSE-EE (PSOE)",211
20,"20069",147046,100691,100232,836,459,"PSE-EE (PSOE)",15439
1,"1036",14955,10052,9959,55,93,"PSE-EE (PSOE)",1432
20,"20006",259,143,143,3,0,"PSE-EE (PSOE)",1
48,"48092",836,618,613,5,5,"PSE-EE (PSOE)",31
20,"20045",46626,30525,30353,197,172,"PSE-EE (PSOE)",6643
1,"1019",150,106,105,1,1,"PSE-EE (PSOE)",2
20,"20043",1739,1090,1088,9,2,"PSE-EE (PSOE)",40
48,"48906",766,547,544,0,3,"PSE-EE (PSOE)",14
48,"48075",1996,1364,1359,6,5,"PSE-EE (PSOE)",55
1,"1013",712,454,450,0,4,"PSE-EE (PSOE)",23
20,"20080",7910,5294,5260,49,34,"PSE-EE (PSOE)",1246
20,"20063",8017,5263,5231,35,32,"PSE-EE (PSOE)",224
48,"48086",2050,1414,1401,5,13,"PSE-EE (PSOE)",131
48,"48093",893,653,643,7,10,"PSE-EE (PSOE)",18
48,"48902",19008,12566,12447,76,119,"PSE-EE (PSOE)",2084
48,"48068",1550,1130,1118,12,12,"PSE-EE (PSOE)",24
1,"1020",327,237,234,3,3,"PSE-EE (PSOE)",8
1,"1047",968,673,668,5,5,"PSE-EE (PSOE)",88
20,"20017",8559,5478,5435,24,43,"PSE-EE (PSOE)",490
48,"48913",1248,884,869,10,15,"PSE-EE (PSOE)",52
20,"20007",310,218,218,3,0,"PSE-EE (PSOE)",0
20,"20022",839,473,472,4,1,"PSE-EE (PSOE)",11
1,"1041",149,103,100,1,3,"PSE-EE (PSOE)",5
1,"1058",1345,799,793,7,6,"PSE-EE (PSOE)",76
20,"20019",9986,6428,6392,48,36,"PSE-EE (PSOE)",826
48,"48903",1835,1361,1351,7,10,"PSE-EE (PSOE)",62
48,"48008",606,424,414,6,10,"PSE-EE (PSOE)",15
20,"20065",3012,1985,1967,12,18,"PSE-EE (PSOE)",259
48,"48055",2668,1872,1849,11,23,"PSE-EE (PSOE)",116
48,"48090",6001,4345,4295,28,50,"PSE-EE (PSOE)",716
48,"48021",1336,908,899,1,9,"PSE-EE (PSOE)",60
1,"1046",601,432,428,3,4,"PSE-EE (PSOE)",42
20,"20076",6990,4666,4648,29,18,"PSE-EE (PSOE)",544
20,"20055",17475,11073,10997,56,76,"PSE-EE (PSOE)",1488
1,"1051",3603,2259,2235,17,24,"PSE-EE (PSOE)",242
20,"20036",13210,8518,8475,67,43,"PSE-EE (PSOE)",806
48,"48048",557,395,393,5,2,"PSE-EE (PSOE)",7
20,"20030",21423,13960,13898,101,62,"PSE-EE (PSOE)",3000
48,"48074",3312,2330,2309,6,21,"PSE-EE (PSOE)",225
20,"20029",4281,2813,2802,19,11,"PSE-EE (PSOE)",203
20,"20061",4273,2601,2590,21,11,"PSE-EE (PSOE)",186
48,"48912",2308,1707,1679,14,28,"PSE-EE (PSOE)",195
1,"1031",1169,882,863,6,19,"PSE-EE (PSOE)",71
20,"20904",95,44,44,2,0,"PSE-EE (PSOE)",1
1,"1003",1190,782,774,2,8,"PSE-EE (PSOE)",12
48,"48037",673,481,478,5,3,"PSE-EE (PSOE)",26
20,"20066",454,236,234,1,2,"PSE-EE (PSOE)",0
48,"48069",12798,8679,8612,55,67,"PSE-EE (PSOE)",591
48,"48023",600,455,452,0,3,"PSE-EE (PSOE)",13
20,"20040",15289,9444,9373,66,71,"PSE-EE (PSOE)",1071
20,"20073",4677,3014,2995,15,19,"PSE-EE (PSOE)",245
48,"48036",24073,16076,15971,86,105,"PSE-EE (PSOE)",2042
1,"1033",651,484,479,2,5,"PSE-EE (PSOE)",62
20,"20047",469,307,304,5,3,"PSE-EE (PSOE)",10
20,"20009",11452,7388,7345,62,43,"PSE-EE (PSOE)",1383
48,"48058",968,647,646,2,1,"PSE-EE (PSOE)",54
48,"48081",1868,1361,1350,4,11,"PSE-EE (PSOE)",69
48,"48083",6958,4885,4856,40,29,"PSE-EE (PSOE)",908
48,"48002",7829,5490,5451,44,39,"PSE-EE (PSOE)",821
1,"1018",1386,939,930,3,9,"PSE-EE (PSOE)",94
48,"48915",362,227,226,0,1,"PSE-EE (PSOE)",2
48,"48035",413,293,292,1,1,"PSE-EE (PSOE)",3
48,"48028",717,543,537,3,6,"PSE-EE (PSOE)",1
48,"48045",5167,3809,3757,28,52,"PSE-EE (PSOE)",399
48,"48073",6910,4306,4271,31,35,"PSE-EE (PSOE)",123
48,"48052",1562,1160,1150,4,10,"PSE-EE (PSOE)",20
48,"48005",115,63,61,0,2,"PSE-EE (PSOE)",2
48,"48078",38617,26366,26212,158,154,"PSE-EE (PSOE)",5790
20,"20018",11064,6719,6690,41,29,"PSE-EE (PSOE)",332
48,"48039",239,190,188,0,2,"PSE-EE (PSOE)",5
20,"20021",200,100,100,2,0,"PSE-EE (PSOE)",1
1,"1052",245,184,181,0,3,"PSE-EE (PSOE)",42
20,"20013",5415,3602,3579,19,23,"PSE-EE (PSOE)",365
48,"48019",3553,2406,2397,18,9,"PSE-EE (PSOE)",306
48,"48072",977,716,713,4,3,"PSE-EE (PSOE)",21
20,"20907",118,85,85,2,0,"PSE-EE (PSOE)",0
48,"48065",3281,2271,2237,8,34,"PSE-EE (PSOE)",203
48,"48018",869,522,522,2,0,"PSE-EE (PSOE)",8
48,"48026",1140,830,823,5,7,"PSE-EE (PSOE)",6
20,"20051",6877,4699,4679,34,20,"PSE-EE (PSOE)",643
48,"48050",191,147,146,0,1,"PSE-EE (PSOE)",1
20,"20906",119,87,87,1,0,"PSE-EE (PSOE)",1
20,"20041",255,123,123,0,0,"PSE-EE (PSOE)",1
48,"48907",348,266,266,2,0,"PSE-EE (PSOE)",5
48,"48071",6087,4294,4254,32,40,"PSE-EE (PSOE)",684
20,"20003",547,308,308,3,0,"PSE-EE (PSOE)",8
1,"1061",154,127,127,1,0,"PSE-EE (PSOE)",4
20,"20023",441,252,251,1,1,"PSE-EE (PSOE)",15
48,"48042",1369,1068,1053,7,15,"PSE-EE (PSOE)",66
48,"48001",5838,3923,3898,28,25,"PSE-EE (PSOE)",525
48,"48062",302,237,236,4,1,"PSE-EE (PSOE)",2
20,"20057",196,122,122,0,0,"PSE-EE (PSOE)",1
48,"48905",2553,1792,1771,12,21,"PSE-EE (PSOE)",141
1,"1011",235,174,171,4,3,"PSE-EE (PSOE)",16
48,"48061",762,565,561,0,4,"PSE-EE (PSOE)",15
1,"1060",197,160,157,0,3,"PSE-EE (PSOE)",12
1,"1901",2354,1592,1571,8,21,"PSE-EE (PSOE)",291
20,"20025",1143,765,760,8,5,"PSE-EE (PSOE)",23
20,"20032",8797,5672,5630,40,42,"PSE-EE (PSOE)",686
20,"20052",1090,779,776,8,3,"PSE-EE (PSOE)",53
1,"1053",582,321,320,4,1,"PSE-EE (PSOE)",13
20,"20062",973,653,653,11,0,"PSE-EE (PSOE)",21
48,"48022",2336,1444,1433,6,11,"PSE-EE (PSOE)",128
48,"48014",1211,806,801,7,5,"PSE-EE (PSOE)",60
20,"20027",2814,1761,1750,15,11,"PSE-EE (PSOE)",74
20,"20020",125,71,69,3,2,"PSE-EE (PSOE)",0
1,"1056",219,136,135,0,1,"PSE-EE (PSOE)",3
1,"1002",8124,5722,5654,31,68,"PSE-EE (PSOE)",592
20,"20064",12503,7803,7755,52,48,"PSE-EE (PSOE)",1173
20,"20903",4330,2756,2734,28,22,"PSE-EE (PSOE)",253
20,"20068",190,135,135,3,0,"PSE-EE (PSOE)",0
48,"48025",883,642,637,7,5,"PSE-EE (PSOE)",8
20,"20905",145,100,100,1,0,"PSE-EE (PSOE)",0
48,"48080",9976,6820,6763,62,57,"PSE-EE (PSOE)",1321
20,"20010",1499,992,986,9,6,"PSE-EE (PSOE)",83
48,"48009",783,586,575,1,11,"PSE-EE (PSOE)",26
48,"48079",427,305,304,2,1,"PSE-EE (PSOE)",3
48,"48032",5743,4065,4048,29,17,"PSE-EE (PSOE)",403
48,"48085",10338,7190,7153,39,37,"PSE-EE (PSOE)",571
20,"20005",1260,738,736,11,2,"PSE-EE (PSOE)",38
48,"48051",213,163,163,0,0,"PSE-EE (PSOE)",19
20,"20039",2111,1480,1472,14,8,"PSE-EE (PSOE)",35
20,"20072",4728,2902,2886,21,16,"PSE-EE (PSOE)",435
1,"1902",734,514,502,4,12,"PSE-EE (PSOE)",57
20,"20028",2237,1373,1365,11,8,"PSE-EE (PSOE)",155
48,"48029",8338,5721,5683,37,38,"PSE-EE (PSOE)",980
48,"48024",995,757,754,7,3,"PSE-EE (PSOE)",2
20,"20011",1658,1219,1210,7,9,"PSE-EE (PSOE)",105
48,"48060",3634,2143,2134,7,9,"PSE-EE (PSOE)",51
20,"20004",252,121,121,0,0,"PSE-EE (PSOE)",10
48,"48034",12866,8798,8747,43,51,"PSE-EE (PSOE)",2082
1,"1030",156,129,129,3,0,"PSE-EE (PSOE)",10
48,"48017",13261,8543,8482,42,61,"PSE-EE (PSOE)",404
20,"20075",4371,2692,2679,18,13,"PSE-EE (PSOE)",270
48,"48091",1121,771,765,7,6,"PSE-EE (PSOE)",52
20,"20042",3228,1967,1958,27,9,"PSE-EE (PSOE)",215
48,"48089",3306,2341,2329,20,12,"PSE-EE (PSOE)",157
20,"20059",8874,5873,5855,29,18,"PSE-EE (PSOE)",370
48,"48004",335,222,222,0,0,"PSE-EE (PSOE)",1
1,"1021",473,310,309,0,1,"PSE-EE (PSOE)",39
48,"48033",217,149,149,0,0,"PSE-EE (PSOE)",0
20,"20034",3145,2026,2014,14,12,"PSE-EE (PSOE)",287
48,"48084",22449,14670,14553,90,117,"PSE-EE (PSOE)",3181
20,"20012",147,99,98,5,1,"PSE-EE (PSOE)",2
20,"20053",4774,2973,2953,13,20,"PSE-EE (PSOE)",303
48,"48911",380,276,272,1,4,"PSE-EE (PSOE)",2
20,"20902",14156,9664,9613,74,51,"PSE-EE (PSOE)",2493
48,"48059",400,294,291,0,3,"PSE-EE (PSOE)",7
20,"20031",176,90,90,0,0,"PSE-EE (PSOE)",0
1,"1006",175,140,140,0,0,"PSE-EE (PSOE)",18
20,"20016",1520,826,821,2,5,"PSE-EE (PSOE)",20
20,"20001",246,133,132,2,1,"PSE-EE (PSOE)",3
48,"48044",62774,45594,45399,287,195,"PSE-EE (PSOE)",4130
48,"48003",14339,9918,9838,53,80,"PSE-EE (PSOE)",1012
20,"20038",387,261,259,0,2,"PSE-EE (PSOE)",5
1,"1016",433,228,226,5,2,"PSE-EE (PSOE)",16
48,"48031",332,233,231,1,2,"PSE-EE (PSOE)",1
1,"1034",161,124,123,1,1,"PSE-EE (PSOE)",20
48,"48904",3511,2625,2600,22,25,"PSE-EE (PSOE)",213
1,"1049",138,109,109,1,0,"PSE-EE (PSOE)",8
48,"48020",273626,184710,183628,1185,1082,"PSE-EE (PSOE)",26257
48,"48010",458,318,317,0,1,"PSE-EE (PSOE)",7
20,"20024",386,210,209,3,1,"PSE-EE (PSOE)",4
1,"1054",960,654,651,4,3,"PSE-EE (PSOE)",36
48,"48088",136,102,102,0,0,"PSE-EE (PSOE)",2
1,"1023",267,187,186,1,1,"PSE-EE (PSOE)",14
20,"20071",14801,9466,9421,60,45,"PSE-EE (PSOE)",798
1,"1043",2304,1552,1532,13,20,"PSE-EE (PSOE)",281
48,"48914",332,272,272,1,0,"PSE-EE (PSOE)",2
20,"20008",716,362,361,6,1,"PSE-EE (PSOE)",9
20,"20067",30828,19984,19882,140,102,"PSE-EE (PSOE)",4021
1,"1057",240,201,200,1,1,"PSE-EE (PSOE)",8
20,"20078",1155,850,846,4,4,"PSE-EE (PSOE)",29
1,"1063",1798,1269,1261,19,8,"PSE-EE (PSOE)",103
20,"20046",1223,739,737,5,2,"PSE-EE (PSOE)",42
1,"1037",587,411,408,1,3,"PSE-EE (PSOE)",33
1,"1022",799,557,544,2,13,"PSE-EE (PSOE)",122
48,"48013",79716,53419,52997,345,422,"PSE-EE (PSOE)",11186
20,"20035",486,337,334,1,3,"PSE-EE (PSOE)",8
48,"48016",5271,3694,3674,24,20,"PSE-EE (PSOE)",350
48,"48038",1126,798,794,3,4,"PSE-EE (PSOE)",19
20,"20050",266,170,169,1,1,"PSE-EE (PSOE)",1
48,"48095",2347,1555,1546,12,9,"PSE-EE (PSOE)",255
48,"48077",3364,2437,2431,18,6,"PSE-EE (PSOE)",129
48,"48027",22150,15089,14982,78,107,"PSE-EE (PSOE)",1603
48,"48908",249,181,181,0,0,"PSE-EE (PSOE)",5
48,"48054",24171,16797,16711,118,86,"PSE-EE (PSOE)",2305
20,"20060",88,67,67,2,0,"PSE-EE (PSOE)",0
20,"20079",17886,11860,11799,91,61,"PSE-EE (PSOE)",1183
48,"48064",606,447,445,4,2,"PSE-EE (PSOE)",8
48,"48006",290,239,239,2,0,"PSE-EE (PSOE)",2
48,"48901",4839,3459,3426,32,33,"PSE-EE (PSOE)",570
48,"48007",364,240,240,5,0,"PSE-EE (PSOE)",2
1,"1017",849,571,565,5,6,"PSE-EE (PSOE)",54
1,"1039",209,155,153,0,2,"PSE-EE (PSOE)",35
48,"48094",3161,2094,2073,12,21,"PSE-EE (PSOE)",91
20,"20049",4122,2677,2666,15,11,"PSE-EE (PSOE)",273
20,"20002",346,203,203,4,0,"PSE-EE (PSOE)",4
48,"48067",1158,813,810,2,3,"PSE-EE (PSOE)",14
40,"40062",60,51,48,0,3,"PSOE",9
2,"2069",11490,8470,8373,41,97,"PSOE",1742
19,"19075",64,39,39,0,0,"PSOE",5
7,"7032",20034,12824,12710,110,114,"PSOE",2747
9,"9411",151,102,101,0,1,"PSOE",26
24,"24230",426,322,320,5,2,"PSOE",70
24,"24167",750,505,499,4,6,"PSOE",125
14,"14039",2604,2062,2021,12,41,"PSOE",980
18,"18910",788,541,536,3,5,"PSOE",200
2,"2056",1718,1296,1274,6,22,"PSOE",514
16,"16194",242,185,179,1,6,"PSOE",95
5,"5104",35,28,28,0,0,"PSOE",4
31,"31178",490,345,342,3,3,"PSOE",119
22,"22173",232,152,152,3,0,"PSOE",38
5,"5054",1224,935,924,8,11,"PSOE",223
41,"41052",3013,2116,2064,14,52,"PSOE",1082
50,"50056",409,300,300,3,0,"PSOE",65
42,"42173",29281,20286,20035,261,251,"PSOE",5904
12,"12098",580,451,447,5,4,"PSOE",88
16,"16249",1995,1519,1499,6,20,"PSOE",550
9,"9078",41,30,30,1,0,"PSOE",9
49,"49032",326,259,259,1,0,"PSOE",62
14,"14048",1207,884,869,13,15,"PSOE",425
42,"42084",25,22,22,1,0,"PSOE",2
18,"18070",288,227,226,0,1,"PSOE",68
9,"9407",28,23,23,0,0,"PSOE",5
50,"50235",2339,1664,1648,11,16,"PSOE",341
40,"40233",417,314,310,3,4,"PSOE",71
37,"37259",44,28,28,0,0,"PSOE",4
40,"40139",279,202,198,1,4,"PSOE",49
12,"12114",198,144,144,1,0,"PSOE",28
47,"47125",58,46,46,0,0,"PSOE",4
26,"26028",134,113,112,0,1,"PSOE",18
31,"31125",274,194,193,6,1,"PSOE",19
6,"6023",4302,3041,3007,16,34,"PSOE",1435
49,"49260",755,590,586,8,4,"PSOE",177
10,"10032",1681,1257,1237,5,20,"PSOE",448
19,"19048",18,15,15,1,0,"PSOE",0
9,"9446",12,7,7,0,0,"PSOE",1
28,"28176",12491,9723,9667,37,56,"PSOE",1000
37,"37088",207,163,162,3,1,"PSOE",55
10,"10098",378,289,287,1,2,"PSOE",89
49,"49050",507,342,338,1,4,"PSOE",49
23,"23052",1125,936,922,4,14,"PSOE",522
49,"49222",380,279,272,0,7,"PSOE",114
5,"5256",112,100,98,1,2,"PSOE",28
37,"37290",141,113,113,0,0,"PSOE",24
44,"44042",123,91,90,0,1,"PSOE",32
13,"13024",898,633,627,3,6,"PSOE",243
19,"19050",16,15,15,0,0,"PSOE",8
18,"18189",776,581,574,4,7,"PSOE",157
24,"24091",645,454,451,1,3,"PSOE",95
10,"10173",577,400,399,5,1,"PSOE",130
28,"28102",894,644,636,6,8,"PSOE",225
45,"45066",7570,5550,5484,25,66,"PSOE",1085
42,"42048",66,51,51,0,0,"PSOE",10
47,"47195",459,345,344,4,1,"PSOE",117
2,"2055",1127,679,668,6,11,"PSOE",263
4,"4045",1757,1309,1288,6,21,"PSOE",764
41,"41023",7905,5402,5347,41,55,"PSOE",2310
50,"50014",147,94,94,0,0,"PSOE",21
24,"24187",857,603,593,7,10,"PSOE",133
16,"16100",670,564,559,0,5,"PSOE",183
5,"5155",52,44,44,0,0,"PSOE",6
5,"5122",134,102,101,0,1,"PSOE",29
44,"44235",92,62,60,0,2,"PSOE",14
5,"5239",214,164,162,3,2,"PSOE",21
6,"6054",5446,3920,3833,32,87,"PSOE",1374
45,"45055",1020,821,790,6,31,"PSOE",266
22,"22018",327,245,244,3,1,"PSOE",75
33,"33017",3144,2094,2071,35,23,"PSOE",648
28,"28068",10955,8136,8076,49,60,"PSOE",1329
44,"44111",92,69,68,0,1,"PSOE",29
42,"42052",15,13,13,0,0,"PSOE",0
5,"5114",1345,1067,1044,3,23,"PSOE",411
39,"39101",274,197,192,3,5,"PSOE",78
42,"42042",45,35,35,0,0,"PSOE",2
26,"26151",448,370,368,1,2,"PSOE",128
37,"37133",111,78,73,1,5,"PSOE",18
5,"5059",106,82,81,1,1,"PSOE",20
47,"47149",42,34,34,3,0,"PSOE",1
10,"10092",292,236,235,1,1,"PSOE",122
16,"16061",969,771,764,14,7,"PSOE",318
12,"12004",4170,3125,3088,19,37,"PSOE",671
10,"10109",1762,1149,1125,14,24,"PSOE",423
34,"34161",23,16,16,0,0,"PSOE",4
5,"5069",73,64,63,0,1,"PSOE",2
19,"19204",148,120,120,0,0,"PSOE",44
4,"4073",330,234,233,2,1,"PSOE",88
19,"19249",32,29,29,0,0,"PSOE",6
31,"31009",677,507,505,5,2,"PSOE",92
9,"9403",94,78,78,1,0,"PSOE",15
42,"42010",19,14,14,1,0,"PSOE",1
11,"11005",4583,3018,2967,25,51,"PSOE",1444
34,"34059",426,347,342,6,5,"PSOE",96
12,"12064",91,82,81,2,1,"PSOE",25
29,"29065",187,137,136,0,1,"PSOE",43
28,"28061",21389,16277,16135,67,142,"PSOE",2538
47,"47051",335,268,263,2,5,"PSOE",48
2,"2016",569,413,410,6,3,"PSOE",133
45,"45042",187,140,140,0,0,"PSOE",37
23,"23077",620,501,494,3,7,"PSOE",250
40,"40221",49,39,39,0,0,"PSOE",3
28,"28033",3899,2805,2788,7,17,"PSOE",466
19,"19148",45,32,31,0,1,"PSOE",4
3,"3113",4243,3091,3046,10,45,"PSOE",938
19,"19252",69,60,60,0,0,"PSOE",13
49,"49012",73,43,43,0,0,"PSOE",8
47,"47115",281,236,233,3,3,"PSOE",36
28,"28180",5251,3927,3893,7,34,"PSOE",1151
18,"18164",1836,1146,1126,6,20,"PSOE",360
23,"23032",566,450,448,4,2,"PSOE",297
44,"44047",220,137,132,2,5,"PSOE",25
24,"24224",616,454,451,4,3,"PSOE",119
40,"40087",92,71,70,1,1,"PSOE",6
37,"37269",447,326,324,1,2,"PSOE",93
37,"37260",150,116,116,1,0,"PSOE",34
34,"34182",786,606,597,10,9,"PSOE",185
46,"46254",1000,785,779,6,6,"PSOE",220
31,"31034",37,25,25,0,0,"PSOE",0
39,"39082",1653,1173,1157,11,16,"PSOE",196
50,"50078",235,177,173,0,4,"PSOE",76
28,"28074",138947,103687,102762,620,925,"PSOE",27135
44,"44016",482,363,360,2,3,"PSOE",105
24,"24096",117,80,79,1,1,"PSOE",20
3,"3120",2406,1753,1720,11,33,"PSOE",376
13,"13051",346,264,264,1,0,"PSOE",100
9,"9256",354,258,258,2,0,"PSOE",46
37,"37310",178,123,123,1,0,"PSOE",56
5,"5167",254,207,202,4,5,"PSOE",90
13,"13092",1846,1477,1462,5,15,"PSOE",539
13,"13057",1147,961,954,1,7,"PSOE",346
5,"5158",367,290,286,6,4,"PSOE",54
13,"13022",348,260,258,4,2,"PSOE",117
46,"46114",569,461,458,1,3,"PSOE",103
47,"47227",61,50,50,0,0,"PSOE",19
41,"41096",6161,4553,4476,32,77,"PSOE",1146
26,"26164",59,46,45,2,1,"PSOE",14
44,"44038",104,83,82,0,1,"PSOE",29
9,"9275",192,129,129,2,0,"PSOE",23
10,"10194",542,415,407,2,8,"PSOE",124
45,"45052",2948,2321,2295,16,26,"PSOE",494
45,"45159",90,75,75,0,0,"PSOE",24
40,"40054",108,90,90,0,0,"PSOE",18
16,"16264",435,366,364,2,2,"PSOE",124
37,"37365",172,134,133,1,1,"PSOE",18
31,"31904",1563,1029,1022,23,7,"PSOE",146
16,"16024",129,98,97,0,1,"PSOE",34
12,"12014",184,144,143,2,1,"PSOE",38
45,"45110",1786,1403,1398,5,5,"PSOE",616
37,"37109",183,129,127,0,2,"PSOE",24
5,"5183",138,111,110,0,1,"PSOE",15
24,"24139",2183,1548,1525,16,23,"PSOE",391
26,"26171",176,139,133,1,6,"PSOE",25
6,"6094",1485,929,926,2,3,"PSOE",551
31,"31055",257,175,172,2,3,"PSOE",10
22,"22157",192,129,128,3,1,"PSOE",50
40,"40052",74,60,60,0,0,"PSOE",18
42,"42106",14,10,10,0,0,"PSOE",0
46,"46082",4918,3745,3712,33,33,"PSOE",637
19,"19117",1579,1135,1123,8,12,"PSOE",327
24,"24222",14256,9996,9884,101,112,"PSOE",2393
47,"47031",189,145,145,1,0,"PSOE",29
31,"31241",133,98,98,2,0,"PSOE",12
40,"40225",1138,883,867,3,16,"PSOE",183
6,"6065",311,236,228,1,8,"PSOE",89
9,"9191",38,28,27,0,1,"PSOE",6
23,"23074",3021,2317,2295,11,22,"PSOE",968
45,"45202",3894,2776,2744,14,32,"PSOE",803
2,"2059",302,234,232,1,2,"PSOE",114
12,"12090",102,86,85,1,1,"PSOE",9
39,"39089",143,104,100,1,4,"PSOE",17
40,"40021",27,27,26,0,1,"PSOE",5
9,"9472",55,45,44,0,1,"PSOE",13
9,"9447",44,41,41,0,0,"PSOE",14
6,"6114",137,112,112,0,0,"PSOE",70
40,"40053",83,66,65,0,1,"PSOE",21
49,"49264",578,383,377,5,6,"PSOE",66
10,"10197",123,90,89,0,1,"PSOE",27
24,"24165",354,240,238,2,2,"PSOE",53
6,"6098",549,385,381,7,4,"PSOE",193
34,"34178",117,103,103,0,0,"PSOE",12
33,"33011",11260,6250,6163,83,87,"PSOE",1441
44,"44264",248,191,189,1,2,"PSOE",60
34,"34185",63,38,37,2,1,"PSOE",7
13,"13062",574,453,448,3,5,"PSOE",161
28,"28051",1541,1163,1149,1,14,"PSOE",222
19,"19022",625,476,469,3,7,"PSOE",75
47,"47143",118,91,90,0,1,"PSOE",13
12,"12128",1393,1090,1072,10,18,"PSOE",267
9,"9422",17,11,11,0,0,"PSOE",0
44,"44107",218,152,152,5,0,"PSOE",49
44,"44223",72,54,54,0,0,"PSOE",8
16,"16274",121,92,92,0,0,"PSOE",41
50,"50193",651,514,501,2,13,"PSOE",106
21,"21009",857,532,523,4,9,"PSOE",226
10,"10034",353,260,257,2,3,"PSOE",107
40,"40076",6492,4768,4700,26,68,"PSOE",929
19,"19095",12,9,9,0,0,"PSOE",1
49,"49231",330,232,232,2,0,"PSOE",45
28,"28160",8256,6102,6059,31,43,"PSOE",865
14,"14015",2125,1579,1554,10,25,"PSOE",562
12,"12037",17,16,14,0,2,"PSOE",5
22,"22135",189,128,127,0,1,"PSOE",25
34,"34211",178,155,152,1,3,"PSOE",21
16,"16188",91,65,65,0,0,"PSOE",20
42,"42011",18,10,10,1,0,"PSOE",0
14,"14074",2299,1896,1866,16,30,"PSOE",920
37,"37119",107,84,82,0,2,"PSOE",28
42,"42063",49,35,35,0,0,"PSOE",10
31,"31145",172,128,128,4,0,"PSOE",22
40,"40222",168,145,144,0,1,"PSOE",40
2,"2018",829,661,653,1,8,"PSOE",227
5,"5133",66,53,53,0,0,"PSOE",13
9,"9200",50,32,31,0,1,"PSOE",8
23,"23064",1655,1363,1353,1,10,"PSOE",605
26,"26045",12,12,12,0,0,"PSOE",7
6,"6066",1762,1189,1182,2,7,"PSOE",661
44,"44014",2521,1896,1867,8,29,"PSOE",532
9,"9386",54,39,38,1,1,"PSOE",1
13,"13028",10418,8075,7976,52,99,"PSOE",2212
9,"9467",64,43,42,1,1,"PSOE",7
6,"6126",2170,1523,1507,1,16,"PSOE",726
19,"19078",50,44,43,0,1,"PSOE",27
49,"49270",133,99,99,1,0,"PSOE",31
29,"29038",17676,11056,10970,141,86,"PSOE",3544
41,"41011",15401,10170,9986,111,184,"PSOE",4817
19,"19213",70,62,61,2,1,"PSOE",18
12,"12101",358,279,275,3,4,"PSOE",56
31,"31130",312,214,213,3,1,"PSOE",17
9,"9908",449,307,306,3,1,"PSOE",49
5,"5126",70,56,55,0,1,"PSOE",9
47,"47011",565,461,458,5,3,"PSOE",105
12,"12091",177,113,112,0,1,"PSOE",21
34,"34023",5236,3685,3636,30,49,"PSOE",1054
31,"31062",1087,830,818,3,12,"PSOE",298
19,"19321",39,30,30,1,0,"PSOE",14
6,"6144",556,431,425,0,6,"PSOE",209
44,"44182",197,157,157,0,0,"PSOE",45
22,"22077",379,279,273,2,6,"PSOE",104
5,"5142",99,88,85,0,3,"PSOE",17
12,"12058",71,63,62,1,1,"PSOE",6
31,"31057",1781,1287,1268,10,19,"PSOE",398
42,"42184",57,43,43,0,0,"PSOE",10
9,"9060",145,114,113,2,1,"PSOE",21
5,"5062",179,148,147,0,1,"PSOE",14
9,"9455",45,33,33,0,0,"PSOE",5
24,"24089",102747,74428,73688,631,740,"PSOE",17207
31,"31059",186,131,131,1,0,"PSOE",22
31,"31039",80,61,60,0,1,"PSOE",12
31,"31149",2305,1461,1441,8,20,"PSOE",92
47,"47123",466,354,352,4,2,"PSOE",65
6,"6012",3267,2300,2277,15,23,"PSOE",1018
31,"31251",3115,2240,2205,15,35,"PSOE",480
37,"37372",144,111,108,0,3,"PSOE",38
44,"44210",746,554,545,3,9,"PSOE",183
12,"12085",4976,3236,3209,16,27,"PSOE",618
26,"26114",79,66,65,1,1,"PSOE",21
50,"50048",34,29,29,0,0,"PSOE",12
18,"18049",595,459,452,3,7,"PSOE",178
16,"16193",66,49,48,0,1,"PSOE",27
9,"9454",43,34,33,0,1,"PSOE",5
44,"44147",412,298,293,5,5,"PSOE",71
39,"39063",967,697,690,9,7,"PSOE",160
34,"34216",66,50,50,0,0,"PSOE",2
3,"3110",291,241,241,1,0,"PSOE",32
26,"26111",242,180,176,0,4,"PSOE",61
11,"11004",88783,51500,51015,513,485,"PSOE",13648
22,"22044",252,198,197,0,1,"PSOE",53
2,"2002",470,394,389,3,5,"PSOE",149
6,"6109",3919,3139,3012,24,127,"PSOE",1397
26,"26087",201,153,149,3,4,"PSOE",21
12,"12104",6933,5411,5342,25,69,"PSOE",1189
50,"50084",77,59,59,2,0,"PSOE",14
34,"34902",139,106,106,0,0,"PSOE",16
11,"11003",1261,836,822,7,14,"PSOE",369
39,"39047",1962,1385,1371,10,14,"PSOE",279
40,"40173",138,99,93,1,6,"PSOE",11
39,"39098",1402,1046,1036,8,10,"PSOE",158
5,"5228",174,121,120,0,1,"PSOE",6
47,"47113",159,129,128,0,1,"PSOE",44
47,"47175",6564,4781,4728,39,53,"PSOE",1258
41,"41049",9299,6896,6771,98,125,"PSOE",2669
37,"37256",218,156,152,1,4,"PSOE",44
18,"18147",3729,2335,2304,16,31,"PSOE",847
50,"50075",80,62,61,1,1,"PSOE",11
18,"18193",14343,9951,9847,93,104,"PSOE",2531
19,"19299",97,79,77,1,2,"PSOE",26
5,"5164",26,14,14,0,0,"PSOE",4
19,"19138",255,202,201,2,1,"PSOE",65
46,"46075",150,130,123,1,7,"PSOE",35
4,"4064",2771,2001,1988,13,13,"PSOE",399
10,"10019",1498,1063,1054,3,9,"PSOE",275
19,"19130",60145,45531,45085,286,446,"PSOE",9852
31,"31261",231,173,169,3,4,"PSOE",31
37,"37337",139,124,124,0,0,"PSOE",7
10,"10096",3408,2440,2391,12,49,"PSOE",932
9,"9181",300,221,221,0,0,"PSOE",24
16,"16118",1375,1106,1086,13,20,"PSOE",259
29,"29079",2416,1788,1764,10,24,"PSOE",823
33,"33057",1593,1063,1049,16,14,"PSOE",344
47,"47111",1020,742,732,7,10,"PSOE",236
44,"44222",131,98,98,0,0,"PSOE",24
31,"31033",49,31,31,1,0,"PSOE",2
6,"6160",3153,2176,2146,16,30,"PSOE",907
44,"44154",256,192,188,3,4,"PSOE",24
5,"5103",72,52,52,0,0,"PSOE",7
10,"10219",1276,796,790,7,6,"PSOE",283
49,"49131",264,194,192,6,2,"PSOE",49
46,"46189",467,393,390,2,3,"PSOE",106
37,"37263",342,237,229,0,8,"PSOE",63
21,"21011",3453,2441,2419,15,22,"PSOE",1143
28,"28062",292,231,226,1,5,"PSOE",26
19,"19036",263,229,229,0,0,"PSOE",64
21,"21050",12427,8036,7969,80,67,"PSOE",3015
12,"12018",287,246,242,1,4,"PSOE",77
24,"24183",805,555,549,6,6,"PSOE",148
37,"37362",4632,3389,3351,25,38,"PSOE",476
29,"29046",2675,1825,1807,14,18,"PSOE",816
31,"31138",932,601,599,2,2,"PSOE",46
19,"19080",65,41,41,0,0,"PSOE",8
2,"2061",637,516,511,4,5,"PSOE",156
16,"16191",899,675,671,2,4,"PSOE",234
34,"34108",542,421,417,3,4,"PSOE",151
37,"37019",150,123,120,0,3,"PSOE",8
5,"5089",485,384,376,0,8,"PSOE",69
30,"30023",3780,2874,2850,12,24,"PSOE",640
49,"49242",447,360,357,5,3,"PSOE",84
5,"5010",152,117,116,1,1,"PSOE",23
9,"9218",369,275,275,1,0,"PSOE",74
5,"5041",1001,775,762,8,13,"PSOE",90
50,"50111",180,143,143,0,0,"PSOE",30
6,"6148",966,691,678,8,13,"PSOE",322
37,"37346",273,212,211,1,1,"PSOE",35
34,"34155",129,104,103,2,1,"PSOE",47
4,"4023",138,96,95,2,1,"PSOE",25
40,"40100",270,213,211,2,2,"PSOE",26
19,"19082",85,64,64,0,0,"PSOE",20
31,"31073",294,212,208,2,4,"PSOE",17
24,"24068",457,344,340,0,4,"PSOE",161
23,"23082",1921,1425,1416,8,9,"PSOE",595
50,"50018",953,656,655,1,1,"PSOE",289
22,"22130",10092,6671,6608,59,63,"PSOE",1627
49,"49255",418,319,316,1,3,"PSOE",57
47,"47180",73,61,60,4,1,"PSOE",11
10,"10071",139,96,94,0,2,"PSOE",37
42,"42045",301,206,197,2,9,"PSOE",47
31,"31107",1710,1255,1243,16,12,"PSOE",236
40,"40143",86,75,74,0,1,"PSOE",16
5,"5141",94,80,80,1,0,"PSOE",15
47,"47209",41,34,34,0,0,"PSOE",4
37,"37170",1449,994,971,3,23,"PSOE",191
45,"45128",2502,1680,1668,6,12,"PSOE",545
37,"37008",4266,3216,3197,19,19,"PSOE",657
7,"7041",2044,1486,1451,13,35,"PSOE",218
10,"10057",143,117,117,1,0,"PSOE",66
21,"21066",498,392,389,3,3,"PSOE",236
50,"50240",1025,729,718,10,11,"PSOE",261
37,"37185",591,423,417,2,6,"PSOE",61
47,"47073",122,103,101,1,2,"PSOE",22
19,"19261",37,25,24,0,1,"PSOE",4
12,"12070",522,406,401,0,5,"PSOE",124
2,"2084",323,231,225,0,6,"PSOE",68
41,"41046",3023,2213,2183,5,30,"PSOE",925
16,"16172",325,268,267,1,1,"PSOE",92
37,"37186",104,85,85,2,0,"PSOE",11
2,"2053",2998,2231,2189,16,42,"PSOE",835
5,"5036",123,101,101,1,0,"PSOE",9
9,"9152",257,183,183,0,0,"PSOE",43
22,"22053",789,520,513,9,7,"PSOE",155
30,"30007",6411,4360,4329,24,31,"PSOE",979
47,"47103",267,197,192,5,5,"PSOE",64
28,"28066",7182,5422,5371,17,51,"PSOE",654
45,"45049",433,305,304,1,1,"PSOE",76
49,"49220",135,110,109,0,1,"PSOE",48
45,"45023",2177,1571,1556,6,15,"PSOE",369
14,"14013",16796,11830,11616,129,214,"PSOE",3544
14,"14038",32322,22117,21887,179,230,"PSOE",6244
5,"5145",50,40,40,0,0,"PSOE",8
10,"10030",465,309,309,1,0,"PSOE",111
6,"6139",553,420,419,1,1,"PSOE",196
46,"46124",787,653,642,4,11,"PSOE",108
14,"14075",572,448,428,1,20,"PSOE",215
39,"39087",41985,31178,30805,228,373,"PSOE",9174
3,"3047",9207,6309,6226,25,83,"PSOE",1398
2,"2082",101,80,80,1,0,"PSOE",26
6,"6110",148,108,108,1,0,"PSOE",48
7,"7005",6710,4127,4090,25,37,"PSOE",964
31,"31245",81,55,55,2,0,"PSOE",1
9,"9375",36,31,31,0,0,"PSOE",4
19,"19302",59,49,49,1,0,"PSOE",15
22,"22223",75,58,58,0,0,"PSOE",19
12,"12124",1840,1387,1381,33,6,"PSOE",270
16,"16253",337,264,263,2,1,"PSOE",52
24,"24209",2769,1888,1865,12,23,"PSOE",572
7,"7046",15797,9127,9043,86,84,"PSOE",2270
9,"9059",136488,101469,100463,907,1006,"PSOE",21486
4,"4083",1776,1345,1336,6,9,"PSOE",610
9,"9063",209,168,167,2,1,"PSOE",16
6,"6156",1175,869,865,8,4,"PSOE",356
46,"46195",1962,1531,1516,11,15,"PSOE",388
31,"31012",793,563,555,6,8,"PSOE",126
22,"22225",2679,1700,1665,17,35,"PSOE",353
5,"5262",357,276,276,1,0,"PSOE",88
22,"22212",79,64,62,0,2,"PSOE",26
44,"44025",6009,4087,3997,25,90,"PSOE",1340
9,"9051",170,130,128,0,2,"PSOE",18
37,"37275",118,70,69,0,1,"PSOE",27
39,"39056",2286,1714,1684,8,30,"PSOE",378
23,"23038",3587,2794,2770,16,24,"PSOE",738
37,"37307",159,104,103,1,1,"PSOE",19
40,"40043",1802,1400,1381,8,19,"PSOE",303
24,"24118",126,88,88,1,0,"PSOE",47
37,"37261",221,163,160,1,3,"PSOE",30
22,"22186",181,130,129,1,1,"PSOE",52
2,"2050",98,83,82,0,1,"PSOE",20
26,"26081",16,14,14,0,0,"PSOE",1
19,"19038",28,24,23,0,1,"PSOE",2
21,"21063",2615,2001,1957,22,44,"PSOE",1220
10,"10004",704,492,482,9,10,"PSOE",213
40,"40193",229,174,172,3,2,"PSOE",45
45,"45001",1835,1281,1251,3,30,"PSOE",407
10,"10112",1571,1107,1081,9,26,"PSOE",411
37,"37360",225,174,173,1,1,"PSOE",42
10,"10065",206,156,155,1,1,"PSOE",69
45,"45135",4269,3340,3288,8,52,"PSOE",898
50,"50025",4562,3158,3124,31,34,"PSOE",826
50,"50045",1243,926,925,6,1,"PSOE",237
22,"22096",301,240,240,0,0,"PSOE",45
19,"19109",39,32,32,0,0,"PSOE",1
40,"40181",4233,3260,3219,23,41,"PSOE",912
45,"45003",562,408,402,1,6,"PSOE",108
31,"31104",1834,1257,1235,16,22,"PSOE",321
34,"34092",288,230,226,1,4,"PSOE",64
42,"42004",2285,1757,1737,15,20,"PSOE",406
18,"18136",1851,1354,1337,5,17,"PSOE",732
19,"19174",109,80,79,0,1,"PSOE",13
22,"22158",11995,8197,8126,62,71,"PSOE",2202
49,"49158",215,170,166,2,4,"PSOE",56
26,"26035",17,12,11,0,1,"PSOE",6
9,"9138",85,72,70,0,2,"PSOE",13
31,"31238",112,93,93,0,0,"PSOE",18
6,"6116",1587,1171,1160,10,11,"PSOE",501
16,"16027",710,542,538,5,4,"PSOE",189
9,"9902",458,331,327,3,4,"PSOE",70
50,"50277",50,42,41,0,1,"PSOE",2
29,"29096",2810,1944,1909,31,35,"PSOE",901
22,"22907",1435,1059,1046,18,13,"PSOE",250
24,"24218",451,330,325,2,5,"PSOE",63
26,"26099",1264,1003,991,9,12,"PSOE",305
37,"37230",221,159,159,2,0,"PSOE",47
5,"5057",2465,1969,1953,15,16,"PSOE",777
21,"21053",3316,2141,2107,17,34,"PSOE",942
9,"9323",61,46,46,1,0,"PSOE",4
42,"42096",272,171,170,6,1,"PSOE",26
22,"22020",115,86,86,1,0,"PSOE",18
19,"19308",56,53,53,0,0,"PSOE",22
16,"16901",675,506,501,6,5,"PSOE",126
30,"30031",492,409,401,0,8,"PSOE",70
39,"39083",1135,679,670,8,9,"PSOE",205
46,"46043",136,124,124,0,0,"PSOE",17
2,"2064",372,325,324,1,1,"PSOE",142
14,"14045",3052,2362,2335,11,27,"PSOE",1290
26,"26027",157,112,108,0,4,"PSOE",30
49,"49187",1236,896,888,4,8,"PSOE",227
9,"9231",69,38,38,1,0,"PSOE",9
47,"47027",2745,2036,2018,9,18,"PSOE",524
4,"4024",3074,2347,2327,20,20,"PSOE",744
37,"37115",123,89,87,0,2,"PSOE",11
50,"50217",446,342,342,1,0,"PSOE",158
37,"37296",336,259,254,2,5,"PSOE",110
33,"33061",378,202,200,0,2,"PSOE",74
46,"46131",49431,36570,36227,231,343,"PSOE",7024
19,"19166",156,120,119,1,1,"PSOE",20
5,"5109",450,352,339,4,13,"PSOE",85
19,"19310",9,7,7,0,0,"PSOE",2
44,"44136",49,43,43,1,0,"PSOE",10
31,"31019",1785,1254,1238,9,16,"PSOE",141
40,"40199",105,84,84,0,0,"PSOE",11
50,"50280",332,253,250,0,3,"PSOE",80
37,"37116",69,50,50,0,0,"PSOE",6
10,"10119",620,460,452,1,8,"PSOE",200
47,"47199",80,63,63,0,0,"PSOE",15
50,"50061",202,172,172,3,0,"PSOE",64
5,"5095",262,225,223,1,2,"PSOE",55
12,"12024",143,125,124,0,1,"PSOE",39
5,"5175",159,131,131,1,0,"PSOE",15
28,"28075",5621,4186,4148,26,38,"PSOE",755
28,"28137",1664,1232,1220,7,12,"PSOE",251
9,"9249",46,33,33,0,0,"PSOE",9
37,"37205",231,189,182,0,7,"PSOE",62
46,"46028",387,330,328,3,2,"PSOE",61
39,"39096",690,487,479,4,8,"PSOE",110
40,"40119",169,138,133,1,5,"PSOE",14
31,"31216",3865,2702,2671,33,31,"PSOE",509
24,"24215",152,113,113,0,0,"PSOE",13
9,"9266",91,74,74,0,0,"PSOE",28
37,"37132",351,256,253,2,3,"PSOE",86
49,"49248",186,151,150,1,1,"PSOE",45
6,"6063",3015,2268,2246,16,22,"PSOE",1090
45,"45054",3959,2882,2848,12,34,"PSOE",752
49,"49031",148,120,119,6,1,"PSOE",29
16,"16128",63,50,50,0,0,"PSOE",16
19,"19126",1627,1155,1134,11,21,"PSOE",185
10,"10076",832,556,541,1,15,"PSOE",236
31,"31088",5572,3897,3862,44,35,"PSOE",664
22,"22090",99,71,71,0,0,"PSOE",20
6,"6003",823,627,616,1,11,"PSOE",272
24,"24182",416,294,290,2,4,"PSOE",62
37,"37285",403,310,308,2,2,"PSOE",77
9,"9431",118,98,98,0,0,"PSOE",17
16,"16238",501,428,422,3,6,"PSOE",165
9,"9149",35,24,24,2,0,"PSOE",4
19,"19156",970,704,699,4,5,"PSOE",174
31,"31100",262,170,168,1,2,"PSOE",8
13,"13054",4944,3729,3678,27,51,"PSOE",969
5,"5065",471,394,392,4,2,"PSOE",50
31,"31122",4773,3520,3506,26,14,"PSOE",424
33,"33045",4487,3057,2999,28,58,"PSOE",952
5,"5261",41,26,26,0,0,"PSOE",3
37,"37147",193,134,132,1,2,"PSOE",37
11,"11027",67913,45219,44833,454,386,"PSOE",9382
50,"50192",236,180,180,2,0,"PSOE",63
42,"42064",86,68,68,0,0,"PSOE",27
22,"22236",253,200,200,0,0,"PSOE",68
31,"31024",99,42,42,0,0,"PSOE",0
45,"45078",1379,1129,1119,6,10,"PSOE",377
37,"37058",58,45,45,0,0,"PSOE",11
37,"37354",5240,3823,3771,39,52,"PSOE",682
47,"47132",45,36,33,1,3,"PSOE",3
34,"34069",2266,1666,1637,11,29,"PSOE",514
23,"23076",827,640,630,1,10,"PSOE",276
19,"19230",505,360,357,3,3,"PSOE",66
19,"19037",141,115,114,1,1,"PSOE",25
19,"19092",409,306,300,1,6,"PSOE",74
31,"31157",3518,2298,2267,23,31,"PSOE",569
9,"9348",148,111,110,2,1,"PSOE",28
39,"39009",3216,2366,2337,17,29,"PSOE",542
39,"39100",860,633,629,15,4,"PSOE",115
37,"37136",652,440,435,3,5,"PSOE",154
45,"45068",160,126,126,0,0,"PSOE",56
45,"45046",2412,1667,1654,7,13,"PSOE",604
44,"44144",346,248,245,2,3,"PSOE",102
9,"9077",34,27,27,0,0,"PSOE",5
14,"14004",2034,1531,1518,14,13,"PSOE",629
13,"13058",4100,2986,2954,25,32,"PSOE",1062
10,"10035",1920,1343,1315,5,28,"PSOE",620
29,"29056",1098,757,750,5,7,"PSOE",299
6,"6099",1145,655,638,6,17,"PSOE",313
22,"22242",62,45,44,0,1,"PSOE",12
28,"28089",3677,2748,2730,10,18,"PSOE",444
4,"4021",185,151,148,1,3,"PSOE",54
16,"16134",4371,3288,3254,20,34,"PSOE",820
42,"42069",1536,1036,1019,6,17,"PSOE",263
39,"39081",437,337,332,4,5,"PSOE",37
39,"39031",1236,878,868,4,10,"PSOE",144
3,"3081",1436,1084,1075,5,9,"PSOE",191
31,"31260",1238,794,788,12,6,"PSOE",84
49,"49185",157,123,122,2,1,"PSOE",26
12,"12077",4605,3439,3382,15,57,"PSOE",843
19,"19282",163,124,123,0,1,"PSOE",12
19,"19040",52,41,39,0,2,"PSOE",15
47,"47161",3918,3145,3126,12,19,"PSOE",421
3,"3042",1393,1010,996,7,14,"PSOE",182
7,"7065",2083,1346,1328,9,18,"PSOE",154
11,"11031",76455,49854,49405,535,449,"PSOE",12099
9,"9258",172,141,139,5,2,"PSOE",27
6,"6102",1048,843,825,6,18,"PSOE",382
31,"31146",35,30,29,1,1,"PSOE",5
21,"21017",3600,2187,2164,26,23,"PSOE",1110
42,"42148",10,10,10,1,0,"PSOE",1
22,"22245",309,267,261,1,6,"PSOE",51
41,"41054",692,560,546,3,14,"PSOE",256
18,"18182",1906,1298,1288,4,10,"PSOE",624
37,"37336",52,50,50,1,0,"PSOE",11
9,"9903",3221,2304,2281,27,23,"PSOE",489
19,"19283",30,25,25,0,0,"PSOE",11
18,"18002",553,395,393,1,2,"PSOE",247
4,"4098",1516,1115,1106,11,9,"PSOE",492
28,"28122",513,375,370,2,5,"PSOE",85
49,"49110",348,231,229,0,2,"PSOE",59
44,"44236",63,48,47,0,1,"PSOE",4
19,"19070",74,53,53,0,0,"PSOE",13
14,"14073",2891,2079,2016,13,63,"PSOE",979
31,"31240",527,327,326,2,1,"PSOE",15
46,"46095",610,467,459,1,8,"PSOE",112
45,"45901",771,547,544,3,3,"PSOE",152
47,"47146",255,206,204,1,2,"PSOE",62
39,"39043",1481,1122,1115,9,7,"PSOE",127
26,"26049",172,125,122,1,3,"PSOE",14
50,"50070",60,36,36,0,0,"PSOE",20
34,"34052",174,135,133,0,2,"PSOE",14
40,"40086",685,561,552,4,9,"PSOE",127
16,"16140",27,16,16,0,0,"PSOE",8
4,"4004",425,329,329,0,0,"PSOE",136
28,"28123",57078,45270,44992,215,278,"PSOE",8471
21,"21043",1871,1310,1285,9,25,"PSOE",680
26,"26120",1454,1139,1126,7,13,"PSOE",307
37,"37380",56,47,45,0,2,"PSOE",14
34,"34246",67,53,51,0,2,"PSOE",13
37,"37379",174,133,131,1,2,"PSOE",45
9,"9906",1219,902,898,8,4,"PSOE",165
18,"18005",372,262,258,0,4,"PSOE",157
13,"13065",2854,1901,1888,9,13,"PSOE",551
4,"4070",1584,1184,1179,3,5,"PSOE",445
24,"24217",135,109,108,1,1,"PSOE",29
9,"9235",156,132,131,3,1,"PSOE",34
44,"44116",83,60,60,1,0,"PSOE",9
47,"47064",33,28,25,0,3,"PSOE",2
12,"12126",24464,18533,18331,113,202,"PSOE",4057
3,"3053",7226,5651,5584,32,67,"PSOE",879
6,"6092",577,415,405,3,10,"PSOE",182
44,"44022",493,323,318,7,5,"PSOE",87
16,"16271",633,517,516,4,1,"PSOE",134
3,"3097",993,822,812,6,10,"PSOE",136
44,"44011",52,40,38,0,2,"PSOE",8
9,"9086",666,462,459,2,3,"PSOE",61
19,"19216",131,98,98,0,0,"PSOE",20
12,"12082",9617,7324,7231,46,93,"PSOE",1527
47,"47021",76,64,64,0,0,"PSOE",8
46,"46063",1756,1367,1345,15,22,"PSOE",292
47,"47013",100,82,81,1,1,"PSOE",38
49,"49249",69,58,58,1,0,"PSOE",3
18,"18007",781,521,512,5,9,"PSOE",287
12,"12060",446,368,364,4,4,"PSOE",62
5,"5129",125,88,87,2,1,"PSOE",1
30,"30902",7975,5318,5273,24,45,"PSOE",1164
5,"5147",159,128,124,5,4,"PSOE",11
26,"26020",476,349,339,3,10,"PSOE",78
42,"42080",157,117,115,0,2,"PSOE",29
44,"44252",86,65,65,0,0,"PSOE",7
34,"34102",205,169,168,1,1,"PSOE",28
44,"44118",164,132,131,2,1,"PSOE",40
49,"49102",196,143,139,2,4,"PSOE",38
12,"12061",373,285,282,3,3,"PSOE",90
23,"23088",6089,4558,4472,34,86,"PSOE",1671
28,"28127",64827,51776,51613,220,163,"PSOE",6235
28,"28031",2048,1500,1486,3,14,"PSOE",443
28,"28147",963,722,720,5,2,"PSOE",193
40,"40077",842,632,619,3,13,"PSOE",100
4,"4103",1476,1018,1008,3,10,"PSOE",375
18,"18100",7807,5452,5398,50,54,"PSOE",2443
49,"49208",394,248,244,2,4,"PSOE",26
24,"24164",370,218,217,0,1,"PSOE",51
40,"40178",98,73,71,1,2,"PSOE",7
30,"30016",151668,102093,101363,484,730,"PSOE",19085
28,"28003",173,141,141,0,0,"PSOE",39
46,"46097",963,733,728,4,5,"PSOE",144
37,"37200",187,136,136,0,0,"PSOE",48
44,"44056",501,345,342,2,3,"PSOE",69
34,"34122",83,60,60,0,0,"PSOE",18
18,"18178",719,549,544,4,5,"PSOE",255
26,"26077",22,22,21,1,1,"PSOE",4
10,"10049",3819,3031,2950,18,81,"PSOE",1242
39,"39049",322,229,229,0,0,"PSOE",71
46,"46118",3763,2940,2908,16,32,"PSOE",871
42,"42083",26,20,20,0,0,"PSOE",2
40,"40220",66,50,46,1,4,"PSOE",7
26,"26023",469,358,354,0,4,"PSOE",103
28,"28149",5759,4352,4310,25,42,"PSOE",693
16,"16101",154,132,132,0,0,"PSOE",52
46,"46066",1263,1024,1018,9,6,"PSOE",254
14,"14069",7524,5460,5392,43,68,"PSOE",2418
45,"45157",2128,1456,1427,13,29,"PSOE",234
42,"42041",34,25,25,0,0,"PSOE",5
34,"34156",50,45,45,0,0,"PSOE",4
31,"31037",84,66,66,1,0,"PSOE",2
24,"24199",424,302,301,0,1,"PSOE",80
10,"10005",540,377,362,3,15,"PSOE",143
24,"24064",1523,1101,1087,3,14,"PSOE",350
5,"5134",48,38,38,0,0,"PSOE",8
46,"46067",1753,1418,1393,1,25,"PSOE",332
47,"47069",124,105,104,1,1,"PSOE",34
45,"45024",1062,793,785,4,8,"PSOE",214
9,"9448",212,169,165,0,4,"PSOE",17
28,"28005",134246,99236,98481,583,755,"PSOE",22498
37,"37125",228,161,156,0,5,"PSOE",34
7,"7064",5315,3475,3434,31,41,"PSOE",695
9,"9901",371,263,259,4,4,"PSOE",43
2,"2048",1226,981,975,7,6,"PSOE",327
44,"44156",45,31,31,1,0,"PSOE",2
26,"26165",358,304,299,2,5,"PSOE",96
42,"42043",3791,2727,2682,25,45,"PSOE",475
42,"42085",189,129,127,3,2,"PSOE",21
6,"6162",2934,2182,2162,14,20,"PSOE",855
26,"26058",154,116,115,0,1,"PSOE",17
41,"41076",2183,1341,1327,19,14,"PSOE",546
41,"41083",1147,864,856,4,8,"PSOE",467
47,"47023",2995,2344,2326,18,18,"PSOE",377
9,"9003",194,147,146,0,1,"PSOE",39
46,"46112",536,455,450,2,5,"PSOE",110
22,"22204",1114,745,739,12,6,"PSOE",102
24,"24133",356,257,257,1,0,"PSOE",59
5,"5156",256,160,159,1,1,"PSOE",23
19,"19187",48,43,43,0,0,"PSOE",13
3,"3063",26462,18591,18492,91,99,"PSOE",4187
24,"24168",460,361,359,0,2,"PSOE",106
37,"37350",420,318,314,5,4,"PSOE",26
18,"18152",944,707,703,0,4,"PSOE",488
22,"22218",43,33,33,0,0,"PSOE",11
39,"39023",6330,4737,4672,25,65,"PSOE",1503
47,"47163",290,230,228,3,2,"PSOE",79
40,"40198",24,19,19,0,0,"PSOE",3
47,"47019",85,74,73,0,1,"PSOE",11
37,"37323",516,376,372,5,4,"PSOE",76
44,"44181",76,57,56,0,1,"PSOE",12
6,"6028",4233,3588,3499,30,89,"PSOE",1508
47,"47098",576,464,452,4,12,"PSOE",86
29,"29094",57554,38071,37696,339,375,"PSOE",10692
50,"50177",308,245,244,4,1,"PSOE",68
44,"44158",1180,876,862,10,14,"PSOE",218
12,"12131",63,52,52,0,0,"PSOE",8
47,"47128",60,52,51,0,1,"PSOE",0
19,"19260",42,39,39,1,0,"PSOE",19
3,"3064",5015,3660,3611,11,49,"PSOE",854
3,"3034",1376,1067,1052,5,15,"PSOE",241
9,"9372",212,176,176,4,0,"PSOE",26
10,"10149",421,283,280,1,3,"PSOE",96
49,"49136",318,220,218,1,2,"PSOE",28
37,"37143",389,301,300,6,1,"PSOE",82
46,"46070",16950,12765,12676,61,89,"PSOE",1880
28,"28104",14040,11151,11096,57,55,"PSOE",1513
50,"50081",511,382,378,4,4,"PSOE",119
31,"31042",2714,1974,1942,22,32,"PSOE",810
50,"50040",89,75,75,0,0,"PSOE",20
2,"2066",234,189,187,1,2,"PSOE",80
12,"12102",522,423,418,1,5,"PSOE",163
50,"50147",777,552,552,2,0,"PSOE",194
33,"33062",400,238,233,2,5,"PSOE",94
23,"23071",1715,1290,1278,7,12,"PSOE",524
45,"45064",3858,2804,2763,20,41,"PSOE",610
16,"16234",25,18,18,0,0,"PSOE",12
2,"2067",1158,858,847,6,11,"PSOE",297
10,"10166",308,206,204,0,2,"PSOE",51
19,"19125",41,32,32,0,0,"PSOE",4
29,"29097",4108,2871,2821,37,50,"PSOE",1349
9,"9374",90,71,70,1,1,"PSOE",13
47,"47165",6955,4955,4303,66,652,"PSOE",599
6,"6154",2802,1923,1894,23,29,"PSOE",765
4,"4091",334,268,267,6,1,"PSOE",160
19,"19168",292,204,198,1,6,"PSOE",59
46,"46150",1831,1341,1333,7,8,"PSOE",357
37,"37055",123,98,94,0,4,"PSOE",20
42,"42050",31,18,18,0,0,"PSOE",1
47,"47157",515,424,423,1,1,"PSOE",127
21,"21019",612,400,391,2,9,"PSOE",193
28,"28156",1019,742,738,3,4,"PSOE",140
31,"31044",289,230,227,1,3,"PSOE",8
23,"23035",1106,873,855,1,18,"PSOE",414
34,"34221",179,144,144,3,0,"PSOE",41
29,"29098",1253,917,895,9,22,"PSOE",430
41,"41059",34165,24949,24709,196,240,"PSOE",6515
49,"49263",51,36,36,0,0,"PSOE",2
47,"47022",59,50,49,0,1,"PSOE",2
33,"33024",226679,158750,157564,1209,1186,"PSOE",37722
30,"30026",15734,10007,9901,51,106,"PSOE",2212
16,"16273",321,242,236,3,6,"PSOE",33
3,"3068",47,44,44,0,0,"PSOE",4
39,"39088",69,52,52,0,0,"PSOE",28
47,"47102",291,230,220,1,10,"PSOE",70
2,"2003",132346,95878,95217,630,661,"PSOE",20846
22,"22906",186,141,139,3,2,"PSOE",53
19,"19193",20,19,19,1,0,"PSOE",9
24,"24106",248,167,166,1,1,"PSOE",39
45,"45133",2797,2068,2048,13,20,"PSOE",647
19,"19157",55,46,46,0,0,"PSOE",12
13,"13037",842,661,652,1,9,"PSOE",249
4,"4901",545,395,394,0,1,"PSOE",167
24,"24107",236,175,173,0,2,"PSOE",67
37,"37177",289,220,219,2,1,"PSOE",41
23,"23903",3540,2662,2634,13,28,"PSOE",1120
5,"5101",292,240,236,1,4,"PSOE",40
40,"40108",112,82,82,0,0,"PSOE",18
10,"10202",606,473,463,4,10,"PSOE",198
24,"24009",322,153,152,2,1,"PSOE",31
40,"40063",7096,5184,5100,36,84,"PSOE",1108
31,"31212",147,102,102,4,0,"PSOE",14
42,"42053",26,19,19,1,0,"PSOE",0
49,"49143",225,163,162,0,1,"PSOE",25
44,"44165",175,135,133,2,2,"PSOE",33
2,"2045",3665,2895,2855,21,40,"PSOE",712
18,"18027",2570,1711,1700,13,11,"PSOE",734
31,"31180",212,154,154,5,0,"PSOE",17
39,"39060",6679,5196,5121,29,75,"PSOE",1380
22,"22139",79,64,64,1,0,"PSOE",5
33,"33067",784,587,579,9,8,"PSOE",232
49,"49023",967,673,662,10,11,"PSOE",124
9,"9065",143,122,122,1,0,"PSOE",28
7,"7009",738,521,510,12,11,"PSOE",106
44,"44200",39,26,26,0,0,"PSOE",3
6,"6038",805,543,541,2,2,"PSOE",261
37,"37003",115,93,93,0,0,"PSOE",23
3,"3102",7229,5492,5414,52,78,"PSOE",1142
37,"37319",114,78,74,0,4,"PSOE",17
46,"46171",16563,12213,12128,85,85,"PSOE",2660
9,"9243",76,59,57,1,2,"PSOE",15
22,"22215",128,96,96,1,0,"PSOE",35
37,"37004",30,21,21,0,0,"PSOE",3
50,"50142",26,17,17,0,0,"PSOE",3
19,"19162",68,49,47,0,2,"PSOE",16
16,"16166",243,176,174,1,2,"PSOE",75
22,"22141",117,91,90,1,1,"PSOE",21
26,"26176",53,44,44,1,0,"PSOE",4
5,"5170",50,43,43,0,0,"PSOE",9
19,"19041",163,129,129,3,0,"PSOE",43
37,"37154",140,113,110,3,3,"PSOE",15
44,"44028",183,151,150,4,1,"PSOE",40
24,"24177",476,325,322,3,3,"PSOE",63
39,"39042",5915,4530,4474,21,56,"PSOE",916
47,"47116",416,341,339,0,2,"PSOE",84
10,"10902",721,548,540,4,8,"PSOE",254
9,"9044",46,35,34,1,1,"PSOE",9
26,"26094",83,70,70,0,0,"PSOE",10
22,"22061",6630,4555,4526,40,29,"PSOE",1098
9,"9159",60,52,51,2,1,"PSOE",3
46,"46208",1112,887,881,4,6,"PSOE",235
39,"39032",1463,1087,1081,7,6,"PSOE",246
50,"50059",769,549,544,8,5,"PSOE",163
10,"10116",3749,2726,2670,21,56,"PSOE",1043
23,"23002",17428,12820,12644,70,176,"PSOE",5249
6,"6133",1775,1324,1312,15,12,"PSOE",601
47,"47188",111,88,88,3,0,"PSOE",18
44,"44262",135,108,107,2,1,"PSOE",25
44,"44124",77,64,64,3,0,"PSOE",24
18,"18107",943,663,655,1,8,"PSOE",346
37,"37196",75,64,64,0,0,"PSOE",20
16,"16030",24,19,19,0,0,"PSOE",5
37,"37281",36,33,31,0,2,"PSOE",8
50,"50249",302,226,220,0,6,"PSOE",33
42,"42155",167,103,102,1,1,"PSOE",13
24,"24180",1134,812,800,9,12,"PSOE",149
22,"22144",243,188,187,1,1,"PSOE",54
5,"5125",55,47,47,0,0,"PSOE",11
49,"49016",247,176,174,5,2,"PSOE",45
26,"26039",39,35,35,2,0,"PSOE",9
47,"47138",241,170,164,1,6,"PSOE",47
5,"5174",68,53,53,2,0,"PSOE",14
44,"44064",69,49,49,0,0,"PSOE",9
31,"31252",87,61,61,0,0,"PSOE",0
5,"5026",195,166,164,2,2,"PSOE",33
31,"31253",129,109,109,0,0,"PSOE",12
37,"37198",207,160,157,3,3,"PSOE",38
13,"13048",504,390,387,2,3,"PSOE",114
46,"46036",564,383,378,5,5,"PSOE",65
42,"42022",221,173,171,5,2,"PSOE",17
37,"37242",91,74,73,0,1,"PSOE",21
39,"39005",1380,1053,1046,9,7,"PSOE",196
6,"6046",1255,1004,995,8,9,"PSOE",453
39,"39065",252,191,189,1,2,"PSOE",44
46,"46019",8849,7072,7004,33,68,"PSOE",2322
9,"9103",217,184,183,1,1,"PSOE",71
9,"9327",26,24,24,0,0,"PSOE",5
7,"7003",11761,6631,6541,55,90,"PSOE",1321
2,"2054",386,291,290,0,1,"PSOE",82
41,"41002",1473,1038,1014,9,24,"PSOE",443
31,"31087",171,128,124,2,4,"PSOE",14
22,"22122",64,57,57,2,0,"PSOE",13
18,"18187",557,383,379,0,4,"PSOE",196
4,"4006",7022,4792,4749,30,43,"PSOE",1497
26,"26146",94,73,72,0,1,"PSOE",15
28,"28020",145,94,94,0,0,"PSOE",10
9,"9250",269,196,194,1,2,"PSOE",59
45,"45076",553,368,364,3,4,"PSOE",110
2,"2028",126,98,98,0,0,"PSOE",55
28,"28116",704,528,523,2,5,"PSOE",81
37,"37328",186,135,131,1,4,"PSOE",34
45,"45009",524,344,341,2,3,"PSOE",84
28,"28048",500,391,387,3,4,"PSOE",88
7,"7018",382,272,269,1,3,"PSOE",47
10,"10168",312,213,208,0,5,"PSOE",81
5,"5030",45,38,38,1,0,"PSOE",9
28,"28117",104,89,89,1,0,"PSOE",12
13,"13088",610,458,453,6,5,"PSOE",210
19,"19059",77,61,58,1,3,"PSOE",12
37,"37120",99,82,78,0,4,"PSOE",16
21,"21074",2649,1755,1733,13,22,"PSOE",853
5,"5082",529,432,422,1,10,"PSOE",86
26,"26043",365,292,281,1,11,"PSOE",88
44,"44267",70,57,56,0,1,"PSOE",12
12,"12015",93,81,78,0,3,"PSOE",5
10,"10169",531,420,409,2,11,"PSOE",135
16,"16909",699,535,532,0,3,"PSOE",236
24,"24184",198,118,117,0,1,"PSOE",22
34,"34184",57,46,45,0,1,"PSOE",5
28,"28050",4076,2860,2839,21,21,"PSOE",427
19,"19279",57,55,55,0,0,"PSOE",12
16,"16910",91,69,69,1,0,"PSOE",24
44,"44268",25,25,24,0,1,"PSOE",8
50,"50274",71,55,55,0,0,"PSOE",11
26,"26033",170,132,129,1,3,"PSOE",50
11,"11028",32488,21971,21672,316,299,"PSOE",6767
49,"49156",237,184,175,0,9,"PSOE",37
10,"10126",1548,1120,1102,8,18,"PSOE",446
10,"10081",182,142,135,2,7,"PSOE",37
3,"3112",628,511,507,2,4,"PSOE",123
12,"12016",1582,1307,1297,6,10,"PSOE",329
44,"44004",408,303,297,0,6,"PSOE",53
33,"33016",19130,13666,13526,125,140,"PSOE",2885
12,"12052",578,452,435,3,17,"PSOE",105
31,"31258",7879,5707,5666,50,41,"PSOE",784
37,"37289",232,167,166,3,1,"PSOE",36
18,"18040",231,136,133,0,3,"PSOE",45
44,"44177",115,84,84,1,0,"PSOE",31
46,"46058",1772,1398,1373,15,25,"PSOE",439
26,"26078",82,70,70,0,0,"PSOE",24
19,"19172",57,48,47,0,1,"PSOE",11
10,"10127",4703,3183,3132,21,51,"PSOE",1103
41,"41074",3012,2282,2257,18,25,"PSOE",896
28,"28120",1223,892,884,2,8,"PSOE",232
45,"45013",1758,1352,1329,8,23,"PSOE",372
41,"41007",12341,8039,7844,103,195,"PSOE",3146
16,"16041",358,275,271,0,4,"PSOE",72
22,"22243",45,28,28,0,0,"PSOE",12
29,"29080",6676,4469,4419,35,50,"PSOE",1575
5,"5019",44555,33259,32939,277,320,"PSOE",5251
31,"31226",591,342,340,2,2,"PSOE",31
37,"37291",272,207,206,0,1,"PSOE",60
47,"47087",381,301,297,3,4,"PSOE",74
37,"37334",76,48,48,1,0,"PSOE",12
16,"16042",1157,933,921,4,12,"PSOE",393
34,"34189",56,44,44,1,0,"PSOE",8
31,"31160",106,89,88,2,1,"PSOE",11
10,"10175",1416,1006,980,4,26,"PSOE",348
2,"2075",1670,1321,1304,4,17,"PSOE",442
14,"14062",1025,806,792,6,14,"PSOE",353
22,"22114",123,81,81,0,0,"PSOE",24
40,"40112",2555,1932,1909,8,23,"PSOE",348
26,"26047",1947,1578,1563,8,15,"PSOE",528
19,"19234",43,33,33,0,0,"PSOE",8
22,"22175",197,143,142,1,1,"PSOE",31
37,"37363",118,88,87,0,1,"PSOE",31
18,"18137",989,761,760,7,1,"PSOE",278
47,"47061",256,212,211,2,1,"PSOE",76
7,"7901",610,462,459,7,3,"PSOE",65
18,"18044",181,107,107,0,0,"PSOE",43
5,"5186",1575,1225,1194,3,31,"PSOE",215
10,"10039",417,291,291,0,0,"PSOE",101
31,"31161",338,264,259,2,5,"PSOE",44
44,"44040",201,160,157,1,3,"PSOE",52
37,"37253",135,109,109,2,0,"PSOE",21
13,"13045",674,508,499,1,9,"PSOE",150
31,"31018",393,292,285,4,7,"PSOE",53
6,"6118",192,145,144,1,1,"PSOE",84
28,"28113",34751,25832,25612,120,220,"PSOE",5424
7,"7013",6881,4693,4587,39,106,"PSOE",604
10,"10178",769,565,553,3,12,"PSOE",179
4,"4099",4989,3636,3588,27,48,"PSOE",1105
2,"2037",22865,14632,14477,91,155,"PSOE",4212
28,"28027",1203,872,857,3,15,"PSOE",164
42,"42120",145,91,89,2,2,"PSOE",22
42,"42033",48,45,45,1,0,"PSOE",6
24,"24227",1607,1127,1116,22,11,"PSOE",231
19,"19285",24,21,21,1,0,"PSOE",11
21,"21002",15478,10597,10507,94,90,"PSOE",2421
22,"22246",76,50,50,0,0,"PSOE",15
31,"31129",395,234,234,0,0,"PSOE",23
33,"33021",4573,3024,2971,22,53,"PSOE",944
41,"41045",5756,3988,3924,53,64,"PSOE",1491
5,"5044",266,183,183,1,0,"PSOE",23
14,"14008",2839,1905,1895,19,10,"PSOE",808
28,"28124",74,54,54,1,0,"PSOE",8
29,"29028",1237,836,826,6,10,"PSOE",375
12,"12122",796,637,627,0,10,"PSOE",165
28,"28028",1755,1353,1344,6,9,"PSOE",212
29,"29073",1579,1091,1080,7,11,"PSOE",411
3,"3055",5164,3695,3647,21,48,"PSOE",643
4,"4100",8768,5390,5353,32,37,"PSOE",1316
37,"37340",151,106,106,1,0,"PSOE",17
18,"18185",541,434,432,2,2,"PSOE",137
39,"39045",367,271,268,1,3,"PSOE",70
18,"18174",446,330,324,2,6,"PSOE",133
9,"9119",46,28,28,0,0,"PSOE",9
37,"37243",98,70,70,1,0,"PSOE",5
18,"18082",861,616,611,5,5,"PSOE",218
16,"16905",1224,920,910,4,10,"PSOE",245
16,"16005",255,180,178,2,2,"PSOE",42
49,"49006",154,99,95,0,4,"PSOE",23
44,"44173",101,81,79,2,2,"PSOE",9
41,"41069",29138,18991,18683,341,308,"PSOE",5834
6,"6123",4627,3182,3120,18,62,"PSOE",1230
6,"6062",594,441,437,5,4,"PSOE",174
34,"34202",29,18,18,1,0,"PSOE",1
14,"14010",4027,2850,2807,19,43,"PSOE",1404
10,"10182",136,95,95,0,0,"PSOE",30
18,"18188",1653,1183,1175,5,8,"PSOE",571
30,"30014",1567,1174,1160,8,14,"PSOE",480
13,"13069",660,508,499,7,9,"PSOE",218
26,"26160",709,552,549,2,3,"PSOE",136
24,"24196",2057,1502,1485,9,17,"PSOE",500
29,"29087",376,270,266,1,4,"PSOE",95
24,"24127",296,226,215,4,11,"PSOE",46
9,"9267",111,99,97,1,2,"PSOE",14
28,"28058",139342,100637,99753,634,884,"PSOE",26003
46,"46012",896,682,663,1,19,"PSOE",144
4,"4018",270,232,229,0,3,"PSOE",112
31,"31234",144,106,106,4,0,"PSOE",16
14,"14011",578,464,462,4,2,"PSOE",199
37,"37343",60,47,47,0,0,"PSOE",5
24,"24028",388,292,288,2,4,"PSOE",86
40,"40204",167,113,110,1,3,"PSOE",13
41,"41082",3415,2671,2647,16,24,"PSOE",1307
19,"19218",50,33,33,0,0,"PSOE",7
13,"13071",39454,26316,26107,183,209,"PSOE",9219
9,"9180",142,107,102,1,5,"PSOE",20
19,"19106",89,59,59,0,0,"PSOE",19
21,"21007",6225,4080,3999,52,81,"PSOE",1405
24,"24062",139,98,98,1,0,"PSOE",33
10,"10185",571,409,405,2,4,"PSOE",152
9,"9012",89,64,63,0,1,"PSOE",17
24,"24030",4277,3038,3007,11,31,"PSOE",914
50,"50182",3399,2364,2335,21,29,"PSOE",348
19,"19107",294,239,237,0,2,"PSOE",80
31,"31035",59,45,43,0,2,"PSOE",11
3,"3029",245,185,183,1,2,"PSOE",45
47,"47067",174,127,126,0,1,"PSOE",12
2,"2085",322,253,252,2,1,"PSOE",91
2,"2044",1105,768,758,7,10,"PSOE",318
42,"42001",278,212,210,3,2,"PSOE",65
47,"47124",392,316,311,3,5,"PSOE",77
24,"24902",347,270,269,2,1,"PSOE",90
5,"5052",95,77,76,0,1,"PSOE",7
31,"31236",1320,865,854,5,11,"PSOE",57
34,"34061",106,82,82,1,0,"PSOE",3
39,"39019",2079,1560,1531,10,29,"PSOE",342
5,"5197",102,85,83,1,2,"PSOE",14
47,"47177",105,76,73,1,3,"PSOE",19
16,"16198",1348,981,971,10,10,"PSOE",413
40,"40094",374,279,276,2,3,"PSOE",54
5,"5152",678,554,551,3,3,"PSOE",91
10,"10142",832,627,621,5,6,"PSOE",265
9,"9227",119,91,89,4,2,"PSOE",19
31,"31237",193,155,153,2,2,"PSOE",23
2,"2901",2200,1440,1437,7,3,"PSOE",510
18,"18901",511,356,355,3,1,"PSOE",100
23,"23065",1597,1170,1149,2,21,"PSOE",542
19,"19221",48,38,37,1,1,"PSOE",13
26,"26092",107,92,90,0,2,"PSOE",18
24,"24099",171,132,132,0,0,"PSOE",40
2,"2047",117,88,88,2,0,"PSOE",19
44,"44261",739,536,529,6,7,"PSOE",194
37,"37180",75,56,56,0,0,"PSOE",10
10,"10052",182,130,129,0,1,"PSOE",18
47,"47043",297,239,237,0,2,"PSOE",83
46,"46224",159,121,121,0,0,"PSOE",25
28,"28130",28293,21253,21040,116,213,"PSOE",4975
3,"3093",19683,14633,14484,70,149,"PSOE",3279
39,"39021",487,381,376,2,5,"PSOE",100
37,"37032",548,401,399,0,2,"PSOE",66
47,"47070",37,27,27,0,0,"PSOE",0
37,"37252",112,79,79,0,0,"PSOE",7
37,"37293",115,84,84,1,0,"PSOE",12
37,"37292",104,77,77,1,0,"PSOE",6
10,"10053",287,215,210,1,5,"PSOE",76
40,"40055",37,26,26,0,0,"PSOE",8
34,"34020",52,39,39,0,0,"PSOE",9
42,"42134",2627,1927,1890,19,37,"PSOE",508
44,"44192",355,280,278,4,2,"PSOE",75
21,"21013",10591,6580,6452,55,128,"PSOE",2265
9,"9368",22,17,17,2,0,"PSOE",0
10,"10192",828,590,584,1,6,"PSOE",195
19,"19297",32,24,24,1,0,"PSOE",2
6,"6902",1667,1121,1113,13,8,"PSOE",447
50,"50268",44,37,37,0,0,"PSOE",4
50,"50123",449,334,331,1,3,"PSOE",163
29,"29004",312,236,233,2,3,"PSOE",104
7,"7027",20769,13097,12987,100,110,"PSOE",2983
10,"10009",266,201,194,0,7,"PSOE",61
31,"31040",192,139,138,4,1,"PSOE",16
18,"18904",775,565,558,1,7,"PSOE",253
7,"7040",280477,173945,172463,1359,1482,"PSOE",33911
44,"44090",78,53,53,0,0,"PSOE",3
37,"37099",73,41,41,0,0,"PSOE",6
31,"31108",1855,1368,1348,7,20,"PSOE",388
16,"16269",419,336,332,2,4,"PSOE",99
47,"47099",150,135,135,1,0,"PSOE",27
19,"19225",823,623,619,3,4,"PSOE",167
37,"37100",80,61,61,1,0,"PSOE",1
19,"19112",60,46,46,0,0,"PSOE",4
10,"10056",586,457,452,4,5,"PSOE",191
37,"37226",155,123,123,2,0,"PSOE",11
16,"16016",224,171,168,0,3,"PSOE",51
12,"12036",581,426,421,10,5,"PSOE",109
3,"3004",581,438,437,2,1,"PSOE",128
22,"22052",925,712,710,8,2,"PSOE",246
7,"7002",6341,4295,4255,39,40,"PSOE",832
9,"9007",57,39,39,0,0,"PSOE",6
50,"50051",816,616,614,2,2,"PSOE",286
9,"9276",382,251,240,3,11,"PSOE",48
9,"9102",36,30,30,0,0,"PSOE",4
37,"37052",273,209,209,2,0,"PSOE",66
37,"37312",258,201,200,2,1,"PSOE",57
39,"39086",358,256,253,0,3,"PSOE",74
22,"22133",115,81,80,1,1,"PSOE",33
34,"34218",461,343,339,2,4,"PSOE",45
49,"49087",521,322,318,0,4,"PSOE",54
18,"18907",1843,1393,1388,4,5,"PSOE",621
6,"6077",341,256,249,0,7,"PSOE",122
49,"49177",278,179,177,1,2,"PSOE",59
40,"40104",265,198,195,0,3,"PSOE",38
31,"31099",62,47,47,2,0,"PSOE",8
22,"22107",112,74,74,0,0,"PSOE",14
22,"22089",302,225,223,0,2,"PSOE",59
3,"3036",87,81,78,0,3,"PSOE",5
39,"39026",1750,1236,1224,11,12,"PSOE",258
28,"28107",457,312,312,0,0,"PSOE",113
46,"46228",2348,1815,1794,7,21,"PSOE",322
50,"50180",119,99,99,2,0,"PSOE",26
22,"22054",1542,1091,1077,13,14,"PSOE",211
9,"9236",38,32,32,0,0,"PSOE",0
37,"37012",154,116,115,1,1,"PSOE",25
13,"13035",984,747,730,7,17,"PSOE",313
24,"24173",951,679,674,9,5,"PSOE",176
37,"37188",181,129,129,3,0,"PSOE",35
39,"39027",3118,2322,2295,26,27,"PSOE",498
50,"50232",175,110,110,3,0,"PSOE",19
24,"24073",478,332,328,2,4,"PSOE",79
9,"9238",921,573,561,4,12,"PSOE",165
37,"37357",262,205,203,1,2,"PSOE",55
46,"46177",4690,3579,3526,19,53,"PSOE",920
5,"5211",459,345,343,1,2,"PSOE",56
19,"19229",66,56,56,0,0,"PSOE",12
10,"10200",392,306,302,1,4,"PSOE",126
44,"44198",182,147,146,4,1,"PSOE",35
9,"9024",156,112,110,1,2,"PSOE",18
44,"44197",56,36,36,0,0,"PSOE",9
45,"45100",188,150,150,0,0,"PSOE",68
42,"42145",138,108,107,2,1,"PSOE",29
9,"9463",264,195,195,7,0,"PSOE",47
34,"34169",404,287,286,0,1,"PSOE",46
9,"9268",95,68,66,0,2,"PSOE",23
13,"13090",1094,843,828,4,15,"PSOE",326
12,"12136",2635,2201,2171,18,30,"PSOE",455
9,"9064",324,271,267,1,4,"PSOE",33
7,"7048",17252,10055,9984,105,71,"PSOE",2134
37,"37358",159,135,133,0,2,"PSOE",22
44,"44099",709,465,462,3,3,"PSOE",216
19,"19194",98,69,69,1,0,"PSOE",21
19,"19304",219,173,171,3,2,"PSOE",53
31,"31247",151,114,113,0,1,"PSOE",8
47,"47160",425,308,303,0,5,"PSOE",64
5,"5264",61,38,37,2,1,"PSOE",1
14,"14050",2391,1822,1787,14,35,"PSOE",507
34,"34076",587,479,479,2,0,"PSOE",100
16,"16217",74,62,62,0,0,"PSOE",19
10,"10157",263,204,201,0,3,"PSOE",59
19,"19231",10,9,9,0,0,"PSOE",0
37,"37059",124,94,93,1,1,"PSOE",27
30,"30028",6649,4797,4726,21,71,"PSOE",1668
16,"16070",30,26,26,1,0,"PSOE",15
33,"33037",34454,22881,22586,243,295,"PSOE",6350
40,"40152",760,592,584,3,8,"PSOE",143
10,"10021",5147,3744,3648,31,96,"PSOE",1506
12,"12138",19061,13010,12847,129,163,"PSOE",2794
42,"42098",10,7,7,1,0,"PSOE",2
33,"33007",1514,946,942,12,4,"PSOE",335
18,"18165",4123,2787,2758,18,29,"PSOE",1010
41,"41031",1238,825,814,11,11,"PSOE",481
3,"3103",272,235,234,1,1,"PSOE",53
4,"4056",143,113,109,0,4,"PSOE",27
26,"26105",2205,1670,1658,12,12,"PSOE",510
6,"6085",3428,2453,2414,25,39,"PSOE",1026
50,"50215",24,19,19,0,0,"PSOE",0
45,"45136",5845,4091,4019,25,72,"PSOE",1088
10,"10160",229,190,189,2,1,"PSOE",97
44,"44133",21,15,15,0,0,"PSOE",2
29,"29903",524,353,349,3,4,"PSOE",178
10,"10022",427,349,341,0,8,"PSOE",133
9,"9067",437,295,294,6,1,"PSOE",54
13,"13095",85,66,66,0,0,"PSOE",13
2,"2022",351,281,279,1,2,"PSOE",62
37,"37349",117,88,88,0,0,"PSOE",11
6,"6087",2110,1583,1561,8,22,"PSOE",671
50,"50216",235,186,184,5,2,"PSOE",44
44,"44102",30,27,26,0,1,"PSOE",2
12,"12140",1143,939,930,6,9,"PSOE",260
19,"19042",25,24,24,0,0,"PSOE",8
26,"26037",128,108,108,2,0,"PSOE",34
21,"21027",48,36,35,1,1,"PSOE",20
29,"29070",40333,25991,25728,214,263,"PSOE",6337
29,"29015",31880,22220,21952,190,268,"PSOE",7268
19,"19122",96,68,68,1,0,"PSOE",17
18,"18032",246,175,174,2,1,"PSOE",40
5,"5157",232,162,159,1,3,"PSOE",43
16,"16123",82,61,61,3,0,"PSOE",18
5,"5108",47,35,35,0,0,"PSOE",12
45,"45172",689,530,522,2,8,"PSOE",150
40,"40113",425,323,316,0,7,"PSOE",75
3,"3013",1113,839,836,4,3,"PSOE",208
12,"12110",234,176,173,0,3,"PSOE",68
31,"31052",96,62,61,0,1,"PSOE",8
19,"19123",40,32,31,1,1,"PSOE",5
9,"9427",1419,978,959,8,19,"PSOE",129
12,"12111",360,305,299,3,6,"PSOE",87
31,"31118",164,112,111,1,1,"PSOE",18
3,"3138",3145,2310,2275,9,35,"PSOE",474
9,"9473",85,70,65,1,5,"PSOE",8
5,"5077",158,140,139,1,1,"PSOE",37
33,"33072",1566,1008,994,11,14,"PSOE",313
49,"49069",367,258,254,5,4,"PSOE",55
10,"10209",282,179,177,1,2,"PSOE",86
10,"10210",543,356,355,1,1,"PSOE",178
9,"9295",61,44,44,0,0,"PSOE",3
18,"18034",505,366,364,1,2,"PSOE",132
16,"16125",1667,1249,1231,3,18,"PSOE",363
45,"45007",696,534,522,3,12,"PSOE",259
49,"49112",126,75,75,0,0,"PSOE",20
37,"37283",123,92,90,0,2,"PSOE",23
46,"46132",2150,1803,1784,7,19,"PSOE",351
39,"39035",9502,7017,6928,57,89,"PSOE",1800
24,"24049",1483,1054,1048,6,6,"PSOE",329
12,"12046",191,151,150,2,1,"PSOE",53
44,"44032",16,11,11,0,0,"PSOE",5
6,"6138",1047,727,715,5,12,"PSOE",375
19,"19300",772,595,591,5,4,"PSOE",72
5,"5176",235,181,174,4,7,"PSOE",33
49,"49275",52210,36205,35754,356,451,"PSOE",7780
19,"19238",42,28,28,0,0,"PSOE",3
22,"22028",371,282,280,3,2,"PSOE",70
12,"12901",3405,2626,2598,23,28,"PSOE",687
13,"13016",664,517,509,4,8,"PSOE",134
16,"16082",291,213,212,0,1,"PSOE",101
31,"31254",1915,1428,1411,3,17,"PSOE",431
7,"7017",851,582,571,7,11,"PSOE",83
44,"44033",269,191,190,0,1,"PSOE",52
24,"24115",54058,37780,37357,308,423,"PSOE",10298
40,"40120",192,170,166,0,4,"PSOE",42
44,"44207",156,118,115,4,3,"PSOE",46
4,"4061",638,506,498,4,8,"PSOE",252
31,"31188",235,161,161,2,0,"PSOE",12
10,"10213",566,469,463,0,6,"PSOE",157
3,"3109",2850,2181,2164,8,17,"PSOE",710
12,"12902",2158,1504,1489,14,15,"PSOE",298
37,"37245",346,261,259,2,2,"PSOE",97
23,"23008",1502,1144,1131,9,13,"PSOE",610
29,"29042",14016,9368,9192,88,176,"PSOE",2451
41,"41015",5297,3478,3405,41,73,"PSOE",1511
6,"6004",1600,1212,1207,2,5,"PSOE",606
19,"19170",193,135,135,0,0,"PSOE",28
9,"9211",1441,1056,1039,9,17,"PSOE",203
5,"5034",14,13,13,0,0,"PSOE",1
3,"3111",5436,3918,3883,18,35,"PSOE",854
23,"23049",1813,1238,1222,9,16,"PSOE",571
16,"16085",138,113,112,0,1,"PSOE",28
19,"19317",139,110,109,1,1,"PSOE",17
29,"29021",161,108,107,4,1,"PSOE",33
42,"42204",54,38,38,1,0,"PSOE",8
23,"23090",1312,1041,1018,5,23,"PSOE",386
37,"37163",41,34,34,0,0,"PSOE",2
26,"26044",52,46,46,0,0,"PSOE",14
42,"42065",21,18,18,0,0,"PSOE",4
33,"33035",11284,7681,7618,70,63,"PSOE",1862
46,"46074",2696,2069,2038,14,31,"PSOE",441
13,"13056",11362,8288,8198,70,90,"PSOE",2275
45,"45011",278,239,233,1,6,"PSOE",74
37,"37332",68,51,50,0,1,"PSOE",5
19,"19208",43,30,30,0,0,"PSOE",5
45,"45179",525,391,386,3,5,"PSOE",127
7,"7061",9819,6351,6280,53,71,"PSOE",1128
31,"31124",208,148,148,2,0,"PSOE",9
44,"44110",49,42,42,1,0,"PSOE",10
16,"16039",392,261,254,1,7,"PSOE",88
50,"50130",383,240,238,2,2,"PSOE",81
2,"2072",1549,1086,1070,2,16,"PSOE",423
21,"21036",200,141,139,0,2,"PSOE",63
9,"9303",86,68,68,0,0,"PSOE",13
37,"37077",261,226,223,1,3,"PSOE",93
5,"5037",255,173,172,1,1,"PSOE",22
22,"22036",92,77,77,0,0,"PSOE",9
42,"42116",45,39,38,3,1,"PSOE",13
49,"49157",206,163,160,2,3,"PSOE",43
31,"31092",662,439,435,4,4,"PSOE",39
7,"7063",1418,1043,1033,6,10,"PSOE",146
42,"42163",50,41,40,0,1,"PSOE",7
46,"46032",5653,4402,4361,33,41,"PSOE",858
42,"42029",137,104,104,2,0,"PSOE",18
44,"44005",50,30,30,0,0,"PSOE",5
24,"24188",3822,2850,2817,19,33,"PSOE",700
45,"45114",588,447,447,0,0,"PSOE",176
45,"45014",4010,2646,2616,22,30,"PSOE",943
30,"30009",12433,9586,9503,41,83,"PSOE",2307
5,"5233",221,191,191,1,0,"PSOE",32
50,"50225",1570,956,950,3,6,"PSOE",239
46,"46007",11989,8784,8711,67,73,"PSOE",1718
24,"24120",341,246,244,1,2,"PSOE",30
37,"37207",287,195,193,1,2,"PSOE",21
12,"12055",104,83,82,3,1,"PSOE",4
5,"5039",54,42,41,0,1,"PSOE",2
23,"23054",382,282,281,1,1,"PSOE",171
50,"50006",925,674,657,6,17,"PSOE",235
23,"23014",2559,1971,1942,13,29,"PSOE",720
34,"34050",200,153,152,0,1,"PSOE",38
24,"24023",263,188,188,1,0,"PSOE",22
26,"26014",474,327,324,1,3,"PSOE",121
13,"13009",1439,1115,1098,9,17,"PSOE",256
47,"47144",78,64,64,1,0,"PSOE",8
47,"47197",876,673,668,8,5,"PSOE",200
5,"5235",124,111,110,0,1,"PSOE",37
49,"49201",302,270,268,3,2,"PSOE",121
10,"10903",826,578,569,3,9,"PSOE",265
30,"30041",13621,8970,8889,46,81,"PSOE",2285
4,"4034",160,99,99,2,0,"PSOE",20
49,"49244",43,29,29,0,0,"PSOE",8
5,"5236",123,91,90,1,1,"PSOE",13
16,"16169",58,37,37,3,0,"PSOE",11
18,"18138",2486,1620,1606,13,14,"PSOE",683
41,"41033",5075,3313,3277,34,36,"PSOE",1556
9,"9308",67,42,42,1,0,"PSOE",4
31,"31195",182,130,128,0,2,"PSOE",8
22,"22163",425,360,355,0,5,"PSOE",69
18,"18183",658,438,434,3,4,"PSOE",166
5,"5090",77,68,68,1,0,"PSOE",16
41,"41077",8702,5983,5875,29,108,"PSOE",2355
44,"44148",90,75,73,2,2,"PSOE",25
39,"39044",3849,2765,2732,21,33,"PSOE",631
26,"26083",284,205,205,2,0,"PSOE",53
11,"11033",20903,12949,12771,164,178,"PSOE",4252
31,"31163",2013,1418,1383,13,35,"PSOE",391
10,"10041",1057,795,781,4,14,"PSOE",306
45,"45118",1991,1351,1339,6,12,"PSOE",373
34,"34053",207,170,169,3,1,"PSOE",40
13,"13013",7068,5147,5063,25,84,"PSOE",1351
10,"10088",204,131,128,1,3,"PSOE",43
11,"11001",4358,2816,2767,11,49,"PSOE",1450
37,"37255",49,34,34,1,0,"PSOE",7
50,"50229",62,47,47,2,0,"PSOE",12
49,"49086",115,96,91,0,5,"PSOE",24
42,"42034",30,22,22,0,0,"PSOE",6
42,"42168",107,80,80,0,0,"PSOE",22
47,"47147",116,92,92,0,0,"PSOE",14
34,"34099",60,48,48,0,0,"PSOE",3
22,"22078",438,319,316,3,3,"PSOE",71
19,"19057",76,59,59,1,0,"PSOE",17
31,"31197",69,56,56,2,0,"PSOE",14
9,"9442",375,279,277,2,2,"PSOE",72
7,"7016",2809,1865,1836,23,29,"PSOE",462
49,"49205",382,293,291,2,2,"PSOE",49
31,"31065",1878,1351,1326,20,25,"PSOE",333
19,"19017",69,57,57,0,0,"PSOE",15
40,"40088",284,228,224,0,4,"PSOE",39
2,"2041",336,265,260,0,5,"PSOE",72
37,"37160",615,434,429,8,5,"PSOE",151
41,"41080",1274,910,892,6,18,"PSOE",433
12,"12059",231,189,188,2,1,"PSOE",50
24,"24061",1704,1213,1204,9,9,"PSOE",309
47,"47228",440,331,331,2,0,"PSOE",74
10,"10091",371,287,284,0,3,"PSOE",81
24,"24162",1683,1257,1246,13,11,"PSOE",306
4,"4071",394,338,337,3,1,"PSOE",174
37,"37087",862,639,635,2,4,"PSOE",76
9,"9444",72,58,58,3,0,"PSOE",6
42,"42036",50,41,41,1,0,"PSOE",17
9,"9050",68,56,55,1,1,"PSOE",6
4,"4072",313,247,245,2,2,"PSOE",50
50,"50138",46,37,37,2,0,"PSOE",4
13,"13018",822,642,640,6,2,"PSOE",267
50,"50117",126,104,103,1,1,"PSOE",28
50,"50042",15,15,15,1,0,"PSOE",3
42,"42037",33,25,25,2,0,"PSOE",2
49,"49090",197,143,141,6,2,"PSOE",30
5,"5099",491,395,386,6,9,"PSOE",141
19,"19145",46,41,41,1,0,"PSOE",1
31,"31200",761,517,508,3,9,"PSOE",120
44,"44220",121,84,83,1,1,"PSOE",9
22,"22081",254,181,181,0,0,"PSOE",27
16,"16007",1177,888,880,7,8,"PSOE",291
42,"42038",36,28,28,1,0,"PSOE",1
5,"5100",278,227,223,1,4,"PSOE",46
44,"44046",49,34,34,1,0,"PSOE",14
40,"40049",49,43,43,0,0,"PSOE",8
34,"34103",98,77,76,0,1,"PSOE",12
46,"46117",495,402,399,5,3,"PSOE",81
45,"45012",661,510,503,6,7,"PSOE",92
9,"9135",41,31,31,1,0,"PSOE",7
31,"31068",2885,2060,2027,20,33,"PSOE",637
5,"5151",91,71,71,1,0,"PSOE",11
19,"19146",41,35,32,0,3,"PSOE",11
45,"45057",222,180,177,1,3,"PSOE",59
37,"37135",1207,905,899,15,6,"PSOE",211
34,"34104",246,185,182,1,3,"PSOE",32
31,"31202",4305,2845,2803,31,42,"PSOE",553
9,"9316",105,80,80,1,0,"PSOE",18
46,"46255",3174,2448,2424,22,24,"PSOE",487
9,"9052",29,23,23,0,0,"PSOE",1
5,"5102",1780,1339,1317,3,22,"PSOE",342
46,"46040",1078,888,878,7,10,"PSOE",211
41,"41051",2180,1529,1501,2,28,"PSOE",618
41,"41018",9480,6523,6455,53,68,"PSOE",3013
37,"37137",105,66,66,0,0,"PSOE",5
31,"31070",2638,1808,1784,20,24,"PSOE",489
16,"16150",97,72,72,0,0,"PSOE",21
22,"22048",12598,8790,8731,91,59,"PSOE",2054
37,"37092",1758,1225,1215,8,10,"PSOE",194
46,"46119",780,653,647,5,6,"PSOE",178
3,"3030",524,448,440,5,8,"PSOE",137
14,"14042",18891,14051,13848,190,203,"PSOE",4349
18,"18057",5305,3827,3791,27,36,"PSOE",1056
16,"16259",29,22,21,0,1,"PSOE",7
46,"46041",329,253,252,5,1,"PSOE",62
6,"6070",7743,5438,5317,39,121,"PSOE",2263
31,"31204",36,28,28,1,0,"PSOE",2
11,"11008",17471,10952,10812,128,140,"PSOE",3391
31,"31005",301,212,211,3,1,"PSOE",33
41,"41053",21259,15147,14853,132,294,"PSOE",5745
12,"12067",537,435,427,0,8,"PSOE",131
9,"9016",85,60,59,3,1,"PSOE",12
44,"44122",1333,925,913,8,12,"PSOE",224
40,"40182",178,133,130,2,3,"PSOE",33
37,"37306",259,186,183,1,3,"PSOE",39
12,"12129",1828,1322,1298,11,24,"PSOE",393
7,"7039",4839,3136,3060,31,76,"PSOE",489
16,"16203",9972,7094,7007,34,87,"PSOE",2305
31,"31105",1507,1167,1142,7,25,"PSOE",295
44,"44018",19,19,19,0,0,"PSOE",1
5,"5056",96,76,76,0,0,"PSOE",12
16,"16057",75,63,63,0,0,"PSOE",26
26,"26026",1321,1039,1025,6,14,"PSOE",317
40,"40183",130,120,119,2,1,"PSOE",5
49,"49219",7464,4988,4914,53,74,"PSOE",1343
18,"18106",425,293,290,0,3,"PSOE",136
6,"6027",676,561,552,2,9,"PSOE",172
47,"47127",137,98,97,0,1,"PSOE",19
39,"39022",980,721,713,2,8,"PSOE",145
45,"45127",696,514,511,3,3,"PSOE",73
46,"46121",105,95,94,0,1,"PSOE",25
19,"19259",30,25,25,1,0,"PSOE",8
19,"19067",70,52,51,1,1,"PSOE",17
31,"31074",387,286,286,5,0,"PSOE",29
46,"46017",32949,23913,23685,142,228,"PSOE",4197
41,"41055",14954,10068,9945,64,123,"PSOE",4002
49,"49097",85,52,51,0,1,"PSOE",15
16,"16108",49,45,42,0,3,"PSOE",15
19,"19031",15,9,9,0,0,"PSOE",2
5,"5206",30,22,20,1,2,"PSOE",6
6,"6075",465,383,372,0,11,"PSOE",233
37,"37268",112,76,76,0,0,"PSOE",6
31,"31008",75,54,54,2,0,"PSOE",12
45,"45162",669,494,486,2,8,"PSOE",162
21,"21056",2895,1990,1906,18,84,"PSOE",819
47,"47155",3228,2277,2254,18,23,"PSOE",490
10,"10103",450,322,318,1,4,"PSOE",156
16,"16109",44,38,38,1,0,"PSOE",12
13,"13030",139,98,96,0,2,"PSOE",35
9,"9190",86,58,56,0,2,"PSOE",7
10,"10012",595,466,459,0,7,"PSOE",231
24,"24206",1700,1253,1240,12,13,"PSOE",491
46,"46260",2581,2087,2068,22,19,"PSOE",457
3,"3035",652,547,541,1,6,"PSOE",146
10,"10058",1021,718,708,2,10,"PSOE",299
19,"19032",165,126,124,1,2,"PSOE",36
45,"45063",417,310,303,1,7,"PSOE",98
31,"31175",71,48,48,0,0,"PSOE",8
40,"40018",91,72,72,1,0,"PSOE",7
5,"5061",252,186,184,3,2,"PSOE",48
37,"37270",189,152,151,2,1,"PSOE",33
5,"5112",97,71,70,2,1,"PSOE",6
40,"40060",82,61,61,0,0,"PSOE",7
18,"18158",8358,5096,5031,28,65,"PSOE",2277
28,"28057",1458,1097,1088,3,9,"PSOE",173
44,"44054",108,85,85,2,0,"PSOE",16
10,"10014",1852,1370,1346,6,24,"PSOE",537
44,"44266",115,90,90,0,0,"PSOE",18
19,"19034",22,16,16,0,0,"PSOE",6
37,"37355",178,142,142,1,0,"PSOE",27
46,"46202",16947,12814,12710,79,104,"PSOE",1857
44,"44196",131,101,98,2,3,"PSOE",38
37,"37271",368,297,296,0,1,"PSOE",91
9,"9022",66,57,57,1,0,"PSOE",6
37,"37314",82,65,65,0,0,"PSOE",1
28,"28135",948,713,709,4,4,"PSOE",106
24,"24141",95,85,84,0,1,"PSOE",29
9,"9062",51,40,39,0,1,"PSOE",9
12,"12072",1101,929,911,11,18,"PSOE",271
46,"46203",3606,2873,2844,9,29,"PSOE",679
4,"4041",322,240,238,6,2,"PSOE",64
37,"37272",141,107,104,0,3,"PSOE",28
9,"9329",121,87,87,1,0,"PSOE",24
47,"47076",17399,13097,12972,92,125,"PSOE",2899
44,"44023",17,16,16,0,0,"PSOE",1
40,"40061",67,55,54,1,1,"PSOE",11
9,"9330",1507,1108,1092,10,16,"PSOE",241
31,"31111",95,65,65,2,0,"PSOE",4
11,"11016",14929,9426,9302,123,124,"PSOE",2677
19,"19265",122,97,95,2,2,"PSOE",14
47,"47049",101,68,68,0,0,"PSOE",17
44,"44230",155,123,123,2,0,"PSOE",51
28,"28041",4524,3508,3490,20,18,"PSOE",496
21,"21021",12254,7339,7244,78,95,"PSOE",2410
46,"46178",4637,3405,3381,27,24,"PSOE",442
19,"19020",44,30,30,1,0,"PSOE",3
50,"50055",3611,2445,2407,22,38,"PSOE",565
24,"24175",1832,1314,1297,14,17,"PSOE",273
16,"16023",469,335,335,2,0,"PSOE",88
49,"49227",315,230,228,2,2,"PSOE",53
26,"26138",4588,3290,3247,15,43,"PSOE",800
37,"37014",1155,817,808,7,9,"PSOE",261
12,"12040",117608,85588,84946,496,642,"PSOE",17202
9,"9332",140,106,106,2,0,"PSOE",16
10,"10111",1325,970,949,2,21,"PSOE",342
37,"37150",41,34,34,0,0,"PSOE",0
26,"26174",146,107,105,2,2,"PSOE",18
29,"29901",43826,29318,29107,250,211,"PSOE",6249
9,"9197",144,111,109,1,2,"PSOE",20
22,"22226",767,570,562,10,8,"PSOE",185
16,"16277",113,84,83,1,1,"PSOE",6
46,"46205",14313,10932,10834,51,98,"PSOE",2460
10,"10203",4558,3120,3079,20,41,"PSOE",1007
28,"28168",1237,884,880,4,4,"PSOE",161
44,"44026",90,77,76,0,1,"PSOE",14
31,"31015",1994,1412,1392,25,20,"PSOE",321
12,"12076",84,69,69,0,0,"PSOE",20
44,"44100",185,153,151,0,2,"PSOE",55
16,"16218",191,150,150,3,0,"PSOE",63
16,"16119",169,127,127,0,0,"PSOE",38
16,"16278",70,55,55,0,0,"PSOE",22
46,"46206",571,453,445,2,8,"PSOE",159
24,"24213",150,122,122,1,0,"PSOE",23
37,"37061",225,168,168,1,0,"PSOE",38
24,"24145",654,463,461,2,2,"PSOE",184
37,"37361",86,66,66,0,0,"PSOE",9
22,"22228",514,364,360,5,4,"PSOE",58
41,"41064",5596,3517,3456,55,61,"PSOE",1890
13,"13042",920,652,648,2,4,"PSOE",236
40,"40069",83,66,63,0,3,"PSOE",8
2,"2021",1017,784,778,6,6,"PSOE",229
31,"31017",358,242,239,0,3,"PSOE",24
9,"9337",117,92,91,0,1,"PSOE",23
28,"28112",161,136,136,1,0,"PSOE",38
26,"26069",236,194,189,0,5,"PSOE",41
46,"46129",524,420,412,4,8,"PSOE",105
37,"37113",433,334,333,3,1,"PSOE",121
45,"45071",1835,1426,1408,5,18,"PSOE",512
4,"4057",1325,894,884,5,10,"PSOE",391
18,"18074",262,201,200,2,1,"PSOE",94
34,"34080",5560,3723,3665,32,58,"PSOE",946
7,"7012",1876,1369,1353,13,16,"PSOE",270
18,"18168",804,546,543,7,3,"PSOE",179
47,"47162",74,60,60,0,0,"PSOE",6
46,"46156",2080,1697,1675,10,22,"PSOE",385
40,"40196",30,25,25,0,0,"PSOE",3
50,"50155",103,80,78,0,2,"PSOE",21
49,"49232",96,74,74,1,0,"PSOE",18
18,"18122",16114,11098,10945,83,153,"PSOE",4191
46,"46052",499,421,417,2,4,"PSOE",110
33,"33070",3351,2403,2373,26,30,"PSOE",636
13,"13098",2092,1503,1461,8,42,"PSOE",445
10,"10117",255,135,134,0,1,"PSOE",71
37,"37020",430,326,321,1,5,"PSOE",81
42,"42196",10,7,7,0,0,"PSOE",1
16,"16227",113,93,93,0,0,"PSOE",21
18,"18123",301,228,222,1,6,"PSOE",107
26,"26038",89,68,67,0,1,"PSOE",25
42,"42020",4263,2877,2821,35,56,"PSOE",751
45,"45006",1406,942,931,4,11,"PSOE",380
44,"44171",178,126,124,2,2,"PSOE",14
28,"28083",8939,6396,6348,38,48,"PSOE",1125
4,"4089",742,521,518,1,3,"PSOE",159
31,"31119",39,26,26,0,0,"PSOE",4
22,"22233",82,57,57,3,0,"PSOE",21
26,"26144",188,155,155,3,0,"PSOE",22
44,"44238",2323,1603,1590,5,13,"PSOE",759
49,"49111",127,98,96,4,2,"PSOE",23
47,"47218",993,743,734,2,9,"PSOE",209
4,"4026",66,54,51,0,3,"PSOE",7
42,"42060",38,21,19,1,2,"PSOE",0
39,"39095",2266,1760,1726,14,34,"PSOE",527
6,"6136",1565,1131,1102,11,29,"PSOE",508
37,"37325",89,62,62,0,0,"PSOE",10
37,"37158",246,183,183,0,0,"PSOE",52
16,"16904",472,378,373,4,5,"PSOE",91
37,"37159",90,70,70,1,0,"PSOE",18
40,"40075",160,139,139,0,0,"PSOE",31
46,"46080",998,803,799,7,4,"PSOE",241
37,"37368",17,17,17,0,0,"PSOE",0
26,"26110",152,131,129,0,2,"PSOE",23
5,"5224",102,86,84,3,2,"PSOE",6
47,"47082",812,640,628,8,12,"PSOE",97
31,"31121",62,44,43,0,1,"PSOE",4
46,"46211",1745,1387,1378,8,9,"PSOE",306
47,"47083",80,59,54,1,5,"PSOE",2
26,"26147",30,28,27,0,1,"PSOE",12
9,"9073",926,691,686,4,5,"PSOE",134
42,"42062",22,12,12,0,0,"PSOE",5
19,"19089",30,22,22,0,0,"PSOE",15
28,"28146",1787,1205,1194,0,11,"PSOE",330
42,"42024",86,61,59,0,2,"PSOE",11
31,"31022",518,332,331,4,1,"PSOE",12
10,"10122",218,156,153,3,3,"PSOE",55
37,"37025",257,220,220,4,0,"PSOE",57
28,"28085",3922,2972,2954,14,18,"PSOE",682
49,"49114",43,34,33,0,1,"PSOE",9
50,"50063",61,51,51,0,0,"PSOE",28
9,"9074",794,575,569,6,6,"PSOE",114
9,"9301",625,473,467,2,6,"PSOE",90
6,"6125",1743,1285,1269,7,16,"PSOE",546
31,"31123",647,369,361,5,8,"PSOE",22
50,"50002",143,108,104,1,4,"PSOE",22
10,"10215",431,311,308,2,3,"PSOE",154
47,"47140",115,102,102,1,0,"PSOE",24
42,"42159",37,29,29,0,0,"PSOE",6
33,"33075",271,154,153,2,1,"PSOE",56
19,"19047",64,55,55,0,0,"PSOE",11
50,"50161",106,75,72,0,3,"PSOE",16
6,"6141",1719,1201,1189,8,12,"PSOE",543
40,"40078",161,125,124,2,1,"PSOE",39
24,"24117",434,334,331,1,3,"PSOE",39
42,"42113",534,409,399,1,10,"PSOE",83
9,"9123",40,35,35,0,0,"PSOE",12
16,"16038",38,31,31,0,0,"PSOE",7
18,"18177",418,258,256,0,2,"PSOE",112
44,"44130",34,24,24,0,0,"PSOE",0
44,"44109",108,73,73,0,0,"PSOE",26
46,"46239",442,340,338,3,2,"PSOE",104
31,"31190",45,34,32,2,2,"PSOE",6
41,"41094",6288,4497,4449,38,48,"PSOE",1667
19,"19049",10,10,9,0,1,"PSOE",5
7,"7021",230,177,174,2,3,"PSOE",26
46,"46057",487,321,317,1,4,"PSOE",58
9,"9255",89,63,62,0,1,"PSOE",13
50,"50285",644,436,434,2,2,"PSOE",126
47,"47142",141,99,97,0,2,"PSOE",20
24,"24087",631,470,466,7,4,"PSOE",50
9,"9169",95,78,78,0,0,"PSOE",16
47,"47007",3769,2765,2736,24,29,"PSOE",525
14,"14060",4868,3473,3412,41,61,"PSOE",1533
26,"26150",112,101,95,0,6,"PSOE",29
2,"2032",276,207,202,1,5,"PSOE",77
40,"40037",41,29,29,0,0,"PSOE",6
6,"6145",922,696,694,5,2,"PSOE",325
47,"47223",157,122,118,2,4,"PSOE",33
9,"9215",368,256,256,2,0,"PSOE",43
33,"33077",1192,811,808,5,3,"PSOE",189
16,"16133",4389,3358,3316,24,42,"PSOE",858
50,"50255",209,163,163,5,0,"PSOE",108
50,"50164",390,247,246,6,1,"PSOE",69
6,"6008",632,525,519,2,6,"PSOE",297
31,"31026",144,118,117,0,1,"PSOE",36
18,"18088",1541,1124,1117,5,7,"PSOE",453
19,"19133",83,72,72,0,0,"PSOE",39
37,"37375",700,578,570,4,8,"PSOE",238
11,"11030",22775,15157,14958,149,199,"PSOE",3716
13,"13060",263,200,194,0,6,"PSOE",71
13,"13059",202,160,156,0,4,"PSOE",54
22,"22113",495,370,368,4,2,"PSOE",97
39,"39071",397,261,256,1,5,"PSOE",41
31,"31093",292,188,188,2,0,"PSOE",37
40,"40208",766,596,589,3,7,"PSOE",103
5,"5138",306,221,220,1,1,"PSOE",26
6,"6147",354,268,268,0,0,"PSOE",148
19,"19246",46,36,34,2,2,"PSOE",12
37,"37376",2233,1539,1515,6,24,"PSOE",264
31,"31228",486,341,337,2,4,"PSOE",60
9,"9079",49,45,45,0,0,"PSOE",1
46,"46138",343,275,272,1,3,"PSOE",71
42,"42031",26,21,21,0,0,"PSOE",0
50,"50258",54,34,34,0,0,"PSOE",4
34,"34140",107,67,67,0,0,"PSOE",18
49,"49243",111,94,93,0,1,"PSOE",11
9,"9217",351,251,249,6,2,"PSOE",43
49,"49121",365,273,273,2,0,"PSOE",45
22,"22040",144,117,115,1,2,"PSOE",26
12,"12056",282,236,231,1,5,"PSOE",45
2,"2036",95,78,78,0,0,"PSOE",17
3,"3023",1398,1184,1167,7,17,"PSOE",288
50,"50134",128,91,89,2,2,"PSOE",25
5,"5042",153,122,121,0,1,"PSOE",18
39,"39074",6902,5113,5039,40,74,"PSOE",931
9,"9309",301,224,220,0,4,"PSOE",37
45,"45084",2257,1679,1656,13,23,"PSOE",597
31,"31029",914,638,625,6,13,"PSOE",119
45,"45150",443,356,354,0,2,"PSOE",193
18,"18046",1832,1160,1140,6,20,"PSOE",479
18,"18140",43496,28038,27872,212,166,"PSOE",8654
46,"46061",342,274,272,1,2,"PSOE",43
44,"44041",56,44,44,1,0,"PSOE",11
24,"24191",108,79,79,0,0,"PSOE",19
10,"10133",1206,956,945,5,11,"PSOE",588
22,"22116",1430,1004,994,5,10,"PSOE",292
34,"34143",168,123,120,2,3,"PSOE",26
5,"5093",408,294,292,1,2,"PSOE",43
22,"22117",2478,1714,1693,22,21,"PSOE",356
31,"31031",220,131,129,0,2,"PSOE",6
16,"16141",143,102,102,0,0,"PSOE",45
44,"44250",19,12,12,0,0,"PSOE",3
16,"16003",125,105,104,0,1,"PSOE",38
44,"44149",103,78,78,3,0,"PSOE",22
9,"9085",475,347,342,2,5,"PSOE",81
24,"24092",798,606,602,1,4,"PSOE",170
16,"16004",259,198,197,2,1,"PSOE",59
19,"19055",52,41,41,1,0,"PSOE",8
30,"30043",24967,18981,18685,101,296,"PSOE",3428
14,"14037",3318,2374,2320,22,54,"PSOE",1072
47,"47091",84,71,71,2,0,"PSOE",20
6,"6152",1319,945,932,4,13,"PSOE",375
19,"19287",148,109,108,0,1,"PSOE",22
31,"31098",1903,1428,1419,19,9,"PSOE",141
34,"34147",166,118,117,0,1,"PSOE",14
9,"9311",59,46,45,0,1,"PSOE",22
31,"31132",145,109,109,0,0,"PSOE",11
28,"28094",865,624,622,4,2,"PSOE",72
40,"40132",56,37,36,1,1,"PSOE",5
14,"14066",5856,4150,4095,48,55,"PSOE",1307
39,"39076",3476,2594,2559,19,35,"PSOE",647
9,"9358",255,194,190,3,4,"PSOE",31
50,"50262",1170,896,887,15,9,"PSOE",327
49,"49007",370,255,249,1,6,"PSOE",86
29,"29086",793,470,470,3,0,"PSOE",191
44,"44151",190,151,148,0,3,"PSOE",35
19,"19018",155,119,118,3,1,"PSOE",20
47,"47174",267,218,215,1,3,"PSOE",42
40,"40215",84,60,60,0,0,"PSOE",6
28,"28095",1529,1119,1106,6,13,"PSOE",156
9,"9360",30,23,23,0,0,"PSOE",5
46,"46064",509,412,399,1,13,"PSOE",82
26,"26053",208,168,163,4,5,"PSOE",45
44,"44012",334,263,261,5,2,"PSOE",51
14,"14067",3889,2946,2899,29,47,"PSOE",1003
6,"6155",1874,1218,1202,16,16,"PSOE",485
47,"47093",813,613,600,5,13,"PSOE",160
22,"22124",201,144,143,1,1,"PSOE",38
19,"19289",28,25,24,1,1,"PSOE",2
44,"44256",38,34,34,0,0,"PSOE",5
2,"2043",1239,937,927,3,10,"PSOE",357
46,"46143",4239,3104,3053,14,51,"PSOE",639
6,"6111",500,337,337,1,0,"PSOE",178
16,"16254",214,174,170,2,4,"PSOE",37
24,"24197",763,538,533,1,5,"PSOE",131
41,"41016",7355,5248,5175,51,73,"PSOE",1371
28,"28096",18354,13310,13205,68,105,"PSOE",2563
19,"19060",146,119,118,1,1,"PSOE",19
22,"22251",364,284,284,0,0,"PSOE",48
49,"49009",393,293,288,2,5,"PSOE",47
37,"37176",133,110,110,0,0,"PSOE",32
9,"9362",208,172,171,2,1,"PSOE",38
19,"19219",13,9,9,0,0,"PSOE",0
19,"19290",834,561,558,5,3,"PSOE",100
12,"12096",777,587,577,6,10,"PSOE",202
42,"42082",8,8,8,1,0,"PSOE",0
49,"49010",345,279,273,5,6,"PSOE",85
31,"31135",106,70,66,2,4,"PSOE",5
44,"44257",166,123,119,1,4,"PSOE",37
13,"13074",974,835,828,3,7,"PSOE",298
16,"16149",148,124,122,2,2,"PSOE",42
40,"40093",77,65,65,1,0,"PSOE",7
37,"37178",100,76,75,0,1,"PSOE",16
41,"41084",2845,2124,2081,9,43,"PSOE",1047
19,"19255",79,63,61,1,2,"PSOE",18
11,"11040",397,307,292,1,15,"PSOE",170
18,"18013",4218,3024,2986,15,38,"PSOE",1091
45,"45191",543,472,468,3,4,"PSOE",197
50,"50076",78,66,65,0,1,"PSOE",23
18,"18149",5230,3903,3864,20,39,"PSOE",905
41,"41085",4086,3058,3012,22,46,"PSOE",964
47,"47095",38,31,31,0,0,"PSOE",3
49,"49011",232,168,165,6,3,"PSOE",19
24,"24065",2138,1503,1472,15,31,"PSOE",363
28,"28099",1748,1290,1283,7,7,"PSOE",202
9,"9365",29,19,19,0,0,"PSOE",4
9,"9182",80,69,67,1,2,"PSOE",10
11,"11041",9866,6477,6402,69,75,"PSOE",2270
44,"44155",1090,793,782,4,11,"PSOE",308
22,"22127",505,374,371,3,3,"PSOE",72
50,"50077",221,168,167,1,1,"PSOE",74
49,"49256",256,204,204,0,0,"PSOE",33
47,"47017",201,158,153,1,5,"PSOE",7
41,"41086",16170,10162,10088,73,74,"PSOE",3967
18,"18150",6763,4733,4678,21,55,"PSOE",1603
5,"5154",38,33,33,0,0,"PSOE",8
44,"44049",849,616,604,9,12,"PSOE",163
29,"29092",570,397,390,4,7,"PSOE",147
50,"50143",566,394,391,6,3,"PSOE",109
9,"9017",89,68,67,4,1,"PSOE",30
41,"41087",10237,6923,6774,48,149,"PSOE",2103
37,"37224",206,183,175,3,8,"PSOE",22
22,"22085",104,86,86,0,0,"PSOE",34
10,"10100",799,578,574,4,4,"PSOE",270
22,"22013",288,216,210,3,6,"PSOE",69
24,"24202",8008,5367,5276,53,91,"PSOE",1743
13,"13079",12244,8582,8450,72,132,"PSOE",2990
42,"42087",49,43,42,0,1,"PSOE",4
21,"21054",8100,5656,5571,46,85,"PSOE",1432
9,"9189",125,90,87,2,3,"PSOE",19
31,"31106",698,533,529,3,4,"PSOE",158
24,"24203",95,69,68,0,1,"PSOE",10
37,"37309",44,30,30,1,0,"PSOE",5
22,"22901",742,478,470,5,8,"PSOE",141
5,"5253",86,70,68,0,2,"PSOE",6
10,"10101",185,145,141,1,4,"PSOE",52
19,"19027",138,105,105,1,0,"PSOE",27
41,"41088",509,360,356,0,4,"PSOE",205
19,"19188",51,35,35,0,0,"PSOE",5
34,"34022",1082,873,861,9,12,"PSOE",295
10,"10010",2290,1362,1341,7,21,"PSOE",587
18,"18153",8597,6024,5972,40,52,"PSOE",1555
9,"9100",59,45,44,0,1,"PSOE",4
12,"12069",66,49,48,0,1,"PSOE",8
29,"29095",3321,2376,2307,24,69,"PSOE",1041
28,"28036",2539,1899,1878,11,21,"PSOE",292
13,"13082",25805,16871,16706,120,165,"PSOE",3811
9,"9101",76,56,55,1,1,"PSOE",6
50,"50270",38,26,26,0,0,"PSOE",3
28,"28037",1559,1177,1166,5,11,"PSOE",447
19,"19189",120,91,90,2,1,"PSOE",16
37,"37051",85,66,66,0,0,"PSOE",19
5,"5007",111,81,80,3,1,"PSOE",6
4,"4015",124,96,96,2,0,"PSOE",36
19,"19153",22,17,17,0,0,"PSOE",9
49,"49099",115,87,87,0,0,"PSOE",30
13,"13083",2423,1693,1653,10,40,"PSOE",429
44,"44052",77,56,56,0,0,"PSOE",12
46,"46123",1829,1407,1388,7,19,"PSOE",243
50,"50082",82,65,64,0,1,"PSOE",16
44,"44159",38,31,31,1,0,"PSOE",4
6,"6122",6634,4427,4321,26,106,"PSOE",1576
12,"12071",1274,992,979,3,13,"PSOE",270
2,"2013",119,92,90,0,2,"PSOE",22
31,"31043",38,31,30,1,1,"PSOE",10
5,"5161",579,459,447,3,12,"PSOE",91
6,"6032",68,53,53,1,0,"PSOE",8
22,"22904",815,579,575,8,4,"PSOE",137
31,"31143",96,55,54,1,1,"PSOE",2
21,"21059",221,166,163,5,3,"PSOE",111
10,"10106",130,109,108,2,1,"PSOE",46
31,"31010",5705,3718,3680,29,38,"PSOE",543
19,"19301",40,33,33,1,0,"PSOE",5
46,"46261",1725,1356,1337,5,19,"PSOE",335
12,"12003",976,746,736,6,10,"PSOE",89
50,"50052",90,68,68,0,0,"PSOE",12
42,"42092",56,44,42,1,2,"PSOE",7
7,"7004",3854,2574,2547,30,27,"PSOE",566
26,"26100",49,44,43,0,1,"PSOE",17
2,"2014",356,283,280,1,3,"PSOE",107
34,"34120",64214,47193,46683,331,510,"PSOE",11905
24,"24105",1459,1042,1025,16,17,"PSOE",253
47,"47101",1710,1357,1336,16,21,"PSOE",447
13,"13087",23137,15677,15480,133,197,"PSOE",3985
10,"10015",675,483,473,3,10,"PSOE",167
44,"44161",443,314,313,2,1,"PSOE",79
34,"34028",143,116,113,1,3,"PSOE",14
26,"26064",2275,1659,1638,17,21,"PSOE",431
10,"10016",330,237,235,0,2,"PSOE",105
9,"9104",53,42,42,0,0,"PSOE",0
5,"5014",5379,4009,3970,18,39,"PSOE",960
46,"46151",728,550,541,0,9,"PSOE",111
45,"45200",4592,3539,3476,14,63,"PSOE",1261
16,"16160",60,44,42,1,2,"PSOE",8
44,"44163",126,94,94,1,0,"PSOE",29
24,"24210",503,358,356,3,2,"PSOE",115
10,"10017",825,620,611,3,9,"PSOE",221
5,"5116",109,89,89,1,0,"PSOE",7
42,"42189",60,46,45,0,1,"PSOE",8
37,"37316",744,563,558,3,5,"PSOE",81
37,"37317",304,238,234,1,4,"PSOE",51
18,"18162",938,698,686,1,12,"PSOE",271
47,"47213",109,82,82,0,0,"PSOE",25
50,"50085",167,126,126,1,0,"PSOE",31
10,"10018",1689,1101,1081,6,20,"PSOE",505
2,"2058",337,234,231,0,3,"PSOE",112
49,"49104",343,234,232,0,2,"PSOE",52
34,"34170",61,42,42,0,0,"PSOE",4
28,"28109",1576,1103,1098,1,5,"PSOE",167
31,"31047",254,191,188,2,3,"PSOE",38
31,"31213",104,52,52,0,0,"PSOE",2
6,"6128",4447,2975,2935,26,40,"PSOE",1031
13,"13091",538,450,446,0,4,"PSOE",167
9,"9380",78,58,58,0,0,"PSOE",7
40,"40109",73,59,59,1,0,"PSOE",10
28,"28042",1173,890,883,3,7,"PSOE",131
45,"45102",3610,2506,2470,14,36,"PSOE",651
46,"46153",439,355,351,1,4,"PSOE",94
5,"5215",164,123,122,2,1,"PSOE",22
45,"45002",2564,1681,1665,17,16,"PSOE",514
5,"5018",29,22,22,0,0,"PSOE",6
37,"37276",143,104,103,1,1,"PSOE",18
9,"9381",30,24,24,1,0,"PSOE",4
34,"34033",17,17,17,0,0,"PSOE",1
39,"39091",1926,1493,1476,10,17,"PSOE",352
2,"2060",1294,997,983,2,14,"PSOE",278
7,"7010",4880,3395,3361,32,34,"PSOE",509
19,"19161",211,159,157,1,2,"PSOE",52
47,"47025",120,94,94,1,0,"PSOE",25
3,"3071",3982,3048,3012,26,36,"PSOE",537
5,"5021",1914,1483,1464,5,19,"PSOE",280
46,"46154",808,636,631,5,5,"PSOE",102
10,"10159",320,251,250,0,1,"PSOE",99
6,"6040",1009,648,645,1,3,"PSOE",359
14,"14052",9379,5917,5854,68,63,"PSOE",2230
19,"19081",29,22,22,1,0,"PSOE",4
24,"24078",380,289,277,0,12,"PSOE",79
16,"16121",258,202,202,3,0,"PSOE",72
7,"7011",27721,17817,17720,139,97,"PSOE",4365
37,"37279",750,522,513,4,9,"PSOE",124
26,"26142",787,612,606,3,6,"PSOE",165
40,"40155",3518,2656,2605,18,51,"PSOE",480
42,"42057",164,104,104,2,0,"PSOE",13
44,"44203",10,10,10,0,0,"PSOE",3
3,"3104",27103,19953,19787,131,166,"PSOE",4651
28,"28141",5823,4297,4262,29,35,"PSOE",570
10,"10024",695,525,520,3,5,"PSOE",104
21,"21067",414,288,287,1,1,"PSOE",148
9,"9384",295,211,206,0,5,"PSOE",36
34,"34176",133,102,101,0,1,"PSOE",8
2,"2063",1463,1073,1060,3,13,"PSOE",452
23,"23003",8688,6326,6257,52,69,"PSOE",2864
45,"45005",238,193,192,3,1,"PSOE",58
45,"45139",167,139,139,1,0,"PSOE",74
49,"49068",462,310,304,4,6,"PSOE",53
31,"31051",251,170,170,2,0,"PSOE",40
9,"9114",86,66,66,0,0,"PSOE",16
24,"24112",309,228,227,1,1,"PSOE",114
9,"9246",620,451,444,2,7,"PSOE",83
10,"10163",350,293,290,2,3,"PSOE",95
49,"49149",390,273,268,3,5,"PSOE",49
23,"23004",436,364,358,1,6,"PSOE",115
19,"19199",17,17,17,1,0,"PSOE",8
19,"19271",46,39,39,0,0,"PSOE",8
34,"34129",179,130,129,1,1,"PSOE",17
7,"7014",7320,4163,4116,45,47,"PSOE",1237
16,"16124",1858,1476,1459,12,17,"PSOE",422
40,"40073",401,345,343,3,2,"PSOE",80
13,"13902",469,367,363,0,4,"PSOE",135
9,"9387",117,95,90,0,5,"PSOE",27
47,"47189",152,119,118,0,1,"PSOE",23
5,"5025",94,79,78,0,1,"PSOE",12
23,"23045",2132,1260,1247,5,13,"PSOE",538
9,"9115",92,68,67,0,1,"PSOE",2
37,"37282",204,149,148,1,1,"PSOE",39
7,"7015",20991,12552,12433,184,119,"PSOE",1944
44,"44206",114,90,87,0,3,"PSOE",13
46,"46158",1026,811,795,6,16,"PSOE",196
31,"31053",523,372,368,1,4,"PSOE",73
10,"10165",257,208,207,0,1,"PSOE",79
37,"37068",365,267,267,1,0,"PSOE",53
26,"26040",70,60,60,0,0,"PSOE",12
9,"9072",316,242,241,0,1,"PSOE",64
46,"46054",11293,8477,8409,47,68,"PSOE",1958
4,"4027",250,159,159,0,0,"PSOE",37
9,"9117",76,60,60,0,0,"PSOE",13
42,"42107",74,54,54,3,0,"PSOE",10
23,"23006",4660,3687,3647,24,40,"PSOE",2166
26,"26074",105,86,85,1,1,"PSOE",20
19,"19202",8,6,6,0,0,"PSOE",3
46,"46237",7211,5395,5343,42,52,"PSOE",1259
18,"18127",16635,11440,11332,91,108,"PSOE",3657
42,"42200",81,59,58,2,1,"PSOE",7
5,"5128",354,281,271,2,10,"PSOE",80
50,"50062",1829,1304,1290,16,14,"PSOE",337
24,"24017",577,426,418,1,8,"PSOE",103
22,"22029",127,100,100,0,0,"PSOE",30
37,"37070",529,399,392,1,7,"PSOE",80
14,"14001",3514,2837,2789,28,48,"PSOE",1146
44,"44175",122,85,84,1,1,"PSOE",23
46,"46238",13282,9786,9721,61,65,"PSOE",1605
22,"22151",93,64,64,1,0,"PSOE",5
46,"46081",10134,7771,7702,41,69,"PSOE",1495
39,"39007",417,278,275,2,3,"PSOE",55
7,"7019",187,133,129,2,4,"PSOE",8
5,"5227",358,253,250,1,3,"PSOE",55
26,"26042",834,635,625,5,10,"PSOE",239
47,"47005",549,413,408,2,5,"PSOE",97
34,"34133",107,91,90,0,1,"PSOE",12
22,"22032",110,76,74,0,2,"PSOE",26
9,"9391",361,264,263,3,1,"PSOE",65
34,"34045",76,66,66,2,0,"PSOE",14
45,"45010",415,311,310,2,1,"PSOE",136
44,"44067",114,81,81,1,0,"PSOE",22
2,"2029",3282,2467,2445,17,22,"PSOE",697
41,"41071",5586,3724,3661,22,63,"PSOE",1517
6,"6142",273,205,197,2,8,"PSOE",114
44,"44142",35,27,27,0,0,"PSOE",6
24,"24086",270,223,218,0,5,"PSOE",48
40,"40036",515,421,410,3,11,"PSOE",65
3,"3049",12088,9121,9027,52,94,"PSOE",2030
45,"45045",1318,905,888,5,17,"PSOE",267
22,"22156",289,220,220,2,0,"PSOE",54
39,"39008",13877,10258,10153,96,105,"PSOE",2659
22,"22035",234,165,159,3,6,"PSOE",70
21,"21076",2121,1458,1437,17,21,"PSOE",716
44,"44068",659,509,503,3,6,"PSOE",140
31,"31091",351,220,217,1,3,"PSOE",14
33,"33046",499,379,367,5,12,"PSOE",91
33,"33015",1540,998,986,8,12,"PSOE",251
19,"19209",40,29,29,1,0,"PSOE",9
9,"9392",53,40,37,1,3,"PSOE",5
47,"47033",196,154,154,1,0,"PSOE",28
42,"42115",61,47,47,1,0,"PSOE",2
31,"31158",255,180,179,3,1,"PSOE",10
4,"4031",2338,1772,1762,2,10,"PSOE",880
47,"47194",298,239,237,2,2,"PSOE",42
34,"34186",52,45,45,0,0,"PSOE",10
45,"45080",6,6,6,0,0,"PSOE",1
46,"46084",1576,1263,1242,5,21,"PSOE",294
45,"45113",1915,1390,1366,6,24,"PSOE",375
44,"44070",53,48,48,0,0,"PSOE",9
16,"16185",43,37,37,0,0,"PSOE",15
37,"37333",224,142,142,1,0,"PSOE",28
19,"19210",21,19,18,1,1,"PSOE",1
18,"18042",403,324,322,2,2,"PSOE",95
4,"4096",266,209,208,0,1,"PSOE",98
42,"42207",40,33,32,0,1,"PSOE",5
31,"31027",836,532,530,2,2,"PSOE",17
31,"31060",13744,9400,9320,72,80,"PSOE",1616
14,"14005",6311,4143,4084,72,59,"PSOE",1365
39,"39010",631,480,475,7,5,"PSOE",153
12,"12118",72,55,53,0,2,"PSOE",12
10,"10174",174,135,132,0,3,"PSOE",41
28,"28052",3855,2626,2587,11,39,"PSOE",428
37,"37079",77,73,73,1,0,"PSOE",9
22,"22039",863,671,667,4,4,"PSOE",174
9,"9127",56,41,39,0,2,"PSOE",3
10,"10037",76232,55104,54464,418,640,"PSOE",12452
31,"31028",212,131,131,0,0,"PSOE",10
31,"31127",138,98,95,0,3,"PSOE",3
28,"28053",6498,4995,4955,28,40,"PSOE",810
41,"41010",4420,2960,2916,30,44,"PSOE",847
47,"47196",34,27,27,0,0,"PSOE",1
42,"42071",171,115,115,3,0,"PSOE",23
3,"3083",5586,3971,3928,33,43,"PSOE",1152
40,"40001",702,560,554,3,6,"PSOE",115
19,"19323",40,31,31,0,0,"PSOE",11
18,"18045",1126,756,742,4,14,"PSOE",385
37,"37209",412,272,270,7,2,"PSOE",100
16,"16139",335,256,255,2,1,"PSOE",63
10,"10131",12861,8813,8721,52,92,"PSOE",2238
21,"21041",113337,72318,71637,748,681,"PSOE",20875
29,"29082",31885,22572,22400,152,172,"PSOE",4522
44,"44247",316,218,215,3,3,"PSOE",61
23,"23056",3088,2243,2203,15,40,"PSOE",858
37,"37211",224,172,172,4,0,"PSOE",25
41,"41099",3976,2369,2347,12,22,"PSOE",1190
9,"9259",230,186,186,5,0,"PSOE",46
46,"46243",138,115,112,1,3,"PSOE",22
39,"39073",9837,7356,7298,31,58,"PSOE",1461
13,"13064",1696,1231,1225,9,6,"PSOE",377
2,"2078",920,675,664,1,11,"PSOE",219
24,"24025",297,228,227,0,1,"PSOE",36
9,"9261",469,332,329,2,3,"PSOE",81
24,"24123",746,488,485,2,3,"PSOE",158
22,"22041",163,134,134,1,0,"PSOE",36
46,"46009",3121,2459,2427,8,32,"PSOE",550
5,"5043",84,66,66,0,0,"PSOE",21
2,"2038",281,223,223,0,0,"PSOE",61
7,"7028",899,601,595,7,6,"PSOE",97
10,"10180",4134,2643,2601,25,42,"PSOE",868
18,"18047",5903,3893,3857,28,36,"PSOE",975
3,"3085",272,217,213,0,4,"PSOE",47
28,"28056",863,630,617,4,13,"PSOE",110
7,"7029",4166,2949,2913,37,36,"PSOE",813
44,"44077",74,60,58,0,2,"PSOE",29
39,"39014",883,619,614,6,5,"PSOE",134
50,"50198",54,41,41,1,0,"PSOE",12
22,"22164",35,28,28,0,0,"PSOE",7
16,"16047",232,175,175,2,0,"PSOE",41
49,"49125",1391,933,918,10,15,"PSOE",229
24,"24228",660,430,422,6,8,"PSOE",57
29,"29029",403,298,294,2,4,"PSOE",93
49,"49042",244,178,176,1,2,"PSOE",29
50,"50104",348,271,269,2,2,"PSOE",100
30,"30013",7396,5147,5102,32,45,"PSOE",2039
42,"42079",26,18,18,1,0,"PSOE",0
10,"10136",302,218,215,4,3,"PSOE",82
37,"37215",136,104,103,1,1,"PSOE",33
50,"50041",12,9,9,0,0,"PSOE",6
2,"2081",18342,13244,13075,80,169,"PSOE",3641
7,"7030",1551,1127,1101,13,26,"PSOE",144
9,"9406",251,192,191,2,1,"PSOE",27
47,"47039",185,141,140,0,1,"PSOE",55
34,"34204",46,41,41,0,0,"PSOE",6
31,"31165",2780,1995,1960,30,35,"PSOE",576
5,"5047",4163,3198,3142,17,56,"PSOE",1033
46,"46220",48410,34644,34292,279,352,"PSOE",6537
23,"23020",1590,1370,1349,9,21,"PSOE",434
50,"50011",122,95,94,1,1,"PSOE",45
18,"18050",1710,1165,1152,3,13,"PSOE",425
7,"7031",23833,14836,14707,124,129,"PSOE",3101
42,"42125",70,59,59,1,0,"PSOE",24
10,"10045",1019,762,755,3,7,"PSOE",332
19,"19330",71,63,63,2,0,"PSOE",25
22,"22168",23,18,18,0,0,"PSOE",5
10,"10046",203,168,168,1,0,"PSOE",68
9,"9133",40,32,32,0,0,"PSOE",5
31,"31166",258,181,181,1,0,"PSOE",16
9,"9408",41,36,36,0,0,"PSOE",4
45,"45121",6796,4743,4692,22,51,"PSOE",1072
31,"31167",826,606,596,9,10,"PSOE",67
12,"12125",216,180,177,0,3,"PSOE",46
37,"37175",403,314,312,6,2,"PSOE",54
6,"6020",1815,1366,1345,10,21,"PSOE",508
4,"4043",549,465,461,1,4,"PSOE",144
42,"42174",174,137,135,5,2,"PSOE",42
22,"22170",651,498,491,5,7,"PSOE",91
50,"50013",219,180,180,0,0,"PSOE",73
31,"31903",6654,4402,4343,27,59,"PSOE",910
14,"14012",6173,4364,4291,35,73,"PSOE",1822
40,"40009",49,43,43,0,0,"PSOE",9
46,"46013",17383,13569,13483,82,86,"PSOE",2345
34,"34154",74,55,53,1,2,"PSOE",9
19,"19331",2609,1872,1844,12,28,"PSOE",532
40,"40136",112,88,87,0,1,"PSOE",9
49,"49047",107,75,75,0,0,"PSOE",16
5,"5196",50,37,36,0,1,"PSOE",15
46,"46170",3417,2714,2688,10,26,"PSOE",820
6,"6067",1972,1308,1292,8,16,"PSOE",527
30,"30017",11605,8541,8451,46,90,"PSOE",2226
9,"9013",48,37,37,0,0,"PSOE",3
12,"12028",12586,9733,9676,62,57,"PSOE",1457
9,"9136",192,142,137,2,5,"PSOE",23
10,"10187",438,308,305,1,3,"PSOE",115
19,"19220",2302,1519,1501,1,18,"PSOE",249
40,"40010",121,102,101,1,1,"PSOE",10
16,"16053",426,351,347,5,4,"PSOE",126
6,"6068",446,347,345,5,2,"PSOE",171
5,"5198",73,62,62,0,0,"PSOE",7
10,"10050",1053,846,837,6,9,"PSOE",332
2,"2086",2586,1701,1687,7,14,"PSOE",678
47,"47206",92,80,80,0,0,"PSOE",28
44,"44190",71,58,56,0,2,"PSOE",15
10,"10051",430,308,296,0,12,"PSOE",132
23,"23027",723,576,572,3,4,"PSOE",321
7,"7036",26955,18578,18433,148,145,"PSOE",3313
24,"24132",615,379,375,1,4,"PSOE",89
50,"50015",96,67,67,0,0,"PSOE",33
37,"37222",93,72,72,0,0,"PSOE",9
40,"40140",92,69,67,0,2,"PSOE",18
9,"9137",174,132,131,3,1,"PSOE",21
7,"7037",3197,1934,1917,26,17,"PSOE",394
12,"12031",3807,2941,2894,24,47,"PSOE",530
47,"47207",278,215,212,3,3,"PSOE",51
5,"5055",568,456,451,4,5,"PSOE",111
21,"21012",316,235,233,2,2,"PSOE",90
49,"49052",187,133,132,1,1,"PSOE",32
9,"9273",52,40,39,2,1,"PSOE",6
19,"19222",110,82,82,0,0,"PSOE",22
12,"12068",48,36,35,1,1,"PSOE",6
19,"19150",128,99,99,1,0,"PSOE",27
37,"37139",205,169,168,2,1,"PSOE",20
19,"19296",30,19,18,0,1,"PSOE",3
3,"3094",9080,6440,6396,34,44,"PSOE",1006
18,"18903",889,669,661,5,8,"PSOE",267
50,"50016",52,40,40,0,0,"PSOE",11
4,"4047",2281,1893,1878,11,15,"PSOE",706
45,"45026",211,167,166,2,1,"PSOE",69
28,"28161",48848,35503,35203,210,300,"PSOE",5880
37,"37182",75,56,55,0,1,"PSOE",5
40,"40224",22,21,21,0,0,"PSOE",2
42,"42007",113,86,86,5,0,"PSOE",15
41,"41021",21294,13762,13570,145,192,"PSOE",4988
24,"24034",3394,2380,2342,28,38,"PSOE",845
45,"45094",387,298,297,1,1,"PSOE",86
50,"50176",236,165,165,3,0,"PSOE",58
13,"13080",351,266,266,2,0,"PSOE",78
30,"30021",9099,6095,6045,20,50,"PSOE",1283
23,"23030",1238,968,960,3,8,"PSOE",609
10,"10055",710,505,497,1,8,"PSOE",122
34,"34067",127,93,93,1,0,"PSOE",26
28,"28064",129,106,106,2,0,"PSOE",28
9,"9414",189,148,146,0,2,"PSOE",37
44,"44263",376,266,263,3,3,"PSOE",73
24,"24136",540,387,383,4,4,"PSOE",74
50,"50114",116,89,88,0,1,"PSOE",27
33,"33031",35120,22295,22024,271,271,"PSOE",6309
3,"3096",5786,4358,4289,17,69,"PSOE",850
22,"22051",100,81,81,0,0,"PSOE",24
46,"46174",972,764,752,2,12,"PSOE",270
37,"37352",207,153,152,1,1,"PSOE",39
26,"26096",245,190,190,1,0,"PSOE",36
39,"39024",1879,1390,1372,2,18,"PSOE",375
30,"30022",16913,11371,11214,93,157,"PSOE",2809
12,"12001",1051,821,800,4,21,"PSOE",233
26,"26169",64,60,60,0,0,"PSOE",14
29,"29040",1977,1290,1278,12,12,"PSOE",465
6,"6076",831,611,607,2,4,"PSOE",211
47,"47182",1323,977,967,8,10,"PSOE",296
37,"37353",126,97,97,1,0,"PSOE",28
47,"47129",871,664,659,4,5,"PSOE",178
31,"31242",260,164,163,1,1,"PSOE",16
22,"22131",82,63,63,0,0,"PSOE",23
49,"49057",109,85,83,1,2,"PSOE",18
37,"37102",404,307,305,2,2,"PSOE",74
9,"9021",56,33,31,1,2,"PSOE",1
49,"49223",752,608,600,4,8,"PSOE",111
24,"24207",294,241,238,3,3,"PSOE",75
44,"44265",186,141,138,2,3,"PSOE",22
28,"28038",4952,3730,3688,34,42,"PSOE",699
50,"50272",12904,8880,8819,84,61,"PSOE",2082
33,"33063",415,320,318,3,2,"PSOE",89
13,"13086",175,137,134,0,3,"PSOE",49
46,"46176",2017,1358,1349,5,9,"PSOE",274
19,"19074",72,62,62,0,0,"PSOE",12
5,"5063",32,28,27,0,1,"PSOE",1
44,"44094",113,94,94,0,0,"PSOE",14
31,"31244",158,87,86,1,1,"PSOE",9
10,"10152",468,340,332,1,8,"PSOE",147
33,"33003",646,355,352,9,3,"PSOE",114
49,"49178",705,496,487,4,9,"PSOE",78
30,"30025",4908,3667,3630,16,37,"PSOE",1148
42,"42012",35,28,28,0,0,"PSOE",6
18,"18909",579,435,429,0,6,"PSOE",200
42,"42144",436,353,348,2,5,"PSOE",98
49,"49179",371,238,237,0,1,"PSOE",46
9,"9419",78,55,55,0,0,"PSOE",3
18,"18067",702,469,466,0,3,"PSOE",215
22,"22182",250,161,158,1,3,"PSOE",43
50,"50022",530,397,390,7,7,"PSOE",109
34,"34222",120,87,87,3,0,"PSOE",2
16,"16215",242,172,169,2,3,"PSOE",70
3,"3099",42319,31083,30801,165,282,"PSOE",5801
13,"13036",799,601,595,2,6,"PSOE",218
10,"10062",406,337,331,0,6,"PSOE",167
6,"6081",1074,806,792,7,14,"PSOE",393
44,"44055",69,56,56,4,0,"PSOE",11
2,"2057",2020,1487,1461,10,26,"PSOE",620
31,"31079",73,54,53,0,1,"PSOE",5
40,"40150",69,61,61,1,0,"PSOE",12
3,"3069",3076,2123,2102,17,21,"PSOE",385
5,"5117",200,174,173,1,1,"PSOE",20
9,"9281",145,114,109,1,5,"PSOE",29
10,"10064",1476,1092,1072,7,20,"PSOE",432
42,"42014",64,43,43,1,0,"PSOE",9
22,"22057",370,271,270,3,1,"PSOE",115
49,"49062",122,90,89,0,1,"PSOE",20
21,"21022",171,107,105,0,2,"PSOE",49
50,"50086",187,132,128,2,4,"PSOE",61
49,"49266",76,63,61,2,2,"PSOE",19
26,"26066",251,201,194,1,7,"PSOE",32
47,"47214",1409,1087,1062,7,25,"PSOE",243
12,"12137",36,23,23,0,0,"PSOE",11
50,"50024",571,437,437,6,0,"PSOE",199
49,"49183",100,77,77,2,0,"PSOE",10
42,"42016",18,14,14,0,0,"PSOE",3
34,"34224",47,37,37,1,0,"PSOE",10
5,"5119",32,22,22,0,0,"PSOE",0
7,"7049",1480,1003,993,14,10,"PSOE",144
31,"31081",338,216,212,4,4,"PSOE",13
4,"4055",371,310,308,0,2,"PSOE",164
19,"19120",101,88,88,1,0,"PSOE",14
10,"10204",429,331,329,6,2,"PSOE",88
22,"22187",293,218,216,2,2,"PSOE",40
34,"34077",347,244,238,4,6,"PSOE",67
12,"12107",355,303,299,4,4,"PSOE",88
44,"44167",38,31,31,0,0,"PSOE",12
16,"16219",89,71,71,0,0,"PSOE",32
23,"23041",499,398,394,2,4,"PSOE",147
34,"34225",4921,3588,3559,30,29,"PSOE",1000
5,"5216",220,171,168,0,3,"PSOE",20
9,"9288",90,70,70,0,0,"PSOE",13
30,"30029",11864,8125,8058,73,67,"PSOE",2360
19,"19306",25,20,20,1,0,"PSOE",2
28,"28072",5709,4356,4324,22,32,"PSOE",621
31,"31249",1872,1290,1273,14,17,"PSOE",483
3,"3072",348,289,285,0,4,"PSOE",68
23,"23080",1762,1332,1322,4,10,"PSOE",780
46,"46207",6676,5106,5040,41,66,"PSOE",967
16,"16073",185,164,164,1,0,"PSOE",65
26,"26036",16986,11940,11816,66,124,"PSOE",2711
28,"28044",5826,4445,4409,24,36,"PSOE",729
13,"13044",2671,1960,1936,13,24,"PSOE",647
40,"40028",105,91,90,2,1,"PSOE",9
9,"9471",149,114,114,1,0,"PSOE",16
16,"16225",73,57,57,3,0,"PSOE",12
41,"41032",3984,2811,2725,27,86,"PSOE",1228
31,"31183",691,544,542,4,2,"PSOE",61
5,"5219",38,30,30,0,0,"PSOE",4
37,"37239",217,185,183,3,2,"PSOE",42
47,"47053",119,98,96,0,2,"PSOE",15
7,"7053",1188,926,918,16,8,"PSOE",146
31,"31117",620,383,375,3,8,"PSOE",7
5,"5123",97,73,73,1,0,"PSOE",8
18,"18076",804,551,549,1,2,"PSOE",362
12,"12141",101,83,83,0,0,"PSOE",12
9,"9160",85,64,64,0,0,"PSOE",10
39,"39033",568,418,415,2,3,"PSOE",141
22,"22190",119,86,85,0,1,"PSOE",32
31,"31184",62,44,44,3,0,"PSOE",0
10,"10208",123,94,93,1,1,"PSOE",47
44,"44204",24,21,21,0,0,"PSOE",11
18,"18033",282,201,200,5,1,"PSOE",107
19,"19309",26,21,21,0,0,"PSOE",1
23,"23044",4816,3663,3569,27,94,"PSOE",1281
47,"47137",29,25,25,1,0,"PSOE",3
40,"40030",473,369,363,3,6,"PSOE",108
44,"44105",82,64,64,0,0,"PSOE",19
26,"26006",1800,1419,1405,8,14,"PSOE",442
10,"10072",859,617,615,5,2,"PSOE",325
16,"16231",46,37,37,0,0,"PSOE",8
31,"31152",1328,924,900,11,24,"PSOE",177
46,"46027",943,780,771,5,9,"PSOE",192
24,"24113",366,293,287,5,6,"PSOE",68
9,"9429",56,41,41,0,0,"PSOE",7
37,"37022",268,215,215,2,0,"PSOE",33
5,"5078",115,91,89,1,2,"PSOE",12
46,"46184",26505,20428,20223,115,205,"PSOE",4412
31,"31086",13188,9713,9642,111,71,"PSOE",1091
33,"33042",4306,2988,2970,35,18,"PSOE",662
10,"10211",444,337,336,0,1,"PSOE",169
5,"5027",269,229,225,2,4,"PSOE",27
31,"31054",462,255,250,4,5,"PSOE",28
41,"41035",1108,794,780,7,14,"PSOE",357
50,"50902",87,79,79,2,0,"PSOE",14
37,"37367",201,164,161,0,3,"PSOE",22
3,"3107",2508,1755,1744,7,11,"PSOE",328
10,"10212",1684,1233,1203,7,30,"PSOE",393
5,"5225",372,285,281,1,4,"PSOE",39
42,"42157",13,10,10,0,0,"PSOE",0
30,"30004",1137,870,862,3,8,"PSOE",318
9,"9389",73,60,60,1,0,"PSOE",13
31,"31154",224,126,126,3,0,"PSOE",11
44,"44066",108,79,74,0,5,"PSOE",30
9,"9164",157,127,126,0,1,"PSOE",22
5,"5080",58,45,43,0,2,"PSOE",7
34,"34233",130,107,107,1,0,"PSOE",17
28,"28076",398,325,317,1,8,"PSOE",67
16,"16237",110,87,87,0,0,"PSOE",13
24,"24051",423,309,307,0,2,"PSOE",73
46,"46029",20613,14964,14879,93,85,"PSOE",2852
49,"49076",321,217,217,2,0,"PSOE",45
41,"41092",7743,5358,5311,55,47,"PSOE",2843
5,"5178",368,284,280,0,4,"PSOE",46
9,"9346",92,64,63,1,1,"PSOE",13
24,"24116",417,314,309,1,5,"PSOE",77
16,"16175",5095,3980,3914,35,66,"PSOE",1596
24,"24052",158,104,102,0,2,"PSOE",36
46,"46030",800,627,614,5,13,"PSOE",161
3,"3017",374,314,307,1,7,"PSOE",71
7,"7060",2568,1677,1653,16,24,"PSOE",270
34,"34236",156,120,119,0,1,"PSOE",16
31,"31090",144,77,77,1,0,"PSOE",6
37,"37330",339,248,246,0,2,"PSOE",63
16,"16036",126,109,106,0,3,"PSOE",32
50,"50284",141,107,104,0,3,"PSOE",42
7,"7020",3581,2542,2502,43,40,"PSOE",414
10,"10170",267,210,206,3,4,"PSOE",58
39,"39069",1972,1510,1489,12,21,"PSOE",436
31,"31257",875,634,625,8,9,"PSOE",115
24,"24053",442,286,280,1,6,"PSOE",55
47,"47058",200,145,143,0,2,"PSOE",39
9,"9433",60,48,45,1,3,"PSOE",8
16,"16177",78,64,64,0,0,"PSOE",14
46,"46083",15422,11179,11049,86,130,"PSOE",1812
37,"37373",748,503,499,1,4,"PSOE",208
46,"46213",15409,10924,10805,97,119,"PSOE",2570
37,"37028",147,116,112,0,4,"PSOE",22
46,"46031",10535,7543,7451,66,92,"PSOE",1702
34,"34089",155,124,124,2,0,"PSOE",14
13,"13004",1025,807,800,4,7,"PSOE",319
5,"5085",35,27,27,0,0,"PSOE",2
50,"50034",826,567,563,5,4,"PSOE",186
7,"7062",7513,4273,4219,52,54,"PSOE",1135
42,"42162",2352,1637,1601,16,36,"PSOE",288
9,"9434",1227,922,909,6,13,"PSOE",170
30,"30038",15411,10847,10767,46,80,"PSOE",2129
9,"9394",715,533,521,3,12,"PSOE",157
45,"45047",2606,1666,1647,6,19,"PSOE",255
4,"4065",363,284,282,7,2,"PSOE",140
10,"10082",1868,1451,1412,11,39,"PSOE",602
37,"37374",1166,935,919,9,16,"PSOE",280
40,"40039",210,156,153,3,3,"PSOE",13
24,"24054",430,314,313,1,1,"PSOE",74
41,"41041",9706,7239,7120,36,119,"PSOE",2713
47,"47224",87,76,76,0,0,"PSOE",17
9,"9041",28,27,27,0,0,"PSOE",8
47,"47034",72,58,58,3,0,"PSOE",8
14,"14033",1283,971,959,9,12,"PSOE",472
6,"6100",935,780,774,1,6,"PSOE",331
45,"45048",358,278,275,1,3,"PSOE",92
45,"45147",581,450,446,1,4,"PSOE",150
47,"47060",258,216,214,1,2,"PSOE",43
10,"10083",90,59,59,2,0,"PSOE",11
45,"45148",292,223,223,0,0,"PSOE",71
30,"30039",19277,13165,13054,75,111,"PSOE",2641
24,"24157",2568,1943,1911,22,32,"PSOE",402
13,"13008",438,299,295,0,4,"PSOE",96
29,"29025",39665,25907,25714,192,193,"PSOE",5464
18,"18181",223,174,172,0,2,"PSOE",31
9,"9307",109,81,80,0,1,"PSOE",34
22,"22074",313,228,225,4,3,"PSOE",52
9,"9438",538,437,433,6,4,"PSOE",106
9,"9439",1028,752,744,9,8,"PSOE",136
4,"4067",570,441,436,2,5,"PSOE",231
34,"34094",64,45,44,0,1,"PSOE",6
3,"3022",145,125,125,0,0,"PSOE",11
40,"40041",979,725,717,5,8,"PSOE",166
23,"23055",47167,31479,31198,264,281,"PSOE",9866
9,"9398",75,56,56,0,0,"PSOE",20
46,"46008",2651,2108,2089,21,19,"PSOE",439
12,"12120",177,152,152,0,0,"PSOE",42
10,"10904",745,507,504,8,3,"PSOE",177
26,"26119",197,156,155,4,1,"PSOE",74
24,"24090",343,235,233,1,2,"PSOE",48
49,"49202",187,130,130,4,0,"PSOE",27
42,"42032",146,118,118,0,0,"PSOE",23
6,"6104",674,491,487,3,4,"PSOE",261
21,"21042",15350,7643,7530,124,113,"PSOE",2081
16,"16093",60,49,47,0,2,"PSOE",10
18,"18094",2359,1744,1720,14,24,"PSOE",577
24,"24159",1806,1386,1366,6,20,"PSOE",254
12,"12057",606,487,474,5,13,"PSOE",129
16,"16247",67,58,58,0,0,"PSOE",20
19,"19136",18,14,14,0,0,"PSOE",8
16,"16094",127,96,94,0,2,"PSOE",16
33,"33051",7061,4640,4587,27,53,"PSOE",1249
26,"26017",381,293,293,5,0,"PSOE",101
12,"12022",344,265,262,2,3,"PSOE",62
5,"5238",782,565,563,5,2,"PSOE",154
24,"24160",684,483,474,6,9,"PSOE",76
22,"22206",193,129,128,1,1,"PSOE",53
44,"44009",809,596,593,7,3,"PSOE",173
9,"9084",186,136,135,4,1,"PSOE",25
40,"40213",86,65,65,3,0,"PSOE",17
28,"28154",5408,3806,3767,16,39,"PSOE",874
44,"44217",29,25,25,3,0,"PSOE",8
18,"18096",341,227,224,3,3,"PSOE",134
19,"19139",29,19,18,0,1,"PSOE",5
3,"3118",2437,1659,1642,4,17,"PSOE",289
6,"6107",1581,999,995,8,4,"PSOE",523
24,"24059",880,536,535,4,1,"PSOE",213
26,"26121",25,22,22,0,0,"PSOE",8
40,"40046",89,75,75,1,0,"PSOE",20
30,"30901",10309,7821,7718,43,103,"PSOE",1714
50,"50231",250,195,192,4,3,"PSOE",64
3,"3025",1270,950,941,2,9,"PSOE",277
2,"2040",559,484,483,3,1,"PSOE",159
16,"16143",16,14,14,2,0,"PSOE",2
40,"40174",349,254,251,2,3,"PSOE",26
6,"6108",2275,1567,1527,11,40,"PSOE",566
5,"5240",3374,2283,2257,7,26,"PSOE",472
9,"9443",179,128,124,0,4,"PSOE",15
9,"9312",96,78,77,0,1,"PSOE",9
40,"40047",30,25,25,0,0,"PSOE",7
9,"9048",1467,1048,1033,13,15,"PSOE",224
13,"13017",256,200,197,0,3,"PSOE",71
9,"9178",47,35,35,0,0,"PSOE",6
33,"33054",1682,1159,1149,12,10,"PSOE",355
22,"22209",155,120,120,3,0,"PSOE",36
19,"19143",1738,1306,1297,12,9,"PSOE",329
46,"46116",13159,10193,10135,53,58,"PSOE",1842
31,"31199",146,92,89,3,3,"PSOE",7
49,"49207",239,150,146,0,4,"PSOE",43
18,"18099",1584,1228,1206,14,22,"PSOE",406
18,"18098",6135,4206,4161,21,45,"PSOE",1683
5,"5242",681,559,558,8,1,"PSOE",58
41,"41048",2228,1470,1447,15,23,"PSOE",706
47,"47066",1268,981,977,12,4,"PSOE",214
3,"3027",157,138,135,0,3,"PSOE",30
21,"21047",1917,1111,1065,15,46,"PSOE",464
28,"28157",609,433,430,1,3,"PSOE",71
26,"26021",2827,2098,2076,15,22,"PSOE",497
3,"3121",21273,14569,14468,62,101,"PSOE",2718
45,"45155",355,291,285,0,6,"PSOE",124
31,"31134",176,125,124,0,1,"PSOE",17
44,"44045",366,274,269,2,5,"PSOE",70
50,"50074",6366,4230,4165,31,65,"PSOE",1320
13,"13020",4781,3198,3161,31,37,"PSOE",1095
10,"10094",234,196,196,1,0,"PSOE",105
31,"31101",1373,973,966,8,7,"PSOE",86
49,"49091",260,193,193,0,0,"PSOE",63
41,"41017",15158,10718,10616,92,102,"PSOE",2771
47,"47150",274,209,205,0,4,"PSOE",37
42,"42039",226,138,138,4,0,"PSOE",39
26,"26022",198,164,163,1,1,"PSOE",17
42,"42175",21,16,16,0,0,"PSOE",0
14,"14041",3182,2296,2251,33,45,"PSOE",640
47,"47231",4401,3299,3277,24,22,"PSOE",691
19,"19021",1030,759,744,7,15,"PSOE",213
44,"44120",222,154,150,2,4,"PSOE",32
37,"37001",192,151,148,0,3,"PSOE",31
28,"28158",665,537,533,4,4,"PSOE",54
37,"37002",139,87,86,0,1,"PSOE",24
11,"11006",24455,15750,15587,193,163,"PSOE",6311
31,"31003",122,87,87,0,0,"PSOE",10
46,"46256",6853,4951,4890,25,61,"PSOE",862
31,"31203",40,28,28,0,0,"PSOE",11
31,"31103",42,34,34,2,0,"PSOE",3
24,"24166",1407,1013,993,8,20,"PSOE",280
13,"13023",8973,6291,6242,44,49,"PSOE",1044
47,"47151",27,24,24,0,0,"PSOE",1
22,"22214",128,106,105,3,1,"PSOE",12
46,"46197",1942,1527,1514,5,13,"PSOE",285
37,"37305",216,171,170,0,1,"PSOE",31
50,"50141",109,90,90,1,0,"PSOE",15
9,"9055",52,42,41,1,1,"PSOE",12
45,"45158",2514,1777,1760,11,17,"PSOE",469
26,"26024",228,181,181,0,0,"PSOE",48
39,"39051",66,57,57,0,0,"PSOE",9
19,"19023",124,100,98,2,2,"PSOE",22
42,"42178",115,83,83,0,0,"PSOE",18
26,"26025",87,71,70,1,1,"PSOE",27
18,"18105",3782,2450,2420,17,30,"PSOE",1198
3,"3124",460,388,384,3,4,"PSOE",86
2,"2007",1030,824,818,4,6,"PSOE",403
45,"45059",1712,1337,1311,1,26,"PSOE",334
45,"45060",173,126,125,1,1,"PSOE",73
39,"39052",18236,13537,13380,110,157,"PSOE",2496
5,"5201",523,419,418,1,1,"PSOE",97
37,"37181",286,210,207,4,3,"PSOE",58
31,"31072",5279,3734,3679,40,55,"PSOE",983
50,"50047",48,36,36,0,0,"PSOE",14
44,"44123",105,71,70,1,1,"PSOE",16
23,"23067",2460,1831,1805,11,26,"PSOE",573
37,"37005",74,54,54,2,0,"PSOE",8
45,"45160",1109,874,864,6,10,"PSOE",205
9,"9450",28,22,21,0,1,"PSOE",6
12,"12130",404,340,335,0,5,"PSOE",28
3,"3127",350,278,273,1,5,"PSOE",88
37,"37267",200,156,147,2,9,"PSOE",37
23,"23069",5353,4310,4212,27,98,"PSOE",1786
3,"3033",117,96,95,0,1,"PSOE",11
34,"34110",88,71,71,1,0,"PSOE",22
16,"16204",261,199,199,1,0,"PSOE",60
39,"39053",219,153,152,2,1,"PSOE",36
24,"24169",2969,2140,2118,13,22,"PSOE",794
6,"6119",689,501,499,4,2,"PSOE",226
50,"50144",34,29,29,2,0,"PSOE",4
45,"45161",13688,9007,8902,32,105,"PSOE",1570
40,"40184",258,211,210,2,1,"PSOE",22
3,"3095",4579,3489,3459,25,30,"PSOE",690
18,"18108",850,659,656,3,3,"PSOE",263
5,"5254",190,160,159,0,1,"PSOE",36
39,"39054",4493,3376,3334,33,42,"PSOE",858
40,"40185",863,646,642,3,4,"PSOE",145
44,"44226",140,98,98,2,0,"PSOE",33
18,"18109",597,411,408,2,3,"PSOE",140
49,"49098",219,167,165,0,2,"PSOE",36
40,"40058",325,277,276,4,1,"PSOE",50
46,"46044",4218,3222,3158,18,64,"PSOE",864
24,"24069",41,35,35,0,0,"PSOE",2
24,"24102",652,470,467,2,3,"PSOE",177
3,"3128",4092,2861,2840,10,21,"PSOE",428
40,"40186",42,29,29,0,0,"PSOE",6
37,"37144",363,277,276,1,1,"PSOE",70
2,"2012",1835,1476,1453,7,23,"PSOE",681
22,"22221",84,58,58,0,0,"PSOE",4
40,"40059",110,95,95,1,0,"PSOE",15
31,"31109",1582,1155,1150,9,5,"PSOE",117
45,"45030",478,368,360,2,8,"PSOE",131
42,"42185",26,22,22,0,0,"PSOE",6
34,"34114",207,144,144,0,0,"PSOE",14
5,"5258",111,95,95,0,0,"PSOE",23
19,"19033",64,52,50,1,2,"PSOE",11
26,"26170",446,330,326,2,4,"PSOE",70
28,"28134",61008,45177,44904,263,273,"PSOE",9106
44,"44127",68,51,51,0,0,"PSOE",17
24,"24171",356,197,196,0,1,"PSOE",51
31,"31110",91,61,58,1,3,"PSOE",13
37,"37313",550,386,384,2,2,"PSOE",109
4,"4081",355,287,287,0,0,"PSOE",178
31,"31209",155,107,106,0,1,"PSOE",7
28,"28010",9963,7745,7688,25,57,"PSOE",1113
13,"13034",58191,42423,42027,291,396,"PSOE",8724
19,"19155",66,56,56,0,0,"PSOE",16
9,"9148",87,70,68,3,2,"PSOE",16
46,"46099",901,689,684,1,5,"PSOE",226
37,"37356",87,67,65,0,2,"PSOE",16
39,"39057",2330,1671,1645,7,26,"PSOE",436
42,"42188",50,39,38,0,1,"PSOE",14
45,"45165",62718,44420,44006,236,414,"PSOE",11031
28,"28011",442,317,316,1,1,"PSOE",56
12,"12073",152,119,117,0,2,"PSOE",32
5,"5115",523,378,373,0,5,"PSOE",61
26,"26136",107,85,85,0,0,"PSOE",15
40,"40190",53,45,44,0,1,"PSOE",6
46,"46262",223,162,159,2,3,"PSOE",23
9,"9195",59,36,36,2,0,"PSOE",5
46,"46125",847,689,684,5,5,"PSOE",197
49,"49226",255,198,195,0,3,"PSOE",57
31,"31112",89,62,62,0,0,"PSOE",7
22,"22019",180,151,150,2,1,"PSOE",44
39,"39058",810,559,557,2,2,"PSOE",197
50,"50054",58,50,50,0,0,"PSOE",13
3,"3038",355,288,285,3,3,"PSOE",67
9,"9460",176,131,131,1,0,"PSOE",19
45,"45067",2318,1791,1752,19,39,"PSOE",444
23,"23075",3298,2564,2541,18,23,"PSOE",1173
44,"44129",39,32,32,0,0,"PSOE",9
5,"5165",368,290,281,3,9,"PSOE",49
4,"4084",341,249,247,2,2,"PSOE",78
16,"16276",21,16,16,1,0,"PSOE",3
24,"24074",97,75,75,1,0,"PSOE",12
46,"46048",3452,2749,2713,14,36,"PSOE",599
50,"50244",201,162,161,1,1,"PSOE",37
13,"13038",1630,1230,1207,7,23,"PSOE",627
37,"37015",224,144,144,1,0,"PSOE",35
37,"37108",99,79,78,0,1,"PSOE",21
44,"44199",44,41,41,2,0,"PSOE",10
42,"42054",19,16,16,0,0,"PSOE",7
31,"31014",275,194,192,4,2,"PSOE",16
4,"4085",387,304,301,2,3,"PSOE",106
3,"3134",143,112,111,0,1,"PSOE",29
47,"47077",246,193,191,1,2,"PSOE",22
34,"34123",1648,1287,1258,12,29,"PSOE",331
50,"50183",331,246,246,3,0,"PSOE",65
46,"46127",2692,2120,2091,18,29,"PSOE",487
9,"9334",50,39,37,0,2,"PSOE",7
49,"49229",126,93,93,0,0,"PSOE",27
24,"24077",225,190,187,2,3,"PSOE",58
7,"7050",3348,2156,2139,19,17,"PSOE",239
19,"19267",19,13,13,0,0,"PSOE",4
14,"14051",1397,1018,1000,2,18,"PSOE",469
39,"39061",3478,2695,2677,13,18,"PSOE",361
5,"5266",100,86,86,0,0,"PSOE",10
21,"21065",273,186,184,0,2,"PSOE",64
23,"23079",3717,2825,2801,28,24,"PSOE",1259
9,"9066",62,48,47,0,1,"PSOE",16
5,"5121",249,185,185,4,0,"PSOE",41
42,"42193",14,10,10,0,0,"PSOE",0
2,"2020",432,365,364,1,1,"PSOE",139
28,"28169",1448,1122,1113,5,9,"PSOE",151
40,"40195",885,672,669,1,3,"PSOE",151
31,"31215",4676,3284,3240,36,44,"PSOE",1003
13,"13043",231,180,179,1,1,"PSOE",66
45,"45036",656,471,469,2,2,"PSOE",125
23,"23001",963,801,799,1,2,"PSOE",326
50,"50088",302,246,237,5,9,"PSOE",87
37,"37018",107,79,79,0,0,"PSOE",18
14,"14053",6006,4285,4232,49,53,"PSOE",1539
47,"47135",83,72,72,2,0,"PSOE",21
30,"30030",312993,231648,230185,1207,1463,"PSOE",38700
11,"11020",165378,109810,108830,1188,980,"PSOE",28950
34,"34175",90,72,70,0,2,"PSOE",5
11,"11021",6764,4434,4362,52,72,"PSOE",1885
47,"47001",55,46,46,0,0,"PSOE",2
41,"41065",22779,14769,14636,132,133,"PSOE",6251
49,"49109",619,483,483,11,0,"PSOE",124
34,"34126",277,200,199,2,1,"PSOE",23
45,"45171",1361,1035,1023,0,12,"PSOE",313
46,"46130",901,687,683,3,4,"PSOE",162
12,"12078",325,235,233,0,2,"PSOE",48
6,"6088",12616,8436,8313,70,123,"PSOE",2734
5,"5902",284,236,232,0,4,"PSOE",43
6,"6134",547,335,332,1,3,"PSOE",153
28,"28082",5683,4324,4286,25,38,"PSOE",639
24,"24179",290,197,192,4,5,"PSOE",56
47,"47081",45,36,35,1,1,"PSOE",13
9,"9070",34,26,26,0,0,"PSOE",7
44,"44237",398,304,301,4,3,"PSOE",105
49,"49233",93,58,55,0,3,"PSOE",12
7,"7054",22334,12814,12708,99,106,"PSOE",2383
12,"12079",399,316,314,2,2,"PSOE",81
42,"42059",21,15,14,0,1,"PSOE",3
13,"13047",5760,4295,4224,23,71,"PSOE",1362
46,"46053",553,445,436,2,9,"PSOE",137
24,"24080",213,164,161,3,3,"PSOE",38
16,"16903",1070,777,765,4,12,"PSOE",138
12,"12080",1932,1598,1570,10,28,"PSOE",587
22,"22232",93,71,69,1,2,"PSOE",15
40,"40031",526,398,396,2,2,"PSOE",83
47,"47164",378,313,311,1,2,"PSOE",86
19,"19272",72,54,53,1,1,"PSOE",20
23,"23085",2252,1655,1644,6,11,"PSOE",929
26,"26145",246,197,197,2,0,"PSOE",36
42,"42197",75,58,56,0,2,"PSOE",10
11,"11023",9348,6410,6349,64,61,"PSOE",2919
44,"44137",193,149,148,0,1,"PSOE",15
41,"41068",13939,9787,9674,72,113,"PSOE",4669
6,"6137",972,744,737,1,7,"PSOE",353
47,"47219",41,36,34,0,2,"PSOE",14
50,"50219",4119,2833,2804,19,29,"PSOE",556
22,"22234",794,552,544,3,8,"PSOE",140
24,"24082",858,629,614,8,15,"PSOE",226
16,"16126",770,634,624,3,10,"PSOE",207
2,"2026",836,690,679,3,11,"PSOE",292
3,"3046",1599,1153,1143,8,10,"PSOE",215
21,"21072",10262,7442,7307,85,135,"PSOE",2935
6,"6002",4322,2819,2762,22,57,"PSOE",928
50,"50159",665,512,507,2,5,"PSOE",166
49,"49075",137,120,119,0,1,"PSOE",38
34,"34132",114,89,86,0,3,"PSOE",19
5,"5226",76,55,54,3,1,"PSOE",2
50,"50251",8262,5946,5872,44,74,"PSOE",1420
44,"44138",135,98,94,0,4,"PSOE",22
28,"28174",1795,1232,1221,7,11,"PSOE",243
33,"33074",3484,2298,2274,24,24,"PSOE",743
19,"19169",40,34,34,0,0,"PSOE",10
31,"31222",62,36,34,3,2,"PSOE",7
9,"9209",4473,3223,3192,20,31,"PSOE",560
42,"42201",22,22,21,0,1,"PSOE",8
24,"24152",464,295,291,1,4,"PSOE",41
14,"14030",8625,6248,6181,53,67,"PSOE",2663
5,"5033",176,144,142,1,2,"PSOE",30
10,"10078",406,321,314,6,7,"PSOE",123
13,"13001",1254,934,925,6,9,"PSOE",428
44,"44240",158,130,129,0,1,"PSOE",41
13,"13053",14328,10164,10041,72,123,"PSOE",2904
16,"16130",571,450,448,1,2,"PSOE",209
45,"45177",2110,1679,1656,3,23,"PSOE",545
14,"14058",7970,5491,5417,66,74,"PSOE",2028
5,"5179",214,178,176,1,2,"PSOE",11
44,"44241",533,396,389,0,7,"PSOE",89
34,"34088",246,193,186,1,7,"PSOE",50
31,"31023",6956,5310,5289,85,21,"PSOE",653
10,"10124",852,665,655,2,10,"PSOE",321
3,"3903",2494,1880,1865,7,15,"PSOE",481
44,"44176",158,115,114,0,1,"PSOE",52
37,"37247",196,163,162,3,1,"PSOE",25
47,"47006",190,136,135,1,1,"PSOE",35
28,"28087",3186,2503,2487,19,16,"PSOE",437
4,"4094",207,144,144,0,0,"PSOE",31
18,"18086",349,274,272,0,2,"PSOE",187
37,"37288",262,182,181,4,1,"PSOE",32
18,"18133",2168,1648,1636,6,12,"PSOE",551
40,"40123",147,114,106,0,8,"PSOE",18
39,"39039",568,382,379,0,3,"PSOE",108
41,"41006",2740,1782,1768,14,14,"PSOE",996
19,"19171",4961,3670,3628,27,42,"PSOE",1073
9,"9485",55,43,42,0,1,"PSOE",4
34,"34136",179,110,110,1,0,"PSOE",24
31,"31025",766,524,518,6,6,"PSOE",45
46,"46136",2537,1952,1930,11,22,"PSOE",454
9,"9350",469,350,343,2,7,"PSOE",39
45,"45079",369,288,286,3,2,"PSOE",86
49,"49241",248,177,177,0,0,"PSOE",30
19,"19281",21,15,15,2,0,"PSOE",4
28,"28177",10270,8083,8030,36,53,"PSOE",1126
50,"50163",3689,2702,2680,37,22,"PSOE",409
18,"18135",4568,3009,2961,14,48,"PSOE",1393
11,"11029",5430,3039,3000,44,39,"PSOE",1353
12,"12087",25,18,18,4,0,"PSOE",2
37,"37165",33,26,25,0,1,"PSOE",1
12,"12017",161,130,128,0,2,"PSOE",29
26,"26046",1581,1175,1159,4,16,"PSOE",286
50,"50067",14119,9909,9819,112,90,"PSOE",2496
9,"9306",106,82,82,1,0,"PSOE",13
23,"23093",3226,2302,2273,19,29,"PSOE",1342
42,"42070",34,27,26,1,1,"PSOE",11
50,"50256",83,53,53,0,0,"PSOE",6
21,"21078",2726,1793,1768,17,25,"PSOE",835
47,"47169",68,59,59,0,0,"PSOE",1
31,"31227",8180,5885,5809,76,76,"PSOE",1130
19,"19051",67,63,63,0,0,"PSOE",19
4,"4097",248,189,189,1,0,"PSOE",69
2,"2034",1382,1110,1093,7,17,"PSOE",345
41,"41075",10212,6419,6295,49,124,"PSOE",2079
19,"19052",25,21,21,1,0,"PSOE",11
18,"18089",14719,10163,10099,63,64,"PSOE",3451
47,"47088",103,86,85,1,1,"PSOE",15
12,"12088",62,59,59,0,0,"PSOE",10
26,"26153",13,12,11,0,1,"PSOE",5
40,"40082",114,84,82,1,2,"PSOE",12
37,"37168",439,316,311,0,5,"PSOE",81
2,"2035",1960,1483,1465,13,18,"PSOE",468
34,"34003",164,122,119,0,3,"PSOE",9
28,"28025",420,320,315,4,5,"PSOE",58
40,"40210",106,74,71,0,3,"PSOE",13
6,"6011",24723,16883,16718,137,165,"PSOE",4327
40,"40211",74,64,64,0,0,"PSOE",10
10,"10086",320,238,233,1,5,"PSOE",76
37,"37033",95,68,68,5,0,"PSOE",13
9,"9904",478,374,370,5,4,"PSOE",87
34,"34096",55,42,42,0,0,"PSOE",9
28,"28091",5440,3596,3558,24,38,"PSOE",895
19,"19053",2008,1422,1404,10,18,"PSOE",371
22,"22115",360,257,256,3,1,"PSOE",63
22,"22002",107,95,95,0,0,"PSOE",28
47,"47089",148,125,124,0,1,"PSOE",12
40,"40084",62,55,52,0,3,"PSOE",9
44,"44249",55,44,44,2,0,"PSOE",14
24,"24190",165,123,121,1,2,"PSOE",26
9,"9083",37,33,33,0,0,"PSOE",1
14,"14064",320,242,236,2,6,"PSOE",104
49,"49245",262,176,173,2,3,"PSOE",31
47,"47010",13729,10549,10454,81,95,"PSOE",1704
45,"45184",200,129,129,0,0,"PSOE",62
3,"3054",343,277,275,3,2,"PSOE",90
34,"34146",51,40,39,0,1,"PSOE",9
46,"46140",344,284,279,0,5,"PSOE",45
19,"19177",76,61,59,0,2,"PSOE",25
41,"41078",2508,1823,1810,19,13,"PSOE",919
6,"6060",5786,4146,4071,24,75,"PSOE",1632
42,"42123",164,117,116,4,1,"PSOE",20
49,"49005",149,91,91,2,0,"PSOE",20
6,"6151",1070,770,766,3,4,"PSOE",377
4,"4005",556,437,431,3,6,"PSOE",177
41,"41079",9294,6670,6580,51,90,"PSOE",3011
37,"37172",888,572,566,3,6,"PSOE",85
19,"19286",720,547,543,2,4,"PSOE",106
47,"47012",113,93,93,0,0,"PSOE",15
40,"40214",208,168,168,2,0,"PSOE",38
5,"5143",66,51,49,0,2,"PSOE",8
22,"22248",116,92,90,1,2,"PSOE",33
6,"6153",20377,14329,14163,103,166,"PSOE",5076
9,"9907",1420,1058,1041,12,17,"PSOE",197
9,"9356",42,33,32,0,1,"PSOE",3
23,"23059",5837,4387,4310,40,77,"PSOE",2106
50,"50105",296,214,211,1,3,"PSOE",68
13,"13068",1061,747,740,4,7,"PSOE",264
31,"31131",901,646,638,7,8,"PSOE",50
31,"31032",1713,1209,1193,24,16,"PSOE",430
12,"12093",178,137,136,2,1,"PSOE",28
22,"22249",116,95,95,4,0,"PSOE",20
11,"11036",689,407,400,3,7,"PSOE",167
18,"18144",781,567,558,4,9,"PSOE",114
40,"40089",222,167,164,0,3,"PSOE",18
4,"4007",734,524,522,1,2,"PSOE",222
39,"39077",236,173,171,1,2,"PSOE",52
47,"47092",110,87,87,0,0,"PSOE",11
37,"37174",1056,820,812,3,8,"PSOE",222
45,"45188",2785,1960,1938,15,22,"PSOE",635
37,"37039",301,217,213,0,4,"PSOE",60
46,"46142",787,619,602,1,17,"PSOE",148
44,"44044",88,72,71,2,1,"PSOE",9
13,"13070",760,583,574,11,9,"PSOE",200
11,"11037",5661,4347,4265,33,82,"PSOE",993
50,"50263",193,121,121,0,0,"PSOE",43
49,"49250",1245,935,920,7,15,"PSOE",227
49,"49008",460,332,331,5,1,"PSOE",94
2,"2042",837,618,611,1,7,"PSOE",248
4,"4008",505,423,417,5,6,"PSOE",106
9,"9224",162,131,131,1,0,"PSOE",25
12,"12095",959,749,742,8,7,"PSOE",220
9,"9445",44,32,32,3,0,"PSOE",8
5,"5049",401,272,266,1,6,"PSOE",52
9,"9134",221,161,156,7,5,"PSOE",42
23,"23024",12435,9058,8833,55,225,"PSOE",2922
13,"13072",768,579,572,5,7,"PSOE",178
16,"16147",64,45,45,0,0,"PSOE",14
49,"49251",163,127,121,1,6,"PSOE",36
10,"10140",1106,820,808,4,12,"PSOE",260
40,"40219",587,455,444,5,11,"PSOE",19
40,"40092",118,87,87,1,0,"PSOE",12
19,"19183",74,65,65,0,0,"PSOE",29
26,"26055",39,32,32,0,0,"PSOE",3
18,"18012",2278,1662,1641,13,21,"PSOE",655
42,"42219",43,31,30,0,1,"PSOE",7
49,"49252",320,254,252,5,2,"PSOE",69
47,"47094",133,115,114,1,1,"PSOE",32
26,"26163",136,118,118,0,0,"PSOE",35
9,"9363",965,737,734,2,3,"PSOE",71
19,"19291",1191,879,869,3,10,"PSOE",218
23,"23904",2796,1825,1798,8,27,"PSOE",891
19,"19061",57,42,42,0,0,"PSOE",9
16,"16010",152,115,112,0,3,"PSOE",18
3,"3060",109,91,91,0,0,"PSOE",17
50,"50265",79,61,61,0,0,"PSOE",11
39,"39080",3542,2656,2628,20,28,"PSOE",651
34,"34017",918,744,736,9,8,"PSOE",193
9,"9093",154,121,119,0,2,"PSOE",28
12,"12097",63,49,49,0,0,"PSOE",6
46,"46223",7801,5950,5899,34,51,"PSOE",1269
22,"22011",88,71,69,0,2,"PSOE",13
19,"19293",1867,1358,1342,7,16,"PSOE",245
40,"40012",269,192,191,2,1,"PSOE",47
22,"22253",61,52,52,0,0,"PSOE",19
19,"19294",29,27,27,0,0,"PSOE",5
5,"5153",103,78,77,1,1,"PSOE",16
14,"14070",1332,986,974,10,12,"PSOE",369
10,"10144",975,746,735,3,11,"PSOE",281
29,"29002",1177,804,789,5,15,"PSOE",316
44,"44048",61,52,52,0,0,"PSOE",15
49,"49013",246,182,181,2,1,"PSOE",42
45,"45092",232,197,191,0,6,"PSOE",59
47,"47178",172,140,140,3,0,"PSOE",28
3,"3062",212,169,165,0,4,"PSOE",30
37,"37045",26,23,21,0,2,"PSOE",8
16,"16152",38,32,32,0,0,"PSOE",3
19,"19110",56,50,50,0,0,"PSOE",9
44,"44224",22,14,14,0,0,"PSOE",7
6,"6117",1424,960,938,4,22,"PSOE",335
13,"13026",438,345,343,2,2,"PSOE",123
2,"2049",823,573,564,1,9,"PSOE",266
40,"40223",216,163,163,1,0,"PSOE",40
49,"49258",114,93,91,2,2,"PSOE",27
49,"49133",304,214,213,1,1,"PSOE",59
19,"19066",55,48,48,0,0,"PSOE",2
47,"47179",395,293,287,0,6,"PSOE",58
34,"34159",357,253,248,4,5,"PSOE",86
37,"37266",82,63,63,2,0,"PSOE",7
16,"16014",602,485,483,0,2,"PSOE",194
49,"49134",172,121,119,0,2,"PSOE",21
24,"24100",761,561,555,7,6,"PSOE",96
12,"12099",539,416,403,7,13,"PSOE",65
44,"44157",64,48,48,1,0,"PSOE",17
44,"44225",107,74,74,1,0,"PSOE",17
37,"37183",414,306,304,0,2,"PSOE",101
10,"10147",1278,961,925,7,36,"PSOE",455
39,"39084",838,631,624,2,7,"PSOE",98
50,"50269",285,193,188,0,5,"PSOE",50
45,"45195",2141,1635,1606,7,29,"PSOE",633
22,"22014",243,192,188,3,4,"PSOE",68
12,"12100",1333,1065,1047,10,18,"PSOE",292
45,"45095",689,513,505,0,8,"PSOE",158
9,"9369",436,319,316,1,3,"PSOE",96
19,"19298",65,45,45,0,0,"PSOE",15
5,"5005",182,148,147,3,1,"PSOE",22
34,"34160",139,115,114,3,1,"PSOE",52
47,"47181",165,135,132,3,3,"PSOE",36
24,"24205",945,694,685,11,9,"PSOE",143
7,"7001",3573,2531,2497,21,34,"PSOE",628
41,"41089",6493,4398,4331,43,67,"PSOE",1764
39,"39085",6836,5086,5032,44,54,"PSOE",1196
24,"24137",1099,783,778,7,5,"PSOE",282
10,"10011",560,458,448,5,10,"PSOE",240
33,"33001",1588,887,880,8,7,"PSOE",278
18,"18154",1007,664,660,2,4,"PSOE",251
19,"19071",7840,5537,5489,45,48,"PSOE",883
5,"5160",323,256,253,2,3,"PSOE",41
2,"2052",459,372,369,4,3,"PSOE",142
22,"22903",652,514,507,1,7,"PSOE",151
16,"16110",93,70,70,0,0,"PSOE",2
34,"34025",57,39,39,1,0,"PSOE",5
12,"12002",110,99,98,1,1,"PSOE",35
49,"49262",392,279,274,1,5,"PSOE",56
10,"10105",2512,1644,1620,12,24,"PSOE",512
40,"40230",94,68,66,0,2,"PSOE",25
46,"46072",3611,2871,2821,23,50,"PSOE",611
45,"45097",1046,839,834,4,5,"PSOE",302
24,"24005",378,260,257,2,3,"PSOE",62
21,"21058",2609,1883,1856,23,27,"PSOE",1190
12,"12103",91,69,67,0,2,"PSOE",5
5,"5012",133,105,102,0,3,"PSOE",16
49,"49138",234,184,184,3,0,"PSOE",38
18,"18022",13432,8491,8407,67,84,"PSOE",2654
3,"3067",99,85,85,0,0,"PSOE",21
4,"4017",1296,857,854,5,3,"PSOE",317
24,"24104",259,169,169,0,0,"PSOE",39
47,"47075",4856,3681,3637,24,44,"PSOE",685
16,"16019",214,156,152,0,4,"PSOE",40
5,"5163",1737,1347,1340,4,7,"PSOE",293
19,"19192",1736,1324,1308,8,16,"PSOE",379
5,"5013",868,728,721,6,7,"PSOE",173
6,"6033",1327,1011,1006,10,5,"PSOE",423
16,"16020",17,10,10,0,0,"PSOE",2
42,"42093",37,29,28,1,1,"PSOE",1
45,"45199",2940,1848,1805,14,43,"PSOE",357
46,"46229",948,762,758,0,4,"PSOE",188
29,"29009",1468,1069,1045,8,24,"PSOE",489
16,"16022",78,67,66,0,1,"PSOE",25
45,"45099",3500,2390,2361,9,29,"PSOE",556
22,"22136",806,588,588,5,0,"PSOE",167
37,"37189",121,88,88,0,0,"PSOE",29
6,"6080",1924,1412,1392,9,20,"PSOE",630
19,"19303",43,35,35,0,0,"PSOE",7
28,"28108",3374,2482,2465,10,17,"PSOE",369
47,"47184",573,453,451,1,2,"PSOE",78
34,"34029",714,587,570,3,17,"PSOE",116
49,"49021",14330,9878,9758,95,120,"PSOE",2517
49,"49265",128,91,91,1,0,"PSOE",26
49,"49142",249,180,179,0,1,"PSOE",55
26,"26173",6,6,6,1,0,"PSOE",2
46,"46230",13960,10351,10241,54,110,"PSOE",2510
18,"18025",288,220,220,1,0,"PSOE",115
9,"9108",384,283,279,1,4,"PSOE",69
37,"37318",208,159,158,1,1,"PSOE",23
24,"24211",272,205,205,2,0,"PSOE",50
9,"9241",202,156,154,4,2,"PSOE",33
13,"13039",14366,10282,10185,81,97,"PSOE",2775
26,"26139",54,45,44,0,1,"PSOE",3
37,"37190",215,171,171,1,0,"PSOE",42
47,"47024",259,208,207,1,1,"PSOE",64
47,"47186",246129,186191,184733,1198,1458,"PSOE",42241
46,"46231",2421,1721,1708,14,13,"PSOE",350
22,"22908",197,142,140,3,2,"PSOE",39
19,"19195",40,32,32,1,0,"PSOE",14
47,"47133",2682,2033,2015,16,18,"PSOE",395
46,"46179",2165,1760,1737,16,23,"PSOE",421
28,"28110",1944,1478,1463,4,15,"PSOE",407
44,"44059",544,425,412,9,13,"PSOE",87
50,"50276",125,104,103,2,1,"PSOE",33
19,"19079",8,8,7,0,1,"PSOE",0
24,"24212",1032,773,760,4,13,"PSOE",232
19,"19196",105,84,81,0,3,"PSOE",17
5,"5168",3560,2589,2561,19,28,"PSOE",447
31,"31148",92,69,69,5,0,"PSOE",20
19,"19305",155,116,115,0,1,"PSOE",28
44,"44060",41,32,32,0,0,"PSOE",4
45,"45203",2563,1801,1771,8,30,"PSOE",545
12,"12008",222,193,192,1,1,"PSOE",48
13,"13094",304,249,247,1,2,"PSOE",74
37,"37193",390,279,275,4,4,"PSOE",91
34,"34174",200,159,154,5,5,"PSOE",16
5,"5169",226,187,185,1,2,"PSOE",26
49,"49025",173,133,133,1,0,"PSOE",51
28,"28111",596,467,467,3,0,"PSOE",101
42,"42056",23,20,20,0,0,"PSOE",2
50,"50247",823,588,581,3,7,"PSOE",117
28,"28080",48554,38885,38691,164,194,"PSOE",4793
40,"40904",357,308,306,3,2,"PSOE",25
4,"4022",347,249,249,7,0,"PSOE",114
50,"50058",66,39,39,0,0,"PSOE",9
6,"6132",855,587,582,3,5,"PSOE",280
39,"39093",299,229,226,4,3,"PSOE",42
12,"12139",318,237,233,0,4,"PSOE",23
5,"5022",1588,1238,1222,5,16,"PSOE",153
12,"12009",17445,12088,11999,75,89,"PSOE",2801
29,"29904",421,338,335,3,3,"PSOE",254
10,"10023",835,616,607,2,9,"PSOE",325
37,"37322",2465,1592,1564,8,28,"PSOE",370
49,"49148",260,137,134,1,3,"PSOE",34
46,"46234",348,279,275,3,4,"PSOE",70
47,"47106",50,39,39,0,0,"PSOE",9
24,"24079",906,664,658,9,6,"PSOE",124
5,"5024",224,169,168,3,1,"PSOE",40
50,"50186",42,31,31,0,0,"PSOE",7
37,"37063",69,59,58,0,1,"PSOE",18
42,"42103",575,450,445,1,5,"PSOE",105
10,"10162",575,437,433,2,4,"PSOE",205
33,"33010",1822,1190,1180,17,10,"PSOE",380
37,"37065",312,223,222,3,1,"PSOE",47
40,"40906",2003,1569,1550,12,19,"PSOE",329
12,"12010",259,213,208,2,5,"PSOE",63
30,"30001",4582,3620,3594,18,26,"PSOE",949
47,"47109",179,138,138,2,0,"PSOE",39
12,"12011",4565,3331,3283,20,48,"PSOE",973
49,"49150",139,112,111,1,1,"PSOE",36
37,"37067",3163,2496,2467,31,29,"PSOE",442
50,"50188",28,25,25,0,0,"PSOE",8
46,"46079",318,241,232,1,9,"PSOE",49
28,"28046",4460,3447,3422,16,25,"PSOE",535
14,"14027",7925,5836,5746,58,90,"PSOE",1849
46,"46001",795,601,592,3,9,"PSOE",165
16,"16171",1800,1469,1443,8,26,"PSOE",508
10,"10027",77,69,69,1,0,"PSOE",32
46,"46236",972,818,809,2,9,"PSOE",211
19,"19201",58,49,48,1,1,"PSOE",7
45,"45107",3257,2504,2472,15,32,"PSOE",532
18,"18035",1232,992,988,6,4,"PSOE",371
49,"49235",443,301,292,0,9,"PSOE",74
42,"42061",291,214,213,3,1,"PSOE",50
19,"19311",82,69,67,0,2,"PSOE",15
50,"50281",73,51,50,0,1,"PSOE",5
6,"6047",849,639,628,2,11,"PSOE",260
16,"16173",205,157,156,0,1,"PSOE",55
34,"34039",61,49,47,0,2,"PSOE",2
46,"46002",1175,941,932,5,9,"PSOE",175
5,"5079",68,53,53,0,0,"PSOE",1
44,"44065",60,40,40,0,0,"PSOE",1
9,"9478",41,32,32,1,0,"PSOE",11
34,"34180",66,55,55,1,0,"PSOE",9
33,"33073",8554,4945,4884,41,61,"PSOE",1345
44,"44174",428,307,304,3,3,"PSOE",83
50,"50093",92,66,66,1,0,"PSOE",17
39,"39097",697,371,368,2,3,"PSOE",79
5,"5177",158,130,129,0,1,"PSOE",45
9,"9120",38,32,32,1,0,"PSOE",6
31,"31255",102,79,79,1,0,"PSOE",17
50,"50001",100,77,77,0,0,"PSOE",15
24,"24219",516,387,386,4,1,"PSOE",94
19,"19314",51,36,36,0,0,"PSOE",12
19,"19090",91,73,73,1,0,"PSOE",24
29,"29053",1699,1105,1091,14,14,"PSOE",253
47,"47084",1150,887,870,7,17,"PSOE",279
46,"46056",182,167,166,1,1,"PSOE",42
47,"47192",102,83,81,1,2,"PSOE",13
6,"6049",1015,725,707,3,18,"PSOE",272
30,"30005",29526,20713,20526,121,187,"PSOE",3742
31,"31156",251,189,188,0,1,"PSOE",25
22,"22155",76,51,51,0,0,"PSOE",8
21,"21034",1188,798,786,8,12,"PSOE",341
49,"49154",127,78,77,0,1,"PSOE",39
5,"5131",99,69,69,0,0,"PSOE",7
42,"42111",303,229,227,2,2,"PSOE",49
5,"5180",86,67,63,3,4,"PSOE",2
2,"2070",403,332,328,4,4,"PSOE",217
5,"5132",960,669,657,1,12,"PSOE",144
44,"44035",113,90,88,1,2,"PSOE",18
37,"37331",212,137,135,0,2,"PSOE",22
50,"50003",128,92,91,1,1,"PSOE",32
46,"46005",22918,16958,16827,102,131,"PSOE",4004
37,"37204",276,198,195,1,3,"PSOE",37
19,"19318",25,18,18,0,0,"PSOE",11
31,"31058",208,148,144,3,4,"PSOE",9
50,"50223",920,712,701,4,11,"PSOE",338
13,"13055",665,487,484,2,3,"PSOE",190
26,"26113",35,35,34,0,1,"PSOE",3
14,"14003",1248,939,930,2,9,"PSOE",415
18,"18039",3490,2406,2378,33,28,"PSOE",1059
12,"12116",58,49,49,0,0,"PSOE",11
47,"47114",4045,2787,2762,26,25,"PSOE",657
41,"41095",41232,27076,26793,315,283,"PSOE",10704
45,"45112",1922,1247,1211,6,36,"PSOE",360
7,"7022",11545,7385,7306,88,79,"PSOE",1535
19,"19319",4449,3086,3056,18,30,"PSOE",550
2,"2073",4867,3520,3474,40,46,"PSOE",1056
24,"24119",706,488,481,3,7,"PSOE",145
12,"12117",3585,2727,2677,20,50,"PSOE",624
6,"6053",602,454,444,3,10,"PSOE",231
9,"9124",1506,1040,1028,6,12,"PSOE",333
41,"41040",10541,7752,7698,68,54,"PSOE",1458
29,"29023",2081,1354,1340,4,14,"PSOE",224
9,"9395",138,104,104,0,0,"PSOE",18
19,"19096",91,72,69,0,3,"PSOE",14
24,"24088",1029,791,789,10,2,"PSOE",202
44,"44071",591,398,398,5,0,"PSOE",81
31,"31159",1107,844,833,6,11,"PSOE",58
9,"9257",93,81,80,4,1,"PSOE",2
4,"4032",5586,3642,3623,23,19,"PSOE",1302
5,"5184",246,183,183,0,0,"PSOE",43
49,"49037",185,153,151,0,2,"PSOE",32
10,"10036",329,241,238,1,3,"PSOE",127
9,"9396",156,121,121,0,0,"PSOE",11
34,"34190",56,41,40,2,1,"PSOE",6
46,"46242",333,267,266,0,1,"PSOE",42
6,"6056",479,407,399,1,8,"PSOE",185
18,"18001",251,168,167,5,1,"PSOE",92
42,"42118",23,17,17,0,0,"PSOE",0
12,"12119",148,95,93,0,2,"PSOE",17
24,"24225",1014,752,739,10,13,"PSOE",149
19,"19097",16,10,10,0,0,"PSOE",0
10,"10176",371,262,261,0,1,"PSOE",115
33,"33019",3072,2020,2005,18,15,"PSOE",523
50,"50100",329,246,241,1,5,"PSOE",90
46,"46164",11771,8564,8483,64,81,"PSOE",1940
42,"42119",158,100,99,3,1,"PSOE",10
23,"23015",1374,1029,1019,5,10,"PSOE",513
16,"16044",39,30,30,0,0,"PSOE",11
9,"9353",76,57,56,1,1,"PSOE",5
47,"47117",301,233,227,2,6,"PSOE",42
40,"40002",36,32,32,0,0,"PSOE",2
50,"50069",73,53,53,1,0,"PSOE",22
28,"28054",11257,8349,8273,55,76,"PSOE",1360
7,"7026",31074,18280,18135,168,145,"PSOE",4326
10,"10177",1707,1228,1201,5,27,"PSOE",430
2,"2077",55,47,47,0,0,"PSOE",14
45,"45016",4204,3146,3105,22,41,"PSOE",732
31,"31162",47,31,31,0,0,"PSOE",11
19,"19099",298,200,199,6,1,"PSOE",61
49,"49040",114,101,101,0,0,"PSOE",46
5,"5188",45,39,38,0,1,"PSOE",7
37,"37082",796,551,544,4,7,"PSOE",180
44,"44076",2203,1690,1663,18,27,"PSOE",560
30,"30012",9091,6962,6897,36,65,"PSOE",2369
37,"37338",79,65,64,0,1,"PSOE",11
23,"23017",1572,1269,1257,4,12,"PSOE",663
16,"16046",245,180,180,1,0,"PSOE",68
16,"16190",5105,3945,3887,17,58,"PSOE",1122
28,"28055",916,693,687,5,6,"PSOE",208
10,"10179",294,231,229,2,2,"PSOE",71
28,"28153",697,499,499,1,0,"PSOE",91
10,"10134",567,401,396,2,5,"PSOE",125
5,"5189",449,351,349,2,2,"PSOE",60
31,"31264",180,105,101,2,4,"PSOE",6
50,"50291",96,74,74,0,0,"PSOE",19
47,"47119",92,80,79,1,1,"PSOE",14
46,"46244",58771,42137,41867,270,270,"PSOE",9176
40,"40004",459,356,352,2,4,"PSOE",92
10,"10043",800,562,553,3,9,"PSOE",248
41,"41102",14655,10183,9919,142,264,"PSOE",3648
34,"34201",193,158,155,1,3,"PSOE",33
9,"9265",37,28,28,0,0,"PSOE",3
16,"16192",48,31,30,1,1,"PSOE",13
45,"45119",3330,2096,2067,15,29,"PSOE",482
16,"16048",408,313,312,1,1,"PSOE",72
18,"18143",973,742,730,5,12,"PSOE",263
46,"46141",439,351,342,2,9,"PSOE",56
49,"49043",289,217,213,1,4,"PSOE",80
4,"4037",1314,969,955,6,14,"PSOE",383
19,"19327",418,350,348,1,2,"PSOE",43
47,"47200",85,66,66,0,0,"PSOE",3
12,"12025",136,104,104,0,0,"PSOE",23
47,"47121",544,437,425,6,12,"PSOE",159
37,"37086",101,72,71,1,1,"PSOE",15
46,"46011",7609,5249,5191,26,58,"PSOE",960
9,"9010",32,23,23,1,0,"PSOE",3
41,"41014",2492,1882,1852,11,30,"PSOE",610
28,"28126",39,29,29,0,0,"PSOE",7
39,"39016",23868,17883,17701,122,182,"PSOE",4199
44,"44082",89,78,77,0,1,"PSOE",24
30,"30015",19171,13561,13464,61,97,"PSOE",3475
5,"5193",193,167,164,1,3,"PSOE",54
42,"42127",38,31,31,1,0,"PSOE",5
31,"31067",1922,1312,1294,10,18,"PSOE",359
50,"50106",134,104,104,0,0,"PSOE",37
19,"19217",54,40,39,0,1,"PSOE",14
5,"5048",118,104,104,0,0,"PSOE",30
3,"3089",9571,6775,6639,47,136,"PSOE",1675
16,"16050",245,201,195,1,6,"PSOE",65
46,"46169",32247,24214,24053,154,161,"PSOE",5652
34,"34058",189,172,172,2,0,"PSOE",56
50,"50201",448,339,335,7,4,"PSOE",104
24,"24095",320,234,232,0,2,"PSOE",46
40,"40177",153,125,125,1,0,"PSOE",28
45,"45089",1495,1102,1094,0,8,"PSOE",404
37,"37301",74,63,63,0,0,"PSOE",11
50,"50107",947,738,733,4,5,"PSOE",199
40,"40135",283,236,231,2,5,"PSOE",80
37,"37218",67,42,41,0,1,"PSOE",8
16,"16196",633,508,503,2,5,"PSOE",207
41,"41903",6757,4562,4504,51,58,"PSOE",1997
23,"23025",2802,2056,2037,9,19,"PSOE",892
45,"45123",3081,2144,2131,11,13,"PSOE",524
22,"22046",728,566,561,5,5,"PSOE",200
31,"31069",832,637,635,3,2,"PSOE",125
5,"5051",179,145,139,1,6,"PSOE",24
19,"19332",92,71,69,1,2,"PSOE",14
33,"33026",8530,5397,5337,48,60,"PSOE",1393
9,"9269",36,26,26,1,0,"PSOE",4
33,"33056",4997,3269,3244,22,25,"PSOE",740
40,"40138",2169,1673,1656,7,17,"PSOE",390
34,"34208",51,42,42,0,0,"PSOE",3
5,"5053",82,57,57,0,0,"PSOE",3
45,"45124",2140,1677,1641,10,36,"PSOE",549
46,"46014",3030,2383,2350,20,33,"PSOE",467
22,"22047",243,205,203,2,2,"PSOE",32
23,"23026",3586,2620,2585,16,35,"PSOE",1140
34,"34210",103,90,90,0,0,"PSOE",16
10,"10188",499,382,374,4,8,"PSOE",178
33,"33027",834,506,498,4,8,"PSOE",187
30,"30018",7978,5866,5811,30,55,"PSOE",1652
50,"50296",396,286,275,4,11,"PSOE",107
10,"10189",2630,1880,1851,4,29,"PSOE",735
37,"37179",209,180,180,0,0,"PSOE",42
5,"5199",40,32,31,0,1,"PSOE",1
50,"50109",103,78,78,3,0,"PSOE",11
47,"47042",54,37,37,0,0,"PSOE",10
41,"41019",4691,3089,3056,27,33,"PSOE",1146
37,"37096",214,166,163,2,3,"PSOE",30
44,"44191",764,586,583,6,3,"PSOE",167
16,"16056",457,306,305,3,1,"PSOE",116
31,"31071",17,16,16,0,0,"PSOE",8
40,"40013",62,49,48,0,1,"PSOE",5
23,"23028",6220,4409,4369,23,40,"PSOE",1820
42,"42132",141,114,114,0,0,"PSOE",31
29,"29036",632,423,416,2,7,"PSOE",213
24,"24033",205,158,157,0,1,"PSOE",32
14,"14043",7574,5515,5443,81,72,"PSOE",2677
34,"34063",83,76,75,1,1,"PSOE",21
47,"47126",50,41,41,0,0,"PSOE",3
40,"40097",128,93,92,0,1,"PSOE",34
46,"46016",1061,870,856,5,14,"PSOE",285
37,"37097",39,27,27,1,0,"PSOE",8
19,"19223",111,83,83,3,0,"PSOE",31
9,"9056",4919,3395,3344,20,51,"PSOE",643
37,"37140",674,443,439,5,4,"PSOE",72
19,"19111",155,126,126,1,0,"PSOE",30
50,"50017",1773,1276,1269,13,7,"PSOE",262
31,"31139",159,96,95,0,1,"PSOE",9
9,"9274",1079,848,835,12,13,"PSOE",231
21,"21014",4016,3025,2991,21,34,"PSOE",1498
10,"10054",547,431,421,1,10,"PSOE",163
40,"40142",53,39,37,0,2,"PSOE",12
37,"37225",103,89,86,0,3,"PSOE",15
46,"46069",162,124,123,0,1,"PSOE",45
12,"12033",1919,1437,1404,19,33,"PSOE",354
16,"16060",744,565,554,7,11,"PSOE",181
24,"24134",3416,2470,2417,19,53,"PSOE",1005
5,"5205",74,57,55,1,2,"PSOE",9
26,"26130",203,167,167,1,0,"PSOE",42
9,"9140",124,80,79,0,1,"PSOE",31
33,"33030",895,669,666,9,3,"PSOE",140
21,"21015",680,398,393,8,5,"PSOE",220
23,"23031",747,637,619,0,18,"PSOE",383
47,"47045",763,575,567,1,8,"PSOE",180
50,"50208",1774,1207,1195,10,12,"PSOE",415
9,"9141",616,485,483,5,2,"PSOE",127
42,"42009",78,63,63,0,0,"PSOE",5
50,"50019",55,41,41,0,0,"PSOE",13
44,"44092",81,59,57,0,2,"PSOE",13
18,"18905",14618,9789,9682,110,107,"PSOE",2794
40,"40017",92,75,75,0,0,"PSOE",9
50,"50146",187,145,144,3,1,"PSOE",59
9,"9415",268,175,175,2,0,"PSOE",22
9,"9020",259,196,188,5,8,"PSOE",40
18,"18906",905,664,657,3,7,"PSOE",228
31,"31075",103,63,63,0,0,"PSOE",2
24,"24037",360,254,250,2,4,"PSOE",44
19,"19114",37,26,26,0,0,"PSOE",12
44,"44093",80,66,66,0,0,"PSOE",28
46,"46227",905,711,702,1,9,"PSOE",208
39,"39025",8637,6486,6378,47,108,"PSOE",2011
47,"47210",382,282,274,3,8,"PSOE",69
46,"46175",456,389,387,3,2,"PSOE",77
14,"14018",3709,2697,2653,26,44,"PSOE",916
49,"49018",329,261,256,2,5,"PSOE",99
47,"47074",149,117,116,2,1,"PSOE",44
23,"23033",1352,1045,1034,12,11,"PSOE",443
16,"16063",97,85,84,1,1,"PSOE",31
34,"34070",154,123,123,2,0,"PSOE",31
16,"16018",394,318,315,1,3,"PSOE",76
42,"42142",50,35,35,1,0,"PSOE",4
41,"41025",2020,1361,1320,7,41,"PSOE",470
19,"19228",26,20,20,0,0,"PSOE",8
49,"49058",307,237,233,0,4,"PSOE",75
37,"37103",436,310,308,8,2,"PSOE",68
29,"29041",3175,2090,2045,24,45,"PSOE",634
45,"45098",2159,1632,1609,12,23,"PSOE",216
9,"9279",174,131,130,3,1,"PSOE",22
49,"49059",94,64,64,0,0,"PSOE",10
6,"6079",652,449,442,4,7,"PSOE",222
16,"16213",36,34,34,0,0,"PSOE",8
12,"12134",141,95,94,0,1,"PSOE",21
40,"40020",157,118,117,1,1,"PSOE",20
5,"5064",103,83,82,0,1,"PSOE",7
4,"4052",12274,8372,8306,93,66,"PSOE",2039
9,"9023",1102,818,811,11,7,"PSOE",131
31,"31078",2429,1795,1767,15,28,"PSOE",509
26,"26101",44,36,35,0,1,"PSOE",14
37,"37232",390,341,339,1,2,"PSOE",59
42,"42013",34,28,27,0,1,"PSOE",6
45,"45032",436,283,275,1,8,"PSOE",90
16,"16113",3077,2225,2202,10,23,"PSOE",635
50,"50243",331,250,246,0,4,"PSOE",76
5,"5212",231,164,163,2,1,"PSOE",36
10,"10063",173,139,137,0,2,"PSOE",36
16,"16216",315,268,265,1,3,"PSOE",96
24,"24040",449,329,325,2,4,"PSOE",91
41,"41027",3922,2660,2604,23,56,"PSOE",851
10,"10201",173,142,142,2,0,"PSOE",63
5,"5213",103,84,82,0,2,"PSOE",17
45,"45033",343,249,243,2,6,"PSOE",92
24,"24143",510,358,349,0,9,"PSOE",132
6,"6082",383,287,286,2,1,"PSOE",129
31,"31080",508,391,385,3,6,"PSOE",67
16,"16068",137,98,97,1,1,"PSOE",38
40,"40022",213,164,161,2,3,"PSOE",35
39,"39029",618,488,481,3,7,"PSOE",74
10,"10156",97,73,72,1,1,"PSOE",37
5,"5166",185,139,139,1,0,"PSOE",17
30,"30027",48176,35521,35266,153,255,"PSOE",6484
9,"9025",122,83,83,1,0,"PSOE",15
50,"50213",94,75,74,0,1,"PSOE",10
9,"9287",208,158,156,3,2,"PSOE",44
3,"3009",46657,35143,34801,223,342,"PSOE",7952
26,"26001",195,161,157,2,4,"PSOE",49
49,"49105",150,109,108,0,1,"PSOE",16
19,"19266",236,188,188,1,0,"PSOE",33
50,"50120",52,40,40,1,0,"PSOE",13
41,"41029",13445,9507,9416,78,91,"PSOE",3193
23,"23040",1480,1199,1192,2,7,"PSOE",417
5,"5070",30,27,27,0,0,"PSOE",14
19,"19119",82,72,71,1,1,"PSOE",15
9,"9154",137,98,97,2,1,"PSOE",17
42,"42151",34,26,26,0,0,"PSOE",7
41,"41030",514,387,373,3,14,"PSOE",161
9,"9027",46,42,41,0,1,"PSOE",12
16,"16071",20,20,20,0,0,"PSOE",2
46,"46180",682,553,549,0,4,"PSOE",148
40,"40154",20,15,15,0,0,"PSOE",7
22,"22188",82,60,59,6,1,"PSOE",22
47,"47215",53,45,45,0,0,"PSOE",3
33,"33068",1093,645,641,4,4,"PSOE",260
24,"24043",134,75,75,1,0,"PSOE",27
10,"10205",2020,1319,1293,5,26,"PSOE",494
10,"10067",10422,7113,7014,62,99,"PSOE",2298
40,"40111",58,49,49,0,0,"PSOE",9
37,"37062",83,65,64,1,1,"PSOE",8
34,"34034",123,95,95,1,0,"PSOE",26
31,"31083",52,37,37,0,0,"PSOE",0
9,"9155",27,20,20,0,0,"PSOE",5
47,"47216",115,91,87,0,4,"PSOE",0
45,"45205",6824,4424,4362,22,62,"PSOE",1107
33,"33039",1655,1223,1209,12,14,"PSOE",388
50,"50122",68,52,52,1,0,"PSOE",10
49,"49186",261,188,185,0,3,"PSOE",27
10,"10069",838,626,615,2,11,"PSOE",261
50,"50027",225,178,177,2,1,"PSOE",64
42,"42153",14,12,12,0,0,"PSOE",2
19,"19001",49,42,42,0,0,"PSOE",3
23,"23043",546,398,396,3,2,"PSOE",169
50,"50297",498961,362043,359558,2748,2485,"PSOE",82192
26,"26004",67,50,50,0,0,"PSOE",6
39,"39094",848,655,651,3,4,"PSOE",150
45,"45038",3356,2376,2350,15,26,"PSOE",368
3,"3105",5373,3911,3828,15,83,"PSOE",751
47,"47217",1910,1370,1366,1,4,"PSOE",282
5,"5220",371,309,301,0,8,"PSOE",40
45,"45039",224,192,190,0,2,"PSOE",41
44,"44103",132,102,102,1,0,"PSOE",19
47,"47054",635,507,495,9,12,"PSOE",99
29,"29049",2962,2132,2110,5,22,"PSOE",1003
24,"24149",152,120,116,3,4,"PSOE",23
16,"16078",41429,30053,29775,235,278,"PSOE",7491
4,"4059",1079,723,712,4,11,"PSOE",411
46,"46105",16190,11323,11206,44,117,"PSOE",2922
21,"21029",1562,1127,1097,14,30,"PSOE",491
16,"16079",30,19,18,0,1,"PSOE",12
50,"50218",113,91,91,1,0,"PSOE",17
19,"19124",386,260,257,0,3,"PSOE",73
26,"26108",266,215,213,0,2,"PSOE",45
9,"9162",141,101,101,0,0,"PSOE",17
31,"31020",449,228,228,3,0,"PSOE",4
5,"5222",147,127,126,1,1,"PSOE",19
37,"37241",168,131,131,1,0,"PSOE",17
50,"50901",138,105,105,0,0,"PSOE",33
45,"45040",1349,846,838,4,8,"PSOE",236
12,"12142",158,117,117,1,0,"PSOE",22
22,"22064",166,122,121,1,1,"PSOE",43
34,"34083",1769,1218,1201,10,17,"PSOE",233
26,"26109",81,69,69,0,0,"PSOE",23
34,"34231",229,168,167,1,1,"PSOE",28
13,"13903",524,419,415,3,4,"PSOE",95
7,"7057",7169,4719,4659,47,60,"PSOE",918
49,"49071",765,495,490,2,5,"PSOE",103
21,"21031",1199,852,837,6,15,"PSOE",398
14,"14028",314,253,249,1,4,"PSOE",124
9,"9034",276,228,227,2,1,"PSOE",48
50,"50125",360,248,246,3,2,"PSOE",73
37,"37284",316,246,238,4,8,"PSOE",66
37,"37118",123,92,90,0,2,"PSOE",24
33,"33012",5201,3466,3432,25,34,"PSOE",877
19,"19004",67,53,53,1,0,"PSOE",4
12,"12013",144,121,119,0,2,"PSOE",27
50,"50126",2371,1573,1559,19,14,"PSOE",401
50,"50031",154,93,93,0,0,"PSOE",31
22,"22066",702,502,498,7,4,"PSOE",124
21,"21032",1800,1286,1259,10,27,"PSOE",483
9,"9166",97,81,81,0,0,"PSOE",3
40,"40034",84,70,70,0,0,"PSOE",11
16,"16083",52,33,33,0,0,"PSOE",7
34,"34234",71,52,50,0,2,"PSOE",7
47,"47057",268,197,196,0,1,"PSOE",20
50,"50903",2214,1602,1585,8,17,"PSOE",346
34,"34042",296,237,234,1,3,"PSOE",63
33,"33014",9037,5999,5938,53,61,"PSOE",1538
31,"31056",174,121,120,0,1,"PSOE",14
16,"16084",48,38,37,1,1,"PSOE",18
21,"21033",538,373,370,3,3,"PSOE",160
44,"44108",320,222,222,1,0,"PSOE",47
6,"6095",9504,6621,6475,96,146,"PSOE",2661
9,"9432",182,145,138,0,7,"PSOE",30
3,"3048",4847,3719,3683,20,36,"PSOE",665
37,"37370",328,258,254,1,4,"PSOE",42
29,"29020",3267,2408,2359,16,49,"PSOE",666
42,"42160",254,206,205,0,1,"PSOE",56
19,"19242",87,65,65,1,0,"PSOE",1
41,"41038",100095,67313,66687,760,626,"PSOE",20972
41,"41093",18554,13978,13874,99,104,"PSOE",2635
12,"12115",219,179,177,0,2,"PSOE",29
37,"37121",575,418,413,3,5,"PSOE",132
12,"12051",471,339,335,1,4,"PSOE",28
21,"21035",9617,6033,5943,76,90,"PSOE",2393
10,"10079",894,662,648,7,14,"PSOE",182
22,"22068",79,60,60,0,0,"PSOE",15
41,"41039",31663,22062,21830,193,232,"PSOE",7107
49,"49117",465,330,324,6,6,"PSOE",83
45,"45111",65,50,50,0,0,"PSOE",23
26,"26149",57,47,46,0,1,"PSOE",16
16,"16087",208,179,177,5,2,"PSOE",49
49,"49079",106,93,92,1,1,"PSOE",16
37,"37122",201,154,153,5,1,"PSOE",54
46,"46188",672,544,537,8,7,"PSOE",91
40,"40164",177,139,138,0,1,"PSOE",24
46,"46110",21228,15563,15443,86,120,"PSOE",3483
37,"37123",177,126,126,0,0,"PSOE",16
34,"34238",330,268,266,3,2,"PSOE",88
42,"42028",75,51,51,0,0,"PSOE",8
50,"50035",72,54,53,1,1,"PSOE",2
16,"16242",317,272,270,1,2,"PSOE",50
5,"5086",80,67,67,2,0,"PSOE",9
49,"49197",175,123,123,1,0,"PSOE",31
24,"24223",2610,1917,1908,39,9,"PSOE",556
28,"28150",3087,2294,2277,10,17,"PSOE",341
21,"21037",472,341,336,2,5,"PSOE",176
22,"22202",141,119,119,0,0,"PSOE",40
3,"3020",99,79,79,0,0,"PSOE",19
16,"16243",407,338,334,3,4,"PSOE",88
46,"46111",10930,7931,7828,44,103,"PSOE",1435
21,"21038",1095,705,693,4,12,"PSOE",252
26,"26013",347,249,246,2,3,"PSOE",71
26,"26115",19,16,16,0,0,"PSOE",3
5,"5087",134,87,85,1,2,"PSOE",5
49,"49081",1382,1016,1003,9,13,"PSOE",307
40,"40040",2607,1843,1828,19,15,"PSOE",344
49,"49200",949,720,715,10,5,"PSOE",182
19,"19245",1155,855,835,5,20,"PSOE",235
4,"4066",13571,8786,8724,50,62,"PSOE",2589
44,"44006",248,185,183,2,2,"PSOE",63
7,"7024",6843,3657,3612,38,45,"PSOE",773
44,"44112",429,290,290,2,0,"PSOE",81
19,"19011",250,184,184,0,0,"PSOE",68
5,"5234",49,44,44,2,0,"PSOE",5
10,"10085",323,235,233,0,2,"PSOE",65
9,"9173",124,100,99,2,1,"PSOE",21
34,"34242",95,71,68,3,3,"PSOE",17
47,"47145",603,448,441,3,7,"PSOE",59
26,"26118",59,48,48,2,0,"PSOE",6
41,"41043",639,436,427,5,9,"PSOE",226
22,"22075",125,83,83,1,0,"PSOE",33
14,"14034",308,247,244,2,3,"PSOE",87
46,"46060",9369,7052,6993,42,59,"PSOE",1534
16,"16246",482,361,355,3,6,"PSOE",124
24,"24158",320,207,203,2,4,"PSOE",47
34,"34243",325,252,248,0,4,"PSOE",66
44,"44008",1613,1163,1153,6,10,"PSOE",446
47,"47062",163,130,130,0,0,"PSOE",7
13,"13011",4792,3112,3077,14,35,"PSOE",1293
42,"42166",59,45,45,0,0,"PSOE",7
37,"37128",260,202,196,0,6,"PSOE",51
7,"7902",1064,685,664,15,21,"PSOE",144
42,"42167",251,175,172,2,3,"PSOE",43
9,"9440",91,78,78,2,0,"PSOE",20
46,"46191",1937,1530,1505,5,25,"PSOE",354
37,"37254",181,142,141,0,1,"PSOE",32
47,"47226",156,123,123,0,0,"PSOE",52
23,"23057",766,625,619,4,6,"PSOE",248
34,"34098",777,551,545,8,6,"PSOE",142
46,"46251",2462,1997,1956,6,41,"PSOE",514
31,"31097",10410,7082,7002,75,80,"PSOE",1087
19,"19015",84,69,68,0,1,"PSOE",23
44,"44115",102,90,90,3,0,"PSOE",27
5,"5237",162,130,124,2,6,"PSOE",10
42,"42076",216,179,174,5,5,"PSOE",43
31,"31263",233,138,137,2,1,"PSOE",6
23,"23097",6443,4117,4063,21,54,"PSOE",1664
44,"44216",26555,18997,18737,168,260,"PSOE",4027
50,"50136",575,414,410,2,4,"PSOE",75
5,"5094",139,116,116,1,0,"PSOE",4
37,"37130",172,151,150,0,1,"PSOE",13
29,"29061",1016,798,769,8,29,"PSOE",202
10,"10089",1359,882,868,3,14,"PSOE",413
33,"33052",721,485,482,3,3,"PSOE",199
29,"29062",654,551,545,2,6,"PSOE",275
37,"37131",185,139,139,0,0,"PSOE",26
10,"10090",513,362,353,2,9,"PSOE",144
21,"21044",17591,10679,10558,118,121,"PSOE",2686
13,"13015",5431,3993,3950,17,43,"PSOE",1450
46,"46193",8788,6925,6871,50,54,"PSOE",1574
24,"24229",418,322,319,2,3,"PSOE",81
47,"47065",857,674,669,1,5,"PSOE",228
22,"22208",188,150,145,0,5,"PSOE",35
9,"9177",1121,757,749,9,8,"PSOE",140
37,"37382",173,137,137,0,0,"PSOE",44
3,"3119",16636,12281,12194,57,87,"PSOE",2446
5,"5096",80,60,59,0,1,"PSOE",23
26,"26122",118,102,102,0,0,"PSOE",24
19,"19251",43,29,28,0,1,"PSOE",9
41,"41047",10117,7515,7422,74,93,"PSOE",1813
42,"42172",29,26,26,0,0,"PSOE",2
23,"23060",19003,12924,12812,102,112,"PSOE",5426
21,"21046",1705,1099,996,16,103,"PSOE",328
16,"16251",1849,1381,1366,7,15,"PSOE",293
49,"49088",87,61,60,0,1,"PSOE",12
47,"47229",210,148,147,1,1,"PSOE",41
44,"44219",194,145,143,1,2,"PSOE",26
29,"29064",503,348,339,8,9,"PSOE",129
3,"3057",182,147,147,1,0,"PSOE",26
37,"37300",566,398,395,0,3,"PSOE",93
10,"10093",398,317,312,4,5,"PSOE",175
24,"24163",3962,2950,2933,24,17,"PSOE",567
9,"9314",94,73,70,0,3,"PSOE",25
23,"23061",7560,5303,5234,29,69,"PSOE",2256
39,"39048",1716,1329,1312,12,17,"PSOE",256
5,"5243",85,61,60,0,1,"PSOE",12
9,"9179",41,32,32,1,0,"PSOE",6
37,"37040",391,299,297,2,2,"PSOE",95
37,"37217",58,45,44,0,1,"PSOE",14
34,"34206",866,661,654,4,7,"PSOE",234
26,"26162",121,99,99,1,0,"PSOE",27
34,"34904",315,234,230,2,4,"PSOE",71
3,"3028",998,818,812,2,6,"PSOE",179
46,"46039",2130,1728,1699,8,29,"PSOE",422
49,"49209",505,342,341,2,1,"PSOE",82
31,"31002",414,288,287,3,1,"PSOE",15
21,"21049",3361,2049,1984,17,65,"PSOE",851
31,"31201",147715,105455,104658,1007,797,"PSOE",15644
3,"3122",42425,30153,29954,154,199,"PSOE",6544
26,"26125",2699,1931,1907,23,24,"PSOE",613
28,"28004",6234,4202,4167,16,35,"PSOE",839
31,"31102",143,69,69,0,0,"PSOE",4
2,"2004",612,479,473,5,6,"PSOE",183
4,"4009",162,123,122,2,1,"PSOE",30
22,"22213",3003,2169,2131,19,38,"PSOE",638
23,"23063",3829,2560,2522,21,38,"PSOE",1176
22,"22082",291,213,212,1,1,"PSOE",44
16,"16258",194,150,150,1,0,"PSOE",41
18,"18148",817,637,634,5,3,"PSOE",226
50,"50234",243,189,185,6,4,"PSOE",31
45,"45058",375,311,304,1,7,"PSOE",91
37,"37262",78,64,63,0,1,"PSOE",4
5,"5247",241,138,138,1,0,"PSOE",27
11,"11007",17964,10038,9856,197,182,"PSOE",3058
49,"49214",698,525,512,3,13,"PSOE",126
18,"18102",8400,5592,5504,44,88,"PSOE",2557
3,"3123",7476,5557,5501,29,56,"PSOE",1324
37,"37221",430,293,290,0,3,"PSOE",91
23,"23905",1868,1277,1272,6,5,"PSOE",560
6,"6115",1261,841,832,5,9,"PSOE",327
16,"16103",261,222,222,0,0,"PSOE",54
19,"19256",43,36,36,0,0,"PSOE",6
33,"33058",1796,1232,1209,11,23,"PSOE",434
26,"26127",212,181,176,0,5,"PSOE",60
16,"16263",959,722,715,4,7,"PSOE",284
4,"4076",1279,960,944,8,16,"PSOE",412
47,"47152",78,60,60,0,0,"PSOE",21
3,"3031",41499,27031,26813,128,218,"PSOE",6168
9,"9449",86,68,66,0,2,"PSOE",3
50,"50046",178,133,133,5,0,"PSOE",21
46,"46257",5571,4266,4224,25,42,"PSOE",856
50,"50205",90,63,61,0,2,"PSOE",26
19,"19024",8196,5613,5563,28,50,"PSOE",1124
37,"37265",220,181,181,0,0,"PSOE",82
18,"18059",4180,2907,2870,20,37,"PSOE",1113
42,"42181",412,313,307,2,6,"PSOE",134
4,"4077",295,263,261,2,2,"PSOE",64
24,"24002",231,173,172,1,1,"PSOE",50
22,"22128",188,146,144,3,2,"PSOE",43
24,"24066",494,368,366,4,2,"PSOE",64
49,"49096",170,131,124,2,7,"PSOE",42
31,"31205",427,299,297,4,2,"PSOE",99
31,"31006",1927,1350,1332,13,18,"PSOE",375
13,"13027",3415,2380,2354,4,26,"PSOE",921
37,"37006",138,103,103,2,0,"PSOE",11
2,"2009",19660,14256,14116,127,140,"PSOE",4011
11,"11010",6410,4189,4130,88,59,"PSOE",1583
40,"40056",34,28,28,1,0,"PSOE",3
46,"46199",5718,4314,4266,28,48,"PSOE",922
16,"16266",368,264,259,1,5,"PSOE",51
22,"22086",215,161,159,1,2,"PSOE",30
19,"19151",1064,744,726,1,18,"PSOE",174
16,"16154",4871,3547,3509,24,38,"PSOE",1001
33,"33060",14633,9647,9474,72,173,"PSOE",3391
2,"2010",1789,1437,1421,11,16,"PSOE",491
34,"34112",46,38,37,0,1,"PSOE",6
6,"6120",3389,2502,2478,12,24,"PSOE",1098
4,"4079",51383,33777,33586,257,191,"PSOE",6735
9,"9058",390,283,279,1,4,"PSOE",48
28,"28162",2617,2029,2016,6,13,"PSOE",272
28,"28008",1799,1182,1174,4,8,"PSOE",249
2,"2011",632,520,516,1,4,"PSOE",229
6,"6030",169,137,135,0,2,"PSOE",63
26,"26131",35,33,33,1,0,"PSOE",5
47,"47020",280,234,231,2,3,"PSOE",58
5,"5159",252,165,164,0,1,"PSOE",9
18,"18020",1028,691,686,3,5,"PSOE",334
14,"14046",4485,3268,3208,33,60,"PSOE",1078
21,"21057",1041,661,657,12,4,"PSOE",358
16,"16270",162,137,137,0,0,"PSOE",20
41,"41057",269,183,181,0,2,"PSOE",81
5,"5110",711,510,505,4,5,"PSOE",103
13,"13032",1137,841,835,2,6,"PSOE",323
44,"44021",107,89,88,0,1,"PSOE",19
31,"31208",2556,1949,1920,16,29,"PSOE",724
26,"26029",37,32,32,0,0,"PSOE",10
11,"11013",2312,1547,1518,15,29,"PSOE",644
22,"22088",153,110,110,2,0,"PSOE",34
47,"47100",138,117,117,1,0,"PSOE",38
44,"44228",100,82,82,0,0,"PSOE",23
9,"9192",55,43,43,0,0,"PSOE",10
42,"42049",116,81,81,1,0,"PSOE",10
13,"13033",1633,1328,1290,4,38,"PSOE",612
47,"47156",162,136,133,0,3,"PSOE",28
45,"45065",271,207,206,1,1,"PSOE",75
24,"24172",418,255,250,2,5,"PSOE",51
9,"9456",130,97,96,0,1,"PSOE",33
45,"45164",182,162,160,1,2,"PSOE",42
50,"50148",316,233,229,4,4,"PSOE",76
16,"16112",1497,1031,1021,9,10,"PSOE",346
34,"34220",147,126,125,3,1,"PSOE",37
9,"9458",469,343,336,5,7,"PSOE",66
9,"9061",162,124,123,0,1,"PSOE",9
31,"31210",196,152,152,2,0,"PSOE",23
4,"4082",297,200,200,0,0,"PSOE",60
33,"33064",234,168,167,1,1,"PSOE",63
10,"10107",1031,801,792,3,9,"PSOE",341
5,"5260",105,90,90,0,0,"PSOE",13
26,"26031",106,83,83,0,0,"PSOE",36
3,"3037",346,282,278,3,4,"PSOE",73
50,"50053",687,513,510,2,3,"PSOE",206
34,"34072",152,136,135,2,1,"PSOE",20
6,"6034",171,121,120,4,1,"PSOE",41
31,"31211",27,15,15,1,0,"PSOE",0
21,"21060",11957,7356,7279,88,77,"PSOE",2349
26,"26172",30,23,23,0,0,"PSOE",8
50,"50181",993,733,720,5,13,"PSOE",182
3,"3132",534,436,435,3,1,"PSOE",142
47,"47158",889,667,659,8,8,"PSOE",249
37,"37013",119,79,76,0,3,"PSOE",7
45,"45166",1617,1305,1286,8,19,"PSOE",538
41,"41060",15242,10021,9847,86,174,"PSOE",3567
39,"39059",7986,5879,5806,45,73,"PSOE",1411
3,"3039",81,62,61,1,1,"PSOE",8
12,"12074",785,652,648,5,4,"PSOE",215
44,"44024",27,25,25,0,0,"PSOE",4
31,"31013",642,406,401,1,5,"PSOE",37
37,"37274",118913,85506,84764,566,742,"PSOE",17019
9,"9196",149,103,103,1,0,"PSOE",30
12,"12006",172,135,133,0,2,"PSOE",48
42,"42015",30,20,19,1,1,"PSOE",3
16,"16117",1040,787,777,4,10,"PSOE",286
22,"22095",72,58,58,1,0,"PSOE",20
28,"28013",40471,28739,28490,188,249,"PSOE",6326
12,"12075",123,88,88,0,0,"PSOE",22
46,"46902",364,306,303,0,3,"PSOE",115
45,"45168",62229,47154,46741,285,413,"PSOE",10230
5,"5017",85,82,81,5,1,"PSOE",11
18,"18163",324,235,233,2,2,"PSOE",85
21,"21064",6522,4227,4146,48,81,"PSOE",1729
45,"45069",1847,1391,1376,6,15,"PSOE",382
46,"46049",281,232,224,0,8,"PSOE",48
19,"19160",886,558,552,2,6,"PSOE",104
26,"26034",654,497,489,1,8,"PSOE",165
9,"9466",129,97,97,1,0,"PSOE",14
47,"47078",163,127,125,1,2,"PSOE",21
29,"29068",7016,4300,4244,35,56,"PSOE",1198
40,"40194",39602,29382,29042,206,340,"PSOE",6654
26,"26140",253,208,206,0,2,"PSOE",46
49,"49107",126,94,93,2,1,"PSOE",37
9,"9335",88,68,68,0,0,"PSOE",21
26,"26141",113,87,82,0,5,"PSOE",10
42,"42055",164,121,121,0,0,"PSOE",34
16,"16026",82,62,61,2,1,"PSOE",23
11,"11019",1826,1302,1248,7,54,"PSOE",478
18,"18120",264,209,208,1,1,"PSOE",135
29,"29013",1610,1238,1207,9,31,"PSOE",523
4,"4087",182,135,135,0,0,"PSOE",35
46,"46103",1264,1015,984,7,31,"PSOE",210
19,"19268",35,24,24,1,0,"PSOE",5
37,"37278",732,532,528,3,4,"PSOE",74
47,"47079",58,48,47,0,1,"PSOE",3
3,"3136",441,338,334,0,4,"PSOE",64
40,"40070",149,107,105,1,2,"PSOE",15
50,"50154",116,96,96,0,0,"PSOE",7
19,"19163",56,41,40,0,1,"PSOE",6
24,"24178",70,59,58,0,1,"PSOE",9
40,"40071",43,39,38,1,1,"PSOE",5
9,"9068",29,24,24,0,0,"PSOE",6
19,"19269",102,81,80,0,1,"PSOE",30
40,"40905",133,103,100,1,3,"PSOE",13
4,"4088",2454,1660,1650,15,10,"PSOE",698
26,"26143",220,175,173,1,2,"PSOE",37
3,"3137",651,492,489,5,3,"PSOE",94
3,"3043",2911,2431,2399,13,32,"PSOE",616
9,"9338",227,170,169,0,1,"PSOE",45
47,"47080",30,22,21,0,1,"PSOE",1
2,"2023",568,486,479,3,7,"PSOE",152
29,"29071",934,596,588,3,8,"PSOE",226
19,"19270",20,17,17,0,0,"PSOE",1
5,"5124",102,83,81,0,2,"PSOE",13
6,"6135",1092,846,828,0,18,"PSOE",259
44,"44029",559,425,424,5,1,"PSOE",179
5,"5903",151,104,104,2,0,"PSOE",30
41,"41067",7093,4930,4866,37,64,"PSOE",1869
47,"47002",23,21,20,1,1,"PSOE",2
11,"11022",48675,26491,26256,270,235,"PSOE",8659
3,"3044",4521,3510,3465,21,45,"PSOE",751
9,"9202",25,22,22,1,0,"PSOE",1
31,"31219",84,66,66,0,0,"PSOE",16
10,"10118",286,251,249,1,2,"PSOE",107
45,"45173",9520,6938,6864,30,74,"PSOE",1601
50,"50090",150,113,112,0,1,"PSOE",15
19,"19044",304,245,244,0,1,"PSOE",45
45,"45074",414,327,323,1,4,"PSOE",92
9,"9206",59,45,45,0,0,"PSOE",7
31,"31220",744,583,579,8,4,"PSOE",158
18,"18124",381,277,277,2,0,"PSOE",69
28,"28018",3768,2968,2945,26,23,"PSOE",521
4,"4090",304,238,234,0,4,"PSOE",106
19,"19167",130,101,99,0,2,"PSOE",14
13,"13049",799,540,531,0,9,"PSOE",149
49,"49189",202,142,142,1,0,"PSOE",14
40,"40074",255,222,219,2,3,"PSOE",32
11,"11024",6723,4696,4634,44,62,"PSOE",1972
24,"24181",1493,1054,1045,5,9,"PSOE",350
40,"40200",40,31,31,0,0,"PSOE",12
24,"24114",3061,2025,1994,9,31,"PSOE",771
13,"13050",493,378,375,3,3,"PSOE",109
26,"26007",511,384,375,0,9,"PSOE",96
6,"6001",686,522,515,0,7,"PSOE",175
16,"16906",80,67,67,1,0,"PSOE",19
37,"37024",89,67,67,0,0,"PSOE",18
3,"3140",26070,18999,18742,174,257,"PSOE",4092
40,"40201",49,42,42,0,0,"PSOE",3
2,"2068",337,251,246,1,5,"PSOE",94
46,"46133",533,415,410,6,5,"PSOE",188
3,"3077",1371,1071,1060,13,11,"PSOE",243
24,"24083",1042,727,715,6,12,"PSOE",292
22,"22235",98,76,76,1,0,"PSOE",30
9,"9480",110,90,90,1,0,"PSOE",12
4,"4092",2838,2127,2103,10,24,"PSOE",737
46,"46055",1262,1025,1012,5,13,"PSOE",190
11,"11026",4782,3451,3378,26,73,"PSOE",1194
14,"14029",4178,3047,3009,28,38,"PSOE",1306
34,"34087",129,103,102,1,1,"PSOE",23
47,"47220",165,130,129,0,1,"PSOE",20
44,"44034",139,109,108,0,1,"PSOE",24
28,"28021",554,370,364,3,6,"PSOE",44
12,"12083",93,79,76,0,3,"PSOE",24
47,"47166",259,204,197,2,7,"PSOE",45
10,"10123",578,481,475,1,6,"PSOE",247
6,"6050",4106,3134,3075,25,59,"PSOE",968
18,"18038",1066,828,802,1,26,"PSOE",374
19,"19278",28,26,26,0,0,"PSOE",4
50,"50253",423,330,328,4,2,"PSOE",84
9,"9347",143,117,115,2,2,"PSOE",10
39,"39068",646,450,445,2,5,"PSOE",99
2,"2030",3065,2287,2263,6,24,"PSOE",996
47,"47167",241,204,204,1,0,"PSOE",68
49,"49116",383,276,269,3,7,"PSOE",61
50,"50065",53,43,43,0,0,"PSOE",11
50,"50254",180,118,116,1,2,"PSOE",34
37,"37287",310,213,210,2,3,"PSOE",30
28,"28022",33479,27129,27037,133,92,"PSOE",2849
6,"6006",4572,3088,3049,26,39,"PSOE",1311
10,"10171",344,245,244,0,1,"PSOE",129
24,"24154",1005,673,666,4,7,"PSOE",198
5,"5084",74,53,53,0,0,"PSOE",12
16,"16240",102,78,78,0,0,"PSOE",27
19,"19008",37,28,27,1,1,"PSOE",2
22,"22239",88,72,72,0,0,"PSOE",18
40,"40206",173,135,134,0,1,"PSOE",14
37,"37029",209,137,135,1,2,"PSOE",48
21,"21077",1711,1224,1202,3,22,"PSOE",589
31,"31225",36,27,27,0,0,"PSOE",7
39,"39070",144,96,94,2,2,"PSOE",25
47,"47086",3906,2970,2936,24,34,"PSOE",962
50,"50066",2621,1862,1851,9,11,"PSOE",275
44,"44244",75,47,47,1,0,"PSOE",10
9,"9214",672,427,427,4,0,"PSOE",104
42,"42206",8,8,8,1,0,"PSOE",0
13,"13005",23298,17250,17070,140,180,"PSOE",4897
37,"37249",43,29,29,0,0,"PSOE",5
50,"50131",231,167,165,0,2,"PSOE",47
46,"46006",4523,3665,3623,20,42,"PSOE",702
33,"33078",142,101,99,0,2,"PSOE",35
34,"34137",27,23,22,0,1,"PSOE",12
5,"5135",425,317,315,5,2,"PSOE",52
47,"47008",24,19,19,1,0,"PSOE",0
3,"3051",348,296,294,0,2,"PSOE",74
37,"37031",361,269,266,2,3,"PSOE",46
50,"50098",174,130,124,0,6,"PSOE",40
37,"37166",214,152,151,2,1,"PSOE",35
31,"31126",358,223,223,2,0,"PSOE",16
9,"9216",387,270,265,1,5,"PSOE",43
28,"28090",8505,6654,6609,33,45,"PSOE",1046
44,"44146",174,153,152,2,1,"PSOE",65
23,"23094",3839,3009,2954,14,55,"PSOE",1350
9,"9352",114,92,92,1,0,"PSOE",23
3,"3052",970,769,755,8,14,"PSOE",146
10,"10129",365,275,271,0,4,"PSOE",123
46,"46216",5053,4109,4090,14,19,"PSOE",569
4,"4002",1039,748,740,2,8,"PSOE",342
13,"13061",5702,3867,3822,28,45,"PSOE",1193
12,"12089",4328,3078,3020,15,58,"PSOE",486
40,"40083",77,59,59,0,0,"PSOE",4
16,"16137",54,32,31,1,1,"PSOE",4
42,"42208",22,13,13,2,0,"PSOE",2
6,"6057",576,479,471,0,8,"PSOE",185
22,"22001",225,151,151,1,0,"PSOE",21
50,"50196",107,87,86,0,1,"PSOE",50
19,"19175",32,28,28,0,0,"PSOE",4
34,"34141",177,149,145,2,4,"PSOE",28
26,"26048",22,22,22,0,0,"PSOE",5
19,"19284",10,10,9,0,1,"PSOE",5
37,"37169",176,127,126,0,1,"PSOE",47
16,"16001",76,61,61,0,0,"PSOE",13
49,"49003",900,612,599,5,13,"PSOE",146
47,"47171",407,303,301,6,2,"PSOE",49
31,"31128",359,265,263,0,2,"PSOE",38
46,"46217",878,691,676,4,15,"PSOE",164
26,"26154",13,10,10,0,0,"PSOE",2
6,"6013",265,212,209,3,3,"PSOE",131
22,"22003",137,110,107,1,3,"PSOE",24
16,"16002",187,158,158,1,0,"PSOE",38
31,"31230",106,82,82,1,0,"PSOE",18
47,"47172",144,124,122,0,2,"PSOE",22
42,"42211",82,66,66,1,0,"PSOE",8
49,"49123",546,391,384,1,7,"PSOE",120
47,"47090",2418,1728,1699,8,29,"PSOE",452
31,"31030",141,100,99,0,1,"PSOE",8
9,"9355",98,75,75,0,0,"PSOE",3
45,"45017",262,204,203,0,1,"PSOE",84
9,"9219",27509,19084,18859,146,225,"PSOE",5474
19,"19102",98,79,78,0,1,"PSOE",23
45,"45185",7700,5771,5691,20,80,"PSOE",1950
24,"24193",378,268,265,2,3,"PSOE",55
37,"37171",409,317,310,2,7,"PSOE",41
37,"37297",425,328,322,2,6,"PSOE",83
22,"22247",33,20,20,0,0,"PSOE",11
42,"42078",1020,717,703,7,14,"PSOE",175
6,"6016",2986,2114,2078,14,36,"PSOE",1009
39,"39075",137376,99899,99048,718,851,"PSOE",21288
16,"16142",136,101,101,1,0,"PSOE",36
45,"45186",3061,2242,2214,11,28,"PSOE",463
31,"31232",25155,17648,17450,196,198,"PSOE",3765
37,"37298",179,127,126,0,1,"PSOE",32
26,"26051",239,193,191,1,2,"PSOE",26
45,"45053",8005,6211,6140,42,71,"PSOE",2043
13,"13067",351,281,279,0,2,"PSOE",120
19,"19179",69,56,56,1,0,"PSOE",21
50,"50169",351,269,265,0,4,"PSOE",67
49,"49126",235,155,154,2,1,"PSOE",39
23,"23101",378,276,271,1,5,"PSOE",150
9,"9221",461,343,338,3,5,"PSOE",66
26,"26052",154,121,117,0,4,"PSOE",25
5,"5144",76,55,54,0,1,"PSOE",12
34,"34009",31,29,29,1,0,"PSOE",2
42,"42215",773,531,520,7,11,"PSOE",150
10,"10137",397,320,317,3,3,"PSOE",155
34,"34010",577,440,438,5,2,"PSOE",85
45,"45087",8311,5828,5747,43,81,"PSOE",1491
31,"31233",97,74,74,0,0,"PSOE",16
28,"28030",1726,1320,1299,8,21,"PSOE",230
34,"34151",159,104,103,0,1,"PSOE",16
50,"50073",2141,1592,1577,7,15,"PSOE",415
6,"6064",841,666,656,2,10,"PSOE",333
50,"50293",413,276,275,4,1,"PSOE",97
49,"49127",2367,1668,1650,16,18,"PSOE",334
22,"22250",353,261,258,4,3,"PSOE",54
9,"9088",66,45,45,0,0,"PSOE",10
10,"10001",282,225,223,3,2,"PSOE",111
40,"40091",119,97,95,1,2,"PSOE",19
9,"9361",115,90,89,0,1,"PSOE",12
34,"34152",125,96,92,1,4,"PSOE",27
13,"13019",5181,3621,3579,18,42,"PSOE",947
50,"50139",313,241,239,3,2,"PSOE",74
3,"3058",4951,3897,3851,30,46,"PSOE",697
47,"47204",256,204,198,0,6,"PSOE",45
44,"44152",64,46,45,0,1,"PSOE",1
29,"29088",2714,1829,1800,12,29,"PSOE",838
16,"16008",89,69,69,0,0,"PSOE",27
46,"46065",1579,1174,1163,8,11,"PSOE",199
18,"18011",4335,3037,3015,20,22,"PSOE",1003
37,"37041",78,52,52,0,0,"PSOE",2
5,"5149",106,77,77,1,0,"PSOE",13
22,"22125",38773,27021,26732,258,289,"PSOE",6411
37,"37302",290,196,195,2,1,"PSOE",55
31,"31235",159,117,115,2,2,"PSOE",22
13,"13073",531,399,391,3,8,"PSOE",148
16,"16148",573,504,500,4,4,"PSOE",111
5,"5245",353,286,285,3,1,"PSOE",51
9,"9226",63,54,54,0,0,"PSOE",9
6,"6159",2329,1351,1318,16,33,"PSOE",640
11,"11039",10018,6186,6109,103,77,"PSOE",2063
4,"4902",45437,28936,28699,214,237,"PSOE",5452
49,"49048",124,97,95,0,2,"PSOE",11
31,"31136",447,299,298,2,1,"PSOE",28
6,"6022",2651,2089,2054,10,35,"PSOE",983
50,"50173",182,132,131,1,1,"PSOE",26
34,"34060",137,111,108,0,3,"PSOE",26
37,"37044",466,362,360,2,2,"PSOE",69
49,"49130",180,143,141,5,2,"PSOE",33
2,"2046",1098,896,878,12,18,"PSOE",255
44,"44258",67,47,47,0,0,"PSOE",10
47,"47068",34,26,26,0,0,"PSOE",6
21,"21010",14687,8293,8220,92,73,"PSOE",2611
10,"10006",1263,978,970,2,8,"PSOE",459
31,"31137",205,112,109,6,3,"PSOE",9
4,"4011",2765,2119,2096,21,23,"PSOE",864
19,"19065",127,104,104,3,0,"PSOE",30
34,"34157",2442,1792,1768,21,24,"PSOE",369
28,"28100",4196,2987,2955,14,32,"PSOE",433
24,"24201",1090,762,759,10,3,"PSOE",199
16,"16012",84,72,71,0,1,"PSOE",32
13,"13077",3489,2205,2152,18,53,"PSOE",675
34,"34018",209,168,164,1,4,"PSOE",30
49,"49132",316,235,232,1,3,"PSOE",44
22,"22174",478,379,378,2,1,"PSOE",95
10,"10007",629,459,454,5,5,"PSOE",146
45,"45093",155,129,127,1,2,"PSOE",21
4,"4904",1777,1230,1221,12,9,"PSOE",223
3,"3032",108,91,90,1,1,"PSOE",18
9,"9229",198,146,143,0,3,"PSOE",43
10,"10008",1319,1019,1008,6,11,"PSOE",364
11,"11042",1186,868,858,7,10,"PSOE",403
37,"37223",110,85,83,0,2,"PSOE",27
47,"47153",108,77,77,0,0,"PSOE",15
26,"26166",141,124,122,0,2,"PSOE",9
40,"40099",52,44,42,0,2,"PSOE",11
47,"47097",325,266,265,0,1,"PSOE",98
31,"31239",322,211,211,5,0,"PSOE",10
4,"4013",141378,94872,94288,741,584,"PSOE",22702
14,"14072",1048,806,795,6,11,"PSOE",409
9,"9098",507,369,362,5,7,"PSOE",99
18,"18061",1057,812,804,1,8,"PSOE",245
49,"49014",112,91,91,2,0,"PSOE",20
26,"26167",59,47,46,1,1,"PSOE",4
44,"44050",3113,2120,2100,25,20,"PSOE",498
5,"5002",1963,1422,1390,3,32,"PSOE",337
16,"16015",374,263,262,4,1,"PSOE",47
26,"26095",100,83,82,0,1,"PSOE",40
49,"49259",89,66,65,1,1,"PSOE",2
6,"6074",4791,3513,3449,18,64,"PSOE",1197
18,"18017",18114,11610,11510,77,100,"PSOE",2847
13,"13081",636,480,472,9,8,"PSOE",217
42,"42089",54,44,44,0,0,"PSOE",12
22,"22902",221,159,156,0,3,"PSOE",26
31,"31041",1606,1114,1101,15,13,"PSOE",170
29,"29005",4358,2859,2817,28,42,"PSOE",914
37,"37184",327,255,252,2,3,"PSOE",67
45,"45196",1400,1047,1033,5,14,"PSOE",334
12,"12034",1424,1065,1035,3,30,"PSOE",317
44,"44051",2683,1977,1946,17,31,"PSOE",591
22,"22220",166,126,125,2,1,"PSOE",37
45,"45029",201,171,171,1,0,"PSOE",58
31,"31174",110,63,63,0,0,"PSOE",9
18,"18063",1200,679,675,2,4,"PSOE",313
31,"31141",110,71,70,1,1,"PSOE",5
29,"29006",673,428,420,1,8,"PSOE",202
31,"31142",1403,958,949,10,9,"PSOE",209
42,"42090",91,69,67,1,2,"PSOE",23
13,"13084",892,701,685,6,16,"PSOE",242
18,"18157",1121,815,803,3,12,"PSOE",214
10,"10150",346,285,279,3,6,"PSOE",158
50,"50271",252,200,197,2,3,"PSOE",48
16,"16017",366,294,294,2,0,"PSOE",101
10,"10013",276,207,200,0,7,"PSOE",57
28,"28009",14086,10611,10545,57,66,"PSOE",1819
13,"13085",2342,1921,1855,10,66,"PSOE",671
44,"44160",466,304,301,2,3,"PSOE",47
18,"18021",17485,11800,11669,95,131,"PSOE",3194
45,"45197",1906,1455,1430,8,25,"PSOE",632
45,"45198",1809,1475,1442,7,33,"PSOE",459
37,"37054",250,195,192,1,3,"PSOE",66
40,"40105",47,42,42,2,0,"PSOE",7
28,"28106",76907,52773,52265,385,508,"PSOE",12518
34,"34165",66,58,58,1,0,"PSOE",1
29,"29008",14596,9519,9407,94,112,"PSOE",2693
49,"49019",243,188,182,2,6,"PSOE",44
5,"5162",86,66,63,0,3,"PSOE",16
37,"37187",572,427,423,1,4,"PSOE",116
12,"12038",167,120,118,2,2,"PSOE",24
18,"18159",995,797,795,2,2,"PSOE",305
28,"28039",128,98,97,2,1,"PSOE",26
40,"40106",201,158,158,2,0,"PSOE",54
16,"16159",220,159,159,0,0,"PSOE",54
18,"18023",15655,10879,10774,82,105,"PSOE",3545
49,"49020",289,214,214,2,0,"PSOE",59
21,"21020",365,223,222,1,1,"PSOE",99
33,"33004",66857,46390,45960,426,430,"PSOE",11357
3,"3131",175,154,147,0,7,"PSOE",12
24,"24039",2063,1597,1596,41,1,"PSOE",341
50,"50273",30,22,22,0,0,"PSOE",6
42,"42094",621,444,433,10,11,"PSOE",85
3,"3007",166,139,137,0,2,"PSOE",16
22,"22055",320,243,238,2,5,"PSOE",78
28,"28040",15811,10118,10009,56,109,"PSOE",2103
42,"42095",1773,1269,1251,15,18,"PSOE",311
31,"31046",57,39,39,1,0,"PSOE",5
31,"31045",508,355,350,8,5,"PSOE",63
18,"18161",212,175,174,3,1,"PSOE",70
13,"13089",1706,1368,1332,8,36,"PSOE",467
16,"16161",57,48,46,0,2,"PSOE",5
46,"46152",96,68,68,0,0,"PSOE",15
40,"40107",100,73,73,1,0,"PSOE",7
4,"4019",249,196,196,1,0,"PSOE",103
40,"40234",397,298,292,2,6,"PSOE",86
49,"49022",288,229,225,3,4,"PSOE",79
5,"5016",6335,4670,4586,41,84,"PSOE",884
37,"37191",114,78,75,1,3,"PSOE",20
9,"9421",230,166,163,3,3,"PSOE",46
31,"31113",133,87,86,0,1,"PSOE",14
29,"29011",2900,1822,1803,9,19,"PSOE",944
6,"6036",5075,3575,3535,35,40,"PSOE",1401
16,"16162",43,35,34,0,1,"PSOE",12
39,"39090",756,553,542,0,11,"PSOE",105
22,"22021",1971,1414,1398,17,16,"PSOE",484
9,"9283",44,32,31,0,1,"PSOE",3
9,"9026",386,301,300,0,1,"PSOE",61
28,"28070",117,91,91,0,0,"PSOE",7
18,"18912",1473,994,979,3,15,"PSOE",547
16,"16163",74,62,62,0,0,"PSOE",25
4,"4020",288,201,197,0,4,"PSOE",73
9,"9242",80,66,66,2,0,"PSOE",22
31,"31248",299,165,162,0,3,"PSOE",25
29,"29902",2567,1577,1559,11,18,"PSOE",799
29,"29012",9755,6689,6599,71,90,"PSOE",2778
34,"34171",968,708,703,5,5,"PSOE",144
45,"45103",397,331,327,3,4,"PSOE",126
22,"22022",552,414,408,6,6,"PSOE",131
10,"10158",330,269,267,0,2,"PSOE",161
9,"9110",80,63,63,0,0,"PSOE",11
26,"26068",80,61,61,1,0,"PSOE",18
18,"18913",813,566,559,2,7,"PSOE",137
6,"6039",1840,1469,1437,9,32,"PSOE",848
18,"18029",1833,1196,1190,12,6,"PSOE",625
7,"7051",5215,3171,3134,39,37,"PSOE",579
9,"9424",36,29,29,1,0,"PSOE",4
5,"5267",101,72,70,0,2,"PSOE",7
46,"46077",7496,5909,5827,45,82,"PSOE",1329
9,"9112",109,85,85,0,0,"PSOE",20
49,"49147",263,190,186,0,4,"PSOE",51
31,"31049",699,469,465,2,4,"PSOE",14
46,"46904",792,610,603,8,7,"PSOE",123
19,"19307",27,23,23,0,0,"PSOE",2
29,"29014",217,141,140,4,1,"PSOE",53
45,"45004",567,410,406,1,4,"PSOE",128
9,"9244",46,34,34,1,0,"PSOE",10
24,"24214",656,490,485,3,5,"PSOE",170
44,"44062",34,25,22,0,3,"PSOE",6
26,"26178",75,57,55,1,2,"PSOE",16
9,"9425",517,384,378,0,6,"PSOE",119
24,"24110",1247,899,892,6,7,"PSOE",349
39,"39002",3298,2342,2309,13,33,"PSOE",688
26,"26177",304,255,254,7,1,"PSOE",60
13,"13097",2270,1687,1671,7,16,"PSOE",562
5,"5023",168,146,145,1,1,"PSOE",37
49,"49271",194,145,141,1,4,"PSOE",54
46,"46078",28017,20288,20143,132,145,"PSOE",4829
31,"31150",213,156,155,1,1,"PSOE",14
5,"5075",107,72,72,0,0,"PSOE",13
19,"19235",93,71,71,1,0,"PSOE",34
6,"6043",665,490,484,2,6,"PSOE",173
34,"34036",211,150,150,0,0,"PSOE",49
3,"3074",1707,1397,1389,4,8,"PSOE",290
46,"46157",2980,2321,2298,10,23,"PSOE",474
24,"24014",7425,5124,5053,32,71,"PSOE",1564
50,"50187",69,44,44,0,0,"PSOE",12
18,"18171",2120,1572,1551,9,21,"PSOE",655
49,"49272",88,70,69,1,1,"PSOE",7
30,"30002",9903,7011,6943,28,68,"PSOE",1534
22,"22149",305,228,228,0,0,"PSOE",65
44,"44063",71,54,54,0,0,"PSOE",13
22,"22193",276,225,224,2,1,"PSOE",59
50,"50029",626,450,450,3,0,"PSOE",232
34,"34038",277,204,203,1,1,"PSOE",28
24,"24015",2265,1649,1635,18,14,"PSOE",357
3,"3075",147,128,128,0,0,"PSOE",12
16,"16032",278,224,221,1,3,"PSOE",72
39,"39004",1518,1090,1074,4,16,"PSOE",322
19,"19087",18,18,18,0,0,"PSOE",7
31,"31153",2159,1403,1387,12,16,"PSOE",154
26,"26180",221,173,172,0,1,"PSOE",27
5,"5127",643,519,514,3,5,"PSOE",125
26,"26073",97,78,78,0,0,"PSOE",22
9,"9388",34,27,26,0,1,"PSOE",7
19,"19088",79,61,61,0,0,"PSOE",12
47,"47029",57,52,52,0,0,"PSOE",12
34,"34232",750,578,564,7,14,"PSOE",182
26,"26181",14,14,14,0,0,"PSOE",4
28,"28084",15859,11156,11058,64,98,"PSOE",2462
23,"23047",1629,1258,1250,10,8,"PSOE",602
10,"10167",314,239,239,1,0,"PSOE",102
50,"50190",695,523,515,3,8,"PSOE",218
26,"26183",64,49,49,0,0,"PSOE",8
42,"42108",12,9,9,1,0,"PSOE",2
3,"3016",93,75,75,0,0,"PSOE",16
18,"18036",3851,2870,2841,17,29,"PSOE",622
12,"12048",251,185,182,0,3,"PSOE",55
6,"6048",849,691,677,7,14,"PSOE",319
41,"41003",2333,1693,1671,13,22,"PSOE",692
46,"46003",950,791,769,1,22,"PSOE",190
33,"33013",446,321,318,3,3,"PSOE",84
47,"47030",993,766,751,6,15,"PSOE",142
46,"46107",1900,1516,1504,5,12,"PSOE",422
41,"41004",56640,37110,36649,440,461,"PSOE",11911
18,"18037",535,402,396,2,6,"PSOE",127
24,"24084",163,116,116,0,0,"PSOE",35
14,"14002",10951,7706,7620,83,86,"PSOE",3526
34,"34181",448,322,319,7,3,"PSOE",125
9,"9251",375,277,274,4,3,"PSOE",35
10,"10031",165,135,134,1,1,"PSOE",41
28,"28049",58480,45136,44820,242,316,"PSOE",10536
49,"49192",130,110,109,2,1,"PSOE",45
46,"46108",469,378,375,1,3,"PSOE",134
23,"23009",12861,9649,9543,72,106,"PSOE",3194
9,"9167",58,41,41,1,0,"PSOE",2
3,"3018",12240,8853,8777,47,76,"PSOE",1898
31,"31256",107,59,59,0,0,"PSOE",3
46,"46161",1483,1188,1173,7,15,"PSOE",285
49,"49033",714,508,505,1,3,"PSOE",123
24,"24019",354,272,267,3,5,"PSOE",95
41,"41005",9068,6366,6281,58,85,"PSOE",2480
23,"23010",14347,9669,9560,86,109,"PSOE",3315
5,"5035",100,84,84,0,0,"PSOE",34
10,"10033",423,320,320,0,0,"PSOE",102
6,"6051",1571,1192,1178,7,14,"PSOE",556
10,"10216",1538,1175,1162,4,13,"PSOE",443
49,"49239",663,458,448,3,10,"PSOE",182
21,"21075",349,275,270,4,5,"PSOE",133
42,"42161",137,102,101,0,1,"PSOE",13
44,"44003",19,17,17,0,0,"PSOE",3
3,"3019",15269,11520,11398,72,122,"PSOE",2622
16,"16181",64,52,52,2,0,"PSOE",14
40,"40124",237,182,177,6,5,"PSOE",43
50,"50096",39,27,27,0,0,"PSOE",6
10,"10172",709,466,465,0,1,"PSOE",158
24,"24020",456,314,307,4,7,"PSOE",75
46,"46240",210,164,161,1,3,"PSOE",22
24,"24021",1675,1162,1144,8,18,"PSOE",352
5,"5182",786,538,532,2,6,"PSOE",107
23,"23011",2170,1515,1496,7,19,"PSOE",721
50,"50004",522,390,388,0,2,"PSOE",148
49,"49118",203,161,160,1,1,"PSOE",33
18,"18087",184857,134428,133526,864,902,"PSOE",29027
9,"9304",199,157,155,3,2,"PSOE",13
45,"45146",107,84,83,0,1,"PSOE",16
19,"19244",82,65,64,1,1,"PSOE",9
44,"44178",58,37,37,0,0,"PSOE",5
7,"7023",3604,2498,2470,49,28,"PSOE",508
2,"2074",5935,4193,4139,32,54,"PSOE",1350
19,"19322",31,25,25,0,0,"PSOE",8
18,"18180",633,410,410,3,0,"PSOE",203
24,"24055",708,516,512,0,4,"PSOE",132
50,"50194",88,63,63,1,0,"PSOE",15
9,"9125",584,432,430,1,2,"PSOE",69
12,"12053",2034,1655,1633,6,22,"PSOE",439
18,"18043",123,80,79,1,1,"PSOE",11
24,"24022",330,230,229,0,1,"PSOE",45
47,"47035",921,717,715,3,2,"PSOE",208
22,"22160",209,168,168,6,0,"PSOE",42
40,"40126",79,56,54,0,2,"PSOE",3
19,"19211",369,289,284,0,5,"PSOE",71
44,"44179",337,229,226,1,3,"PSOE",56
4,"4033",135,97,93,1,4,"PSOE",52
41,"41098",5004,3665,3630,26,35,"PSOE",1118
22,"22162",130,102,102,0,0,"PSOE",21
39,"39012",6687,5021,4957,51,64,"PSOE",1275
34,"34192",90,75,72,0,3,"PSOE",10
50,"50007",45,34,34,1,0,"PSOE",5
24,"24056",2883,2040,2003,11,37,"PSOE",659
14,"14006",1330,1120,1101,8,19,"PSOE",364
42,"42165",409,271,261,10,10,"PSOE",73
6,"6103",4796,3265,3220,20,45,"PSOE",1291
16,"16092",158,125,125,1,0,"PSOE",19
44,"44180",70,61,61,0,0,"PSOE",18
12,"12021",4436,3381,3332,27,49,"PSOE",842
45,"45116",687,509,505,1,4,"PSOE",146
23,"23016",387,321,320,0,1,"PSOE",176
19,"19324",176,126,125,3,1,"PSOE",44
34,"34051",101,88,83,0,5,"PSOE",4
50,"50197",90,67,67,2,0,"PSOE",12
47,"47036",228,181,181,3,0,"PSOE",54
19,"19325",121,83,82,0,1,"PSOE",9
39,"39013",511,402,399,4,3,"PSOE",65
4,"4035",8364,5810,5766,28,44,"PSOE",2248
16,"16189",264,206,205,4,1,"PSOE",38
46,"46165",7129,5436,5388,25,48,"PSOE",1007
3,"3084",539,454,446,3,8,"PSOE",129
31,"31063",92,75,73,2,2,"PSOE",10
37,"37212",104,78,74,0,4,"PSOE",15
50,"50290",386,283,282,1,1,"PSOE",93
40,"40003",139,107,104,0,3,"PSOE",10
19,"19214",75,60,58,0,2,"PSOE",19
45,"45151",578,417,414,0,3,"PSOE",140
41,"41012",3290,2071,2030,20,41,"PSOE",864
11,"11034",2334,1549,1517,14,32,"PSOE",796
37,"37083",182,156,155,0,1,"PSOE",44
46,"46166",8155,6320,6251,30,69,"PSOE",1123
26,"26084",6696,5012,4955,35,57,"PSOE",854
24,"24026",1177,864,849,7,15,"PSOE",133
37,"37213",89,74,73,0,1,"PSOE",8
31,"31064",1424,1121,1104,3,17,"PSOE",324
2,"2079",2875,2209,2181,12,28,"PSOE",562
9,"9262",163,130,127,1,3,"PSOE",31
5,"5190",53,42,41,2,1,"PSOE",3
49,"49164",155,119,115,2,4,"PSOE",39
45,"45018",498,333,330,4,3,"PSOE",76
19,"19215",168,144,140,0,4,"PSOE",24
44,"44080",292,229,223,3,6,"PSOE",74
24,"24194",290,212,212,3,0,"PSOE",129
21,"21004",1631,1045,1028,13,17,"PSOE",508
46,"46167",364,266,264,0,2,"PSOE",92
22,"22165",487,364,360,6,4,"PSOE",93
34,"34056",1998,1452,1444,13,8,"PSOE",284
5,"5046",44,38,38,1,0,"PSOE",13
46,"46245",511,420,415,0,5,"PSOE",99
34,"34100",142,108,108,1,0,"PSOE",25
4,"4038",3084,2140,2126,16,14,"PSOE",754
50,"50200",511,410,403,2,7,"PSOE",178
40,"40006",22,18,18,0,0,"PSOE",3
24,"24125",462,290,286,4,4,"PSOE",69
10,"10183",980,733,728,1,5,"PSOE",282
44,"44184",45,34,34,0,0,"PSOE",5
46,"46246",1058,835,823,5,12,"PSOE",181
40,"40134",731,579,570,1,9,"PSOE",169
47,"47203",62,53,53,1,0,"PSOE",5
9,"9011",65,48,48,0,0,"PSOE",5
22,"22080",280,197,194,6,3,"PSOE",36
22,"22007",792,581,581,8,0,"PSOE",139
47,"47122",2032,1563,1535,7,28,"PSOE",391
29,"29031",1614,1107,1094,13,13,"PSOE",520
10,"10184",756,613,604,10,9,"PSOE",202
34,"34205",61,50,50,0,0,"PSOE",13
16,"16195",497,392,390,1,2,"PSOE",195
19,"19105",2334,1753,1739,8,14,"PSOE",324
24,"24901",889,636,623,5,13,"PSOE",190
12,"12094",847,674,665,5,9,"PSOE",175
50,"50171",106,79,79,0,0,"PSOE",13
44,"44187",201,152,149,4,3,"PSOE",21
44,"44085",52,35,35,0,0,"PSOE",1
46,"46247",1006,714,710,3,4,"PSOE",115
50,"50202",152,100,99,1,1,"PSOE",32
40,"40218",92,65,64,1,1,"PSOE",8
9,"9409",111,86,86,4,0,"PSOE",22
37,"37089",67,56,56,0,0,"PSOE",12
12,"12027",17283,12015,11888,89,127,"PSOE",2423
50,"50295",48,43,42,0,1,"PSOE",13
21,"21008",2658,1660,1636,10,24,"PSOE",948
10,"10186",977,795,778,1,17,"PSOE",319
49,"49169",35,26,26,0,0,"PSOE",8
37,"37345",163,128,128,3,0,"PSOE",26
29,"29033",1122,747,730,4,17,"PSOE",332
24,"24097",218,140,139,3,1,"PSOE",22
44,"44221",372,303,300,1,3,"PSOE",60
24,"24130",438,323,321,4,2,"PSOE",56
28,"28060",1510,1134,1117,1,17,"PSOE",434
42,"42129",681,503,495,3,8,"PSOE",158
49,"49092",129,90,89,1,1,"PSOE",27
9,"9410",3040,2117,2095,16,22,"PSOE",644
46,"46092",276,192,189,0,3,"PSOE",26
2,"2005",559,424,416,5,8,"PSOE",115
4,"4010",576,444,443,3,1,"PSOE",232
16,"16055",691,466,463,2,3,"PSOE",139
39,"39020",23592,15594,15384,128,210,"PSOE",3839
46,"46249",9288,6746,6676,56,70,"PSOE",1839
31,"31170",47,42,42,3,0,"PSOE",4
37,"37304",169,124,124,0,0,"PSOE",23
29,"29001",4170,3106,3068,19,38,"PSOE",1266
24,"24031",215,172,168,0,4,"PSOE",46
46,"46015",7244,5615,5560,40,55,"PSOE",1167
18,"18056",3530,2641,2614,24,27,"PSOE",1041
31,"31905",2843,1983,1966,15,17,"PSOE",429
21,"21051",239,174,170,1,4,"PSOE",79
31,"31906",2562,1800,1779,26,21,"PSOE",289
37,"37348",115,96,95,0,1,"PSOE",8
37,"37347",468,348,346,2,2,"PSOE",68
30,"30019",25857,17544,17374,125,170,"PSOE",3445
16,"16202",769,564,558,0,6,"PSOE",172
31,"31171",680,495,486,8,9,"PSOE",154
9,"9183",51,41,41,0,0,"PSOE",9
50,"50110",367,256,254,0,2,"PSOE",98
49,"49172",527,347,343,1,4,"PSOE",47
33,"33028",1276,649,641,4,8,"PSOE",239
5,"5200",44,31,30,1,1,"PSOE",5
44,"44089",45,39,39,1,0,"PSOE",5
18,"18902",816,632,620,4,12,"PSOE",288
42,"42006",163,109,107,2,2,"PSOE",16
29,"29003",983,754,743,1,11,"PSOE",361
42,"42086",36,27,26,2,1,"PSOE",5
26,"26129",967,775,766,6,9,"PSOE",220
50,"50206",460,363,357,4,6,"PSOE",74
9,"9139",103,87,85,3,2,"PSOE",23
9,"9413",436,306,302,2,4,"PSOE",41
5,"5204",603,456,451,1,5,"PSOE",104
14,"14016",1337,1072,1060,2,12,"PSOE",524
34,"34066",59,49,48,0,1,"PSOE",5
9,"9184",5,4,4,0,0,"PSOE",0
6,"6073",733,496,484,8,12,"PSOE",177
3,"3003",450,378,376,2,2,"PSOE",64
49,"49174",125,95,92,1,3,"PSOE",15
45,"45027",346,275,272,0,3,"PSOE",92
3,"3002",3605,2583,2557,15,26,"PSOE",612
22,"22129",183,120,118,1,2,"PSOE",22
42,"42182",56,43,41,1,2,"PSOE",5
37,"37049",137,96,96,1,0,"PSOE",27
41,"41022",4290,2889,2851,21,38,"PSOE",1318
10,"10193",1412,1090,1078,6,12,"PSOE",302
42,"42008",57,43,43,0,0,"PSOE",4
14,"14017",10868,7764,7665,71,99,"PSOE",3496
5,"5058",78,49,48,0,1,"PSOE",7
49,"49175",230,172,171,1,1,"PSOE",55
49,"49055",102,82,82,2,0,"PSOE",27
37,"37142",586,430,429,1,1,"PSOE",94
50,"50050",98,64,64,2,0,"PSOE",27
50,"50080",33,27,27,0,0,"PSOE",5
49,"49135",626,434,430,1,4,"PSOE",111
22,"22015",319,234,228,3,6,"PSOE",50
26,"26061",1565,1160,1141,13,19,"PSOE",282
45,"45096",1004,807,799,1,8,"PSOE",179
34,"34068",27,22,22,0,0,"PSOE",2
44,"44195",88,60,60,1,0,"PSOE",14
18,"18064",377,291,290,2,1,"PSOE",129
34,"34217",1207,937,923,8,14,"PSOE",181
26,"26098",88,73,73,1,0,"PSOE",10
5,"5208",40,36,36,0,0,"PSOE",8
47,"47046",118,92,90,1,2,"PSOE",33
3,"3005",7769,5917,5866,19,51,"PSOE",1145
16,"16209",116,101,101,2,0,"PSOE",29
7,"7042",10666,6680,6613,64,67,"PSOE",1385
29,"29007",27491,19071,18910,153,161,"PSOE",3915
23,"23072",1986,1542,1530,7,12,"PSOE",722
10,"10196",301,225,225,1,0,"PSOE",95
9,"9373",425,287,285,2,2,"PSOE",19
5,"5209",85,70,70,0,0,"PSOE",8
14,"14019",6464,4967,4909,49,58,"PSOE",1926
24,"24038",3089,2312,2273,17,39,"PSOE",727
50,"50116",182,136,132,0,4,"PSOE",32
12,"12133",59,53,52,0,1,"PSOE",13
33,"33033",9873,6512,6431,68,81,"PSOE",2016
3,"3006",497,384,380,1,4,"PSOE",47
40,"40019",36,31,31,1,0,"PSOE",6
3,"3098",505,393,386,0,7,"PSOE",131
50,"50021",30,21,21,0,0,"PSOE",0
19,"19263",26,15,15,1,0,"PSOE",4
34,"34071",171,132,132,1,0,"PSOE",16
14,"14020",387,269,264,2,5,"PSOE",139
9,"9418",82,62,61,1,1,"PSOE",7
41,"41026",4314,3380,3322,18,58,"PSOE",1277
10,"10061",1628,1055,1035,8,20,"PSOE",482
19,"19116",12,9,9,0,0,"PSOE",0
2,"2015",1441,1112,1093,5,19,"PSOE",412
44,"44096",161,138,135,3,3,"PSOE",40
47,"47212",380,323,322,2,1,"PSOE",73
16,"16066",2325,1788,1745,19,43,"PSOE",393
49,"49061",150,114,112,2,2,"PSOE",34
14,"14021",260178,181773,180348,1872,1425,"PSOE",38361
24,"24007",773,550,548,4,2,"PSOE",207
29,"29099",950,693,685,4,8,"PSOE",314
16,"16115",44,35,34,0,1,"PSOE",12
10,"10199",165,112,111,1,1,"PSOE",34
19,"19264",33,26,26,0,0,"PSOE",10
12,"12135",35719,26016,25793,196,223,"PSOE",5938
34,"34073",185,149,149,0,0,"PSOE",44
9,"9151",448,362,360,6,2,"PSOE",107
16,"16067",123,87,87,0,0,"PSOE",14
29,"29043",2509,1608,1576,18,32,"PSOE",598
18,"18068",1569,1189,1166,6,23,"PSOE",276
37,"37107",10764,7379,7264,56,115,"PSOE",1580
46,"46100",286,232,230,1,2,"PSOE",49
29,"29044",809,561,561,3,0,"PSOE",206
22,"22184",184,155,155,3,0,"PSOE",32
44,"44097",142,92,92,0,0,"PSOE",20
7,"7008",5692,3956,3913,26,43,"PSOE",750
50,"50275",108,55,55,0,0,"PSOE",13
5,"5067",83,68,67,0,1,"PSOE",10
5,"5214",38,28,28,0,0,"PSOE",4
19,"19118",11,9,9,0,0,"PSOE",6
28,"28138",60,46,46,0,0,"PSOE",3
23,"23039",2204,1596,1558,11,38,"PSOE",722
50,"50245",88,65,64,0,1,"PSOE",19
24,"24076",1277,956,947,4,9,"PSOE",259
37,"37235",224,153,148,2,5,"PSOE",36
29,"29067",424813,286785,284689,2351,2096,"PSOE",69196
24,"24144",695,470,465,2,5,"PSOE",94
14,"14023",2021,1660,1639,8,21,"PSOE",585
49,"49064",515,346,338,6,8,"PSOE",69
29,"29045",1684,1178,1168,8,10,"PSOE",340
22,"22059",1149,807,800,3,7,"PSOE",187
46,"46024",413,314,313,2,1,"PSOE",102
26,"26104",13,10,10,0,0,"PSOE",2
28,"28140",3007,2276,2256,7,20,"PSOE",366
28,"28071",60,55,53,1,2,"PSOE",9
14,"14024",1903,1405,1376,16,29,"PSOE",596
49,"49184",172,115,112,0,3,"PSOE",10
33,"33038",2303,1584,1559,13,25,"PSOE",492
10,"10113",2338,1679,1638,9,41,"PSOE",637
28,"28015",18736,14221,14127,68,94,"PSOE",1982
37,"37017",245,182,177,1,5,"PSOE",11
10,"10114",953,665,660,3,5,"PSOE",316
12,"12108",456,378,371,2,7,"PSOE",90
39,"39092",894,626,620,1,6,"PSOE",192
10,"10068",735,570,557,2,13,"PSOE",174
23,"23042",292,217,213,1,4,"PSOE",83
37,"37112",161,112,111,2,1,"PSOE",25
34,"34079",1616,1222,1205,5,17,"PSOE",303
46,"46181",16955,12313,12148,95,165,"PSOE",2503
45,"45137",1604,1032,1024,4,8,"PSOE",414
26,"26106",86,72,72,0,0,"PSOE",17
10,"10206",215,157,157,3,0,"PSOE",62
46,"46051",8347,6355,6302,24,53,"PSOE",1130
22,"22189",185,145,144,5,1,"PSOE",43
19,"19121",246,199,194,1,5,"PSOE",77
5,"5074",686,564,558,5,6,"PSOE",124
33,"33069",3491,2430,2390,17,40,"PSOE",700
9,"9292",87,75,73,1,2,"PSOE",18
28,"28143",72,57,57,1,0,"PSOE",11
31,"31084",1940,1293,1274,16,19,"PSOE",47
46,"46104",1940,1504,1487,7,17,"PSOE",347
29,"29048",1405,1121,1110,8,11,"PSOE",477
26,"26107",94,77,77,2,0,"PSOE",21
16,"16074",37,30,30,1,0,"PSOE",11
49,"49067",367,250,249,0,1,"PSOE",53
49,"49027",140,112,108,1,4,"PSOE",12
45,"45072",671,484,483,2,1,"PSOE",156
21,"21028",375,277,271,2,6,"PSOE",145
12,"12044",468,419,412,3,7,"PSOE",162
46,"46026",1204,1015,1004,3,11,"PSOE",211
30,"30032",2856,2163,2144,6,19,"PSOE",639
18,"18078",732,570,566,2,4,"PSOE",267
14,"14026",2067,1424,1405,4,19,"PSOE",614
16,"16228",172,137,137,4,0,"PSOE",25
19,"19237",47,38,38,0,0,"PSOE",9
33,"33041",7199,4922,4877,52,45,"PSOE",1335
6,"6090",869,617,602,3,15,"PSOE",253
5,"5221",351,254,250,2,4,"PSOE",64
49,"49234",412,328,324,0,4,"PSOE",105
50,"50156",215,181,178,2,3,"PSOE",63
34,"34082",83,74,73,0,1,"PSOE",20
24,"24150",243,172,172,6,0,"PSOE",29
50,"50124",415,318,317,2,1,"PSOE",51
31,"31186",299,195,194,3,1,"PSOE",13
4,"4060",445,348,345,5,3,"PSOE",99
28,"28145",2431,1760,1736,6,24,"PSOE",416
44,"44106",155,116,114,5,2,"PSOE",35
10,"10073",747,524,516,4,8,"PSOE",208
9,"9297",323,251,250,6,1,"PSOE",29
49,"49190",63,47,45,0,2,"PSOE",16
3,"3015",12566,9257,9177,39,80,"PSOE",2038
30,"30034",1129,858,844,7,14,"PSOE",258
3,"3076",8467,6238,6157,30,81,"PSOE",1488
40,"40160",102,71,70,1,1,"PSOE",3
50,"50030",215,141,140,1,1,"PSOE",36
45,"45175",664,545,543,5,2,"PSOE",182
22,"22197",473,354,354,1,0,"PSOE",100
45,"45141",884,700,689,3,11,"PSOE",240
44,"44239",22,20,20,0,0,"PSOE",0
42,"42158",103,76,76,0,0,"PSOE",20
11,"11025",4398,2899,2848,51,51,"PSOE",1552
7,"7058",2791,2060,2034,13,26,"PSOE",406
12,"12113",83,67,66,3,1,"PSOE",12
9,"9035",311,227,225,2,2,"PSOE",51
34,"34086",103,89,88,0,1,"PSOE",18
18,"18083",247,200,196,0,4,"PSOE",64
49,"49191",272,213,206,2,7,"PSOE",95
29,"29052",224,144,144,3,0,"PSOE",54
9,"9345",123,93,91,2,2,"PSOE",35
19,"19005",84,66,66,0,0,"PSOE",15
44,"44001",68,53,52,1,1,"PSOE",5
49,"49153",174,136,132,0,4,"PSOE",20
12,"12049",441,322,312,1,10,"PSOE",92
41,"41037",3213,2376,2342,30,34,"PSOE",1084
39,"39037",1987,1516,1503,8,13,"PSOE",271
18,"18084",4257,3107,3075,26,32,"PSOE",753
31,"31089",242,172,170,1,2,"PSOE",11
37,"37202",978,734,727,10,7,"PSOE",134
42,"42202",20,14,13,0,1,"PSOE",1
19,"19127",89,64,64,0,0,"PSOE",12
4,"4093",1882,1216,1204,11,12,"PSOE",389
31,"31223",985,704,698,4,6,"PSOE",170
16,"16239",135,110,105,0,5,"PSOE",39
44,"44209",833,611,602,6,9,"PSOE",168
29,"29054",41997,28422,28238,189,184,"PSOE",6099
9,"9037",111,91,91,0,0,"PSOE",43
9,"9302",112,83,83,1,0,"PSOE",11
13,"13003",480,382,380,1,2,"PSOE",138
26,"26011",7321,5133,5083,38,50,"PSOE",1419
50,"50222",1622,1091,1071,7,20,"PSOE",411
5,"5229",82,68,67,0,1,"PSOE",7
31,"31224",893,671,662,3,9,"PSOE",207
49,"49034",432,327,325,2,2,"PSOE",63
14,"14031",593,469,459,3,10,"PSOE",223
49,"49193",467,313,308,4,5,"PSOE",45
29,"29055",1796,1354,1336,11,18,"PSOE",519
45,"45145",2565,1695,1675,12,20,"PSOE",350
23,"23051",2758,2171,2144,9,27,"PSOE",1006
24,"24155",471,388,384,6,4,"PSOE",117
10,"10217",526,404,402,1,2,"PSOE",132
19,"19280",3464,2469,2438,14,31,"PSOE",478
22,"22069",429,333,331,2,2,"PSOE",70
39,"39040",4292,3208,3166,14,42,"PSOE",694
49,"49080",685,520,514,2,6,"PSOE",176
5,"5231",165,133,133,2,0,"PSOE",31
10,"10218",1126,803,795,3,8,"PSOE",424
14,"14032",423,334,330,4,4,"PSOE",130
49,"49035",226,200,196,3,4,"PSOE",48
16,"16040",80,62,62,0,0,"PSOE",3
31,"31004",35,21,21,0,0,"PSOE",2
19,"19243",44,31,31,0,0,"PSOE",6
9,"9270",163,115,115,0,0,"PSOE",18
19,"19009",259,200,195,6,5,"PSOE",62
22,"22072",191,136,135,0,1,"PSOE",40
29,"29057",357,241,238,1,3,"PSOE",124
23,"23053",9531,6704,6658,37,46,"PSOE",2638
28,"28178",1065,824,818,5,6,"PSOE",155
40,"40166",253,218,215,1,3,"PSOE",35
3,"3021",5613,4570,4500,26,70,"PSOE",908
44,"44245",248,179,176,2,3,"PSOE",45
50,"50036",104,91,90,0,1,"PSOE",31
26,"26117",2152,1625,1605,10,20,"PSOE",460
28,"28151",3142,2235,2199,8,36,"PSOE",508
34,"34241",18,13,13,1,0,"PSOE",2
44,"44213",62,50,50,0,0,"PSOE",9
41,"41042",5844,4424,4378,40,46,"PSOE",1904
31,"31094",111,82,82,0,0,"PSOE",19
31,"31193",1426,1024,1013,13,11,"PSOE",104
9,"9172",129,103,101,1,2,"PSOE",15
44,"44113",71,52,52,0,0,"PSOE",11
19,"19134",24,15,15,0,0,"PSOE",4
40,"40168",34,29,29,1,0,"PSOE",4
30,"30010",6869,5194,5142,21,52,"PSOE",1217
28,"28152",16093,12945,12877,58,68,"PSOE",1533
46,"46086",82,70,69,1,1,"PSOE",23
50,"50166",255,208,206,2,2,"PSOE",50
40,"40170",1320,1030,1021,7,9,"PSOE",187
13,"13010",883,646,634,3,12,"PSOE",228
44,"44114",243,178,173,0,5,"PSOE",34
49,"49083",52,44,44,2,0,"PSOE",8
24,"24057",1373,1045,1023,11,22,"PSOE",311
14,"14035",5966,4236,4177,39,59,"PSOE",1584
50,"50228",268,210,208,5,2,"PSOE",40
44,"44215",159,109,109,2,0,"PSOE",23
37,"37378",111,77,75,2,2,"PSOE",23
22,"22205",438,322,320,0,2,"PSOE",150
10,"10087",1687,1218,1212,6,6,"PSOE",476
34,"34245",307,209,208,5,1,"PSOE",42
22,"22076",311,201,199,0,2,"PSOE",50
31,"31096",113,82,79,0,3,"PSOE",18
9,"9441",74,65,65,0,0,"PSOE",0
14,"14036",3740,2747,2696,24,51,"PSOE",1293
6,"6105",624,418,417,1,1,"PSOE",160
37,"37129",251,204,201,3,3,"PSOE",42
31,"31196",38,35,35,1,0,"PSOE",3
28,"28093",2096,1670,1653,10,17,"PSOE",280
13,"13012",413,274,273,1,1,"PSOE",131
12,"12121",1107,924,893,4,31,"PSOE",330
41,"41100",1013,692,673,6,19,"PSOE",372
9,"9130",74,51,50,1,1,"PSOE",6
49,"49204",63,51,51,0,0,"PSOE",8
49,"49085",996,684,680,2,4,"PSOE",174
9,"9176",63,47,46,2,1,"PSOE",6
16,"16095",83,64,63,0,1,"PSOE",12
28,"28182",210,171,169,0,2,"PSOE",27
29,"29085",144,109,108,0,1,"PSOE",55
23,"23058",8678,6532,6461,37,71,"PSOE",2431
44,"44010",175,130,128,1,2,"PSOE",39
22,"22207",125,72,71,2,1,"PSOE",19
24,"24161",285,203,201,3,2,"PSOE",34
42,"42171",127,80,79,0,1,"PSOE",13
13,"13014",492,398,397,1,1,"PSOE",156
18,"18097",960,693,685,5,8,"PSOE",261
50,"50137",1011,772,764,8,8,"PSOE",260
47,"47148",442,342,338,2,4,"PSOE",81
44,"44218",35,28,28,1,0,"PSOE",1
46,"46115",378,286,282,1,4,"PSOE",73
31,"31198",37,25,25,0,0,"PSOE",1
28,"28029",520,408,406,0,2,"PSOE",52
46,"46037",1122,936,923,4,13,"PSOE",255
33,"33053",1141,742,732,6,10,"PSOE",292
28,"28155",506,416,411,0,5,"PSOE",152
24,"24060",602,363,361,3,2,"PSOE",90
40,"40048",38,29,27,0,2,"PSOE",7
2,"2001",656,527,523,1,4,"PSOE",179
5,"5097",475,317,313,0,4,"PSOE",64
34,"34903",198,131,131,1,0,"PSOE",28
46,"46253",115,82,82,0,0,"PSOE",20
19,"19104",14,12,12,1,0,"PSOE",5
19,"19181",56,42,42,0,0,"PSOE",6
46,"46090",1637,1391,1367,3,24,"PSOE",354
34,"34011",397,321,320,5,1,"PSOE",94
16,"16098",561,456,454,3,2,"PSOE",175
26,"26124",807,649,639,7,10,"PSOE",206
31,"31001",88,62,62,0,0,"PSOE",8
16,"16099",203,153,147,0,6,"PSOE",35
50,"50043",253,171,171,0,0,"PSOE",47
9,"9090",54,48,48,0,0,"PSOE",3
39,"39017",569,398,391,4,7,"PSOE",57
18,"18146",965,703,685,9,18,"PSOE",297
49,"49128",552,423,414,3,9,"PSOE",117
10,"10002",364,272,270,0,2,"PSOE",110
42,"42081",145,102,100,1,2,"PSOE",28
47,"47040",64,53,53,0,0,"PSOE",10
28,"28902",471,363,356,4,7,"PSOE",38
33,"33055",1514,1109,1092,5,17,"PSOE",352
44,"44119",130,92,91,3,1,"PSOE",32
47,"47230",303,246,242,2,4,"PSOE",60
14,"14040",3776,2873,2833,32,40,"PSOE",587
13,"13021",434,365,363,4,2,"PSOE",135
12,"12063",41,29,29,1,0,"PSOE",9
23,"23062",1454,1141,1128,1,13,"PSOE",574
22,"22009",617,444,441,6,3,"PSOE",144
7,"7034",1008,743,734,7,9,"PSOE",139
47,"47015",200,162,160,0,2,"PSOE",38
42,"42176",29,25,25,0,0,"PSOE",2
4,"4074",2840,2000,1979,23,21,"PSOE",642
40,"40179",626,503,493,2,10,"PSOE",117
16,"16009",62,51,50,0,1,"PSOE",7
45,"45090",384,294,293,3,1,"PSOE",112
19,"19064",70,64,64,2,0,"PSOE",12
28,"28032",4762,3428,3401,19,27,"PSOE",646
19,"19184",71,50,48,0,2,"PSOE",10
4,"4075",5196,3735,3706,23,29,"PSOE",1290
28,"28159",589,468,468,5,0,"PSOE",115
49,"49093",280,223,222,1,1,"PSOE",77
18,"18119",1702,1298,1283,13,15,"PSOE",464
12,"12029",702,557,555,4,2,"PSOE",139
6,"6130",195,164,158,0,6,"PSOE",77
47,"47016",69,56,55,0,1,"PSOE",10
44,"44260",137,91,89,3,2,"PSOE",22
3,"3061",1056,776,768,4,8,"PSOE",136
13,"13076",484,400,394,1,6,"PSOE",147
22,"22012",111,87,86,3,1,"PSOE",15
22,"22084",535,403,399,4,4,"PSOE",88
2,"2006",579,464,458,3,6,"PSOE",172
47,"47232",102,77,74,1,3,"PSOE",18
37,"37138",203,149,148,2,1,"PSOE",42
13,"13025",302,244,244,1,0,"PSOE",90
46,"46198",839,684,674,4,10,"PSOE",140
24,"24032",109,91,89,0,2,"PSOE",32
12,"12065",188,169,169,2,0,"PSOE",44
22,"22217",385,287,281,1,6,"PSOE",89
2,"2008",1193,857,847,7,10,"PSOE",310
28,"28006",78966,59065,58698,267,367,"PSOE",11361
5,"5251",60,42,42,1,0,"PSOE",6
16,"16106",2727,2009,1989,12,20,"PSOE",724
16,"16104",51,41,41,0,0,"PSOE",16
23,"23029",843,628,624,2,4,"PSOE",277
19,"19335",55,47,47,0,0,"PSOE",22
10,"10145",127,97,95,0,2,"PSOE",53
34,"34109",59,48,48,0,0,"PSOE",1
45,"45194",68,54,53,0,1,"PSOE",20
16,"16265",20,19,19,0,0,"PSOE",10
24,"24067",623,388,384,0,4,"PSOE",76
14,"14044",1604,1172,1165,7,7,"PSOE",639
16,"16107",109,86,85,1,1,"PSOE",32
5,"5001",191,148,147,2,1,"PSOE",32
4,"4078",1078,758,746,8,12,"PSOE",266
47,"47208",58,38,36,1,2,"PSOE",3
46,"46225",337,290,281,5,9,"PSOE",43
9,"9451",238,191,190,0,1,"PSOE",62
50,"50113",618,489,484,2,5,"PSOE",213
24,"24101",397,258,257,3,1,"PSOE",109
16,"16205",115,88,87,0,1,"PSOE",8
19,"19224",93,87,87,0,0,"PSOE",6
13,"13029",84,71,71,0,0,"PSOE",19
44,"44020",24,20,19,1,1,"PSOE",3
46,"46200",1903,1561,1539,3,22,"PSOE",405
49,"49221",245,129,127,1,2,"PSOE",28
31,"31207",273,182,177,2,5,"PSOE",16
31,"31140",117,84,84,1,0,"PSOE",3
40,"40228",510,390,382,1,8,"PSOE",82
46,"46259",491,396,393,4,3,"PSOE",111
26,"26168",5340,3774,3717,22,57,"PSOE",717
24,"24170",1908,1365,1345,8,20,"PSOE",441
16,"16206",204,158,157,6,1,"PSOE",44
40,"40144",18,14,14,0,0,"PSOE",2
4,"4080",209,162,162,3,0,"PSOE",35
9,"9326",140,112,111,0,1,"PSOE",23
13,"13031",2452,1919,1909,11,10,"PSOE",602
49,"49261",1537,1048,1033,8,15,"PSOE",266
3,"3129",1194,957,938,0,19,"PSOE",148
26,"26132",112,82,82,0,0,"PSOE",26
45,"45163",8298,5942,5855,28,87,"PSOE",1457
46,"46045",1249,1028,1010,3,18,"PSOE",129
16,"16157",211,179,179,2,0,"PSOE",59
24,"24103",283,163,157,1,6,"PSOE",36
22,"22222",530,384,379,3,5,"PSOE",59
19,"19154",68,56,54,0,2,"PSOE",4
49,"49224",162,112,112,1,0,"PSOE",14
26,"26134",82,68,68,2,0,"PSOE",13
28,"28164",2993,2183,2168,8,15,"PSOE",374
49,"49100",295,212,208,5,4,"PSOE",71
40,"40188",90,72,70,0,2,"PSOE",10
37,"37145",259,190,189,2,1,"PSOE",67
41,"41058",17395,12556,12332,111,224,"PSOE",4188
3,"3130",48,25,25,0,0,"PSOE",5
50,"50083",89,75,75,1,0,"PSOE",29
37,"37011",121,91,91,3,0,"PSOE",21
49,"49225",147,91,90,0,1,"PSOE",12
26,"26030",16,16,15,0,1,"PSOE",1
34,"34167",113,94,94,0,0,"PSOE",19
47,"47183",130,106,105,0,1,"PSOE",28
44,"44229",152,112,111,3,1,"PSOE",20
24,"24006",472,353,347,0,6,"PSOE",90
10,"10108",219,148,146,0,2,"PSOE",38
50,"50242",93,75,75,3,0,"PSOE",17
37,"37146",117,96,95,1,1,"PSOE",8
47,"47131",170,134,128,2,6,"PSOE",47
37,"37315",96,70,70,0,0,"PSOE",9
24,"24142",25119,17336,17141,154,195,"PSOE",4706
33,"33034",10612,6602,6536,62,66,"PSOE",1823
26,"26065",50,43,42,0,1,"PSOE",1
28,"28012",887,664,661,2,3,"PSOE",131
9,"9377",632,485,480,1,5,"PSOE",73
37,"37148",427,298,295,3,3,"PSOE",57
16,"16275",11,11,11,1,0,"PSOE",4
40,"40191",215,181,179,1,2,"PSOE",25
18,"18024",855,665,654,7,11,"PSOE",236
2,"2017",838,594,589,1,5,"PSOE",261
46,"46126",5556,4449,4405,24,44,"PSOE",932
24,"24174",486,343,342,4,1,"PSOE",96
19,"19159",93,78,77,0,1,"PSOE",9
37,"37149",68,64,64,0,0,"PSOE",8
21,"21062",1392,887,879,6,8,"PSOE",411
29,"29100",2433,1684,1667,5,17,"PSOE",851
37,"37234",345,247,247,1,0,"PSOE",82
12,"12106",1158,955,942,8,13,"PSOE",339
42,"42191",185,136,133,0,3,"PSOE",42
5,"5118",79,53,53,0,0,"PSOE",9
9,"9464",35,27,27,0,0,"PSOE",2
40,"40065",493,373,373,3,0,"PSOE",73
40,"40192",159,117,117,2,0,"PSOE",34
18,"18117",506,383,373,1,10,"PSOE",171
34,"34032",40,33,33,1,0,"PSOE",3
47,"47104",2836,2182,2121,19,61,"PSOE",442
40,"40901",384,309,307,4,2,"PSOE",53
49,"49181",362,277,276,2,1,"PSOE",35
2,"2019",2405,1871,1835,12,36,"PSOE",763
9,"9198",104,83,82,1,1,"PSOE",24
34,"34091",123,94,93,3,1,"PSOE",18
42,"42192",42,27,27,2,0,"PSOE",13
49,"49210",471,370,365,1,5,"PSOE",130
46,"46903",6065,4790,4763,18,27,"PSOE",632
41,"41063",2695,1850,1830,13,20,"PSOE",830
37,"37277",75,58,58,0,0,"PSOE",8
28,"28079",2362038,1743924,1733354,8859,10570,"PSOE",329947
4,"4086",1760,1243,1234,9,9,"PSOE",364
31,"31115",165,102,101,1,1,"PSOE",5
46,"46128",1597,1290,1250,5,40,"PSOE",276
16,"16165",61,54,53,0,1,"PSOE",20
50,"50057",1395,919,907,11,12,"PSOE",248
49,"49024",672,459,454,5,5,"PSOE",123
24,"24109",977,633,624,3,9,"PSOE",233
12,"12042",607,520,513,13,7,"PSOE",86
37,"37152",418,290,286,2,4,"PSOE",57
49,"49230",97,72,72,0,0,"PSOE",32
31,"31016",7608,5474,5413,50,61,"PSOE",1103
45,"45170",228,176,167,0,9,"PSOE",46
49,"49108",466,346,344,0,2,"PSOE",91
24,"24011",203,133,132,0,1,"PSOE",99
42,"42194",170,118,114,1,4,"PSOE",31
34,"34125",86,65,64,0,1,"PSOE",7
50,"50278",197,145,145,0,0,"PSOE",36
9,"9382",33,28,28,0,0,"PSOE",1
23,"23081",1513,1103,1084,10,19,"PSOE",560
22,"22229",114,80,80,1,0,"PSOE",21
5,"5901",263,182,180,2,2,"PSOE",27
16,"16029",99,72,70,0,2,"PSOE",10
19,"19198",14,12,12,0,0,"PSOE",5
12,"12109",649,532,524,6,8,"PSOE",165
16,"16122",249,188,187,0,1,"PSOE",59
9,"9201",28,18,18,1,0,"PSOE",5
37,"37280",78,53,53,0,0,"PSOE",6
22,"22230",284,216,216,1,0,"PSOE",54
21,"21068",998,605,592,11,13,"PSOE",302
40,"40072",211,162,159,1,3,"PSOE",22
34,"34229",68,57,56,1,1,"PSOE",5
31,"31085",480,350,350,2,0,"PSOE",27
22,"22103",682,508,502,3,6,"PSOE",176
45,"45073",298,233,233,1,0,"PSOE",67
2,"2024",3409,2589,2554,29,35,"PSOE",764
41,"41066",1342,945,927,2,18,"PSOE",499
19,"19043",84,72,72,0,0,"PSOE",20
46,"46209",1933,1445,1415,5,30,"PSOE",383
37,"37021",79,60,60,0,0,"PSOE",14
16,"16031",46,28,28,1,0,"PSOE",10
19,"19200",71,52,52,1,0,"PSOE",16
9,"9339",128,110,110,0,0,"PSOE",28
39,"39064",1345,1031,1015,7,16,"PSOE",210
39,"39003",297,220,215,0,5,"PSOE",67
29,"29016",251,188,188,1,0,"PSOE",62
9,"9071",41,35,35,1,0,"PSOE",7
47,"47003",227,180,179,3,1,"PSOE",39
22,"22105",114,78,77,2,1,"PSOE",26
5,"5904",127,88,87,1,1,"PSOE",9
28,"28173",517,390,388,1,2,"PSOE",109
21,"21070",6258,4165,4092,48,73,"PSOE",1725
34,"34130",212,164,163,1,1,"PSOE",54
50,"50250",52,44,44,0,0,"PSOE",8
10,"10120",171,121,117,1,4,"PSOE",35
9,"9343",93,66,65,0,1,"PSOE",10
45,"45174",301,237,233,1,4,"PSOE",74
12,"12081",608,486,480,5,6,"PSOE",115
18,"18126",1483,1081,1074,15,7,"PSOE",375
21,"21030",1830,1452,1430,13,22,"PSOE",729
28,"28115",60892,49705,49510,209,195,"PSOE",5834
13,"13904",531,400,392,4,8,"PSOE",114
10,"10075",253,167,166,1,1,"PSOE",60
23,"23086",11511,7997,7874,91,123,"PSOE",3426
10,"10121",7978,5517,5429,35,88,"PSOE",1977
5,"5029",121,96,94,0,2,"PSOE",15
47,"47004",1181,939,930,7,9,"PSOE",348
37,"37069",968,695,689,7,6,"PSOE",148
39,"39006",1711,1307,1287,10,20,"PSOE",244
9,"9298",82,70,69,1,1,"PSOE",0
46,"46159",22857,16840,16697,128,143,"PSOE",3631
21,"21073",1862,1125,1109,8,16,"PSOE",441
23,"23087",11292,8222,8084,59,138,"PSOE",2363
19,"19277",19,13,13,0,0,"PSOE",6
26,"26041",132,92,91,0,1,"PSOE",18
45,"45109",2883,2271,2214,9,57,"PSOE",583
41,"41070",6032,4312,4258,44,54,"PSOE",984
45,"45077",556,428,427,1,1,"PSOE",133
4,"4062",4504,3534,3490,18,44,"PSOE",1385
37,"37286",207,152,145,4,7,"PSOE",51
37,"37026",189,146,146,0,0,"PSOE",50
28,"28086",5154,3530,3493,13,37,"PSOE",652
44,"44141",135,97,96,1,1,"PSOE",20
28,"28175",863,670,668,5,2,"PSOE",83
10,"10214",214,181,177,2,4,"PSOE",44
9,"9390",611,484,482,3,2,"PSOE",110
50,"50283",70,57,57,1,0,"PSOE",16
37,"37072",168,140,138,0,2,"PSOE",20
26,"26112",236,194,190,1,4,"PSOE",51
50,"50064",437,342,339,0,3,"PSOE",133
9,"9075",112,91,91,3,0,"PSOE",14
49,"49238",254,194,193,1,1,"PSOE",60
33,"33076",12258,8106,8031,63,75,"PSOE",1676
44,"44243",24,20,20,0,0,"PSOE",3
34,"34134",50,40,40,2,0,"PSOE",8
47,"47085",16612,11829,11706,114,123,"PSOE",2957
41,"41072",4054,2965,2933,14,32,"PSOE",1167
12,"12084",17615,12766,12644,105,122,"PSOE",3036
3,"3079",18224,13904,13709,80,195,"PSOE",2803
5,"5083",140,110,105,1,5,"PSOE",15
44,"44036",25,21,21,0,0,"PSOE",3
10,"10125",888,635,622,4,13,"PSOE",244
6,"6005",1696,1197,1178,1,19,"PSOE",661
23,"23050",90992,64810,64218,485,592,"PSOE",16306
46,"46214",15766,12131,12036,42,95,"PSOE",2481
42,"42068",82,63,60,1,3,"PSOE",13
3,"3050",18652,13325,13234,57,91,"PSOE",2416
46,"46162",1189,938,929,3,9,"PSOE",295
3,"3904",1396,1033,1026,4,7,"PSOE",326
28,"28023",4775,3755,3735,12,20,"PSOE",507
18,"18134",5828,3840,3800,36,40,"PSOE",983
41,"41073",1707,1055,1041,5,14,"PSOE",443
28,"28088",261,178,178,0,0,"PSOE",47
44,"44037",453,317,315,0,2,"PSOE",58
40,"40165",77,65,64,1,1,"PSOE",16
22,"22126",88,64,64,0,0,"PSOE",15
22,"22252",121,86,81,0,5,"PSOE",29
37,"37192",356,231,227,2,4,"PSOE",34
42,"42177",69,60,60,1,0,"PSOE",20
16,"16199",30,25,25,1,0,"PSOE",2
46,"46137",270,210,207,4,3,"PSOE",51
10,"10128",5697,3958,3891,32,67,"PSOE",1520
19,"19173",45,38,36,0,2,"PSOE",11
14,"14061",744,595,582,1,13,"PSOE",300
46,"46163",1866,1504,1480,8,24,"PSOE",239
29,"29024",386,227,219,2,8,"PSOE",101
6,"6009",204,153,153,0,0,"PSOE",54
50,"50132",751,543,536,0,7,"PSOE",103
29,"29081",261,197,197,1,0,"PSOE",69
9,"9351",62,49,48,1,1,"PSOE",4
44,"44246",1543,1045,1027,12,18,"PSOE",238
50,"50257",171,134,134,2,0,"PSOE",53
6,"6146",1084,838,830,1,8,"PSOE",455
28,"28179",1432,1040,1037,4,3,"PSOE",147
45,"45115",2552,1999,1966,8,33,"PSOE",638
50,"50068",1982,1348,1335,8,13,"PSOE",447
24,"24121",645,492,487,1,5,"PSOE",127
44,"44039",221,165,159,0,6,"PSOE",28
45,"45082",1224,1020,1011,8,9,"PSOE",351
9,"9082",39,36,36,0,0,"PSOE",1
28,"28121",198,160,158,1,2,"PSOE",39
44,"44007",173,122,121,4,1,"PSOE",26
9,"9128",80,63,63,0,0,"PSOE",19
50,"50227",109,79,79,0,0,"PSOE",18
40,"40127",32,25,25,0,0,"PSOE",4
50,"50165",1814,1287,1264,26,23,"PSOE",406
23,"23095",8735,6347,6310,14,37,"PSOE",2459
47,"47009",107,86,85,0,1,"PSOE",23
14,"14063",1046,734,725,2,9,"PSOE",293
5,"5139",74,65,65,0,0,"PSOE",1
11,"11032",53874,31273,31008,348,265,"PSOE",9507
49,"49122",782,526,520,5,6,"PSOE",109
45,"45083",472,368,365,0,3,"PSOE",69
28,"28026",6317,4734,4701,33,33,"PSOE",622
9,"9354",33,29,28,2,1,"PSOE",3
6,"6149",10295,7651,7536,56,115,"PSOE",2805
19,"19054",192,164,164,1,0,"PSOE",44
46,"46139",4485,3617,3574,18,43,"PSOE",812
37,"37294",11692,8317,8221,71,96,"PSOE",1554
34,"34004",5608,4120,4063,43,57,"PSOE",870
50,"50008",5097,3457,3417,31,40,"PSOE",954
28,"28181",20386,16155,16069,57,86,"PSOE",2043
50,"50259",88,67,66,0,1,"PSOE",10
6,"6150",802,602,596,4,6,"PSOE",251
50,"50260",33,33,32,0,1,"PSOE",6
34,"34199",1218,918,899,10,19,"PSOE",245
49,"49246",227,190,183,2,7,"PSOE",29
18,"18004",714,518,509,2,9,"PSOE",209
26,"26050",113,88,85,0,3,"PSOE",11
37,"37035",190,150,150,2,0,"PSOE",30
37,"37036",61,44,43,0,1,"PSOE",5
45,"45085",1500,1011,999,4,12,"PSOE",162
2,"2039",984,790,786,10,4,"PSOE",280
22,"22004",135,81,80,0,1,"PSOE",22
19,"19326",1841,1280,1272,1,8,"PSOE",185
23,"23018",2325,1668,1653,10,15,"PSOE",906
26,"26157",296,241,237,4,4,"PSOE",43
23,"23099",4769,3359,3309,16,50,"PSOE",1159
24,"24093",360,249,248,2,1,"PSOE",68
50,"50261",213,157,157,0,0,"PSOE",68
44,"44251",254,198,191,1,7,"PSOE",36
28,"28183",1039,743,735,2,8,"PSOE",121
11,"11035",13593,8375,8276,90,99,"PSOE",2674
45,"45086",496,351,343,2,8,"PSOE",108
2,"2080",528,406,400,2,6,"PSOE",141
19,"19103",251,208,208,2,0,"PSOE",73
4,"4101",4266,2909,2876,26,33,"PSOE",1116
37,"37173",1504,1129,1114,4,15,"PSOE",293
39,"39046",1404,1001,973,6,28,"PSOE",339
34,"34149",23,18,18,0,0,"PSOE",1
44,"44043",102,74,72,0,2,"PSOE",10
41,"41901",2682,2107,2086,28,21,"PSOE",1339
44,"44150",28,22,21,0,1,"PSOE",6
19,"19288",21,21,20,0,1,"PSOE",7
22,"22006",298,204,204,5,0,"PSOE",51
42,"42216",25,23,23,0,0,"PSOE",8
4,"4102",13694,8944,8865,50,79,"PSOE",2598
21,"21006",3368,2182,2146,13,36,"PSOE",1208
49,"49166",1227,946,933,6,13,"PSOE",235
37,"37342",259,189,186,0,3,"PSOE",36
24,"24094",1385,983,968,11,15,"PSOE",219
46,"46168",1938,1495,1486,2,9,"PSOE",353
45,"45088",2115,1351,1338,4,13,"PSOE",358
31,"31133",43,28,28,0,0,"PSOE",4
10,"10138",555,448,446,2,2,"PSOE",221
23,"23901",1154,970,964,3,6,"PSOE",465
19,"19182",38,34,33,0,1,"PSOE",8
26,"26161",8,7,7,0,0,"PSOE",0
49,"49167",197,147,145,0,2,"PSOE",27
39,"39078",1401,975,963,5,12,"PSOE",210
44,"44185",99,76,75,0,1,"PSOE",8
28,"28059",4323,3171,3157,11,14,"PSOE",572
24,"24129",122,89,89,1,0,"PSOE",15
40,"40008",44,39,39,1,0,"PSOE",9
22,"22045",82,65,64,1,1,"PSOE",18
11,"11038",13737,10181,10034,99,147,"PSOE",3316
45,"45189",599,470,462,2,8,"PSOE",110
6,"6157",443,321,316,1,5,"PSOE",132
50,"50264",156,115,115,0,0,"PSOE",51
29,"29089",3228,2377,2321,10,56,"PSOE",809
47,"47176",219,139,139,1,0,"PSOE",32
6,"6021",926,645,636,8,9,"PSOE",195
10,"10003",569,414,408,1,6,"PSOE",114
37,"37090",52,43,43,0,0,"PSOE",5
45,"45022",391,285,281,3,4,"PSOE",82
44,"44153",1774,1135,1121,5,14,"PSOE",299
26,"26056",419,338,332,1,6,"PSOE",107
37,"37303",190,142,139,1,3,"PSOE",35
31,"31036",909,636,628,7,8,"PSOE",146
44,"44189",56,41,41,0,0,"PSOE",14
50,"50203",1040,748,739,7,9,"PSOE",178
28,"28128",444,315,314,0,1,"PSOE",87
4,"4044",1547,1166,1156,5,10,"PSOE",369
18,"18054",849,606,605,7,1,"PSOE",187
19,"19333",115,82,82,0,0,"PSOE",27
18,"18194",2128,1451,1437,9,14,"PSOE",712
24,"24108",376,280,277,2,3,"PSOE",54
12,"12007",746,651,636,3,15,"PSOE",85
42,"42003",67,48,47,0,1,"PSOE",13
50,"50087",26,17,17,1,0,"PSOE",2
37,"37060",243,187,187,1,0,"PSOE",37
46,"46093",2118,1647,1624,4,23,"PSOE",423
44,"44087",80,69,67,1,2,"PSOE",24
6,"6024",1172,905,883,4,22,"PSOE",371
50,"50174",91,69,68,0,1,"PSOE",17
9,"9094",53,42,42,1,0,"PSOE",5
29,"29091",8957,6186,6078,56,108,"PSOE",1645
47,"47096",140,110,110,0,0,"PSOE",25
16,"16151",64,61,59,0,2,"PSOE",6
16,"16011",27,22,22,1,0,"PSOE",3
19,"19334",35,31,31,0,0,"PSOE",14
50,"50236",102,79,77,0,2,"PSOE",21
9,"9412",790,528,523,4,5,"PSOE",97
18,"18151",260,171,170,3,1,"PSOE",76
22,"22254",1124,801,792,11,9,"PSOE",281
46,"46146",1654,1304,1278,7,26,"PSOE",229
14,"14071",929,642,630,2,12,"PSOE",305
46,"46068",346,276,266,6,10,"PSOE",70
3,"3125",343,254,251,0,3,"PSOE",46
34,"34158",288,186,184,3,2,"PSOE",57
33,"33059",4646,3075,3033,29,42,"PSOE",707
6,"6901",2118,1559,1546,23,13,"PSOE",580
16,"16013",27,24,24,0,0,"PSOE",2
28,"28101",231,187,187,0,0,"PSOE",35
11,"11901",5648,3676,3631,67,45,"PSOE",1788
28,"28035",1353,1006,998,2,8,"PSOE",233
18,"18016",307,235,233,0,2,"PSOE",112
29,"29037",209,158,157,1,1,"PSOE",52
19,"19901",41,38,37,0,1,"PSOE",7
6,"6072",2307,1696,1681,12,15,"PSOE",641
44,"44019",67,50,49,0,1,"PSOE",10
40,"40015",28,26,26,1,0,"PSOE",5
50,"50079",249,175,174,0,1,"PSOE",55
37,"37141",154,122,122,2,0,"PSOE",40
28,"28131",12990,9512,9433,38,79,"PSOE",1491
22,"22050",88,77,77,0,0,"PSOE",23
24,"24003",648,460,453,7,7,"PSOE",138
13,"13046",724,529,525,1,4,"PSOE",223
26,"26060",84,62,62,2,0,"PSOE",11
46,"46226",41,36,35,0,1,"PSOE",21
46,"46148",1513,1160,1146,7,14,"PSOE",219
6,"6903",2021,1377,1360,12,17,"PSOE",528
42,"42088",67,47,47,1,0,"PSOE",8
22,"22177",98,75,75,0,0,"PSOE",22
40,"40057",1456,1154,1148,7,6,"PSOE",357
23,"23070",3914,2433,2407,14,26,"PSOE",920
41,"41056",3687,2841,2812,30,29,"PSOE",1561
40,"40101",877,635,628,8,7,"PSOE",145
10,"10148",32850,22161,21856,177,305,"PSOE",6019
45,"45028",3649,2701,2673,12,28,"PSOE",994
9,"9232",154,119,116,0,3,"PSOE",44
21,"21016",1023,746,723,4,23,"PSOE",393
28,"28065",126539,96997,96210,505,787,"PSOE",23692
49,"49017",251,180,177,1,3,"PSOE",21
50,"50178",293,190,187,0,3,"PSOE",66
41,"41024",22600,14263,14048,128,215,"PSOE",5619
40,"40103",159,125,123,2,2,"PSOE",30
33,"33032",11395,7592,7465,90,127,"PSOE",2484
4,"4050",800,558,553,3,5,"PSOE",235
49,"49176",667,433,431,1,2,"PSOE",63
50,"50209",2601,1731,1721,13,10,"PSOE",386
41,"41090",3523,2576,2512,13,64,"PSOE",1008
19,"19073",23,19,19,0,0,"PSOE",6
40,"40229",36,24,24,0,0,"PSOE",6
34,"34163",45,38,38,0,0,"PSOE",11
42,"42141",112,80,80,0,0,"PSOE",22
19,"19115",24,18,18,0,0,"PSOE",2
31,"31243",306,224,221,2,3,"PSOE",22
44,"44053",105,78,78,0,0,"PSOE",21
34,"34027",1085,751,741,6,10,"PSOE",238
22,"22905",281,209,209,1,0,"PSOE",35
50,"50210",38,30,30,1,0,"PSOE",11
19,"19191",14,13,12,0,1,"PSOE",5
28,"28067",4063,3102,3079,3,23,"PSOE",737
7,"7044",8439,5681,5543,48,138,"PSOE",908
22,"22181",92,61,61,2,0,"PSOE",8
42,"42187",62,46,45,1,1,"PSOE",3
31,"31144",796,445,444,6,1,"PSOE",35
6,"6078",507,409,404,1,5,"PSOE",108
7,"7045",1295,947,936,5,11,"PSOE",221
10,"10153",309,222,218,0,4,"PSOE",56
45,"45132",2197,1645,1632,14,13,"PSOE",247
31,"31177",255,169,166,2,3,"PSOE",31
5,"5210",87,70,69,0,1,"PSOE",8
9,"9280",28,20,20,0,0,"PSOE",4
37,"37104",27,22,22,0,0,"PSOE",9
47,"47048",188,144,144,1,0,"PSOE",21
40,"40149",514,375,369,5,6,"PSOE",53
42,"42025",1189,844,833,2,11,"PSOE",278
40,"40035",137,105,104,0,1,"PSOE",14
6,"6035",937,696,681,5,15,"PSOE",216
33,"33065",1102,722,713,7,9,"PSOE",152
19,"19076",27,19,19,0,0,"PSOE",3
10,"10155",1126,773,763,5,10,"PSOE",296
50,"50212",40,36,36,0,0,"PSOE",11
39,"39028",3739,2850,2817,16,33,"PSOE",485
5,"5015",82,61,61,1,0,"PSOE",18
12,"12005",8062,5829,5754,64,75,"PSOE",1343
37,"37057",215,172,171,1,1,"PSOE",29
24,"24008",9282,6685,6603,52,82,"PSOE",1249
46,"46022",15365,11093,10997,59,96,"PSOE",2634
9,"9239",52,40,39,0,1,"PSOE",3
3,"3100",503,440,437,0,3,"PSOE",79
45,"45201",3447,2082,2050,9,32,"PSOE",492
33,"33005",1449,936,924,11,12,"PSOE",336
7,"7007",421,296,293,2,3,"PSOE",40
18,"18069",502,362,357,0,5,"PSOE",138
4,"4054",358,285,281,2,4,"PSOE",105
34,"34074",707,540,531,9,9,"PSOE",164
6,"6037",1748,1148,1134,9,14,"PSOE",416
21,"21023",2124,1298,1264,7,34,"PSOE",638
50,"50119",927,724,713,5,11,"PSOE",230
40,"40151",46,33,33,0,0,"PSOE",3
6,"6083",46149,31049,30739,234,310,"PSOE",9392
40,"40024",856,651,639,6,12,"PSOE",132
23,"23092",27775,19734,19541,175,193,"PSOE",6001
24,"24131",724,511,507,3,4,"PSOE",105
11,"11018",1468,1046,1031,9,15,"PSOE",428
26,"26091",161,146,146,0,0,"PSOE",23
13,"13075",211,164,161,1,3,"PSOE",42
49,"49267",88,73,69,2,4,"PSOE",16
22,"22909",315,226,225,4,1,"PSOE",87
28,"28043",5921,3803,3759,18,44,"PSOE",849
49,"49268",403,313,309,1,4,"PSOE",38
3,"3010",325,277,275,1,2,"PSOE",56
40,"40903",86,67,67,0,0,"PSOE",10
42,"42017",140,113,112,0,1,"PSOE",40
3,"3135",211,170,166,2,4,"PSOE",64
44,"44027",164,123,123,1,0,"PSOE",45
46,"46232",895,711,696,5,15,"PSOE",249
46,"46050",194,150,149,0,1,"PSOE",52
49,"49065",1103,836,818,2,18,"PSOE",210
47,"47105",183,158,156,0,2,"PSOE",52
42,"42100",32,30,30,0,0,"PSOE",7
49,"49146",295,216,213,3,3,"PSOE",59
33,"33008",1777,1238,1229,3,9,"PSOE",395
12,"12043",570,449,442,2,7,"PSOE",97
44,"44168",189,139,138,2,1,"PSOE",25
44,"44061",70,54,51,0,3,"PSOE",8
22,"22060",1164,858,850,3,8,"PSOE",248
42,"42018",152,117,116,1,1,"PSOE",14
50,"50089",8225,6074,6043,43,31,"PSOE",899
31,"31250",2810,1786,1770,19,16,"PSOE",183
31,"31050",6014,3489,3450,57,39,"PSOE",326
37,"37238",110,87,85,0,2,"PSOE",21
13,"13096",7652,5480,5415,19,65,"PSOE",1634
42,"42019",516,363,356,3,7,"PSOE",74
24,"24044",168,119,118,1,1,"PSOE",26
10,"10207",504,357,350,6,7,"PSOE",150
45,"45105",392,301,297,3,4,"PSOE",103
22,"22143",217,143,141,1,2,"PSOE",17
18,"18170",330,219,217,0,2,"PSOE",114
5,"5172",123,93,93,1,0,"PSOE",25
37,"37364",820,607,598,6,9,"PSOE",159
45,"45138",1091,877,871,4,6,"PSOE",268
37,"37240",945,623,619,5,4,"PSOE",110
24,"24148",1672,1249,1241,23,8,"PSOE",228
30,"30011",4697,3421,3383,15,38,"PSOE",773
16,"16170",692,501,493,4,8,"PSOE",174
31,"31151",66,46,46,1,0,"PSOE",4
19,"19086",1473,1123,1111,7,12,"PSOE",366
37,"37197",84,57,57,2,0,"PSOE",8
9,"9032",109,75,73,0,2,"PSOE",31
3,"3014",237287,167428,166445,847,983,"PSOE",33915
44,"44172",301,218,216,4,2,"PSOE",54
9,"9247",24,21,21,1,0,"PSOE",1
41,"41034",23070,14805,14625,186,180,"PSOE",5971
50,"50060",172,128,127,1,1,"PSOE",28
7,"7055",7442,4604,4553,42,51,"PSOE",872
42,"42021",83,55,55,3,0,"PSOE",6
44,"44031",97,62,62,0,0,"PSOE",21
29,"29017",6553,4744,4668,33,76,"PSOE",2039
40,"40118",51,35,34,1,1,"PSOE",10
49,"49029",623,495,488,3,7,"PSOE",68
6,"6045",506,379,374,3,5,"PSOE",183
9,"9248",78,59,59,1,0,"PSOE",11
22,"22027",329,221,218,0,3,"PSOE",61
9,"9163",582,467,459,2,8,"PSOE",135
49,"49151",619,459,456,2,3,"PSOE",136
10,"10028",90,73,73,0,0,"PSOE",30
22,"22150",472,331,330,1,1,"PSOE",84
31,"31021",62,39,38,0,1,"PSOE",6
23,"23046",2391,1916,1895,6,21,"PSOE",979
22,"22195",235,182,181,3,1,"PSOE",24
40,"40032",390,289,285,2,4,"PSOE",50
14,"14056",23581,16120,15958,143,162,"PSOE",6511
10,"10029",414,339,333,0,6,"PSOE",177
46,"46106",1535,1150,1140,10,10,"PSOE",294
45,"45008",139,118,118,1,0,"PSOE",48
39,"39036",969,743,739,2,4,"PSOE",153
46,"46185",378,320,313,2,7,"PSOE",60
49,"49152",525,339,334,2,5,"PSOE",57
31,"31187",111,68,63,1,5,"PSOE",5
42,"42023",63,51,51,0,0,"PSOE",12
18,"18175",11670,8200,8097,36,103,"PSOE",2923
23,"23007",3087,2205,2187,6,18,"PSOE",1080
19,"19203",30,24,24,0,0,"PSOE",7
40,"40161",36,28,28,2,0,"PSOE",0
45,"45142",7871,6007,5927,37,80,"PSOE",1555
33,"33043",683,446,441,2,5,"PSOE",189
46,"46212",1620,1150,1124,9,26,"PSOE",218
31,"31155",256,169,167,2,2,"PSOE",50
46,"46160",1913,1452,1436,1,16,"PSOE",415
42,"42110",59,45,45,2,0,"PSOE",8
4,"4029",8859,5834,5790,35,44,"PSOE",2239
37,"37329",42,34,34,0,0,"PSOE",1
49,"49077",183,103,103,0,0,"PSOE",23
30,"30036",14698,9859,9734,41,125,"PSOE",1642
50,"50012",100,80,79,2,1,"PSOE",38
50,"50233",106,81,81,0,0,"PSOE",15
3,"3078",478,389,389,5,0,"PSOE",65
33,"33044",178278,125469,124554,1124,915,"PSOE",24714
50,"50094",1617,1173,1159,12,14,"PSOE",331
9,"9122",94,67,66,1,1,"PSOE",12
24,"24153",232,179,177,2,2,"PSOE",43
46,"46004",1922,1565,1547,11,18,"PSOE",282
16,"16176",38,30,30,0,0,"PSOE",15
39,"39099",3114,2308,2281,12,27,"PSOE",576
2,"2071",1011,831,825,5,6,"PSOE",282
5,"5181",43,34,34,1,0,"PSOE",8
19,"19007",459,341,336,0,5,"PSOE",99
9,"9076",23,17,17,1,0,"PSOE",1
9,"9253",109,94,91,1,3,"PSOE",25
50,"50095",12323,8628,8550,110,78,"PSOE",3227
45,"45156",3410,2751,2711,13,40,"PSOE",811
28,"28097",119,94,94,0,0,"PSOE",34
16,"16086",890,740,735,6,5,"PSOE",242
6,"6097",2362,1750,1727,7,23,"PSOE",691
6,"6052",4030,2735,2688,20,47,"PSOE",782
37,"37248",152,126,125,1,1,"PSOE",12
29,"29022",179,137,136,0,1,"PSOE",60
34,"34047",1782,1397,1374,12,23,"PSOE",229
37,"37074",150,123,120,0,3,"PSOE",49
31,"31259",484,291,286,2,5,"PSOE",27
50,"50286",77,50,50,3,0,"PSOE",17
3,"3080",1300,1035,1025,3,10,"PSOE",186
5,"5246",59,46,44,0,2,"PSOE",12
42,"42149",381,277,273,2,4,"PSOE",69
34,"34106",109,89,86,2,3,"PSOE",9
19,"19232",71,57,57,1,0,"PSOE",8
45,"45035",281,212,209,1,3,"PSOE",62
50,"50204",2436,1785,1770,3,15,"PSOE",802
30,"30008",13918,9757,9645,59,112,"PSOE",1962
42,"42117",140,101,99,0,2,"PSOE",17
23,"23012",4162,2907,2889,14,18,"PSOE",1349
26,"26079",634,520,512,4,8,"PSOE",94
31,"31192",156,129,127,3,2,"PSOE",8
33,"33048",154,95,94,0,1,"PSOE",35
34,"34048",73,59,59,1,0,"PSOE",12
46,"46241",392,299,291,1,8,"PSOE",72
4,"4001",1062,823,814,5,9,"PSOE",356
3,"3114",1562,1198,1188,9,10,"PSOE",284
46,"46085",11081,7938,7866,46,72,"PSOE",1743
5,"5136",96,61,60,3,1,"PSOE",10
41,"41097",3137,2180,2134,18,46,"PSOE",1160
34,"34049",359,266,260,1,6,"PSOE",66
5,"5088",30,23,23,0,0,"PSOE",2
50,"50287",270,191,191,0,0,"PSOE",52
37,"37251",124,93,92,1,1,"PSOE",10
26,"26080",472,391,389,0,2,"PSOE",80
31,"31061",54,49,49,0,0,"PSOE",8
37,"37335",406,296,290,0,6,"PSOE",55
37,"37126",29,24,24,0,0,"PSOE",3
10,"10038",87,68,68,0,0,"PSOE",16
49,"49159",271,209,205,4,4,"PSOE",56
7,"7025",472,355,351,1,4,"PSOE",42
33,"33049",6322,4116,4062,43,54,"PSOE",1245
37,"37080",225,171,167,0,4,"PSOE",37
40,"40128",129,95,93,0,2,"PSOE",21
12,"12020",118,105,105,0,0,"PSOE",7
6,"6058",2026,1433,1416,9,17,"PSOE",632
5,"5187",1754,1323,1303,7,20,"PSOE",290
33,"33020",13307,9011,8914,99,97,"PSOE",2648
34,"34196",89,68,68,1,0,"PSOE",11
24,"24122",1342,930,924,8,6,"PSOE",303
31,"31262",228,179,178,5,1,"PSOE",13
9,"9129",104,83,83,0,0,"PSOE",41
28,"28063",258,194,193,1,1,"PSOE",36
40,"40129",177,148,147,1,1,"PSOE",26
45,"45117",747,606,601,4,5,"PSOE",271
49,"49162",186,142,140,1,2,"PSOE",36
19,"19248",78,63,63,0,0,"PSOE",11
46,"46087",120,98,97,0,1,"PSOE",37
47,"47118",168,127,127,2,0,"PSOE",31
16,"16045",222,172,171,1,1,"PSOE",63
9,"9006",59,39,39,0,0,"PSOE",6
40,"40045",109,85,85,2,0,"PSOE",19
4,"4069",4687,3471,3437,27,34,"PSOE",1121
6,"6059",1851,1268,1258,7,10,"PSOE",477
49,"49163",219,158,154,5,4,"PSOE",22
29,"29072",3262,2382,2352,17,30,"PSOE",958
46,"46088",166,125,125,4,0,"PSOE",27
50,"50009",105,80,80,0,0,"PSOE",8
47,"47037",168,138,133,0,5,"PSOE",28
10,"10042",84,63,63,0,0,"PSOE",29
46,"46192",761,576,570,5,6,"PSOE",133
18,"18141",404,285,282,0,3,"PSOE",61
5,"5045",91,66,66,0,0,"PSOE",14
45,"45019",7377,5307,5251,37,56,"PSOE",1506
21,"21003",690,471,458,6,13,"PSOE",261
23,"23019",1536,1196,1174,2,22,"PSOE",511
41,"41101",5928,4209,4173,18,36,"PSOE",1800
9,"9009",163,133,131,2,2,"PSOE",24
42,"42124",64,49,49,0,0,"PSOE",16
5,"5191",121,106,105,1,1,"PSOE",27
37,"37381",147,114,107,2,7,"PSOE",13
37,"37257",52,46,46,0,0,"PSOE",3
40,"40005",30,23,23,0,0,"PSOE",2
44,"44183",77,50,49,0,1,"PSOE",15
45,"45187",4062,3277,3233,15,44,"PSOE",1232
29,"29063",323,250,245,1,5,"PSOE",76
45,"45020",1290,1037,1026,6,11,"PSOE",313
3,"3088",5498,4041,3989,29,52,"PSOE",834
9,"9132",171,122,122,2,0,"PSOE",18
5,"5192",101,82,79,2,3,"PSOE",11
31,"31066",855,589,579,8,10,"PSOE",180
45,"45120",129,104,104,1,0,"PSOE",43
31,"31901",15459,11119,11026,108,93,"PSOE",1997
46,"46194",15567,11156,11044,86,112,"PSOE",2373
49,"49206",840,614,604,9,10,"PSOE",185
24,"24027",1211,863,847,8,16,"PSOE",247
16,"16049",149,111,110,0,1,"PSOE",54
11,"11015",62476,38177,37875,488,302,"PSOE",9864
16,"16146",83,57,57,0,0,"PSOE",15
41,"41081",29189,20205,20015,196,190,"PSOE",8337
49,"49044",80,60,58,0,2,"PSOE",21
23,"23021",524,431,429,0,2,"PSOE",222
10,"10047",955,732,727,1,5,"PSOE",314
40,"40121",280,226,218,3,8,"PSOE",50
26,"26148",165,135,133,1,2,"PSOE",38
49,"49046",268,203,203,0,0,"PSOE",50
28,"28901",799,558,554,0,4,"PSOE",131
12,"12026",881,678,663,13,15,"PSOE",148
44,"44084",54,41,41,0,0,"PSOE",13
22,"22008",173,137,133,3,4,"PSOE",24
26,"26054",320,263,260,4,3,"PSOE",96
5,"5194",140,119,116,1,3,"PSOE",27
39,"39018",4220,3264,3204,35,60,"PSOE",972
46,"46091",118,94,94,0,0,"PSOE",8
5,"5195",220,169,169,2,0,"PSOE",26
3,"3090",17182,12487,12385,74,102,"PSOE",2513
50,"50294",70,63,63,0,0,"PSOE",18
47,"47041",150,112,110,2,2,"PSOE",27
16,"16052",547,418,416,2,2,"PSOE",120
31,"31179",502,348,345,0,3,"PSOE",101
28,"28903",33082,27065,26922,154,143,"PSOE",4459
46,"46248",4897,3596,3544,18,52,"PSOE",826
46,"46196",147,125,125,1,0,"PSOE",30
18,"18101",9265,6618,6560,59,58,"PSOE",1560
31,"31168",246,172,171,1,1,"PSOE",18
19,"19254",45,34,34,0,0,"PSOE",8
6,"6113",2721,2004,1971,7,33,"PSOE",683
37,"37219",173,109,108,0,1,"PSOE",18
37,"37091",177,117,116,1,1,"PSOE",21
47,"47205",384,266,260,0,6,"PSOE",31
3,"3070",2051,1455,1437,7,18,"PSOE",330
22,"22227",206,163,160,3,3,"PSOE",62
18,"18179",538,376,374,6,2,"PSOE",153
3,"3040",254,216,213,2,3,"PSOE",39
9,"9317",19,16,16,0,0,"PSOE",3
40,"40180",299,246,241,1,5,"PSOE",44
46,"46102",19788,15154,15038,89,116,"PSOE",4495
19,"19108",111,97,96,0,1,"PSOE",19
45,"45192",2491,2069,2049,2,20,"PSOE",725
29,"29090",1688,1144,1134,15,10,"PSOE",341
50,"50266",122,90,90,0,0,"PSOE",29
19,"19185",28,21,20,0,1,"PSOE",5
14,"14014",2557,2035,2007,9,28,"PSOE",920
49,"49171",646,514,508,10,6,"PSOE",115
18,"18014",6581,4584,4545,37,39,"PSOE",1150
45,"45125",2305,1865,1841,8,24,"PSOE",644
9,"9318",61,41,41,0,0,"PSOE",12
28,"28129",8030,5986,5941,42,45,"PSOE",958
5,"5249",105,84,82,0,2,"PSOE",15
29,"29035",1567,1157,1144,11,13,"PSOE",544
40,"40141",842,593,584,10,9,"PSOE",136
22,"22049",78,64,64,0,0,"PSOE",12
10,"10190",545,406,395,2,11,"PSOE",175
45,"45126",260,176,175,3,1,"PSOE",68
49,"49053",931,709,699,8,10,"PSOE",206
9,"9095",84,61,61,0,0,"PSOE",8
46,"46172",5042,3504,3477,22,27,"PSOE",627
49,"49257",291,190,184,1,6,"PSOE",53
24,"24001",189,124,122,0,2,"PSOE",31
47,"47018",34,28,28,0,0,"PSOE",0
12,"12032",23525,17093,16966,104,127,"PSOE",3519
33,"33029",350,181,174,2,7,"PSOE",80
5,"5107",62,39,39,0,0,"PSOE",2
34,"34214",183,144,144,0,0,"PSOE",52
19,"19258",90,77,77,0,0,"PSOE",18
50,"50238",91,66,66,1,0,"PSOE",13
49,"49054",894,617,601,13,16,"PSOE",155
31,"31172",373,278,272,3,6,"PSOE",26
31,"31908",1004,686,682,2,4,"PSOE",56
37,"37351",281,229,227,0,2,"PSOE",69
46,"46147",16835,11920,11791,61,129,"PSOE",2300
11,"11902",3629,2275,2252,25,23,"PSOE",889
14,"14054",13697,10315,10109,93,206,"PSOE",3429
16,"16902",137,107,107,0,0,"PSOE",33
31,"31217",321,226,223,1,3,"PSOE",37
9,"9019",150,92,90,0,2,"PSOE",18
40,"40016",58,49,49,0,0,"PSOE",9
44,"44125",61,44,44,0,0,"PSOE",9
42,"42139",23,15,15,1,0,"PSOE",0
28,"28132",11685,8130,8062,56,68,"PSOE",1966
45,"45062",1112,878,867,4,11,"PSOE",250
6,"6029",1195,855,841,3,14,"PSOE",502
42,"42183",111,82,82,2,0,"PSOE",3
22,"22087",67,45,45,2,0,"PSOE",9
37,"37050",66,52,52,0,0,"PSOE",15
42,"42105",50,45,45,0,0,"PSOE",1
29,"29084",27359,17843,17627,176,216,"PSOE",5473
46,"46096",274,209,209,1,0,"PSOE",51
39,"39034",286,188,185,5,3,"PSOE",37
4,"4049",5313,3620,3579,18,41,"PSOE",1104
5,"5060",116,95,95,0,0,"PSOE",13
12,"12132",480,396,389,3,7,"PSOE",73
44,"44227",74,63,62,0,1,"PSOE",21
42,"42140",16,12,12,0,0,"PSOE",0
5,"5257",132,101,101,0,0,"PSOE",11
46,"46201",64,52,51,1,1,"PSOE",31
44,"44126",329,234,229,4,5,"PSOE",58
34,"34113",38,36,36,0,0,"PSOE",6
50,"50020",809,564,559,2,5,"PSOE",150
46,"46149",363,271,268,2,3,"PSOE",43
30,"30003",24332,16183,16040,104,143,"PSOE",4533
26,"26063",124,94,94,2,0,"PSOE",24
33,"33002",9995,6765,6672,47,93,"PSOE",2147
16,"16111",171,123,123,1,0,"PSOE",39
4,"4051",436,360,356,1,4,"PSOE",116
16,"16211",370,263,263,3,0,"PSOE",100
47,"47130",96,72,72,0,0,"PSOE",13
16,"16064",684,568,562,4,6,"PSOE",164
11,"11014",16858,10366,10245,153,121,"PSOE",2887
49,"49101",153,102,99,0,3,"PSOE",17
40,"40189",512,401,392,2,9,"PSOE",132
31,"31011",693,459,456,8,3,"PSOE",40
28,"28165",1794,1293,1285,3,8,"PSOE",255
46,"46046",892,675,668,1,7,"PSOE",76
6,"6124",1708,1202,1165,8,37,"PSOE",530
49,"49139",171,135,135,0,0,"PSOE",41
16,"16065",388,320,314,2,6,"PSOE",80
9,"9036",37,31,30,1,1,"PSOE",1
42,"42051",20,14,14,1,0,"PSOE",0
44,"44128",68,54,54,1,0,"PSOE",21
50,"50149",34,24,24,0,0,"PSOE",3
40,"40148",238,188,187,2,1,"PSOE",39
7,"7059",2996,2053,2013,17,40,"PSOE",433
46,"46038",327,242,242,3,0,"PSOE",55
37,"37134",230,168,165,0,3,"PSOE",62
47,"47112",2587,2015,1988,7,27,"PSOE",432
10,"10154",181,131,129,0,2,"PSOE",48
37,"37056",37,30,29,0,1,"PSOE",1
29,"29010",1651,1278,1237,4,41,"PSOE",649
23,"23037",502,404,400,6,4,"PSOE",220
26,"26032",51,41,39,0,2,"PSOE",14
50,"50150",649,402,397,2,5,"PSOE",111
50,"50118",2165,1552,1540,10,12,"PSOE",603
37,"37233",61,48,47,1,1,"PSOE",19
50,"50023",224,175,175,0,0,"PSOE",42
7,"7047",2246,1517,1482,18,35,"PSOE",284
10,"10110",2300,1623,1574,11,49,"PSOE",504
5,"5066",453,367,367,5,0,"PSOE",102
18,"18116",2850,2059,2025,20,34,"PSOE",674
22,"22111",154,103,102,0,1,"PSOE",23
46,"46263",251,214,212,0,2,"PSOE",98
26,"26102",6111,4486,4435,28,51,"PSOE",1139
33,"33036",11542,8062,7987,60,75,"PSOE",2375
47,"47159",822,644,636,1,8,"PSOE",210
3,"3133",41576,25849,25639,127,210,"PSOE",5274
28,"28069",50,44,41,0,3,"PSOE",9
46,"46023",327,280,278,2,2,"PSOE",41
26,"26103",796,616,610,6,6,"PSOE",171
49,"49228",54,44,43,0,1,"PSOE",9
45,"45134",1581,1204,1192,6,12,"PSOE",313
9,"9039",58,46,46,2,0,"PSOE",0
26,"26012",23,23,23,1,0,"PSOE",3
44,"44086",449,342,336,3,6,"PSOE",88
47,"47222",83,64,64,1,0,"PSOE",18
44,"44232",378,284,276,6,8,"PSOE",79
37,"37016",569,406,401,2,5,"PSOE",80
31,"31169",2193,1472,1445,9,27,"PSOE",527
12,"12041",100,81,81,0,0,"PSOE",15
6,"6084",1093,828,818,8,10,"PSOE",304
31,"31181",145,112,112,0,0,"PSOE",15
9,"9423",27,24,24,0,0,"PSOE",3
50,"50153",935,713,708,6,5,"PSOE",301
37,"37237",324,244,240,1,4,"PSOE",91
24,"24176",316,247,244,1,3,"PSOE",49
39,"39030",1895,1225,1212,10,13,"PSOE",271
26,"26002",830,632,622,0,10,"PSOE",194
45,"45070",1427,1147,1142,1,5,"PSOE",303
45,"45181",2315,1674,1640,7,34,"PSOE",565
26,"26003",413,331,329,2,2,"PSOE",79
9,"9289",1451,1014,1000,5,14,"PSOE",252
18,"18914",1649,1238,1213,3,25,"PSOE",556
21,"21025",4026,2433,2396,30,37,"PSOE",929
28,"28170",2472,1640,1622,13,18,"PSOE",436
5,"5073",297,253,252,2,1,"PSOE",27
19,"19197",27,22,22,0,0,"PSOE",9
18,"18167",1895,1258,1250,4,8,"PSOE",548
10,"10115",3544,2705,2647,11,58,"PSOE",884
49,"49066",492,336,332,4,4,"PSOE",69
18,"18121",129,98,98,1,0,"PSOE",32
28,"28016",79,53,51,0,2,"PSOE",13
22,"22102",179,141,138,2,3,"PSOE",30
33,"33009",905,611,609,3,2,"PSOE",144
24,"24012",290,207,205,1,2,"PSOE",29
18,"18915",745,533,525,2,8,"PSOE",295
46,"46182",1266,929,922,6,7,"PSOE",164
9,"9030",112,75,73,1,2,"PSOE",13
4,"4058",354,261,259,1,2,"PSOE",91
42,"42154",97,69,69,1,0,"PSOE",20
6,"6042",1011,698,687,2,11,"PSOE",294
50,"50279",86,64,64,0,0,"PSOE",41
45,"45050",457,333,328,1,5,"PSOE",87
33,"33050",592,387,376,2,11,"PSOE",126
9,"9174",794,559,552,4,7,"PSOE",137
9,"9294",108,86,82,0,4,"PSOE",28
37,"37114",84,70,69,2,1,"PSOE",21
5,"5076",478,386,378,4,8,"PSOE",71
12,"12045",345,268,259,1,9,"PSOE",102
24,"24216",723,522,518,1,4,"PSOE",110
46,"46235",21579,15929,15763,113,166,"PSOE",3165
3,"3106",583,480,478,2,2,"PSOE",127
31,"31185",494,341,341,1,0,"PSOE",28
23,"23084",935,658,653,7,5,"PSOE",346
28,"28114",150,101,100,1,1,"PSOE",5
49,"49203",313,240,232,0,8,"PSOE",74
21,"21069",1702,1167,1149,6,18,"PSOE",579
34,"34230",15,12,12,0,0,"PSOE",2
49,"49041",432,326,322,5,4,"PSOE",120
6,"6091",3774,2709,2666,23,43,"PSOE",1060
40,"40158",17,12,12,0,0,"PSOE",0
41,"41001",1596,1183,1159,5,24,"PSOE",479
18,"18079",3441,2442,2411,16,31,"PSOE",1252
45,"45140",1087,833,823,3,10,"PSOE",345
9,"9340",77,49,49,0,0,"PSOE",9
19,"19045",140,120,120,0,0,"PSOE",18
19,"19003",42,35,34,1,1,"PSOE",14
9,"9476",62,43,43,0,0,"PSOE",10
34,"34179",28,21,20,0,1,"PSOE",1
37,"37199",142,105,105,1,0,"PSOE",38
50,"50199",334,244,242,3,2,"PSOE",76
28,"28047",40914,30019,29788,169,231,"PSOE",5619
40,"40159",142,100,99,1,1,"PSOE",20
47,"47139",1040,777,767,6,10,"PSOE",203
9,"9208",210,136,134,3,2,"PSOE",20
2,"2027",315,248,246,2,2,"PSOE",82
19,"19274",902,660,651,7,9,"PSOE",180
39,"39066",872,667,661,4,6,"PSOE",180
34,"34084",138,109,107,0,2,"PSOE",16
4,"4028",221,191,190,1,1,"PSOE",114
37,"37244",131,98,98,0,0,"PSOE",7
26,"26008",1860,1399,1387,5,12,"PSOE",473
30,"30035",18671,13103,12979,54,124,"PSOE",1956
37,"37369",137,95,94,0,1,"PSOE",17
26,"26075",329,267,264,2,3,"PSOE",88
6,"6093",4447,3254,3204,15,50,"PSOE",1400
37,"37201",262,187,186,1,1,"PSOE",48
41,"41036",3941,2674,2642,23,32,"PSOE",921
29,"29030",805,620,614,4,6,"PSOE",317
44,"44208",37,22,22,0,0,"PSOE",4
26,"26009",401,325,321,4,4,"PSOE",85
5,"5081",40,36,36,1,0,"PSOE",5
28,"28078",38,32,32,0,0,"PSOE",1
19,"19019",20,18,17,0,1,"PSOE",3
46,"46134",2357,1725,1712,14,13,"PSOE",314
50,"50032",261,189,189,5,0,"PSOE",55
6,"6019",2079,1451,1417,8,34,"PSOE",631
24,"24018",174,143,141,0,2,"PSOE",17
44,"44002",47,40,40,0,0,"PSOE",14
42,"42026",24,20,20,0,0,"PSOE",4
19,"19241",43,34,34,1,0,"PSOE",2
37,"37246",5304,3993,3949,26,44,"PSOE",1154
31,"31189",1161,720,709,6,11,"PSOE",109
9,"9038",119,100,100,0,0,"PSOE",28
18,"18085",720,507,499,3,8,"PSOE",234
19,"19129",28,26,26,0,0,"PSOE",3
34,"34237",592,462,452,6,10,"PSOE",110
14,"14059",690,533,528,4,5,"PSOE",194
47,"47193",1577,1251,1241,7,10,"PSOE",270
49,"49194",368,218,216,1,2,"PSOE",59
5,"5244",50,39,39,1,0,"PSOE",2
30,"30006",803,691,685,2,6,"PSOE",180
45,"45056",2201,1260,1243,12,17,"PSOE",324
23,"23091",729,555,553,5,2,"PSOE",252
40,"40079",234,179,179,3,0,"PSOE",42
6,"6007",1475,1038,1032,1,6,"PSOE",612
47,"47168",29,26,26,1,0,"PSOE",0
42,"42027",76,61,60,0,1,"PSOE",14
47,"47059",97,76,76,2,0,"PSOE",13
31,"31191",3016,2167,2147,22,20,"PSOE",475
49,"49063",338,272,266,4,6,"PSOE",69
24,"24185",474,357,350,3,7,"PSOE",84
45,"45180",2727,1966,1940,9,26,"PSOE",399
28,"28119",2092,1590,1582,12,8,"PSOE",213
50,"50108",48,38,38,0,0,"PSOE",10
45,"45091",394,269,267,3,2,"PSOE",107
41,"41062",2223,1653,1637,7,16,"PSOE",678
9,"9054",101,68,66,1,2,"PSOE",7
44,"44211",42,35,35,0,0,"PSOE",10
24,"24156",239,159,158,1,1,"PSOE",31
5,"5232",102,84,79,1,5,"PSOE",10
13,"13007",1271,993,977,8,16,"PSOE",366
49,"49119",227,169,168,0,1,"PSOE",63
2,"2033",1892,1505,1474,6,31,"PSOE",406
9,"9170",205,162,162,1,0,"PSOE",26
37,"37124",212,146,144,1,2,"PSOE",35
16,"16088",108,88,87,0,1,"PSOE",33
9,"9228",160,137,136,1,1,"PSOE",18
37,"37264",65,40,40,0,0,"PSOE",8
19,"19010",8,8,8,0,0,"PSOE",2
10,"10901",1174,752,741,4,11,"PSOE",266
10,"10084",1345,888,875,4,13,"PSOE",368
45,"45182",1034,806,791,1,15,"PSOE",252
6,"6101",463,381,378,2,3,"PSOE",133
41,"41009",1222,812,805,3,7,"PSOE",382
16,"16245",419,327,323,7,4,"PSOE",87
22,"22203",83,67,67,1,0,"PSOE",17
9,"9043",192,137,133,1,4,"PSOE",24
24,"24189",5865,3933,3885,31,48,"PSOE",749
9,"9001",27,22,22,0,0,"PSOE",14
16,"16280",192,164,161,1,3,"PSOE",53
26,"26059",1125,828,812,5,16,"PSOE",206
44,"44075",323,248,246,0,2,"PSOE",43
16,"16043",95,73,73,1,0,"PSOE",15
46,"46034",1758,1390,1379,4,11,"PSOE",245
26,"26015",196,158,157,2,1,"PSOE",23
4,"4068",187,154,152,0,2,"PSOE",57
19,"19247",139,102,100,1,2,"PSOE",35
45,"45149",556,446,440,0,6,"PSOE",138
41,"41044",7423,5273,5241,34,32,"PSOE",1536
29,"29059",2587,1965,1922,14,43,"PSOE",581
50,"50038",1502,1121,1111,7,10,"PSOE",420
34,"34215",164,141,140,1,1,"PSOE",41
40,"40156",322,238,235,1,3,"PSOE",40
47,"47044",331,293,290,2,3,"PSOE",70
49,"49084",287,229,228,4,1,"PSOE",49
9,"9045",268,181,181,4,0,"PSOE",22
24,"24058",208,155,154,3,1,"PSOE",42
26,"26082",112,87,87,1,0,"PSOE",21
30,"30042",1922,1504,1491,7,13,"PSOE",377
29,"29060",692,510,508,1,2,"PSOE",161
5,"5092",152,125,122,0,3,"PSOE",17
40,"40172",39,34,34,0,0,"PSOE",9
9,"9905",384,279,279,2,0,"PSOE",43
40,"40212",27,23,22,2,1,"PSOE",3
37,"37007",437,314,306,3,8,"PSOE",94
21,"21055",6975,5293,5241,48,52,"PSOE",1369
10,"10164",737,484,475,3,9,"PSOE",196
26,"26005",2381,1598,1577,23,21,"PSOE",356
19,"19016",65,49,49,0,0,"PSOE",17
6,"6106",423,274,272,5,2,"PSOE",82
16,"16248",859,654,636,5,18,"PSOE",157
46,"46062",4631,3511,3474,27,37,"PSOE",777
4,"4036",226,175,175,0,0,"PSOE",70
50,"50071",132,92,92,0,0,"PSOE",7
14,"14065",1850,1384,1377,16,7,"PSOE",475
50,"50230",1165,833,828,8,5,"PSOE",261
16,"16096",274,232,229,1,3,"PSOE",98
45,"45152",587,458,451,0,7,"PSOE",197
19,"19178",33,22,22,0,0,"PSOE",8
7,"7056",5026,3410,3375,32,35,"PSOE",580
42,"42035",769,527,516,2,11,"PSOE",123
18,"18006",4130,2904,2864,13,40,"PSOE",1068
37,"37341",53,39,39,0,0,"PSOE",4
21,"21045",249,180,178,3,2,"PSOE",86
19,"19250",20,17,17,0,0,"PSOE",4
37,"37214",129,93,91,0,2,"PSOE",20
37,"37299",219,166,163,4,3,"PSOE",32
26,"26019",355,274,271,1,3,"PSOE",81
44,"44117",340,271,268,4,3,"PSOE",94
34,"34101",50,41,41,0,0,"PSOE",10
16,"16097",156,124,121,0,3,"PSOE",55
5,"5241",3063,2056,2032,15,24,"PSOE",382
37,"37258",172,116,115,3,1,"PSOE",35
19,"19142",265,182,180,3,2,"PSOE",69
6,"6018",753,535,529,3,6,"PSOE",250
46,"46073",1092,888,884,6,4,"PSOE",265
19,"19329",59,50,50,1,0,"PSOE",11
46,"46021",23649,17291,17153,100,138,"PSOE",4303
18,"18066",2107,1392,1384,4,8,"PSOE",685
40,"40231",108,90,89,0,1,"PSOE",21
9,"9223",45,37,37,0,0,"PSOE",2
18,"18145",10491,7538,7477,59,61,"PSOE",1750
24,"24071",1006,745,734,10,11,"PSOE",230
40,"40216",759,574,571,3,3,"PSOE",125
16,"16006",120,98,96,3,2,"PSOE",33
26,"26076",129,107,106,0,1,"PSOE",35
28,"28002",3007,2091,2074,14,17,"PSOE",366
41,"41902",4659,2679,2646,23,33,"PSOE",1354
18,"18176",250,191,189,2,2,"PSOE",112
7,"7033",27104,15524,15337,174,187,"PSOE",2756
18,"18192",1538,1151,1123,6,28,"PSOE",464
26,"26088",37,32,31,0,1,"PSOE",8
31,"31902",4405,3092,3061,25,31,"PSOE",369
14,"14068",538,401,398,10,3,"PSOE",190
47,"47014",51,45,45,0,0,"PSOE",10
21,"21048",305,214,210,4,4,"PSOE",94
44,"44013",11244,7815,7712,82,103,"PSOE",1810
40,"40051",38,34,34,0,0,"PSOE",9
29,"29066",334,234,233,4,1,"PSOE",78
3,"3008",168,130,129,0,1,"PSOE",36
3,"3059",20583,15125,15018,63,107,"PSOE",2597
16,"16255",140,122,121,0,1,"PSOE",51
50,"50140",166,115,115,0,0,"PSOE",24
46,"46222",384,307,304,1,3,"PSOE",75
10,"10141",263,194,194,0,0,"PSOE",81
37,"37042",44,28,27,0,1,"PSOE",1
6,"6158",13314,9654,9507,67,147,"PSOE",3050
7,"7035",1524,1078,1055,8,23,"PSOE",243
22,"22172",556,372,370,6,2,"PSOE",66
16,"16197",59,42,42,0,0,"PSOE",19
37,"37164",256,191,189,5,2,"PSOE",37
29,"29077",199,149,146,2,3,"PSOE",76
46,"46101",860,716,705,3,11,"PSOE",191
42,"42075",83,62,62,0,0,"PSOE",14
6,"6129",577,438,429,0,9,"PSOE",196
28,"28073",12549,8788,8701,54,87,"PSOE",1832
6,"6069",3065,2053,2035,14,18,"PSOE",970
19,"19039",61,54,54,1,0,"PSOE",14
26,"26126",31,27,27,0,0,"PSOE",4
42,"42131",51,37,37,1,0,"PSOE",9
12,"12127",75,55,55,0,0,"PSOE",23
44,"44132",60,54,54,1,0,"PSOE",13
4,"4903",4320,2858,2825,19,33,"PSOE",644
6,"6161",302,236,235,1,1,"PSOE",114
26,"26057",48,38,38,0,0,"PSOE",13
40,"40025",136,117,115,0,2,"PSOE",17
33,"33047",1107,852,843,9,9,"PSOE",212
3,"3092",6743,5254,5178,37,76,"PSOE",860
49,"49094",224,149,149,2,0,"PSOE",30
21,"21052",4583,2734,2663,22,71,"PSOE",1238
34,"34107",81,52,51,5,1,"PSOE",6
44,"44017",285,227,223,4,4,"PSOE",62
26,"26128",105,81,81,1,0,"PSOE",27
11,"11009",605,414,410,1,4,"PSOE",139
46,"46042",3380,2799,2755,20,44,"PSOE",679
40,"40014",58,46,45,0,1,"PSOE",14
4,"4012",191,161,161,0,0,"PSOE",58
34,"34019",125,107,105,0,2,"PSOE",18
34,"34213",57,45,44,1,1,"PSOE",5
37,"37046",11225,7824,7697,53,127,"PSOE",1747
22,"22023",421,313,309,6,4,"PSOE",93
6,"6026",837,598,591,0,7,"PSOE",214
10,"10191",527,405,397,2,8,"PSOE",114
45,"45061",2447,1703,1689,12,14,"PSOE",595
16,"16153",949,778,772,7,6,"PSOE",289
37,"37047",180,84,84,0,0,"PSOE",11
29,"29093",2214,1643,1621,3,22,"PSOE",680
10,"10146",1507,1004,977,7,27,"PSOE",414
42,"42195",101,62,62,0,0,"PSOE",19
9,"9230",38,32,32,0,0,"PSOE",1
9,"9018",24668,17575,17369,111,206,"PSOE",4233
13,"13063",3706,2539,2514,33,25,"PSOE",776
40,"40146",254,197,196,0,1,"PSOE",52
40,"40157",47,44,44,0,0,"PSOE",10
16,"16236",910,656,651,4,5,"PSOE",153
4,"4048",1503,1090,1085,9,5,"PSOE",447
31,"31007",131,87,86,1,1,"PSOE",11
31,"31206",2090,1461,1440,22,21,"PSOE",176
9,"9325",190,130,129,2,1,"PSOE",18
46,"46122",2704,2082,2063,10,19,"PSOE",608
18,"18018",634,472,468,5,4,"PSOE",215
44,"44193",78,54,54,1,0,"PSOE",15
47,"47154",152,128,125,1,3,"PSOE",28
10,"10102",529,411,405,5,6,"PSOE",189
14,"14055",18557,12950,12764,178,186,"PSOE",4058
13,"13901",893,665,655,5,10,"PSOE",235
37,"37324",360,276,275,2,1,"PSOE",66
18,"18010",566,427,421,1,6,"PSOE",172
37,"37157",78,63,62,0,1,"PSOE",22
50,"50298",5333,3949,3902,39,47,"PSOE",1058
28,"28163",442,344,339,1,5,"PSOE",80
10,"10104",5119,3633,3585,15,48,"PSOE",1120
37,"37311",227,182,182,3,0,"PSOE",36
34,"34024",31,21,21,1,0,"PSOE",2
22,"22016",601,413,411,6,2,"PSOE",140
37,"37101",160,128,125,0,3,"PSOE",15
37,"37229",135,112,112,0,0,"PSOE",9
7,"7043",3389,2290,2252,26,38,"PSOE",383
37,"37009",213,172,171,3,1,"PSOE",36
37,"37085",4712,3366,3333,27,33,"PSOE",545
45,"45075",143,109,108,0,1,"PSOE",20
37,"37010",939,708,702,0,6,"PSOE",166
19,"19190",2369,1760,1745,10,15,"PSOE",489
49,"49137",176,139,138,0,1,"PSOE",39
14,"14047",1672,1187,1178,14,9,"PSOE",466
50,"50241",588,415,410,4,5,"PSOE",121
18,"18112",123,82,82,2,0,"PSOE",30
16,"16272",221,176,175,0,1,"PSOE",28
4,"4016",2138,1551,1536,9,15,"PSOE",415
9,"9328",76,56,56,0,0,"PSOE",8
9,"9417",40,32,32,1,0,"PSOE",3
18,"18908",801,593,588,3,5,"PSOE",251
37,"37098",333,247,247,1,0,"PSOE",95
19,"19046",21588,15689,15515,82,174,"PSOE",4186
40,"40080",59,43,41,0,2,"PSOE",5
16,"16174",185,145,143,0,2,"PSOE",51
16,"16212",247,203,202,0,1,"PSOE",66
23,"23073",4507,3229,3200,13,29,"PSOE",1447
9,"9482",33,28,28,0,0,"PSOE",2
18,"18128",343,270,269,1,1,"PSOE",76
10,"10198",1143,981,964,6,17,"PSOE",375
18,"18114",609,424,422,8,2,"PSOE",187
46,"46186",19068,14599,14474,69,125,"PSOE",3050
34,"34116",62,49,49,0,0,"PSOE",9
45,"45043",793,657,649,1,8,"PSOE",199
5,"5148",25,15,15,0,0,"PSOE",3
23,"23048",870,619,613,1,6,"PSOE",195
40,"40095",477,377,369,0,8,"PSOE",40
50,"50128",26,25,25,1,0,"PSOE",6
46,"46047",532,446,437,2,9,"PSOE",145
37,"37273",107,71,71,1,0,"PSOE",11
9,"9105",109,86,81,1,5,"PSOE",11
21,"21061",5084,3223,3177,28,46,"PSOE",1596
37,"37106",258,165,162,0,3,"PSOE",32
49,"49180",148,103,102,2,1,"PSOE",23
16,"16116",77,68,68,0,0,"PSOE",22
49,"49103",414,330,328,5,2,"PSOE",45
44,"44231",38,33,33,0,0,"PSOE",4
50,"50151",636,499,499,0,0,"PSOE",192
34,"34135",399,293,289,0,4,"PSOE",52
46,"46204",6681,5256,5202,32,54,"PSOE",1377
18,"18115",2553,1800,1781,17,19,"PSOE",657
47,"47185",99,73,71,0,2,"PSOE",11
5,"5263",173,129,129,1,0,"PSOE",21
9,"9378",31,24,23,0,1,"PSOE",5
47,"47050",3719,2630,2598,26,32,"PSOE",601
45,"45167",1440,1144,1133,6,11,"PSOE",346
11,"11017",3212,2233,2203,39,30,"PSOE",1015
45,"45034",1353,1082,1078,6,4,"PSOE",290
22,"22058",194,164,162,1,2,"PSOE",48
24,"24041",538,367,366,3,1,"PSOE",102
14,"14022",4006,2977,2949,17,28,"PSOE",1145
50,"50220",40,32,32,0,0,"PSOE",11
46,"46173",1328,1069,1057,4,12,"PSOE",232
5,"5140",111,89,87,0,2,"PSOE",16
18,"18003",14022,9938,9820,80,118,"PSOE",2658
9,"9109",1056,619,595,8,24,"PSOE",79
22,"22083",463,394,390,5,4,"PSOE",133
40,"40068",26,24,24,0,0,"PSOE",0
3,"3041",5954,4218,4194,22,24,"PSOE",793
31,"31214",91,64,62,1,2,"PSOE",8
49,"49036",506,374,367,2,7,"PSOE",94
40,"40110",349,265,263,3,2,"PSOE",65
45,"45169",189,140,138,0,2,"PSOE",56
46,"46215",1436,1154,1143,5,11,"PSOE",258
37,"37206",94,73,73,3,0,"PSOE",19
5,"5173",60,49,49,0,0,"PSOE",5
37,"37030",85,66,66,0,0,"PSOE",8
45,"45081",17875,12656,12533,82,123,"PSOE",2483
5,"5072",81,67,67,1,0,"PSOE",9
39,"39062",1812,1379,1366,5,13,"PSOE",207
31,"31116",62,51,50,1,1,"PSOE",3
29,"29069",85684,54130,53621,455,509,"PSOE",14412
16,"16224",83,66,65,1,1,"PSOE",13
42,"42152",78,55,55,0,0,"PSOE",5
50,"50185",133,108,108,1,0,"PSOE",15
5,"5218",121,97,97,0,0,"PSOE",25
44,"44101",58,46,46,2,0,"PSOE",12
5,"5171",74,52,50,1,2,"PSOE",6
39,"39001",2102,1622,1601,18,21,"PSOE",358
44,"44169",342,252,252,3,0,"PSOE",82
37,"37321",168,132,132,2,0,"PSOE",34
10,"10161",76,53,53,0,0,"PSOE",20
9,"9113",449,339,332,4,7,"PSOE",76
45,"45037",1603,1122,1111,5,11,"PSOE",369
18,"18030",576,413,409,6,4,"PSOE",158
34,"34228",83,74,74,1,0,"PSOE",19
24,"24046",942,637,633,5,4,"PSOE",210
45,"45183",2220,1444,1428,3,16,"PSOE",272
37,"37155",65,57,57,0,0,"PSOE",23
42,"42209",140,107,106,4,1,"PSOE",20
6,"6143",3360,2353,2321,12,32,"PSOE",1186
14,"14057",6136,4713,4631,47,82,"PSOE",1419
37,"37038",788,595,583,4,12,"PSOE",166
50,"50170",371,283,280,0,3,"PSOE",128
44,"44135",113,88,87,0,1,"PSOE",33
33,"33071",595,433,430,10,3,"PSOE",216
28,"28172",9077,6992,6936,31,56,"PSOE",948
19,"19165",47,41,41,0,0,"PSOE",15
46,"46183",5993,4443,4381,19,62,"PSOE",713
28,"28144",6010,4676,4644,22,32,"PSOE",736
10,"10026",648,500,492,7,8,"PSOE",144
47,"47028",33,21,21,0,0,"PSOE",1
2,"2065",476,394,392,1,2,"PSOE",128
9,"9046",29,25,25,0,0,"PSOE",4
34,"34037",302,218,216,1,2,"PSOE",33
37,"37216",302,252,248,3,4,"PSOE",54
37,"37161",136,106,106,1,0,"PSOE",23
6,"6014",6682,4479,4409,14,70,"PSOE",1227
49,"49004",126,100,100,4,0,"PSOE",27
22,"22106",22,14,14,0,0,"PSOE",3
44,"44205",700,460,453,4,7,"PSOE",140
47,"47190",98,80,80,1,0,"PSOE",8
5,"5905",217,165,164,0,1,"PSOE",20
29,"29050",421,306,302,3,4,"PSOE",113
42,"42198",23,16,16,4,0,"PSOE",1
3,"3045",210,176,172,0,4,"PSOE",59
50,"50189",705,527,519,13,8,"PSOE",131
50,"50157",290,220,218,3,2,"PSOE",82
47,"47110",450,350,346,1,4,"PSOE",111
28,"28019",1233,893,885,4,8,"PSOE",270
24,"24151",478,353,352,1,1,"PSOE",90
12,"12123",48,40,40,3,0,"PSOE",3
34,"34131",59,52,51,0,1,"PSOE",3
45,"45041",3752,2633,2597,12,36,"PSOE",566
16,"16034",180,146,144,2,2,"PSOE",47
50,"50092",299,233,231,0,2,"PSOE",86
41,"41091",541987,385251,382091,3298,3160,"PSOE",107150
31,"31221",1214,798,786,12,12,"PSOE",93
47,"47191",108,79,79,0,0,"PSOE",13
42,"42135",72,52,52,1,0,"PSOE",13
49,"49039",338,245,239,3,6,"PSOE",66
24,"24024",692,496,491,4,5,"PSOE",91
19,"19132",92,81,81,0,0,"PSOE",16
34,"34057",471,339,338,1,1,"PSOE",73
5,"5259",124,105,105,1,0,"PSOE",25
29,"29074",794,586,581,0,5,"PSOE",282
37,"37231",250,196,193,4,3,"PSOE",43
22,"22109",261,191,190,1,1,"PSOE",33
16,"16129",95,81,79,0,2,"PSOE",16
45,"45031",2723,1835,1822,12,13,"PSOE",448
16,"16908",186,152,152,1,0,"PSOE",59
50,"50221",35,17,17,0,0,"PSOE",7
40,"40162",392,303,302,1,1,"PSOE",36
10,"10066",160,122,122,0,0,"PSOE",51
16,"16089",375,303,303,6,0,"PSOE",84
50,"50160",2238,1546,1528,12,18,"PSOE",602
24,"24221",795,543,538,7,5,"PSOE",126
13,"13002",1483,1012,998,3,14,"PSOE",329
22,"22200",244,184,182,5,2,"PSOE",44
37,"37027",228,172,171,0,1,"PSOE",34
16,"16131",130,100,97,2,3,"PSOE",29
9,"9483",211,158,157,0,1,"PSOE",49
29,"29076",2153,1390,1360,10,30,"PSOE",568
44,"44143",380,307,306,2,1,"PSOE",104
34,"34046",41,36,35,0,1,"PSOE",14
9,"9168",290,217,217,3,0,"PSOE",89
9,"9091",724,500,490,4,10,"PSOE",84
28,"28118",57,46,45,0,1,"PSOE",10
4,"4063",1096,776,768,2,8,"PSOE",321
41,"41050",5150,3817,3777,19,40,"PSOE",1450
24,"24063",374,254,252,2,2,"PSOE",49
22,"22201",266,188,187,3,1,"PSOE",80
46,"46109",6150,4625,4556,25,69,"PSOE",1018
42,"42205",89,71,71,2,0,"PSOE",18
10,"10080",366,257,255,1,2,"PSOE",120
2,"2031",565,457,455,0,2,"PSOE",183
40,"40205",261,202,198,2,4,"PSOE",31
30,"30037",18793,13150,13003,47,147,"PSOE",2336
26,"26086",16,15,15,1,0,"PSOE",0
46,"46089",2132,1602,1574,9,28,"PSOE",288
16,"16145",450,363,361,5,2,"PSOE",147
10,"10070",718,546,542,1,4,"PSOE",190
33,"33040",4549,2986,2942,35,44,"PSOE",845
42,"42130",59,46,45,1,1,"PSOE",3
16,"16025",26,23,23,0,0,"PSOE",4
24,"24098",1193,842,831,11,11,"PSOE",294
9,"9437",282,219,218,3,1,"PSOE",61
31,"31147",100,82,82,2,0,"PSOE",11
22,"22112",9566,6354,6305,56,49,"PSOE",1422
5,"5038",115,83,81,0,2,"PSOE",2
16,"16186",456,375,371,0,4,"PSOE",133
46,"46145",21990,16337,16187,93,150,"PSOE",3327
49,"49188",112,90,89,1,1,"PSOE",15
50,"50028",78,51,51,0,0,"PSOE",19
37,"37236",135,105,103,1,2,"PSOE",22
31,"31038",1339,957,942,11,15,"PSOE",197
44,"44145",1020,719,709,9,10,"PSOE",181
26,"26152",33,28,28,1,0,"PSOE",3
34,"34001",34,28,28,2,0,"PSOE",5
44,"44074",429,333,326,4,7,"PSOE",100
50,"50195",54,40,40,0,0,"PSOE",7
21,"21039",311,225,223,1,2,"PSOE",120
3,"3082",12567,8537,8464,44,73,"PSOE",1726
6,"6010",1105,819,801,5,18,"PSOE",342
10,"10130",1761,1300,1277,6,23,"PSOE",500
39,"39102",2277,1615,1598,9,17,"PSOE",357
16,"16091",65,53,53,0,0,"PSOE",24
45,"45193",613,504,497,1,7,"PSOE",120
5,"5040",66,50,50,1,0,"PSOE",7
49,"49173",375,230,221,3,9,"PSOE",48
49,"49038",99,71,65,1,6,"PSOE",11
31,"31194",311,217,216,3,1,"PSOE",19
3,"3116",1155,877,875,6,2,"PSOE",152
50,"50289",51,38,38,0,0,"PSOE",14
37,"37377",241,201,199,1,2,"PSOE",40
42,"42073",75,58,58,0,0,"PSOE",10
3,"3073",236,200,199,1,1,"PSOE",55
26,"26071",8491,5834,5761,47,73,"PSOE",1458
22,"22024",226,174,171,3,3,"PSOE",43
29,"29019",878,652,636,3,16,"PSOE",166
34,"34041",90,71,71,1,0,"PSOE",11
31,"31229",47,35,35,0,0,"PSOE",3
29,"29027",2326,1626,1609,12,17,"PSOE",588
50,"50167",233,183,178,1,5,"PSOE",36
45,"45051",1590,1171,1152,5,19,"PSOE",439
50,"50101",864,603,597,8,6,"PSOE",226
47,"47063",103,81,80,1,1,"PSOE",10
34,"34005",851,673,658,4,15,"PSOE",168
28,"28092",151841,110916,109954,582,962,"PSOE",25736
18,"18095",1967,1450,1430,11,20,"PSOE",566
22,"22025",1071,676,669,18,7,"PSOE",181
45,"45154",1493,1079,1074,6,5,"PSOE",245
45,"45143",1170,881,874,4,7,"PSOE",202
42,"42217",31,25,24,0,1,"PSOE",12
13,"13006",597,456,447,4,9,"PSOE",196
2,"2025",7461,5759,5618,34,141,"PSOE",1173
31,"31231",117,76,73,1,3,"PSOE",16
42,"42212",69,43,43,1,0,"PSOE",5
22,"22042",117,95,92,0,3,"PSOE",26
29,"29039",2666,1898,1873,22,25,"PSOE",498
9,"9131",462,365,364,2,1,"PSOE",112
33,"33022",893,578,567,11,11,"PSOE",200
13,"13066",2506,1971,1947,11,24,"PSOE",666
12,"12092",111,91,90,0,1,"PSOE",17
23,"23098",867,713,701,1,12,"PSOE",324
18,"18048",2387,1683,1662,8,21,"PSOE",660
50,"50168",28,27,27,0,0,"PSOE",7
3,"3056",8676,6638,6541,34,97,"PSOE",1576
46,"46071",464,383,377,0,6,"PSOE",97
26,"26018",10477,8053,7956,65,97,"PSOE",2494
22,"22043",93,66,65,0,1,"PSOE",12
46,"46219",127,112,112,1,0,"PSOE",26
28,"28001",61,46,45,0,1,"PSOE",5
22,"22079",118,83,83,1,0,"PSOE",35
19,"19058",6793,5258,5218,19,40,"PSOE",1050
6,"6017",272,222,221,1,1,"PSOE",63
47,"47211",47,35,34,0,1,"PSOE",1
10,"10060",967,648,640,2,8,"PSOE",267
9,"9277",120,101,99,0,2,"PSOE",34
47,"47225",80,63,63,0,0,"PSOE",10
9,"9400",317,247,245,1,2,"PSOE",73
40,"40202",60,46,46,0,0,"PSOE",8
40,"40033",58,51,51,0,0,"PSOE",9
45,"45153",1615,1258,1243,7,15,"PSOE",332
26,"26135",164,125,124,1,1,"PSOE",27
6,"6140",630,506,499,3,7,"PSOE",142
50,"50211",249,176,173,0,3,"PSOE",48
50,"50191",470,310,308,1,2,"PSOE",87
10,"10077",677,479,472,1,7,"PSOE",161
5,"5130",90,85,85,0,0,"PSOE",32
19,"19240",51,44,42,0,2,"PSOE",11
5,"5120",36,26,26,0,0,"PSOE",3
28,"28024",151,125,124,1,1,"PSOE",18
50,"50152",1430,1008,994,14,14,"PSOE",300
16,"16035",261,203,198,4,5,"PSOE",75
45,"45176",3706,2554,2521,22,33,"PSOE",483
10,"10099",583,378,374,2,4,"PSOE",184
18,"18051",1147,817,810,8,7,"PSOE",444
45,"45021",2500,1708,1665,12,43,"PSOE",467
34,"34168",52,47,47,2,0,"PSOE",8
2,"2083",219,191,191,0,0,"PSOE",84
10,"10139",114,82,78,1,4,"PSOE",29
34,"34012",357,269,264,5,5,"PSOE",61
23,"23902",2320,1867,1847,4,20,"PSOE",1131
42,"42218",82,55,55,0,0,"PSOE",6
4,"4053",12320,8946,8866,70,80,"PSOE",2491
10,"10048",233,168,168,0,0,"PSOE",34
50,"50044",230,145,145,1,0,"PSOE",66
6,"6112",393,323,321,2,2,"PSOE",139
49,"49078",170,141,140,1,1,"PSOE",38
39,"39079",8874,6547,6478,47,69,"PSOE",1670
9,"9225",83,55,54,0,1,"PSOE",17
50,"50172",193,132,129,1,3,"PSOE",26
46,"46144",663,532,529,2,3,"PSOE",102
24,"24198",592,412,407,2,5,"PSOE",217
45,"45190",475,371,366,0,5,"PSOE",140
41,"41028",2003,1524,1511,9,13,"PSOE",390
24,"24226",199,139,137,0,2,"PSOE",14
37,"37081",930,728,722,3,6,"PSOE",286
24,"24070",4124,3024,2981,20,43,"PSOE",1124
22,"22167",493,388,381,9,7,"PSOE",101
19,"19176",237,181,181,0,0,"PSOE",39
29,"29083",2107,1540,1512,9,28,"PSOE",706
16,"16102",1205,912,905,12,7,"PSOE",246
26,"26175",51,41,41,0,0,"PSOE",14
10,"10097",101,75,74,0,1,"PSOE",30
40,"40902",123,99,96,1,3,"PSOE",11
24,"24042",63,56,56,1,0,"PSOE",18
50,"50184",115,85,85,0,0,"PSOE",20
21,"21024",492,338,326,6,12,"PSOE",159
10,"10143",154,112,112,0,0,"PSOE",49
26,"26155",160,132,132,0,0,"PSOE",51
9,"9175",127,94,93,2,1,"PSOE",4
40,"40007",78,63,61,0,2,"PSOE",8
40,"40125",87,58,58,1,0,"PSOE",6
49,"49216",162,142,142,0,0,"PSOE",51
41,"41008",1059,749,739,10,10,"PSOE",476
18,"18103",757,579,575,4,4,"PSOE",277
31,"31082",617,371,365,10,6,"PSOE",23
18,"18015",434,334,333,0,1,"PSOE",159
13,"13078",9041,6325,6266,47,59,"PSOE",1970
9,"9366",86,62,62,2,0,"PSOE",9
19,"19186",81,68,68,0,0,"PSOE",26
5,"5105",341,249,247,7,2,"PSOE",60
26,"26093",53,39,38,0,1,"PSOE",12
7,"7038",2010,1424,1412,18,12,"PSOE",233
28,"28034",361,274,269,1,5,"PSOE",50
47,"47187",84,61,58,0,3,"PSOE",5
49,"49269",229,165,162,1,3,"PSOE",40
16,"16058",103,77,77,0,0,"PSOE",36
2,"2062",408,297,292,0,5,"PSOE",104
5,"5252",64,45,45,1,0,"PSOE",3
9,"9057",145,108,108,0,0,"PSOE",19
31,"31907",10745,8067,8009,116,58,"PSOE",1073
42,"42044",54,42,39,0,3,"PSOE",3
28,"28007",124592,94222,93521,491,701,"PSOE",20679
29,"29018",2010,1472,1420,9,52,"PSOE",635
45,"45108",509,412,411,1,1,"PSOE",164
19,"19239",92,62,62,1,0,"PSOE",16
18,"18093",2750,1793,1776,7,17,"PSOE",669
2,"2076",329,237,236,1,1,"PSOE",101
21,"21005",15523,9038,8913,56,125,"PSOE",3818
26,"26123",126,108,107,2,1,"PSOE",24
37,"37156",4292,2996,2966,24,30,"PSOE",619
50,"50207",106,93,93,1,0,"PSOE",24
28,"28045",33328,24620,24434,146,186,"PSOE",4404
16,"16155",508,398,391,2,7,"PSOE",94
4,"4014",144,117,114,1,3,"PSOE",81
18,"18062",10393,7235,7161,63,74,"PSOE",2037
22,"22063",169,133,129,1,4,"PSOE",25
40,"40203",899,722,715,4,7,"PSOE",145
39,"39067",790,513,505,1,8,"PSOE",149
13,"13093",4103,2963,2929,21,34,"PSOE",789
3,"3902",10254,6996,6930,34,66,"PSOE",1365
50,"50246",41,28,28,0,0,"PSOE",5
49,"49145",236,162,157,0,5,"PSOE",26
37,"37339",315,251,251,4,0,"PSOE",56
28,"28133",5979,4140,4098,18,42,"PSOE",1041
19,"19113",485,366,366,3,0,"PSOE",139
26,"26072",281,254,254,0,0,"PSOE",89
40,"40145",1103,879,870,2,9,"PSOE",199
9,"9416",53,35,35,0,0,"PSOE",3
50,"50115",3235,2128,2109,14,19,"PSOE",667
45,"45129",131,92,92,0,0,"PSOE",23
45,"45130",317,253,250,1,3,"PSOE",75
37,"37023",1413,1072,1060,5,12,"PSOE",194
29,"29051",40391,25780,25419,232,361,"PSOE",5953
18,"18173",8939,5922,5849,42,73,"PSOE",2153
12,"12112",99,79,78,3,1,"PSOE",29
10,"10151",207,165,162,0,3,"PSOE",68
26,"26062",89,72,71,2,1,"PSOE",8
23,"23034",2540,1957,1934,14,23,"PSOE",1086
6,"6031",469,277,272,2,5,"PSOE",108
16,"16158",535,416,413,5,3,"PSOE",105
3,"3066",42121,29655,29419,214,236,"PSOE",7365
4,"4095",714,471,468,5,3,"PSOE",186
49,"49240",206,162,161,2,1,"PSOE",33
19,"19135",107,90,90,3,0,"PSOE",23
24,"24050",102,77,76,0,1,"PSOE",19
50,"50292",125,102,102,1,0,"PSOE",17
22,"22176",173,134,130,1,4,"PSOE",18
46,"46250",578719,442973,440154,2541,2819,"PSOE",76793
3,"3026",1224,949,936,5,13,"PSOE",199
49,"49170",102,72,71,0,1,"PSOE",20
9,"9194",2020,1472,1459,9,13,"PSOE",298
37,"37071",78,65,64,0,1,"PSOE",34
22,"22199",7000,4737,4688,104,49,"PSOE",1379
13,"13052",6422,4651,4580,46,71,"PSOE",1278
47,"47134",165,128,125,1,3,"PSOE",36
34,"34240",89,64,64,0,0,"PSOE",8
6,"6044",28875,19791,19616,145,175,"PSOE",6306
26,"26067",22,15,15,1,0,"PSOE",1
22,"22067",65,50,50,1,0,"PSOE",24
11,"11011",1716,1195,1165,12,30,"PSOE",416
37,"37250",356,229,228,0,1,"PSOE",70
12,"12105",848,644,638,2,6,"PSOE",95
28,"28166",320,254,251,2,3,"PSOE",63
19,"19006",769,547,540,2,7,"PSOE",147
40,"40163",53,44,43,0,1,"PSOE",3
50,"50033",66,49,48,0,1,"PSOE",12
28,"28136",647,528,518,2,10,"PSOE",99
44,"44164",27,23,23,0,0,"PSOE",4
22,"22094",101,74,74,1,0,"PSOE",23
50,"50162",146,109,105,4,4,"PSOE",43
6,"6127",2863,2112,2088,10,24,"PSOE",791
33,"33066",42963,28564,28282,300,282,"PSOE",6787
26,"26089",110582,82972,82186,588,786,"PSOE",18485
47,"47141",134,111,110,0,1,"PSOE",17
34,"34031",30,30,29,0,1,"PSOE",3
18,"18911",7473,5098,5035,51,63,"PSOE",1411
28,"28167",8356,6158,6106,46,52,"PSOE",1243
5,"5230",66,63,62,1,1,"PSOE",4
37,"37359",184,130,129,0,1,"PSOE",16
37,"37127",214,154,151,1,3,"PSOE",53
10,"10181",686,533,523,1,10,"PSOE",231
46,"46252",118,99,98,0,1,"PSOE",30
49,"49160",49,33,33,0,0,"PSOE",17
46,"46020",3760,2916,2866,22,50,"PSOE",628
9,"9430",22,18,17,0,1,"PSOE",4
29,"29026",1057,751,748,5,3,"PSOE",278
21,"21001",637,462,455,6,7,"PSOE",210
28,"28017",1208,907,899,7,8,"PSOE",136
31,"31114",366,245,241,8,4,"PSOE",40
44,"44131",25,20,20,0,0,"PSOE",3
18,"18028",928,765,758,2,7,"PSOE",292
50,"50224",72,57,56,2,1,"PSOE",9
37,"37078",829,674,664,8,10,"PSOE",172
26,"26016",28,25,24,1,1,"PSOE",8
10,"10025",400,327,318,1,9,"PSOE",124
3,"3901",1135,822,817,8,5,"PSOE",143
49,"49115",184,136,135,0,1,"PSOE",34
18,"18071",5579,4044,3985,37,59,"PSOE",1378
46,"46076",575,454,443,0,11,"PSOE",103
13,"13040",868,678,672,4,6,"PSOE",233
46,"46155",1029,833,822,4,11,"PSOE",204
16,"16135",134,92,92,2,0,"PSOE",23
37,"37320",95,72,72,0,0,"PSOE",17
5,"5217",56,44,43,0,1,"PSOE",9
9,"9199",92,72,71,1,1,"PSOE",9
46,"46025",2499,1953,1934,8,19,"PSOE",402
21,"21026",266,166,159,3,7,"PSOE",68
6,"6086",1221,814,799,2,15,"PSOE",340
14,"14025",2924,2466,2422,14,44,"PSOE",922
22,"22244",52,38,37,0,1,"PSOE",9
16,"16167",316,249,244,1,5,"PSOE",112
26,"26070",183,153,153,1,0,"PSOE",36
50,"50282",69,54,54,0,0,"PSOE",9
49,"49026",226,179,176,0,3,"PSOE",54
6,"6041",460,372,367,0,5,"PSOE",138
3,"3012",1085,852,841,3,11,"PSOE",229
7,"7052",4667,2908,2886,29,22,"PSOE",516
26,"26158",251,214,210,0,4,"PSOE",48
45,"45101",3756,3020,2984,12,36,"PSOE",641
49,"49129",853,592,574,9,18,"PSOE",199
11,"11002",4273,2835,2815,16,20,"PSOE",1175
16,"16250",76,59,59,0,0,"PSOE",12
19,"19013",125,108,108,1,0,"PSOE",51
49,"49002",63,51,49,0,2,"PSOE",16
47,"47056",87,67,67,0,0,"PSOE",11
24,"24010",8386,5708,5632,60,76,"PSOE",1359
19,"19147",43,33,33,0,0,"PSOE",12
47,"47198",69,50,50,0,0,"PSOE",6
26,"26179",41,32,31,0,1,"PSOE",13
40,"40115",101,86,85,1,1,"PSOE",25
45,"45106",7439,5613,5534,52,79,"PSOE",1686
34,"34081",61,53,52,0,1,"PSOE",6
37,"37110",113,86,86,1,0,"PSOE",21
49,"49199",254,193,189,3,4,"PSOE",56
5,"5265",82,66,66,1,0,"PSOE",7
50,"50005",229,189,189,1,0,"PSOE",37
49,"49237",165,119,117,2,2,"PSOE",34
2,"2051",1676,1177,1162,6,15,"PSOE",264
31,"31164",568,421,417,5,4,"PSOE",136
47,"47173",880,644,638,20,6,"PSOE",217
50,"50091",41,36,36,0,0,"PSOE",7
37,"37366",43,32,32,0,0,"PSOE",4
24,"24124",367,244,233,3,11,"PSOE",50
16,"16081",48,34,34,0,0,"PSOE",6
24,"24081",140,98,92,0,6,"PSOE",14
42,"42156",28,16,16,1,0,"PSOE",3
16,"16033",1714,1319,1305,6,14,"PSOE",433
37,"37117",1494,1067,1048,3,19,"PSOE",211
46,"46218",1060,910,885,7,25,"PSOE",157
9,"9310",13,9,8,0,1,"PSOE",2
37,"37327",185,149,146,3,3,"PSOE",30
14,"14007",15207,10558,10417,82,141,"PSOE",4267
23,"23096",2642,2164,2138,9,26,"PSOE",1220
31,"31120",388,250,249,3,1,"PSOE",30
21,"21071",203,157,153,4,4,"PSOE",73
49,"49113",167,137,135,1,2,"PSOE",14
49,"49236",75,58,58,0,0,"PSOE",11
46,"46258",2652,2084,2062,16,22,"PSOE",452
5,"5106",35,25,25,0,0,"PSOE",0
47,"47047",199,157,156,2,1,"PSOE",21
30,"30024",58746,42036,41731,206,305,"PSOE",10491
21,"21040",3170,2129,2071,20,58,"PSOE",894
50,"50072",170,125,125,0,0,"PSOE",26
21,"21018",1769,1120,1095,11,25,"PSOE",595
50,"50129",235,161,158,2,3,"PSOE",46
14,"14049",16309,11635,11515,115,120,"PSOE",4266
19,"19098",19,17,17,0,0,"PSOE",7
28,"28014",33085,23626,23466,113,160,"PSOE",4712
39,"39050",270,187,186,0,1,"PSOE",31
29,"29034",467,358,356,0,2,"PSOE",103
29,"29075",12934,8234,8147,69,87,"PSOE",2114
50,"50252",5138,3642,3611,24,31,"PSOE",940
3,"3024",3901,3067,3024,11,43,"PSOE",915
42,"42046",49,39,39,0,0,"PSOE",8
37,"37034",85,65,65,0,0,"PSOE",20
24,"24047",783,545,540,2,5,"PSOE",126
10,"10020",1604,1185,1169,9,16,"PSOE",515
46,"46098",2482,1907,1889,11,18,"PSOE",343
10,"10044",1428,1040,1025,5,15,"PSOE",523
22,"22142",97,75,74,1,1,"PSOE",8
52,"52001",53306,27373,27012,267,361,"PSOE",6783
7,"7006",5178,3366,3329,52,37,"PSOE",802
49,"49141",340,248,246,0,2,"PSOE",71
34,"34121",187,148,148,3,0,"PSOE",21
22,"22110",738,531,527,4,4,"PSOE",153
40,"40122",512,395,394,2,1,"PSOE",86
49,"49155",79,61,60,3,1,"PSOE",7
45,"45144",783,620,618,3,2,"PSOE",229
37,"37344",241,175,174,2,1,"PSOE",59
47,"47032",152,117,116,1,1,"PSOE",8
40,"40176",395,306,305,2,1,"PSOE",99
28,"28125",3002,2180,2163,11,17,"PSOE",353
49,"49168",93,74,74,0,0,"PSOE",14
46,"46187",1306,1017,1000,0,17,"PSOE",218
22,"22017",866,650,642,5,8,"PSOE",192
31,"31076",2417,1918,1906,9,12,"PSOE",162
45,"45104",428,324,323,1,1,"PSOE",140
3,"3101",4808,3627,3580,22,47,"PSOE",687
19,"19262",135,100,100,0,0,"PSOE",21
45,"45131",282,234,230,0,4,"PSOE",68
42,"42030",94,78,78,1,0,"PSOE",5
22,"22119",1291,942,935,5,7,"PSOE",261
50,"50288",3387,2415,2398,31,17,"PSOE",457
23,"23005",30465,20878,20630,177,248,"PSOE",6916
40,"40044",145,114,113,2,1,"PSOE",22
50,"50248",508,387,374,2,13,"PSOE",129
10,"10040",441,313,307,4,6,"PSOE",128
44,"44121",60,47,47,2,0,"PSOE",8
50,"50214",27,18,17,0,1,"PSOE",3
31,"31048",176,132,130,4,2,"PSOE",12
37,"37151",148,125,124,2,1,"PSOE",8
13,"13041",244,170,165,1,5,"PSOE",52
22,"22037",115,86,86,0,0,"PSOE",5
37,"37037",117,84,82,0,2,"PSOE",10
46,"46035",6822,5202,5142,43,60,"PSOE",1402
4,"4003",17357,11157,11075,64,82,"PSOE",3007
18,"18065",618,496,470,3,26,"PSOE",146
45,"45204",632,488,487,1,1,"PSOE",134
18,"18184",2168,1629,1607,13,22,"PSOE",669
5,"5185",95,82,81,0,1,"PSOE",6
30,"30040",732,617,607,2,10,"PSOE",185
49,"49082",359,304,301,6,3,"PSOE",114
33,"33018",2901,2000,1976,18,24,"PSOE",437
50,"50133",113,80,80,4,0,"PSOE",28
37,"37208",76,56,54,1,2,"PSOE",3
19,"19212",703,543,531,3,12,"PSOE",104
50,"50135",91,70,70,3,0,"PSOE",19
50,"50102",859,658,653,8,5,"PSOE",215
12,"12012",2685,2234,2202,13,32,"PSOE",634
6,"6061",1084,853,837,4,16,"PSOE",474
10,"10059",364,253,248,1,5,"PSOE",128
46,"46233",3860,2859,2817,10,42,"PSOE",600
45,"45015",606,437,433,2,4,"PSOE",122
3,"3115",255,222,220,2,2,"PSOE",42
22,"22137",1069,727,718,3,9,"PSOE",273
34,"34035",111,98,97,0,1,"PSOE",35
40,"40131",48,42,42,0,0,"PSOE",8
49,"49030",86,69,69,0,0,"PSOE",6
50,"50010",68,58,58,0,0,"PSOE",3
34,"34055",270,209,207,2,2,"PSOE",43
31,"31176",2869,2010,1963,33,47,"PSOE",536
5,"5113",71,56,56,0,0,"PSOE",7
18,"18111",2765,1949,1936,18,13,"PSOE",606
18,"18053",1630,1082,1076,8,6,"PSOE",489
33,"33023",3321,2299,2265,31,34,"PSOE",672
3,"3091",252,217,215,2,2,"PSOE",43
10,"10132",396,278,275,0,3,"PSOE",163
50,"50039",491,392,390,2,2,"PSOE",125
3,"3117",362,318,313,2,5,"PSOE",50
31,"31173",861,683,667,3,16,"PSOE",217
19,"19152",556,390,382,1,8,"PSOE",117
34,"34177",179,149,149,2,0,"PSOE",32
16,"16132",35,27,26,0,1,"PSOE",10
47,"47071",410,324,321,4,3,"PSOE",45
34,"34124",60,50,49,0,1,"PSOE",11
9,"9315",378,245,243,1,2,"PSOE",24
31,"31095",75,59,59,1,0,"PSOE",11
49,"49273",187,112,112,0,0,"PSOE",16
42,"42213",27,21,21,1,0,"PSOE",2
40,"40130",130,107,106,1,1,"PSOE",22
39,"39055",1086,824,816,6,8,"PSOE",137
6,"6121",3355,2279,2248,8,31,"PSOE",810
16,"16156",97,78,77,0,1,"PSOE",28
6,"6015",116758,77960,77205,583,755,"PSOE",18160
3,"3086",151,135,134,1,1,"PSOE",33
33,"33006",1540,1010,1003,5,7,"PSOE",355
29,"29032",6657,5031,4977,33,54,"PSOE",1839
46,"46135",9680,7682,7634,36,48,"PSOE",1244
14,"14009",2788,1852,1834,20,18,"PSOE",792
10,"10095",338,259,251,1,8,"PSOE",119
31,"31077",5352,3908,3848,41,60,"PSOE",1001
37,"37194",251,196,195,1,1,"PSOE",59
34,"34901",1104,825,814,5,11,"PSOE",164
9,"9047",54,47,46,1,1,"PSOE",5
34,"34093",85,70,70,0,0,"PSOE",1
31,"31265",82,53,53,2,0,"PSOE",4
28,"28171",4239,2848,2820,19,28,"PSOE",596
10,"10905",656,446,439,2,7,"PSOE",140
16,"16051",142,120,119,0,1,"PSOE",40
39,"39015",839,647,642,4,5,"PSOE",111
19,"19227",66,44,43,2,1,"PSOE",15
49,"49015",227,179,177,0,2,"PSOE",50
9,"9144",53,40,40,0,0,"PSOE",7
41,"41020",12887,8210,8118,82,92,"PSOE",4244
34,"34006",81,67,66,2,1,"PSOE",6
40,"40029",35,27,26,0,1,"PSOE",5
34,"34223",218,155,155,1,0,"PSOE",16
42,"42097",23,14,11,0,3,"PSOE",7
50,"50239",62,50,48,0,2,"PSOE",7
6,"6071",245,206,200,0,6,"PSOE",108
42,"42128",42,42,41,1,1,"PSOE",9
42,"42058",113,92,89,0,3,"PSOE",13
22,"22062",167,116,116,1,0,"PSOE",17
34,"34127",93,65,64,1,1,"PSOE",9
23,"23066",4347,3465,3410,15,55,"PSOE",1361
30,"30020",6303,4543,4497,25,46,"PSOE",952
22,"22178",103,82,81,0,1,"PSOE",20
47,"47038",105,77,77,0,0,"PSOE",26
16,"16187",74,55,55,1,0,"PSOE",14
49,"49124",253,174,169,1,5,"PSOE",41
46,"46059",1261,1035,1019,9,16,"PSOE",204
26,"26010",93,80,80,2,0,"PSOE",17
31,"31246",140,111,107,1,4,"PSOE",19
9,"9033",90,74,74,1,0,"PSOE",11
46,"46094",20540,15378,15234,102,144,"PSOE",2696
44,"44088",29,21,21,0,0,"PSOE",3
50,"50267",602,433,430,8,3,"PSOE",168
3,"3065",167284,123032,122305,711,727,"PSOE",27383
24,"24004",463,350,348,4,2,"PSOE",92
31,"31182",34,28,28,0,0,"PSOE",4
46,"46010",935,729,723,4,6,"PSOE",113
24,"24016",466,270,269,1,1,"PSOE",82
19,"19091",26,20,20,0,0,"PSOE",6
34,"34015",41,35,35,3,0,"PSOE",4
49,"49165",59,51,51,0,0,"PSOE",10
9,"9014",195,115,114,1,1,"PSOE",32
46,"46113",2457,1804,1782,6,22,"PSOE",288
24,"24146",265,210,207,1,3,"PSOE",56
30,"30033",10188,7403,7285,68,118,"PSOE",1632
49,"49028",115,104,103,1,1,"PSOE",6
40,"40171",32,23,23,0,0,"PSOE",4
12,"12039",833,717,710,4,7,"PSOE",220
50,"50179",249,214,213,2,1,"PSOE",83
46,"46221",352,305,304,0,1,"PSOE",76
42,"42190",89,65,64,0,1,"PSOE",26
47,"47170",33,28,27,2,1,"PSOE",8
47,"47026",46,40,40,1,0,"PSOE",3
6,"6089",596,469,461,1,8,"PSOE",209
9,"9272",282,210,206,3,4,"PSOE",51
9,"9428",108,92,91,0,1,"PSOE",21
9,"9213",307,220,218,2,2,"PSOE",37
42,"42121",64,47,47,0,0,"PSOE",16
5,"5008",227,170,168,1,2,"PSOE",41
18,"18132",3291,2524,2494,9,30,"PSOE",1286
19,"19233",80,65,63,1,2,"PSOE",10
24,"24036",288,184,184,2,0,"PSOE",65
44,"44201",495,411,406,0,5,"PSOE",149
37,"37203",158,117,117,0,0,"PSOE",26
50,"50121",277,216,214,1,2,"PSOE",78
39,"39041",1760,1370,1354,9,16,"PSOE",336
46,"46018",608,515,511,0,4,"PSOE",134
50,"50237",101,74,73,1,1,"PSOE",16
45,"45025",1205,831,827,2,4,"PSOE",262
46,"46190",48947,35638,35419,211,219,"PSOE",6987
4,"4046",858,609,599,7,10,"PSOE",239
6,"6131",1076,843,837,2,6,"PSOE",438
44,"44194",109,78,73,3,5,"PSOE",11
39,"39072",344,198,196,2,2,"PSOE",22
41,"41061",2195,1749,1703,11,46,"PSOE",259
16,"16062",24,23,23,0,0,"PSOE",6
29,"29047",1117,885,866,1,19,"PSOE",404
3,"3139",22437,15315,15170,100,145,"PSOE",3484
50,"50026",439,335,325,10,10,"PSOE",113
37,"37195",46,36,36,1,0,"PSOE",17
47,"47055",203,167,163,0,4,"PSOE",59
29,"29058",1450,911,894,4,17,"PSOE",417
49,"49247",443,283,279,2,4,"PSOE",55
28,"28148",85454,62367,61884,370,483,"PSOE",13416
16,"16072",146,104,103,2,1,"PSOE",41
44,"44212",39,37,37,1,0,"PSOE",7
6,"6025",5106,3571,3523,44,48,"PSOE",1491
16,"16279",203,128,127,1,1,"PSOE",34
34,"34139",166,107,106,1,1,"PSOE",19
37,"37228",360,297,295,2,2,"PSOE",101
24,"24029",735,539,535,3,4,"PSOE",187
41,"41013",4839,3151,3094,33,57,"PSOE",1593
9,"9405",130,98,96,0,2,"PSOE",21
37,"37073",586,448,438,2,10,"PSOE",88
39,"39038",1452,997,990,8,7,"PSOE",216
33,"33025",9174,5838,5786,57,52,"PSOE",1568
34,"34227",77,61,61,2,0,"PSOE",7
51,"51001",59125,31093,30737,316,356,"PSOE",6947
44,"44234",61,51,51,1,0,"PSOE",11
19,"19226",43,38,38,0,0,"PSOE",18
9,"9143",27,19,18,0,1,"PSOE",0
40,"40207",763,599,593,3,6,"PSOE",94
19,"19002",69,58,57,0,1,"PSOE",25
4,"4030",1119,819,812,5,7,"PSOE",354
10,"10135",1302,981,969,3,12,"PSOE",378
45,"45122",5212,4004,3961,16,43,"PSOE",852
6,"6055",2051,1453,1422,8,31,"PSOE",538
49,"49056",300,211,208,2,3,"PSOE",62
9,"9321",1626,1238,1227,8,11,"PSOE",360
3,"3001",337,269,268,0,1,"PSOE",20
10,"10195",7709,5572,5481,37,91,"PSOE",1530
50,"50175",1002,695,688,5,7,"PSOE",233
50,"50099",3083,2148,2132,13,16,"PSOE",796
46,"46210",330,277,277,2,0,"PSOE",58
3,"3011",7753,5464,5415,27,49,"PSOE",1246
42,"42164",1600,1150,1127,8,23,"PSOE",271
47,"47221",111,94,94,0,0,"PSOE",20
9,"9029",168,131,129,4,2,"PSOE",18
12,"12050",1305,1015,1000,6,15,"PSOE",321
49,"49120",74,53,52,0,1,"PSOE",17
46,"46120",1113,903,875,2,28,"PSOE",197
16,"16244",718,593,587,6,6,"PSOE",177
40,"40026",119,109,109,0,0,"PSOE",19
37,"37371",272,165,162,1,3,"PSOE",45
34,"34062",171,119,118,2,1,"PSOE",16
19,"19257",3403,2430,2402,19,28,"PSOE",493
39,"39011",1585,1169,1160,5,9,"PSOE",167
40,"40081",124,94,92,2,2,"PSOE",16
9,"9220",75,56,54,1,2,"PSOE",13
37,"37162",204,152,151,0,1,"PSOE",35
22,"22099",483,379,377,4,2,"PSOE",126
50,"50037",136,98,96,0,2,"PSOE",20
21,"21079",722,494,490,5,4,"PSOE",220
11,"11012",99886,70290,69673,693,617,"PSOE",14488
47,"47052",6576,4988,4944,40,44,"PSOE",1109
18,"18072",667,424,420,0,4,"PSOE",189
46,"46033",191,156,155,0,1,"PSOE",33
5,"5207",692,547,543,0,4,"PSOE",181
6,"6096",220,176,171,2,5,"PSOE",33
37,"37167",173,143,140,2,3,"PSOE",59
49,"49095",291,221,220,0,1,"PSOE",56
35,"35021",14924,10477,10370,45,107,"PSOE-NCa",1958
38,"38047",1777,1198,1170,4,28,"PSOE-NCa",247
38,"38046",9113,6850,6775,40,75,"PSOE-NCa",1076
35,"35025",1797,1261,1245,4,16,"PSOE-NCa",227
38,"38045",3837,2127,2111,12,16,"PSOE-NCa",567
38,"38044",2188,1348,1334,6,14,"PSOE-NCa",314
38,"38009",4127,2915,2868,20,47,"PSOE-NCa",514
38,"38008",5520,3825,3766,17,59,"PSOE-NCa",874
38,"38002",956,702,696,21,6,"PSOE-NCa",232
35,"35027",10344,7310,7216,50,94,"PSOE-NCa",1772
38,"38041",6821,4908,4861,40,47,"PSOE-NCa",783
38,"38007",1661,1114,1103,6,11,"PSOE-NCa",308
38,"38038",162027,104978,104035,575,943,"PSOE-NCa",19691
38,"38029",1517,744,734,1,10,"PSOE-NCa",177
38,"38027",5414,3618,3571,16,47,"PSOE-NCa",712
38,"38030",1933,1296,1290,2,6,"PSOE-NCa",401
35,"35017",25676,15038,14716,94,322,"PSOE-NCa",2876
38,"38034",4049,2855,2807,19,48,"PSOE-NCa",662
38,"38017",28437,16239,16075,95,164,"PSOE-NCa",3490
38,"38031",28687,21132,20858,104,274,"PSOE-NCa",5284
35,"35022",48603,29443,29042,160,401,"PSOE-NCa",7684
35,"35008",6131,4507,4459,34,48,"PSOE-NCa",1041
38,"38042",3802,2652,2625,14,27,"PSOE-NCa",895
35,"35034",7873,3975,3943,27,32,"PSOE-NCa",724
38,"38011",20570,13831,13698,75,133,"PSOE-NCa",2925
38,"38022",18450,12334,12160,62,174,"PSOE-NCa",2340
35,"35001",4584,3282,3222,26,60,"PSOE-NCa",943
38,"38023",121908,81147,80333,494,814,"PSOE-NCa",15240
38,"38016",1223,638,623,3,15,"PSOE-NCa",190
38,"38033",3702,2505,2464,8,41,"PSOE-NCa",770
38,"38043",18892,13089,12928,87,161,"PSOE-NCa",2598
38,"38036",6592,4518,4440,45,78,"PSOE-NCa",1350
35,"35005",1048,747,737,8,10,"PSOE-NCa",246
35,"35011",24002,15928,15684,95,244,"PSOE-NCa",3855
35,"35012",10382,5443,5392,17,51,"PSOE-NCa",1253
38,"38037",12864,8287,8163,64,124,"PSOE-NCa",2063
35,"35028",9776,5476,5401,43,75,"PSOE-NCa",1269
35,"35023",11686,8212,8076,55,136,"PSOE-NCa",1848
35,"35029",4152,2530,2498,32,32,"PSOE-NCa",650
38,"38013",2949,1896,1867,17,29,"PSOE-NCa",357
38,"38020",15113,9928,9830,59,98,"PSOE-NCa",2060
38,"38005",5468,3425,3392,18,33,"PSOE-NCa",1020
38,"38021",1629,1033,1022,9,11,"PSOE-NCa",261
35,"35004",39299,20523,20294,140,229,"PSOE-NCa",5689
38,"38052",1273,883,875,2,8,"PSOE-NCa",197
35,"35015",9950,5139,5070,29,69,"PSOE-NCa",1562
35,"35006",30457,21398,21118,162,280,"PSOE-NCa",5560
35,"35014",11209,6016,5917,42,99,"PSOE-NCa",1148
38,"38035",9474,5616,5564,36,52,"PSOE-NCa",1108
35,"35031",7259,5037,4942,29,95,"PSOE-NCa",899
38,"38010",4008,2733,2661,19,72,"PSOE-NCa",790
38,"38012",2347,1644,1630,7,14,"PSOE-NCa",456
38,"38040",5021,3136,3102,14,34,"PSOE-NCa",485
35,"35020",6034,3992,3934,20,58,"PSOE-NCa",1672
38,"38001",20228,11032,10936,47,96,"PSOE-NCa",3007
35,"35033",6398,4340,4266,19,74,"PSOE-NCa",1060
35,"35024",13735,8545,8439,77,106,"PSOE-NCa",1788
38,"38028",22103,15036,14844,85,192,"PSOE-NCa",4199
35,"35016",297736,192251,190256,1386,1995,"PSOE-NCa",43871
35,"35009",19905,14185,13961,89,224,"PSOE-NCa",3973
38,"38053",3735,2469,2435,17,34,"PSOE-NCa",502
35,"35013",6625,4896,4781,41,115,"PSOE-NCa",940
35,"35032",3412,2473,2425,17,48,"PSOE-NCa",500
38,"38901",1405,900,887,3,13,"PSOE-NCa",234
35,"35010",3558,2341,2301,28,40,"PSOE-NCa",510
38,"38003",1439,969,952,10,17,"PSOE-NCa",357
35,"35019",32481,19318,19067,123,251,"PSOE-NCa",4824
35,"35003",5211,2949,2908,13,41,"PSOE-NCa",621
38,"38050",2462,1624,1604,8,20,"PSOE-NCa",389
38,"38025",6880,4839,4761,30,78,"PSOE-NCa",1293
35,"35002",23328,15495,15313,94,182,"PSOE-NCa",3660
38,"38018",4402,3058,3011,16,47,"PSOE-NCa",615
38,"38032",13237,8908,8828,52,80,"PSOE-NCa",1706
38,"38015",4170,2862,2836,10,26,"PSOE-NCa",562
35,"35007",511,316,309,2,7,"PSOE-NCa",73
35,"35018",12552,7609,7547,54,62,"PSOE-NCa",1739
38,"38049",2655,1654,1627,8,27,"PSOE-NCa",378
38,"38024",15077,9512,9356,55,156,"PSOE-NCa",1639
38,"38051",7194,5158,5080,31,78,"PSOE-NCa",1027
35,"35026",81091,51953,51195,407,758,"PSOE-NCa",11487
35,"35030",9250,5413,5326,34,87,"PSOE-NCa",1264
38,"38026",32950,24443,24196,129,247,"PSOE-NCa",4581
38,"38006",39766,20776,20587,139,189,"PSOE-NCa",4943
38,"38039",10641,7547,7459,49,88,"PSOE-NCa",1091
38,"38004",4456,3026,2983,23,43,"PSOE-NCa",731
38,"38019",13200,8123,8047,36,76,"PSOE-NCa",2677
38,"38014",1357,935,926,3,9,"PSOE-NCa",152
38,"38048",3901,2667,2637,20,30,"PSOE-NCa",446
33,"33071",595,433,430,10,3,"PUEDE",0
33,"33034",10612,6602,6536,62,66,"PUEDE",4
33,"33055",1514,1109,1092,5,17,"PUEDE",0
33,"33004",66857,46390,45960,426,430,"PUEDE",24
33,"33057",1593,1063,1049,16,14,"PUEDE",0
33,"33012",5201,3466,3432,25,34,"PUEDE",1
33,"33059",4646,3075,3033,29,42,"PUEDE",1
33,"33063",415,320,318,3,2,"PUEDE",0
33,"33062",400,238,233,2,5,"PUEDE",0
33,"33075",271,154,153,2,1,"PUEDE",0
33,"33030",895,669,666,9,3,"PUEDE",0
33,"33073",8554,4945,4884,41,61,"PUEDE",6
33,"33031",35120,22295,22024,271,271,"PUEDE",8
33,"33040",4549,2986,2942,35,44,"PUEDE",1
33,"33044",178278,125469,124554,1124,915,"PUEDE",51
33,"33001",1588,887,880,8,7,"PUEDE",0
33,"33074",3484,2298,2274,24,24,"PUEDE",0
33,"33042",4306,2988,2970,35,18,"PUEDE",1
33,"33011",11260,6250,6163,83,87,"PUEDE",5
33,"33056",4997,3269,3244,22,25,"PUEDE",1
33,"33014",9037,5999,5938,53,61,"PUEDE",4
33,"33015",1540,998,986,8,12,"PUEDE",1
33,"33076",12258,8106,8031,63,75,"PUEDE",4
33,"33050",592,387,376,2,11,"PUEDE",0
33,"33016",19130,13666,13526,125,140,"PUEDE",9
33,"33077",1192,811,808,5,3,"PUEDE",1
33,"33060",14633,9647,9474,72,173,"PUEDE",9
33,"33070",3351,2403,2373,26,30,"PUEDE",0
33,"33045",4487,3057,2999,28,58,"PUEDE",3
33,"33046",499,379,367,5,12,"PUEDE",0
33,"33038",2303,1584,1559,13,25,"PUEDE",1
33,"33009",905,611,609,3,2,"PUEDE",0
33,"33027",834,506,498,4,8,"PUEDE",0
33,"33020",13307,9011,8914,99,97,"PUEDE",7
33,"33013",446,321,318,3,3,"PUEDE",0
33,"33072",1566,1008,994,11,14,"PUEDE",0
33,"33041",7199,4922,4877,52,45,"PUEDE",2
33,"33021",4573,3024,2971,22,53,"PUEDE",2
33,"33039",1655,1223,1209,12,14,"PUEDE",0
33,"33024",226679,158750,157564,1209,1186,"PUEDE",106
33,"33007",1514,946,942,12,4,"PUEDE",2
33,"33069",3491,2430,2390,17,40,"PUEDE",1
33,"33078",142,101,99,0,2,"PUEDE",1
33,"33036",11542,8062,7987,60,75,"PUEDE",2
33,"33017",3144,2094,2071,35,23,"PUEDE",1
33,"33052",721,485,482,3,3,"PUEDE",0
33,"33047",1107,852,843,9,9,"PUEDE",1
33,"33033",9873,6512,6431,68,81,"PUEDE",4
33,"33026",8530,5397,5337,48,60,"PUEDE",2
33,"33010",1822,1190,1180,17,10,"PUEDE",2
33,"33064",234,168,167,1,1,"PUEDE",0
33,"33058",1796,1232,1209,11,23,"PUEDE",4
33,"33061",378,202,200,0,2,"PUEDE",0
33,"33067",784,587,579,9,8,"PUEDE",1
33,"33054",1682,1159,1149,12,10,"PUEDE",0
33,"33006",1540,1010,1003,5,7,"PUEDE",2
33,"33051",7061,4640,4587,27,53,"PUEDE",0
33,"33022",893,578,567,11,11,"PUEDE",1
33,"33037",34454,22881,22586,243,295,"PUEDE",16
33,"33048",154,95,94,0,1,"PUEDE",0
33,"33019",3072,2020,2005,18,15,"PUEDE",0
33,"33003",646,355,352,9,3,"PUEDE",0
33,"33068",1093,645,641,4,4,"PUEDE",1
33,"33025",9174,5838,5786,57,52,"PUEDE",3
33,"33032",11395,7592,7465,90,127,"PUEDE",5
33,"33005",1449,936,924,11,12,"PUEDE",0
33,"33065",1102,722,713,7,9,"PUEDE",0
33,"33043",683,446,441,2,5,"PUEDE",0
33,"33018",2901,2000,1976,18,24,"PUEDE",1
33,"33028",1276,649,641,4,8,"PUEDE",1
33,"33066",42963,28564,28282,300,282,"PUEDE",13
33,"33023",3321,2299,2265,31,34,"PUEDE",2
33,"33002",9995,6765,6672,47,93,"PUEDE",4
33,"33029",350,181,174,2,7,"PUEDE",0
33,"33008",1777,1238,1229,3,9,"PUEDE",1
33,"33049",6322,4116,4062,43,54,"PUEDE",3
33,"33053",1141,742,732,6,10,"PUEDE",0
33,"33035",11284,7681,7618,70,63,"PUEDE",6
17,"17041",218,130,129,2,1,"PxC",0
17,"17224",314,190,188,2,2,"PxC",0
17,"17095",19555,11537,11428,89,109,"PxC",19
17,"17186",3788,2554,2526,27,28,"PxC",10
17,"17132",1298,884,877,12,7,"PxC",2
17,"17210",551,350,349,9,1,"PxC",0
17,"17094",1059,602,600,4,2,"PxC",0
17,"17093",891,563,560,6,3,"PxC",3
17,"17068",245,158,156,1,2,"PxC",1
17,"17139",1364,884,865,8,19,"PxC",3
17,"17040",537,347,345,3,2,"PxC",0
17,"17015",12546,7832,7777,66,55,"PxC",12
17,"17032",1721,967,961,10,6,"PxC",4
17,"17126",311,236,234,0,2,"PxC",1
17,"17121",224,140,140,1,0,"PxC",0
17,"17012",1145,703,698,9,5,"PxC",3
17,"17225",214,139,139,3,0,"PxC",0
17,"17198",429,270,267,2,3,"PxC",2
17,"17141",5887,3197,3165,34,32,"PxC",1
17,"17149",364,248,248,0,0,"PxC",0
17,"17175",578,321,312,5,9,"PxC",3
17,"17202",3791,2280,2263,18,17,"PxC",4
17,"17025",1134,793,787,6,6,"PxC",1
17,"17081",246,163,162,2,1,"PxC",0
17,"17161",992,726,721,10,5,"PxC",0
17,"17136",178,125,124,0,1,"PxC",0
17,"17211",830,581,580,10,1,"PxC",0
17,"17207",2375,1590,1579,11,11,"PxC",0
17,"17155",14515,8393,8330,65,63,"PxC",73
17,"17067",696,467,464,5,3,"PxC",2
17,"17078",336,223,220,6,3,"PxC",0
17,"17227",129,86,85,5,1,"PxC",0
17,"17009",4015,2584,2567,14,17,"PxC",4
17,"17189",1516,1076,1070,5,6,"PxC",3
17,"17085",301,215,214,5,1,"PxC",0
17,"17215",2087,1481,1466,7,15,"PxC",2
17,"17140",670,478,473,5,5,"PxC",1
17,"17101",559,347,338,2,9,"PxC",0
17,"17183",277,180,179,1,1,"PxC",0
17,"17214",705,423,419,2,4,"PxC",1
17,"17089",5543,3349,3326,22,23,"PxC",4
17,"17116",354,228,224,3,4,"PxC",0
17,"17169",2475,1619,1601,11,18,"PxC",2
17,"17233",2260,1528,1514,23,14,"PxC",2
17,"17157",125,95,95,1,0,"PxC",0
17,"17031",168,97,97,3,0,"PxC",0
17,"17030",641,400,398,1,2,"PxC",0
17,"17137",3437,2293,2275,19,18,"PxC",8
17,"17091",407,258,253,5,5,"PxC",0
17,"17200",613,424,422,5,2,"PxC",0
17,"17007",1731,1191,1182,7,9,"PxC",1
17,"17047",4798,2773,2757,28,16,"PxC",6
17,"17022",6910,4207,4184,58,23,"PxC",15
17,"17058",177,101,100,3,1,"PxC",0
17,"17168",380,260,258,0,2,"PxC",2
17,"17158",476,276,274,1,2,"PxC",0
17,"17901",987,623,620,9,3,"PxC",2
17,"17080",138,96,96,1,0,"PxC",0
17,"17162",150,86,86,1,0,"PxC",0
17,"17148",1515,981,972,4,9,"PxC",5
17,"17188",164,124,124,1,0,"PxC",0
17,"17167",2700,1765,1749,37,16,"PxC",1
17,"17145",1482,967,956,8,11,"PxC",1
17,"17064",322,214,211,4,3,"PxC",0
17,"17176",124,92,92,1,0,"PxC",0
17,"17177",549,332,331,1,1,"PxC",0
17,"17097",196,148,148,3,0,"PxC",0
17,"17038",366,234,232,6,2,"PxC",0
17,"17130",325,223,222,3,1,"PxC",0
17,"17044",6770,4411,4376,33,35,"PxC",10
17,"17109",696,422,419,1,3,"PxC",1
17,"17213",5424,3239,3219,24,20,"PxC",13
17,"17003",104,67,66,0,1,"PxC",0
17,"17060",424,268,266,5,2,"PxC",0
17,"17152",10737,6308,6252,45,56,"PxC",21
17,"17125",130,80,80,0,0,"PxC",0
17,"17051",218,145,142,1,3,"PxC",0
17,"17050",652,453,453,3,0,"PxC",0
17,"17061",156,104,103,1,1,"PxC",0
17,"17190",844,528,528,3,0,"PxC",1
17,"17037",104,69,69,1,0,"PxC",0
17,"17065",331,230,230,1,0,"PxC",0
17,"17133",1255,805,796,9,9,"PxC",1
17,"17028",293,205,204,6,1,"PxC",0
17,"17105",247,147,147,1,0,"PxC",0
17,"17203",153,99,99,0,0,"PxC",0
17,"17082",417,255,253,2,2,"PxC",1
17,"17124",1607,1027,1007,11,20,"PxC",1
17,"17153",188,133,133,0,0,"PxC",0
17,"17084",238,146,144,5,2,"PxC",0
17,"17114",23041,13985,13880,135,105,"PxC",42
17,"17193",4216,2555,2525,16,30,"PxC",3
17,"17180",8295,4958,4935,36,23,"PxC",17
17,"17075",330,205,205,1,0,"PxC",1
17,"17206",146,88,86,1,2,"PxC",0
17,"17077",548,369,368,1,1,"PxC",0
17,"17212",141,104,102,0,2,"PxC",0
17,"17195",329,237,234,0,3,"PxC",0
17,"17205",208,157,155,1,2,"PxC",0
17,"17197",132,102,101,1,1,"PxC",0
17,"17216",165,110,110,1,0,"PxC",0
17,"17096",179,106,105,1,1,"PxC",1
17,"17008",3639,2191,2171,16,20,"PxC",9
17,"17034",6931,4166,4150,29,16,"PxC",9
17,"17073",1873,1363,1356,15,7,"PxC",3
17,"17146",2969,1868,1855,8,13,"PxC",2
17,"17144",206,141,141,3,0,"PxC",0
17,"17001",587,404,398,2,6,"PxC",0
17,"17083",2940,1895,1876,16,19,"PxC",0
17,"17194",80,55,54,0,1,"PxC",0
17,"17165",656,439,435,3,4,"PxC",0
17,"17151",174,111,110,3,1,"PxC",0
17,"17027",2821,1896,1889,17,7,"PxC",2
17,"17088",533,368,366,4,2,"PxC",1
17,"17166",522,374,367,1,7,"PxC",0
17,"17071",1134,778,774,10,4,"PxC",2
17,"17023",27269,17209,17032,122,177,"PxC",28
17,"17134",228,162,161,0,1,"PxC",0
17,"17052",125,78,78,0,0,"PxC",0
17,"17079",64395,41049,40699,342,350,"PxC",85
17,"17066",26562,15223,15087,150,136,"PxC",43
17,"17154",92,67,66,0,1,"PxC",0
17,"17174",178,99,97,2,2,"PxC",0
17,"17103",4954,2877,2850,25,27,"PxC",10
17,"17042",419,272,272,2,0,"PxC",0
17,"17178",1059,654,650,7,4,"PxC",0
17,"17029",207,127,127,1,0,"PxC",1
17,"17092",3509,2256,2223,18,33,"PxC",9
17,"17228",288,179,176,1,3,"PxC",0
17,"17086",1729,1068,1059,8,9,"PxC",3
17,"17035",548,381,379,5,2,"PxC",0
17,"17128",308,205,203,3,2,"PxC",0
17,"17115",282,183,183,1,0,"PxC",0
17,"17036",2717,1730,1716,15,14,"PxC",4
17,"17182",263,181,181,6,0,"PxC",0
17,"17218",582,404,401,1,3,"PxC",0
17,"17223",801,516,506,9,10,"PxC",0
17,"17063",162,111,109,0,2,"PxC",0
17,"17160",14747,9189,9129,65,60,"PxC",24
17,"17013",2787,1780,1762,17,18,"PxC",3
17,"17098",301,192,188,2,4,"PxC",1
17,"17138",928,637,633,4,4,"PxC",2
17,"17217",354,265,263,2,2,"PxC",0
17,"17046",717,459,458,4,1,"PxC",0
17,"17181",3372,2135,2112,12,23,"PxC",1
17,"17171",165,117,116,2,1,"PxC",0
17,"17099",81,57,57,1,0,"PxC",0
17,"17090",545,370,368,4,2,"PxC",1
17,"17117",14353,8469,8426,49,43,"PxC",26
17,"17234",182,115,114,0,1,"PxC",0
17,"17187",631,445,441,2,4,"PxC",1
17,"17021",131,86,85,4,1,"PxC",0
17,"17164",3982,2363,2350,11,13,"PxC",6
17,"17209",630,443,438,7,5,"PxC",2
17,"17048",6241,3831,3801,36,30,"PxC",3
17,"17020",3592,2333,2315,20,18,"PxC",3
17,"17226",867,549,546,8,3,"PxC",3
17,"17163",2626,1764,1747,10,17,"PxC",3
17,"17076",124,86,84,3,2,"PxC",2
17,"17201",135,87,84,0,3,"PxC",0
17,"17129",133,101,101,1,0,"PxC",1
17,"17026",544,370,367,5,3,"PxC",1
17,"17135",362,253,253,1,0,"PxC",0
17,"17006",1127,686,682,1,4,"PxC",1
17,"17159",643,413,406,3,7,"PxC",1
17,"17069",374,256,251,0,5,"PxC",0
17,"17033",5307,3264,3241,29,23,"PxC",14
17,"17191",141,92,89,1,3,"PxC",1
17,"17119",74,54,54,0,0,"PxC",0
17,"17019",1775,1201,1188,7,13,"PxC",2
17,"17049",3117,2092,2072,14,20,"PxC",6
17,"17043",161,122,117,1,5,"PxC",0
17,"17170",171,125,123,1,2,"PxC",1
17,"17005",413,257,252,3,5,"PxC",1
17,"17010",336,224,224,3,0,"PxC",0
17,"17112",190,127,125,2,2,"PxC",1
17,"17016",731,500,496,1,4,"PxC",2
17,"17011",637,444,439,6,5,"PxC",0
17,"17204",572,355,354,4,1,"PxC",2
17,"17903",897,568,563,2,5,"PxC",1
17,"17192",144,96,93,1,3,"PxC",2
17,"17107",264,167,165,8,2,"PxC",0
17,"17002",556,401,396,0,5,"PxC",1
17,"17902",1357,886,878,13,8,"PxC",1
17,"17057",968,641,636,11,5,"PxC",0
17,"17172",454,300,297,0,3,"PxC",1
17,"17056",1715,1120,1106,16,14,"PxC",3
17,"17220",796,538,536,5,2,"PxC",1
17,"17196",220,150,150,4,0,"PxC",1
17,"17222",101,76,75,0,1,"PxC",0
17,"17039",1759,1159,1145,14,14,"PxC",2
17,"17185",2265,1420,1404,15,16,"PxC",2
17,"17143",142,103,99,1,4,"PxC",0
17,"17173",180,132,131,0,1,"PxC",0
17,"17110",1322,856,853,3,3,"PxC",4
17,"17184",1254,814,809,6,5,"PxC",0
17,"17018",480,327,322,2,5,"PxC",0
17,"17118",12711,7567,7515,42,52,"PxC",11
17,"17111",880,590,586,7,4,"PxC",0
17,"17230",468,318,317,3,1,"PxC",0
17,"17208",995,594,590,8,4,"PxC",0
17,"17100",194,133,131,3,2,"PxC",0
17,"17062",5958,3463,3441,22,22,"PxC",6
17,"17123",354,266,263,0,3,"PxC",0
17,"17074",510,337,335,2,2,"PxC",0
17,"17199",6853,4147,4122,27,25,"PxC",14
17,"17142",2550,1806,1797,30,9,"PxC",7
17,"17102",571,400,400,6,0,"PxC",1
17,"17221",4153,2577,2564,27,13,"PxC",5
17,"17070",111,76,76,2,0,"PxC",0
17,"17150",1401,962,951,6,11,"PxC",0
17,"17054",370,236,236,1,0,"PxC",0
17,"17024",268,153,152,1,1,"PxC",0
17,"17147",8053,4988,4933,52,55,"PxC",14
17,"17087",225,152,149,2,3,"PxC",0
17,"17014",64,48,48,1,0,"PxC",0
17,"17106",140,103,102,0,1,"PxC",1
17,"17055",150,110,109,0,1,"PxC",0
17,"17232",152,92,91,1,1,"PxC",1
17,"17120",786,517,512,8,5,"PxC",0
17,"17004",512,335,334,4,1,"PxC",0
46,"46240",210,164,161,1,3,"RECORTES CERO-GRUPO VERDE",0
8,"8054",8998,6172,6129,44,43,"RECORTES CERO-GRUPO VERDE",19
5,"5186",1575,1225,1194,3,31,"RECORTES CERO-GRUPO VERDE",1
21,"21054",8100,5656,5571,46,85,"RECORTES CERO-GRUPO VERDE",9
5,"5213",103,84,82,0,2,"RECORTES CERO-GRUPO VERDE",0
6,"6143",3360,2353,2321,12,32,"RECORTES CERO-GRUPO VERDE",2
8,"8307",48295,32010,31798,195,212,"RECORTES CERO-GRUPO VERDE",88
16,"16219",89,71,71,0,0,"RECORTES CERO-GRUPO VERDE",0
23,"23006",4660,3687,3647,24,40,"RECORTES CERO-GRUPO VERDE",1
9,"9064",324,271,267,1,4,"RECORTES CERO-GRUPO VERDE",0
5,"5035",100,84,84,0,0,"RECORTES CERO-GRUPO VERDE",0
7,"7054",22334,12814,12708,99,106,"RECORTES CERO-GRUPO VERDE",41
1,"1021",473,310,309,0,1,"RECORTES CERO-GRUPO VERDE",0
8,"8239",453,304,302,3,2,"RECORTES CERO-GRUPO VERDE",1
19,"19254",45,34,34,0,0,"RECORTES CERO-GRUPO VERDE",0
19,"19211",369,289,284,0,5,"RECORTES CERO-GRUPO VERDE",0
42,"42053",26,19,19,1,0,"RECORTES CERO-GRUPO VERDE",0
37,"37120",99,82,78,0,4,"RECORTES CERO-GRUPO VERDE",0
44,"44175",122,85,84,1,1,"RECORTES CERO-GRUPO VERDE",0
20,"20061",4273,2601,2590,21,11,"RECORTES CERO-GRUPO VERDE",1
47,"47144",78,64,64,1,0,"RECORTES CERO-GRUPO VERDE",0
47,"47213",109,82,82,0,0,"RECORTES CERO-GRUPO VERDE",0
8,"8901",227,148,145,1,3,"RECORTES CERO-GRUPO VERDE",0
25,"25224",126,70,70,5,0,"RECORTES CERO-GRUPO VERDE",0
22,"22114",123,81,81,0,0,"RECORTES CERO-GRUPO VERDE",0
26,"26178",75,57,55,1,2,"RECORTES CERO-GRUPO VERDE",0
27,"27004",1227,760,749,7,11,"RECORTES CERO-GRUPO VERDE",2
40,"40127",32,25,25,0,0,"RECORTES CERO-GRUPO VERDE",0
31,"31187",111,68,63,1,5,"RECORTES CERO-GRUPO VERDE",0
5,"5224",102,86,84,3,2,"RECORTES CERO-GRUPO VERDE",0
3,"3018",12240,8853,8777,47,76,"RECORTES CERO-GRUPO VERDE",9
10,"10210",543,356,355,1,1,"RECORTES CERO-GRUPO VERDE",0
5,"5195",220,169,169,2,0,"RECORTES CERO-GRUPO VERDE",0
17,"17130",325,223,222,3,1,"RECORTES CERO-GRUPO VERDE",0
16,"16227",113,93,93,0,0,"RECORTES CERO-GRUPO VERDE",0
17,"17070",111,76,76,2,0,"RECORTES CERO-GRUPO VERDE",0
16,"16236",910,656,651,4,5,"RECORTES CERO-GRUPO VERDE",1
19,"19270",20,17,17,0,0,"RECORTES CERO-GRUPO VERDE",0
37,"37132",351,256,253,2,3,"RECORTES CERO-GRUPO VERDE",1
5,"5094",139,116,116,1,0,"RECORTES CERO-GRUPO VERDE",0
3,"3122",42425,30153,29954,154,199,"RECORTES CERO-GRUPO VERDE",67
24,"24222",14256,9996,9884,101,112,"RECORTES CERO-GRUPO VERDE",11
46,"46184",26505,20428,20223,115,205,"RECORTES CERO-GRUPO VERDE",31
38,"38052",1273,883,875,2,8,"RECORTES CERO-GRUPO VERDE",2
12,"12037",17,16,14,0,2,"RECORTES CERO-GRUPO VERDE",0
46,"46083",15422,11179,11049,86,130,"RECORTES CERO-GRUPO VERDE",18
12,"12132",480,396,389,3,7,"RECORTES CERO-GRUPO VERDE",0
7,"7053",1188,926,918,16,8,"RECORTES CERO-GRUPO VERDE",2
45,"45009",524,344,341,2,3,"RECORTES CERO-GRUPO VERDE",0
32,"32026",2704,1929,1896,22,33,"RECORTES CERO-GRUPO VERDE",3
1,"1049",138,109,109,1,0,"RECORTES CERO-GRUPO VERDE",1
13,"13093",4103,2963,2929,21,34,"RECORTES CERO-GRUPO VERDE",4
49,"49190",63,47,45,0,2,"RECORTES CERO-GRUPO VERDE",0
25,"25901",293,202,202,7,0,"RECORTES CERO-GRUPO VERDE",1
7,"7021",230,177,174,2,3,"RECORTES CERO-GRUPO VERDE",1
16,"16272",221,176,175,0,1,"RECORTES CERO-GRUPO VERDE",0
25,"25180",234,143,143,1,0,"RECORTES CERO-GRUPO VERDE",0
26,"26108",266,215,213,0,2,"RECORTES CERO-GRUPO VERDE",0
17,"17169",2475,1619,1601,11,18,"RECORTES CERO-GRUPO VERDE",2
25,"25097",84,65,65,3,0,"RECORTES CERO-GRUPO VERDE",0
14,"14049",16309,11635,11515,115,120,"RECORTES CERO-GRUPO VERDE",12
31,"31057",1781,1287,1268,10,19,"RECORTES CERO-GRUPO VERDE",4
13,"13089",1706,1368,1332,8,36,"RECORTES CERO-GRUPO VERDE",0
28,"28053",6498,4995,4955,28,40,"RECORTES CERO-GRUPO VERDE",6
9,"9429",56,41,41,0,0,"RECORTES CERO-GRUPO VERDE",0
9,"9180",142,107,102,1,5,"RECORTES CERO-GRUPO VERDE",0
3,"3094",9080,6440,6396,34,44,"RECORTES CERO-GRUPO VERDE",11
22,"22175",197,143,142,1,1,"RECORTES CERO-GRUPO VERDE",0
9,"9330",1507,1108,1092,10,16,"RECORTES CERO-GRUPO VERDE",3
9,"9196",149,103,103,1,0,"RECORTES CERO-GRUPO VERDE",0
18,"18012",2278,1662,1641,13,21,"RECORTES CERO-GRUPO VERDE",2
25,"25130",195,113,112,2,1,"RECORTES CERO-GRUPO VERDE",0
28,"28015",18736,14221,14127,68,94,"RECORTES CERO-GRUPO VERDE",12
16,"16039",392,261,254,1,7,"RECORTES CERO-GRUPO VERDE",1
46,"46005",22918,16958,16827,102,131,"RECORTES CERO-GRUPO VERDE",32
19,"19202",8,6,6,0,0,"RECORTES CERO-GRUPO VERDE",0
50,"50038",1502,1121,1111,7,10,"RECORTES CERO-GRUPO VERDE",4
45,"45087",8311,5828,5747,43,81,"RECORTES CERO-GRUPO VERDE",4
5,"5219",38,30,30,0,0,"RECORTES CERO-GRUPO VERDE",0
5,"5083",140,110,105,1,5,"RECORTES CERO-GRUPO VERDE",0
9,"9409",111,86,86,4,0,"RECORTES CERO-GRUPO VERDE",0
24,"24067",623,388,384,0,4,"RECORTES CERO-GRUPO VERDE",0
40,"40087",92,71,70,1,1,"RECORTES CERO-GRUPO VERDE",0
42,"42196",10,7,7,0,0,"RECORTES CERO-GRUPO VERDE",0
8,"8209",6773,4410,4382,29,28,"RECORTES CERO-GRUPO VERDE",6
13,"13098",2092,1503,1461,8,42,"RECORTES CERO-GRUPO VERDE",3
18,"18033",282,201,200,5,1,"RECORTES CERO-GRUPO VERDE",0
1,"1019",150,106,105,1,1,"RECORTES CERO-GRUPO VERDE",1
16,"16140",27,16,16,0,0,"RECORTES CERO-GRUPO VERDE",0
25,"25158",1620,1019,1012,15,7,"RECORTES CERO-GRUPO VERDE",1
49,"49268",403,313,309,1,4,"RECORTES CERO-GRUPO VERDE",0
31,"31101",1373,973,966,8,7,"RECORTES CERO-GRUPO VERDE",6
19,"19246",46,36,34,2,2,"RECORTES CERO-GRUPO VERDE",0
28,"28003",173,141,141,0,0,"RECORTES CERO-GRUPO VERDE",0
10,"10095",338,259,251,1,8,"RECORTES CERO-GRUPO VERDE",0
1,"1002",8124,5722,5654,31,68,"RECORTES CERO-GRUPO VERDE",17
44,"44191",764,586,583,6,3,"RECORTES CERO-GRUPO VERDE",3
2,"2061",637,516,511,4,5,"RECORTES CERO-GRUPO VERDE",0
32,"32032",8059,5708,5608,58,100,"RECORTES CERO-GRUPO VERDE",18
9,"9046",29,25,25,0,0,"RECORTES CERO-GRUPO VERDE",0
12,"12050",1305,1015,1000,6,15,"RECORTES CERO-GRUPO VERDE",1
16,"16125",1667,1249,1231,3,18,"RECORTES CERO-GRUPO VERDE",0
9,"9316",105,80,80,1,0,"RECORTES CERO-GRUPO VERDE",0
19,"19335",55,47,47,0,0,"RECORTES CERO-GRUPO VERDE",0
12,"12092",111,91,90,0,1,"RECORTES CERO-GRUPO VERDE",0
46,"46172",5042,3504,3477,22,27,"RECORTES CERO-GRUPO VERDE",7
1,"1036",14955,10052,9959,55,93,"RECORTES CERO-GRUPO VERDE",17
5,"5015",82,61,61,1,0,"RECORTES CERO-GRUPO VERDE",0
19,"19212",703,543,531,3,12,"RECORTES CERO-GRUPO VERDE",0
9,"9061",162,124,123,0,1,"RECORTES CERO-GRUPO VERDE",0
46,"46020",3760,2916,2866,22,50,"RECORTES CERO-GRUPO VERDE",3
25,"25135",1028,600,593,10,7,"RECORTES CERO-GRUPO VERDE",2
10,"10105",2512,1644,1620,12,24,"RECORTES CERO-GRUPO VERDE",4
17,"17109",696,422,419,1,3,"RECORTES CERO-GRUPO VERDE",0
45,"45101",3756,3020,2984,12,36,"RECORTES CERO-GRUPO VERDE",2
12,"12071",1274,992,979,3,13,"RECORTES CERO-GRUPO VERDE",3
26,"26037",128,108,108,2,0,"RECORTES CERO-GRUPO VERDE",0
14,"14001",3514,2837,2789,28,48,"RECORTES CERO-GRUPO VERDE",1
43,"43118",419,311,308,5,3,"RECORTES CERO-GRUPO VERDE",0
8,"8238",14531,10378,10325,98,53,"RECORTES CERO-GRUPO VERDE",24
27,"27009",2097,1533,1507,12,26,"RECORTES CERO-GRUPO VERDE",5
5,"5126",70,56,55,0,1,"RECORTES CERO-GRUPO VERDE",0
15,"15009",10739,7688,7559,54,129,"RECORTES CERO-GRUPO VERDE",16
40,"40084",62,55,52,0,3,"RECORTES CERO-GRUPO VERDE",0
19,"19240",51,44,42,0,2,"RECORTES CERO-GRUPO VERDE",1
40,"40231",108,90,89,0,1,"RECORTES CERO-GRUPO VERDE",0
26,"26171",176,139,133,1,6,"RECORTES CERO-GRUPO VERDE",0
37,"37197",84,57,57,2,0,"RECORTES CERO-GRUPO VERDE",0
26,"26100",49,44,43,0,1,"RECORTES CERO-GRUPO VERDE",0
10,"10198",1143,981,964,6,17,"RECORTES CERO-GRUPO VERDE",1
10,"10093",398,317,312,4,5,"RECORTES CERO-GRUPO VERDE",0
16,"16088",108,88,87,0,1,"RECORTES CERO-GRUPO VERDE",0
8,"8035",12547,7877,7828,51,49,"RECORTES CERO-GRUPO VERDE",13
3,"3076",8467,6238,6157,30,81,"RECORTES CERO-GRUPO VERDE",8
37,"37199",142,105,105,1,0,"RECORTES CERO-GRUPO VERDE",0
8,"8296",1777,1237,1231,7,6,"RECORTES CERO-GRUPO VERDE",3
9,"9326",140,112,111,0,1,"RECORTES CERO-GRUPO VERDE",1
31,"31219",84,66,66,0,0,"RECORTES CERO-GRUPO VERDE",1
40,"40021",27,27,26,0,1,"RECORTES CERO-GRUPO VERDE",0
17,"17101",559,347,338,2,9,"RECORTES CERO-GRUPO VERDE",0
1,"1053",582,321,320,4,1,"RECORTES CERO-GRUPO VERDE",0
45,"45022",391,285,281,3,4,"RECORTES CERO-GRUPO VERDE",0
41,"41027",3922,2660,2604,23,56,"RECORTES CERO-GRUPO VERDE",1
9,"9229",198,146,143,0,3,"RECORTES CERO-GRUPO VERDE",0
1,"1008",786,513,509,11,4,"RECORTES CERO-GRUPO VERDE",0
49,"49042",244,178,176,1,2,"RECORTES CERO-GRUPO VERDE",0
27,"27021",1753,1090,1056,12,34,"RECORTES CERO-GRUPO VERDE",2
29,"29043",2509,1608,1576,18,32,"RECORTES CERO-GRUPO VERDE",1
8,"8202",12680,8341,8278,75,63,"RECORTES CERO-GRUPO VERDE",20
25,"25197",133,89,88,1,1,"RECORTES CERO-GRUPO VERDE",0
18,"18133",2168,1648,1636,6,12,"RECORTES CERO-GRUPO VERDE",2
25,"25181",172,123,120,4,3,"RECORTES CERO-GRUPO VERDE",0
37,"37135",1207,905,899,15,6,"RECORTES CERO-GRUPO VERDE",2
20,"20036",13210,8518,8475,67,43,"RECORTES CERO-GRUPO VERDE",12
28,"28004",6234,4202,4167,16,35,"RECORTES CERO-GRUPO VERDE",9
32,"32039",1262,957,941,6,16,"RECORTES CERO-GRUPO VERDE",0
40,"40006",22,18,18,0,0,"RECORTES CERO-GRUPO VERDE",0
47,"47186",246129,186191,184733,1198,1458,"RECORTES CERO-GRUPO VERDE",337
25,"25022",104,79,79,0,0,"RECORTES CERO-GRUPO VERDE",0
43,"43023",231,170,169,0,1,"RECORTES CERO-GRUPO VERDE",0
34,"34104",246,185,182,1,3,"RECORTES CERO-GRUPO VERDE",0
19,"19013",125,108,108,1,0,"RECORTES CERO-GRUPO VERDE",0
22,"22902",221,159,156,0,3,"RECORTES CERO-GRUPO VERDE",0
28,"28026",6317,4734,4701,33,33,"RECORTES CERO-GRUPO VERDE",6
6,"6028",4233,3588,3499,30,89,"RECORTES CERO-GRUPO VERDE",3
2,"2024",3409,2589,2554,29,35,"RECORTES CERO-GRUPO VERDE",0
5,"5205",74,57,55,1,2,"RECORTES CERO-GRUPO VERDE",0
9,"9074",794,575,569,6,6,"RECORTES CERO-GRUPO VERDE",1
28,"28129",8030,5986,5941,42,45,"RECORTES CERO-GRUPO VERDE",7
12,"12117",3585,2727,2677,20,50,"RECORTES CERO-GRUPO VERDE",6
50,"50098",174,130,124,0,6,"RECORTES CERO-GRUPO VERDE",1
10,"10184",756,613,604,10,9,"RECORTES CERO-GRUPO VERDE",0
3,"3010",325,277,275,1,2,"RECORTES CERO-GRUPO VERDE",0
42,"42034",30,22,22,0,0,"RECORTES CERO-GRUPO VERDE",0
5,"5077",158,140,139,1,1,"RECORTES CERO-GRUPO VERDE",0
48,"48041",693,533,529,3,4,"RECORTES CERO-GRUPO VERDE",0
9,"9239",52,40,39,0,1,"RECORTES CERO-GRUPO VERDE",0
16,"16195",497,392,390,1,2,"RECORTES CERO-GRUPO VERDE",1
9,"9078",41,30,30,1,0,"RECORTES CERO-GRUPO VERDE",0
10,"10098",378,289,287,1,2,"RECORTES CERO-GRUPO VERDE",0
43,"43012",3534,2559,2548,34,11,"RECORTES CERO-GRUPO VERDE",7
45,"45014",4010,2646,2616,22,30,"RECORTES CERO-GRUPO VERDE",10
39,"39028",3739,2850,2817,16,33,"RECORTES CERO-GRUPO VERDE",5
42,"42094",621,444,433,10,11,"RECORTES CERO-GRUPO VERDE",0
19,"19311",82,69,67,0,2,"RECORTES CERO-GRUPO VERDE",0
42,"42039",226,138,138,4,0,"RECORTES CERO-GRUPO VERDE",0
39,"39052",18236,13537,13380,110,157,"RECORTES CERO-GRUPO VERDE",20
10,"10191",527,405,397,2,8,"RECORTES CERO-GRUPO VERDE",0
43,"43071",921,613,607,6,6,"RECORTES CERO-GRUPO VERDE",0
46,"46095",610,467,459,1,8,"RECORTES CERO-GRUPO VERDE",0
34,"34109",59,48,48,0,0,"RECORTES CERO-GRUPO VERDE",0
9,"9043",192,137,133,1,4,"RECORTES CERO-GRUPO VERDE",0
28,"28007",124592,94222,93521,491,701,"RECORTES CERO-GRUPO VERDE",221
8,"8079",343,256,255,4,1,"RECORTES CERO-GRUPO VERDE",0
15,"15071",7951,5255,5178,50,77,"RECORTES CERO-GRUPO VERDE",14
25,"25102",707,420,407,6,13,"RECORTES CERO-GRUPO VERDE",2
8,"8221",12368,8798,8763,67,35,"RECORTES CERO-GRUPO VERDE",27
22,"22002",107,95,95,0,0,"RECORTES CERO-GRUPO VERDE",0
9,"9044",46,35,34,1,1,"RECORTES CERO-GRUPO VERDE",0
15,"15046",6332,4377,4262,40,115,"RECORTES CERO-GRUPO VERDE",16
17,"17129",133,101,101,1,0,"RECORTES CERO-GRUPO VERDE",0
3,"3026",1224,949,936,5,13,"RECORTES CERO-GRUPO VERDE",3
34,"34243",325,252,248,0,4,"RECORTES CERO-GRUPO VERDE",0
10,"10132",396,278,275,0,3,"RECORTES CERO-GRUPO VERDE",0
40,"40057",1456,1154,1148,7,6,"RECORTES CERO-GRUPO VERDE",1
44,"44181",76,57,56,0,1,"RECORTES CERO-GRUPO VERDE",0
17,"17062",5958,3463,3441,22,22,"RECORTES CERO-GRUPO VERDE",3
31,"31237",193,155,153,2,2,"RECORTES CERO-GRUPO VERDE",2
8,"8235",3686,2488,2470,16,18,"RECORTES CERO-GRUPO VERDE",5
19,"19259",30,25,25,1,0,"RECORTES CERO-GRUPO VERDE",0
19,"19224",93,87,87,0,0,"RECORTES CERO-GRUPO VERDE",0
36,"36052",7292,4999,4907,45,92,"RECORTES CERO-GRUPO VERDE",6
24,"24166",1407,1013,993,8,20,"RECORTES CERO-GRUPO VERDE",0
40,"40107",100,73,73,1,0,"RECORTES CERO-GRUPO VERDE",0
49,"49141",340,248,246,0,2,"RECORTES CERO-GRUPO VERDE",0
19,"19214",75,60,58,0,2,"RECORTES CERO-GRUPO VERDE",0
41,"41034",23070,14805,14625,186,180,"RECORTES CERO-GRUPO VERDE",20
15,"15081",1034,791,782,11,9,"RECORTES CERO-GRUPO VERDE",1
4,"4036",226,175,175,0,0,"RECORTES CERO-GRUPO VERDE",0
24,"24069",41,35,35,0,0,"RECORTES CERO-GRUPO VERDE",0
22,"22087",67,45,45,2,0,"RECORTES CERO-GRUPO VERDE",0
45,"45162",669,494,486,2,8,"RECORTES CERO-GRUPO VERDE",0
8,"8250",7061,4480,4448,48,32,"RECORTES CERO-GRUPO VERDE",25
31,"31156",251,189,188,0,1,"RECORTES CERO-GRUPO VERDE",0
35,"35029",4152,2530,2498,32,32,"RECORTES CERO-GRUPO VERDE",11
7,"7051",5215,3171,3134,39,37,"RECORTES CERO-GRUPO VERDE",18
4,"4060",445,348,345,5,3,"RECORTES CERO-GRUPO VERDE",0
10,"10211",444,337,336,0,1,"RECORTES CERO-GRUPO VERDE",0
16,"16192",48,31,30,1,1,"RECORTES CERO-GRUPO VERDE",0
44,"44206",114,90,87,0,3,"RECORTES CERO-GRUPO VERDE",0
16,"16234",25,18,18,0,0,"RECORTES CERO-GRUPO VERDE",0
5,"5143",66,51,49,0,2,"RECORTES CERO-GRUPO VERDE",0
19,"19017",69,57,57,0,0,"RECORTES CERO-GRUPO VERDE",0
17,"17166",522,374,367,1,7,"RECORTES CERO-GRUPO VERDE",2
19,"19262",135,100,100,0,0,"RECORTES CERO-GRUPO VERDE",0
37,"37102",404,307,305,2,2,"RECORTES CERO-GRUPO VERDE",0
15,"15075",12336,8830,8725,91,105,"RECORTES CERO-GRUPO VERDE",19
40,"40018",91,72,72,1,0,"RECORTES CERO-GRUPO VERDE",0
2,"2068",337,251,246,1,5,"RECORTES CERO-GRUPO VERDE",0
36,"36023",8395,5965,5884,41,81,"RECORTES CERO-GRUPO VERDE",7
31,"31183",691,544,542,4,2,"RECORTES CERO-GRUPO VERDE",2
24,"24218",451,330,325,2,5,"RECORTES CERO-GRUPO VERDE",0
47,"47117",301,233,227,2,6,"RECORTES CERO-GRUPO VERDE",0
44,"44252",86,65,65,0,0,"RECORTES CERO-GRUPO VERDE",0
39,"39084",838,631,624,2,7,"RECORTES CERO-GRUPO VERDE",1
6,"6149",10295,7651,7536,56,115,"RECORTES CERO-GRUPO VERDE",10
6,"6058",2026,1433,1416,9,17,"RECORTES CERO-GRUPO VERDE",1
42,"42088",67,47,47,1,0,"RECORTES CERO-GRUPO VERDE",0
13,"13034",58191,42423,42027,291,396,"RECORTES CERO-GRUPO VERDE",96
18,"18084",4257,3107,3075,26,32,"RECORTES CERO-GRUPO VERDE",2
15,"15051",4638,3182,3153,44,29,"RECORTES CERO-GRUPO VERDE",3
19,"19228",26,20,20,0,0,"RECORTES CERO-GRUPO VERDE",0
50,"50903",2214,1602,1585,8,17,"RECORTES CERO-GRUPO VERDE",5
21,"21024",492,338,326,6,12,"RECORTES CERO-GRUPO VERDE",0
40,"40110",349,265,263,3,2,"RECORTES CERO-GRUPO VERDE",0
26,"26088",37,32,31,0,1,"RECORTES CERO-GRUPO VERDE",0
39,"39001",2102,1622,1601,18,21,"RECORTES CERO-GRUPO VERDE",2
19,"19285",24,21,21,1,0,"RECORTES CERO-GRUPO VERDE",0
19,"19036",263,229,229,0,0,"RECORTES CERO-GRUPO VERDE",0
39,"39048",1716,1329,1312,12,17,"RECORTES CERO-GRUPO VERDE",0
41,"41049",9299,6896,6771,98,125,"RECORTES CERO-GRUPO VERDE",10
29,"29010",1651,1278,1237,4,41,"RECORTES CERO-GRUPO VERDE",0
46,"46022",15365,11093,10997,59,96,"RECORTES CERO-GRUPO VERDE",19
20,"20050",266,170,169,1,1,"RECORTES CERO-GRUPO VERDE",0
44,"44209",833,611,602,6,9,"RECORTES CERO-GRUPO VERDE",0
8,"8183",4550,2809,2796,20,13,"RECORTES CERO-GRUPO VERDE",2
8,"8229",535,357,354,9,3,"RECORTES CERO-GRUPO VERDE",0
9,"9302",112,83,83,1,0,"RECORTES CERO-GRUPO VERDE",0
9,"9108",384,283,279,1,4,"RECORTES CERO-GRUPO VERDE",0
19,"19194",98,69,69,1,0,"RECORTES CERO-GRUPO VERDE",1
9,"9315",378,245,243,1,2,"RECORTES CERO-GRUPO VERDE",1
44,"44257",166,123,119,1,4,"RECORTES CERO-GRUPO VERDE",0
5,"5149",106,77,77,1,0,"RECORTES CERO-GRUPO VERDE",1
3,"3039",81,62,61,1,1,"RECORTES CERO-GRUPO VERDE",0
16,"16068",137,98,97,1,1,"RECORTES CERO-GRUPO VERDE",0
8,"8092",3736,2369,2342,13,27,"RECORTES CERO-GRUPO VERDE",2
19,"19159",93,78,77,0,1,"RECORTES CERO-GRUPO VERDE",0
14,"14023",2021,1660,1639,8,21,"RECORTES CERO-GRUPO VERDE",0
49,"49143",225,163,162,0,1,"RECORTES CERO-GRUPO VERDE",0
39,"39029",618,488,481,3,7,"RECORTES CERO-GRUPO VERDE",0
41,"41080",1274,910,892,6,18,"RECORTES CERO-GRUPO VERDE",1
25,"25113",1168,811,803,8,8,"RECORTES CERO-GRUPO VERDE",1
38,"38049",2655,1654,1627,8,27,"RECORTES CERO-GRUPO VERDE",1
25,"25902",567,365,356,8,9,"RECORTES CERO-GRUPO VERDE",0
45,"45128",2502,1680,1668,6,12,"RECORTES CERO-GRUPO VERDE",0
46,"46021",23649,17291,17153,100,138,"RECORTES CERO-GRUPO VERDE",62
9,"9369",436,319,316,1,3,"RECORTES CERO-GRUPO VERDE",3
44,"44094",113,94,94,0,0,"RECORTES CERO-GRUPO VERDE",1
43,"43042",2129,1439,1437,12,2,"RECORTES CERO-GRUPO VERDE",4
39,"39050",270,187,186,0,1,"RECORTES CERO-GRUPO VERDE",0
42,"42041",34,25,25,0,0,"RECORTES CERO-GRUPO VERDE",0
20,"20905",145,100,100,1,0,"RECORTES CERO-GRUPO VERDE",0
23,"23905",1868,1277,1272,6,5,"RECORTES CERO-GRUPO VERDE",1
34,"34171",968,708,703,5,5,"RECORTES CERO-GRUPO VERDE",2
49,"49127",2367,1668,1650,16,18,"RECORTES CERO-GRUPO VERDE",3
45,"45085",1500,1011,999,4,12,"RECORTES CERO-GRUPO VERDE",1
43,"43901",8737,4703,4639,62,64,"RECORTES CERO-GRUPO VERDE",6
14,"14014",2557,2035,2007,9,28,"RECORTES CERO-GRUPO VERDE",2
8,"8273",2333,1654,1637,10,17,"RECORTES CERO-GRUPO VERDE",5
19,"19334",35,31,31,0,0,"RECORTES CERO-GRUPO VERDE",0
25,"25141",153,95,95,0,0,"RECORTES CERO-GRUPO VERDE",0
17,"17120",786,517,512,8,5,"RECORTES CERO-GRUPO VERDE",1
6,"6040",1009,648,645,1,3,"RECORTES CERO-GRUPO VERDE",0
22,"22039",863,671,667,4,4,"RECORTES CERO-GRUPO VERDE",0
19,"19331",2609,1872,1844,12,28,"RECORTES CERO-GRUPO VERDE",3
11,"11016",14929,9426,9302,123,124,"RECORTES CERO-GRUPO VERDE",13
1,"1051",3603,2259,2235,17,24,"RECORTES CERO-GRUPO VERDE",3
8,"8300",5678,3983,3964,35,19,"RECORTES CERO-GRUPO VERDE",18
44,"44201",495,411,406,0,5,"RECORTES CERO-GRUPO VERDE",0
34,"34108",542,421,417,3,4,"RECORTES CERO-GRUPO VERDE",1
17,"17082",417,255,253,2,2,"RECORTES CERO-GRUPO VERDE",0
1,"1061",154,127,127,1,0,"RECORTES CERO-GRUPO VERDE",0
50,"50111",180,143,143,0,0,"RECORTES CERO-GRUPO VERDE",0
9,"9321",1626,1238,1227,8,11,"RECORTES CERO-GRUPO VERDE",0
40,"40014",58,46,45,0,1,"RECORTES CERO-GRUPO VERDE",0
17,"17094",1059,602,600,4,2,"RECORTES CERO-GRUPO VERDE",1
10,"10008",1319,1019,1008,6,11,"RECORTES CERO-GRUPO VERDE",2
20,"20022",839,473,472,4,1,"RECORTES CERO-GRUPO VERDE",0
10,"10192",828,590,584,1,6,"RECORTES CERO-GRUPO VERDE",0
25,"25101",561,364,358,2,6,"RECORTES CERO-GRUPO VERDE",0
2,"2022",351,281,279,1,2,"RECORTES CERO-GRUPO VERDE",0
2,"2077",55,47,47,0,0,"RECORTES CERO-GRUPO VERDE",0
48,"48046",12611,8836,8794,39,42,"RECORTES CERO-GRUPO VERDE",9
48,"48053",895,666,662,6,4,"RECORTES CERO-GRUPO VERDE",0
9,"9309",301,224,220,0,4,"RECORTES CERO-GRUPO VERDE",1
19,"19284",10,10,9,0,1,"RECORTES CERO-GRUPO VERDE",0
22,"22135",189,128,127,0,1,"RECORTES CERO-GRUPO VERDE",0
10,"10087",1687,1218,1212,6,6,"RECORTES CERO-GRUPO VERDE",1
6,"6104",674,491,487,3,4,"RECORTES CERO-GRUPO VERDE",2
5,"5108",47,35,35,0,0,"RECORTES CERO-GRUPO VERDE",0
16,"16902",137,107,107,0,0,"RECORTES CERO-GRUPO VERDE",0
47,"47081",45,36,35,1,1,"RECORTES CERO-GRUPO VERDE",0
50,"50249",302,226,220,0,6,"RECORTES CERO-GRUPO VERDE",4
4,"4089",742,521,518,1,3,"RECORTES CERO-GRUPO VERDE",1
17,"17147",8053,4988,4933,52,55,"RECORTES CERO-GRUPO VERDE",12
17,"17105",247,147,147,1,0,"RECORTES CERO-GRUPO VERDE",1
44,"44250",19,12,12,0,0,"RECORTES CERO-GRUPO VERDE",0
5,"5093",408,294,292,1,2,"RECORTES CERO-GRUPO VERDE",1
42,"42046",49,39,39,0,0,"RECORTES CERO-GRUPO VERDE",0
31,"31207",273,182,177,2,5,"RECORTES CERO-GRUPO VERDE",0
48,"48074",3312,2330,2309,6,21,"RECORTES CERO-GRUPO VERDE",5
16,"16124",1858,1476,1459,12,17,"RECORTES CERO-GRUPO VERDE",1
25,"25191",334,205,204,4,1,"RECORTES CERO-GRUPO VERDE",0
18,"18124",381,277,277,2,0,"RECORTES CERO-GRUPO VERDE",0
9,"9416",53,35,35,0,0,"RECORTES CERO-GRUPO VERDE",0
19,"19222",110,82,82,0,0,"RECORTES CERO-GRUPO VERDE",0
1,"1027",416,257,254,3,3,"RECORTES CERO-GRUPO VERDE",0
25,"25163",231,135,132,2,3,"RECORTES CERO-GRUPO VERDE",0
5,"5044",266,183,183,1,0,"RECORTES CERO-GRUPO VERDE",0
29,"29018",2010,1472,1420,9,52,"RECORTES CERO-GRUPO VERDE",1
18,"18185",541,434,432,2,2,"RECORTES CERO-GRUPO VERDE",0
8,"8155",6730,4353,4320,39,33,"RECORTES CERO-GRUPO VERDE",8
34,"34131",59,52,51,0,1,"RECORTES CERO-GRUPO VERDE",0
8,"8211",33081,23576,23413,226,163,"RECORTES CERO-GRUPO VERDE",88
2,"2013",119,92,90,0,2,"RECORTES CERO-GRUPO VERDE",0
7,"7043",3389,2290,2252,26,38,"RECORTES CERO-GRUPO VERDE",7
5,"5208",40,36,36,0,0,"RECORTES CERO-GRUPO VERDE",0
39,"39036",969,743,739,2,4,"RECORTES CERO-GRUPO VERDE",0
32,"32065",657,463,454,3,9,"RECORTES CERO-GRUPO VERDE",0
20,"20081",7470,4856,4833,40,23,"RECORTES CERO-GRUPO VERDE",12
9,"9430",22,18,17,0,1,"RECORTES CERO-GRUPO VERDE",0
31,"31154",224,126,126,3,0,"RECORTES CERO-GRUPO VERDE",0
27,"27016",7172,4910,4846,51,64,"RECORTES CERO-GRUPO VERDE",13
8,"8199",663,456,453,14,3,"RECORTES CERO-GRUPO VERDE",1
43,"43146",39,29,28,0,1,"RECORTES CERO-GRUPO VERDE",0
24,"24105",1459,1042,1025,16,17,"RECORTES CERO-GRUPO VERDE",4
16,"16015",374,263,262,4,1,"RECORTES CERO-GRUPO VERDE",1
31,"31110",91,61,58,1,3,"RECORTES CERO-GRUPO VERDE",0
34,"34027",1085,751,741,6,10,"RECORTES CERO-GRUPO VERDE",1
25,"25194",423,246,244,6,2,"RECORTES CERO-GRUPO VERDE",1
16,"16112",1497,1031,1021,9,10,"RECORTES CERO-GRUPO VERDE",1
2,"2014",356,283,280,1,3,"RECORTES CERO-GRUPO VERDE",0
46,"46160",1913,1452,1436,1,16,"RECORTES CERO-GRUPO VERDE",3
6,"6018",753,535,529,3,6,"RECORTES CERO-GRUPO VERDE",1
49,"49192",130,110,109,2,1,"RECORTES CERO-GRUPO VERDE",0
41,"41001",1596,1183,1159,5,24,"RECORTES CERO-GRUPO VERDE",1
6,"6110",148,108,108,1,0,"RECORTES CERO-GRUPO VERDE",1
9,"9012",89,64,63,0,1,"RECORTES CERO-GRUPO VERDE",1
31,"31167",826,606,596,9,10,"RECORTES CERO-GRUPO VERDE",6
6,"6035",937,696,681,5,15,"RECORTES CERO-GRUPO VERDE",0
44,"44267",70,57,56,0,1,"RECORTES CERO-GRUPO VERDE",0
25,"25096",902,534,525,10,9,"RECORTES CERO-GRUPO VERDE",0
6,"6065",311,236,228,1,8,"RECORTES CERO-GRUPO VERDE",0
28,"28166",320,254,251,2,3,"RECORTES CERO-GRUPO VERDE",2
19,"19218",50,33,33,0,0,"RECORTES CERO-GRUPO VERDE",0
43,"43021",357,232,231,6,1,"RECORTES CERO-GRUPO VERDE",2
9,"9167",58,41,41,1,0,"RECORTES CERO-GRUPO VERDE",0
49,"49226",255,198,195,0,3,"RECORTES CERO-GRUPO VERDE",1
4,"4030",1119,819,812,5,7,"RECORTES CERO-GRUPO VERDE",0
24,"24184",198,118,117,0,1,"RECORTES CERO-GRUPO VERDE",0
44,"44003",19,17,17,0,0,"RECORTES CERO-GRUPO VERDE",0
10,"10216",1538,1175,1162,4,13,"RECORTES CERO-GRUPO VERDE",3
34,"34184",57,46,45,0,1,"RECORTES CERO-GRUPO VERDE",0
22,"22095",72,58,58,1,0,"RECORTES CERO-GRUPO VERDE",0
5,"5132",960,669,657,1,12,"RECORTES CERO-GRUPO VERDE",1
41,"41072",4054,2965,2933,14,32,"RECORTES CERO-GRUPO VERDE",1
28,"28022",33479,27129,27037,133,92,"RECORTES CERO-GRUPO VERDE",22
49,"49117",465,330,324,6,6,"RECORTES CERO-GRUPO VERDE",0
46,"46023",327,280,278,2,2,"RECORTES CERO-GRUPO VERDE",2
17,"17145",1482,967,956,8,11,"RECORTES CERO-GRUPO VERDE",2
5,"5166",185,139,139,1,0,"RECORTES CERO-GRUPO VERDE",0
16,"16087",208,179,177,5,2,"RECORTES CERO-GRUPO VERDE",0
44,"44199",44,41,41,2,0,"RECORTES CERO-GRUPO VERDE",0
24,"24098",1193,842,831,11,11,"RECORTES CERO-GRUPO VERDE",0
8,"8121",86351,57040,56655,446,385,"RECORTES CERO-GRUPO VERDE",162
4,"4010",576,444,443,3,1,"RECORTES CERO-GRUPO VERDE",0
31,"31044",289,230,227,1,3,"RECORTES CERO-GRUPO VERDE",0
39,"39020",23592,15594,15384,128,210,"RECORTES CERO-GRUPO VERDE",36
23,"23064",1655,1363,1353,1,10,"RECORTES CERO-GRUPO VERDE",0
45,"45024",1062,793,785,4,8,"RECORTES CERO-GRUPO VERDE",1
19,"19281",21,15,15,2,0,"RECORTES CERO-GRUPO VERDE",0
39,"39101",274,197,192,3,5,"RECORTES CERO-GRUPO VERDE",1
46,"46136",2537,1952,1930,11,22,"RECORTES CERO-GRUPO VERDE",4
24,"24187",857,603,593,7,10,"RECORTES CERO-GRUPO VERDE",1
31,"31226",591,342,340,2,2,"RECORTES CERO-GRUPO VERDE",1
48,"48016",5271,3694,3674,24,20,"RECORTES CERO-GRUPO VERDE",5
31,"31192",156,129,127,3,2,"RECORTES CERO-GRUPO VERDE",0
12,"12138",19061,13010,12847,129,163,"RECORTES CERO-GRUPO VERDE",23
31,"31048",176,132,130,4,2,"RECORTES CERO-GRUPO VERDE",1
28,"28005",134246,99236,98481,583,755,"RECORTES CERO-GRUPO VERDE",235
8,"8218",8009,5105,5075,59,30,"RECORTES CERO-GRUPO VERDE",5
31,"31060",13744,9400,9320,72,80,"RECORTES CERO-GRUPO VERDE",50
40,"40069",83,66,63,0,3,"RECORTES CERO-GRUPO VERDE",1
1,"1060",197,160,157,0,3,"RECORTES CERO-GRUPO VERDE",2
44,"44156",45,31,31,1,0,"RECORTES CERO-GRUPO VERDE",0
9,"9460",176,131,131,1,0,"RECORTES CERO-GRUPO VERDE",0
31,"31149",2305,1461,1441,8,20,"RECORTES CERO-GRUPO VERDE",2
39,"39011",1585,1169,1160,5,9,"RECORTES CERO-GRUPO VERDE",2
9,"9258",172,141,139,5,2,"RECORTES CERO-GRUPO VERDE",0
48,"48001",5838,3923,3898,28,25,"RECORTES CERO-GRUPO VERDE",12
16,"16280",192,164,161,1,3,"RECORTES CERO-GRUPO VERDE",0
45,"45126",260,176,175,3,1,"RECORTES CERO-GRUPO VERDE",3
39,"39022",980,721,713,2,8,"RECORTES CERO-GRUPO VERDE",0
26,"26047",1947,1578,1563,8,15,"RECORTES CERO-GRUPO VERDE",2
8,"8274",4665,3028,3009,26,19,"RECORTES CERO-GRUPO VERDE",13
46,"46017",32949,23913,23685,142,228,"RECORTES CERO-GRUPO VERDE",46
34,"34035",111,98,97,0,1,"RECORTES CERO-GRUPO VERDE",0
14,"14025",2924,2466,2422,14,44,"RECORTES CERO-GRUPO VERDE",2
34,"34080",5560,3723,3665,32,58,"RECORTES CERO-GRUPO VERDE",6
6,"6042",1011,698,687,2,11,"RECORTES CERO-GRUPO VERDE",0
25,"25119",2248,1449,1442,15,7,"RECORTES CERO-GRUPO VERDE",1
9,"9903",3221,2304,2281,27,23,"RECORTES CERO-GRUPO VERDE",2
39,"39013",511,402,399,4,3,"RECORTES CERO-GRUPO VERDE",0
2,"2036",95,78,78,0,0,"RECORTES CERO-GRUPO VERDE",0
2,"2037",22865,14632,14477,91,155,"RECORTES CERO-GRUPO VERDE",19
26,"26119",197,156,155,4,1,"RECORTES CERO-GRUPO VERDE",0
6,"6119",689,501,499,4,2,"RECORTES CERO-GRUPO VERDE",0
17,"17213",5424,3239,3219,24,20,"RECORTES CERO-GRUPO VERDE",6
44,"44204",24,21,21,0,0,"RECORTES CERO-GRUPO VERDE",0
43,"43114",392,271,268,2,3,"RECORTES CERO-GRUPO VERDE",0
46,"46217",878,691,676,4,15,"RECORTES CERO-GRUPO VERDE",0
39,"39074",6902,5113,5039,40,74,"RECORTES CERO-GRUPO VERDE",8
5,"5043",84,66,66,0,0,"RECORTES CERO-GRUPO VERDE",0
28,"28024",151,125,124,1,1,"RECORTES CERO-GRUPO VERDE",0
3,"3075",147,128,128,0,0,"RECORTES CERO-GRUPO VERDE",0
22,"22025",1071,676,669,18,7,"RECORTES CERO-GRUPO VERDE",0
44,"44216",26555,18997,18737,168,260,"RECORTES CERO-GRUPO VERDE",39
43,"43061",45,30,29,0,1,"RECORTES CERO-GRUPO VERDE",0
13,"13047",5760,4295,4224,23,71,"RECORTES CERO-GRUPO VERDE",7
16,"16248",859,654,636,5,18,"RECORTES CERO-GRUPO VERDE",1
10,"10134",567,401,396,2,5,"RECORTES CERO-GRUPO VERDE",0
42,"42212",69,43,43,1,0,"RECORTES CERO-GRUPO VERDE",0
9,"9176",63,47,46,2,1,"RECORTES CERO-GRUPO VERDE",0
17,"17177",549,332,331,1,1,"RECORTES CERO-GRUPO VERDE",1
46,"46149",363,271,268,2,3,"RECORTES CERO-GRUPO VERDE",1
34,"34069",2266,1666,1637,11,29,"RECORTES CERO-GRUPO VERDE",2
44,"44238",2323,1603,1590,5,13,"RECORTES CERO-GRUPO VERDE",1
34,"34246",67,53,51,0,2,"RECORTES CERO-GRUPO VERDE",0
49,"49071",765,495,490,2,5,"RECORTES CERO-GRUPO VERDE",0
9,"9476",62,43,43,0,0,"RECORTES CERO-GRUPO VERDE",0
27,"27902",7205,4829,4754,53,75,"RECORTES CERO-GRUPO VERDE",14
14,"14028",314,253,249,1,4,"RECORTES CERO-GRUPO VERDE",1
8,"8003",7084,4839,4803,39,36,"RECORTES CERO-GRUPO VERDE",11
13,"13015",5431,3993,3950,17,43,"RECORTES CERO-GRUPO VERDE",6
49,"49087",521,322,318,0,4,"RECORTES CERO-GRUPO VERDE",1
28,"28125",3002,2180,2163,11,17,"RECORTES CERO-GRUPO VERDE",4
44,"44080",292,229,223,3,6,"RECORTES CERO-GRUPO VERDE",1
29,"29029",403,298,294,2,4,"RECORTES CERO-GRUPO VERDE",0
39,"39097",697,371,368,2,3,"RECORTES CERO-GRUPO VERDE",0
19,"19216",131,98,98,0,0,"RECORTES CERO-GRUPO VERDE",0
9,"9164",157,127,126,0,1,"RECORTES CERO-GRUPO VERDE",1
29,"29030",805,620,614,4,6,"RECORTES CERO-GRUPO VERDE",0
19,"19142",265,182,180,3,2,"RECORTES CERO-GRUPO VERDE",0
37,"37146",117,96,95,1,1,"RECORTES CERO-GRUPO VERDE",0
9,"9443",179,128,124,0,4,"RECORTES CERO-GRUPO VERDE",0
19,"19034",22,16,16,0,0,"RECORTES CERO-GRUPO VERDE",0
16,"16159",220,159,159,0,0,"RECORTES CERO-GRUPO VERDE",0
50,"50042",15,15,15,1,0,"RECORTES CERO-GRUPO VERDE",0
13,"13052",6422,4651,4580,46,71,"RECORTES CERO-GRUPO VERDE",12
8,"8267",6461,4265,4245,51,20,"RECORTES CERO-GRUPO VERDE",7
49,"49225",147,91,90,0,1,"RECORTES CERO-GRUPO VERDE",0
8,"8254",1739,1159,1156,10,3,"RECORTES CERO-GRUPO VERDE",1
19,"19143",1738,1306,1297,12,9,"RECORTES CERO-GRUPO VERDE",0
9,"9360",30,23,23,0,0,"RECORTES CERO-GRUPO VERDE",0
29,"29075",12934,8234,8147,69,87,"RECORTES CERO-GRUPO VERDE",5
42,"42052",15,13,13,0,0,"RECORTES CERO-GRUPO VERDE",0
26,"26065",50,43,42,0,1,"RECORTES CERO-GRUPO VERDE",0
16,"16051",142,120,119,0,1,"RECORTES CERO-GRUPO VERDE",0
41,"41005",9068,6366,6281,58,85,"RECORTES CERO-GRUPO VERDE",6
2,"2043",1239,937,927,3,10,"RECORTES CERO-GRUPO VERDE",0
18,"18024",855,665,654,7,11,"RECORTES CERO-GRUPO VERDE",1
25,"25024",351,226,223,2,3,"RECORTES CERO-GRUPO VERDE",0
6,"6126",2170,1523,1507,1,16,"RECORTES CERO-GRUPO VERDE",1
46,"46030",800,627,614,5,13,"RECORTES CERO-GRUPO VERDE",0
25,"25125",417,250,250,5,0,"RECORTES CERO-GRUPO VERDE",0
48,"48018",869,522,522,2,0,"RECORTES CERO-GRUPO VERDE",1
8,"8243",162,113,113,7,0,"RECORTES CERO-GRUPO VERDE",0
17,"17090",545,370,368,4,2,"RECORTES CERO-GRUPO VERDE",0
2,"2003",132346,95878,95217,630,661,"RECORTES CERO-GRUPO VERDE",183
4,"4073",330,234,233,2,1,"RECORTES CERO-GRUPO VERDE",0
19,"19183",74,65,65,0,0,"RECORTES CERO-GRUPO VERDE",0
33,"33046",499,379,367,5,12,"RECORTES CERO-GRUPO VERDE",2
8,"8007",6483,4281,4250,33,31,"RECORTES CERO-GRUPO VERDE",7
49,"49251",163,127,121,1,6,"RECORTES CERO-GRUPO VERDE",0
48,"48028",717,543,537,3,6,"RECORTES CERO-GRUPO VERDE",0
18,"18147",3729,2335,2304,16,31,"RECORTES CERO-GRUPO VERDE",2
9,"9362",208,172,171,2,1,"RECORTES CERO-GRUPO VERDE",3
1,"1032",517,361,354,1,7,"RECORTES CERO-GRUPO VERDE",1
47,"47159",822,644,636,1,8,"RECORTES CERO-GRUPO VERDE",1
5,"5167",254,207,202,4,5,"RECORTES CERO-GRUPO VERDE",1
6,"6007",1475,1038,1032,1,6,"RECORTES CERO-GRUPO VERDE",0
43,"43068",520,330,326,7,4,"RECORTES CERO-GRUPO VERDE",0
16,"16010",152,115,112,0,3,"RECORTES CERO-GRUPO VERDE",0
9,"9227",119,91,89,4,2,"RECORTES CERO-GRUPO VERDE",0
17,"17052",125,78,78,0,0,"RECORTES CERO-GRUPO VERDE",1
11,"11029",5430,3039,3000,44,39,"RECORTES CERO-GRUPO VERDE",5
9,"9434",1227,922,909,6,13,"RECORTES CERO-GRUPO VERDE",2
34,"34123",1648,1287,1258,12,29,"RECORTES CERO-GRUPO VERDE",1
48,"48029",8338,5721,5683,37,38,"RECORTES CERO-GRUPO VERDE",20
50,"50076",78,66,65,0,1,"RECORTES CERO-GRUPO VERDE",0
6,"6160",3153,2176,2146,16,30,"RECORTES CERO-GRUPO VERDE",2
12,"12097",63,49,49,0,0,"RECORTES CERO-GRUPO VERDE",0
26,"26164",59,46,45,2,1,"RECORTES CERO-GRUPO VERDE",0
49,"49171",646,514,508,10,6,"RECORTES CERO-GRUPO VERDE",0
9,"9055",52,42,41,1,1,"RECORTES CERO-GRUPO VERDE",0
47,"47232",102,77,74,1,3,"RECORTES CERO-GRUPO VERDE",0
16,"16186",456,375,371,0,4,"RECORTES CERO-GRUPO VERDE",1
34,"34157",2442,1792,1768,21,24,"RECORTES CERO-GRUPO VERDE",3
31,"31260",1238,794,788,12,6,"RECORTES CERO-GRUPO VERDE",4
18,"18150",6763,4733,4678,21,55,"RECORTES CERO-GRUPO VERDE",7
22,"22127",505,374,371,3,3,"RECORTES CERO-GRUPO VERDE",3
8,"8246",1665,1086,1078,9,8,"RECORTES CERO-GRUPO VERDE",0
34,"34139",166,107,106,1,1,"RECORTES CERO-GRUPO VERDE",0
9,"9272",282,210,206,3,4,"RECORTES CERO-GRUPO VERDE",1
2,"2034",1382,1110,1093,7,17,"RECORTES CERO-GRUPO VERDE",2
5,"5154",38,33,33,0,0,"RECORTES CERO-GRUPO VERDE",0
5,"5200",44,31,30,1,1,"RECORTES CERO-GRUPO VERDE",0
40,"40097",128,93,92,0,1,"RECORTES CERO-GRUPO VERDE",2
4,"4904",1777,1230,1221,12,9,"RECORTES CERO-GRUPO VERDE",2
9,"9217",351,251,249,6,2,"RECORTES CERO-GRUPO VERDE",0
9,"9352",114,92,92,1,0,"RECORTES CERO-GRUPO VERDE",0
8,"8247",961,637,634,4,3,"RECORTES CERO-GRUPO VERDE",1
16,"16106",2727,2009,1989,12,20,"RECORTES CERO-GRUPO VERDE",0
8,"8287",1048,736,735,2,1,"RECORTES CERO-GRUPO VERDE",0
6,"6026",837,598,591,0,7,"RECORTES CERO-GRUPO VERDE",1
9,"9139",103,87,85,3,2,"RECORTES CERO-GRUPO VERDE",0
16,"16204",261,199,199,1,0,"RECORTES CERO-GRUPO VERDE",1
8,"8124",36804,24782,24632,184,150,"RECORTES CERO-GRUPO VERDE",92
17,"17095",19555,11537,11428,89,109,"RECORTES CERO-GRUPO VERDE",24
4,"4047",2281,1893,1878,11,15,"RECORTES CERO-GRUPO VERDE",2
27,"27063",1737,1226,1186,14,40,"RECORTES CERO-GRUPO VERDE",3
22,"22103",682,508,502,3,6,"RECORTES CERO-GRUPO VERDE",0
9,"9003",194,147,146,0,1,"RECORTES CERO-GRUPO VERDE",1
33,"33040",4549,2986,2942,35,44,"RECORTES CERO-GRUPO VERDE",4
24,"24024",692,496,491,4,5,"RECORTES CERO-GRUPO VERDE",1
50,"50144",34,29,29,2,0,"RECORTES CERO-GRUPO VERDE",0
45,"45184",200,129,129,0,0,"RECORTES CERO-GRUPO VERDE",0
42,"42073",75,58,58,0,0,"RECORTES CERO-GRUPO VERDE",1
32,"32076",2094,1488,1474,20,14,"RECORTES CERO-GRUPO VERDE",1
2,"2050",98,83,82,0,1,"RECORTES CERO-GRUPO VERDE",0
25,"25087",60,43,43,0,0,"RECORTES CERO-GRUPO VERDE",0
6,"6903",2021,1377,1360,12,17,"RECORTES CERO-GRUPO VERDE",1
8,"8289",4338,2912,2898,27,14,"RECORTES CERO-GRUPO VERDE",6
28,"28008",1799,1182,1174,4,8,"RECORTES CERO-GRUPO VERDE",3
4,"4079",51383,33777,33586,257,191,"RECORTES CERO-GRUPO VERDE",44
28,"28102",894,644,636,6,8,"RECORTES CERO-GRUPO VERDE",3
40,"40058",325,277,276,4,1,"RECORTES CERO-GRUPO VERDE",0
37,"37082",796,551,544,4,7,"RECORTES CERO-GRUPO VERDE",1
14,"14036",3740,2747,2696,24,51,"RECORTES CERO-GRUPO VERDE",1
48,"48034",12866,8798,8747,43,51,"RECORTES CERO-GRUPO VERDE",36
39,"39085",6836,5086,5032,44,54,"RECORTES CERO-GRUPO VERDE",6
46,"46071",464,383,377,0,6,"RECORTES CERO-GRUPO VERDE",0
7,"7001",3573,2531,2497,21,34,"RECORTES CERO-GRUPO VERDE",4
20,"20068",190,135,135,3,0,"RECORTES CERO-GRUPO VERDE",0
5,"5256",112,100,98,1,2,"RECORTES CERO-GRUPO VERDE",0
16,"16062",24,23,23,0,0,"RECORTES CERO-GRUPO VERDE",0
47,"47190",98,80,80,1,0,"RECORTES CERO-GRUPO VERDE",0
22,"22004",135,81,80,0,1,"RECORTES CERO-GRUPO VERDE",0
9,"9232",154,119,116,0,3,"RECORTES CERO-GRUPO VERDE",0
9,"9311",59,46,45,0,1,"RECORTES CERO-GRUPO VERDE",0
24,"24059",880,536,535,4,1,"RECORTES CERO-GRUPO VERDE",1
37,"37010",939,708,702,0,6,"RECORTES CERO-GRUPO VERDE",1
3,"3025",1270,950,941,2,9,"RECORTES CERO-GRUPO VERDE",0
31,"31142",1403,958,949,10,9,"RECORTES CERO-GRUPO VERDE",0
48,"48035",413,293,292,1,1,"RECORTES CERO-GRUPO VERDE",0
16,"16063",97,85,84,1,1,"RECORTES CERO-GRUPO VERDE",0
24,"24103",283,163,157,1,6,"RECORTES CERO-GRUPO VERDE",0
22,"22222",530,384,379,3,5,"RECORTES CERO-GRUPO VERDE",1
9,"9010",32,23,23,1,0,"RECORTES CERO-GRUPO VERDE",0
25,"25222",66,52,52,1,0,"RECORTES CERO-GRUPO VERDE",0
45,"45019",7377,5307,5251,37,56,"RECORTES CERO-GRUPO VERDE",11
27,"27052",915,676,667,6,9,"RECORTES CERO-GRUPO VERDE",1
33,"33013",446,321,318,3,3,"RECORTES CERO-GRUPO VERDE",0
26,"26019",355,274,271,1,3,"RECORTES CERO-GRUPO VERDE",1
16,"16174",185,145,143,0,2,"RECORTES CERO-GRUPO VERDE",0
34,"34167",113,94,94,0,0,"RECORTES CERO-GRUPO VERDE",0
8,"8294",1966,1287,1280,17,7,"RECORTES CERO-GRUPO VERDE",2
15,"15076",2611,1758,1739,17,19,"RECORTES CERO-GRUPO VERDE",3
48,"48036",24073,16076,15971,86,105,"RECORTES CERO-GRUPO VERDE",38
33,"33003",646,355,352,9,3,"RECORTES CERO-GRUPO VERDE",0
9,"9251",375,277,274,4,3,"RECORTES CERO-GRUPO VERDE",1
10,"10077",677,479,472,1,7,"RECORTES CERO-GRUPO VERDE",0
48,"48910",2909,1950,1937,10,13,"RECORTES CERO-GRUPO VERDE",1
29,"29098",1253,917,895,9,22,"RECORTES CERO-GRUPO VERDE",1
48,"48026",1140,830,823,5,7,"RECORTES CERO-GRUPO VERDE",0
2,"2002",470,394,389,3,5,"RECORTES CERO-GRUPO VERDE",0
8,"8200",61409,41278,41024,312,254,"RECORTES CERO-GRUPO VERDE",145
19,"19264",33,26,26,0,0,"RECORTES CERO-GRUPO VERDE",0
46,"46247",1006,714,710,3,4,"RECORTES CERO-GRUPO VERDE",0
20,"20038",387,261,259,0,2,"RECORTES CERO-GRUPO VERDE",0
29,"29088",2714,1829,1800,12,29,"RECORTES CERO-GRUPO VERDE",0
6,"6111",500,337,337,1,0,"RECORTES CERO-GRUPO VERDE",0
10,"10154",181,131,129,0,2,"RECORTES CERO-GRUPO VERDE",0
34,"34103",98,77,76,0,1,"RECORTES CERO-GRUPO VERDE",0
12,"12105",848,644,638,2,6,"RECORTES CERO-GRUPO VERDE",1
37,"37057",215,172,171,1,1,"RECORTES CERO-GRUPO VERDE",0
37,"37189",121,88,88,0,0,"RECORTES CERO-GRUPO VERDE",0
10,"10155",1126,773,763,5,10,"RECORTES CERO-GRUPO VERDE",1
8,"8172",20326,13875,13802,92,73,"RECORTES CERO-GRUPO VERDE",31
4,"4053",12320,8946,8866,70,80,"RECORTES CERO-GRUPO VERDE",7
2,"2057",2020,1487,1461,10,26,"RECORTES CERO-GRUPO VERDE",1
8,"8242",219,153,153,4,0,"RECORTES CERO-GRUPO VERDE",0
2,"2017",838,594,589,1,5,"RECORTES CERO-GRUPO VERDE",1
22,"22020",115,86,86,1,0,"RECORTES CERO-GRUPO VERDE",0
3,"3133",41576,25849,25639,127,210,"RECORTES CERO-GRUPO VERDE",31
18,"18116",2850,2059,2025,20,34,"RECORTES CERO-GRUPO VERDE",2
19,"19304",219,173,171,3,2,"RECORTES CERO-GRUPO VERDE",0
46,"46049",281,232,224,0,8,"RECORTES CERO-GRUPO VERDE",0
12,"12126",24464,18533,18331,113,202,"RECORTES CERO-GRUPO VERDE",19
9,"9332",140,106,106,2,0,"RECORTES CERO-GRUPO VERDE",1
14,"14050",2391,1822,1787,14,35,"RECORTES CERO-GRUPO VERDE",1
12,"12040",117608,85588,84946,496,642,"RECORTES CERO-GRUPO VERDE",219
9,"9256",354,258,258,2,0,"RECORTES CERO-GRUPO VERDE",2
19,"19209",40,29,29,1,0,"RECORTES CERO-GRUPO VERDE",0
6,"6038",805,543,541,2,2,"RECORTES CERO-GRUPO VERDE",0
22,"22083",463,394,390,5,4,"RECORTES CERO-GRUPO VERDE",0
6,"6159",2329,1351,1318,16,33,"RECORTES CERO-GRUPO VERDE",2
18,"18148",817,637,634,5,3,"RECORTES CERO-GRUPO VERDE",0
28,"28014",33085,23626,23466,113,160,"RECORTES CERO-GRUPO VERDE",50
38,"38017",28437,16239,16075,95,164,"RECORTES CERO-GRUPO VERDE",33
44,"44232",378,284,276,6,8,"RECORTES CERO-GRUPO VERDE",0
8,"8299",391,244,244,5,0,"RECORTES CERO-GRUPO VERDE",0
36,"36004",10161,6939,6844,63,95,"RECORTES CERO-GRUPO VERDE",12
9,"9334",50,39,37,0,2,"RECORTES CERO-GRUPO VERDE",1
3,"3135",211,170,166,2,4,"RECORTES CERO-GRUPO VERDE",0
46,"46076",575,454,443,0,11,"RECORTES CERO-GRUPO VERDE",0
8,"8245",78562,50821,50538,384,283,"RECORTES CERO-GRUPO VERDE",178
47,"47215",53,45,45,0,0,"RECORTES CERO-GRUPO VERDE",0
50,"50077",221,168,167,1,1,"RECORTES CERO-GRUPO VERDE",0
44,"44234",61,51,51,1,0,"RECORTES CERO-GRUPO VERDE",0
18,"18165",4123,2787,2758,18,29,"RECORTES CERO-GRUPO VERDE",6
10,"10021",5147,3744,3648,31,96,"RECORTES CERO-GRUPO VERDE",10
26,"26069",236,194,189,0,5,"RECORTES CERO-GRUPO VERDE",0
37,"37031",361,269,266,2,3,"RECORTES CERO-GRUPO VERDE",0
16,"16104",51,41,41,0,0,"RECORTES CERO-GRUPO VERDE",0
8,"8260",18335,12325,12263,106,62,"RECORTES CERO-GRUPO VERDE",51
45,"45003",562,408,402,1,6,"RECORTES CERO-GRUPO VERDE",0
6,"6086",1221,814,799,2,15,"RECORTES CERO-GRUPO VERDE",1
21,"21026",266,166,159,3,7,"RECORTES CERO-GRUPO VERDE",0
18,"18151",260,171,170,3,1,"RECORTES CERO-GRUPO VERDE",0
50,"50237",101,74,73,1,1,"RECORTES CERO-GRUPO VERDE",0
49,"49109",619,483,483,11,0,"RECORTES CERO-GRUPO VERDE",0
37,"37154",140,113,110,3,3,"RECORTES CERO-GRUPO VERDE",0
28,"28044",5826,4445,4409,24,36,"RECORTES CERO-GRUPO VERDE",17
19,"19081",29,22,22,1,0,"RECORTES CERO-GRUPO VERDE",0
48,"48032",5743,4065,4048,29,17,"RECORTES CERO-GRUPO VERDE",5
20,"20044",367,236,236,0,0,"RECORTES CERO-GRUPO VERDE",1
8,"8179",579,396,396,5,0,"RECORTES CERO-GRUPO VERDE",1
31,"31150",213,156,155,1,1,"RECORTES CERO-GRUPO VERDE",0
19,"19234",43,33,33,0,0,"RECORTES CERO-GRUPO VERDE",0
43,"43140",2367,1550,1532,4,18,"RECORTES CERO-GRUPO VERDE",5
25,"25204",1231,731,724,5,7,"RECORTES CERO-GRUPO VERDE",0
17,"17030",641,400,398,1,2,"RECORTES CERO-GRUPO VERDE",0
40,"40002",36,32,32,0,0,"RECORTES CERO-GRUPO VERDE",0
41,"41022",4290,2889,2851,21,38,"RECORTES CERO-GRUPO VERDE",2
31,"31262",228,179,178,5,1,"RECORTES CERO-GRUPO VERDE",0
9,"9274",1079,848,835,12,13,"RECORTES CERO-GRUPO VERDE",2
37,"37099",73,41,41,0,0,"RECORTES CERO-GRUPO VERDE",0
42,"42008",57,43,43,0,0,"RECORTES CERO-GRUPO VERDE",0
28,"28113",34751,25832,25612,120,220,"RECORTES CERO-GRUPO VERDE",45
3,"3105",5373,3911,3828,15,83,"RECORTES CERO-GRUPO VERDE",3
10,"10163",350,293,290,2,3,"RECORTES CERO-GRUPO VERDE",0
2,"2064",372,325,324,1,1,"RECORTES CERO-GRUPO VERDE",0
34,"34177",179,149,149,2,0,"RECORTES CERO-GRUPO VERDE",0
20,"20045",46626,30525,30353,197,172,"RECORTES CERO-GRUPO VERDE",99
34,"34037",302,218,216,1,2,"RECORTES CERO-GRUPO VERDE",1
8,"8181",7887,5178,5144,48,34,"RECORTES CERO-GRUPO VERDE",12
19,"19237",47,38,38,0,0,"RECORTES CERO-GRUPO VERDE",0
42,"42106",14,10,10,0,0,"RECORTES CERO-GRUPO VERDE",0
39,"39003",297,220,215,0,5,"RECORTES CERO-GRUPO VERDE",0
25,"25059",805,527,523,7,4,"RECORTES CERO-GRUPO VERDE",0
15,"15010",1887,1168,1150,13,18,"RECORTES CERO-GRUPO VERDE",0
19,"19310",9,7,7,0,0,"RECORTES CERO-GRUPO VERDE",0
34,"34178",117,103,103,0,0,"RECORTES CERO-GRUPO VERDE",0
46,"46210",330,277,277,2,0,"RECORTES CERO-GRUPO VERDE",0
37,"37008",4266,3216,3197,19,19,"RECORTES CERO-GRUPO VERDE",4
19,"19226",43,38,38,0,0,"RECORTES CERO-GRUPO VERDE",0
19,"19261",37,25,24,0,1,"RECORTES CERO-GRUPO VERDE",0
16,"16172",325,268,267,1,1,"RECORTES CERO-GRUPO VERDE",0
16,"16032",278,224,221,1,3,"RECORTES CERO-GRUPO VERDE",0
31,"31208",2556,1949,1920,16,29,"RECORTES CERO-GRUPO VERDE",3
10,"10028",90,73,73,0,0,"RECORTES CERO-GRUPO VERDE",0
5,"5175",159,131,131,1,0,"RECORTES CERO-GRUPO VERDE",0
25,"25234",4279,2546,2508,23,38,"RECORTES CERO-GRUPO VERDE",4
21,"21071",203,157,153,4,4,"RECORTES CERO-GRUPO VERDE",1
25,"25192",743,449,436,2,13,"RECORTES CERO-GRUPO VERDE",0
45,"45175",664,545,543,5,2,"RECORTES CERO-GRUPO VERDE",0
20,"20047",469,307,304,5,3,"RECORTES CERO-GRUPO VERDE",0
12,"12901",3405,2626,2598,23,28,"RECORTES CERO-GRUPO VERDE",3
17,"17230",468,318,317,3,1,"RECORTES CERO-GRUPO VERDE",0
37,"37024",89,67,67,0,0,"RECORTES CERO-GRUPO VERDE",0
8,"8061",1497,986,983,14,3,"RECORTES CERO-GRUPO VERDE",3
14,"14066",5856,4150,4095,48,55,"RECORTES CERO-GRUPO VERDE",1
16,"16251",1849,1381,1366,7,15,"RECORTES CERO-GRUPO VERDE",3
14,"14057",6136,4713,4631,47,82,"RECORTES CERO-GRUPO VERDE",1
50,"50262",1170,896,887,15,9,"RECORTES CERO-GRUPO VERDE",0
26,"26052",154,121,117,0,4,"RECORTES CERO-GRUPO VERDE",0
35,"35008",6131,4507,4459,34,48,"RECORTES CERO-GRUPO VERDE",15
40,"40161",36,28,28,2,0,"RECORTES CERO-GRUPO VERDE",0
2,"2028",126,98,98,0,0,"RECORTES CERO-GRUPO VERDE",0
42,"42110",59,45,45,2,0,"RECORTES CERO-GRUPO VERDE",0
2,"2055",1127,679,668,6,11,"RECORTES CERO-GRUPO VERDE",2
15,"15001",4765,3280,3237,25,43,"RECORTES CERO-GRUPO VERDE",11
26,"26123",126,108,107,2,1,"RECORTES CERO-GRUPO VERDE",0
48,"48047",159,111,111,0,0,"RECORTES CERO-GRUPO VERDE",0
41,"41092",7743,5358,5311,55,47,"RECORTES CERO-GRUPO VERDE",9
19,"19317",139,110,109,1,1,"RECORTES CERO-GRUPO VERDE",0
34,"34120",64214,47193,46683,331,510,"RECORTES CERO-GRUPO VERDE",108
31,"31223",985,704,698,4,6,"RECORTES CERO-GRUPO VERDE",1
2,"2016",569,413,410,6,3,"RECORTES CERO-GRUPO VERDE",0
23,"23088",6089,4558,4472,34,86,"RECORTES CERO-GRUPO VERDE",4
4,"4083",1776,1345,1336,6,9,"RECORTES CERO-GRUPO VERDE",1
12,"12135",35719,26016,25793,196,223,"RECORTES CERO-GRUPO VERDE",60
2,"2070",403,332,328,4,4,"RECORTES CERO-GRUPO VERDE",2
37,"37056",37,30,29,0,1,"RECORTES CERO-GRUPO VERDE",0
9,"9211",1441,1056,1039,9,17,"RECORTES CERO-GRUPO VERDE",1
3,"3048",4847,3719,3683,20,36,"RECORTES CERO-GRUPO VERDE",4
44,"44176",158,115,114,0,1,"RECORTES CERO-GRUPO VERDE",0
42,"42113",534,409,399,1,10,"RECORTES CERO-GRUPO VERDE",0
19,"19208",43,30,30,0,0,"RECORTES CERO-GRUPO VERDE",0
3,"3903",2494,1880,1865,7,15,"RECORTES CERO-GRUPO VERDE",0
1,"1017",849,571,565,5,6,"RECORTES CERO-GRUPO VERDE",1
16,"16038",38,31,31,0,0,"RECORTES CERO-GRUPO VERDE",0
19,"19242",87,65,65,1,0,"RECORTES CERO-GRUPO VERDE",1
17,"17078",336,223,220,6,3,"RECORTES CERO-GRUPO VERDE",0
31,"31157",3518,2298,2267,23,31,"RECORTES CERO-GRUPO VERDE",1
25,"25112",273,192,188,4,4,"RECORTES CERO-GRUPO VERDE",1
47,"47194",298,239,237,2,2,"RECORTES CERO-GRUPO VERDE",1
12,"12016",1582,1307,1297,6,10,"RECORTES CERO-GRUPO VERDE",0
40,"40108",112,82,82,0,0,"RECORTES CERO-GRUPO VERDE",0
8,"8175",3347,2080,2064,20,16,"RECORTES CERO-GRUPO VERDE",3
2,"2058",337,234,231,0,3,"RECORTES CERO-GRUPO VERDE",0
16,"16132",35,27,26,0,1,"RECORTES CERO-GRUPO VERDE",0
8,"8271",70,48,48,0,0,"RECORTES CERO-GRUPO VERDE",0
31,"31236",1320,865,854,5,11,"RECORTES CERO-GRUPO VERDE",1
4,"4044",1547,1166,1156,5,10,"RECORTES CERO-GRUPO VERDE",0
46,"46127",2692,2120,2091,18,29,"RECORTES CERO-GRUPO VERDE",4
40,"40109",73,59,59,1,0,"RECORTES CERO-GRUPO VERDE",0
43,"43110",259,175,175,6,0,"RECORTES CERO-GRUPO VERDE",0
46,"46006",4523,3665,3623,20,42,"RECORTES CERO-GRUPO VERDE",1
9,"9350",469,350,343,2,7,"RECORTES CERO-GRUPO VERDE",0
18,"18042",403,324,322,2,2,"RECORTES CERO-GRUPO VERDE",1
31,"31158",255,180,179,3,1,"RECORTES CERO-GRUPO VERDE",0
16,"16041",358,275,271,0,4,"RECORTES CERO-GRUPO VERDE",1
4,"4032",5586,3642,3623,23,19,"RECORTES CERO-GRUPO VERDE",2
27,"27006",2564,1659,1637,17,22,"RECORTES CERO-GRUPO VERDE",3
25,"25227",652,402,400,4,2,"RECORTES CERO-GRUPO VERDE",0
16,"16243",407,338,334,3,4,"RECORTES CERO-GRUPO VERDE",0
2,"2074",5935,4193,4139,32,54,"RECORTES CERO-GRUPO VERDE",5
18,"18088",1541,1124,1117,5,7,"RECORTES CERO-GRUPO VERDE",0
42,"42164",1600,1150,1127,8,23,"RECORTES CERO-GRUPO VERDE",4
9,"9902",458,331,327,3,4,"RECORTES CERO-GRUPO VERDE",3
9,"9216",387,270,265,1,5,"RECORTES CERO-GRUPO VERDE",0
1,"1034",161,124,123,1,1,"RECORTES CERO-GRUPO VERDE",0
28,"28169",1448,1122,1113,5,9,"RECORTES CERO-GRUPO VERDE",1
18,"18181",223,174,172,0,2,"RECORTES CERO-GRUPO VERDE",0
29,"29081",261,197,197,1,0,"RECORTES CERO-GRUPO VERDE",0
50,"50006",925,674,657,6,17,"RECORTES CERO-GRUPO VERDE",1
2,"2075",1670,1321,1304,4,17,"RECORTES CERO-GRUPO VERDE",0
16,"16166",243,176,174,1,2,"RECORTES CERO-GRUPO VERDE",0
8,"8178",435,309,308,4,1,"RECORTES CERO-GRUPO VERDE",0
16,"16043",95,73,73,1,0,"RECORTES CERO-GRUPO VERDE",0
6,"6056",479,407,399,1,8,"RECORTES CERO-GRUPO VERDE",3
15,"15020",3784,2476,2447,17,29,"RECORTES CERO-GRUPO VERDE",1
37,"37208",76,56,54,1,2,"RECORTES CERO-GRUPO VERDE",0
13,"13096",7652,5480,5415,19,65,"RECORTES CERO-GRUPO VERDE",7
10,"10100",799,578,574,4,4,"RECORTES CERO-GRUPO VERDE",0
28,"28091",5440,3596,3558,24,38,"RECORTES CERO-GRUPO VERDE",3
48,"48022",2336,1444,1433,6,11,"RECORTES CERO-GRUPO VERDE",2
24,"24189",5865,3933,3885,31,48,"RECORTES CERO-GRUPO VERDE",10
2,"2076",329,237,236,1,1,"RECORTES CERO-GRUPO VERDE",0
8,"8302",9218,5946,5891,82,55,"RECORTES CERO-GRUPO VERDE",16
4,"4034",160,99,99,2,0,"RECORTES CERO-GRUPO VERDE",0
40,"40198",24,19,19,0,0,"RECORTES CERO-GRUPO VERDE",0
41,"41066",1342,945,927,2,18,"RECORTES CERO-GRUPO VERDE",1
46,"46096",274,209,209,1,0,"RECORTES CERO-GRUPO VERDE",2
49,"49244",43,29,29,0,0,"RECORTES CERO-GRUPO VERDE",0
12,"12120",177,152,152,0,0,"RECORTES CERO-GRUPO VERDE",0
14,"14007",15207,10558,10417,82,141,"RECORTES CERO-GRUPO VERDE",17
16,"16189",264,206,205,4,1,"RECORTES CERO-GRUPO VERDE",0
10,"10178",769,565,553,3,12,"RECORTES CERO-GRUPO VERDE",2
41,"41099",3976,2369,2347,12,22,"RECORTES CERO-GRUPO VERDE",1
19,"19325",121,83,82,0,1,"RECORTES CERO-GRUPO VERDE",0
28,"28027",1203,872,857,3,15,"RECORTES CERO-GRUPO VERDE",2
41,"41045",5756,3988,3924,53,64,"RECORTES CERO-GRUPO VERDE",9
42,"42121",64,47,47,0,0,"RECORTES CERO-GRUPO VERDE",0
25,"25161",360,219,218,2,1,"RECORTES CERO-GRUPO VERDE",1
21,"21002",15478,10597,10507,94,90,"RECORTES CERO-GRUPO VERDE",16
10,"10088",204,131,128,1,3,"RECORTES CERO-GRUPO VERDE",0
14,"14064",320,242,236,2,6,"RECORTES CERO-GRUPO VERDE",0
12,"12022",344,265,262,2,3,"RECORTES CERO-GRUPO VERDE",0
5,"5189",449,351,349,2,2,"RECORTES CERO-GRUPO VERDE",1
10,"10179",294,231,229,2,2,"RECORTES CERO-GRUPO VERDE",0
9,"9905",384,279,279,2,0,"RECORTES CERO-GRUPO VERDE",0
43,"43157",353,268,264,5,4,"RECORTES CERO-GRUPO VERDE",0
8,"8182",2811,1799,1789,22,10,"RECORTES CERO-GRUPO VERDE",3
16,"16904",472,378,373,4,5,"RECORTES CERO-GRUPO VERDE",0
18,"18079",3441,2442,2411,16,31,"RECORTES CERO-GRUPO VERDE",7
48,"48055",2668,1872,1849,11,23,"RECORTES CERO-GRUPO VERDE",5
47,"47012",113,93,93,0,0,"RECORTES CERO-GRUPO VERDE",0
15,"15086",2869,1970,1950,13,20,"RECORTES CERO-GRUPO VERDE",7
10,"10043",800,562,553,3,9,"RECORTES CERO-GRUPO VERDE",0
42,"42078",1020,717,703,7,14,"RECORTES CERO-GRUPO VERDE",0
25,"25207",6212,3710,3680,47,30,"RECORTES CERO-GRUPO VERDE",7
3,"3055",5164,3695,3647,21,48,"RECORTES CERO-GRUPO VERDE",4
31,"31231",117,76,73,1,3,"RECORTES CERO-GRUPO VERDE",1
27,"27015",4270,2832,2769,33,63,"RECORTES CERO-GRUPO VERDE",8
21,"21004",1631,1045,1028,13,17,"RECORTES CERO-GRUPO VERDE",5
46,"46167",364,266,264,0,2,"RECORTES CERO-GRUPO VERDE",0
39,"39076",3476,2594,2559,19,35,"RECORTES CERO-GRUPO VERDE",3
25,"25252",548,343,342,9,1,"RECORTES CERO-GRUPO VERDE",1
15,"15024",4393,3141,3073,32,68,"RECORTES CERO-GRUPO VERDE",4
18,"18174",446,330,324,2,6,"RECORTES CERO-GRUPO VERDE",0
17,"17034",6931,4166,4150,29,16,"RECORTES CERO-GRUPO VERDE",11
47,"47013",100,82,81,1,1,"RECORTES CERO-GRUPO VERDE",0
4,"4028",221,191,190,1,1,"RECORTES CERO-GRUPO VERDE",0
10,"10030",465,309,309,1,0,"RECORTES CERO-GRUPO VERDE",0
6,"6048",849,691,677,7,14,"RECORTES CERO-GRUPO VERDE",0
2,"2041",336,265,260,0,5,"RECORTES CERO-GRUPO VERDE",0
39,"39016",23868,17883,17701,122,182,"RECORTES CERO-GRUPO VERDE",27
9,"9050",68,56,55,1,1,"RECORTES CERO-GRUPO VERDE",0
37,"37161",136,106,106,1,0,"RECORTES CERO-GRUPO VERDE",0
27,"27054",1190,881,860,9,21,"RECORTES CERO-GRUPO VERDE",2
25,"25223",922,553,543,8,10,"RECORTES CERO-GRUPO VERDE",1
46,"46220",48410,34644,34292,279,352,"RECORTES CERO-GRUPO VERDE",86
16,"16194",242,185,179,1,6,"RECORTES CERO-GRUPO VERDE",0
43,"43160",1276,837,826,8,11,"RECORTES CERO-GRUPO VERDE",1
49,"49115",184,136,135,0,1,"RECORTES CERO-GRUPO VERDE",0
16,"16253",337,264,263,2,1,"RECORTES CERO-GRUPO VERDE",0
17,"17011",637,444,439,6,5,"RECORTES CERO-GRUPO VERDE",0
9,"9134",221,161,156,7,5,"RECORTES CERO-GRUPO VERDE",0
14,"14011",578,464,462,4,2,"RECORTES CERO-GRUPO VERDE",0
19,"19330",71,63,63,2,0,"RECORTES CERO-GRUPO VERDE",0
1,"1030",156,129,129,3,0,"RECORTES CERO-GRUPO VERDE",1
44,"44185",99,76,75,0,1,"RECORTES CERO-GRUPO VERDE",0
12,"12027",17283,12015,11888,89,127,"RECORTES CERO-GRUPO VERDE",32
6,"6156",1175,869,865,8,4,"RECORTES CERO-GRUPO VERDE",0
22,"22045",82,65,64,1,1,"RECORTES CERO-GRUPO VERDE",0
46,"46091",118,94,94,0,0,"RECORTES CERO-GRUPO VERDE",0
9,"9408",41,36,36,0,0,"RECORTES CERO-GRUPO VERDE",0
22,"22251",364,284,284,0,0,"RECORTES CERO-GRUPO VERDE",0
26,"26162",121,99,99,1,0,"RECORTES CERO-GRUPO VERDE",0
9,"9268",95,68,66,0,2,"RECORTES CERO-GRUPO VERDE",1
34,"34059",426,347,342,6,5,"RECORTES CERO-GRUPO VERDE",1
20,"20062",973,653,653,11,0,"RECORTES CERO-GRUPO VERDE",2
19,"19332",92,71,69,1,2,"RECORTES CERO-GRUPO VERDE",0
2,"2085",322,253,252,2,1,"RECORTES CERO-GRUPO VERDE",1
28,"28060",1510,1134,1117,1,17,"RECORTES CERO-GRUPO VERDE",1
17,"17051",218,145,142,1,3,"RECORTES CERO-GRUPO VERDE",0
23,"23063",3829,2560,2522,21,38,"RECORTES CERO-GRUPO VERDE",1
6,"6158",13314,9654,9507,67,147,"RECORTES CERO-GRUPO VERDE",28
16,"16197",59,42,42,0,0,"RECORTES CERO-GRUPO VERDE",0
37,"37059",124,94,93,1,1,"RECORTES CERO-GRUPO VERDE",0
19,"19195",40,32,32,1,0,"RECORTES CERO-GRUPO VERDE",0
23,"23051",2758,2171,2144,9,27,"RECORTES CERO-GRUPO VERDE",2
28,"28088",261,178,178,0,0,"RECORTES CERO-GRUPO VERDE",1
45,"45080",6,6,6,0,0,"RECORTES CERO-GRUPO VERDE",0
10,"10172",709,466,465,0,1,"RECORTES CERO-GRUPO VERDE",1
16,"16133",4389,3358,3316,24,42,"RECORTES CERO-GRUPO VERDE",2
2,"2086",2586,1701,1687,7,14,"RECORTES CERO-GRUPO VERDE",3
7,"7035",1524,1078,1055,8,23,"RECORTES CERO-GRUPO VERDE",4
27,"27023",2579,1891,1865,23,26,"RECORTES CERO-GRUPO VERDE",2
25,"25128",136,75,75,0,0,"RECORTES CERO-GRUPO VERDE",0
49,"49050",507,342,338,1,4,"RECORTES CERO-GRUPO VERDE",1
25,"25002",482,316,314,2,2,"RECORTES CERO-GRUPO VERDE",0
34,"34156",50,45,45,0,0,"RECORTES CERO-GRUPO VERDE",0
23,"23065",1597,1170,1149,2,21,"RECORTES CERO-GRUPO VERDE",0
28,"28061",21389,16277,16135,67,142,"RECORTES CERO-GRUPO VERDE",26
9,"9094",53,42,42,1,0,"RECORTES CERO-GRUPO VERDE",0
2,"2006",579,464,458,3,6,"RECORTES CERO-GRUPO VERDE",0
4,"4045",1757,1309,1288,6,21,"RECORTES CERO-GRUPO VERDE",0
3,"3092",6743,5254,5178,37,76,"RECORTES CERO-GRUPO VERDE",14
12,"12128",1393,1090,1072,10,18,"RECORTES CERO-GRUPO VERDE",0
28,"28062",292,231,226,1,5,"RECORTES CERO-GRUPO VERDE",0
44,"44179",337,229,226,1,3,"RECORTES CERO-GRUPO VERDE",0
37,"37079",77,73,73,1,0,"RECORTES CERO-GRUPO VERDE",0
39,"39082",1653,1173,1157,11,16,"RECORTES CERO-GRUPO VERDE",1
18,"18057",5305,3827,3791,27,36,"RECORTES CERO-GRUPO VERDE",14
24,"24032",109,91,89,0,2,"RECORTES CERO-GRUPO VERDE",0
42,"42004",2285,1757,1737,15,20,"RECORTES CERO-GRUPO VERDE",2
4,"4046",858,609,599,7,10,"RECORTES CERO-GRUPO VERDE",1
8,"8193",944,601,596,12,5,"RECORTES CERO-GRUPO VERDE",0
2,"2048",1226,981,975,7,6,"RECORTES CERO-GRUPO VERDE",2
43,"43044",3963,2671,2640,33,31,"RECORTES CERO-GRUPO VERDE",6
17,"17016",731,500,496,1,4,"RECORTES CERO-GRUPO VERDE",0
14,"14015",2125,1579,1554,10,25,"RECORTES CERO-GRUPO VERDE",0
17,"17056",1715,1120,1106,16,14,"RECORTES CERO-GRUPO VERDE",1
49,"49186",261,188,185,0,3,"RECORTES CERO-GRUPO VERDE",0
8,"8207",1865,1407,1402,19,5,"RECORTES CERO-GRUPO VERDE",5
49,"49054",894,617,601,13,16,"RECORTES CERO-GRUPO VERDE",2
31,"31239",322,211,211,5,0,"RECORTES CERO-GRUPO VERDE",0
9,"9413",436,306,302,2,4,"RECORTES CERO-GRUPO VERDE",0
40,"40128",129,95,93,0,2,"RECORTES CERO-GRUPO VERDE",0
2,"2049",823,573,564,1,9,"RECORTES CERO-GRUPO VERDE",1
39,"39012",6687,5021,4957,51,64,"RECORTES CERO-GRUPO VERDE",11
7,"7026",31074,18280,18135,168,145,"RECORTES CERO-GRUPO VERDE",55
34,"34004",5608,4120,4063,43,57,"RECORTES CERO-GRUPO VERDE",9
48,"48063",372,279,277,2,2,"RECORTES CERO-GRUPO VERDE",2
32,"32046",1160,787,779,4,8,"RECORTES CERO-GRUPO VERDE",1
2,"2010",1789,1437,1421,11,16,"RECORTES CERO-GRUPO VERDE",0
9,"9058",390,283,279,1,4,"RECORTES CERO-GRUPO VERDE",1
33,"33030",895,669,666,9,3,"RECORTES CERO-GRUPO VERDE",0
18,"18904",775,565,558,1,7,"RECORTES CERO-GRUPO VERDE",1
7,"7040",280477,173945,172463,1359,1482,"RECORTES CERO-GRUPO VERDE",696
9,"9414",189,148,146,0,2,"RECORTES CERO-GRUPO VERDE",0
49,"49174",125,95,92,1,3,"RECORTES CERO-GRUPO VERDE",0
27,"27030",3327,2207,2159,31,48,"RECORTES CERO-GRUPO VERDE",5
17,"17019",1775,1201,1188,7,13,"RECORTES CERO-GRUPO VERDE",0
9,"9231",69,38,38,1,0,"RECORTES CERO-GRUPO VERDE",0
46,"46044",4218,3222,3158,18,64,"RECORTES CERO-GRUPO VERDE",3
5,"5109",450,352,339,4,13,"RECORTES CERO-GRUPO VERDE",0
9,"9275",192,129,129,2,0,"RECORTES CERO-GRUPO VERDE",0
25,"25907",494,266,265,6,1,"RECORTES CERO-GRUPO VERDE",2
28,"28065",126539,96997,96210,505,787,"RECORTES CERO-GRUPO VERDE",213
1,"1039",209,155,153,0,2,"RECORTES CERO-GRUPO VERDE",0
19,"19113",485,366,366,3,0,"RECORTES CERO-GRUPO VERDE",0
39,"39024",1879,1390,1372,2,18,"RECORTES CERO-GRUPO VERDE",1
16,"16206",204,158,157,6,1,"RECORTES CERO-GRUPO VERDE",0
37,"37083",182,156,155,0,1,"RECORTES CERO-GRUPO VERDE",0
5,"5060",116,95,95,0,0,"RECORTES CERO-GRUPO VERDE",0
37,"37228",360,297,295,2,2,"RECORTES CERO-GRUPO VERDE",0
40,"40130",130,107,106,1,1,"RECORTES CERO-GRUPO VERDE",0
29,"29040",1977,1290,1278,12,12,"RECORTES CERO-GRUPO VERDE",2
39,"39086",358,256,253,0,3,"RECORTES CERO-GRUPO VERDE",1
49,"49018",329,261,256,2,5,"RECORTES CERO-GRUPO VERDE",0
10,"10150",346,285,279,3,6,"RECORTES CERO-GRUPO VERDE",2
16,"16209",116,101,101,2,0,"RECORTES CERO-GRUPO VERDE",0
49,"49223",752,608,600,4,8,"RECORTES CERO-GRUPO VERDE",0
1,"1041",149,103,100,1,3,"RECORTES CERO-GRUPO VERDE",0
9,"9277",120,101,99,0,2,"RECORTES CERO-GRUPO VERDE",0
47,"47047",199,157,156,2,1,"RECORTES CERO-GRUPO VERDE",0
31,"31209",155,107,106,0,1,"RECORTES CERO-GRUPO VERDE",1
43,"43091",132,86,86,0,0,"RECORTES CERO-GRUPO VERDE",0
13,"13068",1061,747,740,4,7,"RECORTES CERO-GRUPO VERDE",0
25,"25123",193,134,131,2,3,"RECORTES CERO-GRUPO VERDE",0
8,"8226",891,648,645,6,3,"RECORTES CERO-GRUPO VERDE",0
9,"9265",37,28,28,0,0,"RECORTES CERO-GRUPO VERDE",0
10,"10045",1019,762,755,3,7,"RECORTES CERO-GRUPO VERDE",1
19,"19329",59,50,50,1,0,"RECORTES CERO-GRUPO VERDE",0
12,"12003",976,746,736,6,10,"RECORTES CERO-GRUPO VERDE",0
4,"4017",1296,857,854,5,3,"RECORTES CERO-GRUPO VERDE",0
29,"29041",3175,2090,2045,24,45,"RECORTES CERO-GRUPO VERDE",3
32,"32006",1531,1114,1090,10,24,"RECORTES CERO-GRUPO VERDE",1
19,"19115",24,18,18,0,0,"RECORTES CERO-GRUPO VERDE",0
46,"46238",13282,9786,9721,61,65,"RECORTES CERO-GRUPO VERDE",6
40,"40020",157,118,117,1,1,"RECORTES CERO-GRUPO VERDE",0
17,"17063",162,111,109,0,2,"RECORTES CERO-GRUPO VERDE",0
18,"18067",702,469,466,0,3,"RECORTES CERO-GRUPO VERDE",0
25,"25209",1495,995,978,9,17,"RECORTES CERO-GRUPO VERDE",1
16,"16160",60,44,42,1,2,"RECORTES CERO-GRUPO VERDE",0
12,"12073",152,119,117,0,2,"RECORTES CERO-GRUPO VERDE",0
2,"2056",1718,1296,1274,6,22,"RECORTES CERO-GRUPO VERDE",1
18,"18161",212,175,174,3,1,"RECORTES CERO-GRUPO VERDE",1
10,"10016",330,237,235,0,2,"RECORTES CERO-GRUPO VERDE",1
50,"50243",331,250,246,0,4,"RECORTES CERO-GRUPO VERDE",0
3,"3007",166,139,137,0,2,"RECORTES CERO-GRUPO VERDE",0
9,"9024",156,112,110,1,2,"RECORTES CERO-GRUPO VERDE",0
50,"50212",40,36,36,0,0,"RECORTES CERO-GRUPO VERDE",0
9,"9419",78,55,55,0,0,"RECORTES CERO-GRUPO VERDE",0
19,"19117",1579,1135,1123,8,12,"RECORTES CERO-GRUPO VERDE",2
43,"43053",191,144,143,3,1,"RECORTES CERO-GRUPO VERDE",1
5,"5165",368,290,281,3,9,"RECORTES CERO-GRUPO VERDE",1
19,"19303",43,35,35,0,0,"RECORTES CERO-GRUPO VERDE",0
44,"44268",25,25,24,0,1,"RECORTES CERO-GRUPO VERDE",0
42,"42095",1773,1269,1251,15,18,"RECORTES CERO-GRUPO VERDE",2
20,"20073",4677,3014,2995,15,19,"RECORTES CERO-GRUPO VERDE",4
31,"31212",147,102,102,4,0,"RECORTES CERO-GRUPO VERDE",0
22,"22137",1069,727,718,3,9,"RECORTES CERO-GRUPO VERDE",1
1,"1046",601,432,428,3,4,"RECORTES CERO-GRUPO VERDE",0
27,"27040",3200,2351,2310,21,41,"RECORTES CERO-GRUPO VERDE",1
6,"6037",1748,1148,1134,9,14,"RECORTES CERO-GRUPO VERDE",0
28,"28069",50,44,41,0,3,"RECORTES CERO-GRUPO VERDE",0
19,"19118",11,9,9,0,0,"RECORTES CERO-GRUPO VERDE",0
9,"9283",44,32,31,0,1,"RECORTES CERO-GRUPO VERDE",0
49,"49035",226,200,196,3,4,"RECORTES CERO-GRUPO VERDE",0
18,"18178",719,549,544,4,5,"RECORTES CERO-GRUPO VERDE",0
49,"49210",471,370,365,1,5,"RECORTES CERO-GRUPO VERDE",1
14,"14041",3182,2296,2251,33,45,"RECORTES CERO-GRUPO VERDE",2
49,"49130",180,143,141,5,2,"RECORTES CERO-GRUPO VERDE",0
5,"5053",82,57,57,0,0,"RECORTES CERO-GRUPO VERDE",0
28,"28138",60,46,46,0,0,"RECORTES CERO-GRUPO VERDE",0
18,"18164",1836,1146,1126,6,20,"RECORTES CERO-GRUPO VERDE",0
37,"37109",183,129,127,0,2,"RECORTES CERO-GRUPO VERDE",0
3,"3134",143,112,111,0,1,"RECORTES CERO-GRUPO VERDE",0
9,"9065",143,122,122,1,0,"RECORTES CERO-GRUPO VERDE",0
15,"15080",1756,1131,1117,11,14,"RECORTES CERO-GRUPO VERDE",2
44,"44060",41,32,32,0,0,"RECORTES CERO-GRUPO VERDE",0
29,"29012",9755,6689,6599,71,90,"RECORTES CERO-GRUPO VERDE",7
44,"44200",39,26,26,0,0,"RECORTES CERO-GRUPO VERDE",0
50,"50214",27,18,17,0,1,"RECORTES CERO-GRUPO VERDE",0
22,"22909",315,226,225,4,1,"RECORTES CERO-GRUPO VERDE",0
49,"49184",172,115,112,0,3,"RECORTES CERO-GRUPO VERDE",1
1,"1006",175,140,140,0,0,"RECORTES CERO-GRUPO VERDE",1
48,"48071",6087,4294,4254,32,40,"RECORTES CERO-GRUPO VERDE",6
18,"18913",813,566,559,2,7,"RECORTES CERO-GRUPO VERDE",0
5,"5121",249,185,185,4,0,"RECORTES CERO-GRUPO VERDE",1
9,"9095",84,61,61,0,0,"RECORTES CERO-GRUPO VERDE",0
25,"25100",211,125,124,1,1,"RECORTES CERO-GRUPO VERDE",0
24,"24109",977,633,624,3,9,"RECORTES CERO-GRUPO VERDE",0
3,"3103",272,235,234,1,1,"RECORTES CERO-GRUPO VERDE",0
39,"39031",1236,878,868,4,10,"RECORTES CERO-GRUPO VERDE",0
28,"28141",5823,4297,4262,29,35,"RECORTES CERO-GRUPO VERDE",13
47,"47207",278,215,212,3,3,"RECORTES CERO-GRUPO VERDE",0
3,"3011",7753,5464,5415,27,49,"RECORTES CERO-GRUPO VERDE",7
23,"23001",963,801,799,1,2,"RECORTES CERO-GRUPO VERDE",0
3,"3072",348,289,285,0,4,"RECORTES CERO-GRUPO VERDE",0
8,"8220",2356,1690,1683,18,7,"RECORTES CERO-GRUPO VERDE",2
44,"44203",10,10,10,0,0,"RECORTES CERO-GRUPO VERDE",0
24,"24133",356,257,257,1,0,"RECORTES CERO-GRUPO VERDE",1
48,"48042",1369,1068,1053,7,15,"RECORTES CERO-GRUPO VERDE",2
41,"41032",3984,2811,2725,27,86,"RECORTES CERO-GRUPO VERDE",7
5,"5023",168,146,145,1,1,"RECORTES CERO-GRUPO VERDE",0
34,"34228",83,74,74,1,0,"RECORTES CERO-GRUPO VERDE",0
29,"29048",1405,1121,1110,8,11,"RECORTES CERO-GRUPO VERDE",0
25,"25143",84,56,55,0,1,"RECORTES CERO-GRUPO VERDE",0
3,"3012",1085,852,841,3,11,"RECORTES CERO-GRUPO VERDE",0
27,"27029",1463,1023,1002,11,21,"RECORTES CERO-GRUPO VERDE",0
18,"18032",246,175,174,2,1,"RECORTES CERO-GRUPO VERDE",0
18,"18074",262,201,200,2,1,"RECORTES CERO-GRUPO VERDE",0
16,"16074",37,30,30,1,0,"RECORTES CERO-GRUPO VERDE",0
19,"19082",85,64,64,0,0,"RECORTES CERO-GRUPO VERDE",0
46,"46104",1940,1504,1487,7,17,"RECORTES CERO-GRUPO VERDE",0
39,"39033",568,418,415,2,3,"RECORTES CERO-GRUPO VERDE",0
5,"5075",107,72,72,0,0,"RECORTES CERO-GRUPO VERDE",0
5,"5076",478,386,378,4,8,"RECORTES CERO-GRUPO VERDE",2
25,"25019",4572,2726,2698,34,28,"RECORTES CERO-GRUPO VERDE",6
4,"4024",3074,2347,2327,20,20,"RECORTES CERO-GRUPO VERDE",4
50,"50187",69,44,44,0,0,"RECORTES CERO-GRUPO VERDE",0
37,"37067",3163,2496,2467,31,29,"RECORTES CERO-GRUPO VERDE",2
26,"26072",281,254,254,0,0,"RECORTES CERO-GRUPO VERDE",1
16,"16903",1070,777,765,4,12,"RECORTES CERO-GRUPO VERDE",0
24,"24180",1134,812,800,9,12,"RECORTES CERO-GRUPO VERDE",2
34,"34082",83,74,73,0,1,"RECORTES CERO-GRUPO VERDE",0
7,"7055",7442,4604,4553,42,51,"RECORTES CERO-GRUPO VERDE",17
46,"46105",16190,11323,11206,44,117,"RECORTES CERO-GRUPO VERDE",9
3,"3014",237287,167428,166445,847,983,"RECORTES CERO-GRUPO VERDE",252
8,"8264",4325,2929,2908,26,21,"RECORTES CERO-GRUPO VERDE",8
45,"45129",131,92,92,0,0,"RECORTES CERO-GRUPO VERDE",0
9,"9248",78,59,59,1,0,"RECORTES CERO-GRUPO VERDE",0
32,"32018",1247,975,962,9,13,"RECORTES CERO-GRUPO VERDE",1
49,"49189",202,142,142,1,0,"RECORTES CERO-GRUPO VERDE",0
24,"24114",3061,2025,1994,9,31,"RECORTES CERO-GRUPO VERDE",1
31,"31186",299,195,194,3,1,"RECORTES CERO-GRUPO VERDE",1
15,"15049",1098,758,752,7,6,"RECORTES CERO-GRUPO VERDE",1
42,"42022",221,173,171,5,2,"RECORTES CERO-GRUPO VERDE",0
9,"9117",76,60,60,0,0,"RECORTES CERO-GRUPO VERDE",0
33,"33042",4306,2988,2970,35,18,"RECORTES CERO-GRUPO VERDE",6
46,"46002",1175,941,932,5,9,"RECORTES CERO-GRUPO VERDE",0
2,"2026",836,690,679,3,11,"RECORTES CERO-GRUPO VERDE",0
26,"26146",94,73,72,0,1,"RECORTES CERO-GRUPO VERDE",0
43,"43022",1497,897,889,14,8,"RECORTES CERO-GRUPO VERDE",0
1,"1013",712,454,450,0,4,"RECORTES CERO-GRUPO VERDE",0
44,"44207",156,118,115,4,3,"RECORTES CERO-GRUPO VERDE",0
45,"45041",3752,2633,2597,12,36,"RECORTES CERO-GRUPO VERDE",7
24,"24094",1385,983,968,11,15,"RECORTES CERO-GRUPO VERDE",2
16,"16173",205,157,156,0,1,"RECORTES CERO-GRUPO VERDE",0
42,"42023",63,51,51,0,0,"RECORTES CERO-GRUPO VERDE",0
14,"14029",4178,3047,3009,28,38,"RECORTES CERO-GRUPO VERDE",2
7,"7017",851,582,571,7,11,"RECORTES CERO-GRUPO VERDE",4
9,"9389",73,60,60,1,0,"RECORTES CERO-GRUPO VERDE",1
46,"46003",950,791,769,1,22,"RECORTES CERO-GRUPO VERDE",0
5,"5226",76,55,54,3,1,"RECORTES CERO-GRUPO VERDE",0
50,"50031",154,93,93,0,0,"RECORTES CERO-GRUPO VERDE",0
42,"42012",35,28,28,0,0,"RECORTES CERO-GRUPO VERDE",0
23,"23048",870,619,613,1,6,"RECORTES CERO-GRUPO VERDE",1
9,"9301",625,473,467,2,6,"RECORTES CERO-GRUPO VERDE",1
48,"48077",3364,2437,2431,18,6,"RECORTES CERO-GRUPO VERDE",3
7,"7019",187,133,129,2,4,"RECORTES CERO-GRUPO VERDE",1
18,"18176",250,191,189,2,2,"RECORTES CERO-GRUPO VERDE",1
2,"2029",3282,2467,2445,17,22,"RECORTES CERO-GRUPO VERDE",1
25,"25111",117,72,70,2,2,"RECORTES CERO-GRUPO VERDE",0
5,"5179",214,178,176,1,2,"RECORTES CERO-GRUPO VERDE",0
14,"14002",10951,7706,7620,83,86,"RECORTES CERO-GRUPO VERDE",7
49,"49077",183,103,103,0,0,"RECORTES CERO-GRUPO VERDE",0
2,"2030",3065,2287,2263,6,24,"RECORTES CERO-GRUPO VERDE",4
22,"22032",110,76,74,0,2,"RECORTES CERO-GRUPO VERDE",1
15,"15052",4314,2889,2838,21,51,"RECORTES CERO-GRUPO VERDE",3
42,"42026",24,20,20,0,0,"RECORTES CERO-GRUPO VERDE",0
37,"37246",5304,3993,3949,26,44,"RECORTES CERO-GRUPO VERDE",8
8,"8228",301,199,197,6,2,"RECORTES CERO-GRUPO VERDE",0
46,"46161",1483,1188,1173,7,15,"RECORTES CERO-GRUPO VERDE",2
6,"6096",220,176,171,2,5,"RECORTES CERO-GRUPO VERDE",2
20,"20017",8559,5478,5435,24,43,"RECORTES CERO-GRUPO VERDE",14
33,"33015",1540,998,986,8,12,"RECORTES CERO-GRUPO VERDE",0
9,"9348",148,111,110,2,1,"RECORTES CERO-GRUPO VERDE",0
17,"17195",329,237,234,0,3,"RECORTES CERO-GRUPO VERDE",0
26,"26011",7321,5133,5083,38,50,"RECORTES CERO-GRUPO VERDE",4
28,"28050",4076,2860,2839,21,21,"RECORTES CERO-GRUPO VERDE",6
6,"6098",549,385,381,7,4,"RECORTES CERO-GRUPO VERDE",0
37,"37074",150,123,120,0,3,"RECORTES CERO-GRUPO VERDE",0
37,"37123",177,126,126,0,0,"RECORTES CERO-GRUPO VERDE",0
4,"4054",358,285,281,2,4,"RECORTES CERO-GRUPO VERDE",0
8,"8217",24989,17765,17661,114,104,"RECORTES CERO-GRUPO VERDE",65
43,"43150",1281,937,923,6,14,"RECORTES CERO-GRUPO VERDE",0
44,"44177",115,84,84,1,0,"RECORTES CERO-GRUPO VERDE",0
31,"31247",151,114,113,0,1,"RECORTES CERO-GRUPO VERDE",0
16,"16217",74,62,62,0,0,"RECORTES CERO-GRUPO VERDE",0
19,"19095",12,9,9,0,0,"RECORTES CERO-GRUPO VERDE",0
39,"39100",860,633,629,15,4,"RECORTES CERO-GRUPO VERDE",1
41,"41073",1707,1055,1041,5,14,"RECORTES CERO-GRUPO VERDE",3
42,"42116",45,39,38,3,1,"RECORTES CERO-GRUPO VERDE",0
17,"17197",132,102,101,1,1,"RECORTES CERO-GRUPO VERDE",0
31,"31092",662,439,435,4,4,"RECORTES CERO-GRUPO VERDE",1
44,"44211",42,35,35,0,0,"RECORTES CERO-GRUPO VERDE",0
16,"16242",317,272,270,1,2,"RECORTES CERO-GRUPO VERDE",0
50,"50224",72,57,56,2,1,"RECORTES CERO-GRUPO VERDE",0
32,"32027",1053,765,749,2,16,"RECORTES CERO-GRUPO VERDE",2
44,"44245",248,179,176,2,3,"RECORTES CERO-GRUPO VERDE",0
9,"9437",282,219,218,3,1,"RECORTES CERO-GRUPO VERDE",0
5,"5038",115,83,81,0,2,"RECORTES CERO-GRUPO VERDE",0
50,"50195",54,40,40,0,0,"RECORTES CERO-GRUPO VERDE",0
8,"8149",993,569,567,10,2,"RECORTES CERO-GRUPO VERDE",1
25,"25245",435,289,280,5,9,"RECORTES CERO-GRUPO VERDE",0
17,"17028",293,205,204,6,1,"RECORTES CERO-GRUPO VERDE",0
31,"31193",1426,1024,1013,13,11,"RECORTES CERO-GRUPO VERDE",2
34,"34241",18,13,13,1,0,"RECORTES CERO-GRUPO VERDE",0
25,"25115",824,489,487,7,2,"RECORTES CERO-GRUPO VERDE",0
8,"8233",1871,1153,1140,16,13,"RECORTES CERO-GRUPO VERDE",2
15,"15019",25888,16680,16460,186,220,"RECORTES CERO-GRUPO VERDE",35
8,"8219",15422,10701,10619,98,82,"RECORTES CERO-GRUPO VERDE",17
13,"13008",438,299,295,0,4,"RECORTES CERO-GRUPO VERDE",0
19,"19011",250,184,184,0,0,"RECORTES CERO-GRUPO VERDE",0
16,"16091",65,53,53,0,0,"RECORTES CERO-GRUPO VERDE",0
24,"24157",2568,1943,1911,22,32,"RECORTES CERO-GRUPO VERDE",4
25,"25031",52,29,29,0,0,"RECORTES CERO-GRUPO VERDE",0
6,"6087",2110,1583,1561,8,22,"RECORTES CERO-GRUPO VERDE",0
46,"46216",5053,4109,4090,14,19,"RECORTES CERO-GRUPO VERDE",4
34,"34003",164,122,119,0,3,"RECORTES CERO-GRUPO VERDE",0
24,"24090",343,235,233,1,2,"RECORTES CERO-GRUPO VERDE",0
36,"36018",3240,2198,2170,10,28,"RECORTES CERO-GRUPO VERDE",1
18,"18093",2750,1793,1776,7,17,"RECORTES CERO-GRUPO VERDE",2
23,"23055",47167,31479,31198,264,281,"RECORTES CERO-GRUPO VERDE",37
37,"37252",112,79,79,0,0,"RECORTES CERO-GRUPO VERDE",0
30,"30041",13621,8970,8889,46,81,"RECORTES CERO-GRUPO VERDE",17
19,"19199",17,17,17,1,0,"RECORTES CERO-GRUPO VERDE",0
41,"41011",15401,10170,9986,111,184,"RECORTES CERO-GRUPO VERDE",13
25,"25248",891,592,586,6,6,"RECORTES CERO-GRUPO VERDE",1
15,"15058",27793,20392,20235,221,157,"RECORTES CERO-GRUPO VERDE",46
42,"42032",146,118,118,0,0,"RECORTES CERO-GRUPO VERDE",0
12,"12056",282,236,231,1,5,"RECORTES CERO-GRUPO VERDE",0
45,"45050",457,333,328,1,5,"RECORTES CERO-GRUPO VERDE",1
5,"5236",123,91,90,1,1,"RECORTES CERO-GRUPO VERDE",0
5,"5092",152,125,122,0,3,"RECORTES CERO-GRUPO VERDE",1
46,"46009",3121,2459,2427,8,32,"RECORTES CERO-GRUPO VERDE",7
9,"9175",127,94,93,2,1,"RECORTES CERO-GRUPO VERDE",0
34,"34052",174,135,133,0,2,"RECORTES CERO-GRUPO VERDE",0
16,"16190",5105,3945,3887,17,58,"RECORTES CERO-GRUPO VERDE",3
25,"25250",345,210,204,0,6,"RECORTES CERO-GRUPO VERDE",1
2,"2078",920,675,664,1,11,"RECORTES CERO-GRUPO VERDE",0
50,"50039",491,392,390,2,2,"RECORTES CERO-GRUPO VERDE",0
44,"44009",809,596,593,7,3,"RECORTES CERO-GRUPO VERDE",0
37,"37129",251,204,201,3,3,"RECORTES CERO-GRUPO VERDE",1
16,"16095",83,64,63,0,1,"RECORTES CERO-GRUPO VERDE",0
34,"34098",777,551,545,8,6,"RECORTES CERO-GRUPO VERDE",1
31,"31264",180,105,101,2,4,"RECORTES CERO-GRUPO VERDE",0
8,"8305",27339,17960,17809,147,151,"RECORTES CERO-GRUPO VERDE",37
34,"34055",270,209,207,2,2,"RECORTES CERO-GRUPO VERDE",0
29,"29028",1237,836,826,6,10,"RECORTES CERO-GRUPO VERDE",0
41,"41013",4839,3151,3094,33,57,"RECORTES CERO-GRUPO VERDE",4
4,"4070",1584,1184,1179,3,5,"RECORTES CERO-GRUPO VERDE",0
43,"43075",89,61,60,1,1,"RECORTES CERO-GRUPO VERDE",0
9,"9405",130,98,96,0,2,"RECORTES CERO-GRUPO VERDE",1
9,"9047",54,47,46,1,1,"RECORTES CERO-GRUPO VERDE",0
24,"24161",285,203,201,3,2,"RECORTES CERO-GRUPO VERDE",0
3,"3118",2437,1659,1642,4,17,"RECORTES CERO-GRUPO VERDE",4
1,"1901",2354,1592,1571,8,21,"RECORTES CERO-GRUPO VERDE",7
32,"32034",1124,845,839,5,6,"RECORTES CERO-GRUPO VERDE",2
39,"39015",839,647,642,4,5,"RECORTES CERO-GRUPO VERDE",0
6,"6062",594,441,437,5,4,"RECORTES CERO-GRUPO VERDE",0
22,"22079",118,83,83,1,0,"RECORTES CERO-GRUPO VERDE",0
31,"31265",82,53,53,2,0,"RECORTES CERO-GRUPO VERDE",1
46,"46089",2132,1602,1574,9,28,"RECORTES CERO-GRUPO VERDE",2
32,"32020",2576,1923,1899,5,24,"RECORTES CERO-GRUPO VERDE",0
7,"7030",1551,1127,1101,13,26,"RECORTES CERO-GRUPO VERDE",3
47,"47228",440,331,331,2,0,"RECORTES CERO-GRUPO VERDE",0
43,"43077",463,272,272,5,0,"RECORTES CERO-GRUPO VERDE",0
3,"3119",16636,12281,12194,57,87,"RECORTES CERO-GRUPO VERDE",12
33,"33053",1141,742,732,6,10,"RECORTES CERO-GRUPO VERDE",1
25,"25165",285,179,176,2,3,"RECORTES CERO-GRUPO VERDE",0
1,"1028",1070,716,710,3,6,"RECORTES CERO-GRUPO VERDE",2
28,"28002",3007,2091,2074,14,17,"RECORTES CERO-GRUPO VERDE",2
4,"4092",2838,2127,2103,10,24,"RECORTES CERO-GRUPO VERDE",3
43,"43038",21366,13061,12943,111,118,"RECORTES CERO-GRUPO VERDE",23
41,"41015",5297,3478,3405,41,73,"RECORTES CERO-GRUPO VERDE",3
46,"46038",327,242,242,3,0,"RECORTES CERO-GRUPO VERDE",1
20,"20027",2814,1761,1750,15,11,"RECORTES CERO-GRUPO VERDE",3
44,"44118",164,132,131,2,1,"RECORTES CERO-GRUPO VERDE",0
23,"23061",7560,5303,5234,29,69,"RECORTES CERO-GRUPO VERDE",4
9,"9407",28,23,23,0,0,"RECORTES CERO-GRUPO VERDE",0
39,"39017",569,398,391,4,7,"RECORTES CERO-GRUPO VERDE",0
25,"25166",181,110,109,2,1,"RECORTES CERO-GRUPO VERDE",0
17,"17089",5543,3349,3326,22,23,"RECORTES CERO-GRUPO VERDE",3
9,"9314",94,73,70,0,3,"RECORTES CERO-GRUPO VERDE",0
17,"17049",3117,2092,2072,14,20,"RECORTES CERO-GRUPO VERDE",6
50,"50233",106,81,81,0,0,"RECORTES CERO-GRUPO VERDE",0
43,"43161",17197,10481,10400,95,81,"RECORTES CERO-GRUPO VERDE",23
2,"2084",323,231,225,0,6,"RECORTES CERO-GRUPO VERDE",0
28,"28157",609,433,430,1,3,"RECORTES CERO-GRUPO VERDE",1
7,"7033",27104,15524,15337,174,187,"RECORTES CERO-GRUPO VERDE",56
18,"18192",1538,1151,1123,6,28,"RECORTES CERO-GRUPO VERDE",2
19,"19020",44,30,30,1,0,"RECORTES CERO-GRUPO VERDE",0
5,"5244",50,39,39,1,0,"RECORTES CERO-GRUPO VERDE",0
12,"12063",41,29,29,1,0,"RECORTES CERO-GRUPO VERDE",0
15,"15066",4009,2814,2776,33,38,"RECORTES CERO-GRUPO VERDE",6
17,"17207",2375,1590,1579,11,11,"RECORTES CERO-GRUPO VERDE",0
16,"16100",670,564,559,0,5,"RECORTES CERO-GRUPO VERDE",0
43,"43080",239,183,181,0,2,"RECORTES CERO-GRUPO VERDE",0
35,"35001",4584,3282,3222,26,60,"RECORTES CERO-GRUPO VERDE",9
46,"46196",147,125,125,1,0,"RECORTES CERO-GRUPO VERDE",0
47,"47205",384,266,260,0,6,"RECORTES CERO-GRUPO VERDE",0
3,"3029",245,185,183,1,2,"RECORTES CERO-GRUPO VERDE",0
50,"50004",522,390,388,0,2,"RECORTES CERO-GRUPO VERDE",0
47,"47222",83,64,64,1,0,"RECORTES CERO-GRUPO VERDE",0
15,"15042",3028,2033,2000,19,33,"RECORTES CERO-GRUPO VERDE",8
22,"22126",88,64,64,0,0,"RECORTES CERO-GRUPO VERDE",0
8,"8230",7635,5177,5121,54,56,"RECORTES CERO-GRUPO VERDE",15
25,"25154",122,74,72,0,2,"RECORTES CERO-GRUPO VERDE",0
6,"6114",137,112,112,0,0,"RECORTES CERO-GRUPO VERDE",0
21,"21050",12427,8036,7969,80,67,"RECORTES CERO-GRUPO VERDE",5
50,"50045",1243,926,925,6,1,"RECORTES CERO-GRUPO VERDE",2
3,"3123",7476,5557,5501,29,56,"RECORTES CERO-GRUPO VERDE",5
8,"8009",9180,6207,6192,50,15,"RECORTES CERO-GRUPO VERDE",14
9,"9317",19,16,16,0,0,"RECORTES CERO-GRUPO VERDE",0
16,"16259",29,22,21,0,1,"RECORTES CERO-GRUPO VERDE",0
36,"36028",4102,2913,2868,17,45,"RECORTES CERO-GRUPO VERDE",9
17,"17054",370,236,236,1,0,"RECORTES CERO-GRUPO VERDE",0
11,"11007",17964,10038,9856,197,182,"RECORTES CERO-GRUPO VERDE",19
9,"9318",61,41,41,0,0,"RECORTES CERO-GRUPO VERDE",0
6,"6161",302,236,235,1,1,"RECORTES CERO-GRUPO VERDE",0
46,"46119",780,653,647,5,6,"RECORTES CERO-GRUPO VERDE",2
44,"44016",482,363,360,2,3,"RECORTES CERO-GRUPO VERDE",0
5,"5104",35,28,28,0,0,"RECORTES CERO-GRUPO VERDE",0
2,"2007",1030,824,818,4,6,"RECORTES CERO-GRUPO VERDE",0
6,"6100",935,780,774,1,6,"RECORTES CERO-GRUPO VERDE",0
15,"15032",3444,2322,2269,30,53,"RECORTES CERO-GRUPO VERDE",6
50,"50016",52,40,40,0,0,"RECORTES CERO-GRUPO VERDE",0
25,"25171",2185,1416,1410,8,6,"RECORTES CERO-GRUPO VERDE",1
31,"31204",36,28,28,1,0,"RECORTES CERO-GRUPO VERDE",0
46,"46042",3380,2799,2755,20,44,"RECORTES CERO-GRUPO VERDE",0
44,"44224",22,14,14,0,0,"RECORTES CERO-GRUPO VERDE",0
19,"19023",124,100,98,2,2,"RECORTES CERO-GRUPO VERDE",0
20,"20032",8797,5672,5630,40,42,"RECORTES CERO-GRUPO VERDE",5
27,"27026",2397,1503,1471,9,32,"RECORTES CERO-GRUPO VERDE",1
5,"5056",96,76,76,0,0,"RECORTES CERO-GRUPO VERDE",0
24,"24167",750,505,499,4,6,"RECORTES CERO-GRUPO VERDE",1
35,"35004",39299,20523,20294,140,229,"RECORTES CERO-GRUPO VERDE",46
43,"43085",226,180,180,1,0,"RECORTES CERO-GRUPO VERDE",0
25,"25172",1797,1170,1146,10,24,"RECORTES CERO-GRUPO VERDE",1
2,"2008",1193,857,847,7,10,"RECORTES CERO-GRUPO VERDE",0
5,"5201",523,419,418,1,1,"RECORTES CERO-GRUPO VERDE",0
45,"45160",1109,874,864,6,10,"RECORTES CERO-GRUPO VERDE",2
49,"49173",375,230,221,3,9,"RECORTES CERO-GRUPO VERDE",0
28,"28131",12990,9512,9433,38,79,"RECORTES CERO-GRUPO VERDE",17
20,"20066",454,236,234,1,2,"RECORTES CERO-GRUPO VERDE",0
17,"17123",354,266,263,0,3,"RECORTES CERO-GRUPO VERDE",0
9,"9189",125,90,87,2,3,"RECORTES CERO-GRUPO VERDE",0
37,"37141",154,122,122,2,0,"RECORTES CERO-GRUPO VERDE",0
19,"19901",41,38,37,0,1,"RECORTES CERO-GRUPO VERDE",0
25,"25906",218,125,125,1,0,"RECORTES CERO-GRUPO VERDE",0
16,"16060",744,565,554,7,11,"RECORTES CERO-GRUPO VERDE",1
31,"31206",2090,1461,1440,22,21,"RECORTES CERO-GRUPO VERDE",11
38,"38008",5520,3825,3766,17,59,"RECORTES CERO-GRUPO VERDE",6
48,"48094",3161,2094,2073,12,21,"RECORTES CERO-GRUPO VERDE",2
49,"49097",85,52,51,0,1,"RECORTES CERO-GRUPO VERDE",0
50,"50050",98,64,64,2,0,"RECORTES CERO-GRUPO VERDE",1
26,"26131",35,33,33,1,0,"RECORTES CERO-GRUPO VERDE",0
44,"44226",140,98,98,2,0,"RECORTES CERO-GRUPO VERDE",0
11,"11902",3629,2275,2252,25,23,"RECORTES CERO-GRUPO VERDE",2
41,"41089",6493,4398,4331,43,67,"RECORTES CERO-GRUPO VERDE",11
25,"25006",340,201,200,6,1,"RECORTES CERO-GRUPO VERDE",1
19,"19031",15,9,9,0,0,"RECORTES CERO-GRUPO VERDE",0
31,"31008",75,54,54,2,0,"RECORTES CERO-GRUPO VERDE",0
37,"37268",112,76,76,0,0,"RECORTES CERO-GRUPO VERDE",0
8,"8015",155409,99368,98735,820,633,"RECORTES CERO-GRUPO VERDE",479
6,"6121",3355,2279,2248,8,31,"RECORTES CERO-GRUPO VERDE",1
49,"49099",115,87,87,0,0,"RECORTES CERO-GRUPO VERDE",0
10,"10104",5119,3633,3585,15,48,"RECORTES CERO-GRUPO VERDE",6
9,"9455",45,33,33,0,0,"RECORTES CERO-GRUPO VERDE",0
5,"5257",132,101,101,0,0,"RECORTES CERO-GRUPO VERDE",0
35,"35006",30457,21398,21118,162,280,"RECORTES CERO-GRUPO VERDE",82
45,"45130",317,253,250,1,3,"RECORTES CERO-GRUPO VERDE",0
19,"19071",7840,5537,5489,45,48,"RECORTES CERO-GRUPO VERDE",11
32,"32003",885,654,649,5,5,"RECORTES CERO-GRUPO VERDE",2
16,"16271",633,517,516,4,1,"RECORTES CERO-GRUPO VERDE",1
24,"24037",360,254,250,2,4,"RECORTES CERO-GRUPO VERDE",0
9,"9327",26,24,24,0,0,"RECORTES CERO-GRUPO VERDE",0
39,"39056",2286,1714,1684,8,30,"RECORTES CERO-GRUPO VERDE",5
22,"22221",84,58,58,0,0,"RECORTES CERO-GRUPO VERDE",0
9,"9456",130,97,96,0,1,"RECORTES CERO-GRUPO VERDE",0
9,"9192",55,43,43,0,0,"RECORTES CERO-GRUPO VERDE",0
5,"5061",252,186,184,3,2,"RECORTES CERO-GRUPO VERDE",1
31,"31176",2869,2010,1963,33,47,"RECORTES CERO-GRUPO VERDE",15
29,"29008",14596,9519,9407,94,112,"RECORTES CERO-GRUPO VERDE",5
5,"5240",3374,2283,2257,7,26,"RECORTES CERO-GRUPO VERDE",1
9,"9144",53,40,40,0,0,"RECORTES CERO-GRUPO VERDE",0
5,"5013",868,728,721,6,7,"RECORTES CERO-GRUPO VERDE",3
8,"8170",450,276,274,7,2,"RECORTES CERO-GRUPO VERDE",1
13,"13086",175,137,134,0,3,"RECORTES CERO-GRUPO VERDE",0
17,"17023",27269,17209,17032,122,177,"RECORTES CERO-GRUPO VERDE",48
39,"39057",2330,1671,1645,7,26,"RECORTES CERO-GRUPO VERDE",2
10,"10107",1031,801,792,3,9,"RECORTES CERO-GRUPO VERDE",1
8,"8253",131,81,81,2,0,"RECORTES CERO-GRUPO VERDE",0
45,"45065",271,207,206,1,1,"RECORTES CERO-GRUPO VERDE",0
41,"41059",34165,24949,24709,196,240,"RECORTES CERO-GRUPO VERDE",63
12,"12072",1101,929,911,11,18,"RECORTES CERO-GRUPO VERDE",1
17,"17100",194,133,131,3,2,"RECORTES CERO-GRUPO VERDE",0
40,"40061",67,55,54,1,1,"RECORTES CERO-GRUPO VERDE",0
14,"14048",1207,884,869,13,15,"RECORTES CERO-GRUPO VERDE",2
50,"50211",249,176,173,0,3,"RECORTES CERO-GRUPO VERDE",0
3,"3037",346,282,278,3,4,"RECORTES CERO-GRUPO VERDE",0
48,"48901",4839,3459,3426,32,33,"RECORTES CERO-GRUPO VERDE",3
28,"28068",10955,8136,8076,49,60,"RECORTES CERO-GRUPO VERDE",15
31,"31111",95,65,65,2,0,"RECORTES CERO-GRUPO VERDE",0
13,"13088",610,458,453,6,5,"RECORTES CERO-GRUPO VERDE",0
46,"46125",847,689,684,5,5,"RECORTES CERO-GRUPO VERDE",2
37,"37147",193,134,132,1,2,"RECORTES CERO-GRUPO VERDE",0
20,"20039",2111,1480,1472,14,8,"RECORTES CERO-GRUPO VERDE",1
39,"39058",810,559,557,2,2,"RECORTES CERO-GRUPO VERDE",0
8,"8131",704,471,468,7,3,"RECORTES CERO-GRUPO VERDE",1
22,"22094",101,74,74,1,0,"RECORTES CERO-GRUPO VERDE",0
10,"10109",1762,1149,1125,14,24,"RECORTES CERO-GRUPO VERDE",3
1,"1044",236,169,167,0,2,"RECORTES CERO-GRUPO VERDE",0
32,"32008",8256,5542,5490,39,52,"RECORTES CERO-GRUPO VERDE",22
16,"16067",123,87,87,0,0,"RECORTES CERO-GRUPO VERDE",0
15,"15041",9568,6828,6710,75,118,"RECORTES CERO-GRUPO VERDE",14
24,"24008",9282,6685,6603,52,82,"RECORTES CERO-GRUPO VERDE",9
37,"37358",159,135,133,0,2,"RECORTES CERO-GRUPO VERDE",0
49,"49227",315,230,228,2,2,"RECORTES CERO-GRUPO VERDE",0
12,"12074",785,652,648,5,4,"RECORTES CERO-GRUPO VERDE",0
28,"28013",40471,28739,28490,188,249,"RECORTES CERO-GRUPO VERDE",38
19,"19038",28,24,23,0,1,"RECORTES CERO-GRUPO VERDE",0
37,"37149",68,64,64,0,0,"RECORTES CERO-GRUPO VERDE",0
9,"9197",144,111,109,1,2,"RECORTES CERO-GRUPO VERDE",0
15,"15079",1540,1027,1007,16,20,"RECORTES CERO-GRUPO VERDE",2
1,"1058",1345,799,793,7,6,"RECORTES CERO-GRUPO VERDE",2
3,"3019",15269,11520,11398,72,122,"RECORTES CERO-GRUPO VERDE",14
14,"14013",16796,11830,11616,129,214,"RECORTES CERO-GRUPO VERDE",17
19,"19021",1030,759,744,7,15,"RECORTES CERO-GRUPO VERDE",2
25,"25182",1036,660,655,9,5,"RECORTES CERO-GRUPO VERDE",0
37,"37150",41,34,34,0,0,"RECORTES CERO-GRUPO VERDE",0
45,"45069",1847,1391,1376,6,15,"RECORTES CERO-GRUPO VERDE",1
28,"28168",1237,884,880,4,4,"RECORTES CERO-GRUPO VERDE",3
43,"43055",1975,1384,1379,21,5,"RECORTES CERO-GRUPO VERDE",2
3,"3040",254,216,213,2,3,"RECORTES CERO-GRUPO VERDE",0
4,"4021",185,151,148,1,3,"RECORTES CERO-GRUPO VERDE",2
8,"8134",810,541,538,7,3,"RECORTES CERO-GRUPO VERDE",0
23,"23077",620,501,494,3,7,"RECORTES CERO-GRUPO VERDE",1
22,"22096",301,240,240,0,0,"RECORTES CERO-GRUPO VERDE",2
5,"5119",32,22,22,0,0,"RECORTES CERO-GRUPO VERDE",0
46,"46024",413,314,313,2,1,"RECORTES CERO-GRUPO VERDE",1
5,"5019",44555,33259,32939,277,320,"RECORTES CERO-GRUPO VERDE",68
15,"15043",5114,3476,3401,47,75,"RECORTES CERO-GRUPO VERDE",10
5,"5266",100,86,86,0,0,"RECORTES CERO-GRUPO VERDE",0
2,"2020",432,365,364,1,1,"RECORTES CERO-GRUPO VERDE",0
19,"19268",35,24,24,1,0,"RECORTES CERO-GRUPO VERDE",0
18,"18029",1833,1196,1190,12,6,"RECORTES CERO-GRUPO VERDE",1
36,"36005",8121,5480,5400,52,80,"RECORTES CERO-GRUPO VERDE",10
20,"20042",3228,1967,1958,27,9,"RECORTES CERO-GRUPO VERDE",0
37,"37018",107,79,79,0,0,"RECORTES CERO-GRUPO VERDE",0
14,"14052",9379,5917,5854,68,63,"RECORTES CERO-GRUPO VERDE",4
19,"19197",27,22,22,0,0,"RECORTES CERO-GRUPO VERDE",0
40,"40070",149,107,105,1,2,"RECORTES CERO-GRUPO VERDE",0
18,"18121",129,98,98,1,0,"RECORTES CERO-GRUPO VERDE",0
19,"19269",102,81,80,0,1,"RECORTES CERO-GRUPO VERDE",0
23,"23081",1513,1103,1084,10,19,"RECORTES CERO-GRUPO VERDE",0
48,"48905",2553,1792,1771,12,21,"RECORTES CERO-GRUPO VERDE",4
11,"11020",165378,109810,108830,1188,980,"RECORTES CERO-GRUPO VERDE",268
49,"49231",330,232,232,2,0,"RECORTES CERO-GRUPO VERDE",0
31,"31017",358,242,239,0,3,"RECORTES CERO-GRUPO VERDE",0
22,"22102",179,141,138,2,3,"RECORTES CERO-GRUPO VERDE",0
16,"16073",185,164,164,1,0,"RECORTES CERO-GRUPO VERDE",0
28,"28016",79,53,51,0,2,"RECORTES CERO-GRUPO VERDE",0
9,"9068",29,24,24,0,0,"RECORTES CERO-GRUPO VERDE",0
17,"17225",214,139,139,3,0,"RECORTES CERO-GRUPO VERDE",0
32,"32060",832,583,576,8,7,"RECORTES CERO-GRUPO VERDE",1
17,"17188",164,124,124,1,0,"RECORTES CERO-GRUPO VERDE",0
37,"37239",217,185,183,3,2,"RECORTES CERO-GRUPO VERDE",0
14,"14054",13697,10315,10109,93,206,"RECORTES CERO-GRUPO VERDE",8
2,"2023",568,486,479,3,7,"RECORTES CERO-GRUPO VERDE",0
42,"42020",4263,2877,2821,35,56,"RECORTES CERO-GRUPO VERDE",2
42,"42058",113,92,89,0,3,"RECORTES CERO-GRUPO VERDE",0
46,"46052",499,421,417,2,4,"RECORTES CERO-GRUPO VERDE",1
6,"6134",547,335,332,1,3,"RECORTES CERO-GRUPO VERDE",1
29,"29071",934,596,588,3,8,"RECORTES CERO-GRUPO VERDE",0
37,"37281",36,33,31,0,2,"RECORTES CERO-GRUPO VERDE",1
26,"26038",89,68,67,0,1,"RECORTES CERO-GRUPO VERDE",0
19,"19271",46,39,39,0,0,"RECORTES CERO-GRUPO VERDE",0
9,"9339",128,110,110,0,0,"RECORTES CERO-GRUPO VERDE",0
16,"16171",1800,1469,1443,8,26,"RECORTES CERO-GRUPO VERDE",1
49,"49150",139,112,111,1,1,"RECORTES CERO-GRUPO VERDE",0
25,"25233",275,178,178,4,0,"RECORTES CERO-GRUPO VERDE",0
26,"26144",188,155,155,3,0,"RECORTES CERO-GRUPO VERDE",0
28,"28018",3768,2968,2945,26,23,"RECORTES CERO-GRUPO VERDE",4
22,"22105",114,78,77,2,1,"RECORTES CERO-GRUPO VERDE",0
17,"17111",880,590,586,7,4,"RECORTES CERO-GRUPO VERDE",0
19,"19044",304,245,244,0,1,"RECORTES CERO-GRUPO VERDE",0
45,"45040",1349,846,838,4,8,"RECORTES CERO-GRUPO VERDE",0
9,"9071",41,35,35,1,0,"RECORTES CERO-GRUPO VERDE",0
45,"45074",414,327,323,1,4,"RECORTES CERO-GRUPO VERDE",0
11,"11023",9348,6410,6349,64,61,"RECORTES CERO-GRUPO VERDE",3
12,"12080",1932,1598,1570,10,28,"RECORTES CERO-GRUPO VERDE",3
16,"16081",48,34,34,0,0,"RECORTES CERO-GRUPO VERDE",0
16,"16126",770,634,624,3,10,"RECORTES CERO-GRUPO VERDE",0
8,"8020",4926,3523,3502,33,21,"RECORTES CERO-GRUPO VERDE",7
44,"44032",16,11,11,0,0,"RECORTES CERO-GRUPO VERDE",0
7,"7056",5026,3410,3375,32,35,"RECORTES CERO-GRUPO VERDE",16
40,"40074",255,222,219,2,3,"RECORTES CERO-GRUPO VERDE",1
45,"45075",143,109,108,0,1,"RECORTES CERO-GRUPO VERDE",0
10,"10166",308,206,204,0,2,"RECORTES CERO-GRUPO VERDE",0
34,"34039",61,49,47,0,2,"RECORTES CERO-GRUPO VERDE",0
1,"1055",838,538,527,8,11,"RECORTES CERO-GRUPO VERDE",0
29,"29051",40391,25780,25419,232,361,"RECORTES CERO-GRUPO VERDE",34
8,"8021",70,49,46,0,3,"RECORTES CERO-GRUPO VERDE",0
12,"12081",608,486,480,5,6,"RECORTES CERO-GRUPO VERDE",1
25,"25193",759,485,480,2,5,"RECORTES CERO-GRUPO VERDE",0
37,"37244",131,98,98,0,0,"RECORTES CERO-GRUPO VERDE",0
9,"9478",41,32,32,1,0,"RECORTES CERO-GRUPO VERDE",0
3,"3046",1599,1153,1143,8,10,"RECORTES CERO-GRUPO VERDE",4
31,"31221",1214,798,786,12,12,"RECORTES CERO-GRUPO VERDE",2
33,"33074",3484,2298,2274,24,24,"RECORTES CERO-GRUPO VERDE",3
50,"50221",35,17,17,0,0,"RECORTES CERO-GRUPO VERDE",0
46,"46055",1262,1025,1012,5,13,"RECORTES CERO-GRUPO VERDE",1
18,"18128",343,270,269,1,1,"RECORTES CERO-GRUPO VERDE",0
5,"5129",125,88,87,2,1,"RECORTES CERO-GRUPO VERDE",0
16,"16035",261,203,198,4,5,"RECORTES CERO-GRUPO VERDE",0
24,"24083",1042,727,715,6,12,"RECORTES CERO-GRUPO VERDE",0
15,"15088",3519,2304,2270,27,34,"RECORTES CERO-GRUPO VERDE",1
8,"8022",12212,7210,7155,66,55,"RECORTES CERO-GRUPO VERDE",4
5,"5130",90,85,85,0,0,"RECORTES CERO-GRUPO VERDE",0
16,"16908",186,152,152,1,0,"RECORTES CERO-GRUPO VERDE",0
2,"2069",11490,8470,8373,41,97,"RECORTES CERO-GRUPO VERDE",4
8,"8023",6734,4350,4323,35,27,"RECORTES CERO-GRUPO VERDE",9
14,"14058",7970,5491,5417,66,74,"RECORTES CERO-GRUPO VERDE",7
40,"40204",167,113,110,1,3,"RECORTES CERO-GRUPO VERDE",0
6,"6050",4106,3134,3075,25,59,"RECORTES CERO-GRUPO VERDE",2
19,"19241",43,34,34,1,0,"RECORTES CERO-GRUPO VERDE",0
50,"50222",1622,1091,1071,7,20,"RECORTES CERO-GRUPO VERDE",0
37,"37162",204,152,151,0,1,"RECORTES CERO-GRUPO VERDE",0
8,"8268",1005,665,659,4,6,"RECORTES CERO-GRUPO VERDE",0
46,"46135",9680,7682,7634,36,48,"RECORTES CERO-GRUPO VERDE",14
43,"43148",90275,59182,58757,388,425,"RECORTES CERO-GRUPO VERDE",188
50,"50033",66,49,48,0,1,"RECORTES CERO-GRUPO VERDE",0
25,"25196",113,57,57,0,0,"RECORTES CERO-GRUPO VERDE",0
44,"44035",113,90,88,1,2,"RECORTES CERO-GRUPO VERDE",0
39,"39038",1452,997,990,8,7,"RECORTES CERO-GRUPO VERDE",2
7,"7061",9819,6351,6280,53,71,"RECORTES CERO-GRUPO VERDE",28
14,"14059",690,533,528,4,5,"RECORTES CERO-GRUPO VERDE",0
9,"9076",23,17,17,1,0,"RECORTES CERO-GRUPO VERDE",0
19,"19279",57,55,55,0,0,"RECORTES CERO-GRUPO VERDE",0
24,"24086",270,223,218,0,5,"RECORTES CERO-GRUPO VERDE",0
33,"33016",19130,13666,13526,125,140,"RECORTES CERO-GRUPO VERDE",15
9,"9038",119,100,100,0,0,"RECORTES CERO-GRUPO VERDE",0
8,"8270",18490,12343,12274,93,69,"RECORTES CERO-GRUPO VERDE",26
3,"3904",1396,1033,1026,4,7,"RECORTES CERO-GRUPO VERDE",1
47,"47077",246,193,191,1,2,"RECORTES CERO-GRUPO VERDE",0
41,"41084",2845,2124,2081,9,43,"RECORTES CERO-GRUPO VERDE",0
10,"10202",606,473,463,4,10,"RECORTES CERO-GRUPO VERDE",1
45,"45001",1835,1281,1251,3,30,"RECORTES CERO-GRUPO VERDE",0
6,"6144",556,431,425,0,6,"RECORTES CERO-GRUPO VERDE",0
9,"9485",55,43,42,0,1,"RECORTES CERO-GRUPO VERDE",0
47,"47059",97,76,76,2,0,"RECORTES CERO-GRUPO VERDE",0
12,"12085",4976,3236,3209,16,27,"RECORTES CERO-GRUPO VERDE",9
33,"33047",1107,852,843,9,9,"RECORTES CERO-GRUPO VERDE",2
12,"12087",25,18,18,4,0,"RECORTES CERO-GRUPO VERDE",0
22,"22112",9566,6354,6305,56,49,"RECORTES CERO-GRUPO VERDE",6
23,"23093",3226,2302,2273,19,29,"RECORTES CERO-GRUPO VERDE",1
20,"20052",1090,779,776,8,3,"RECORTES CERO-GRUPO VERDE",4
13,"13058",4100,2986,2954,25,32,"RECORTES CERO-GRUPO VERDE",5
26,"26013",347,249,246,2,3,"RECORTES CERO-GRUPO VERDE",0
25,"25155",647,421,418,0,3,"RECORTES CERO-GRUPO VERDE",1
17,"17080",138,96,96,1,0,"RECORTES CERO-GRUPO VERDE",0
10,"10219",1276,796,790,7,6,"RECORTES CERO-GRUPO VERDE",2
24,"24156",239,159,158,1,1,"RECORTES CERO-GRUPO VERDE",0
19,"19322",31,25,25,0,0,"RECORTES CERO-GRUPO VERDE",0
27,"27061",1027,753,732,6,21,"RECORTES CERO-GRUPO VERDE",5
17,"17003",104,67,66,0,1,"RECORTES CERO-GRUPO VERDE",0
47,"47087",381,301,297,3,4,"RECORTES CERO-GRUPO VERDE",0
37,"37291",272,207,206,0,1,"RECORTES CERO-GRUPO VERDE",0
22,"22243",45,28,28,0,0,"RECORTES CERO-GRUPO VERDE",0
46,"46137",270,210,207,4,3,"RECORTES CERO-GRUPO VERDE",0
6,"6101",463,381,378,2,3,"RECORTES CERO-GRUPO VERDE",0
23,"23054",382,282,281,1,1,"RECORTES CERO-GRUPO VERDE",0
50,"50287",270,191,191,0,0,"RECORTES CERO-GRUPO VERDE",0
44,"44246",1543,1045,1027,12,18,"RECORTES CERO-GRUPO VERDE",4
24,"24188",3822,2850,2817,19,33,"RECORTES CERO-GRUPO VERDE",4
14,"14062",1025,806,792,6,14,"RECORTES CERO-GRUPO VERDE",0
6,"6147",354,268,268,0,0,"RECORTES CERO-GRUPO VERDE",1
15,"15902",4598,3209,3149,51,60,"RECORTES CERO-GRUPO VERDE",7
9,"9353",76,57,56,1,1,"RECORTES CERO-GRUPO VERDE",0
34,"34094",64,45,44,0,1,"RECORTES CERO-GRUPO VERDE",0
12,"12020",118,105,105,0,0,"RECORTES CERO-GRUPO VERDE",0
49,"49201",302,270,268,3,2,"RECORTES CERO-GRUPO VERDE",0
49,"49121",365,273,273,2,0,"RECORTES CERO-GRUPO VERDE",0
45,"45183",2220,1444,1428,3,16,"RECORTES CERO-GRUPO VERDE",2
8,"8275",247,179,179,4,0,"RECORTES CERO-GRUPO VERDE",1
5,"5139",74,65,65,0,0,"RECORTES CERO-GRUPO VERDE",0
44,"44180",70,61,61,0,0,"RECORTES CERO-GRUPO VERDE",0
9,"9259",230,186,186,5,0,"RECORTES CERO-GRUPO VERDE",0
14,"14035",5966,4236,4177,39,59,"RECORTES CERO-GRUPO VERDE",3
3,"3053",7226,5651,5584,32,67,"RECORTES CERO-GRUPO VERDE",12
37,"37169",176,127,126,0,1,"RECORTES CERO-GRUPO VERDE",0
41,"41077",8702,5983,5875,29,108,"RECORTES CERO-GRUPO VERDE",9
13,"13063",3706,2539,2514,33,25,"RECORTES CERO-GRUPO VERDE",2
40,"40211",74,64,64,0,0,"RECORTES CERO-GRUPO VERDE",0
8,"8276",237,165,165,2,0,"RECORTES CERO-GRUPO VERDE",1
17,"17124",1607,1027,1007,11,20,"RECORTES CERO-GRUPO VERDE",0
34,"34005",851,673,658,4,15,"RECORTES CERO-GRUPO VERDE",2
42,"42167",251,175,172,2,3,"RECORTES CERO-GRUPO VERDE",0
1,"1063",1798,1269,1261,19,8,"RECORTES CERO-GRUPO VERDE",3
6,"6105",624,418,417,1,1,"RECORTES CERO-GRUPO VERDE",0
8,"8032",1981,1319,1311,11,8,"RECORTES CERO-GRUPO VERDE",5
18,"18095",1967,1450,1430,11,20,"RECORTES CERO-GRUPO VERDE",3
20,"20056",4082,2589,2570,27,19,"RECORTES CERO-GRUPO VERDE",3
22,"22003",137,110,107,1,3,"RECORTES CERO-GRUPO VERDE",0
47,"47011",565,461,458,5,3,"RECORTES CERO-GRUPO VERDE",0
22,"22116",1430,1004,994,5,10,"RECORTES CERO-GRUPO VERDE",0
31,"31130",312,214,213,3,1,"RECORTES CERO-GRUPO VERDE",0
48,"48024",995,757,754,7,3,"RECORTES CERO-GRUPO VERDE",0
16,"16191",899,675,671,2,4,"RECORTES CERO-GRUPO VERDE",0
22,"22117",2478,1714,1693,22,21,"RECORTES CERO-GRUPO VERDE",2
46,"46192",761,576,570,5,6,"RECORTES CERO-GRUPO VERDE",1
20,"20024",386,210,209,3,1,"RECORTES CERO-GRUPO VERDE",0
5,"5142",99,88,85,0,3,"RECORTES CERO-GRUPO VERDE",0
39,"39075",137376,99899,99048,718,851,"RECORTES CERO-GRUPO VERDE",150
14,"14037",3318,2374,2320,22,54,"RECORTES CERO-GRUPO VERDE",2
19,"19178",33,22,22,0,0,"RECORTES CERO-GRUPO VERDE",0
37,"37297",425,328,322,2,6,"RECORTES CERO-GRUPO VERDE",0
40,"40214",208,168,168,2,0,"RECORTES CERO-GRUPO VERDE",0
16,"16004",259,198,197,2,1,"RECORTES CERO-GRUPO VERDE",0
49,"49247",443,283,279,2,4,"RECORTES CERO-GRUPO VERDE",0
16,"16250",76,59,59,0,0,"RECORTES CERO-GRUPO VERDE",0
6,"6016",2986,2114,2078,14,36,"RECORTES CERO-GRUPO VERDE",3
34,"34147",166,118,117,0,1,"RECORTES CERO-GRUPO VERDE",0
6,"6017",272,222,221,1,1,"RECORTES CERO-GRUPO VERDE",0
9,"9221",461,343,338,3,5,"RECORTES CERO-GRUPO VERDE",1
44,"44251",254,198,191,1,7,"RECORTES CERO-GRUPO VERDE",0
4,"4101",4266,2909,2876,26,33,"RECORTES CERO-GRUPO VERDE",2
34,"34149",23,18,18,0,0,"RECORTES CERO-GRUPO VERDE",0
17,"17128",308,205,203,3,2,"RECORTES CERO-GRUPO VERDE",0
49,"49007",370,255,249,1,6,"RECORTES CERO-GRUPO VERDE",2
18,"18144",781,567,558,4,9,"RECORTES CERO-GRUPO VERDE",0
31,"31033",49,31,31,1,0,"RECORTES CERO-GRUPO VERDE",0
39,"39047",1962,1385,1371,10,14,"RECORTES CERO-GRUPO VERDE",4
8,"8240",9348,6512,6483,38,29,"RECORTES CERO-GRUPO VERDE",16
16,"16006",120,98,96,3,2,"RECORTES CERO-GRUPO VERDE",0
37,"37039",301,217,213,0,4,"RECORTES CERO-GRUPO VERDE",0
12,"12060",446,368,364,4,4,"RECORTES CERO-GRUPO VERDE",0
9,"9908",449,307,306,3,1,"RECORTES CERO-GRUPO VERDE",0
37,"37300",566,398,395,0,3,"RECORTES CERO-GRUPO VERDE",0
4,"4007",734,524,522,1,2,"RECORTES CERO-GRUPO VERDE",0
32,"32082",1243,891,878,1,13,"RECORTES CERO-GRUPO VERDE",0
5,"5099",491,395,386,6,9,"RECORTES CERO-GRUPO VERDE",0
5,"5147",159,128,124,5,4,"RECORTES CERO-GRUPO VERDE",1
2,"2042",837,618,611,1,7,"RECORTES CERO-GRUPO VERDE",0
43,"43120",441,270,267,1,3,"RECORTES CERO-GRUPO VERDE",0
44,"44256",38,34,34,0,0,"RECORTES CERO-GRUPO VERDE",0
44,"44220",121,84,83,1,1,"RECORTES CERO-GRUPO VERDE",0
18,"18146",965,703,685,9,18,"RECORTES CERO-GRUPO VERDE",3
46,"46117",495,402,399,5,3,"RECORTES CERO-GRUPO VERDE",2
10,"10002",364,272,270,0,2,"RECORTES CERO-GRUPO VERDE",1
50,"50074",6366,4230,4165,31,65,"RECORTES CERO-GRUPO VERDE",4
3,"3058",4951,3897,3851,30,46,"RECORTES CERO-GRUPO VERDE",5
14,"14040",3776,2873,2833,32,40,"RECORTES CERO-GRUPO VERDE",1
14,"14068",538,401,398,10,3,"RECORTES CERO-GRUPO VERDE",0
19,"19060",146,119,118,1,1,"RECORTES CERO-GRUPO VERDE",0
37,"37176",133,110,110,0,0,"RECORTES CERO-GRUPO VERDE",0
4,"4901",545,395,394,0,1,"RECORTES CERO-GRUPO VERDE",0
32,"32084",918,641,635,3,6,"RECORTES CERO-GRUPO VERDE",1
17,"17132",1298,884,877,12,7,"RECORTES CERO-GRUPO VERDE",0
28,"28097",119,94,94,0,0,"RECORTES CERO-GRUPO VERDE",0
12,"12095",959,749,742,8,7,"RECORTES CERO-GRUPO VERDE",1
24,"24198",592,412,407,2,5,"RECORTES CERO-GRUPO VERDE",0
16,"16255",140,122,121,0,1,"RECORTES CERO-GRUPO VERDE",0
19,"19061",57,42,42,0,0,"RECORTES CERO-GRUPO VERDE",0
22,"22047",243,205,203,2,2,"RECORTES CERO-GRUPO VERDE",1
47,"47086",3906,2970,2936,24,34,"RECORTES CERO-GRUPO VERDE",4
33,"33036",11542,8062,7987,60,75,"RECORTES CERO-GRUPO VERDE",9
22,"22242",62,45,44,0,1,"RECORTES CERO-GRUPO VERDE",1
3,"3050",18652,13325,13234,57,91,"RECORTES CERO-GRUPO VERDE",15
12,"12096",777,587,577,6,10,"RECORTES CERO-GRUPO VERDE",1
50,"50265",79,61,61,0,0,"RECORTES CERO-GRUPO VERDE",0
31,"31036",909,636,628,7,8,"RECORTES CERO-GRUPO VERDE",5
5,"5152",678,554,551,3,3,"RECORTES CERO-GRUPO VERDE",0
49,"49011",232,168,165,6,3,"RECORTES CERO-GRUPO VERDE",2
19,"19064",70,64,64,2,0,"RECORTES CERO-GRUPO VERDE",0
22,"22252",121,86,81,0,5,"RECORTES CERO-GRUPO VERDE",0
39,"39080",3542,2656,2628,20,28,"RECORTES CERO-GRUPO VERDE",6
50,"50266",122,90,90,0,0,"RECORTES CERO-GRUPO VERDE",0
17,"17092",3509,2256,2223,18,33,"RECORTES CERO-GRUPO VERDE",5
16,"16150",97,72,72,0,0,"RECORTES CERO-GRUPO VERDE",0
32,"32041",767,524,515,4,9,"RECORTES CERO-GRUPO VERDE",0
45,"45058",375,311,304,1,7,"RECORTES CERO-GRUPO VERDE",0
5,"5153",103,78,77,1,1,"RECORTES CERO-GRUPO VERDE",0
25,"25216",226,138,136,1,2,"RECORTES CERO-GRUPO VERDE",0
10,"10006",1263,978,970,2,8,"RECORTES CERO-GRUPO VERDE",4
47,"47096",140,110,110,0,0,"RECORTES CERO-GRUPO VERDE",0
42,"42042",45,35,35,0,0,"RECORTES CERO-GRUPO VERDE",0
42,"42178",115,83,83,0,0,"RECORTES CERO-GRUPO VERDE",0
44,"44261",739,536,529,6,7,"RECORTES CERO-GRUPO VERDE",0
24,"24201",1090,762,759,10,3,"RECORTES CERO-GRUPO VERDE",4
29,"29002",1177,804,789,5,15,"RECORTES CERO-GRUPO VERDE",0
50,"50267",602,433,430,8,3,"RECORTES CERO-GRUPO VERDE",1
31,"31238",112,93,93,0,0,"RECORTES CERO-GRUPO VERDE",1
22,"22254",1124,801,792,11,9,"RECORTES CERO-GRUPO VERDE",0
29,"29003",983,754,743,1,11,"RECORTES CERO-GRUPO VERDE",0
10,"10007",629,459,454,5,5,"RECORTES CERO-GRUPO VERDE",1
34,"34158",288,186,184,3,2,"RECORTES CERO-GRUPO VERDE",0
19,"19066",55,48,48,0,0,"RECORTES CERO-GRUPO VERDE",0
8,"8288",1659,1004,994,7,10,"RECORTES CERO-GRUPO VERDE",0
9,"9098",507,369,362,5,7,"RECORTES CERO-GRUPO VERDE",1
32,"32090",774,530,511,4,19,"RECORTES CERO-GRUPO VERDE",4
37,"37266",82,63,63,2,0,"RECORTES CERO-GRUPO VERDE",0
22,"22901",742,478,470,5,8,"RECORTES CERO-GRUPO VERDE",0
15,"15033",2472,1863,1845,8,18,"RECORTES CERO-GRUPO VERDE",5
9,"9450",28,22,21,0,1,"RECORTES CERO-GRUPO VERDE",0
44,"44262",135,108,107,2,1,"RECORTES CERO-GRUPO VERDE",0
19,"19027",138,105,105,1,0,"RECORTES CERO-GRUPO VERDE",1
5,"5253",86,70,68,0,2,"RECORTES CERO-GRUPO VERDE",0
17,"17138",928,637,633,4,4,"RECORTES CERO-GRUPO VERDE",1
12,"12068",48,36,35,1,1,"RECORTES CERO-GRUPO VERDE",0
5,"5107",62,39,39,0,0,"RECORTES CERO-GRUPO VERDE",0
22,"22218",43,33,33,0,0,"RECORTES CERO-GRUPO VERDE",0
46,"46070",16950,12765,12676,61,89,"RECORTES CERO-GRUPO VERDE",27
26,"26167",59,47,46,1,1,"RECORTES CERO-GRUPO VERDE",0
48,"48033",217,149,149,0,0,"RECORTES CERO-GRUPO VERDE",0
20,"20067",30828,19984,19882,140,102,"RECORTES CERO-GRUPO VERDE",52
32,"32092",520,321,320,6,1,"RECORTES CERO-GRUPO VERDE",3
35,"35031",7259,5037,4942,29,95,"RECORTES CERO-GRUPO VERDE",22
49,"49259",89,66,65,1,1,"RECORTES CERO-GRUPO VERDE",0
49,"49221",245,129,127,1,2,"RECORTES CERO-GRUPO VERDE",0
42,"42139",23,15,15,1,0,"RECORTES CERO-GRUPO VERDE",0
46,"46148",1513,1160,1146,7,14,"RECORTES CERO-GRUPO VERDE",3
16,"16155",508,398,391,2,7,"RECORTES CERO-GRUPO VERDE",0
8,"8045",73,37,35,0,2,"RECORTES CERO-GRUPO VERDE",0
34,"34161",23,16,16,0,0,"RECORTES CERO-GRUPO VERDE",0
45,"45196",1400,1047,1033,5,14,"RECORTES CERO-GRUPO VERDE",0
10,"10011",560,458,448,5,10,"RECORTES CERO-GRUPO VERDE",0
18,"18154",1007,664,660,2,4,"RECORTES CERO-GRUPO VERDE",1
37,"37311",227,182,182,3,0,"RECORTES CERO-GRUPO VERDE",0
9,"9101",76,56,55,1,1,"RECORTES CERO-GRUPO VERDE",0
19,"19299",97,79,77,1,2,"RECORTES CERO-GRUPO VERDE",0
8,"8291",4536,2975,2965,21,10,"RECORTES CERO-GRUPO VERDE",11
7,"7002",6341,4295,4255,39,40,"RECORTES CERO-GRUPO VERDE",8
3,"3065",167284,123032,122305,711,727,"RECORTES CERO-GRUPO VERDE",216
10,"10012",595,466,459,0,7,"RECORTES CERO-GRUPO VERDE",0
40,"40229",36,24,24,0,0,"RECORTES CERO-GRUPO VERDE",0
37,"37269",447,326,324,1,2,"RECORTES CERO-GRUPO VERDE",0
8,"8047",3899,2292,2260,16,32,"RECORTES CERO-GRUPO VERDE",5
17,"17141",5887,3197,3165,34,32,"RECORTES CERO-GRUPO VERDE",5
26,"26062",89,72,71,2,1,"RECORTES CERO-GRUPO VERDE",0
17,"17022",6910,4207,4184,58,23,"RECORTES CERO-GRUPO VERDE",6
5,"5010",152,117,116,1,1,"RECORTES CERO-GRUPO VERDE",0
25,"25048",1651,1051,1040,11,11,"RECORTES CERO-GRUPO VERDE",0
8,"8017",2762,1701,1688,9,13,"RECORTES CERO-GRUPO VERDE",1
32,"32050",2433,1829,1814,12,15,"RECORTES CERO-GRUPO VERDE",1
37,"37186",104,85,85,2,0,"RECORTES CERO-GRUPO VERDE",0
18,"18158",8358,5096,5031,28,65,"RECORTES CERO-GRUPO VERDE",3
19,"19227",66,44,43,2,1,"RECORTES CERO-GRUPO VERDE",0
31,"31177",255,169,166,2,3,"RECORTES CERO-GRUPO VERDE",1
17,"17142",2550,1806,1797,30,9,"RECORTES CERO-GRUPO VERDE",0
22,"22054",1542,1091,1077,13,14,"RECORTES CERO-GRUPO VERDE",2
28,"28107",457,312,312,0,0,"RECORTES CERO-GRUPO VERDE",4
37,"37187",572,427,423,1,4,"RECORTES CERO-GRUPO VERDE",1
46,"46150",1831,1341,1333,7,8,"RECORTES CERO-GRUPO VERDE",1
7,"7004",3854,2574,2547,30,27,"RECORTES CERO-GRUPO VERDE",5
5,"5162",86,66,63,0,3,"RECORTES CERO-GRUPO VERDE",1
20,"20070",1092,748,746,5,2,"RECORTES CERO-GRUPO VERDE",0
37,"37314",82,65,65,0,0,"RECORTES CERO-GRUPO VERDE",0
3,"3067",99,85,85,0,0,"RECORTES CERO-GRUPO VERDE",0
7,"7005",6710,4127,4090,25,37,"RECORTES CERO-GRUPO VERDE",13
2,"2015",1441,1112,1093,5,19,"RECORTES CERO-GRUPO VERDE",1
19,"19075",64,39,39,0,0,"RECORTES CERO-GRUPO VERDE",0
25,"25179",162,103,103,2,0,"RECORTES CERO-GRUPO VERDE",0
21,"21061",5084,3223,3177,28,46,"RECORTES CERO-GRUPO VERDE",3
16,"16020",17,10,10,0,0,"RECORTES CERO-GRUPO VERDE",0
5,"5115",523,378,373,0,5,"RECORTES CERO-GRUPO VERDE",0
12,"12104",6933,5411,5342,25,69,"RECORTES CERO-GRUPO VERDE",10
5,"5164",26,14,14,0,0,"RECORTES CERO-GRUPO VERDE",0
8,"8295",10870,6972,6918,51,54,"RECORTES CERO-GRUPO VERDE",27
22,"22136",806,588,588,5,0,"RECORTES CERO-GRUPO VERDE",0
43,"43134",282,191,191,4,0,"RECORTES CERO-GRUPO VERDE",0
9,"9105",109,86,81,1,5,"RECORTES CERO-GRUPO VERDE",0
50,"50274",71,55,55,0,0,"RECORTES CERO-GRUPO VERDE",1
37,"37316",744,563,558,3,5,"RECORTES CERO-GRUPO VERDE",0
19,"19076",27,19,19,0,0,"RECORTES CERO-GRUPO VERDE",0
1,"1003",1190,782,774,2,8,"RECORTES CERO-GRUPO VERDE",0
15,"15003",1803,1227,1210,9,17,"RECORTES CERO-GRUPO VERDE",1
22,"22184",184,155,155,3,0,"RECORTES CERO-GRUPO VERDE",1
46,"46048",3452,2749,2713,14,36,"RECORTES CERO-GRUPO VERDE",4
33,"33005",1449,936,924,11,12,"RECORTES CERO-GRUPO VERDE",0
16,"16023",469,335,335,2,0,"RECORTES CERO-GRUPO VERDE",0
44,"44164",27,23,23,0,0,"RECORTES CERO-GRUPO VERDE",0
17,"17026",544,370,367,5,3,"RECORTES CERO-GRUPO VERDE",0
24,"24009",322,153,152,2,1,"RECORTES CERO-GRUPO VERDE",0
22,"22908",197,142,140,3,2,"RECORTES CERO-GRUPO VERDE",1
44,"44056",501,345,342,2,3,"RECORTES CERO-GRUPO VERDE",0
2,"2031",565,457,455,0,2,"RECORTES CERO-GRUPO VERDE",0
25,"25212",233,154,153,6,1,"RECORTES CERO-GRUPO VERDE",0
2,"2005",559,424,416,5,8,"RECORTES CERO-GRUPO VERDE",1
3,"3101",4808,3627,3580,22,47,"RECORTES CERO-GRUPO VERDE",6
25,"25226",253,155,152,3,3,"RECORTES CERO-GRUPO VERDE",0
37,"37191",114,78,75,1,3,"RECORTES CERO-GRUPO VERDE",0
31,"31047",254,191,188,2,3,"RECORTES CERO-GRUPO VERDE",0
16,"16024",129,98,97,0,1,"RECORTES CERO-GRUPO VERDE",0
11,"11018",1468,1046,1031,9,15,"RECORTES CERO-GRUPO VERDE",1
50,"50152",1430,1008,994,14,14,"RECORTES CERO-GRUPO VERDE",0
6,"6129",577,438,429,0,9,"RECORTES CERO-GRUPO VERDE",1
16,"16025",26,23,23,0,0,"RECORTES CERO-GRUPO VERDE",0
8,"8176",156,109,107,2,2,"RECORTES CERO-GRUPO VERDE",0
10,"10020",1604,1185,1169,9,16,"RECORTES CERO-GRUPO VERDE",1
49,"49024",672,459,454,5,5,"RECORTES CERO-GRUPO VERDE",0
38,"38901",1405,900,887,3,13,"RECORTES CERO-GRUPO VERDE",4
17,"17067",696,467,464,5,3,"RECORTES CERO-GRUPO VERDE",0
49,"49230",97,72,72,0,0,"RECORTES CERO-GRUPO VERDE",0
45,"45203",2563,1801,1771,8,30,"RECORTES CERO-GRUPO VERDE",3
9,"9243",76,59,57,1,2,"RECORTES CERO-GRUPO VERDE",0
44,"44167",38,31,31,0,0,"RECORTES CERO-GRUPO VERDE",0
9,"9335",88,68,68,0,0,"RECORTES CERO-GRUPO VERDE",1
24,"24177",476,325,322,3,3,"RECORTES CERO-GRUPO VERDE",0
34,"34034",123,95,95,1,0,"RECORTES CERO-GRUPO VERDE",0
37,"37320",95,72,72,0,0,"RECORTES CERO-GRUPO VERDE",0
47,"47187",84,61,58,0,3,"RECORTES CERO-GRUPO VERDE",0
32,"32013",2183,1428,1425,8,3,"RECORTES CERO-GRUPO VERDE",3
12,"12108",456,378,371,2,7,"RECORTES CERO-GRUPO VERDE",0
5,"5021",1914,1483,1464,5,19,"RECORTES CERO-GRUPO VERDE",4
9,"9382",33,28,28,0,0,"RECORTES CERO-GRUPO VERDE",0
4,"4022",347,249,249,7,0,"RECORTES CERO-GRUPO VERDE",0
23,"23080",1762,1332,1322,4,10,"RECORTES CERO-GRUPO VERDE",0
1,"1009",1265,849,845,2,4,"RECORTES CERO-GRUPO VERDE",0
39,"39093",299,229,226,4,3,"RECORTES CERO-GRUPO VERDE",0
2,"2062",408,297,292,0,5,"RECORTES CERO-GRUPO VERDE",0
26,"26070",183,153,153,1,0,"RECORTES CERO-GRUPO VERDE",0
24,"24214",656,490,485,3,5,"RECORTES CERO-GRUPO VERDE",1
25,"25231",486,330,330,4,0,"RECORTES CERO-GRUPO VERDE",0
46,"46156",2080,1697,1675,10,22,"RECORTES CERO-GRUPO VERDE",3
28,"28112",161,136,136,1,0,"RECORTES CERO-GRUPO VERDE",0
8,"8057",60,45,44,1,1,"RECORTES CERO-GRUPO VERDE",0
37,"37322",2465,1592,1564,8,28,"RECORTES CERO-GRUPO VERDE",3
37,"37155",65,57,57,0,0,"RECORTES CERO-GRUPO VERDE",0
40,"40071",43,39,38,1,1,"RECORTES CERO-GRUPO VERDE",0
9,"9384",295,211,206,0,5,"RECORTES CERO-GRUPO VERDE",1
13,"13097",2270,1687,1671,7,16,"RECORTES CERO-GRUPO VERDE",1
44,"44135",113,88,87,0,1,"RECORTES CERO-GRUPO VERDE",0
47,"47106",50,39,39,0,0,"RECORTES CERO-GRUPO VERDE",0
9,"9246",620,451,444,2,7,"RECORTES CERO-GRUPO VERDE",0
10,"10025",400,327,318,1,9,"RECORTES CERO-GRUPO VERDE",2
46,"46078",28017,20288,20143,132,145,"RECORTES CERO-GRUPO VERDE",42
33,"33010",1822,1190,1180,17,10,"RECORTES CERO-GRUPO VERDE",0
12,"12110",234,176,173,0,3,"RECORTES CERO-GRUPO VERDE",0
7,"7014",7320,4163,4116,45,47,"RECORTES CERO-GRUPO VERDE",10
20,"20078",1155,850,846,4,4,"RECORTES CERO-GRUPO VERDE",0
6,"6044",28875,19791,19616,145,175,"RECORTES CERO-GRUPO VERDE",50
44,"44171",178,126,124,2,2,"RECORTES CERO-GRUPO VERDE",0
14,"14027",7925,5836,5746,58,90,"RECORTES CERO-GRUPO VERDE",2
49,"49028",115,104,103,1,1,"RECORTES CERO-GRUPO VERDE",0
28,"28114",150,101,100,1,1,"RECORTES CERO-GRUPO VERDE",0
40,"40906",2003,1569,1550,12,19,"RECORTES CERO-GRUPO VERDE",4
22,"22149",305,228,228,0,0,"RECORTES CERO-GRUPO VERDE",0
1,"1011",235,174,171,4,3,"RECORTES CERO-GRUPO VERDE",0
22,"22106",22,14,14,0,0,"RECORTES CERO-GRUPO VERDE",1
2,"2065",476,394,392,1,2,"RECORTES CERO-GRUPO VERDE",0
13,"13902",469,367,363,0,4,"RECORTES CERO-GRUPO VERDE",1
37,"37198",207,160,157,3,3,"RECORTES CERO-GRUPO VERDE",0
22,"22027",329,221,218,0,3,"RECORTES CERO-GRUPO VERDE",0
10,"10165",257,208,207,0,1,"RECORTES CERO-GRUPO VERDE",0
47,"47110",450,350,346,1,4,"RECORTES CERO-GRUPO VERDE",1
19,"19201",58,49,48,1,1,"RECORTES CERO-GRUPO VERDE",0
19,"19088",79,61,61,0,0,"RECORTES CERO-GRUPO VERDE",0
17,"17152",10737,6308,6252,45,56,"RECORTES CERO-GRUPO VERDE",9
12,"12012",2685,2234,2202,13,32,"RECORTES CERO-GRUPO VERDE",1
2,"2067",1158,858,847,6,11,"RECORTES CERO-GRUPO VERDE",0
19,"19274",902,660,651,7,9,"RECORTES CERO-GRUPO VERDE",4
8,"8142",133,103,101,5,2,"RECORTES CERO-GRUPO VERDE",1
9,"9343",93,66,65,0,1,"RECORTES CERO-GRUPO VERDE",0
43,"43104",1783,1157,1142,10,15,"RECORTES CERO-GRUPO VERDE",0
16,"16034",180,146,144,2,2,"RECORTES CERO-GRUPO VERDE",1
25,"25109",231,163,162,2,1,"RECORTES CERO-GRUPO VERDE",1
40,"40120",192,170,166,0,4,"RECORTES CERO-GRUPO VERDE",0
8,"8184",53822,34744,34545,264,199,"RECORTES CERO-GRUPO VERDE",111
50,"50001",100,77,77,0,0,"RECORTES CERO-GRUPO VERDE",0
5,"5177",158,130,129,0,1,"RECORTES CERO-GRUPO VERDE",0
37,"37070",529,399,392,1,7,"RECORTES CERO-GRUPO VERDE",1
3,"3077",1371,1071,1060,13,11,"RECORTES CERO-GRUPO VERDE",0
12,"12113",83,67,66,3,1,"RECORTES CERO-GRUPO VERDE",0
18,"18175",11670,8200,8097,36,103,"RECORTES CERO-GRUPO VERDE",9
47,"47192",102,83,81,1,2,"RECORTES CERO-GRUPO VERDE",0
9,"9120",38,32,32,1,0,"RECORTES CERO-GRUPO VERDE",0
46,"46186",19068,14599,14474,69,125,"RECORTES CERO-GRUPO VERDE",48
9,"9250",269,196,194,1,2,"RECORTES CERO-GRUPO VERDE",0
37,"37329",42,34,34,0,0,"RECORTES CERO-GRUPO VERDE",0
3,"3078",478,389,389,5,0,"RECORTES CERO-GRUPO VERDE",0
45,"45110",1786,1403,1398,5,5,"RECORTES CERO-GRUPO VERDE",0
25,"25239",590,258,256,5,2,"RECORTES CERO-GRUPO VERDE",0
8,"8227",2326,1508,1487,20,21,"RECORTES CERO-GRUPO VERDE",2
49,"49154",127,78,77,0,1,"RECORTES CERO-GRUPO VERDE",0
24,"24116",417,314,309,1,5,"RECORTES CERO-GRUPO VERDE",0
18,"18038",1066,828,802,1,26,"RECORTES CERO-GRUPO VERDE",0
24,"24183",805,555,549,6,6,"RECORTES CERO-GRUPO VERDE",0
16,"16036",126,109,106,0,3,"RECORTES CERO-GRUPO VERDE",0
9,"9347",143,117,115,2,2,"RECORTES CERO-GRUPO VERDE",0
25,"25240",1383,925,919,16,6,"RECORTES CERO-GRUPO VERDE",1
9,"9122",94,67,66,1,1,"RECORTES CERO-GRUPO VERDE",0
22,"22155",76,51,51,0,0,"RECORTES CERO-GRUPO VERDE",0
46,"46004",1922,1565,1547,11,18,"RECORTES CERO-GRUPO VERDE",3
5,"5180",86,67,63,3,4,"RECORTES CERO-GRUPO VERDE",0
16,"16176",38,30,30,0,0,"RECORTES CERO-GRUPO VERDE",0
47,"47113",159,129,128,0,1,"RECORTES CERO-GRUPO VERDE",0
19,"19318",25,18,18,0,0,"RECORTES CERO-GRUPO VERDE",0
7,"7020",3581,2542,2502,43,40,"RECORTES CERO-GRUPO VERDE",12
41,"41094",6288,4497,4449,38,48,"RECORTES CERO-GRUPO VERDE",9
15,"15016",4749,3058,3020,19,38,"RECORTES CERO-GRUPO VERDE",5
19,"19092",409,306,300,1,6,"RECORTES CERO-GRUPO VERDE",0
37,"37331",212,137,135,0,2,"RECORTES CERO-GRUPO VERDE",0
29,"29077",199,149,146,2,3,"RECORTES CERO-GRUPO VERDE",0
6,"6052",4030,2735,2688,20,47,"RECORTES CERO-GRUPO VERDE",3
34,"34185",63,38,37,2,1,"RECORTES CERO-GRUPO VERDE",0
22,"22069",429,333,331,2,2,"RECORTES CERO-GRUPO VERDE",0
10,"10156",97,73,72,1,1,"RECORTES CERO-GRUPO VERDE",0
28,"28109",1576,1103,1098,1,5,"RECORTES CERO-GRUPO VERDE",3
34,"34074",707,540,531,9,9,"RECORTES CERO-GRUPO VERDE",3
2,"2072",1549,1086,1070,2,16,"RECORTES CERO-GRUPO VERDE",0
40,"40124",237,182,177,6,5,"RECORTES CERO-GRUPO VERDE",1
19,"19319",4449,3086,3056,18,30,"RECORTES CERO-GRUPO VERDE",6
2,"2032",276,207,202,1,5,"RECORTES CERO-GRUPO VERDE",0
3,"3080",1300,1035,1025,3,10,"RECORTES CERO-GRUPO VERDE",1
5,"5134",48,38,38,0,0,"RECORTES CERO-GRUPO VERDE",0
15,"15017",19420,13661,13505,175,156,"RECORTES CERO-GRUPO VERDE",51
8,"8067",5739,3616,3577,47,39,"RECORTES CERO-GRUPO VERDE",6
46,"46084",1576,1263,1242,5,21,"RECORTES CERO-GRUPO VERDE",1
37,"37333",224,142,142,1,0,"RECORTES CERO-GRUPO VERDE",0
17,"17039",1759,1159,1145,14,14,"RECORTES CERO-GRUPO VERDE",0
24,"24223",2610,1917,1908,39,9,"RECORTES CERO-GRUPO VERDE",2
43,"43111",2044,1291,1275,9,16,"RECORTES CERO-GRUPO VERDE",3
35,"35020",6034,3992,3934,20,58,"RECORTES CERO-GRUPO VERDE",4
4,"4096",266,209,208,0,1,"RECORTES CERO-GRUPO VERDE",0
17,"17160",14747,9189,9129,65,60,"RECORTES CERO-GRUPO VERDE",21
22,"22203",83,67,67,1,0,"RECORTES CERO-GRUPO VERDE",0
41,"41075",10212,6419,6295,49,124,"RECORTES CERO-GRUPO VERDE",6
9,"9125",584,432,430,1,2,"RECORTES CERO-GRUPO VERDE",2
5,"5184",246,183,183,0,0,"RECORTES CERO-GRUPO VERDE",0
24,"24120",341,246,244,1,2,"RECORTES CERO-GRUPO VERDE",0
16,"16042",1157,933,921,4,12,"RECORTES CERO-GRUPO VERDE",0
40,"40126",79,56,54,0,2,"RECORTES CERO-GRUPO VERDE",0
3,"3082",12567,8537,8464,44,73,"RECORTES CERO-GRUPO VERDE",21
8,"8192",5678,3729,3707,35,22,"RECORTES CERO-GRUPO VERDE",7
4,"4097",248,189,189,1,0,"RECORTES CERO-GRUPO VERDE",0
45,"45115",2552,1999,1966,8,33,"RECORTES CERO-GRUPO VERDE",4
17,"17161",992,726,721,10,5,"RECORTES CERO-GRUPO VERDE",1
42,"42118",23,17,17,0,0,"RECORTES CERO-GRUPO VERDE",0
12,"12119",148,95,93,0,2,"RECORTES CERO-GRUPO VERDE",1
44,"44074",429,333,326,4,7,"RECORTES CERO-GRUPO VERDE",1
47,"47116",416,341,339,0,2,"RECORTES CERO-GRUPO VERDE",0
46,"46138",343,275,272,1,3,"RECORTES CERO-GRUPO VERDE",1
26,"26118",59,48,48,2,0,"RECORTES CERO-GRUPO VERDE",0
49,"49002",63,51,49,0,2,"RECORTES CERO-GRUPO VERDE",0
25,"25118",346,198,189,3,9,"RECORTES CERO-GRUPO VERDE",0
9,"9128",80,63,63,0,0,"RECORTES CERO-GRUPO VERDE",0
49,"49160",49,33,33,0,0,"RECORTES CERO-GRUPO VERDE",1
8,"8070",266,194,191,2,3,"RECORTES CERO-GRUPO VERDE",2
19,"19324",176,126,125,3,1,"RECORTES CERO-GRUPO VERDE",0
14,"14063",1046,734,725,2,9,"RECORTES CERO-GRUPO VERDE",0
44,"44247",316,218,215,3,3,"RECORTES CERO-GRUPO VERDE",1
10,"10039",417,291,291,0,0,"RECORTES CERO-GRUPO VERDE",0
27,"27011",2452,1494,1467,19,27,"RECORTES CERO-GRUPO VERDE",3
5,"5187",1754,1323,1303,7,20,"RECORTES CERO-GRUPO VERDE",0
9,"9129",104,83,83,0,0,"RECORTES CERO-GRUPO VERDE",0
9,"9006",59,39,39,0,0,"RECORTES CERO-GRUPO VERDE",0
26,"26082",112,87,87,1,0,"RECORTES CERO-GRUPO VERDE",0
5,"5188",45,39,38,0,1,"RECORTES CERO-GRUPO VERDE",0
25,"25249",182,99,98,1,1,"RECORTES CERO-GRUPO VERDE",0
16,"16045",222,172,171,1,1,"RECORTES CERO-GRUPO VERDE",0
37,"37211",224,172,172,4,0,"RECORTES CERO-GRUPO VERDE",0
26,"26050",113,88,85,0,3,"RECORTES CERO-GRUPO VERDE",0
24,"24227",1607,1127,1116,22,11,"RECORTES CERO-GRUPO VERDE",3
32,"32077",1166,791,785,14,6,"RECORTES CERO-GRUPO VERDE",0
26,"26083",284,205,205,2,0,"RECORTES CERO-GRUPO VERDE",0
34,"34199",1218,918,899,10,19,"RECORTES CERO-GRUPO VERDE",2
3,"3085",272,217,213,0,4,"RECORTES CERO-GRUPO VERDE",0
9,"9403",94,78,78,1,0,"RECORTES CERO-GRUPO VERDE",0
14,"14008",2839,1905,1895,19,10,"RECORTES CERO-GRUPO VERDE",0
31,"31163",2013,1418,1383,13,35,"RECORTES CERO-GRUPO VERDE",4
46,"46166",8155,6320,6251,30,69,"RECORTES CERO-GRUPO VERDE",15
16,"16047",232,175,175,2,0,"RECORTES CERO-GRUPO VERDE",0
8,"8033",12813,8564,8509,63,55,"RECORTES CERO-GRUPO VERDE",14
25,"25251",707,443,442,2,1,"RECORTES CERO-GRUPO VERDE",1
50,"50291",96,74,74,0,0,"RECORTES CERO-GRUPO VERDE",0
10,"10180",4134,2643,2601,25,42,"RECORTES CERO-GRUPO VERDE",4
19,"19326",1841,1280,1272,1,8,"RECORTES CERO-GRUPO VERDE",5
8,"8074",10611,6728,6679,52,49,"RECORTES CERO-GRUPO VERDE",14
45,"45018",498,333,330,4,3,"RECORTES CERO-GRUPO VERDE",3
25,"25122",1915,1208,1197,16,11,"RECORTES CERO-GRUPO VERDE",1
8,"8198",4411,2972,2954,23,18,"RECORTES CERO-GRUPO VERDE",11
42,"42124",64,49,49,0,0,"RECORTES CERO-GRUPO VERDE",0
33,"33022",893,578,567,11,11,"RECORTES CERO-GRUPO VERDE",1
19,"19103",251,208,208,2,0,"RECORTES CERO-GRUPO VERDE",0
18,"18187",557,383,379,0,4,"RECORTES CERO-GRUPO VERDE",0
26,"26086",16,15,15,1,0,"RECORTES CERO-GRUPO VERDE",0
50,"50104",348,271,269,2,2,"RECORTES CERO-GRUPO VERDE",0
24,"24229",418,322,319,2,3,"RECORTES CERO-GRUPO VERDE",0
43,"43159",81,59,59,0,0,"RECORTES CERO-GRUPO VERDE",0
9,"9132",171,122,122,2,0,"RECORTES CERO-GRUPO VERDE",0
50,"50292",125,102,102,1,0,"RECORTES CERO-GRUPO VERDE",0
4,"4038",3084,2140,2126,16,14,"RECORTES CERO-GRUPO VERDE",1
41,"41014",2492,1882,1852,11,30,"RECORTES CERO-GRUPO VERDE",0
34,"34204",46,41,41,0,0,"RECORTES CERO-GRUPO VERDE",0
7,"7031",23833,14836,14707,124,129,"RECORTES CERO-GRUPO VERDE",61
45,"45120",129,104,104,1,0,"RECORTES CERO-GRUPO VERDE",0
19,"19018",155,119,118,3,1,"RECORTES CERO-GRUPO VERDE",0
45,"45154",1493,1079,1074,6,5,"RECORTES CERO-GRUPO VERDE",1
32,"32081",2077,1517,1500,14,17,"RECORTES CERO-GRUPO VERDE",4
5,"5047",4163,3198,3142,17,56,"RECORTES CERO-GRUPO VERDE",4
40,"40134",731,579,570,1,9,"RECORTES CERO-GRUPO VERDE",0
24,"24230",426,322,320,5,2,"RECORTES CERO-GRUPO VERDE",0
5,"5193",193,167,164,1,3,"RECORTES CERO-GRUPO VERDE",0
12,"12094",847,674,665,5,9,"RECORTES CERO-GRUPO VERDE",0
50,"50201",448,339,335,7,4,"RECORTES CERO-GRUPO VERDE",0
9,"9267",111,99,97,1,2,"RECORTES CERO-GRUPO VERDE",0
24,"24901",889,636,623,5,13,"RECORTES CERO-GRUPO VERDE",0
47,"47122",2032,1563,1535,7,28,"RECORTES CERO-GRUPO VERDE",0
5,"5194",140,119,116,1,3,"RECORTES CERO-GRUPO VERDE",0
44,"44084",54,41,41,0,0,"RECORTES CERO-GRUPO VERDE",0
28,"28127",64827,51776,51613,220,163,"RECORTES CERO-GRUPO VERDE",61
45,"45122",5212,4004,3961,16,43,"RECORTES CERO-GRUPO VERDE",9
33,"33025",9174,5838,5786,57,52,"RECORTES CERO-GRUPO VERDE",6
40,"40135",283,236,231,2,5,"RECORTES CERO-GRUPO VERDE",0
13,"13072",768,579,572,5,7,"RECORTES CERO-GRUPO VERDE",2
26,"26089",110582,82972,82186,588,786,"RECORTES CERO-GRUPO VERDE",179
36,"36026",20137,13779,13596,141,183,"RECORTES CERO-GRUPO VERDE",33
17,"17170",171,125,123,1,2,"RECORTES CERO-GRUPO VERDE",0
19,"19106",89,59,59,0,0,"RECORTES CERO-GRUPO VERDE",0
10,"10186",977,795,778,1,17,"RECORTES CERO-GRUPO VERDE",1
14,"14012",6173,4364,4291,35,73,"RECORTES CERO-GRUPO VERDE",5
19,"19219",13,9,9,0,0,"RECORTES CERO-GRUPO VERDE",0
3,"3090",17182,12487,12385,74,102,"RECORTES CERO-GRUPO VERDE",19
31,"31168",246,172,171,1,1,"RECORTES CERO-GRUPO VERDE",0
46,"46248",4897,3596,3544,18,52,"RECORTES CERO-GRUPO VERDE",1
9,"9136",192,142,137,2,5,"RECORTES CERO-GRUPO VERDE",0
9,"9013",48,37,37,0,0,"RECORTES CERO-GRUPO VERDE",0
29,"29022",179,137,136,0,1,"RECORTES CERO-GRUPO VERDE",0
9,"9394",715,533,521,3,12,"RECORTES CERO-GRUPO VERDE",1
12,"12116",58,49,49,0,0,"RECORTES CERO-GRUPO VERDE",0
3,"3060",109,91,91,0,0,"RECORTES CERO-GRUPO VERDE",0
10,"10049",3819,3031,2950,18,81,"RECORTES CERO-GRUPO VERDE",6
15,"15030",200176,143255,142070,1452,1185,"RECORTES CERO-GRUPO VERDE",341
44,"44086",449,342,336,3,6,"RECORTES CERO-GRUPO VERDE",0
3,"3091",252,217,215,2,2,"RECORTES CERO-GRUPO VERDE",0
25,"25001",144,73,73,0,0,"RECORTES CERO-GRUPO VERDE",0
29,"29034",467,358,356,0,2,"RECORTES CERO-GRUPO VERDE",0
44,"44190",71,58,56,0,2,"RECORTES CERO-GRUPO VERDE",0
7,"7036",26955,18578,18433,148,145,"RECORTES CERO-GRUPO VERDE",75
34,"34061",106,82,82,1,0,"RECORTES CERO-GRUPO VERDE",0
10,"10005",540,377,362,3,15,"RECORTES CERO-GRUPO VERDE",0
8,"8204",3055,2094,2082,17,12,"RECORTES CERO-GRUPO VERDE",11
44,"44087",80,69,67,1,2,"RECORTES CERO-GRUPO VERDE",0
48,"48060",3634,2143,2134,7,9,"RECORTES CERO-GRUPO VERDE",1
46,"46015",7244,5615,5560,40,55,"RECORTES CERO-GRUPO VERDE",8
23,"23027",723,576,572,3,4,"RECORTES CERO-GRUPO VERDE",0
8,"8081",339,222,221,3,1,"RECORTES CERO-GRUPO VERDE",0
41,"41019",4691,3089,3056,27,33,"RECORTES CERO-GRUPO VERDE",3
40,"40140",92,69,67,0,2,"RECORTES CERO-GRUPO VERDE",0
50,"50110",367,256,254,0,2,"RECORTES CERO-GRUPO VERDE",0
26,"26093",53,39,38,0,1,"RECORTES CERO-GRUPO VERDE",0
31,"31906",2562,1800,1779,26,21,"RECORTES CERO-GRUPO VERDE",9
45,"45025",1205,831,827,2,4,"RECORTES CERO-GRUPO VERDE",0
17,"17055",150,110,109,0,1,"RECORTES CERO-GRUPO VERDE",0
16,"16057",75,63,63,0,0,"RECORTES CERO-GRUPO VERDE",0
21,"21012",316,235,233,2,2,"RECORTES CERO-GRUPO VERDE",0
10,"10053",287,215,210,1,5,"RECORTES CERO-GRUPO VERDE",0
44,"44049",849,616,604,9,12,"RECORTES CERO-GRUPO VERDE",1
49,"49172",527,347,343,1,4,"RECORTES CERO-GRUPO VERDE",0
33,"33029",350,181,174,2,7,"RECORTES CERO-GRUPO VERDE",0
17,"17174",178,99,97,2,2,"RECORTES CERO-GRUPO VERDE",1
37,"37349",117,88,88,0,0,"RECORTES CERO-GRUPO VERDE",0
34,"34063",83,76,75,1,1,"RECORTES CERO-GRUPO VERDE",0
7,"7039",4839,3136,3060,31,76,"RECORTES CERO-GRUPO VERDE",9
34,"34214",183,144,144,0,0,"RECORTES CERO-GRUPO VERDE",0
30,"30020",6303,4543,4497,25,46,"RECORTES CERO-GRUPO VERDE",0
31,"31072",5279,3734,3679,40,55,"RECORTES CERO-GRUPO VERDE",8
40,"40142",53,39,37,0,2,"RECORTES CERO-GRUPO VERDE",0
31,"31040",192,139,138,4,1,"RECORTES CERO-GRUPO VERDE",0
39,"39083",1135,679,670,8,9,"RECORTES CERO-GRUPO VERDE",0
16,"16014",602,485,483,0,2,"RECORTES CERO-GRUPO VERDE",0
19,"19067",70,52,51,1,1,"RECORTES CERO-GRUPO VERDE",0
9,"9140",124,80,79,0,1,"RECORTES CERO-GRUPO VERDE",0
8,"8084",1142,773,768,14,5,"RECORTES CERO-GRUPO VERDE",1
24,"24034",3394,2380,2342,28,38,"RECORTES CERO-GRUPO VERDE",2
26,"26095",100,83,82,0,1,"RECORTES CERO-GRUPO VERDE",0
16,"16205",115,88,87,0,1,"RECORTES CERO-GRUPO VERDE",0
44,"44090",78,53,53,0,0,"RECORTES CERO-GRUPO VERDE",0
4,"4048",1503,1090,1085,9,5,"RECORTES CERO-GRUPO VERDE",1
43,"43169",450,370,367,10,3,"RECORTES CERO-GRUPO VERDE",0
22,"22176",173,134,130,1,4,"RECORTES CERO-GRUPO VERDE",0
3,"3064",5015,3660,3611,11,49,"RECORTES CERO-GRUPO VERDE",4
5,"5158",367,290,286,6,4,"RECORTES CERO-GRUPO VERDE",0
19,"19225",823,623,619,3,4,"RECORTES CERO-GRUPO VERDE",0
12,"12034",1424,1065,1035,3,30,"RECORTES CERO-GRUPO VERDE",0
33,"33031",35120,22295,22024,271,271,"RECORTES CERO-GRUPO VERDE",31
37,"37352",207,153,152,1,1,"RECORTES CERO-GRUPO VERDE",0
18,"18063",1200,679,675,2,4,"RECORTES CERO-GRUPO VERDE",0
3,"3004",581,438,437,2,1,"RECORTES CERO-GRUPO VERDE",0
32,"32002",2017,1413,1398,16,15,"RECORTES CERO-GRUPO VERDE",1
46,"46019",8849,7072,7004,33,68,"RECORTES CERO-GRUPO VERDE",12
8,"8210",4329,2624,2594,31,30,"RECORTES CERO-GRUPO VERDE",3
41,"41023",7905,5402,5347,41,55,"RECORTES CERO-GRUPO VERDE",4
8,"8087",152,121,121,2,0,"RECORTES CERO-GRUPO VERDE",0
44,"44092",81,59,57,0,2,"RECORTES CERO-GRUPO VERDE",0
36,"36034",3475,2403,2367,11,36,"RECORTES CERO-GRUPO VERDE",9
25,"25007",1405,850,841,8,9,"RECORTES CERO-GRUPO VERDE",1
21,"21017",3600,2187,2164,26,23,"RECORTES CERO-GRUPO VERDE",5
47,"47210",382,282,274,3,8,"RECORTES CERO-GRUPO VERDE",0
49,"49057",109,85,83,1,2,"RECORTES CERO-GRUPO VERDE",0
50,"50020",809,564,559,2,5,"RECORTES CERO-GRUPO VERDE",2
22,"22053",789,520,513,9,7,"RECORTES CERO-GRUPO VERDE",0
23,"23033",1352,1045,1034,12,11,"RECORTES CERO-GRUPO VERDE",3
20,"20003",547,308,308,3,0,"RECORTES CERO-GRUPO VERDE",0
37,"37354",5240,3823,3771,39,52,"RECORTES CERO-GRUPO VERDE",9
33,"33032",11395,7592,7465,90,127,"RECORTES CERO-GRUPO VERDE",9
38,"38011",20570,13831,13698,75,133,"RECORTES CERO-GRUPO VERDE",45
12,"12002",110,99,98,1,1,"RECORTES CERO-GRUPO VERDE",0
45,"45098",2159,1632,1609,12,23,"RECORTES CERO-GRUPO VERDE",0
8,"8048",582,419,417,4,2,"RECORTES CERO-GRUPO VERDE",1
24,"24139",2183,1548,1525,16,23,"RECORTES CERO-GRUPO VERDE",2
26,"26064",2275,1659,1638,17,21,"RECORTES CERO-GRUPO VERDE",5
40,"40105",47,42,42,2,0,"RECORTES CERO-GRUPO VERDE",0
41,"41025",2020,1361,1320,7,41,"RECORTES CERO-GRUPO VERDE",2
5,"5063",32,28,27,0,1,"RECORTES CERO-GRUPO VERDE",0
28,"28135",948,713,709,4,4,"RECORTES CERO-GRUPO VERDE",1
34,"34071",171,132,132,1,0,"RECORTES CERO-GRUPO VERDE",0
37,"37104",27,22,22,0,0,"RECORTES CERO-GRUPO VERDE",0
10,"10060",967,648,640,2,8,"RECORTES CERO-GRUPO VERDE",0
50,"50116",182,136,132,0,4,"RECORTES CERO-GRUPO VERDE",0
1,"1043",2304,1552,1532,13,20,"RECORTES CERO-GRUPO VERDE",3
22,"22055",320,243,238,2,5,"RECORTES CERO-GRUPO VERDE",0
16,"16065",388,320,314,2,6,"RECORTES CERO-GRUPO VERDE",0
12,"12134",141,95,94,0,1,"RECORTES CERO-GRUPO VERDE",0
8,"8090",128,101,101,2,0,"RECORTES CERO-GRUPO VERDE",0
5,"5211",459,345,343,1,2,"RECORTES CERO-GRUPO VERDE",0
17,"17182",263,181,181,6,0,"RECORTES CERO-GRUPO VERDE",0
50,"50273",30,22,22,0,0,"RECORTES CERO-GRUPO VERDE",0
25,"25137",8585,5143,5095,56,48,"RECORTES CERO-GRUPO VERDE",4
19,"19116",12,9,9,0,0,"RECORTES CERO-GRUPO VERDE",0
27,"27038",935,679,671,7,8,"RECORTES CERO-GRUPO VERDE",3
42,"42013",34,28,27,0,1,"RECORTES CERO-GRUPO VERDE",0
16,"16066",2325,1788,1745,19,43,"RECORTES CERO-GRUPO VERDE",1
15,"15040",2753,1905,1880,5,25,"RECORTES CERO-GRUPO VERDE",2
47,"47131",170,134,128,2,6,"RECORTES CERO-GRUPO VERDE",0
31,"31178",490,345,342,3,3,"RECORTES CERO-GRUPO VERDE",2
12,"12039",833,717,710,4,7,"RECORTES CERO-GRUPO VERDE",1
21,"21021",12254,7339,7244,78,95,"RECORTES CERO-GRUPO VERDE",13
14,"14021",260178,181773,180348,1872,1425,"RECORTES CERO-GRUPO VERDE",241
9,"9378",31,24,23,0,1,"RECORTES CERO-GRUPO VERDE",0
7,"7007",421,296,293,2,3,"RECORTES CERO-GRUPO VERDE",3
7,"7047",2246,1517,1482,18,35,"RECORTES CERO-GRUPO VERDE",2
34,"34073",185,149,149,0,0,"RECORTES CERO-GRUPO VERDE",0
12,"12136",2635,2201,2171,18,30,"RECORTES CERO-GRUPO VERDE",1
6,"6082",383,287,286,2,1,"RECORTES CERO-GRUPO VERDE",0
26,"26102",6111,4486,4435,28,51,"RECORTES CERO-GRUPO VERDE",4
31,"31080",508,391,385,3,6,"RECORTES CERO-GRUPO VERDE",0
10,"10064",1476,1092,1072,7,20,"RECORTES CERO-GRUPO VERDE",0
20,"20007",310,218,218,3,0,"RECORTES CERO-GRUPO VERDE",0
40,"40094",374,279,276,2,3,"RECORTES CERO-GRUPO VERDE",1
18,"18027",2570,1711,1700,13,11,"RECORTES CERO-GRUPO VERDE",5
18,"18117",506,383,373,1,10,"RECORTES CERO-GRUPO VERDE",3
22,"22058",194,164,162,1,2,"RECORTES CERO-GRUPO VERDE",0
3,"3009",46657,35143,34801,223,342,"RECORTES CERO-GRUPO VERDE",80
45,"45034",1353,1082,1078,6,4,"RECORTES CERO-GRUPO VERDE",0
24,"24042",63,56,56,1,0,"RECORTES CERO-GRUPO VERDE",0
40,"40152",760,592,584,3,8,"RECORTES CERO-GRUPO VERDE",3
50,"50025",4562,3158,3124,31,34,"RECORTES CERO-GRUPO VERDE",0
2,"2019",2405,1871,1835,12,36,"RECORTES CERO-GRUPO VERDE",1
45,"45135",4269,3340,3288,8,52,"RECORTES CERO-GRUPO VERDE",2
3,"3102",7229,5492,5414,52,78,"RECORTES CERO-GRUPO VERDE",7
34,"34225",4921,3588,3559,30,29,"RECORTES CERO-GRUPO VERDE",7
45,"45035",281,212,209,1,3,"RECORTES CERO-GRUPO VERDE",1
26,"26002",830,632,622,0,10,"RECORTES CERO-GRUPO VERDE",0
18,"18028",928,765,758,2,7,"RECORTES CERO-GRUPO VERDE",1
24,"24213",150,122,122,1,0,"RECORTES CERO-GRUPO VERDE",1
8,"8095",73,48,47,0,1,"RECORTES CERO-GRUPO VERDE",0
25,"25014",260,165,165,5,0,"RECORTES CERO-GRUPO VERDE",0
49,"49065",1103,836,818,2,18,"RECORTES CERO-GRUPO VERDE",0
47,"47026",46,40,40,1,0,"RECORTES CERO-GRUPO VERDE",0
22,"22141",117,91,90,1,1,"RECORTES CERO-GRUPO VERDE",0
46,"46103",1264,1015,984,7,31,"RECORTES CERO-GRUPO VERDE",2
37,"37237",324,244,240,1,4,"RECORTES CERO-GRUPO VERDE",0
14,"14024",1903,1405,1376,16,29,"RECORTES CERO-GRUPO VERDE",1
10,"10068",735,570,557,2,13,"RECORTES CERO-GRUPO VERDE",1
21,"21025",4026,2433,2396,30,37,"RECORTES CERO-GRUPO VERDE",3
9,"9424",36,29,29,1,0,"RECORTES CERO-GRUPO VERDE",0
37,"37362",4632,3389,3351,25,38,"RECORTES CERO-GRUPO VERDE",6
19,"19121",246,199,194,1,5,"RECORTES CERO-GRUPO VERDE",0
44,"44061",70,54,51,0,3,"RECORTES CERO-GRUPO VERDE",0
5,"5073",297,253,252,2,1,"RECORTES CERO-GRUPO VERDE",0
9,"9029",168,131,129,4,2,"RECORTES CERO-GRUPO VERDE",1
7,"7052",4667,2908,2886,29,22,"RECORTES CERO-GRUPO VERDE",12
40,"40028",105,91,90,2,1,"RECORTES CERO-GRUPO VERDE",0
36,"36043",4747,3210,3162,20,48,"RECORTES CERO-GRUPO VERDE",4
10,"10207",504,357,350,6,7,"RECORTES CERO-GRUPO VERDE",0
47,"47135",83,72,72,2,0,"RECORTES CERO-GRUPO VERDE",0
19,"19122",96,68,68,1,0,"RECORTES CERO-GRUPO VERDE",0
9,"9292",87,75,73,1,2,"RECORTES CERO-GRUPO VERDE",0
25,"25017",236,169,167,7,2,"RECORTES CERO-GRUPO VERDE",0
24,"24215",152,113,113,0,0,"RECORTES CERO-GRUPO VERDE",0
12,"12140",1143,939,930,6,9,"RECORTES CERO-GRUPO VERDE",0
9,"9160",85,64,64,0,0,"RECORTES CERO-GRUPO VERDE",0
16,"16225",73,57,57,3,0,"RECORTES CERO-GRUPO VERDE",0
6,"6088",12616,8436,8313,70,123,"RECORTES CERO-GRUPO VERDE",23
19,"19001",49,42,42,0,0,"RECORTES CERO-GRUPO VERDE",0
43,"43904",2900,1602,1573,32,29,"RECORTES CERO-GRUPO VERDE",4
5,"5220",371,309,301,0,8,"RECORTES CERO-GRUPO VERDE",0
1,"1052",245,184,181,0,3,"RECORTES CERO-GRUPO VERDE",1
41,"41033",5075,3313,3277,34,36,"RECORTES CERO-GRUPO VERDE",3
46,"46026",1204,1015,1004,3,11,"RECORTES CERO-GRUPO VERDE",4
5,"5221",351,254,250,2,4,"RECORTES CERO-GRUPO VERDE",0
45,"45106",7439,5613,5534,52,79,"RECORTES CERO-GRUPO VERDE",4
48,"48043",4423,3118,3108,17,10,"RECORTES CERO-GRUPO VERDE",4
31,"31252",87,61,61,0,0,"RECORTES CERO-GRUPO VERDE",0
9,"9428",108,92,91,0,1,"RECORTES CERO-GRUPO VERDE",0
17,"17190",844,528,528,3,0,"RECORTES CERO-GRUPO VERDE",0
15,"15048",4839,3456,3414,36,42,"RECORTES CERO-GRUPO VERDE",7
6,"6090",869,617,602,3,15,"RECORTES CERO-GRUPO VERDE",0
47,"47138",241,170,164,1,6,"RECORTES CERO-GRUPO VERDE",0
50,"50298",5333,3949,3902,39,47,"RECORTES CERO-GRUPO VERDE",0
9,"9162",141,101,101,0,0,"RECORTES CERO-GRUPO VERDE",0
36,"36045",24529,17613,17336,129,277,"RECORTES CERO-GRUPO VERDE",44
26,"26006",1800,1419,1405,8,14,"RECORTES CERO-GRUPO VERDE",1
12,"12046",191,151,150,2,1,"RECORTES CERO-GRUPO VERDE",0
39,"39035",9502,7017,6928,57,89,"RECORTES CERO-GRUPO VERDE",11
6,"6091",3774,2709,2666,23,43,"RECORTES CERO-GRUPO VERDE",0
36,"36046",4036,2971,2921,15,50,"RECORTES CERO-GRUPO VERDE",11
25,"25021",2607,1490,1481,20,9,"RECORTES CERO-GRUPO VERDE",0
37,"37367",201,164,161,0,3,"RECORTES CERO-GRUPO VERDE",0
26,"26109",81,69,69,0,0,"RECORTES CERO-GRUPO VERDE",0
45,"45141",884,700,689,3,11,"RECORTES CERO-GRUPO VERDE",0
49,"49275",52210,36205,35754,356,451,"RECORTES CERO-GRUPO VERDE",88
46,"46080",998,803,799,7,4,"RECORTES CERO-GRUPO VERDE",2
47,"47191",108,79,79,0,0,"RECORTES CERO-GRUPO VERDE",0
49,"49152",525,339,334,2,5,"RECORTES CERO-GRUPO VERDE",0
3,"3016",93,75,75,0,0,"RECORTES CERO-GRUPO VERDE",0
32,"32019",11537,7975,7861,56,114,"RECORTES CERO-GRUPO VERDE",17
16,"16082",291,213,212,0,1,"RECORTES CERO-GRUPO VERDE",0
21,"21032",1800,1286,1259,10,27,"RECORTES CERO-GRUPO VERDE",0
26,"26110",152,131,129,0,2,"RECORTES CERO-GRUPO VERDE",0
40,"40160",102,71,70,1,1,"RECORTES CERO-GRUPO VERDE",0
31,"31088",5572,3897,3862,44,35,"RECORTES CERO-GRUPO VERDE",18
37,"37118",123,92,90,0,2,"RECORTES CERO-GRUPO VERDE",1
26,"26111",242,180,176,0,4,"RECORTES CERO-GRUPO VERDE",1
9,"9035",311,227,225,2,2,"RECORTES CERO-GRUPO VERDE",0
27,"27053",537,316,308,3,8,"RECORTES CERO-GRUPO VERDE",1
45,"45142",7871,6007,5927,37,80,"RECORTES CERO-GRUPO VERDE",2
42,"42063",49,35,35,0,0,"RECORTES CERO-GRUPO VERDE",0
47,"47220",165,130,129,0,1,"RECORTES CERO-GRUPO VERDE",0
7,"7059",2996,2053,2013,17,40,"RECORTES CERO-GRUPO VERDE",7
36,"36048",5331,3653,3603,22,50,"RECORTES CERO-GRUPO VERDE",8
12,"12902",2158,1504,1489,14,15,"RECORTES CERO-GRUPO VERDE",2
16,"16237",110,87,87,0,0,"RECORTES CERO-GRUPO VERDE",0
5,"5178",368,284,280,0,4,"RECORTES CERO-GRUPO VERDE",0
28,"28078",38,32,32,0,0,"RECORTES CERO-GRUPO VERDE",0
13,"13001",1254,934,925,6,9,"RECORTES CERO-GRUPO VERDE",0
49,"49238",254,194,193,1,1,"RECORTES CERO-GRUPO VERDE",0
34,"34182",786,606,597,10,9,"RECORTES CERO-GRUPO VERDE",2
31,"31189",1161,720,709,6,11,"RECORTES CERO-GRUPO VERDE",1
37,"37072",168,140,138,0,2,"RECORTES CERO-GRUPO VERDE",0
9,"9037",111,91,91,0,0,"RECORTES CERO-GRUPO VERDE",0
36,"36049",6804,4960,4860,36,100,"RECORTES CERO-GRUPO VERDE",13
29,"29054",41997,28422,28238,189,184,"RECORTES CERO-GRUPO VERDE",62
5,"5228",174,121,120,0,1,"RECORTES CERO-GRUPO VERDE",0
19,"19129",28,26,26,0,0,"RECORTES CERO-GRUPO VERDE",0
50,"50129",235,161,158,2,3,"RECORTES CERO-GRUPO VERDE",0
5,"5229",82,68,67,0,1,"RECORTES CERO-GRUPO VERDE",0
28,"28148",85454,62367,61884,370,483,"RECORTES CERO-GRUPO VERDE",155
52,"52001",53306,27373,27012,267,361,"RECORTES CERO-GRUPO VERDE",43
21,"21035",9617,6033,5943,76,90,"RECORTES CERO-GRUPO VERDE",7
9,"9168",290,217,217,3,0,"RECORTES CERO-GRUPO VERDE",0
45,"45144",783,620,618,3,2,"RECORTES CERO-GRUPO VERDE",0
19,"19130",60145,45531,45085,286,446,"RECORTES CERO-GRUPO VERDE",82
3,"3079",18224,13904,13709,80,195,"RECORTES CERO-GRUPO VERDE",21
46,"46031",10535,7543,7451,66,92,"RECORTES CERO-GRUPO VERDE",14
16,"16086",890,740,735,6,5,"RECORTES CERO-GRUPO VERDE",0
9,"9303",86,68,68,0,0,"RECORTES CERO-GRUPO VERDE",0
19,"19243",44,31,31,0,0,"RECORTES CERO-GRUPO VERDE",0
29,"29044",809,561,561,3,0,"RECORTES CERO-GRUPO VERDE",1
27,"27058",3495,2510,2480,30,30,"RECORTES CERO-GRUPO VERDE",3
37,"37373",748,503,499,1,4,"RECORTES CERO-GRUPO VERDE",0
17,"17196",220,150,150,4,0,"RECORTES CERO-GRUPO VERDE",0
26,"26012",23,23,23,1,0,"RECORTES CERO-GRUPO VERDE",0
49,"49157",206,163,160,2,3,"RECORTES CERO-GRUPO VERDE",0
21,"21037",472,341,336,2,5,"RECORTES CERO-GRUPO VERDE",1
1,"1059",186557,126506,125278,798,1228,"RECORTES CERO-GRUPO VERDE",509
47,"47223",157,122,118,2,4,"RECORTES CERO-GRUPO VERDE",0
4,"4065",363,284,282,7,2,"RECORTES CERO-GRUPO VERDE",0
19,"19132",92,81,81,0,0,"RECORTES CERO-GRUPO VERDE",0
14,"14032",423,334,330,4,4,"RECORTES CERO-GRUPO VERDE",0
20,"20019",9986,6428,6392,48,36,"RECORTES CERO-GRUPO VERDE",8
9,"9039",58,46,46,2,0,"RECORTES CERO-GRUPO VERDE",0
16,"16185",43,37,37,0,0,"RECORTES CERO-GRUPO VERDE",0
23,"23052",1125,936,922,4,14,"RECORTES CERO-GRUPO VERDE",0
8,"8232",1775,1183,1176,6,7,"RECORTES CERO-GRUPO VERDE",2
37,"37250",356,229,228,0,1,"RECORTES CERO-GRUPO VERDE",0
9,"9395",138,104,104,0,0,"RECORTES CERO-GRUPO VERDE",0
33,"33017",3144,2094,2071,35,23,"RECORTES CERO-GRUPO VERDE",3
4,"4066",13571,8786,8724,50,62,"RECORTES CERO-GRUPO VERDE",4
40,"40166",253,218,215,1,3,"RECORTES CERO-GRUPO VERDE",0
9,"9041",28,27,27,0,0,"RECORTES CERO-GRUPO VERDE",0
45,"45048",358,278,275,1,3,"RECORTES CERO-GRUPO VERDE",1
34,"34093",85,70,70,0,0,"RECORTES CERO-GRUPO VERDE",0
5,"5088",30,23,23,0,0,"RECORTES CERO-GRUPO VERDE",0
26,"26080",472,391,389,0,2,"RECORTES CERO-GRUPO VERDE",0
12,"12118",72,55,53,0,2,"RECORTES CERO-GRUPO VERDE",1
9,"9438",538,437,433,6,4,"RECORTES CERO-GRUPO VERDE",2
44,"44213",62,50,50,0,0,"RECORTES CERO-GRUPO VERDE",0
18,"18089",14719,10163,10099,63,64,"RECORTES CERO-GRUPO VERDE",11
33,"33049",6322,4116,4062,43,54,"RECORTES CERO-GRUPO VERDE",6
24,"24056",2883,2040,2003,11,37,"RECORTES CERO-GRUPO VERDE",1
10,"10085",323,235,233,0,2,"RECORTES CERO-GRUPO VERDE",0
6,"6148",966,691,678,8,13,"RECORTES CERO-GRUPO VERDE",0
9,"9082",39,36,36,0,0,"RECORTES CERO-GRUPO VERDE",0
36,"36019",1625,1042,1029,9,13,"RECORTES CERO-GRUPO VERDE",0
46,"46034",1758,1390,1379,4,11,"RECORTES CERO-GRUPO VERDE",3
34,"34242",95,71,68,3,3,"RECORTES CERO-GRUPO VERDE",0
5,"5089",485,384,376,0,8,"RECORTES CERO-GRUPO VERDE",0
9,"9173",124,100,99,2,1,"RECORTES CERO-GRUPO VERDE",0
8,"8111",218,185,184,3,1,"RECORTES CERO-GRUPO VERDE",0
18,"18182",1906,1298,1288,4,10,"RECORTES CERO-GRUPO VERDE",0
24,"24122",1342,930,924,8,6,"RECORTES CERO-GRUPO VERDE",0
25,"25157",181,115,114,7,1,"RECORTES CERO-GRUPO VERDE",1
10,"10904",745,507,504,8,3,"RECORTES CERO-GRUPO VERDE",1
40,"40043",1802,1400,1381,8,19,"RECORTES CERO-GRUPO VERDE",2
10,"10086",320,238,233,1,5,"RECORTES CERO-GRUPO VERDE",0
8,"8112",12911,7790,7723,74,67,"RECORTES CERO-GRUPO VERDE",15
13,"13011",4792,3112,3077,14,35,"RECORTES CERO-GRUPO VERDE",2
22,"22076",311,201,199,0,2,"RECORTES CERO-GRUPO VERDE",0
16,"16093",60,49,47,0,2,"RECORTES CERO-GRUPO VERDE",0
16,"16094",127,96,94,0,2,"RECORTES CERO-GRUPO VERDE",0
34,"34245",307,209,208,5,1,"RECORTES CERO-GRUPO VERDE",1
45,"45117",747,606,601,4,5,"RECORTES CERO-GRUPO VERDE",0
13,"13012",413,274,273,1,1,"RECORTES CERO-GRUPO VERDE",0
8,"8236",1527,1006,999,4,7,"RECORTES CERO-GRUPO VERDE",2
44,"44115",102,90,90,3,0,"RECORTES CERO-GRUPO VERDE",0
8,"8113",52035,32351,32150,254,201,"RECORTES CERO-GRUPO VERDE",56
26,"26017",381,293,293,5,0,"RECORTES CERO-GRUPO VERDE",1
47,"47226",156,123,123,0,0,"RECORTES CERO-GRUPO VERDE",0
40,"40045",109,85,85,2,0,"RECORTES CERO-GRUPO VERDE",0
9,"9441",74,65,65,0,0,"RECORTES CERO-GRUPO VERDE",0
9,"9085",475,347,342,2,5,"RECORTES CERO-GRUPO VERDE",0
45,"45118",1991,1351,1339,6,12,"RECORTES CERO-GRUPO VERDE",5
18,"18096",341,227,224,3,3,"RECORTES CERO-GRUPO VERDE",1
26,"26121",25,22,22,0,0,"RECORTES CERO-GRUPO VERDE",0
44,"44010",175,130,128,1,2,"RECORTES CERO-GRUPO VERDE",0
37,"37256",218,156,152,1,4,"RECORTES CERO-GRUPO VERDE",0
16,"16249",1995,1519,1499,6,20,"RECORTES CERO-GRUPO VERDE",2
27,"27901",2386,1596,1569,25,27,"RECORTES CERO-GRUPO VERDE",2
46,"46036",564,383,378,5,5,"RECORTES CERO-GRUPO VERDE",0
15,"15061",5571,3746,3691,27,55,"RECORTES CERO-GRUPO VERDE",9
48,"48086",2050,1414,1401,5,13,"RECORTES CERO-GRUPO VERDE",0
21,"21044",17591,10679,10558,118,121,"RECORTES CERO-GRUPO VERDE",12
5,"5095",262,225,223,1,2,"RECORTES CERO-GRUPO VERDE",0
22,"22207",125,72,71,2,1,"RECORTES CERO-GRUPO VERDE",0
4,"4071",394,338,337,3,1,"RECORTES CERO-GRUPO VERDE",1
11,"11002",4273,2835,2815,16,20,"RECORTES CERO-GRUPO VERDE",0
9,"9177",1121,757,749,9,8,"RECORTES CERO-GRUPO VERDE",3
37,"37381",147,114,107,2,7,"RECORTES CERO-GRUPO VERDE",0
17,"17204",572,355,354,4,1,"RECORTES CERO-GRUPO VERDE",0
44,"44117",340,271,268,4,3,"RECORTES CERO-GRUPO VERDE",2
5,"5241",3063,2056,2032,15,24,"RECORTES CERO-GRUPO VERDE",1
5,"5096",80,60,59,0,1,"RECORTES CERO-GRUPO VERDE",0
41,"41047",10117,7515,7422,74,93,"RECORTES CERO-GRUPO VERDE",22
45,"45054",3959,2882,2848,12,34,"RECORTES CERO-GRUPO VERDE",3
9,"9178",47,35,35,0,0,"RECORTES CERO-GRUPO VERDE",0
9,"9266",91,74,74,0,0,"RECORTES CERO-GRUPO VERDE",0
18,"18050",1710,1165,1152,3,13,"RECORTES CERO-GRUPO VERDE",3
17,"17088",533,368,366,4,2,"RECORTES CERO-GRUPO VERDE",0
18,"18098",6135,4206,4161,21,45,"RECORTES CERO-GRUPO VERDE",4
5,"5097",475,317,313,0,4,"RECORTES CERO-GRUPO VERDE",1
3,"3120",2406,1753,1720,11,33,"RECORTES CERO-GRUPO VERDE",0
21,"21046",1705,1099,996,16,103,"RECORTES CERO-GRUPO VERDE",1
4,"4072",313,247,245,2,2,"RECORTES CERO-GRUPO VERDE",0
13,"13018",822,642,640,6,2,"RECORTES CERO-GRUPO VERDE",1
11,"11004",88783,51500,51015,513,485,"RECORTES CERO-GRUPO VERDE",118
18,"18099",1584,1228,1206,14,22,"RECORTES CERO-GRUPO VERDE",4
43,"43079",364,248,248,0,0,"RECORTES CERO-GRUPO VERDE",0
32,"32037",728,518,509,6,9,"RECORTES CERO-GRUPO VERDE",1
26,"26124",807,649,639,7,10,"RECORTES CERO-GRUPO VERDE",0
24,"24062",139,98,98,1,0,"RECORTES CERO-GRUPO VERDE",0
17,"17206",146,88,86,1,2,"RECORTES CERO-GRUPO VERDE",2
46,"46254",1000,785,779,6,6,"RECORTES CERO-GRUPO VERDE",0
9,"9051",170,130,128,0,2,"RECORTES CERO-GRUPO VERDE",0
49,"49046",268,203,203,0,0,"RECORTES CERO-GRUPO VERDE",0
34,"34904",315,234,230,2,4,"RECORTES CERO-GRUPO VERDE",0
44,"44119",130,92,91,3,1,"RECORTES CERO-GRUPO VERDE",0
11,"11005",4583,3018,2967,25,51,"RECORTES CERO-GRUPO VERDE",5
49,"49091",260,193,193,0,0,"RECORTES CERO-GRUPO VERDE",0
22,"22212",79,64,62,0,2,"RECORTES CERO-GRUPO VERDE",0
3,"3028",998,818,812,2,6,"RECORTES CERO-GRUPO VERDE",0
13,"13020",4781,3198,3161,31,37,"RECORTES CERO-GRUPO VERDE",11
40,"40179",626,503,493,2,10,"RECORTES CERO-GRUPO VERDE",0
40,"40052",74,60,60,0,0,"RECORTES CERO-GRUPO VERDE",0
17,"17208",995,594,590,8,4,"RECORTES CERO-GRUPO VERDE",1
19,"19146",41,35,32,0,3,"RECORTES CERO-GRUPO VERDE",0
36,"36027",4430,3137,3101,15,36,"RECORTES CERO-GRUPO VERDE",8
4,"4064",2771,2001,1988,13,13,"RECORTES CERO-GRUPO VERDE",0
31,"31169",2193,1472,1445,9,27,"RECORTES CERO-GRUPO VERDE",1
40,"40010",121,102,101,1,1,"RECORTES CERO-GRUPO VERDE",0
8,"8244",5851,4095,4058,36,37,"RECORTES CERO-GRUPO VERDE",18
25,"25169",173,112,111,3,1,"RECORTES CERO-GRUPO VERDE",0
32,"32040",1477,1090,1084,7,6,"RECORTES CERO-GRUPO VERDE",2
19,"19255",79,63,61,1,2,"RECORTES CERO-GRUPO VERDE",0
26,"26126",31,27,27,0,0,"RECORTES CERO-GRUPO VERDE",0
49,"49093",280,223,222,1,1,"RECORTES CERO-GRUPO VERDE",0
22,"22214",128,106,105,3,1,"RECORTES CERO-GRUPO VERDE",0
3,"3030",524,448,440,5,8,"RECORTES CERO-GRUPO VERDE",1
5,"5103",72,52,52,0,0,"RECORTES CERO-GRUPO VERDE",0
21,"21010",14687,8293,8220,92,73,"RECORTES CERO-GRUPO VERDE",9
46,"46041",329,253,252,5,1,"RECORTES CERO-GRUPO VERDE",1
35,"35002",23328,15495,15313,94,182,"RECORTES CERO-GRUPO VERDE",38
42,"42177",69,60,60,1,0,"RECORTES CERO-GRUPO VERDE",0
44,"44121",60,47,47,2,0,"RECORTES CERO-GRUPO VERDE",0
26,"26127",212,181,176,0,5,"RECORTES CERO-GRUPO VERDE",0
40,"40181",4233,3260,3219,23,41,"RECORTES CERO-GRUPO VERDE",3
17,"17210",551,350,349,9,1,"RECORTES CERO-GRUPO VERDE",0
8,"8010",4168,2631,2606,20,25,"RECORTES CERO-GRUPO VERDE",2
31,"31104",1834,1257,1235,16,22,"RECORTES CERO-GRUPO VERDE",7
21,"21052",4583,2734,2663,22,71,"RECORTES CERO-GRUPO VERDE",4
45,"45059",1712,1337,1311,1,26,"RECORTES CERO-GRUPO VERDE",2
50,"50046",178,133,133,5,0,"RECORTES CERO-GRUPO VERDE",1
13,"13025",302,244,244,1,0,"RECORTES CERO-GRUPO VERDE",0
9,"9056",4919,3395,3344,20,51,"RECORTES CERO-GRUPO VERDE",7
37,"37264",65,40,40,0,0,"RECORTES CERO-GRUPO VERDE",0
40,"40182",178,133,130,2,3,"RECORTES CERO-GRUPO VERDE",0
5,"5105",341,249,247,7,2,"RECORTES CERO-GRUPO VERDE",0
13,"13026",438,345,343,2,2,"RECORTES CERO-GRUPO VERDE",0
40,"40055",37,26,26,0,0,"RECORTES CERO-GRUPO VERDE",0
5,"5251",60,42,42,1,0,"RECORTES CERO-GRUPO VERDE",0
42,"42181",412,313,307,2,6,"RECORTES CERO-GRUPO VERDE",0
15,"15070",9069,6090,5976,94,114,"RECORTES CERO-GRUPO VERDE",12
3,"3125",343,254,251,0,3,"RECORTES CERO-GRUPO VERDE",0
19,"19024",8196,5613,5563,28,50,"RECORTES CERO-GRUPO VERDE",19
37,"37005",74,54,54,2,0,"RECORTES CERO-GRUPO VERDE",0
42,"42044",54,42,39,0,3,"RECORTES CERO-GRUPO VERDE",0
26,"26026",1321,1039,1025,6,14,"RECORTES CERO-GRUPO VERDE",0
14,"14016",1337,1072,1060,2,12,"RECORTES CERO-GRUPO VERDE",0
40,"40100",270,213,211,2,2,"RECORTES CERO-GRUPO VERDE",0
24,"24002",231,173,172,1,1,"RECORTES CERO-GRUPO VERDE",0
8,"8165",1649,1100,1085,9,15,"RECORTES CERO-GRUPO VERDE",3
1,"1037",587,411,408,1,3,"RECORTES CERO-GRUPO VERDE",1
47,"47154",152,128,125,1,3,"RECORTES CERO-GRUPO VERDE",0
40,"40184",258,211,210,2,1,"RECORTES CERO-GRUPO VERDE",0
10,"10102",529,411,405,5,6,"RECORTES CERO-GRUPO VERDE",0
13,"13028",10418,8075,7976,52,99,"RECORTES CERO-GRUPO VERDE",7
46,"46043",136,124,124,0,0,"RECORTES CERO-GRUPO VERDE",1
31,"31107",1710,1255,1243,16,12,"RECORTES CERO-GRUPO VERDE",2
12,"12069",66,49,48,0,1,"RECORTES CERO-GRUPO VERDE",0
14,"14045",3052,2362,2335,11,27,"RECORTES CERO-GRUPO VERDE",3
25,"25045",57,40,40,0,0,"RECORTES CERO-GRUPO VERDE",2
45,"45161",13688,9007,8902,32,105,"RECORTES CERO-GRUPO VERDE",31
16,"16269",419,336,332,2,4,"RECORTES CERO-GRUPO VERDE",0
25,"25174",397,280,280,2,0,"RECORTES CERO-GRUPO VERDE",1
23,"23070",3914,2433,2407,14,26,"RECORTES CERO-GRUPO VERDE",1
8,"8126",8748,5927,5895,56,32,"RECORTES CERO-GRUPO VERDE",9
9,"9190",86,58,56,0,2,"RECORTES CERO-GRUPO VERDE",0
17,"17097",196,148,148,3,0,"RECORTES CERO-GRUPO VERDE",1
13,"13030",139,98,96,0,2,"RECORTES CERO-GRUPO VERDE",0
2,"2011",632,520,516,1,4,"RECORTES CERO-GRUPO VERDE",0
13,"13031",2452,1919,1909,11,10,"RECORTES CERO-GRUPO VERDE",1
9,"9059",136488,101469,100463,907,1006,"RECORTES CERO-GRUPO VERDE",235
50,"50051",816,616,614,2,2,"RECORTES CERO-GRUPO VERDE",0
22,"22088",153,110,110,2,0,"RECORTES CERO-GRUPO VERDE",0
34,"34113",38,36,36,0,0,"RECORTES CERO-GRUPO VERDE",0
39,"39055",1086,824,816,6,8,"RECORTES CERO-GRUPO VERDE",0
8,"8251",4984,3257,3241,17,16,"RECORTES CERO-GRUPO VERDE",6
3,"3129",1194,957,938,0,19,"RECORTES CERO-GRUPO VERDE",0
23,"23071",1715,1290,1278,7,12,"RECORTES CERO-GRUPO VERDE",2
5,"5112",97,71,70,2,1,"RECORTES CERO-GRUPO VERDE",1
19,"19154",68,56,54,0,2,"RECORTES CERO-GRUPO VERDE",0
18,"18111",2765,1949,1936,18,13,"RECORTES CERO-GRUPO VERDE",3
8,"8252",24570,17009,16901,145,108,"RECORTES CERO-GRUPO VERDE",59
46,"46046",892,675,668,1,7,"RECORTES CERO-GRUPO VERDE",0
4,"4016",2138,1551,1536,9,15,"RECORTES CERO-GRUPO VERDE",2
5,"5258",111,95,95,0,0,"RECORTES CERO-GRUPO VERDE",0
15,"15038",2227,1463,1443,25,20,"RECORTES CERO-GRUPO VERDE",1
40,"40189",512,401,392,2,9,"RECORTES CERO-GRUPO VERDE",0
46,"46176",2017,1358,1349,5,9,"RECORTES CERO-GRUPO VERDE",1
9,"9417",40,32,32,1,0,"RECORTES CERO-GRUPO VERDE",0
16,"16158",535,416,413,5,3,"RECORTES CERO-GRUPO VERDE",0
6,"6124",1708,1202,1165,8,37,"RECORTES CERO-GRUPO VERDE",0
8,"8018",2636,1690,1675,23,15,"RECORTES CERO-GRUPO VERDE",4
49,"49101",153,102,99,0,3,"RECORTES CERO-GRUPO VERDE",0
28,"28165",1794,1293,1285,3,8,"RECORTES CERO-GRUPO VERDE",0
49,"49139",171,135,135,0,0,"RECORTES CERO-GRUPO VERDE",1
38,"38013",2949,1896,1867,17,29,"RECORTES CERO-GRUPO VERDE",1
25,"25049",151,110,108,1,2,"RECORTES CERO-GRUPO VERDE",0
26,"26031",106,83,83,0,0,"RECORTES CERO-GRUPO VERDE",0
22,"22090",99,71,71,0,0,"RECORTES CERO-GRUPO VERDE",0
28,"28011",442,317,316,1,1,"RECORTES CERO-GRUPO VERDE",1
9,"9458",469,343,336,5,7,"RECORTES CERO-GRUPO VERDE",2
15,"15077",8261,5186,5103,59,83,"RECORTES CERO-GRUPO VERDE",5
37,"37012",154,116,115,1,1,"RECORTES CERO-GRUPO VERDE",0
42,"42188",50,39,38,0,1,"RECORTES CERO-GRUPO VERDE",0
40,"40191",215,181,179,1,2,"RECORTES CERO-GRUPO VERDE",1
5,"5261",41,26,26,0,0,"RECORTES CERO-GRUPO VERDE",0
38,"38014",1357,935,926,3,9,"RECORTES CERO-GRUPO VERDE",1
34,"34121",187,148,148,3,0,"RECORTES CERO-GRUPO VERDE",0
9,"9195",59,36,36,2,0,"RECORTES CERO-GRUPO VERDE",0
19,"19265",122,97,95,2,2,"RECORTES CERO-GRUPO VERDE",0
32,"32053",1438,1158,1144,11,14,"RECORTES CERO-GRUPO VERDE",1
44,"44024",27,25,25,0,0,"RECORTES CERO-GRUPO VERDE",0
17,"17065",331,230,230,1,0,"RECORTES CERO-GRUPO VERDE",0
17,"17102",571,400,400,6,0,"RECORTES CERO-GRUPO VERDE",0
17,"17221",4153,2577,2564,27,13,"RECORTES CERO-GRUPO VERDE",6
26,"26138",4588,3290,3247,15,43,"RECORTES CERO-GRUPO VERDE",2
13,"13038",1630,1230,1207,7,23,"RECORTES CERO-GRUPO VERDE",0
16,"16116",77,68,68,0,0,"RECORTES CERO-GRUPO VERDE",0
45,"45068",160,126,126,0,0,"RECORTES CERO-GRUPO VERDE",0
5,"5118",79,53,53,0,0,"RECORTES CERO-GRUPO VERDE",0
28,"28167",8356,6158,6106,46,52,"RECORTES CERO-GRUPO VERDE",11
37,"37015",224,144,144,1,0,"RECORTES CERO-GRUPO VERDE",0
50,"50024",571,437,437,6,0,"RECORTES CERO-GRUPO VERDE",0
5,"5214",38,28,28,0,0,"RECORTES CERO-GRUPO VERDE",0
44,"44131",25,20,20,0,0,"RECORTES CERO-GRUPO VERDE",0
48,"48009",783,586,575,1,11,"RECORTES CERO-GRUPO VERDE",0
9,"9464",35,27,27,0,0,"RECORTES CERO-GRUPO VERDE",0
16,"16117",1040,787,777,4,10,"RECORTES CERO-GRUPO VERDE",1
12,"12075",123,88,88,0,0,"RECORTES CERO-GRUPO VERDE",0
17,"17222",101,76,75,0,1,"RECORTES CERO-GRUPO VERDE",0
50,"50056",409,300,300,3,0,"RECORTES CERO-GRUPO VERDE",0
16,"16118",1375,1106,1086,13,20,"RECORTES CERO-GRUPO VERDE",2
32,"32056",1592,1124,1118,7,6,"RECORTES CERO-GRUPO VERDE",0
33,"33067",784,587,579,9,8,"RECORTES CERO-GRUPO VERDE",1
9,"9466",129,97,97,1,0,"RECORTES CERO-GRUPO VERDE",1
5,"5265",82,66,66,1,0,"RECORTES CERO-GRUPO VERDE",1
9,"9154",137,98,97,2,1,"RECORTES CERO-GRUPO VERDE",0
40,"40154",20,15,15,0,0,"RECORTES CERO-GRUPO VERDE",0
10,"10113",2338,1679,1638,9,41,"RECORTES CERO-GRUPO VERDE",2
25,"25183",499,326,323,7,3,"RECORTES CERO-GRUPO VERDE",0
18,"18120",264,209,208,1,1,"RECORTES CERO-GRUPO VERDE",0
37,"37152",418,290,286,2,4,"RECORTES CERO-GRUPO VERDE",0
12,"12076",84,69,69,0,0,"RECORTES CERO-GRUPO VERDE",0
29,"29069",85684,54130,53621,455,509,"RECORTES CERO-GRUPO VERDE",102
34,"34125",86,65,64,0,1,"RECORTES CERO-GRUPO VERDE",0
43,"43098",343,235,233,5,2,"RECORTES CERO-GRUPO VERDE",0
19,"19162",68,49,47,0,2,"RECORTES CERO-GRUPO VERDE",0
33,"33069",3491,2430,2390,17,40,"RECORTES CERO-GRUPO VERDE",6
10,"10114",953,665,660,3,5,"RECORTES CERO-GRUPO VERDE",3
49,"49108",466,346,344,0,2,"RECORTES CERO-GRUPO VERDE",0
3,"3136",441,338,334,0,4,"RECORTES CERO-GRUPO VERDE",0
50,"50058",66,39,39,0,0,"RECORTES CERO-GRUPO VERDE",0
48,"48011",9673,6468,6423,45,45,"RECORTES CERO-GRUPO VERDE",14
31,"31116",62,51,50,1,1,"RECORTES CERO-GRUPO VERDE",0
38,"38019",13200,8123,8047,36,76,"RECORTES CERO-GRUPO VERDE",7
16,"16122",249,188,187,0,1,"RECORTES CERO-GRUPO VERDE",0
8,"8137",262,188,187,2,1,"RECORTES CERO-GRUPO VERDE",2
13,"13044",2671,1960,1936,13,24,"RECORTES CERO-GRUPO VERDE",4
37,"37279",750,522,513,4,9,"RECORTES CERO-GRUPO VERDE",1
5,"5123",97,73,73,1,0,"RECORTES CERO-GRUPO VERDE",0
9,"9200",50,32,31,0,1,"RECORTES CERO-GRUPO VERDE",0
15,"15083",1086,757,746,5,11,"RECORTES CERO-GRUPO VERDE",3
26,"26143",220,175,173,1,2,"RECORTES CERO-GRUPO VERDE",0
43,"43059",252,188,188,2,0,"RECORTES CERO-GRUPO VERDE",0
5,"5902",284,236,232,0,4,"RECORTES CERO-GRUPO VERDE",0
38,"38020",15113,9928,9830,59,98,"RECORTES CERO-GRUPO VERDE",23
13,"13045",674,508,499,1,9,"RECORTES CERO-GRUPO VERDE",1
16,"16123",82,61,61,3,0,"RECORTES CERO-GRUPO VERDE",0
17,"17226",867,549,546,8,3,"RECORTES CERO-GRUPO VERDE",1
19,"19165",47,41,41,0,0,"RECORTES CERO-GRUPO VERDE",0
18,"18123",301,228,222,1,6,"RECORTES CERO-GRUPO VERDE",0
12,"12079",399,316,314,2,2,"RECORTES CERO-GRUPO VERDE",0
31,"31118",164,112,111,1,1,"RECORTES CERO-GRUPO VERDE",0
8,"8139",175,132,132,2,0,"RECORTES CERO-GRUPO VERDE",0
22,"22232",93,71,69,1,2,"RECORTES CERO-GRUPO VERDE",0
31,"31019",1785,1254,1238,9,16,"RECORTES CERO-GRUPO VERDE",5
16,"16078",41429,30053,29775,235,278,"RECORTES CERO-GRUPO VERDE",52
32,"32062",811,621,617,6,4,"RECORTES CERO-GRUPO VERDE",0
28,"28083",8939,6396,6348,38,48,"RECORTES CERO-GRUPO VERDE",16
48,"48013",79716,53419,52997,345,422,"RECORTES CERO-GRUPO VERDE",136
38,"38021",1629,1033,1022,9,11,"RECORTES CERO-GRUPO VERDE",1
5,"5125",55,47,47,0,0,"RECORTES CERO-GRUPO VERDE",0
29,"29072",3262,2382,2352,17,30,"RECORTES CERO-GRUPO VERDE",3
19,"19166",156,120,119,1,1,"RECORTES CERO-GRUPO VERDE",0
31,"31020",449,228,228,3,0,"RECORTES CERO-GRUPO VERDE",0
8,"8140",4774,3118,3098,23,20,"RECORTES CERO-GRUPO VERDE",7
42,"42197",75,58,56,0,2,"RECORTES CERO-GRUPO VERDE",0
2,"2025",7461,5759,5618,34,141,"RECORTES CERO-GRUPO VERDE",15
23,"23085",2252,1655,1644,6,11,"RECORTES CERO-GRUPO VERDE",1
22,"22233",82,57,57,3,0,"RECORTES CERO-GRUPO VERDE",0
26,"26145",246,197,197,2,0,"RECORTES CERO-GRUPO VERDE",1
49,"49112",126,75,75,0,0,"RECORTES CERO-GRUPO VERDE",1
13,"13049",799,540,531,0,9,"RECORTES CERO-GRUPO VERDE",0
6,"6137",972,744,737,1,7,"RECORTES CERO-GRUPO VERDE",1
42,"42198",23,16,16,4,0,"RECORTES CERO-GRUPO VERDE",0
37,"37023",1413,1072,1060,5,12,"RECORTES CERO-GRUPO VERDE",1
33,"33073",8554,4945,4884,41,61,"RECORTES CERO-GRUPO VERDE",5
20,"20014",1108,611,609,4,2,"RECORTES CERO-GRUPO VERDE",2
50,"50030",215,141,140,1,1,"RECORTES CERO-GRUPO VERDE",0
17,"17114",23041,13985,13880,135,105,"RECORTES CERO-GRUPO VERDE",12
31,"31120",388,250,249,3,1,"RECORTES CERO-GRUPO VERDE",0
47,"47165",6955,4955,4303,66,652,"RECORTES CERO-GRUPO VERDE",9
19,"19168",292,204,198,1,6,"RECORTES CERO-GRUPO VERDE",0
50,"50062",1829,1304,1290,16,14,"RECORTES CERO-GRUPO VERDE",1
3,"3140",26070,18999,18742,174,257,"RECORTES CERO-GRUPO VERDE",17
49,"49114",43,34,33,0,1,"RECORTES CERO-GRUPO VERDE",0
20,"20048",182,100,98,2,2,"RECORTES CERO-GRUPO VERDE",0
22,"22107",112,74,74,0,0,"RECORTES CERO-GRUPO VERDE",0
45,"45076",553,368,364,3,4,"RECORTES CERO-GRUPO VERDE",1
9,"9480",110,90,90,1,0,"RECORTES CERO-GRUPO VERDE",0
35,"35016",297736,192251,190256,1386,1995,"RECORTES CERO-GRUPO VERDE",692
23,"23087",11292,8222,8084,59,138,"RECORTES CERO-GRUPO VERDE",21
19,"19277",19,13,13,0,0,"RECORTES CERO-GRUPO VERDE",0
19,"19046",21588,15689,15515,82,174,"RECORTES CERO-GRUPO VERDE",38
6,"6003",823,627,616,1,11,"RECORTES CERO-GRUPO VERDE",4
8,"8144",717,447,437,5,10,"RECORTES CERO-GRUPO VERDE",1
19,"19169",40,34,34,0,0,"RECORTES CERO-GRUPO VERDE",1
17,"17116",354,228,224,3,4,"RECORTES CERO-GRUPO VERDE",0
32,"32067",1294,837,826,8,11,"RECORTES CERO-GRUPO VERDE",2
6,"6004",1600,1212,1207,2,5,"RECORTES CERO-GRUPO VERDE",1
12,"12083",93,79,76,0,3,"RECORTES CERO-GRUPO VERDE",0
15,"15089",4291,3020,2972,28,48,"RECORTES CERO-GRUPO VERDE",4
19,"19090",91,73,73,1,0,"RECORTES CERO-GRUPO VERDE",0
22,"22200",244,184,182,5,2,"RECORTES CERO-GRUPO VERDE",0
13,"13053",14328,10164,10041,72,123,"RECORTES CERO-GRUPO VERDE",16
50,"50161",106,75,72,0,3,"RECORTES CERO-GRUPO VERDE",0
9,"9075",112,91,91,3,0,"RECORTES CERO-GRUPO VERDE",0
5,"5131",99,69,69,0,0,"RECORTES CERO-GRUPO VERDE",0
22,"22110",738,531,527,4,4,"RECORTES CERO-GRUPO VERDE",1
9,"9483",211,158,157,0,1,"RECORTES CERO-GRUPO VERDE",0
8,"8024",386,243,236,0,7,"RECORTES CERO-GRUPO VERDE",0
49,"49116",383,276,269,3,7,"RECORTES CERO-GRUPO VERDE",0
17,"17234",182,115,114,0,1,"RECORTES CERO-GRUPO VERDE",0
48,"48912",2308,1707,1679,14,28,"RECORTES CERO-GRUPO VERDE",3
17,"17117",14353,8469,8426,49,43,"RECORTES CERO-GRUPO VERDE",11
13,"13055",665,487,484,2,3,"RECORTES CERO-GRUPO VERDE",2
12,"12084",17615,12766,12644,105,122,"RECORTES CERO-GRUPO VERDE",29
26,"26149",57,47,46,0,1,"RECORTES CERO-GRUPO VERDE",0
23,"23091",729,555,553,5,2,"RECORTES CERO-GRUPO VERDE",0
37,"37164",256,191,189,5,2,"RECORTES CERO-GRUPO VERDE",0
20,"20051",6877,4699,4679,34,20,"RECORTES CERO-GRUPO VERDE",10
11,"11028",32488,21971,21672,316,299,"RECORTES CERO-GRUPO VERDE",69
19,"19171",4961,3670,3628,27,42,"RECORTES CERO-GRUPO VERDE",8
24,"24185",474,357,350,3,7,"RECORTES CERO-GRUPO VERDE",0
28,"28177",10270,8083,8030,36,53,"RECORTES CERO-GRUPO VERDE",6
44,"44144",346,248,245,2,3,"RECORTES CERO-GRUPO VERDE",0
19,"19172",57,48,47,0,1,"RECORTES CERO-GRUPO VERDE",0
42,"42206",8,8,8,1,0,"RECORTES CERO-GRUPO VERDE",0
37,"37289",232,167,166,3,1,"RECORTES CERO-GRUPO VERDE",0
25,"25068",556,346,341,11,5,"RECORTES CERO-GRUPO VERDE",0
23,"23092",27775,19734,19541,175,193,"RECORTES CERO-GRUPO VERDE",33
6,"6008",632,525,519,2,6,"RECORTES CERO-GRUPO VERDE",0
33,"33078",142,101,99,0,2,"RECORTES CERO-GRUPO VERDE",0
18,"18135",4568,3009,2961,14,48,"RECORTES CERO-GRUPO VERDE",7
50,"50066",2621,1862,1851,9,11,"RECORTES CERO-GRUPO VERDE",3
37,"37165",33,26,25,0,1,"RECORTES CERO-GRUPO VERDE",0
5,"5232",102,84,79,1,5,"RECORTES CERO-GRUPO VERDE",0
28,"28089",3677,2748,2730,10,18,"RECORTES CERO-GRUPO VERDE",3
8,"8148",2233,1491,1483,7,8,"RECORTES CERO-GRUPO VERDE",2
15,"15093",4220,2533,2498,30,35,"RECORTES CERO-GRUPO VERDE",1
17,"17198",429,270,267,2,3,"RECORTES CERO-GRUPO VERDE",0
19,"19133",83,72,72,0,0,"RECORTES CERO-GRUPO VERDE",0
32,"32072",3821,2705,2667,24,38,"RECORTES CERO-GRUPO VERDE",6
5,"5136",96,61,60,3,1,"RECORTES CERO-GRUPO VERDE",0
38,"38030",1933,1296,1290,2,6,"RECORTES CERO-GRUPO VERDE",1
26,"26152",33,28,28,1,0,"RECORTES CERO-GRUPO VERDE",0
13,"13059",202,160,156,0,4,"RECORTES CERO-GRUPO VERDE",0
45,"45182",1034,806,791,1,15,"RECORTES CERO-GRUPO VERDE",0
25,"25030",135,74,72,1,2,"RECORTES CERO-GRUPO VERDE",0
14,"14034",308,247,244,2,3,"RECORTES CERO-GRUPO VERDE",0
22,"22001",225,151,151,1,0,"RECORTES CERO-GRUPO VERDE",0
45,"45082",1224,1020,1011,8,9,"RECORTES CERO-GRUPO VERDE",0
50,"50165",1814,1287,1264,26,23,"RECORTES CERO-GRUPO VERDE",2
8,"8150",255,186,186,1,0,"RECORTES CERO-GRUPO VERDE",0
8,"8029",3480,2472,2460,25,12,"RECORTES CERO-GRUPO VERDE",10
34,"34140",107,67,67,0,0,"RECORTES CERO-GRUPO VERDE",0
2,"2035",1960,1483,1465,13,18,"RECORTES CERO-GRUPO VERDE",4
37,"37032",548,401,399,0,2,"RECORTES CERO-GRUPO VERDE",1
3,"3022",145,125,125,0,0,"RECORTES CERO-GRUPO VERDE",0
26,"26153",13,12,11,0,1,"RECORTES CERO-GRUPO VERDE",0
25,"25203",8931,5003,4955,72,48,"RECORTES CERO-GRUPO VERDE",10
19,"19283",30,25,25,0,0,"RECORTES CERO-GRUPO VERDE",1
8,"8151",466,288,287,2,1,"RECORTES CERO-GRUPO VERDE",0
31,"31128",359,265,263,0,2,"RECORTES CERO-GRUPO VERDE",1
16,"16139",335,256,255,2,1,"RECORTES CERO-GRUPO VERDE",0
26,"26048",22,22,22,0,0,"RECORTES CERO-GRUPO VERDE",0
37,"37293",115,84,84,1,0,"RECORTES CERO-GRUPO VERDE",0
23,"23096",2642,2164,2138,9,26,"RECORTES CERO-GRUPO VERDE",0
8,"8152",114,80,79,0,1,"RECORTES CERO-GRUPO VERDE",0
25,"25072",5850,3493,3444,29,49,"RECORTES CERO-GRUPO VERDE",3
26,"26049",172,125,122,1,3,"RECORTES CERO-GRUPO VERDE",0
49,"49245",262,176,173,2,3,"RECORTES CERO-GRUPO VERDE",1
24,"24190",165,123,121,1,2,"RECORTES CERO-GRUPO VERDE",0
26,"26154",13,10,10,0,0,"RECORTES CERO-GRUPO VERDE",0
6,"6013",265,212,209,3,3,"RECORTES CERO-GRUPO VERDE",0
37,"37170",1449,994,971,3,23,"RECORTES CERO-GRUPO VERDE",0
25,"25033",1096,729,723,4,6,"RECORTES CERO-GRUPO VERDE",1
43,"43115",143,100,98,2,2,"RECORTES CERO-GRUPO VERDE",1
17,"17125",130,80,80,0,0,"RECORTES CERO-GRUPO VERDE",0
19,"19054",192,164,164,1,0,"RECORTES CERO-GRUPO VERDE",0
47,"47172",144,124,122,0,2,"RECORTES CERO-GRUPO VERDE",0
18,"18141",404,285,282,0,3,"RECORTES CERO-GRUPO VERDE",0
10,"10133",1206,956,945,5,11,"RECORTES CERO-GRUPO VERDE",1
25,"25073",582,328,324,8,4,"RECORTES CERO-GRUPO VERDE",0
2,"2038",281,223,223,0,0,"RECORTES CERO-GRUPO VERDE",1
37,"37296",336,259,254,2,5,"RECORTES CERO-GRUPO VERDE",0
8,"8002",201,130,124,0,6,"RECORTES CERO-GRUPO VERDE",1
19,"19177",76,61,59,0,2,"RECORTES CERO-GRUPO VERDE",0
28,"28182",210,171,169,0,2,"RECORTES CERO-GRUPO VERDE",0
43,"43117",146,108,105,0,3,"RECORTES CERO-GRUPO VERDE",0
37,"37036",61,44,43,0,1,"RECORTES CERO-GRUPO VERDE",0
23,"23098",867,713,701,1,12,"RECORTES CERO-GRUPO VERDE",2
26,"26157",296,241,237,4,4,"RECORTES CERO-GRUPO VERDE",0
2,"2039",984,790,786,10,4,"RECORTES CERO-GRUPO VERDE",0
34,"34006",81,67,66,2,1,"RECORTES CERO-GRUPO VERDE",0
28,"28028",1755,1353,1344,6,9,"RECORTES CERO-GRUPO VERDE",0
37,"37298",179,127,126,0,1,"RECORTES CERO-GRUPO VERDE",0
22,"22248",116,92,90,1,2,"RECORTES CERO-GRUPO VERDE",0
20,"20058",755,529,525,3,4,"RECORTES CERO-GRUPO VERDE",2
28,"28094",865,624,622,4,2,"RECORTES CERO-GRUPO VERDE",0
5,"5144",76,55,54,0,1,"RECORTES CERO-GRUPO VERDE",0
24,"24093",360,249,248,2,1,"RECORTES CERO-GRUPO VERDE",0
31,"31032",1713,1209,1193,24,16,"RECORTES CERO-GRUPO VERDE",1
47,"47174",267,218,215,1,3,"RECORTES CERO-GRUPO VERDE",0
31,"31232",25155,17648,17450,196,198,"RECORTES CERO-GRUPO VERDE",54
3,"3056",8676,6638,6541,34,97,"RECORTES CERO-GRUPO VERDE",16
9,"9223",45,37,37,0,0,"RECORTES CERO-GRUPO VERDE",1
40,"40215",84,60,60,0,0,"RECORTES CERO-GRUPO VERDE",0
20,"20059",8874,5873,5855,29,18,"RECORTES CERO-GRUPO VERDE",7
10,"10137",397,320,317,3,3,"RECORTES CERO-GRUPO VERDE",0
18,"18007",781,521,512,5,9,"RECORTES CERO-GRUPO VERDE",0
29,"29064",503,348,339,8,9,"RECORTES CERO-GRUPO VERDE",0
10,"10092",292,236,235,1,1,"RECORTES CERO-GRUPO VERDE",0
31,"31233",97,74,74,0,0,"RECORTES CERO-GRUPO VERDE",0
13,"13069",660,508,499,7,9,"RECORTES CERO-GRUPO VERDE",0
26,"26160",709,552,549,2,3,"RECORTES CERO-GRUPO VERDE",2
4,"4102",13694,8944,8865,50,79,"RECORTES CERO-GRUPO VERDE",7
19,"19288",21,21,20,0,1,"RECORTES CERO-GRUPO VERDE",0
23,"23901",1154,970,964,3,6,"RECORTES CERO-GRUPO VERDE",3
47,"47175",6564,4781,4728,39,53,"RECORTES CERO-GRUPO VERDE",6
22,"22250",353,261,258,4,3,"RECORTES CERO-GRUPO VERDE",0
37,"37175",403,314,312,6,2,"RECORTES CERO-GRUPO VERDE",0
8,"8036",163,105,104,1,1,"RECORTES CERO-GRUPO VERDE",0
22,"22008",173,137,133,3,4,"RECORTES CERO-GRUPO VERDE",0
10,"10139",114,82,78,1,4,"RECORTES CERO-GRUPO VERDE",0
31,"31234",144,106,106,4,0,"RECORTES CERO-GRUPO VERDE",1
49,"49009",393,293,288,2,5,"RECORTES CERO-GRUPO VERDE",1
6,"6020",1815,1366,1345,10,21,"RECORTES CERO-GRUPO VERDE",0
9,"9224",162,131,131,1,0,"RECORTES CERO-GRUPO VERDE",0
34,"34012",357,269,264,5,5,"RECORTES CERO-GRUPO VERDE",0
44,"44045",366,274,269,2,5,"RECORTES CERO-GRUPO VERDE",0
45,"45189",599,470,462,2,8,"RECORTES CERO-GRUPO VERDE",1
35,"35027",10344,7310,7216,50,94,"RECORTES CERO-GRUPO VERDE",15
16,"16008",89,69,69,0,0,"RECORTES CERO-GRUPO VERDE",1
31,"31035",59,45,43,0,2,"RECORTES CERO-GRUPO VERDE",0
23,"23902",2320,1867,1847,4,20,"RECORTES CERO-GRUPO VERDE",3
37,"37041",78,52,52,0,0,"RECORTES CERO-GRUPO VERDE",0
4,"4009",162,123,122,2,1,"RECORTES CERO-GRUPO VERDE",0
13,"13073",531,399,391,3,8,"RECORTES CERO-GRUPO VERDE",0
16,"16148",573,504,500,4,4,"RECORTES CERO-GRUPO VERDE",0
31,"31235",159,117,115,2,2,"RECORTES CERO-GRUPO VERDE",0
45,"45190",475,371,366,0,5,"RECORTES CERO-GRUPO VERDE",0
43,"43122",106,77,77,4,0,"RECORTES CERO-GRUPO VERDE",0
19,"19107",294,239,237,0,2,"RECORTES CERO-GRUPO VERDE",0
5,"5102",1780,1339,1317,3,22,"RECORTES CERO-GRUPO VERDE",0
9,"9181",300,221,221,0,0,"RECORTES CERO-GRUPO VERDE",0
31,"31135",106,70,66,2,4,"RECORTES CERO-GRUPO VERDE",1
28,"28903",33082,27065,26922,154,143,"RECORTES CERO-GRUPO VERDE",39
20,"20063",8017,5263,5231,35,32,"RECORTES CERO-GRUPO VERDE",4
29,"29001",4170,3106,3068,19,38,"RECORTES CERO-GRUPO VERDE",0
13,"13074",974,835,828,3,7,"RECORTES CERO-GRUPO VERDE",0
40,"40220",66,50,46,1,4,"RECORTES CERO-GRUPO VERDE",0
10,"10142",832,627,621,5,6,"RECORTES CERO-GRUPO VERDE",1
42,"42084",25,22,22,1,0,"RECORTES CERO-GRUPO VERDE",0
32,"32086",2646,1693,1677,13,16,"RECORTES CERO-GRUPO VERDE",3
28,"28033",3899,2805,2788,7,17,"RECORTES CERO-GRUPO VERDE",1
31,"31136",447,299,298,2,1,"RECORTES CERO-GRUPO VERDE",3
48,"48030",606,441,439,1,2,"RECORTES CERO-GRUPO VERDE",0
19,"19185",28,21,20,0,1,"RECORTES CERO-GRUPO VERDE",0
10,"10143",154,112,112,0,0,"RECORTES CERO-GRUPO VERDE",0
8,"8162",2047,1400,1392,7,8,"RECORTES CERO-GRUPO VERDE",5
25,"25082",285,186,178,5,8,"RECORTES CERO-GRUPO VERDE",2
8,"8286",2879,1802,1797,14,5,"RECORTES CERO-GRUPO VERDE",7
18,"18014",6581,4584,4545,37,39,"RECORTES CERO-GRUPO VERDE",9
41,"41086",16170,10162,10088,73,74,"RECORTES CERO-GRUPO VERDE",21
11,"11041",9866,6477,6402,69,75,"RECORTES CERO-GRUPO VERDE",18
8,"8041",10343,6645,6582,57,63,"RECORTES CERO-GRUPO VERDE",17
9,"9228",160,137,136,1,1,"RECORTES CERO-GRUPO VERDE",0
29,"29091",8957,6186,6078,56,108,"RECORTES CERO-GRUPO VERDE",7
16,"16152",38,32,32,0,0,"RECORTES CERO-GRUPO VERDE",0
6,"6025",5106,3571,3523,44,48,"RECORTES CERO-GRUPO VERDE",4
8,"8163",18641,11801,11729,68,72,"RECORTES CERO-GRUPO VERDE",18
31,"31038",1339,957,942,11,15,"RECORTES CERO-GRUPO VERDE",6
43,"43003",324,217,217,3,0,"RECORTES CERO-GRUPO VERDE",1
4,"4012",191,161,161,0,0,"RECORTES CERO-GRUPO VERDE",0
8,"8164",913,618,609,7,9,"RECORTES CERO-GRUPO VERDE",0
22,"22013",288,216,210,3,6,"RECORTES CERO-GRUPO VERDE",0
8,"8042",2231,1565,1558,17,7,"RECORTES CERO-GRUPO VERDE",1
31,"31138",932,601,599,2,2,"RECORTES CERO-GRUPO VERDE",1
47,"47179",395,293,287,0,6,"RECORTES CERO-GRUPO VERDE",1
10,"10146",1507,1004,977,7,27,"RECORTES CERO-GRUPO VERDE",1
43,"43004",6281,3993,3929,38,64,"RECORTES CERO-GRUPO VERDE",3
31,"31039",80,61,60,0,1,"RECORTES CERO-GRUPO VERDE",0
46,"46199",5718,4314,4266,28,48,"RECORTES CERO-GRUPO VERDE",7
22,"22014",243,192,188,3,4,"RECORTES CERO-GRUPO VERDE",0
25,"25131",403,248,241,7,7,"RECORTES CERO-GRUPO VERDE",0
22,"22129",183,120,118,1,2,"RECORTES CERO-GRUPO VERDE",0
16,"16107",109,86,85,1,1,"RECORTES CERO-GRUPO VERDE",0
45,"45094",387,298,297,1,1,"RECORTES CERO-GRUPO VERDE",0
24,"24203",95,69,68,0,1,"RECORTES CERO-GRUPO VERDE",0
5,"5002",1963,1422,1390,3,32,"RECORTES CERO-GRUPO VERDE",4
49,"49134",172,121,119,0,2,"RECORTES CERO-GRUPO VERDE",1
31,"31240",527,327,326,2,1,"RECORTES CERO-GRUPO VERDE",1
29,"29005",4358,2859,2817,28,42,"RECORTES CERO-GRUPO VERDE",3
14,"14073",2891,2079,2016,13,63,"RECORTES CERO-GRUPO VERDE",0
44,"44158",1180,876,862,10,14,"RECORTES CERO-GRUPO VERDE",1
13,"13081",636,480,472,9,8,"RECORTES CERO-GRUPO VERDE",1
17,"17139",1364,884,865,8,19,"RECORTES CERO-GRUPO VERDE",1
26,"26061",1565,1160,1141,13,19,"RECORTES CERO-GRUPO VERDE",3
8,"8166",991,631,625,7,6,"RECORTES CERO-GRUPO VERDE",0
34,"34023",5236,3685,3636,30,49,"RECORTES CERO-GRUPO VERDE",6
37,"37050",66,52,52,0,0,"RECORTES CERO-GRUPO VERDE",0
43,"43129",4580,2844,2805,23,39,"RECORTES CERO-GRUPO VERDE",6
37,"37184",327,255,252,2,3,"RECORTES CERO-GRUPO VERDE",0
19,"19298",65,45,45,0,0,"RECORTES CERO-GRUPO VERDE",0
13,"13082",25805,16871,16706,120,165,"RECORTES CERO-GRUPO VERDE",32
24,"24205",945,694,685,11,9,"RECORTES CERO-GRUPO VERDE",1
10,"10149",421,283,280,1,3,"RECORTES CERO-GRUPO VERDE",0
31,"31141",110,71,70,1,1,"RECORTES CERO-GRUPO VERDE",0
31,"31042",2714,1974,1942,22,32,"RECORTES CERO-GRUPO VERDE",1
17,"17021",131,86,85,4,1,"RECORTES CERO-GRUPO VERDE",0
17,"17140",670,478,473,5,5,"RECORTES CERO-GRUPO VERDE",0
29,"29006",673,428,420,1,8,"RECORTES CERO-GRUPO VERDE",0
44,"44159",38,31,31,1,0,"RECORTES CERO-GRUPO VERDE",0
18,"18157",1121,815,803,3,12,"RECORTES CERO-GRUPO VERDE",2
26,"26170",446,330,326,2,4,"RECORTES CERO-GRUPO VERDE",0
6,"6031",469,277,272,2,5,"RECORTES CERO-GRUPO VERDE",0
13,"13084",892,701,685,6,16,"RECORTES CERO-GRUPO VERDE",0
2,"2053",2998,2231,2189,16,42,"RECORTES CERO-GRUPO VERDE",6
3,"3066",42121,29655,29419,214,236,"RECORTES CERO-GRUPO VERDE",48
42,"42090",91,69,67,1,2,"RECORTES CERO-GRUPO VERDE",0
9,"9103",217,184,183,1,1,"RECORTES CERO-GRUPO VERDE",0
18,"18064",377,291,290,2,1,"RECORTES CERO-GRUPO VERDE",0
42,"42092",56,44,42,1,2,"RECORTES CERO-GRUPO VERDE",0
14,"14047",1672,1187,1178,14,9,"RECORTES CERO-GRUPO VERDE",0
13,"13085",2342,1921,1855,10,66,"RECORTES CERO-GRUPO VERDE",1
22,"22017",866,650,642,5,8,"RECORTES CERO-GRUPO VERDE",0
5,"5209",85,70,70,0,0,"RECORTES CERO-GRUPO VERDE",0
9,"9374",90,71,70,1,1,"RECORTES CERO-GRUPO VERDE",0
16,"16064",684,568,562,4,6,"RECORTES CERO-GRUPO VERDE",0
43,"43132",373,264,261,4,3,"RECORTES CERO-GRUPO VERDE",0
49,"49019",243,188,182,2,6,"RECORTES CERO-GRUPO VERDE",1
47,"47022",59,50,49,0,1,"RECORTES CERO-GRUPO VERDE",0
44,"44054",108,85,85,2,0,"RECORTES CERO-GRUPO VERDE",0
43,"43010",322,233,227,0,6,"RECORTES CERO-GRUPO VERDE",2
45,"45031",2723,1835,1822,12,13,"RECORTES CERO-GRUPO VERDE",3
34,"34028",143,116,113,1,3,"RECORTES CERO-GRUPO VERDE",0
25,"25094",137,98,95,1,3,"RECORTES CERO-GRUPO VERDE",0
6,"6033",1327,1011,1006,10,5,"RECORTES CERO-GRUPO VERDE",0
19,"19192",1736,1324,1308,8,16,"RECORTES CERO-GRUPO VERDE",0
8,"8171",2103,1288,1280,12,8,"RECORTES CERO-GRUPO VERDE",1
24,"24007",773,550,548,4,2,"RECORTES CERO-GRUPO VERDE",1
9,"9104",53,42,42,0,0,"RECORTES CERO-GRUPO VERDE",0
13,"13087",23137,15677,15480,133,197,"RECORTES CERO-GRUPO VERDE",24
46,"46151",728,550,541,0,9,"RECORTES CERO-GRUPO VERDE",2
12,"12004",4170,3125,3088,19,37,"RECORTES CERO-GRUPO VERDE",7
44,"44163",126,94,94,1,0,"RECORTES CERO-GRUPO VERDE",0
10,"10017",825,620,611,3,9,"RECORTES CERO-GRUPO VERDE",0
31,"31045",508,355,350,8,5,"RECORTES CERO-GRUPO VERDE",1
16,"16022",78,67,66,0,1,"RECORTES CERO-GRUPO VERDE",0
9,"9377",632,485,480,1,5,"RECORTES CERO-GRUPO VERDE",1
29,"29099",950,693,685,4,8,"RECORTES CERO-GRUPO VERDE",1
40,"40233",417,314,310,3,4,"RECORTES CERO-GRUPO VERDE",0
34,"34029",714,587,570,3,17,"RECORTES CERO-GRUPO VERDE",0
39,"39089",143,104,100,1,4,"RECORTES CERO-GRUPO VERDE",0
16,"16161",57,48,46,0,2,"RECORTES CERO-GRUPO VERDE",0
50,"50085",167,126,126,1,0,"RECORTES CERO-GRUPO VERDE",0
46,"46152",96,68,68,0,0,"RECORTES CERO-GRUPO VERDE",0
31,"31146",35,30,29,1,1,"RECORTES CERO-GRUPO VERDE",1
38,"38051",7194,5158,5080,31,78,"RECORTES CERO-GRUPO VERDE",4
24,"24107",236,175,173,0,2,"RECORTES CERO-GRUPO VERDE",0
45,"45201",3447,2082,2050,9,32,"RECORTES CERO-GRUPO VERDE",7
29,"29011",2900,1822,1803,9,19,"RECORTES CERO-GRUPO VERDE",1
13,"13091",538,450,446,0,4,"RECORTES CERO-GRUPO VERDE",0
37,"37058",58,45,45,0,0,"RECORTES CERO-GRUPO VERDE",0
49,"49266",76,63,61,2,2,"RECORTES CERO-GRUPO VERDE",0
4,"4020",288,201,197,0,4,"RECORTES CERO-GRUPO VERDE",0
8,"8052",141,88,88,0,0,"RECORTES CERO-GRUPO VERDE",0
25,"25098",253,151,150,0,1,"RECORTES CERO-GRUPO VERDE",0
36,"36003",9980,7191,7110,67,81,"RECORTES CERO-GRUPO VERDE",12
26,"26174",146,107,105,2,2,"RECORTES CERO-GRUPO VERDE",0
46,"46231",2421,1721,1708,14,13,"RECORTES CERO-GRUPO VERDE",1
16,"16163",74,62,62,0,0,"RECORTES CERO-GRUPO VERDE",0
44,"44165",175,135,133,2,2,"RECORTES CERO-GRUPO VERDE",0
31,"31147",100,82,82,2,0,"RECORTES CERO-GRUPO VERDE",0
13,"13092",1846,1477,1462,5,15,"RECORTES CERO-GRUPO VERDE",0
33,"33007",1514,946,942,12,4,"RECORTES CERO-GRUPO VERDE",1
37,"37319",114,78,74,0,4,"RECORTES CERO-GRUPO VERDE",0
22,"22022",552,414,408,6,6,"RECORTES CERO-GRUPO VERDE",0
25,"25099",1273,761,752,7,9,"RECORTES CERO-GRUPO VERDE",1
31,"31248",299,165,162,0,3,"RECORTES CERO-GRUPO VERDE",1
19,"19305",155,116,115,0,1,"RECORTES CERO-GRUPO VERDE",0
34,"34033",17,17,17,0,0,"RECORTES CERO-GRUPO VERDE",0
7,"7010",4880,3395,3361,32,34,"RECORTES CERO-GRUPO VERDE",6
6,"6039",1840,1469,1437,9,32,"RECORTES CERO-GRUPO VERDE",2
47,"47025",120,94,94,1,0,"RECORTES CERO-GRUPO VERDE",0
31,"31049",699,469,465,2,4,"RECORTES CERO-GRUPO VERDE",1
49,"49146",295,216,213,3,3,"RECORTES CERO-GRUPO VERDE",0
33,"33008",1777,1238,1229,3,9,"RECORTES CERO-GRUPO VERDE",0
8,"8177",40,30,30,0,0,"RECORTES CERO-GRUPO VERDE",0
25,"25228",3035,1933,1921,26,12,"RECORTES CERO-GRUPO VERDE",4
24,"24011",203,133,132,0,1,"RECORTES CERO-GRUPO VERDE",0
40,"40904",357,308,306,3,2,"RECORTES CERO-GRUPO VERDE",2
37,"37061",225,168,168,1,0,"RECORTES CERO-GRUPO VERDE",1
40,"40903",86,67,67,0,0,"RECORTES CERO-GRUPO VERDE",0
22,"22023",421,313,309,6,4,"RECORTES CERO-GRUPO VERDE",0
16,"16167",316,249,244,1,5,"RECORTES CERO-GRUPO VERDE",0
37,"37321",168,132,132,2,0,"RECORTES CERO-GRUPO VERDE",0
37,"37062",83,65,64,1,1,"RECORTES CERO-GRUPO VERDE",0
23,"23002",17428,12820,12644,70,176,"RECORTES CERO-GRUPO VERDE",16
22,"22142",97,75,74,1,1,"RECORTES CERO-GRUPO VERDE",0
19,"19198",14,12,12,0,0,"RECORTES CERO-GRUPO VERDE",0
46,"46234",348,279,275,3,4,"RECORTES CERO-GRUPO VERDE",0
36,"36006",11520,8529,8396,63,133,"RECORTES CERO-GRUPO VERDE",13
10,"10161",76,53,53,0,0,"RECORTES CERO-GRUPO VERDE",0
49,"49148",260,137,134,1,3,"RECORTES CERO-GRUPO VERDE",0
24,"24012",290,207,205,1,2,"RECORTES CERO-GRUPO VERDE",1
21,"21068",998,605,592,11,13,"RECORTES CERO-GRUPO VERDE",1
37,"37063",69,59,58,0,1,"RECORTES CERO-GRUPO VERDE",0
10,"10024",695,525,520,3,5,"RECORTES CERO-GRUPO VERDE",4
49,"49271",194,145,141,1,4,"RECORTES CERO-GRUPO VERDE",0
49,"49149",390,273,268,3,5,"RECORTES CERO-GRUPO VERDE",0
34,"34036",211,150,150,0,0,"RECORTES CERO-GRUPO VERDE",0
3,"3074",1707,1397,1389,4,8,"RECORTES CERO-GRUPO VERDE",3
8,"8180",26613,17585,17490,153,95,"RECORTES CERO-GRUPO VERDE",75
19,"19308",56,53,53,0,0,"RECORTES CERO-GRUPO VERDE",0
6,"6043",665,490,484,2,6,"RECORTES CERO-GRUPO VERDE",3
39,"39094",848,655,651,3,4,"RECORTES CERO-GRUPO VERDE",0
37,"37065",312,223,222,3,1,"RECORTES CERO-GRUPO VERDE",0
24,"24014",7425,5124,5053,32,71,"RECORTES CERO-GRUPO VERDE",8
31,"31151",66,46,46,1,0,"RECORTES CERO-GRUPO VERDE",0
24,"24216",723,522,518,1,4,"RECORTES CERO-GRUPO VERDE",0
13,"13901",893,665,655,5,10,"RECORTES CERO-GRUPO VERDE",0
16,"16170",692,501,493,4,8,"RECORTES CERO-GRUPO VERDE",1
25,"25103",135,76,76,4,0,"RECORTES CERO-GRUPO VERDE",0
48,"48044",62774,45594,45399,287,195,"RECORTES CERO-GRUPO VERDE",66
5,"5025",94,79,78,0,1,"RECORTES CERO-GRUPO VERDE",0
8,"8304",812,562,558,3,4,"RECORTES CERO-GRUPO VERDE",0
46,"46079",318,241,232,1,9,"RECORTES CERO-GRUPO VERDE",0
19,"19087",18,18,18,0,0,"RECORTES CERO-GRUPO VERDE",0
7,"7015",20991,12552,12433,184,119,"RECORTES CERO-GRUPO VERDE",45
19,"19200",71,52,52,1,0,"RECORTES CERO-GRUPO VERDE",0
5,"5026",195,166,164,2,2,"RECORTES CERO-GRUPO VERDE",1
29,"29017",6553,4744,4668,33,76,"RECORTES CERO-GRUPO VERDE",1
26,"26180",221,173,172,0,1,"RECORTES CERO-GRUPO VERDE",0
50,"50188",28,25,25,0,0,"RECORTES CERO-GRUPO VERDE",0
9,"9388",34,27,26,0,1,"RECORTES CERO-GRUPO VERDE",0
50,"50189",705,527,519,13,8,"RECORTES CERO-GRUPO VERDE",0
25,"25105",125,92,92,2,0,"RECORTES CERO-GRUPO VERDE",0
37,"37327",185,149,146,3,3,"RECORTES CERO-GRUPO VERDE",1
30,"30003",24332,16183,16040,104,143,"RECORTES CERO-GRUPO VERDE",19
28,"28019",1233,893,885,4,8,"RECORTES CERO-GRUPO VERDE",1
40,"40201",49,42,42,0,0,"RECORTES CERO-GRUPO VERDE",0
33,"33012",5201,3466,3432,25,34,"RECORTES CERO-GRUPO VERDE",4
8,"8306",506,299,297,5,2,"RECORTES CERO-GRUPO VERDE",3
42,"42108",12,9,9,1,0,"RECORTES CERO-GRUPO VERDE",0
46,"46237",7211,5395,5343,42,52,"RECORTES CERO-GRUPO VERDE",10
5,"5029",121,96,94,0,2,"RECORTES CERO-GRUPO VERDE",0
10,"10167",314,239,239,1,0,"RECORTES CERO-GRUPO VERDE",0
34,"34041",90,71,71,1,0,"RECORTES CERO-GRUPO VERDE",1
24,"24017",577,426,418,1,8,"RECORTES CERO-GRUPO VERDE",0
41,"41003",2333,1693,1671,13,22,"RECORTES CERO-GRUPO VERDE",3
22,"22029",127,100,100,0,0,"RECORTES CERO-GRUPO VERDE",0
44,"44066",108,79,74,0,5,"RECORTES CERO-GRUPO VERDE",0
17,"17035",548,381,379,5,2,"RECORTES CERO-GRUPO VERDE",0
5,"5030",45,38,38,1,0,"RECORTES CERO-GRUPO VERDE",0
23,"23007",3087,2205,2187,6,18,"RECORTES CERO-GRUPO VERDE",7
31,"31255",102,79,79,1,0,"RECORTES CERO-GRUPO VERDE",0
1,"1014",371,280,272,4,8,"RECORTES CERO-GRUPO VERDE",0
39,"39006",1711,1307,1287,10,20,"RECORTES CERO-GRUPO VERDE",0
49,"49153",174,136,132,0,4,"RECORTES CERO-GRUPO VERDE",1
8,"8185",188,123,122,2,1,"RECORTES CERO-GRUPO VERDE",0
4,"4029",8859,5834,5790,35,44,"RECORTES CERO-GRUPO VERDE",1
28,"28049",58480,45136,44820,242,316,"RECORTES CERO-GRUPO VERDE",138
41,"41004",56640,37110,36649,440,461,"RECORTES CERO-GRUPO VERDE",120
27,"27002",1633,1137,1108,9,29,"RECORTES CERO-GRUPO VERDE",3
4,"4093",1882,1216,1204,11,12,"RECORTES CERO-GRUPO VERDE",0
19,"19204",148,120,120,0,0,"RECORTES CERO-GRUPO VERDE",0
5,"5033",176,144,142,1,2,"RECORTES CERO-GRUPO VERDE",1
26,"26076",129,107,106,0,1,"RECORTES CERO-GRUPO VERDE",0
10,"10170",267,210,206,3,4,"RECORTES CERO-GRUPO VERDE",0
37,"37330",339,248,246,0,2,"RECORTES CERO-GRUPO VERDE",0
34,"34045",76,66,66,2,0,"RECORTES CERO-GRUPO VERDE",0
43,"43025",600,408,404,2,4,"RECORTES CERO-GRUPO VERDE",0
15,"15015",2799,2045,2008,24,37,"RECORTES CERO-GRUPO VERDE",4
43,"43026",782,524,520,6,4,"RECORTES CERO-GRUPO VERDE",0
9,"9253",109,94,91,1,3,"RECORTES CERO-GRUPO VERDE",0
14,"14003",1248,939,930,2,9,"RECORTES CERO-GRUPO VERDE",2
10,"10033",423,320,320,0,0,"RECORTES CERO-GRUPO VERDE",0
40,"40123",147,114,106,0,8,"RECORTES CERO-GRUPO VERDE",0
6,"6051",1571,1192,1178,7,14,"RECORTES CERO-GRUPO VERDE",1
10,"10171",344,245,244,0,1,"RECORTES CERO-GRUPO VERDE",0
49,"49155",79,61,60,3,1,"RECORTES CERO-GRUPO VERDE",0
43,"43149",686,447,443,8,4,"RECORTES CERO-GRUPO VERDE",0
36,"36014",1942,1459,1444,9,15,"RECORTES CERO-GRUPO VERDE",2
8,"8189",127,90,89,3,1,"RECORTES CERO-GRUPO VERDE",0
24,"24118",126,88,88,1,0,"RECORTES CERO-GRUPO VERDE",0
1,"1018",1386,939,930,3,9,"RECORTES CERO-GRUPO VERDE",0
49,"49156",237,184,175,0,9,"RECORTES CERO-GRUPO VERDE",0
8,"8066",1365,926,921,8,5,"RECORTES CERO-GRUPO VERDE",2
5,"5182",786,538,532,2,6,"RECORTES CERO-GRUPO VERDE",0
34,"34047",1782,1397,1374,12,23,"RECORTES CERO-GRUPO VERDE",2
8,"8903",214,166,165,0,1,"RECORTES CERO-GRUPO VERDE",0
50,"50193",651,514,501,2,13,"RECORTES CERO-GRUPO VERDE",0
20,"20904",95,44,44,2,0,"RECORTES CERO-GRUPO VERDE",0
6,"6053",602,454,444,3,10,"RECORTES CERO-GRUPO VERDE",1
39,"39009",3216,2366,2337,17,29,"RECORTES CERO-GRUPO VERDE",3
22,"22036",92,77,77,0,0,"RECORTES CERO-GRUPO VERDE",0
14,"14004",2034,1531,1518,14,13,"RECORTES CERO-GRUPO VERDE",4
10,"10035",1920,1343,1315,5,28,"RECORTES CERO-GRUPO VERDE",1
50,"50194",88,63,63,1,0,"RECORTES CERO-GRUPO VERDE",0
49,"49036",506,374,367,2,7,"RECORTES CERO-GRUPO VERDE",0
29,"29024",386,227,219,2,8,"RECORTES CERO-GRUPO VERDE",0
8,"8191",5239,3454,3438,27,16,"RECORTES CERO-GRUPO VERDE",4
41,"41008",1059,749,739,10,10,"RECORTES CERO-GRUPO VERDE",1
4,"4001",1062,823,814,5,9,"RECORTES CERO-GRUPO VERDE",0
44,"44178",58,37,37,0,0,"RECORTES CERO-GRUPO VERDE",0
43,"43029",310,213,211,3,2,"RECORTES CERO-GRUPO VERDE",0
31,"31159",1107,844,833,6,11,"RECORTES CERO-GRUPO VERDE",0
9,"9257",93,81,80,4,1,"RECORTES CERO-GRUPO VERDE",0
27,"27008",1379,1000,982,9,18,"RECORTES CERO-GRUPO VERDE",1
46,"46085",11081,7938,7866,46,72,"RECORTES CERO-GRUPO VERDE",10
46,"46007",11989,8784,8711,67,73,"RECORTES CERO-GRUPO VERDE",21
34,"34049",359,266,260,1,6,"RECORTES CERO-GRUPO VERDE",0
29,"29025",39665,25907,25714,192,193,"RECORTES CERO-GRUPO VERDE",48
18,"18043",123,80,79,1,1,"RECORTES CERO-GRUPO VERDE",0
14,"14006",1330,1120,1101,8,19,"RECORTES CERO-GRUPO VERDE",1
1,"1020",327,237,234,3,3,"RECORTES CERO-GRUPO VERDE",0
4,"4033",135,97,93,1,4,"RECORTES CERO-GRUPO VERDE",0
16,"16187",74,55,55,1,0,"RECORTES CERO-GRUPO VERDE",0
43,"43153",10688,6675,6615,39,60,"RECORTES CERO-GRUPO VERDE",13
47,"47196",34,27,27,0,0,"RECORTES CERO-GRUPO VERDE",0
16,"16137",54,32,31,1,1,"RECORTES CERO-GRUPO VERDE",0
18,"18045",1126,756,742,4,14,"RECORTES CERO-GRUPO VERDE",2
46,"46086",82,70,69,1,1,"RECORTES CERO-GRUPO VERDE",0
24,"24023",263,188,188,1,0,"RECORTES CERO-GRUPO VERDE",0
46,"46008",2651,2108,2089,21,19,"RECORTES CERO-GRUPO VERDE",3
8,"8194",25660,15045,14941,122,104,"RECORTES CERO-GRUPO VERDE",140
49,"49039",338,245,239,3,6,"RECORTES CERO-GRUPO VERDE",0
27,"27010",4327,2899,2837,53,62,"RECORTES CERO-GRUPO VERDE",12
41,"41010",4420,2960,2916,30,44,"RECORTES CERO-GRUPO VERDE",3
34,"34051",101,88,83,0,5,"RECORTES CERO-GRUPO VERDE",0
30,"30011",4697,3421,3383,15,38,"RECORTES CERO-GRUPO VERDE",7
47,"47036",228,181,181,3,0,"RECORTES CERO-GRUPO VERDE",0
5,"5042",153,122,121,0,1,"RECORTES CERO-GRUPO VERDE",0
31,"31062",1087,830,818,3,12,"RECORTES CERO-GRUPO VERDE",2
31,"31162",47,31,31,0,0,"RECORTES CERO-GRUPO VERDE",0
8,"8195",82,63,63,0,0,"RECORTES CERO-GRUPO VERDE",0
47,"47118",168,127,127,2,0,"RECORTES CERO-GRUPO VERDE",0
1,"1022",799,557,544,2,13,"RECORTES CERO-GRUPO VERDE",3
19,"19213",70,62,61,2,1,"RECORTES CERO-GRUPO VERDE",0
25,"25120",92002,55658,55214,587,444,"RECORTES CERO-GRUPO VERDE",103
6,"6059",1851,1268,1258,7,10,"RECORTES CERO-GRUPO VERDE",1
43,"43034",477,350,342,9,8,"RECORTES CERO-GRUPO VERDE",0
27,"27013",3766,2900,2851,25,49,"RECORTES CERO-GRUPO VERDE",8
10,"10041",1057,795,781,4,14,"RECORTES CERO-GRUPO VERDE",0
41,"41100",1013,692,673,6,19,"RECORTES CERO-GRUPO VERDE",1
31,"31063",92,75,73,2,2,"RECORTES CERO-GRUPO VERDE",0
8,"8196",19233,12733,12671,94,62,"RECORTES CERO-GRUPO VERDE",30
40,"40004",459,356,352,2,4,"RECORTES CERO-GRUPO VERDE",0
24,"24025",297,228,227,0,1,"RECORTES CERO-GRUPO VERDE",0
5,"5190",53,42,41,2,1,"RECORTES CERO-GRUPO VERDE",0
19,"19215",168,144,140,0,4,"RECORTES CERO-GRUPO VERDE",0
15,"15023",6419,4348,4261,36,87,"RECORTES CERO-GRUPO VERDE",11
1,"1023",267,187,186,1,1,"RECORTES CERO-GRUPO VERDE",0
24,"24124",367,244,233,3,11,"RECORTES CERO-GRUPO VERDE",0
50,"50102",859,658,653,8,5,"RECORTES CERO-GRUPO VERDE",0
42,"42123",164,117,116,4,1,"RECORTES CERO-GRUPO VERDE",1
12,"12122",796,637,627,0,10,"RECORTES CERO-GRUPO VERDE",0
37,"37085",4712,3366,3333,27,33,"RECORTES CERO-GRUPO VERDE",9
16,"16048",408,313,312,1,1,"RECORTES CERO-GRUPO VERDE",0
4,"4037",1314,969,955,6,14,"RECORTES CERO-GRUPO VERDE",0
31,"31164",568,421,417,5,4,"RECORTES CERO-GRUPO VERDE",0
14,"14009",2788,1852,1834,20,18,"RECORTES CERO-GRUPO VERDE",1
31,"31065",1878,1351,1326,20,25,"RECORTES CERO-GRUPO VERDE",0
18,"18049",595,459,452,3,7,"RECORTES CERO-GRUPO VERDE",0
37,"37086",101,72,71,1,1,"RECORTES CERO-GRUPO VERDE",0
16,"16193",66,49,48,0,1,"RECORTES CERO-GRUPO VERDE",0
5,"5192",101,82,79,2,3,"RECORTES CERO-GRUPO VERDE",0
50,"50199",334,244,242,3,2,"RECORTES CERO-GRUPO VERDE",0
22,"22043",93,66,65,0,1,"RECORTES CERO-GRUPO VERDE",0
46,"46245",511,420,415,0,5,"RECORTES CERO-GRUPO VERDE",1
3,"3088",5498,4041,3989,29,52,"RECORTES CERO-GRUPO VERDE",2
37,"37215",136,104,103,1,1,"RECORTES CERO-GRUPO VERDE",2
14,"14010",4027,2850,2807,19,43,"RECORTES CERO-GRUPO VERDE",1
25,"25253",159,105,105,1,0,"RECORTES CERO-GRUPO VERDE",0
8,"8280",97,66,66,2,0,"RECORTES CERO-GRUPO VERDE",0
9,"9133",40,32,32,0,0,"RECORTES CERO-GRUPO VERDE",0
19,"19217",54,40,39,0,1,"RECORTES CERO-GRUPO VERDE",0
3,"3089",9571,6775,6639,47,136,"RECORTES CERO-GRUPO VERDE",7
10,"10183",980,733,728,1,5,"RECORTES CERO-GRUPO VERDE",0
24,"24028",388,292,288,2,4,"RECORTES CERO-GRUPO VERDE",1
27,"27018",3467,2086,2059,20,27,"RECORTES CERO-GRUPO VERDE",3
9,"9011",65,48,48,0,0,"RECORTES CERO-GRUPO VERDE",0
7,"7032",20034,12824,12710,110,114,"RECORTES CERO-GRUPO VERDE",24
37,"37216",302,252,248,3,4,"RECORTES CERO-GRUPO VERDE",0
16,"16050",245,201,195,1,6,"RECORTES CERO-GRUPO VERDE",0
27,"27019",8111,5773,5680,53,93,"RECORTES CERO-GRUPO VERDE",16
49,"49167",197,147,145,0,2,"RECORTES CERO-GRUPO VERDE",0
40,"40008",44,39,39,1,0,"RECORTES CERO-GRUPO VERDE",0
37,"37088",207,163,162,3,1,"RECORTES CERO-GRUPO VERDE",0
47,"47040",64,53,53,0,0,"RECORTES CERO-GRUPO VERDE",0
45,"45021",2500,1708,1665,12,43,"RECORTES CERO-GRUPO VERDE",4
18,"18051",1147,817,810,8,7,"RECORTES CERO-GRUPO VERDE",0
24,"24029",735,539,535,3,4,"RECORTES CERO-GRUPO VERDE",0
4,"4043",549,465,461,1,4,"RECORTES CERO-GRUPO VERDE",0
24,"24129",122,89,89,1,0,"RECORTES CERO-GRUPO VERDE",0
44,"44085",52,35,35,0,0,"RECORTES CERO-GRUPO VERDE",0
6,"6066",1762,1189,1182,2,7,"RECORTES CERO-GRUPO VERDE",0
7,"7034",1008,743,734,7,9,"RECORTES CERO-GRUPO VERDE",3
16,"16052",547,418,416,2,2,"RECORTES CERO-GRUPO VERDE",0
18,"18053",1630,1082,1076,8,6,"RECORTES CERO-GRUPO VERDE",4
25,"25126",290,200,198,2,2,"RECORTES CERO-GRUPO VERDE",0
28,"28059",4323,3171,3157,11,14,"RECORTES CERO-GRUPO VERDE",8
31,"31069",832,637,635,3,2,"RECORTES CERO-GRUPO VERDE",1
43,"43040",330,257,255,5,2,"RECORTES CERO-GRUPO VERDE",0
37,"37345",163,128,128,3,0,"RECORTES CERO-GRUPO VERDE",10
6,"6067",1972,1308,1292,8,16,"RECORTES CERO-GRUPO VERDE",2
29,"29033",1122,747,730,4,17,"RECORTES CERO-GRUPO VERDE",1
43,"43123",70482,44051,43675,345,376,"RECORTES CERO-GRUPO VERDE",128
50,"50108",48,38,38,0,0,"RECORTES CERO-GRUPO VERDE",0
37,"37091",177,117,116,1,1,"RECORTES CERO-GRUPO VERDE",0
9,"9269",36,26,26,1,0,"RECORTES CERO-GRUPO VERDE",0
44,"44189",56,41,41,0,0,"RECORTES CERO-GRUPO VERDE",0
48,"48059",400,294,291,0,3,"RECORTES CERO-GRUPO VERDE",0
10,"10188",499,382,374,4,8,"RECORTES CERO-GRUPO VERDE",2
10,"10050",1053,846,837,6,9,"RECORTES CERO-GRUPO VERDE",0
12,"12127",75,55,55,0,0,"RECORTES CERO-GRUPO VERDE",0
9,"9270",163,115,115,0,0,"RECORTES CERO-GRUPO VERDE",0
17,"17172",454,300,297,0,3,"RECORTES CERO-GRUPO VERDE",0
19,"19221",48,38,37,1,1,"RECORTES CERO-GRUPO VERDE",0
18,"18901",511,356,355,3,1,"RECORTES CERO-GRUPO VERDE",0
24,"24031",215,172,168,0,4,"RECORTES CERO-GRUPO VERDE",0
31,"31170",47,42,42,3,0,"RECORTES CERO-GRUPO VERDE",1
22,"22048",12598,8790,8731,91,59,"RECORTES CERO-GRUPO VERDE",22
6,"6069",3065,2053,2035,14,18,"RECORTES CERO-GRUPO VERDE",2
27,"27024",1598,1173,1158,8,15,"RECORTES CERO-GRUPO VERDE",1
2,"2901",2200,1440,1437,7,3,"RECORTES CERO-GRUPO VERDE",3
43,"43165",577,436,433,3,3,"RECORTES CERO-GRUPO VERDE",0
50,"50205",90,63,61,0,2,"RECORTES CERO-GRUPO VERDE",1
12,"12031",3807,2941,2894,24,47,"RECORTES CERO-GRUPO VERDE",4
31,"31071",17,16,16,0,0,"RECORTES CERO-GRUPO VERDE",0
25,"25003",3762,2215,2195,22,20,"RECORTES CERO-GRUPO VERDE",1
8,"8205",59828,43344,43140,367,204,"RECORTES CERO-GRUPO VERDE",77
8,"8206",728,523,515,5,8,"RECORTES CERO-GRUPO VERDE",1
29,"29036",632,423,416,2,7,"RECORTES CERO-GRUPO VERDE",1
47,"47126",50,41,41,0,0,"RECORTES CERO-GRUPO VERDE",0
37,"37223",110,85,83,0,2,"RECORTES CERO-GRUPO VERDE",0
3,"3001",337,269,268,0,1,"RECORTES CERO-GRUPO VERDE",0
9,"9273",52,40,39,2,1,"RECORTES CERO-GRUPO VERDE",0
46,"46016",1061,870,856,5,14,"RECORTES CERO-GRUPO VERDE",0
34,"34213",57,45,44,1,1,"RECORTES CERO-GRUPO VERDE",0
49,"49053",931,709,699,8,10,"RECORTES CERO-GRUPO VERDE",0
18,"18059",4180,2907,2870,20,37,"RECORTES CERO-GRUPO VERDE",2
10,"10054",547,431,421,1,10,"RECORTES CERO-GRUPO VERDE",0
19,"19223",111,83,83,3,0,"RECORTES CERO-GRUPO VERDE",0
34,"34066",59,49,48,0,1,"RECORTES CERO-GRUPO VERDE",0
29,"29037",209,158,157,1,1,"RECORTES CERO-GRUPO VERDE",0
4,"4013",141378,94872,94288,741,584,"RECORTES CERO-GRUPO VERDE",123
37,"37225",103,89,86,0,3,"RECORTES CERO-GRUPO VERDE",0
10,"10009",266,201,194,0,7,"RECORTES CERO-GRUPO VERDE",0
21,"21014",4016,3025,2991,21,34,"RECORTES CERO-GRUPO VERDE",6
27,"27028",79049,54057,53355,559,702,"RECORTES CERO-GRUPO VERDE",172
41,"41021",21294,13762,13570,145,192,"RECORTES CERO-GRUPO VERDE",29
9,"9018",24668,17575,17369,111,206,"RECORTES CERO-GRUPO VERDE",43
10,"10055",710,505,497,1,8,"RECORTES CERO-GRUPO VERDE",0
12,"12033",1919,1437,1404,19,33,"RECORTES CERO-GRUPO VERDE",0
39,"39023",6330,4737,4672,25,65,"RECORTES CERO-GRUPO VERDE",3
18,"18062",10393,7235,7161,63,74,"RECORTES CERO-GRUPO VERDE",13
31,"31173",861,683,667,3,16,"RECORTES CERO-GRUPO VERDE",0
10,"10193",1412,1090,1078,6,12,"RECORTES CERO-GRUPO VERDE",3
40,"40143",86,75,74,0,1,"RECORTES CERO-GRUPO VERDE",0
14,"14017",10868,7764,7665,71,99,"RECORTES CERO-GRUPO VERDE",6
9,"9141",616,485,483,5,2,"RECORTES CERO-GRUPO VERDE",2
3,"3096",5786,4358,4289,17,69,"RECORTES CERO-GRUPO VERDE",9
44,"44194",109,78,73,3,5,"RECORTES CERO-GRUPO VERDE",0
37,"37226",155,123,123,2,0,"RECORTES CERO-GRUPO VERDE",0
29,"29039",2666,1898,1873,22,25,"RECORTES CERO-GRUPO VERDE",3
28,"28133",5979,4140,4098,18,42,"RECORTES CERO-GRUPO VERDE",5
49,"49056",300,211,208,2,3,"RECORTES CERO-GRUPO VERDE",0
34,"34216",66,50,50,0,0,"RECORTES CERO-GRUPO VERDE",0
34,"34217",1207,937,923,8,14,"RECORTES CERO-GRUPO VERDE",3
43,"43048",805,525,513,8,12,"RECORTES CERO-GRUPO VERDE",3
50,"50208",1774,1207,1195,10,12,"RECORTES CERO-GRUPO VERDE",1
6,"6076",831,611,607,2,4,"RECORTES CERO-GRUPO VERDE",0
10,"10195",7709,5572,5481,37,91,"RECORTES CERO-GRUPO VERDE",7
44,"44195",88,60,60,1,0,"RECORTES CERO-GRUPO VERDE",0
25,"25134",623,369,366,3,3,"RECORTES CERO-GRUPO VERDE",0
49,"49176",667,433,431,1,2,"RECORTES CERO-GRUPO VERDE",0
31,"31175",71,48,48,0,0,"RECORTES CERO-GRUPO VERDE",0
25,"25008",1124,715,702,10,13,"RECORTES CERO-GRUPO VERDE",0
24,"24137",1099,783,778,7,5,"RECORTES CERO-GRUPO VERDE",2
41,"41024",22600,14263,14048,128,215,"RECORTES CERO-GRUPO VERDE",49
12,"12133",59,53,52,0,1,"RECORTES CERO-GRUPO VERDE",0
43,"43049",728,464,461,4,3,"RECORTES CERO-GRUPO VERDE",2
48,"48096",6577,4794,4728,31,66,"RECORTES CERO-GRUPO VERDE",13
37,"37145",259,190,189,2,1,"RECORTES CERO-GRUPO VERDE",0
19,"19073",23,19,19,0,0,"RECORTES CERO-GRUPO VERDE",0
26,"26099",1264,1003,991,9,12,"RECORTES CERO-GRUPO VERDE",0
16,"16211",370,263,263,3,0,"RECORTES CERO-GRUPO VERDE",0
10,"10059",364,253,248,1,5,"RECORTES CERO-GRUPO VERDE",0
8,"8212",488,319,316,0,3,"RECORTES CERO-GRUPO VERDE",0
9,"9236",38,32,32,0,0,"RECORTES CERO-GRUPO VERDE",0
6,"6078",507,409,404,1,5,"RECORTES CERO-GRUPO VERDE",0
47,"47130",96,72,72,0,0,"RECORTES CERO-GRUPO VERDE",0
18,"18065",618,496,470,3,26,"RECORTES CERO-GRUPO VERDE",0
18,"18066",2107,1392,1384,4,8,"RECORTES CERO-GRUPO VERDE",0
5,"5210",87,70,69,0,1,"RECORTES CERO-GRUPO VERDE",0
5,"5259",124,105,105,1,0,"RECORTES CERO-GRUPO VERDE",0
48,"48066",348,258,258,1,0,"RECORTES CERO-GRUPO VERDE",0
9,"9022",66,57,57,1,0,"RECORTES CERO-GRUPO VERDE",0
8,"8213",6319,3950,3935,37,15,"RECORTES CERO-GRUPO VERDE",3
10,"10199",165,112,111,1,1,"RECORTES CERO-GRUPO VERDE",1
49,"49179",371,238,237,0,1,"RECORTES CERO-GRUPO VERDE",0
5,"5064",103,83,82,0,1,"RECORTES CERO-GRUPO VERDE",0
9,"9280",28,20,20,0,0,"RECORTES CERO-GRUPO VERDE",0
16,"16213",36,34,34,0,0,"RECORTES CERO-GRUPO VERDE",0
37,"37106",258,165,162,0,3,"RECORTES CERO-GRUPO VERDE",0
18,"18909",579,435,429,0,6,"RECORTES CERO-GRUPO VERDE",0
4,"4052",12274,8372,8306,93,66,"RECORTES CERO-GRUPO VERDE",9
9,"9149",35,24,24,2,0,"RECORTES CERO-GRUPO VERDE",0
31,"31078",2429,1795,1767,15,28,"RECORTES CERO-GRUPO VERDE",5
7,"7046",15797,9127,9043,86,84,"RECORTES CERO-GRUPO VERDE",22
23,"23037",502,404,400,6,4,"RECORTES CERO-GRUPO VERDE",0
30,"30026",15734,10007,9901,51,106,"RECORTES CERO-GRUPO VERDE",9
24,"24040",449,329,325,2,4,"RECORTES CERO-GRUPO VERDE",0
8,"8215",2588,1663,1647,16,16,"RECORTES CERO-GRUPO VERDE",5
22,"22057",370,271,270,3,1,"RECORTES CERO-GRUPO VERDE",0
10,"10201",173,142,142,2,0,"RECORTES CERO-GRUPO VERDE",0
42,"42145",138,108,107,2,1,"RECORTES CERO-GRUPO VERDE",0
37,"37107",10764,7379,7264,56,115,"RECORTES CERO-GRUPO VERDE",11
40,"40150",69,61,61,1,0,"RECORTES CERO-GRUPO VERDE",0
5,"5066",453,367,367,5,0,"RECORTES CERO-GRUPO VERDE",0
24,"24041",538,367,366,3,1,"RECORTES CERO-GRUPO VERDE",2
21,"21022",171,107,105,0,2,"RECORTES CERO-GRUPO VERDE",0
31,"31179",502,348,345,0,3,"RECORTES CERO-GRUPO VERDE",0
37,"37234",345,247,247,1,0,"RECORTES CERO-GRUPO VERDE",0
8,"8216",25,15,15,1,0,"RECORTES CERO-GRUPO VERDE",0
37,"37108",99,79,78,0,1,"RECORTES CERO-GRUPO VERDE",0
7,"7048",17252,10055,9984,105,71,"RECORTES CERO-GRUPO VERDE",35
17,"17184",1254,814,809,6,5,"RECORTES CERO-GRUPO VERDE",0
18,"18912",1473,994,979,3,15,"RECORTES CERO-GRUPO VERDE",0
5,"5069",73,64,63,0,1,"RECORTES CERO-GRUPO VERDE",0
27,"27041",2341,1718,1705,16,13,"RECORTES CERO-GRUPO VERDE",2
19,"19231",10,9,9,0,0,"RECORTES CERO-GRUPO VERDE",0
8,"8094",1559,1112,1097,14,15,"RECORTES CERO-GRUPO VERDE",2
18,"18070",288,227,226,0,1,"RECORTES CERO-GRUPO VERDE",1
50,"50120",52,40,40,1,0,"RECORTES CERO-GRUPO VERDE",0
5,"5215",164,123,122,2,1,"RECORTES CERO-GRUPO VERDE",0
31,"31180",212,154,154,5,0,"RECORTES CERO-GRUPO VERDE",0
39,"39030",1895,1225,1212,10,13,"RECORTES CERO-GRUPO VERDE",2
10,"10066",160,122,122,0,0,"RECORTES CERO-GRUPO VERDE",0
49,"49064",515,346,338,6,8,"RECORTES CERO-GRUPO VERDE",0
27,"27042",1740,1235,1218,12,17,"RECORTES CERO-GRUPO VERDE",0
10,"10204",429,331,329,6,2,"RECORTES CERO-GRUPO VERDE",0
7,"7050",3348,2156,2139,19,17,"RECORTES CERO-GRUPO VERDE",9
42,"42017",140,113,112,0,1,"RECORTES CERO-GRUPO VERDE",0
24,"24043",134,75,75,1,0,"RECORTES CERO-GRUPO VERDE",0
37,"37110",113,86,86,1,0,"RECORTES CERO-GRUPO VERDE",0
29,"29046",2675,1825,1807,14,18,"RECORTES CERO-GRUPO VERDE",2
37,"37361",86,66,66,0,0,"RECORTES CERO-GRUPO VERDE",0
16,"16072",146,104,103,2,1,"RECORTES CERO-GRUPO VERDE",0
5,"5217",56,44,43,0,1,"RECORTES CERO-GRUPO VERDE",0
34,"34077",347,244,238,4,6,"RECORTES CERO-GRUPO VERDE",1
49,"49185",157,123,122,2,1,"RECORTES CERO-GRUPO VERDE",0
37,"37112",161,112,111,2,1,"RECORTES CERO-GRUPO VERDE",1
41,"41031",1238,825,814,11,11,"RECORTES CERO-GRUPO VERDE",0
24,"24044",168,119,118,1,1,"RECORTES CERO-GRUPO VERDE",0
10,"10206",215,157,157,3,0,"RECORTES CERO-GRUPO VERDE",0
19,"19233",80,65,63,1,2,"RECORTES CERO-GRUPO VERDE",0
22,"22189",185,145,144,5,1,"RECORTES CERO-GRUPO VERDE",0
31,"31182",34,28,28,0,0,"RECORTES CERO-GRUPO VERDE",0
4,"4057",1325,894,884,5,10,"RECORTES CERO-GRUPO VERDE",0
25,"25142",364,229,225,2,4,"RECORTES CERO-GRUPO VERDE",0
9,"9159",60,52,51,2,1,"RECORTES CERO-GRUPO VERDE",0
39,"39032",1463,1087,1081,7,6,"RECORTES CERO-GRUPO VERDE",1
46,"46025",2499,1953,1934,8,19,"RECORTES CERO-GRUPO VERDE",8
9,"9425",517,384,378,0,6,"RECORTES CERO-GRUPO VERDE",0
18,"18915",745,533,525,2,8,"RECORTES CERO-GRUPO VERDE",1
9,"9030",112,75,73,1,2,"RECORTES CERO-GRUPO VERDE",0
37,"37113",433,334,333,3,1,"RECORTES CERO-GRUPO VERDE",0
28,"28073",12549,8788,8701,54,87,"RECORTES CERO-GRUPO VERDE",25
27,"27046",1530,1022,1007,9,15,"RECORTES CERO-GRUPO VERDE",0
19,"19235",93,71,71,1,0,"RECORTES CERO-GRUPO VERDE",0
23,"23043",546,398,396,3,2,"RECORTES CERO-GRUPO VERDE",1
26,"26107",94,77,77,2,0,"RECORTES CERO-GRUPO VERDE",0
42,"42154",97,69,69,1,0,"RECORTES CERO-GRUPO VERDE",0
28,"28143",72,57,57,1,0,"RECORTES CERO-GRUPO VERDE",0
4,"4058",354,261,259,1,2,"RECORTES CERO-GRUPO VERDE",0
36,"36044",2541,1674,1646,7,28,"RECORTES CERO-GRUPO VERDE",4
45,"45039",224,192,190,0,2,"RECORTES CERO-GRUPO VERDE",0
37,"37365",172,134,133,1,1,"RECORTES CERO-GRUPO VERDE",0
12,"12045",345,268,259,1,9,"RECORTES CERO-GRUPO VERDE",0
19,"19123",40,32,31,1,1,"RECORTES CERO-GRUPO VERDE",0
47,"47217",1910,1370,1366,1,4,"RECORTES CERO-GRUPO VERDE",2
32,"32016",790,550,543,2,7,"RECORTES CERO-GRUPO VERDE",0
16,"16079",30,19,18,0,1,"RECORTES CERO-GRUPO VERDE",0
8,"8223",1852,1182,1171,12,11,"RECORTES CERO-GRUPO VERDE",4
40,"40158",17,12,12,0,0,"RECORTES CERO-GRUPO VERDE",0
42,"42021",83,55,55,3,0,"RECORTES CERO-GRUPO VERDE",0
20,"20013",5415,3602,3579,19,23,"RECORTES CERO-GRUPO VERDE",8
45,"45140",1087,833,823,3,10,"RECORTES CERO-GRUPO VERDE",1
31,"31185",494,341,341,1,0,"RECORTES CERO-GRUPO VERDE",0
39,"39034",286,188,185,5,3,"RECORTES CERO-GRUPO VERDE",0
8,"8224",820,557,551,2,6,"RECORTES CERO-GRUPO VERDE",1
27,"27050",2975,2190,2154,16,36,"RECORTES CERO-GRUPO VERDE",3
23,"23045",2132,1260,1247,5,13,"RECORTES CERO-GRUPO VERDE",0
5,"5222",147,127,126,1,1,"RECORTES CERO-GRUPO VERDE",0
19,"19238",42,28,28,0,0,"RECORTES CERO-GRUPO VERDE",0
41,"41035",1108,794,780,7,14,"RECORTES CERO-GRUPO VERDE",2
43,"43062",281,217,215,2,2,"RECORTES CERO-GRUPO VERDE",0
24,"24049",1483,1054,1048,6,6,"RECORTES CERO-GRUPO VERDE",0
6,"6092",577,415,405,3,10,"RECORTES CERO-GRUPO VERDE",1
50,"50125",360,248,246,3,2,"RECORTES CERO-GRUPO VERDE",1
50,"50281",73,51,50,0,1,"RECORTES CERO-GRUPO VERDE",0
15,"15012",3627,2659,2602,28,57,"RECORTES CERO-GRUPO VERDE",4
47,"47219",41,36,34,0,2,"RECORTES CERO-GRUPO VERDE",0
49,"49075",137,120,119,0,1,"RECORTES CERO-GRUPO VERDE",0
19,"19239",92,62,62,1,0,"RECORTES CERO-GRUPO VERDE",0
4,"4061",638,506,498,4,8,"RECORTES CERO-GRUPO VERDE",0
24,"24151",478,353,352,1,1,"RECORTES CERO-GRUPO VERDE",0
49,"49191",272,213,206,2,7,"RECORTES CERO-GRUPO VERDE",0
6,"6093",4447,3254,3204,15,50,"RECORTES CERO-GRUPO VERDE",5
10,"10212",1684,1233,1203,7,30,"RECORTES CERO-GRUPO VERDE",3
50,"50220",40,32,32,0,0,"RECORTES CERO-GRUPO VERDE",2
15,"15050",1822,1004,988,13,16,"RECORTES CERO-GRUPO VERDE",2
19,"19126",1627,1155,1134,11,21,"RECORTES CERO-GRUPO VERDE",3
19,"19005",84,66,66,0,0,"RECORTES CERO-GRUPO VERDE",0
29,"29052",224,144,144,3,0,"RECORTES CERO-GRUPO VERDE",1
41,"41037",3213,2376,2342,30,34,"RECORTES CERO-GRUPO VERDE",2
25,"25150",181,115,113,3,2,"RECORTES CERO-GRUPO VERDE",1
44,"44107",218,152,152,5,0,"RECORTES CERO-GRUPO VERDE",0
30,"30035",18671,13103,12979,54,124,"RECORTES CERO-GRUPO VERDE",17
22,"22199",7000,4737,4688,104,49,"RECORTES CERO-GRUPO VERDE",10
24,"24051",423,309,307,0,2,"RECORTES CERO-GRUPO VERDE",0
43,"43065",399,252,251,3,1,"RECORTES CERO-GRUPO VERDE",0
26,"26112",236,194,190,1,4,"RECORTES CERO-GRUPO VERDE",0
4,"4062",4504,3534,3490,18,44,"RECORTES CERO-GRUPO VERDE",4
1,"1056",219,136,135,0,1,"RECORTES CERO-GRUPO VERDE",1
10,"10031",165,135,134,1,1,"RECORTES CERO-GRUPO VERDE",1
22,"22067",65,50,50,1,0,"RECORTES CERO-GRUPO VERDE",0
27,"27055",1293,826,809,6,17,"RECORTES CERO-GRUPO VERDE",0
6,"6095",9504,6621,6475,96,146,"RECORTES CERO-GRUPO VERDE",18
14,"14030",8625,6248,6181,53,67,"RECORTES CERO-GRUPO VERDE",5
34,"34236",156,120,119,0,1,"RECORTES CERO-GRUPO VERDE",0
47,"47221",111,94,94,0,0,"RECORTES CERO-GRUPO VERDE",0
51,"51001",59125,31093,30737,316,356,"RECORTES CERO-GRUPO VERDE",117
1,"1057",240,201,200,1,1,"RECORTES CERO-GRUPO VERDE",1
41,"41038",100095,67313,66687,760,626,"RECORTES CERO-GRUPO VERDE",171
4,"4063",1096,776,768,2,8,"RECORTES CERO-GRUPO VERDE",0
14,"14031",593,469,459,3,10,"RECORTES CERO-GRUPO VERDE",0
27,"27056",1248,848,836,9,12,"RECORTES CERO-GRUPO VERDE",6
34,"34088",246,193,186,1,7,"RECORTES CERO-GRUPO VERDE",0
25,"25025",1353,871,864,16,7,"RECORTES CERO-GRUPO VERDE",2
22,"22068",79,60,60,0,0,"RECORTES CERO-GRUPO VERDE",0
29,"29055",1796,1354,1336,11,18,"RECORTES CERO-GRUPO VERDE",3
31,"31190",45,34,32,2,2,"RECORTES CERO-GRUPO VERDE",0
18,"18086",349,274,272,0,2,"RECORTES CERO-GRUPO VERDE",0
15,"15053",7729,5089,5043,49,46,"RECORTES CERO-GRUPO VERDE",14
24,"24053",442,286,280,1,6,"RECORTES CERO-GRUPO VERDE",0
15,"15054",32106,21026,20772,259,254,"RECORTES CERO-GRUPO VERDE",71
10,"10217",526,404,402,1,2,"RECORTES CERO-GRUPO VERDE",0
34,"34089",155,124,124,2,0,"RECORTES CERO-GRUPO VERDE",0
49,"49194",368,218,216,1,2,"RECORTES CERO-GRUPO VERDE",0
8,"8107",11502,7510,7445,67,65,"RECORTES CERO-GRUPO VERDE",22
5,"5085",35,27,27,0,0,"RECORTES CERO-GRUPO VERDE",0
39,"39040",4292,3208,3166,14,42,"RECORTES CERO-GRUPO VERDE",3
30,"30038",15411,10847,10767,46,80,"RECORTES CERO-GRUPO VERDE",17
48,"48080",9976,6820,6763,62,57,"RECORTES CERO-GRUPO VERDE",20
8,"8231",20564,13037,12952,96,85,"RECORTES CERO-GRUPO VERDE",43
15,"15055",4572,3070,3013,27,57,"RECORTES CERO-GRUPO VERDE",6
24,"24054",430,314,313,1,1,"RECORTES CERO-GRUPO VERDE",0
13,"13006",597,456,447,4,9,"RECORTES CERO-GRUPO VERDE",1
27,"27060",2598,1690,1665,19,25,"RECORTES CERO-GRUPO VERDE",6
41,"41041",9706,7239,7120,36,119,"RECORTES CERO-GRUPO VERDE",6
9,"9170",205,162,162,1,0,"RECORTES CERO-GRUPO VERDE",1
37,"37124",212,146,144,1,2,"RECORTES CERO-GRUPO VERDE",0
14,"14005",6311,4143,4084,72,59,"RECORTES CERO-GRUPO VERDE",0
19,"19244",82,65,64,1,1,"RECORTES CERO-GRUPO VERDE",0
31,"31093",292,188,188,2,0,"RECORTES CERO-GRUPO VERDE",0
44,"44212",39,37,37,1,0,"RECORTES CERO-GRUPO VERDE",1
47,"47143",118,91,90,0,1,"RECORTES CERO-GRUPO VERDE",0
12,"12053",2034,1655,1633,6,22,"RECORTES CERO-GRUPO VERDE",0
19,"19010",8,8,8,0,0,"RECORTES CERO-GRUPO VERDE",0
5,"5233",221,191,191,1,0,"RECORTES CERO-GRUPO VERDE",0
41,"41042",5844,4424,4378,40,46,"RECORTES CERO-GRUPO VERDE",3
46,"46033",191,156,155,0,1,"RECORTES CERO-GRUPO VERDE",0
3,"3114",1562,1198,1188,9,10,"RECORTES CERO-GRUPO VERDE",0
21,"21039",311,225,223,1,2,"RECORTES CERO-GRUPO VERDE",0
7,"7065",2083,1346,1328,9,18,"RECORTES CERO-GRUPO VERDE",3
10,"10902",721,548,540,4,8,"RECORTES CERO-GRUPO VERDE",0
37,"37251",124,93,92,1,1,"RECORTES CERO-GRUPO VERDE",3
40,"40168",34,29,29,1,0,"RECORTES CERO-GRUPO VERDE",0
31,"31094",111,82,82,0,0,"RECORTES CERO-GRUPO VERDE",0
10,"10176",371,262,261,0,1,"RECORTES CERO-GRUPO VERDE",0
3,"3115",255,222,220,2,2,"RECORTES CERO-GRUPO VERDE",0
36,"36055",13620,9580,9400,62,180,"RECORTES CERO-GRUPO VERDE",21
37,"37126",29,24,24,0,0,"RECORTES CERO-GRUPO VERDE",0
21,"21040",3170,2129,2071,20,58,"RECORTES CERO-GRUPO VERDE",2
7,"7901",610,462,459,7,3,"RECORTES CERO-GRUPO VERDE",0
49,"49083",52,44,44,2,0,"RECORTES CERO-GRUPO VERDE",0
37,"37127",214,154,151,1,3,"RECORTES CERO-GRUPO VERDE",0
21,"21041",113337,72318,71637,748,681,"RECORTES CERO-GRUPO VERDE",196
26,"26015",196,158,157,2,1,"RECORTES CERO-GRUPO VERDE",0
45,"45149",556,446,440,0,6,"RECORTES CERO-GRUPO VERDE",0
49,"49202",187,130,130,4,0,"RECORTES CERO-GRUPO VERDE",1
5,"5090",77,68,68,1,0,"RECORTES CERO-GRUPO VERDE",0
48,"48083",6958,4885,4856,40,29,"RECORTES CERO-GRUPO VERDE",11
31,"31195",182,130,128,0,2,"RECORTES CERO-GRUPO VERDE",0
33,"33050",592,387,376,2,11,"RECORTES CERO-GRUPO VERDE",0
1,"1062",313,211,210,2,1,"RECORTES CERO-GRUPO VERDE",0
43,"43073",83,60,58,0,2,"RECORTES CERO-GRUPO VERDE",1
21,"21042",15350,7643,7530,124,113,"RECORTES CERO-GRUPO VERDE",18
41,"41044",7423,5273,5241,34,32,"RECORTES CERO-GRUPO VERDE",8
47,"47063",103,81,80,1,1,"RECORTES CERO-GRUPO VERDE",0
46,"46035",6822,5202,5142,43,60,"RECORTES CERO-GRUPO VERDE",5
10,"10905",656,446,439,2,7,"RECORTES CERO-GRUPO VERDE",1
4,"4069",4687,3471,3437,27,34,"RECORTES CERO-GRUPO VERDE",3
27,"27066",12696,8704,8537,98,167,"RECORTES CERO-GRUPO VERDE",36
37,"37254",181,142,141,0,1,"RECORTES CERO-GRUPO VERDE",0
17,"17085",301,215,214,5,1,"RECORTES CERO-GRUPO VERDE",0
25,"25034",2326,1361,1340,15,21,"RECORTES CERO-GRUPO VERDE",2
19,"19138",255,202,201,2,1,"RECORTES CERO-GRUPO VERDE",0
45,"45151",578,417,414,0,3,"RECORTES CERO-GRUPO VERDE",0
36,"36058",4994,3292,3243,33,49,"RECORTES CERO-GRUPO VERDE",3
22,"22206",193,129,128,1,1,"RECORTES CERO-GRUPO VERDE",0
31,"31197",69,56,56,2,0,"RECORTES CERO-GRUPO VERDE",0
17,"17203",153,99,99,0,0,"RECORTES CERO-GRUPO VERDE",0
13,"13014",492,398,397,1,1,"RECORTES CERO-GRUPO VERDE",0
47,"47064",33,28,25,0,3,"RECORTES CERO-GRUPO VERDE",0
49,"49086",115,96,91,0,5,"RECORTES CERO-GRUPO VERDE",0
12,"12058",71,63,62,1,1,"RECORTES CERO-GRUPO VERDE",0
31,"31098",1903,1428,1419,19,9,"RECORTES CERO-GRUPO VERDE",6
40,"40173",138,99,93,1,6,"RECORTES CERO-GRUPO VERDE",0
50,"50040",89,75,75,0,0,"RECORTES CERO-GRUPO VERDE",0
30,"30901",10309,7821,7718,43,103,"RECORTES CERO-GRUPO VERDE",11
16,"16096",274,232,229,1,3,"RECORTES CERO-GRUPO VERDE",0
10,"10090",513,362,353,2,9,"RECORTES CERO-GRUPO VERDE",0
50,"50231",250,195,192,4,3,"RECORTES CERO-GRUPO VERDE",0
6,"6108",2275,1567,1527,11,40,"RECORTES CERO-GRUPO VERDE",4
31,"31198",37,25,25,0,0,"RECORTES CERO-GRUPO VERDE",0
40,"40174",349,254,251,2,3,"RECORTES CERO-GRUPO VERDE",0
25,"25164",376,242,238,4,4,"RECORTES CERO-GRUPO VERDE",1
14,"14038",32322,22117,21887,179,230,"RECORTES CERO-GRUPO VERDE",14
26,"26122",118,102,102,0,0,"RECORTES CERO-GRUPO VERDE",0
40,"40047",30,25,25,0,0,"RECORTES CERO-GRUPO VERDE",0
30,"30902",7975,5318,5273,24,45,"RECORTES CERO-GRUPO VERDE",10
47,"47065",857,674,669,1,5,"RECORTES CERO-GRUPO VERDE",1
25,"25124",166,106,105,1,1,"RECORTES CERO-GRUPO VERDE",0
44,"44219",194,145,143,1,2,"RECORTES CERO-GRUPO VERDE",0
9,"9312",96,78,77,0,1,"RECORTES CERO-GRUPO VERDE",0
28,"28156",1019,742,738,3,4,"RECORTES CERO-GRUPO VERDE",2
41,"41048",2228,1470,1447,15,23,"RECORTES CERO-GRUPO VERDE",5
8,"8005",6205,4187,4167,22,20,"RECORTES CERO-GRUPO VERDE",9
2,"2001",656,527,523,1,4,"RECORTES CERO-GRUPO VERDE",0
33,"33054",1682,1159,1149,12,10,"RECORTES CERO-GRUPO VERDE",7
49,"49207",239,150,146,0,4,"RECORTES CERO-GRUPO VERDE",0
34,"34102",205,169,168,1,1,"RECORTES CERO-GRUPO VERDE",0
34,"34903",198,131,131,1,0,"RECORTES CERO-GRUPO VERDE",1
19,"19252",69,60,60,0,0,"RECORTES CERO-GRUPO VERDE",0
8,"8241",73,52,52,0,0,"RECORTES CERO-GRUPO VERDE",0
14,"14039",2604,2062,2021,12,41,"RECORTES CERO-GRUPO VERDE",2
36,"36061",8606,6232,6133,41,99,"RECORTES CERO-GRUPO VERDE",9
8,"8118",17547,12183,12108,105,75,"RECORTES CERO-GRUPO VERDE",37
16,"16254",214,174,170,2,4,"RECORTES CERO-GRUPO VERDE",1
13,"13019",5181,3621,3579,18,42,"RECORTES CERO-GRUPO VERDE",3
19,"19145",46,41,41,1,0,"RECORTES CERO-GRUPO VERDE",0
26,"26125",2699,1931,1907,23,24,"RECORTES CERO-GRUPO VERDE",1
49,"49208",394,248,244,2,4,"RECORTES CERO-GRUPO VERDE",0
38,"38002",956,702,696,21,6,"RECORTES CERO-GRUPO VERDE",1
47,"47150",274,209,205,0,4,"RECORTES CERO-GRUPO VERDE",0
48,"48089",3306,2341,2329,20,12,"RECORTES CERO-GRUPO VERDE",2
21,"21048",305,214,210,4,4,"RECORTES CERO-GRUPO VERDE",0
8,"8119",6180,4155,4123,28,32,"RECORTES CERO-GRUPO VERDE",22
31,"31201",147715,105455,104658,1007,797,"RECORTES CERO-GRUPO VERDE",303
41,"41050",5150,3817,3777,19,40,"RECORTES CERO-GRUPO VERDE",4
9,"9052",29,23,23,0,0,"RECORTES CERO-GRUPO VERDE",0
2,"2004",612,479,473,5,6,"RECORTES CERO-GRUPO VERDE",0
6,"6112",393,323,321,2,2,"RECORTES CERO-GRUPO VERDE",0
29,"29066",334,234,233,4,1,"RECORTES CERO-GRUPO VERDE",1
4,"4074",2840,2000,1979,23,21,"RECORTES CERO-GRUPO VERDE",3
10,"10187",438,308,305,1,3,"RECORTES CERO-GRUPO VERDE",0
46,"46040",1078,888,878,7,10,"RECORTES CERO-GRUPO VERDE",2
6,"6113",2721,2004,1971,7,33,"RECORTES CERO-GRUPO VERDE",2
12,"12064",91,82,81,2,1,"RECORTES CERO-GRUPO VERDE",0
24,"24064",1523,1101,1087,3,14,"RECORTES CERO-GRUPO VERDE",0
37,"37002",139,87,86,0,1,"RECORTES CERO-GRUPO VERDE",0
18,"18102",8400,5592,5504,44,88,"RECORTES CERO-GRUPO VERDE",5
34,"34106",109,89,86,2,3,"RECORTES CERO-GRUPO VERDE",0
13,"13023",8973,6291,6242,44,49,"RECORTES CERO-GRUPO VERDE",6
4,"4075",5196,3735,3706,23,29,"RECORTES CERO-GRUPO VERDE",5
37,"37137",105,66,66,0,0,"RECORTES CERO-GRUPO VERDE",1
26,"26024",228,181,181,0,0,"RECORTES CERO-GRUPO VERDE",0
25,"25041",568,347,344,4,3,"RECORTES CERO-GRUPO VERDE",2
19,"19022",625,476,469,3,7,"RECORTES CERO-GRUPO VERDE",0
41,"41052",3013,2116,2064,14,52,"RECORTES CERO-GRUPO VERDE",4
45,"45158",2514,1777,1760,11,17,"RECORTES CERO-GRUPO VERDE",1
25,"25170",266,169,167,1,2,"RECORTES CERO-GRUPO VERDE",0
6,"6115",1261,841,832,5,9,"RECORTES CERO-GRUPO VERDE",1
8,"8122",1698,1080,1073,5,7,"RECORTES CERO-GRUPO VERDE",0
24,"24065",2138,1503,1472,15,31,"RECORTES CERO-GRUPO VERDE",1
22,"22084",535,403,399,4,4,"RECORTES CERO-GRUPO VERDE",2
38,"38006",39766,20776,20587,139,189,"RECORTES CERO-GRUPO VERDE",39
44,"44223",72,54,54,0,0,"RECORTES CERO-GRUPO VERDE",0
37,"37139",205,169,168,2,1,"RECORTES CERO-GRUPO VERDE",0
11,"11008",17471,10952,10812,128,140,"RECORTES CERO-GRUPO VERDE",19
19,"19257",3403,2430,2402,19,28,"RECORTES CERO-GRUPO VERDE",4
6,"6116",1587,1171,1160,10,11,"RECORTES CERO-GRUPO VERDE",0
44,"44017",285,227,223,4,4,"RECORTES CERO-GRUPO VERDE",1
47,"47069",124,105,104,1,1,"RECORTES CERO-GRUPO VERDE",2
22,"22085",104,86,86,0,0,"RECORTES CERO-GRUPO VERDE",0
18,"18105",3782,2450,2420,17,30,"RECORTES CERO-GRUPO VERDE",0
24,"24066",494,368,366,4,2,"RECORTES CERO-GRUPO VERDE",0
4,"4077",295,263,261,2,2,"RECORTES CERO-GRUPO VERDE",0
49,"49219",7464,4988,4914,53,74,"RECORTES CERO-GRUPO VERDE",7
3,"3032",108,91,90,1,1,"RECORTES CERO-GRUPO VERDE",1
18,"18106",425,293,290,0,3,"RECORTES CERO-GRUPO VERDE",0
21,"21053",3316,2141,2107,17,34,"RECORTES CERO-GRUPO VERDE",6
50,"50047",48,36,36,0,0,"RECORTES CERO-GRUPO VERDE",2
24,"24033",205,158,157,0,1,"RECORTES CERO-GRUPO VERDE",0
31,"31073",294,212,208,2,4,"RECORTES CERO-GRUPO VERDE",1
28,"28161",48848,35503,35203,210,300,"RECORTES CERO-GRUPO VERDE",87
9,"9323",61,46,46,1,0,"RECORTES CERO-GRUPO VERDE",0
11,"11010",6410,4189,4130,88,59,"RECORTES CERO-GRUPO VERDE",11
25,"25173",1705,1156,1143,14,13,"RECORTES CERO-GRUPO VERDE",4
8,"8248",5419,3566,3546,45,20,"RECORTES CERO-GRUPO VERDE",0
2,"2009",19660,14256,14116,127,140,"RECORTES CERO-GRUPO VERDE",15
44,"44225",107,74,74,1,0,"RECORTES CERO-GRUPO VERDE",0
42,"42045",301,206,197,2,9,"RECORTES CERO-GRUPO VERDE",0
39,"39053",219,153,152,2,1,"RECORTES CERO-GRUPO VERDE",1
45,"45061",2447,1703,1689,12,14,"RECORTES CERO-GRUPO VERDE",1
8,"8125",25081,16406,16329,164,77,"RECORTES CERO-GRUPO VERDE",61
24,"24169",2969,2140,2118,13,22,"RECORTES CERO-GRUPO VERDE",2
6,"6120",3389,2502,2478,12,24,"RECORTES CERO-GRUPO VERDE",3
37,"37142",586,430,429,1,1,"RECORTES CERO-GRUPO VERDE",0
8,"8014",1962,1366,1359,15,7,"RECORTES CERO-GRUPO VERDE",3
3,"3034",1376,1067,1052,5,15,"RECORTES CERO-GRUPO VERDE",0
28,"28163",442,344,339,1,5,"RECORTES CERO-GRUPO VERDE",0
24,"24068",457,344,340,0,4,"RECORTES CERO-GRUPO VERDE",0
37,"37143",389,301,300,6,1,"RECORTES CERO-GRUPO VERDE",0
39,"39054",4493,3376,3334,33,42,"RECORTES CERO-GRUPO VERDE",1
19,"19260",42,39,39,1,0,"RECORTES CERO-GRUPO VERDE",0
9,"9372",212,176,176,4,0,"RECORTES CERO-GRUPO VERDE",0
16,"16270",162,137,137,0,0,"RECORTES CERO-GRUPO VERDE",0
41,"41056",3687,2841,2812,30,29,"RECORTES CERO-GRUPO VERDE",2
48,"48095",2347,1555,1546,12,9,"RECORTES CERO-GRUPO VERDE",1
24,"24170",1908,1365,1345,8,20,"RECORTES CERO-GRUPO VERDE",2
12,"12070",522,406,401,0,5,"RECORTES CERO-GRUPO VERDE",0
46,"46260",2581,2087,2068,22,19,"RECORTES CERO-GRUPO VERDE",6
44,"44126",329,234,229,4,5,"RECORTES CERO-GRUPO VERDE",2
24,"24070",4124,3024,2981,20,43,"RECORTES CERO-GRUPO VERDE",4
19,"19032",165,126,124,1,2,"RECORTES CERO-GRUPO VERDE",0
32,"32049",760,510,507,9,3,"RECORTES CERO-GRUPO VERDE",1
48,"48004",335,222,222,0,0,"RECORTES CERO-GRUPO VERDE",0
46,"46045",1249,1028,1010,3,18,"RECORTES CERO-GRUPO VERDE",0
19,"19033",64,52,50,1,2,"RECORTES CERO-GRUPO VERDE",0
31,"31010",5705,3718,3680,29,38,"RECORTES CERO-GRUPO VERDE",12
28,"28106",76907,52773,52265,385,508,"RECORTES CERO-GRUPO VERDE",164
25,"25176",309,216,211,1,5,"RECORTES CERO-GRUPO VERDE",0
46,"46261",1725,1356,1337,5,19,"RECORTES CERO-GRUPO VERDE",0
11,"11013",2312,1547,1518,15,29,"RECORTES CERO-GRUPO VERDE",0
28,"28010",9963,7745,7688,25,57,"RECORTES CERO-GRUPO VERDE",11
48,"48005",115,63,61,0,2,"RECORTES CERO-GRUPO VERDE",0
16,"16212",247,203,202,0,1,"RECORTES CERO-GRUPO VERDE",0
41,"41058",17395,12556,12332,111,224,"RECORTES CERO-GRUPO VERDE",16
50,"50148",316,233,229,4,4,"RECORTES CERO-GRUPO VERDE",0
20,"20037",99,64,64,2,0,"RECORTES CERO-GRUPO VERDE",0
22,"22089",302,225,223,0,2,"RECORTES CERO-GRUPO VERDE",0
49,"49263",51,36,36,0,0,"RECORTES CERO-GRUPO VERDE",0
9,"9375",36,31,31,0,0,"RECORTES CERO-GRUPO VERDE",0
18,"18114",609,424,422,8,2,"RECORTES CERO-GRUPO VERDE",0
24,"24071",1006,745,734,10,11,"RECORTES CERO-GRUPO VERDE",1
19,"19263",26,15,15,1,0,"RECORTES CERO-GRUPO VERDE",0
44,"44229",152,112,111,3,1,"RECORTES CERO-GRUPO VERDE",0
3,"3131",175,154,147,0,7,"RECORTES CERO-GRUPO VERDE",1
6,"6125",1743,1285,1269,7,16,"RECORTES CERO-GRUPO VERDE",0
33,"33065",1102,722,713,7,9,"RECORTES CERO-GRUPO VERDE",0
42,"42051",20,14,14,1,0,"RECORTES CERO-GRUPO VERDE",0
45,"45066",7570,5550,5484,25,66,"RECORTES CERO-GRUPO VERDE",6
31,"31211",27,15,15,1,0,"RECORTES CERO-GRUPO VERDE",0
46,"46047",532,446,437,2,9,"RECORTES CERO-GRUPO VERDE",1
9,"9329",121,87,87,1,0,"RECORTES CERO-GRUPO VERDE",2
43,"43093",3919,2461,2434,47,27,"RECORTES CERO-GRUPO VERDE",6
31,"31012",793,563,555,6,8,"RECORTES CERO-GRUPO VERDE",3
42,"42189",60,46,45,0,1,"RECORTES CERO-GRUPO VERDE",0
37,"37148",427,298,295,3,3,"RECORTES CERO-GRUPO VERDE",0
46,"46204",6681,5256,5202,32,54,"RECORTES CERO-GRUPO VERDE",9
41,"41060",15242,10021,9847,86,174,"RECORTES CERO-GRUPO VERDE",14
13,"13037",842,661,652,1,9,"RECORTES CERO-GRUPO VERDE",0
5,"5117",200,174,173,1,1,"RECORTES CERO-GRUPO VERDE",0
17,"17220",796,538,536,5,2,"RECORTES CERO-GRUPO VERDE",0
4,"4084",341,249,247,2,2,"RECORTES CERO-GRUPO VERDE",0
31,"31013",642,406,401,1,5,"RECORTES CERO-GRUPO VERDE",0
44,"44231",38,33,33,0,0,"RECORTES CERO-GRUPO VERDE",0
43,"43095",2474,1575,1551,17,24,"RECORTES CERO-GRUPO VERDE",8
35,"35010",3558,2341,2301,28,40,"RECORTES CERO-GRUPO VERDE",1
8,"8257",107,71,71,0,0,"RECORTES CERO-GRUPO VERDE",0
49,"49228",54,44,43,0,1,"RECORTES CERO-GRUPO VERDE",0
11,"11017",3212,2233,2203,39,30,"RECORTES CERO-GRUPO VERDE",1
19,"19266",236,188,188,1,0,"RECORTES CERO-GRUPO VERDE",0
16,"16277",113,84,83,1,1,"RECORTES CERO-GRUPO VERDE",0
21,"21063",2615,2001,1957,22,44,"RECORTES CERO-GRUPO VERDE",3
46,"46205",14313,10932,10834,51,98,"RECORTES CERO-GRUPO VERDE",20
31,"31213",104,52,52,0,0,"RECORTES CERO-GRUPO VERDE",0
4,"4085",387,304,301,2,3,"RECORTES CERO-GRUPO VERDE",0
40,"40068",26,24,24,0,0,"RECORTES CERO-GRUPO VERDE",0
38,"38016",1223,638,623,3,15,"RECORTES CERO-GRUPO VERDE",5
22,"22227",206,163,160,3,3,"RECORTES CERO-GRUPO VERDE",1
47,"47160",425,308,303,0,5,"RECORTES CERO-GRUPO VERDE",0
49,"49145",236,162,157,0,5,"RECORTES CERO-GRUPO VERDE",0
18,"18119",1702,1298,1283,13,15,"RECORTES CERO-GRUPO VERDE",1
16,"16278",70,55,55,0,0,"RECORTES CERO-GRUPO VERDE",0
37,"37017",245,182,177,1,5,"RECORTES CERO-GRUPO VERDE",0
25,"25055",169,105,104,4,1,"RECORTES CERO-GRUPO VERDE",0
40,"40194",39602,29382,29042,206,340,"RECORTES CERO-GRUPO VERDE",94
13,"13041",244,170,165,1,5,"RECORTES CERO-GRUPO VERDE",0
11,"11019",1826,1302,1248,7,54,"RECORTES CERO-GRUPO VERDE",2
28,"28079",2362038,1743924,1733354,8859,10570,"RECORTES CERO-GRUPO VERDE",3651
9,"9467",64,43,42,1,1,"RECORTES CERO-GRUPO VERDE",1
17,"17106",140,103,102,0,1,"RECORTES CERO-GRUPO VERDE",2
32,"32057",565,416,415,4,1,"RECORTES CERO-GRUPO VERDE",1
31,"31215",4676,3284,3240,36,44,"RECORTES CERO-GRUPO VERDE",6
25,"25185",692,400,397,6,3,"RECORTES CERO-GRUPO VERDE",0
42,"42056",23,20,20,0,0,"RECORTES CERO-GRUPO VERDE",0
39,"39062",1812,1379,1366,5,13,"RECORTES CERO-GRUPO VERDE",2
4,"4087",182,135,135,0,0,"RECORTES CERO-GRUPO VERDE",0
2,"2021",1017,784,778,6,6,"RECORTES CERO-GRUPO VERDE",0
34,"34126",277,200,199,2,1,"RECORTES CERO-GRUPO VERDE",0
6,"6132",855,587,582,3,5,"RECORTES CERO-GRUPO VERDE",2
17,"17107",264,167,165,8,2,"RECORTES CERO-GRUPO VERDE",0
43,"43099",306,228,226,4,2,"RECORTES CERO-GRUPO VERDE",0
9,"9337",117,92,91,0,1,"RECORTES CERO-GRUPO VERDE",1
8,"8261",2327,1499,1493,11,6,"RECORTES CERO-GRUPO VERDE",1
24,"24079",906,664,658,9,6,"RECORTES CERO-GRUPO VERDE",1
22,"22229",114,80,80,1,0,"RECORTES CERO-GRUPO VERDE",1
29,"29070",40333,25991,25728,214,263,"RECORTES CERO-GRUPO VERDE",82
4,"4088",2454,1660,1650,15,10,"RECORTES CERO-GRUPO VERDE",1
48,"48012",2049,1527,1512,7,15,"RECORTES CERO-GRUPO VERDE",1
9,"9338",227,170,169,0,1,"RECORTES CERO-GRUPO VERDE",0
31,"31216",3865,2702,2671,33,31,"RECORTES CERO-GRUPO VERDE",10
11,"11021",6764,4434,4362,52,72,"RECORTES CERO-GRUPO VERDE",0
49,"49232",96,74,74,1,0,"RECORTES CERO-GRUPO VERDE",0
31,"31217",321,226,223,1,3,"RECORTES CERO-GRUPO VERDE",1
50,"50248",508,387,374,2,13,"RECORTES CERO-GRUPO VERDE",1
44,"44236",63,48,47,0,1,"RECORTES CERO-GRUPO VERDE",0
47,"47002",23,21,20,1,1,"RECORTES CERO-GRUPO VERDE",0
39,"39063",967,697,690,9,7,"RECORTES CERO-GRUPO VERDE",1
44,"44029",559,425,424,5,1,"RECORTES CERO-GRUPO VERDE",0
25,"25190",262,185,183,0,2,"RECORTES CERO-GRUPO VERDE",0
44,"44237",398,304,301,4,3,"RECORTES CERO-GRUPO VERDE",0
28,"28017",1208,907,899,7,8,"RECORTES CERO-GRUPO VERDE",1
21,"21069",1702,1167,1149,6,18,"RECORTES CERO-GRUPO VERDE",0
3,"3044",4521,3510,3465,21,45,"RECORTES CERO-GRUPO VERDE",2
48,"48907",348,266,266,2,0,"RECORTES CERO-GRUPO VERDE",0
46,"46131",49431,36570,36227,231,343,"RECORTES CERO-GRUPO VERDE",54
41,"41067",7093,4930,4866,37,64,"RECORTES CERO-GRUPO VERDE",3
33,"33071",595,433,430,10,3,"RECORTES CERO-GRUPO VERDE",1
31,"31119",39,26,26,0,0,"RECORTES CERO-GRUPO VERDE",0
39,"39064",1345,1031,1015,7,16,"RECORTES CERO-GRUPO VERDE",1
15,"15085",3332,2280,2247,25,33,"RECORTES CERO-GRUPO VERDE",4
34,"34130",212,164,163,1,1,"RECORTES CERO-GRUPO VERDE",0
46,"46053",553,445,436,2,9,"RECORTES CERO-GRUPO VERDE",0
47,"47164",378,313,311,1,2,"RECORTES CERO-GRUPO VERDE",0
41,"41068",13939,9787,9674,72,113,"RECORTES CERO-GRUPO VERDE",12
49,"49234",412,328,324,0,4,"RECORTES CERO-GRUPO VERDE",1
49,"49235",443,301,292,0,9,"RECORTES CERO-GRUPO VERDE",2
29,"29073",1579,1091,1080,7,11,"RECORTES CERO-GRUPO VERDE",2
47,"47003",227,180,179,3,1,"RECORTES CERO-GRUPO VERDE",0
18,"18126",1483,1081,1074,15,7,"RECORTES CERO-GRUPO VERDE",2
19,"19272",72,54,53,1,1,"RECORTES CERO-GRUPO VERDE",0
11,"11024",6723,4696,4634,44,62,"RECORTES CERO-GRUPO VERDE",3
50,"50061",202,172,172,3,0,"RECORTES CERO-GRUPO VERDE",0
46,"46028",387,330,328,3,2,"RECORTES CERO-GRUPO VERDE",0
6,"6138",1047,727,715,5,12,"RECORTES CERO-GRUPO VERDE",1
6,"6001",686,522,515,0,7,"RECORTES CERO-GRUPO VERDE",1
8,"8265",1553,1028,1018,11,10,"RECORTES CERO-GRUPO VERDE",1
8,"8266",43030,30192,30039,229,153,"RECORTES CERO-GRUPO VERDE",96
24,"24082",858,629,614,8,15,"RECORTES CERO-GRUPO VERDE",1
31,"31021",62,39,38,0,1,"RECORTES CERO-GRUPO VERDE",0
39,"39066",872,667,661,4,6,"RECORTES CERO-GRUPO VERDE",4
28,"28020",145,94,94,0,0,"RECORTES CERO-GRUPO VERDE",0
49,"49236",75,58,58,0,0,"RECORTES CERO-GRUPO VERDE",0
41,"41069",29138,18991,18683,341,308,"RECORTES CERO-GRUPO VERDE",43
10,"10122",218,156,153,3,3,"RECORTES CERO-GRUPO VERDE",0
8,"8143",2682,1718,1707,17,11,"RECORTES CERO-GRUPO VERDE",4
25,"25062",750,486,482,1,4,"RECORTES CERO-GRUPO VERDE",1
9,"9073",926,691,686,4,5,"RECORTES CERO-GRUPO VERDE",2
40,"40076",6492,4768,4700,26,68,"RECORTES CERO-GRUPO VERDE",3
43,"43106",810,526,522,7,4,"RECORTES CERO-GRUPO VERDE",0
16,"16906",80,67,67,1,0,"RECORTES CERO-GRUPO VERDE",0
44,"44240",158,130,129,0,1,"RECORTES CERO-GRUPO VERDE",0
28,"28021",554,370,364,3,6,"RECORTES CERO-GRUPO VERDE",0
34,"34133",107,91,90,0,1,"RECORTES CERO-GRUPO VERDE",0
39,"39067",790,513,505,1,8,"RECORTES CERO-GRUPO VERDE",0
3,"3047",9207,6309,6226,25,83,"RECORTES CERO-GRUPO VERDE",11
20,"20049",4122,2677,2666,15,11,"RECORTES CERO-GRUPO VERDE",5
21,"21074",2649,1755,1733,13,22,"RECORTES CERO-GRUPO VERDE",0
10,"10123",578,481,475,1,6,"RECORTES CERO-GRUPO VERDE",2
10,"10124",852,665,655,2,10,"RECORTES CERO-GRUPO VERDE",0
6,"6141",1719,1201,1189,8,12,"RECORTES CERO-GRUPO VERDE",1
41,"41071",5586,3724,3661,22,63,"RECORTES CERO-GRUPO VERDE",5
19,"19170",193,135,135,0,0,"RECORTES CERO-GRUPO VERDE",0
9,"9482",33,28,28,0,0,"RECORTES CERO-GRUPO VERDE",0
26,"26043",365,292,281,1,11,"RECORTES CERO-GRUPO VERDE",0
39,"39068",646,450,445,2,5,"RECORTES CERO-GRUPO VERDE",1
6,"6142",273,205,197,2,8,"RECORTES CERO-GRUPO VERDE",0
16,"16909",699,535,532,0,3,"RECORTES CERO-GRUPO VERDE",0
44,"44243",24,20,20,0,0,"RECORTES CERO-GRUPO VERDE",0
10,"10125",888,635,622,4,13,"RECORTES CERO-GRUPO VERDE",0
39,"39069",1972,1510,1489,12,21,"RECORTES CERO-GRUPO VERDE",2
43,"43108",1774,1172,1160,14,12,"RECORTES CERO-GRUPO VERDE",3
45,"45078",1379,1129,1119,6,10,"RECORTES CERO-GRUPO VERDE",0
28,"28087",3186,2503,2487,19,16,"RECORTES CERO-GRUPO VERDE",1
45,"45079",369,288,286,3,2,"RECORTES CERO-GRUPO VERDE",0
5,"5133",66,53,53,0,0,"RECORTES CERO-GRUPO VERDE",0
43,"43109",2606,1491,1475,20,16,"RECORTES CERO-GRUPO VERDE",5
16,"16910",91,69,69,1,0,"RECORTES CERO-GRUPO VERDE",0
48,"48019",3553,2406,2397,18,9,"RECORTES CERO-GRUPO VERDE",5
47,"47168",29,26,26,1,0,"RECORTES CERO-GRUPO VERDE",0
4,"4095",714,471,468,5,3,"RECORTES CERO-GRUPO VERDE",0
17,"17001",587,404,398,2,6,"RECORTES CERO-GRUPO VERDE",1
49,"49240",206,162,161,2,1,"RECORTES CERO-GRUPO VERDE",0
17,"17118",12711,7567,7515,42,52,"RECORTES CERO-GRUPO VERDE",8
38,"38028",22103,15036,14844,85,192,"RECORTES CERO-GRUPO VERDE",25
24,"24087",631,470,466,7,4,"RECORTES CERO-GRUPO VERDE",2
19,"19280",3464,2469,2438,14,31,"RECORTES CERO-GRUPO VERDE",3
17,"17119",74,54,54,0,0,"RECORTES CERO-GRUPO VERDE",0
24,"24088",1029,791,789,10,2,"RECORTES CERO-GRUPO VERDE",0
38,"38029",1517,744,734,1,10,"RECORTES CERO-GRUPO VERDE",1
10,"10127",4703,3183,3132,21,51,"RECORTES CERO-GRUPO VERDE",5
42,"42069",1536,1036,1019,6,17,"RECORTES CERO-GRUPO VERDE",2
6,"6145",922,696,694,5,2,"RECORTES CERO-GRUPO VERDE",0
9,"9351",62,49,48,1,1,"RECORTES CERO-GRUPO VERDE",0
41,"41074",3012,2282,2257,18,25,"RECORTES CERO-GRUPO VERDE",1
8,"8272",151,90,90,1,0,"RECORTES CERO-GRUPO VERDE",0
14,"14033",1283,971,959,9,12,"RECORTES CERO-GRUPO VERDE",1
28,"28178",1065,824,818,5,6,"RECORTES CERO-GRUPO VERDE",1
31,"31126",358,223,223,2,0,"RECORTES CERO-GRUPO VERDE",0
45,"45181",2315,1674,1640,7,34,"RECORTES CERO-GRUPO VERDE",1
11,"11030",22775,15157,14958,149,199,"RECORTES CERO-GRUPO VERDE",27
24,"24089",102747,74428,73688,631,740,"RECORTES CERO-GRUPO VERDE",115
6,"6146",1084,838,830,1,8,"RECORTES CERO-GRUPO VERDE",0
46,"46059",1261,1035,1019,9,16,"RECORTES CERO-GRUPO VERDE",1
14,"14061",744,595,582,1,13,"RECORTES CERO-GRUPO VERDE",0
49,"49242",447,360,357,5,3,"RECORTES CERO-GRUPO VERDE",1
37,"37167",173,143,140,2,3,"RECORTES CERO-GRUPO VERDE",0
16,"16135",134,92,92,2,0,"RECORTES CERO-GRUPO VERDE",0
31,"31027",836,532,530,2,2,"RECORTES CERO-GRUPO VERDE",0
17,"17004",512,335,334,4,1,"RECORTES CERO-GRUPO VERDE",1
47,"47009",107,86,85,0,1,"RECORTES CERO-GRUPO VERDE",0
15,"15901",3546,2247,2228,24,19,"RECORTES CERO-GRUPO VERDE",8
17,"17121",224,140,140,1,0,"RECORTES CERO-GRUPO VERDE",0
18,"18137",989,761,760,7,1,"RECORTES CERO-GRUPO VERDE",0
28,"28025",420,320,315,4,5,"RECORTES CERO-GRUPO VERDE",0
31,"31228",486,341,337,2,4,"RECORTES CERO-GRUPO VERDE",3
31,"31028",212,131,131,0,0,"RECORTES CERO-GRUPO VERDE",0
32,"32075",4217,3089,3044,33,45,"RECORTES CERO-GRUPO VERDE",12
13,"13062",574,453,448,3,5,"RECORTES CERO-GRUPO VERDE",0
18,"18002",553,395,393,1,2,"RECORTES CERO-GRUPO VERDE",0
4,"4098",1516,1115,1106,11,9,"RECORTES CERO-GRUPO VERDE",1
41,"41076",2183,1341,1327,19,14,"RECORTES CERO-GRUPO VERDE",5
17,"17005",413,257,252,3,5,"RECORTES CERO-GRUPO VERDE",0
19,"19053",2008,1422,1404,10,18,"RECORTES CERO-GRUPO VERDE",1
22,"22115",360,257,256,3,1,"RECORTES CERO-GRUPO VERDE",0
34,"34141",177,149,145,2,4,"RECORTES CERO-GRUPO VERDE",0
38,"38032",13237,8908,8828,52,80,"RECORTES CERO-GRUPO VERDE",26
45,"45083",472,368,365,0,3,"RECORTES CERO-GRUPO VERDE",2
44,"44147",412,298,293,5,5,"RECORTES CERO-GRUPO VERDE",1
48,"48023",600,455,452,0,3,"RECORTES CERO-GRUPO VERDE",0
6,"6150",802,602,596,4,6,"RECORTES CERO-GRUPO VERDE",0
8,"8153",538,386,385,2,1,"RECORTES CERO-GRUPO VERDE",1
3,"3054",343,277,275,3,2,"RECORTES CERO-GRUPO VERDE",0
45,"45084",2257,1679,1656,13,23,"RECORTES CERO-GRUPO VERDE",1
9,"9354",33,29,28,2,1,"RECORTES CERO-GRUPO VERDE",0
23,"23097",6443,4117,4063,21,54,"RECORTES CERO-GRUPO VERDE",5
17,"17006",1127,686,682,1,4,"RECORTES CERO-GRUPO VERDE",2
49,"49246",227,190,183,2,7,"RECORTES CERO-GRUPO VERDE",1
43,"43116",451,324,317,5,7,"RECORTES CERO-GRUPO VERDE",0
37,"37171",409,317,310,2,7,"RECORTES CERO-GRUPO VERDE",0
47,"47090",2418,1728,1699,8,29,"RECORTES CERO-GRUPO VERDE",1
20,"20057",196,122,122,0,0,"RECORTES CERO-GRUPO VERDE",0
49,"49005",149,91,91,2,0,"RECORTES CERO-GRUPO VERDE",0
46,"46140",344,284,279,0,5,"RECORTES CERO-GRUPO VERDE",0
25,"25206",260,150,150,5,0,"RECORTES CERO-GRUPO VERDE",0
4,"4100",8768,5390,5353,32,37,"RECORTES CERO-GRUPO VERDE",11
8,"8278",4779,3161,3148,20,13,"RECORTES CERO-GRUPO VERDE",1
19,"19286",720,547,543,2,4,"RECORTES CERO-GRUPO VERDE",0
9,"9356",42,33,32,0,1,"RECORTES CERO-GRUPO VERDE",0
14,"14065",1850,1384,1377,16,7,"RECORTES CERO-GRUPO VERDE",1
50,"50261",213,157,157,0,0,"RECORTES CERO-GRUPO VERDE",0
10,"10135",1302,981,969,3,12,"RECORTES CERO-GRUPO VERDE",1
42,"42213",27,21,21,1,0,"RECORTES CERO-GRUPO VERDE",0
28,"28183",1039,743,735,2,8,"RECORTES CERO-GRUPO VERDE",1
28,"28093",2096,1670,1653,10,17,"RECORTES CERO-GRUPO VERDE",2
22,"22119",1291,942,935,5,7,"RECORTES CERO-GRUPO VERDE",1
31,"31131",901,646,638,7,8,"RECORTES CERO-GRUPO VERDE",1
13,"13067",351,281,279,0,2,"RECORTES CERO-GRUPO VERDE",0
42,"42215",773,531,520,7,11,"RECORTES CERO-GRUPO VERDE",0
9,"9358",255,194,190,3,4,"RECORTES CERO-GRUPO VERDE",0
48,"48025",883,642,637,7,5,"RECORTES CERO-GRUPO VERDE",0
16,"16143",16,14,14,2,0,"RECORTES CERO-GRUPO VERDE",0
6,"6154",2802,1923,1894,23,29,"RECORTES CERO-GRUPO VERDE",0
49,"49248",186,151,150,1,1,"RECORTES CERO-GRUPO VERDE",0
32,"32080",328,249,244,5,5,"RECORTES CERO-GRUPO VERDE",1
35,"35025",1797,1261,1245,4,16,"RECORTES CERO-GRUPO VERDE",2
22,"22122",64,57,57,2,0,"RECORTES CERO-GRUPO VERDE",0
9,"9048",1467,1048,1033,13,15,"RECORTES CERO-GRUPO VERDE",3
42,"42080",157,117,115,0,2,"RECORTES CERO-GRUPO VERDE",0
47,"47092",110,87,87,0,0,"RECORTES CERO-GRUPO VERDE",0
34,"34151",159,104,103,0,1,"RECORTES CERO-GRUPO VERDE",0
17,"17010",336,224,224,3,0,"RECORTES CERO-GRUPO VERDE",0
40,"40089",222,167,164,0,3,"RECORTES CERO-GRUPO VERDE",1
46,"46142",787,619,602,1,17,"RECORTES CERO-GRUPO VERDE",1
6,"6155",1874,1218,1202,16,16,"RECORTES CERO-GRUPO VERDE",5
20,"20060",88,67,67,2,0,"RECORTES CERO-GRUPO VERDE",0
24,"24095",320,234,232,0,2,"RECORTES CERO-GRUPO VERDE",0
45,"45088",2115,1351,1338,4,13,"RECORTES CERO-GRUPO VERDE",3
50,"50171",106,79,79,0,0,"RECORTES CERO-GRUPO VERDE",0
28,"28030",1726,1320,1299,8,21,"RECORTES CERO-GRUPO VERDE",3
4,"4103",1476,1018,1008,3,10,"RECORTES CERO-GRUPO VERDE",1
4,"4008",505,423,417,5,6,"RECORTES CERO-GRUPO VERDE",0
49,"49250",1245,935,920,7,15,"RECORTES CERO-GRUPO VERDE",1
35,"35026",81091,51953,51195,407,758,"RECORTES CERO-GRUPO VERDE",172
42,"42081",145,102,100,1,2,"RECORTES CERO-GRUPO VERDE",1
9,"9361",115,90,89,0,1,"RECORTES CERO-GRUPO VERDE",0
8,"8282",6578,4714,4690,45,24,"RECORTES CERO-GRUPO VERDE",11
25,"25210",1108,685,677,3,8,"RECORTES CERO-GRUPO VERDE",0
6,"6157",443,321,316,1,5,"RECORTES CERO-GRUPO VERDE",0
19,"19290",834,561,558,5,3,"RECORTES CERO-GRUPO VERDE",3
10,"10140",1106,820,808,4,12,"RECORTES CERO-GRUPO VERDE",0
40,"40092",118,87,87,1,0,"RECORTES CERO-GRUPO VERDE",2
17,"17012",1145,703,698,9,5,"RECORTES CERO-GRUPO VERDE",0
24,"24096",117,80,79,1,1,"RECORTES CERO-GRUPO VERDE",0
49,"49010",345,279,273,5,6,"RECORTES CERO-GRUPO VERDE",0
34,"34154",74,55,53,1,2,"RECORTES CERO-GRUPO VERDE",1
24,"24097",218,140,139,3,1,"RECORTES CERO-GRUPO VERDE",0
11,"11039",10018,6186,6109,103,77,"RECORTES CERO-GRUPO VERDE",8
2,"2044",1105,768,758,7,10,"RECORTES CERO-GRUPO VERDE",0
5,"5151",91,71,71,1,0,"RECORTES CERO-GRUPO VERDE",0
22,"22082",291,213,212,1,1,"RECORTES CERO-GRUPO VERDE",2
16,"16149",148,124,122,2,2,"RECORTES CERO-GRUPO VERDE",0
34,"34155",129,104,103,2,1,"RECORTES CERO-GRUPO VERDE",0
2,"2045",3665,2895,2855,21,40,"RECORTES CERO-GRUPO VERDE",1
44,"44258",67,47,47,0,0,"RECORTES CERO-GRUPO VERDE",0
17,"17013",2787,1780,1762,17,18,"RECORTES CERO-GRUPO VERDE",3
49,"49255",418,319,316,1,3,"RECORTES CERO-GRUPO VERDE",0
49,"49252",320,254,252,5,2,"RECORTES CERO-GRUPO VERDE",0
45,"45091",394,269,267,3,2,"RECORTES CERO-GRUPO VERDE",0
10,"10004",704,492,482,9,10,"RECORTES CERO-GRUPO VERDE",0
25,"25081",308,189,189,2,0,"RECORTES CERO-GRUPO VERDE",0
18,"18013",4218,3024,2986,15,38,"RECORTES CERO-GRUPO VERDE",5
18,"18149",5230,3903,3864,20,39,"RECORTES CERO-GRUPO VERDE",6
13,"13075",211,164,161,1,3,"RECORTES CERO-GRUPO VERDE",0
11,"11040",397,307,292,1,15,"RECORTES CERO-GRUPO VERDE",0
24,"24199",424,302,301,0,1,"RECORTES CERO-GRUPO VERDE",1
4,"4903",4320,2858,2825,19,33,"RECORTES CERO-GRUPO VERDE",2
2,"2047",117,88,88,2,0,"RECORTES CERO-GRUPO VERDE",0
3,"3061",1056,776,768,4,8,"RECORTES CERO-GRUPO VERDE",3
39,"39081",437,337,332,4,5,"RECORTES CERO-GRUPO VERDE",0
45,"45092",232,197,191,0,6,"RECORTES CERO-GRUPO VERDE",0
32,"32088",1622,1018,1002,8,16,"RECORTES CERO-GRUPO VERDE",3
13,"13077",3489,2205,2152,18,53,"RECORTES CERO-GRUPO VERDE",6
19,"19294",29,27,27,0,0,"RECORTES CERO-GRUPO VERDE",0
17,"17135",362,253,253,1,0,"RECORTES CERO-GRUPO VERDE",0
16,"16012",84,72,71,0,1,"RECORTES CERO-GRUPO VERDE",0
37,"37180",75,56,56,0,0,"RECORTES CERO-GRUPO VERDE",0
29,"29092",570,397,390,4,7,"RECORTES CERO-GRUPO VERDE",1
10,"10145",127,97,95,0,2,"RECORTES CERO-GRUPO VERDE",0
46,"46068",346,276,266,6,10,"RECORTES CERO-GRUPO VERDE",0
14,"14071",929,642,630,2,12,"RECORTES CERO-GRUPO VERDE",2
28,"28034",361,274,269,1,5,"RECORTES CERO-GRUPO VERDE",0
25,"25217",10625,6319,6260,99,59,"RECORTES CERO-GRUPO VERDE",8
41,"41087",10237,6923,6774,48,149,"RECORTES CERO-GRUPO VERDE",4
5,"5001",191,148,147,2,1,"RECORTES CERO-GRUPO VERDE",0
49,"49257",291,190,184,1,6,"RECORTES CERO-GRUPO VERDE",1
9,"9368",22,17,17,2,0,"RECORTES CERO-GRUPO VERDE",0
28,"28035",1353,1006,998,2,8,"RECORTES CERO-GRUPO VERDE",1
37,"37182",75,56,55,0,1,"RECORTES CERO-GRUPO VERDE",0
16,"16265",20,19,19,0,0,"RECORTES CERO-GRUPO VERDE",0
40,"40183",130,120,119,2,1,"RECORTES CERO-GRUPO VERDE",0
29,"29093",2214,1643,1621,3,22,"RECORTES CERO-GRUPO VERDE",2
37,"37309",44,30,30,1,0,"RECORTES CERO-GRUPO VERDE",0
16,"16153",949,778,772,7,6,"RECORTES CERO-GRUPO VERDE",0
47,"47097",325,266,265,0,1,"RECORTES CERO-GRUPO VERDE",0
13,"13080",351,266,266,2,0,"RECORTES CERO-GRUPO VERDE",0
34,"34022",1082,873,861,9,12,"RECORTES CERO-GRUPO VERDE",0
6,"6902",1667,1121,1113,13,8,"RECORTES CERO-GRUPO VERDE",2
10,"10147",1278,961,925,7,36,"RECORTES CERO-GRUPO VERDE",2
34,"34159",357,253,248,4,5,"RECORTES CERO-GRUPO VERDE",0
19,"19070",74,53,53,0,0,"RECORTES CERO-GRUPO VERDE",0
18,"18153",8597,6024,5972,40,52,"RECORTES CERO-GRUPO VERDE",8
28,"28036",2539,1899,1878,11,21,"RECORTES CERO-GRUPO VERDE",3
24,"24101",397,258,257,3,1,"RECORTES CERO-GRUPO VERDE",0
34,"34160",139,115,114,3,1,"RECORTES CERO-GRUPO VERDE",1
25,"25219",141,102,101,0,1,"RECORTES CERO-GRUPO VERDE",0
5,"5005",182,148,147,3,1,"RECORTES CERO-GRUPO VERDE",0
24,"24102",652,470,467,2,3,"RECORTES CERO-GRUPO VERDE",0
49,"49135",626,434,430,1,4,"RECORTES CERO-GRUPO VERDE",2
49,"49016",247,176,174,5,2,"RECORTES CERO-GRUPO VERDE",0
2,"2051",1676,1177,1162,6,15,"RECORTES CERO-GRUPO VERDE",0
22,"22131",82,63,63,0,0,"RECORTES CERO-GRUPO VERDE",0
27,"27031",15570,10606,10420,118,186,"RECORTES CERO-GRUPO VERDE",29
31,"31041",1606,1114,1101,15,13,"RECORTES CERO-GRUPO VERDE",1
2,"2052",459,372,369,4,3,"RECORTES CERO-GRUPO VERDE",0
49,"49017",251,180,177,1,3,"RECORTES CERO-GRUPO VERDE",0
4,"4015",124,96,96,2,0,"RECORTES CERO-GRUPO VERDE",0
16,"16156",97,78,77,0,1,"RECORTES CERO-GRUPO VERDE",0
45,"45096",1004,807,799,1,8,"RECORTES CERO-GRUPO VERDE",0
25,"25221",122,81,81,0,0,"RECORTES CERO-GRUPO VERDE",0
50,"50081",511,382,378,4,4,"RECORTES CERO-GRUPO VERDE",0
41,"41090",3523,2576,2512,13,64,"RECORTES CERO-GRUPO VERDE",1
44,"44265",186,141,138,2,3,"RECORTES CERO-GRUPO VERDE",0
29,"29096",2810,1944,1909,31,35,"RECORTES CERO-GRUPO VERDE",7
44,"44053",105,78,78,0,0,"RECORTES CERO-GRUPO VERDE",1
31,"31043",38,31,30,1,1,"RECORTES CERO-GRUPO VERDE",1
47,"47021",76,64,64,0,0,"RECORTES CERO-GRUPO VERDE",0
46,"46098",2482,1907,1889,11,18,"RECORTES CERO-GRUPO VERDE",3
48,"48065",3281,2271,2237,8,34,"RECORTES CERO-GRUPO VERDE",4
18,"18022",13432,8491,8407,67,84,"RECORTES CERO-GRUPO VERDE",8
25,"25092",130,98,95,2,3,"RECORTES CERO-GRUPO VERDE",0
10,"10014",1852,1370,1346,6,24,"RECORTES CERO-GRUPO VERDE",0
29,"29097",4108,2871,2821,37,50,"RECORTES CERO-GRUPO VERDE",1
50,"50271",252,200,197,2,3,"RECORTES CERO-GRUPO VERDE",0
19,"19301",40,33,33,1,0,"RECORTES CERO-GRUPO VERDE",0
39,"39087",41985,31178,30805,228,373,"RECORTES CERO-GRUPO VERDE",48
16,"16019",214,156,152,0,4,"RECORTES CERO-GRUPO VERDE",0
44,"44161",443,314,313,2,1,"RECORTES CERO-GRUPO VERDE",0
19,"19074",72,62,62,0,0,"RECORTES CERO-GRUPO VERDE",0
50,"50272",12904,8880,8819,84,61,"RECORTES CERO-GRUPO VERDE",24
37,"37103",436,310,308,8,2,"RECORTES CERO-GRUPO VERDE",0
9,"9148",87,70,68,3,2,"RECORTES CERO-GRUPO VERDE",0
37,"37188",181,129,129,3,0,"RECORTES CERO-GRUPO VERDE",2
18,"18159",995,797,795,2,2,"RECORTES CERO-GRUPO VERDE",0
28,"28039",128,98,97,2,1,"RECORTES CERO-GRUPO VERDE",0
31,"31244",158,87,86,1,1,"RECORTES CERO-GRUPO VERDE",0
31,"31245",81,55,55,2,0,"RECORTES CERO-GRUPO VERDE",0
39,"39088",69,52,52,0,0,"RECORTES CERO-GRUPO VERDE",0
48,"48037",673,481,478,5,3,"RECORTES CERO-GRUPO VERDE",0
5,"5014",5379,4009,3970,18,39,"RECORTES CERO-GRUPO VERDE",3
47,"47102",291,230,220,1,10,"RECORTES CERO-GRUPO VERDE",0
50,"50084",77,59,59,2,0,"RECORTES CERO-GRUPO VERDE",0
45,"45200",4592,3539,3476,14,63,"RECORTES CERO-GRUPO VERDE",7
22,"22019",180,151,150,2,1,"RECORTES CERO-GRUPO VERDE",2
34,"34168",52,47,47,2,0,"RECORTES CERO-GRUPO VERDE",1
49,"49021",14330,9878,9758,95,120,"RECORTES CERO-GRUPO VERDE",7
8,"8051",17948,12140,12076,102,64,"RECORTES CERO-GRUPO VERDE",30
46,"46074",2696,2069,2038,14,31,"RECORTES CERO-GRUPO VERDE",6
46,"46230",13960,10351,10241,54,110,"RECORTES CERO-GRUPO VERDE",14
25,"25225",564,356,356,1,0,"RECORTES CERO-GRUPO VERDE",0
48,"48038",1126,798,794,3,4,"RECORTES CERO-GRUPO VERDE",0
24,"24106",248,167,166,1,1,"RECORTES CERO-GRUPO VERDE",0
47,"47023",2995,2344,2326,18,18,"RECORTES CERO-GRUPO VERDE",3
37,"37190",215,171,171,1,0,"RECORTES CERO-GRUPO VERDE",0
19,"19078",50,44,43,0,1,"RECORTES CERO-GRUPO VERDE",0
31,"31246",140,111,107,1,4,"RECORTES CERO-GRUPO VERDE",0
29,"29100",2433,1684,1667,5,17,"RECORTES CERO-GRUPO VERDE",1
43,"43013",4411,2750,2739,19,11,"RECORTES CERO-GRUPO VERDE",7
39,"39090",756,553,542,0,11,"RECORTES CERO-GRUPO VERDE",0
22,"22907",1435,1059,1046,18,13,"RECORTES CERO-GRUPO VERDE",0
15,"15004",4834,3436,3391,30,45,"RECORTES CERO-GRUPO VERDE",4
16,"16162",43,35,34,0,1,"RECORTES CERO-GRUPO VERDE",0
5,"5017",85,82,81,5,1,"RECORTES CERO-GRUPO VERDE",0
9,"9241",202,156,154,4,2,"RECORTES CERO-GRUPO VERDE",0
9,"9380",78,58,58,0,0,"RECORTES CERO-GRUPO VERDE",0
47,"47024",259,208,207,1,1,"RECORTES CERO-GRUPO VERDE",0
34,"34170",61,42,42,0,0,"RECORTES CERO-GRUPO VERDE",0
48,"48039",239,190,188,0,2,"RECORTES CERO-GRUPO VERDE",2
2,"2059",302,234,232,1,2,"RECORTES CERO-GRUPO VERDE",0
1,"1004",1399,1008,995,8,13,"RECORTES CERO-GRUPO VERDE",1
38,"38053",3735,2469,2435,17,34,"RECORTES CERO-GRUPO VERDE",7
48,"48070",544,362,362,4,0,"RECORTES CERO-GRUPO VERDE",0
9,"9381",30,24,24,1,0,"RECORTES CERO-GRUPO VERDE",0
15,"15005",24516,15761,15537,213,224,"RECORTES CERO-GRUPO VERDE",42
42,"42097",23,14,11,0,3,"RECORTES CERO-GRUPO VERDE",1
37,"37193",390,279,275,4,4,"RECORTES CERO-GRUPO VERDE",0
50,"50087",26,17,17,1,0,"RECORTES CERO-GRUPO VERDE",0
12,"12007",746,651,636,3,15,"RECORTES CERO-GRUPO VERDE",1
29,"29013",1610,1238,1207,9,31,"RECORTES CERO-GRUPO VERDE",0
46,"46232",895,711,696,5,15,"RECORTES CERO-GRUPO VERDE",0
50,"50277",50,42,41,0,1,"RECORTES CERO-GRUPO VERDE",0
13,"13094",304,249,247,1,2,"RECORTES CERO-GRUPO VERDE",0
12,"12008",222,193,192,1,1,"RECORTES CERO-GRUPO VERDE",0
16,"16026",82,62,61,2,1,"RECORTES CERO-GRUPO VERDE",0
46,"46077",7496,5909,5827,45,82,"RECORTES CERO-GRUPO VERDE",7
43,"43139",2039,1218,1191,8,27,"RECORTES CERO-GRUPO VERDE",0
37,"37194",251,196,195,1,1,"RECORTES CERO-GRUPO VERDE",0
17,"17148",1515,981,972,4,9,"RECORTES CERO-GRUPO VERDE",2
19,"19306",25,20,20,1,0,"RECORTES CERO-GRUPO VERDE",0
31,"31249",1872,1290,1273,14,17,"RECORTES CERO-GRUPO VERDE",3
18,"18167",1895,1258,1250,4,8,"RECORTES CERO-GRUPO VERDE",0
29,"29904",421,338,335,3,3,"RECORTES CERO-GRUPO VERDE",0
26,"26177",304,255,254,7,1,"RECORTES CERO-GRUPO VERDE",0
12,"12109",649,532,524,6,8,"RECORTES CERO-GRUPO VERDE",0
37,"37195",46,36,36,1,0,"RECORTES CERO-GRUPO VERDE",0
24,"24110",1247,899,892,6,7,"RECORTES CERO-GRUPO VERDE",1
39,"39002",3298,2342,2309,13,33,"RECORTES CERO-GRUPO VERDE",5
7,"7012",1876,1369,1353,13,16,"RECORTES CERO-GRUPO VERDE",4
45,"45004",567,410,406,1,4,"RECORTES CERO-GRUPO VERDE",2
49,"49270",133,99,99,1,0,"RECORTES CERO-GRUPO VERDE",0
15,"15008",5627,4112,4072,36,40,"RECORTES CERO-GRUPO VERDE",9
2,"2063",1463,1073,1060,3,13,"RECORTES CERO-GRUPO VERDE",4
4,"4023",138,96,95,2,1,"RECORTES CERO-GRUPO VERDE",0
40,"40905",133,103,100,1,3,"RECORTES CERO-GRUPO VERDE",0
10,"10162",575,437,433,2,4,"RECORTES CERO-GRUPO VERDE",1
17,"17031",168,97,97,3,0,"RECORTES CERO-GRUPO VERDE",0
5,"5024",224,169,168,3,1,"RECORTES CERO-GRUPO VERDE",0
9,"9386",54,39,38,1,1,"RECORTES CERO-GRUPO VERDE",0
18,"18170",330,219,217,0,2,"RECORTES CERO-GRUPO VERDE",0
37,"37323",516,376,372,5,4,"RECORTES CERO-GRUPO VERDE",0
45,"45901",771,547,544,3,3,"RECORTES CERO-GRUPO VERDE",1
26,"26071",8491,5834,5761,47,73,"RECORTES CERO-GRUPO VERDE",11
23,"23004",436,364,358,1,6,"RECORTES CERO-GRUPO VERDE",0
47,"47028",33,21,21,0,0,"RECORTES CERO-GRUPO VERDE",0
46,"46235",21579,15929,15763,113,166,"RECORTES CERO-GRUPO VERDE",31
12,"12010",259,213,208,2,5,"RECORTES CERO-GRUPO VERDE",0
22,"22144",243,188,187,1,1,"RECORTES CERO-GRUPO VERDE",0
9,"9387",117,95,90,0,5,"RECORTES CERO-GRUPO VERDE",0
8,"8059",347,195,195,2,0,"RECORTES CERO-GRUPO VERDE",0
17,"17032",1721,967,961,10,6,"RECORTES CERO-GRUPO VERDE",3
20,"20079",17886,11860,11799,91,61,"RECORTES CERO-GRUPO VERDE",15
19,"19309",26,21,21,0,0,"RECORTES CERO-GRUPO VERDE",0
24,"24113",366,293,287,5,6,"RECORTES CERO-GRUPO VERDE",1
30,"30002",9903,7011,6943,28,68,"RECORTES CERO-GRUPO VERDE",7
50,"50280",332,253,250,0,3,"RECORTES CERO-GRUPO VERDE",6
44,"44172",301,218,216,4,2,"RECORTES CERO-GRUPO VERDE",0
31,"31253",129,109,109,0,0,"RECORTES CERO-GRUPO VERDE",0
39,"39095",2266,1760,1726,14,34,"RECORTES CERO-GRUPO VERDE",2
28,"28115",60892,49705,49510,209,195,"RECORTES CERO-GRUPO VERDE",46
20,"20080",7910,5294,5260,49,34,"RECORTES CERO-GRUPO VERDE",13
36,"36010",2847,2102,2076,13,26,"RECORTES CERO-GRUPO VERDE",3
45,"45007",696,534,522,3,12,"RECORTES CERO-GRUPO VERDE",0
28,"28047",40914,30019,29788,169,231,"RECORTES CERO-GRUPO VERDE",63
45,"45008",139,118,118,1,0,"RECORTES CERO-GRUPO VERDE",0
13,"13050",493,378,375,3,3,"RECORTES CERO-GRUPO VERDE",1
26,"26073",97,78,78,0,0,"RECORTES CERO-GRUPO VERDE",0
37,"37069",968,695,689,7,6,"RECORTES CERO-GRUPO VERDE",2
49,"49030",86,69,69,0,0,"RECORTES CERO-GRUPO VERDE",0
16,"16033",1714,1319,1305,6,14,"RECORTES CERO-GRUPO VERDE",3
34,"34180",66,55,55,1,0,"RECORTES CERO-GRUPO VERDE",0
31,"31054",462,255,250,4,5,"RECORTES CERO-GRUPO VERDE",0
30,"30004",1137,870,862,3,8,"RECORTES CERO-GRUPO VERDE",0
48,"48045",5167,3809,3757,28,52,"RECORTES CERO-GRUPO VERDE",4
45,"45109",2883,2271,2214,9,57,"RECORTES CERO-GRUPO VERDE",1
15,"15013",6151,4237,4189,48,48,"RECORTES CERO-GRUPO VERDE",7
31,"31254",1915,1428,1411,3,17,"RECORTES CERO-GRUPO VERDE",8
12,"12013",144,121,119,0,2,"RECORTES CERO-GRUPO VERDE",0
31,"31055",257,175,172,2,3,"RECORTES CERO-GRUPO VERDE",0
28,"28116",704,528,523,2,5,"RECORTES CERO-GRUPO VERDE",0
10,"10168",312,213,208,0,5,"RECORTES CERO-GRUPO VERDE",0
24,"24219",516,387,386,4,1,"RECORTES CERO-GRUPO VERDE",0
47,"47031",189,145,145,1,0,"RECORTES CERO-GRUPO VERDE",0
34,"34042",296,237,234,1,3,"RECORTES CERO-GRUPO VERDE",1
9,"9390",611,484,482,3,2,"RECORTES CERO-GRUPO VERDE",0
12,"12014",184,144,143,2,1,"RECORTES CERO-GRUPO VERDE",0
17,"17036",2717,1730,1716,15,14,"RECORTES CERO-GRUPO VERDE",3
39,"39098",1402,1046,1036,8,10,"RECORTES CERO-GRUPO VERDE",4
43,"43147",524,381,373,4,8,"RECORTES CERO-GRUPO VERDE",0
1,"1016",433,228,226,5,2,"RECORTES CERO-GRUPO VERDE",0
39,"39007",417,278,275,2,3,"RECORTES CERO-GRUPO VERDE",1
8,"8308",131,87,87,1,0,"RECORTES CERO-GRUPO VERDE",0
12,"12114",198,144,144,1,0,"RECORTES CERO-GRUPO VERDE",0
17,"17157",125,95,95,1,0,"RECORTES CERO-GRUPO VERDE",0
37,"37202",978,734,727,10,7,"RECORTES CERO-GRUPO VERDE",1
8,"8064",1847,1245,1230,9,15,"RECORTES CERO-GRUPO VERDE",0
9,"9391",361,264,263,3,1,"RECORTES CERO-GRUPO VERDE",1
46,"46239",442,340,338,3,2,"RECORTES CERO-GRUPO VERDE",0
20,"20902",14156,9664,9613,74,51,"RECORTES CERO-GRUPO VERDE",29
50,"50192",236,180,180,2,0,"RECORTES CERO-GRUPO VERDE",0
25,"25242",720,456,450,2,6,"RECORTES CERO-GRUPO VERDE",0
31,"31257",875,634,625,8,9,"RECORTES CERO-GRUPO VERDE",5
18,"18039",3490,2406,2378,33,28,"RECORTES CERO-GRUPO VERDE",6
50,"50003",128,92,91,1,1,"RECORTES CERO-GRUPO VERDE",1
18,"18177",418,258,256,0,2,"RECORTES CERO-GRUPO VERDE",0
2,"2071",1011,831,825,5,6,"RECORTES CERO-GRUPO VERDE",0
9,"9392",53,40,37,1,3,"RECORTES CERO-GRUPO VERDE",0
5,"5181",43,34,34,1,0,"RECORTES CERO-GRUPO VERDE",2
22,"22156",289,220,220,2,0,"RECORTES CERO-GRUPO VERDE",2
50,"50285",644,436,434,2,2,"RECORTES CERO-GRUPO VERDE",1
43,"43027",161,118,116,15,2,"RECORTES CERO-GRUPO VERDE",1
31,"31258",7879,5707,5666,50,41,"RECORTES CERO-GRUPO VERDE",23
28,"28051",1541,1163,1149,1,14,"RECORTES CERO-GRUPO VERDE",5
45,"45012",661,510,503,6,7,"RECORTES CERO-GRUPO VERDE",0
27,"27005",2595,1846,1816,13,30,"RECORTES CERO-GRUPO VERDE",4
10,"10034",353,260,257,2,3,"RECORTES CERO-GRUPO VERDE",0
8,"8190",256,168,165,2,3,"RECORTES CERO-GRUPO VERDE",0
48,"48049",549,416,416,1,0,"RECORTES CERO-GRUPO VERDE",1
18,"18179",538,376,374,6,2,"RECORTES CERO-GRUPO VERDE",0
37,"37205",231,189,182,0,7,"RECORTES CERO-GRUPO VERDE",1
5,"5037",255,173,172,1,1,"RECORTES CERO-GRUPO VERDE",0
8,"8904",10553,6623,6579,52,44,"RECORTES CERO-GRUPO VERDE",16
16,"16040",80,62,62,0,0,"RECORTES CERO-GRUPO VERDE",0
45,"45013",1758,1352,1329,8,23,"RECORTES CERO-GRUPO VERDE",0
25,"25244",361,223,220,5,3,"RECORTES CERO-GRUPO VERDE",0
46,"46162",1189,938,929,3,9,"RECORTES CERO-GRUPO VERDE",1
17,"17040",537,347,345,3,2,"RECORTES CERO-GRUPO VERDE",1
22,"22158",11995,8197,8126,62,71,"RECORTES CERO-GRUPO VERDE",13
8,"8905",2346,1689,1681,26,8,"RECORTES CERO-GRUPO VERDE",4
34,"34189",56,44,44,1,0,"RECORTES CERO-GRUPO VERDE",0
43,"43152",439,323,320,2,3,"RECORTES CERO-GRUPO VERDE",0
28,"28052",3855,2626,2587,11,39,"RECORTES CERO-GRUPO VERDE",2
45,"45114",588,447,447,0,0,"RECORTES CERO-GRUPO VERDE",0
15,"15018",1142,741,732,18,9,"RECORTES CERO-GRUPO VERDE",3
47,"47115",281,236,233,3,3,"RECORTES CERO-GRUPO VERDE",0
36,"36017",17782,12411,12240,117,171,"RECORTES CERO-GRUPO VERDE",27
37,"37207",287,195,193,1,2,"RECORTES CERO-GRUPO VERDE",0
5,"5039",54,42,41,0,1,"RECORTES CERO-GRUPO VERDE",0
28,"28121",198,160,158,1,2,"RECORTES CERO-GRUPO VERDE",0
41,"41097",3137,2180,2134,18,46,"RECORTES CERO-GRUPO VERDE",2
25,"25247",123,66,66,1,0,"RECORTES CERO-GRUPO VERDE",0
9,"9001",27,22,22,0,0,"RECORTES CERO-GRUPO VERDE",0
31,"31261",231,173,169,3,4,"RECORTES CERO-GRUPO VERDE",0
34,"34190",56,41,40,2,1,"RECORTES CERO-GRUPO VERDE",0
10,"10038",87,68,68,0,0,"RECORTES CERO-GRUPO VERDE",0
41,"41098",5004,3665,3630,26,35,"RECORTES CERO-GRUPO VERDE",6
23,"23015",1374,1029,1019,5,10,"RECORTES CERO-GRUPO VERDE",1
34,"34050",200,153,152,0,1,"RECORTES CERO-GRUPO VERDE",0
37,"37080",225,171,167,0,4,"RECORTES CERO-GRUPO VERDE",0
19,"19097",16,10,10,0,0,"RECORTES CERO-GRUPO VERDE",0
45,"45116",687,509,505,1,4,"RECORTES CERO-GRUPO VERDE",0
34,"34192",90,75,72,0,3,"RECORTES CERO-GRUPO VERDE",0
6,"6057",576,479,471,0,8,"RECORTES CERO-GRUPO VERDE",0
9,"9398",75,56,56,0,0,"RECORTES CERO-GRUPO VERDE",0
22,"22162",130,102,102,0,0,"RECORTES CERO-GRUPO VERDE",0
50,"50007",45,34,34,1,0,"RECORTES CERO-GRUPO VERDE",0
29,"29026",1057,751,748,5,3,"RECORTES CERO-GRUPO VERDE",0
50,"50197",90,67,67,2,0,"RECORTES CERO-GRUPO VERDE",0
8,"8071",240,163,162,5,1,"RECORTES CERO-GRUPO VERDE",0
37,"37337",139,124,124,0,0,"RECORTES CERO-GRUPO VERDE",0
15,"15021",5127,3587,3543,38,44,"RECORTES CERO-GRUPO VERDE",3
49,"49040",114,101,101,0,0,"RECORTES CERO-GRUPO VERDE",0
27,"27012",1355,736,729,5,7,"RECORTES CERO-GRUPO VERDE",2
50,"50008",5097,3457,3417,31,40,"RECORTES CERO-GRUPO VERDE",14
34,"34196",89,68,68,1,0,"RECORTES CERO-GRUPO VERDE",0
15,"15022",5785,3811,3771,33,40,"RECORTES CERO-GRUPO VERDE",8
22,"22163",425,360,355,0,5,"RECORTES CERO-GRUPO VERDE",1
21,"21001",637,462,455,6,7,"RECORTES CERO-GRUPO VERDE",0
37,"37338",79,65,64,0,1,"RECORTES CERO-GRUPO VERDE",0
18,"18046",1832,1160,1140,6,20,"RECORTES CERO-GRUPO VERDE",0
37,"37212",104,78,74,0,4,"RECORTES CERO-GRUPO VERDE",0
9,"9130",74,51,50,1,1,"RECORTES CERO-GRUPO VERDE",0
22,"22042",117,95,92,0,3,"RECORTES CERO-GRUPO VERDE",0
41,"41012",3290,2071,2030,20,41,"RECORTES CERO-GRUPO VERDE",4
49,"49041",432,326,322,5,4,"RECORTES CERO-GRUPO VERDE",0
28,"28055",916,693,687,5,6,"RECORTES CERO-GRUPO VERDE",0
34,"34201",193,158,155,1,3,"RECORTES CERO-GRUPO VERDE",0
33,"33021",4573,3024,2971,22,53,"RECORTES CERO-GRUPO VERDE",7
2,"2079",2875,2209,2181,12,28,"RECORTES CERO-GRUPO VERDE",2
28,"28124",74,54,54,1,0,"RECORTES CERO-GRUPO VERDE",0
25,"25121",644,415,410,8,5,"RECORTES CERO-GRUPO VERDE",0
46,"46010",935,729,723,4,6,"RECORTES CERO-GRUPO VERDE",3
12,"12024",143,125,124,0,1,"RECORTES CERO-GRUPO VERDE",0
17,"17046",717,459,458,4,1,"RECORTES CERO-GRUPO VERDE",2
6,"6061",1084,853,837,4,16,"RECORTES CERO-GRUPO VERDE",0
30,"30013",7396,5147,5102,32,45,"RECORTES CERO-GRUPO VERDE",2
2,"2080",528,406,400,2,6,"RECORTES CERO-GRUPO VERDE",0
5,"5045",91,66,66,0,0,"RECORTES CERO-GRUPO VERDE",0
28,"28057",1458,1097,1088,3,9,"RECORTES CERO-GRUPO VERDE",2
19,"19327",418,350,348,1,2,"RECORTES CERO-GRUPO VERDE",0
24,"24125",462,290,286,4,4,"RECORTES CERO-GRUPO VERDE",0
17,"17047",4798,2773,2757,28,16,"RECORTES CERO-GRUPO VERDE",3
40,"40005",30,23,23,0,0,"RECORTES CERO-GRUPO VERDE",0
31,"31165",2780,1995,1960,30,35,"RECORTES CERO-GRUPO VERDE",5
22,"22208",188,150,145,0,5,"RECORTES CERO-GRUPO VERDE",0
12,"12059",231,189,188,2,1,"RECORTES CERO-GRUPO VERDE",0
12,"12123",48,40,40,3,0,"RECORTES CERO-GRUPO VERDE",0
10,"10182",136,95,95,0,0,"RECORTES CERO-GRUPO VERDE",0
15,"15025",1061,629,622,6,7,"RECORTES CERO-GRUPO VERDE",0
8,"8075",3883,2479,2467,14,12,"RECORTES CERO-GRUPO VERDE",2
30,"30014",1567,1174,1160,8,14,"RECORTES CERO-GRUPO VERDE",0
23,"23020",1590,1370,1349,9,21,"RECORTES CERO-GRUPO VERDE",1
44,"44184",45,34,34,0,0,"RECORTES CERO-GRUPO VERDE",0
31,"31166",258,181,181,1,0,"RECORTES CERO-GRUPO VERDE",0
18,"18188",1653,1183,1175,5,8,"RECORTES CERO-GRUPO VERDE",2
50,"50011",122,95,94,1,1,"RECORTES CERO-GRUPO VERDE",0
15,"15027",1536,1182,1155,6,27,"RECORTES CERO-GRUPO VERDE",3
23,"23021",524,431,429,0,2,"RECORTES CERO-GRUPO VERDE",0
2,"2082",101,80,80,1,0,"RECORTES CERO-GRUPO VERDE",1
47,"47203",62,53,53,1,0,"RECORTES CERO-GRUPO VERDE",0
6,"6064",841,666,656,2,10,"RECORTES CERO-GRUPO VERDE",0
28,"28058",139342,100637,99753,634,884,"RECORTES CERO-GRUPO VERDE",350
5,"5048",118,104,104,0,0,"RECORTES CERO-GRUPO VERDE",0
37,"37343",60,47,47,0,0,"RECORTES CERO-GRUPO VERDE",0
37,"37217",58,45,44,0,1,"RECORTES CERO-GRUPO VERDE",0
8,"8201",442,278,278,4,0,"RECORTES CERO-GRUPO VERDE",1
2,"2083",219,191,191,0,0,"RECORTES CERO-GRUPO VERDE",0
5,"5049",401,272,266,1,6,"RECORTES CERO-GRUPO VERDE",0
15,"15028",1409,1038,1024,6,14,"RECORTES CERO-GRUPO VERDE",2
48,"48058",968,647,646,2,1,"RECORTES CERO-GRUPO VERDE",1
25,"25255",417,298,296,2,2,"RECORTES CERO-GRUPO VERDE",0
1,"1031",1169,882,863,6,19,"RECORTES CERO-GRUPO VERDE",0
17,"17050",652,453,453,3,0,"RECORTES CERO-GRUPO VERDE",0
29,"29032",6657,5031,4977,33,54,"RECORTES CERO-GRUPO VERDE",5
49,"49168",93,74,74,0,0,"RECORTES CERO-GRUPO VERDE",0
47,"47041",150,112,110,2,2,"RECORTES CERO-GRUPO VERDE",0
31,"31068",2885,2060,2027,20,33,"RECORTES CERO-GRUPO VERDE",6
45,"45123",3081,2144,2131,11,13,"RECORTES CERO-GRUPO VERDE",7
40,"40009",49,43,43,0,0,"RECORTES CERO-GRUPO VERDE",0
18,"18054",849,606,605,7,1,"RECORTES CERO-GRUPO VERDE",1
21,"21009",857,532,523,4,9,"RECORTES CERO-GRUPO VERDE",2
5,"5052",95,77,76,0,1,"RECORTES CERO-GRUPO VERDE",0
15,"15029",5688,3590,3544,32,46,"RECORTES CERO-GRUPO VERDE",8
37,"37219",173,109,108,0,1,"RECORTES CERO-GRUPO VERDE",0
6,"6068",446,347,345,5,2,"RECORTES CERO-GRUPO VERDE",0
30,"30017",11605,8541,8451,46,90,"RECORTES CERO-GRUPO VERDE",5
9,"9410",3040,2117,2095,16,22,"RECORTES CERO-GRUPO VERDE",3
31,"31904",1563,1029,1022,23,7,"RECORTES CERO-GRUPO VERDE",0
49,"49048",124,97,95,0,2,"RECORTES CERO-GRUPO VERDE",0
43,"43164",301,205,204,2,1,"RECORTES CERO-GRUPO VERDE",0
41,"41018",9480,6523,6455,53,68,"RECORTES CERO-GRUPO VERDE",7
49,"49170",102,72,71,0,1,"RECORTES CERO-GRUPO VERDE",0
17,"17171",165,117,116,2,1,"RECORTES CERO-GRUPO VERDE",0
23,"23026",3586,2620,2585,16,35,"RECORTES CERO-GRUPO VERDE",1
34,"34210",103,90,90,0,0,"RECORTES CERO-GRUPO VERDE",0
50,"50109",103,78,78,3,0,"RECORTES CERO-GRUPO VERDE",0
19,"19333",115,82,82,0,0,"RECORTES CERO-GRUPO VERDE",0
40,"40012",269,192,191,2,1,"RECORTES CERO-GRUPO VERDE",0
25,"25903",236,161,161,3,0,"RECORTES CERO-GRUPO VERDE",0
30,"30018",7978,5866,5811,30,55,"RECORTES CERO-GRUPO VERDE",11
24,"24132",615,379,375,1,4,"RECORTES CERO-GRUPO VERDE",0
16,"16056",457,306,305,3,1,"RECORTES CERO-GRUPO VERDE",0
26,"26092",107,92,90,0,2,"RECORTES CERO-GRUPO VERDE",0
22,"22173",232,152,152,3,0,"RECORTES CERO-GRUPO VERDE",0
39,"39021",487,381,376,2,5,"RECORTES CERO-GRUPO VERDE",0
9,"9411",151,102,101,0,1,"RECORTES CERO-GRUPO VERDE",0
18,"18902",816,632,620,4,12,"RECORTES CERO-GRUPO VERDE",1
30,"30019",25857,17544,17374,125,170,"RECORTES CERO-GRUPO VERDE",22
49,"49052",187,133,132,1,1,"RECORTES CERO-GRUPO VERDE",0
7,"7038",2010,1424,1412,18,12,"RECORTES CERO-GRUPO VERDE",1
5,"5055",568,456,451,4,5,"RECORTES CERO-GRUPO VERDE",1
16,"16202",769,564,558,0,6,"RECORTES CERO-GRUPO VERDE",1
31,"31171",680,495,486,8,9,"RECORTES CERO-GRUPO VERDE",1
6,"6071",245,206,200,0,6,"RECORTES CERO-GRUPO VERDE",0
40,"40141",842,593,584,10,9,"RECORTES CERO-GRUPO VERDE",0
21,"21013",10591,6580,6452,55,128,"RECORTES CERO-GRUPO VERDE",15
31,"31907",10745,8067,8009,116,58,"RECORTES CERO-GRUPO VERDE",38
42,"42006",163,109,107,2,2,"RECORTES CERO-GRUPO VERDE",1
18,"18903",889,669,661,5,8,"RECORTES CERO-GRUPO VERDE",0
5,"5057",2465,1969,1953,15,16,"RECORTES CERO-GRUPO VERDE",1
42,"42007",113,86,86,5,0,"RECORTES CERO-GRUPO VERDE",0
6,"6072",2307,1696,1681,12,15,"RECORTES CERO-GRUPO VERDE",2
47,"47208",58,38,36,1,2,"RECORTES CERO-GRUPO VERDE",1
37,"37098",333,247,247,1,0,"RECORTES CERO-GRUPO VERDE",0
28,"28063",258,194,193,1,1,"RECORTES CERO-GRUPO VERDE",0
47,"47044",331,293,290,2,3,"RECORTES CERO-GRUPO VERDE",0
5,"5058",78,49,48,0,1,"RECORTES CERO-GRUPO VERDE",0
47,"47127",137,98,97,0,1,"RECORTES CERO-GRUPO VERDE",0
17,"17175",578,321,312,5,9,"RECORTES CERO-GRUPO VERDE",1
50,"50113",618,489,484,2,5,"RECORTES CERO-GRUPO VERDE",0
9,"9019",150,92,90,0,2,"RECORTES CERO-GRUPO VERDE",0
22,"22086",215,161,159,1,2,"RECORTES CERO-GRUPO VERDE",2
17,"17057",968,641,636,11,5,"RECORTES CERO-GRUPO VERDE",4
46,"46018",608,515,511,0,4,"RECORTES CERO-GRUPO VERDE",0
9,"9415",268,175,175,2,0,"RECORTES CERO-GRUPO VERDE",0
47,"47209",41,34,34,0,0,"RECORTES CERO-GRUPO VERDE",0
10,"10194",542,415,407,2,8,"RECORTES CERO-GRUPO VERDE",1
45,"45028",3649,2701,2673,12,28,"RECORTES CERO-GRUPO VERDE",3
17,"17176",124,92,92,1,0,"RECORTES CERO-GRUPO VERDE",0
15,"15035",11427,7779,7657,144,122,"RECORTES CERO-GRUPO VERDE",17
4,"4049",5313,3620,3579,18,41,"RECORTES CERO-GRUPO VERDE",1
22,"22220",166,126,125,2,1,"RECORTES CERO-GRUPO VERDE",0
5,"5206",30,22,20,1,2,"RECORTES CERO-GRUPO VERDE",0
25,"25133",706,432,427,8,5,"RECORTES CERO-GRUPO VERDE",0
7,"7042",10666,6680,6613,64,67,"RECORTES CERO-GRUPO VERDE",24
42,"42009",78,63,63,0,0,"RECORTES CERO-GRUPO VERDE",0
20,"20002",346,203,203,4,0,"RECORTES CERO-GRUPO VERDE",0
25,"25908",226,144,143,3,1,"RECORTES CERO-GRUPO VERDE",0
17,"17060",424,268,266,5,2,"RECORTES CERO-GRUPO VERDE",0
15,"15036",57885,39471,39096,417,375,"RECORTES CERO-GRUPO VERDE",98
12,"12036",581,426,421,10,5,"RECORTES CERO-GRUPO VERDE",0
30,"30023",3780,2874,2850,12,24,"RECORTES CERO-GRUPO VERDE",8
4,"4050",800,558,553,3,5,"RECORTES CERO-GRUPO VERDE",1
3,"3005",7769,5917,5866,19,51,"RECORTES CERO-GRUPO VERDE",15
50,"50115",3235,2128,2109,14,19,"RECORTES CERO-GRUPO VERDE",1
45,"45030",478,368,360,2,8,"RECORTES CERO-GRUPO VERDE",0
25,"25047",1014,675,674,8,1,"RECORTES CERO-GRUPO VERDE",0
13,"13032",1137,841,835,2,6,"RECORTES CERO-GRUPO VERDE",2
33,"33063",415,320,318,3,2,"RECORTES CERO-GRUPO VERDE",0
27,"27033",623,415,409,8,6,"RECORTES CERO-GRUPO VERDE",0
10,"10197",123,90,89,0,1,"RECORTES CERO-GRUPO VERDE",0
4,"4051",436,360,356,1,4,"RECORTES CERO-GRUPO VERDE",0
39,"39026",1750,1236,1224,11,12,"RECORTES CERO-GRUPO VERDE",1
28,"28066",7182,5422,5371,17,51,"RECORTES CERO-GRUPO VERDE",7
25,"25910",100,63,61,2,2,"RECORTES CERO-GRUPO VERDE",0
32,"32005",861,662,650,7,12,"RECORTES CERO-GRUPO VERDE",1
43,"43173",100,53,51,0,2,"RECORTES CERO-GRUPO VERDE",0
34,"34220",147,126,125,3,1,"RECORTES CERO-GRUPO VERDE",0
5,"5114",1345,1067,1044,3,23,"RECORTES CERO-GRUPO VERDE",1
24,"24172",418,255,250,2,5,"RECORTES CERO-GRUPO VERDE",1
40,"40148",238,188,187,2,1,"RECORTES CERO-GRUPO VERDE",0
37,"37231",250,196,193,4,3,"RECORTES CERO-GRUPO VERDE",0
24,"24141",95,85,84,0,1,"RECORTES CERO-GRUPO VERDE",0
6,"6079",652,449,442,4,7,"RECORTES CERO-GRUPO VERDE",0
43,"43174",138,102,100,1,2,"RECORTES CERO-GRUPO VERDE",0
9,"9023",1102,818,811,11,7,"RECORTES CERO-GRUPO VERDE",3
15,"15039",1263,889,875,7,14,"RECORTES CERO-GRUPO VERDE",5
50,"50022",530,397,390,7,7,"RECORTES CERO-GRUPO VERDE",0
12,"12038",167,120,118,2,2,"RECORTES CERO-GRUPO VERDE",1
19,"19229",66,56,56,0,0,"RECORTES CERO-GRUPO VERDE",0
25,"25911",451,273,271,7,2,"RECORTES CERO-GRUPO VERDE",0
24,"24142",25119,17336,17141,154,195,"RECORTES CERO-GRUPO VERDE",41
10,"10200",392,306,302,1,4,"RECORTES CERO-GRUPO VERDE",0
25,"25011",5243,2796,2767,23,29,"RECORTES CERO-GRUPO VERDE",14
45,"45032",436,283,275,1,8,"RECORTES CERO-GRUPO VERDE",1
46,"46100",286,232,230,1,2,"RECORTES CERO-GRUPO VERDE",0
25,"25912",857,547,539,1,8,"RECORTES CERO-GRUPO VERDE",5
47,"47049",101,68,68,0,0,"RECORTES CERO-GRUPO VERDE",1
43,"43175",554,363,360,5,3,"RECORTES CERO-GRUPO VERDE",2
18,"18068",1569,1189,1166,6,23,"RECORTES CERO-GRUPO VERDE",1
17,"17064",322,214,211,4,3,"RECORTES CERO-GRUPO VERDE",0
24,"24143",510,358,349,0,9,"RECORTES CERO-GRUPO VERDE",0
33,"33035",11284,7681,7618,70,63,"RECORTES CERO-GRUPO VERDE",8
20,"20006",259,143,143,3,0,"RECORTES CERO-GRUPO VERDE",0
43,"43054",2812,1755,1739,16,16,"RECORTES CERO-GRUPO VERDE",3
25,"25913",86,67,67,3,0,"RECORTES CERO-GRUPO VERDE",0
50,"50118",2165,1552,1540,10,12,"RECORTES CERO-GRUPO VERDE",5
46,"46101",860,716,705,3,11,"RECORTES CERO-GRUPO VERDE",2
42,"42148",10,10,10,1,0,"RECORTES CERO-GRUPO VERDE",0
21,"21023",2124,1298,1264,7,34,"RECORTES CERO-GRUPO VERDE",3
18,"18069",502,362,357,0,5,"RECORTES CERO-GRUPO VERDE",1
23,"23039",2204,1596,1558,11,38,"RECORTES CERO-GRUPO VERDE",2
25,"25013",2146,1240,1226,16,14,"RECORTES CERO-GRUPO VERDE",3
10,"10065",206,156,155,1,1,"RECORTES CERO-GRUPO VERDE",0
40,"40024",856,651,639,6,12,"RECORTES CERO-GRUPO VERDE",3
49,"49183",100,77,77,2,0,"RECORTES CERO-GRUPO VERDE",0
26,"26001",195,161,157,2,4,"RECORTES CERO-GRUPO VERDE",0
29,"29045",1684,1178,1168,8,10,"RECORTES CERO-GRUPO VERDE",5
12,"12041",100,81,81,0,0,"RECORTES CERO-GRUPO VERDE",0
26,"26034",654,497,489,1,8,"RECORTES CERO-GRUPO VERDE",0
7,"7049",1480,1003,993,14,10,"RECORTES CERO-GRUPO VERDE",5
31,"31181",145,112,112,0,0,"RECORTES CERO-GRUPO VERDE",0
30,"30028",6649,4797,4726,21,71,"RECORTES CERO-GRUPO VERDE",4
42,"42055",164,121,121,0,0,"RECORTES CERO-GRUPO VERDE",1
26,"26104",13,10,10,0,0,"RECORTES CERO-GRUPO VERDE",0
5,"5216",220,171,168,0,3,"RECORTES CERO-GRUPO VERDE",0
24,"24145",654,463,461,2,2,"RECORTES CERO-GRUPO VERDE",0
9,"9423",27,24,24,0,0,"RECORTES CERO-GRUPO VERDE",0
27,"27043",1295,805,793,9,12,"RECORTES CERO-GRUPO VERDE",0
12,"12042",607,520,513,13,7,"RECORTES CERO-GRUPO VERDE",0
9,"9027",46,42,41,0,1,"RECORTES CERO-GRUPO VERDE",2
40,"40026",119,109,109,0,0,"RECORTES CERO-GRUPO VERDE",0
50,"50026",439,335,325,10,10,"RECORTES CERO-GRUPO VERDE",0
15,"15044",1286,937,927,8,10,"RECORTES CERO-GRUPO VERDE",5
28,"28071",60,55,53,1,2,"RECORTES CERO-GRUPO VERDE",0
18,"18914",1649,1238,1213,3,25,"RECORTES CERO-GRUPO VERDE",0
17,"17068",245,158,156,1,2,"RECORTES CERO-GRUPO VERDE",1
20,"20010",1499,992,986,9,6,"RECORTES CERO-GRUPO VERDE",0
50,"50216",235,186,184,5,2,"RECORTES CERO-GRUPO VERDE",0
22,"22188",82,60,59,6,1,"RECORTES CERO-GRUPO VERDE",0
43,"43902",2743,1551,1531,23,20,"RECORTES CERO-GRUPO VERDE",2
28,"28072",5709,4356,4324,22,32,"RECORTES CERO-GRUPO VERDE",2
15,"15045",3770,2184,2157,14,27,"RECORTES CERO-GRUPO VERDE",4
5,"5074",686,564,558,5,6,"RECORTES CERO-GRUPO VERDE",1
50,"50027",225,178,177,2,1,"RECORTES CERO-GRUPO VERDE",0
3,"3104",27103,19953,19787,131,166,"RECORTES CERO-GRUPO VERDE",36
12,"12043",570,449,442,2,7,"RECORTES CERO-GRUPO VERDE",1
46,"46182",1266,929,922,6,7,"RECORTES CERO-GRUPO VERDE",5
32,"32014",1142,848,834,6,14,"RECORTES CERO-GRUPO VERDE",0
49,"49067",367,250,249,0,1,"RECORTES CERO-GRUPO VERDE",0
43,"43903",2392,1324,1313,10,11,"RECORTES CERO-GRUPO VERDE",1
22,"22190",119,86,85,0,1,"RECORTES CERO-GRUPO VERDE",1
49,"49187",1236,896,888,4,8,"RECORTES CERO-GRUPO VERDE",1
45,"45138",1091,877,871,4,6,"RECORTES CERO-GRUPO VERDE",0
18,"18076",804,551,549,1,2,"RECORTES CERO-GRUPO VERDE",0
14,"14026",2067,1424,1405,4,19,"RECORTES CERO-GRUPO VERDE",0
45,"45038",3356,2376,2350,15,26,"RECORTES CERO-GRUPO VERDE",3
48,"48073",6910,4306,4271,31,35,"RECORTES CERO-GRUPO VERDE",1
21,"21028",375,277,271,2,6,"RECORTES CERO-GRUPO VERDE",0
50,"50217",446,342,342,1,0,"RECORTES CERO-GRUPO VERDE",0
40,"40157",47,44,44,0,0,"RECORTES CERO-GRUPO VERDE",0
15,"15047",2429,1576,1549,19,27,"RECORTES CERO-GRUPO VERDE",2
25,"25146",227,140,140,3,0,"RECORTES CERO-GRUPO VERDE",0
49,"49068",462,310,304,4,6,"RECORTES CERO-GRUPO VERDE",0
29,"29050",421,306,302,3,4,"RECORTES CERO-GRUPO VERDE",0
37,"37241",168,131,131,1,0,"RECORTES CERO-GRUPO VERDE",0
28,"28074",138947,103687,102762,620,925,"RECORTES CERO-GRUPO VERDE",308
25,"25020",289,206,205,3,1,"RECORTES CERO-GRUPO VERDE",0
8,"8099",749,487,485,2,2,"RECORTES CERO-GRUPO VERDE",0
17,"17071",1134,778,774,10,4,"RECORTES CERO-GRUPO VERDE",0
19,"19002",69,58,57,0,1,"RECORTES CERO-GRUPO VERDE",0
22,"22193",276,225,224,2,1,"RECORTES CERO-GRUPO VERDE",0
31,"31086",13188,9713,9642,111,71,"RECORTES CERO-GRUPO VERDE",44
9,"9033",90,74,74,1,0,"RECORTES CERO-GRUPO VERDE",0
9,"9295",61,44,44,0,0,"RECORTES CERO-GRUPO VERDE",0
16,"16231",46,37,37,0,0,"RECORTES CERO-GRUPO VERDE",0
19,"19124",386,260,257,0,3,"RECORTES CERO-GRUPO VERDE",2
19,"19003",42,35,34,1,1,"RECORTES CERO-GRUPO VERDE",0
3,"3015",12566,9257,9177,39,80,"RECORTES CERO-GRUPO VERDE",10
37,"37242",91,74,73,0,1,"RECORTES CERO-GRUPO VERDE",0
23,"23046",2391,1916,1895,6,21,"RECORTES CERO-GRUPO VERDE",1
17,"17074",510,337,335,2,2,"RECORTES CERO-GRUPO VERDE",0
41,"41091",541987,385251,382091,3298,3160,"RECORTES CERO-GRUPO VERDE",772
22,"22195",235,182,181,3,1,"RECORTES CERO-GRUPO VERDE",0
12,"12048",251,185,182,0,3,"RECORTES CERO-GRUPO VERDE",0
50,"50902",87,79,79,2,0,"RECORTES CERO-GRUPO VERDE",0
48,"48076",308,218,217,2,1,"RECORTES CERO-GRUPO VERDE",0
37,"37368",17,17,17,0,0,"RECORTES CERO-GRUPO VERDE",0
17,"17192",144,96,93,1,3,"RECORTES CERO-GRUPO VERDE",0
30,"30034",1129,858,844,7,14,"RECORTES CERO-GRUPO VERDE",0
8,"8225",92,66,66,4,0,"RECORTES CERO-GRUPO VERDE",0
17,"17075",330,205,205,1,0,"RECORTES CERO-GRUPO VERDE",0
40,"40033",58,51,51,0,0,"RECORTES CERO-GRUPO VERDE",0
28,"28146",1787,1205,1194,0,11,"RECORTES CERO-GRUPO VERDE",0
43,"43063",557,355,349,9,6,"RECORTES CERO-GRUPO VERDE",0
9,"9431",118,98,98,0,0,"RECORTES CERO-GRUPO VERDE",0
7,"7058",2791,2060,2034,13,26,"RECORTES CERO-GRUPO VERDE",8
24,"24152",464,295,291,1,4,"RECORTES CERO-GRUPO VERDE",0
44,"44001",68,53,52,1,1,"RECORTES CERO-GRUPO VERDE",0
31,"31188",235,161,161,2,0,"RECORTES CERO-GRUPO VERDE",0
26,"26042",834,635,625,5,10,"RECORTES CERO-GRUPO VERDE",2
50,"50126",2371,1573,1559,19,14,"RECORTES CERO-GRUPO VERDE",1
9,"9036",37,31,30,1,1,"RECORTES CERO-GRUPO VERDE",0
10,"10214",214,181,177,2,4,"RECORTES CERO-GRUPO VERDE",0
20,"20016",1520,826,821,2,5,"RECORTES CERO-GRUPO VERDE",0
12,"12049",441,322,312,1,10,"RECORTES CERO-GRUPO VERDE",0
19,"19006",769,547,540,2,7,"RECORTES CERO-GRUPO VERDE",0
31,"31089",242,172,170,1,2,"RECORTES CERO-GRUPO VERDE",1
24,"24153",232,179,177,2,2,"RECORTES CERO-GRUPO VERDE",0
32,"32022",1337,892,881,6,11,"RECORTES CERO-GRUPO VERDE",0
30,"30036",14698,9859,9734,41,125,"RECORTES CERO-GRUPO VERDE",17
50,"50032",261,189,189,5,0,"RECORTES CERO-GRUPO VERDE",0
10,"10078",406,321,314,6,7,"RECORTES CERO-GRUPO VERDE",0
48,"48078",38617,26366,26212,158,154,"RECORTES CERO-GRUPO VERDE",39
46,"46056",182,167,166,1,1,"RECORTES CERO-GRUPO VERDE",0
7,"7060",2568,1677,1653,16,24,"RECORTES CERO-GRUPO VERDE",5
9,"9432",182,145,138,0,7,"RECORTES CERO-GRUPO VERDE",0
26,"26010",93,80,80,2,0,"RECORTES CERO-GRUPO VERDE",0
37,"37247",196,163,162,3,1,"RECORTES CERO-GRUPO VERDE",0
8,"8105",9630,6394,6339,49,55,"RECORTES CERO-GRUPO VERDE",21
9,"9433",60,48,45,1,3,"RECORTES CERO-GRUPO VERDE",0
31,"31090",144,77,77,1,0,"RECORTES CERO-GRUPO VERDE",1
16,"16239",135,110,105,0,5,"RECORTES CERO-GRUPO VERDE",0
24,"24154",1005,673,666,4,7,"RECORTES CERO-GRUPO VERDE",0
36,"36051",14267,9638,9493,71,145,"RECORTES CERO-GRUPO VERDE",21
5,"5084",74,53,53,0,0,"RECORTES CERO-GRUPO VERDE",0
34,"34237",592,462,452,6,10,"RECORTES CERO-GRUPO VERDE",0
40,"40164",177,139,138,0,1,"RECORTES CERO-GRUPO VERDE",0
5,"5230",66,63,62,1,1,"RECORTES CERO-GRUPO VERDE",0
7,"7062",7513,4273,4219,52,54,"RECORTES CERO-GRUPO VERDE",10
20,"20018",11064,6719,6690,41,29,"RECORTES CERO-GRUPO VERDE",6
32,"32025",1079,791,777,1,14,"RECORTES CERO-GRUPO VERDE",1
37,"37248",152,126,125,1,1,"RECORTES CERO-GRUPO VERDE",0
34,"34091",123,94,93,3,1,"RECORTES CERO-GRUPO VERDE",0
40,"40037",41,29,29,0,0,"RECORTES CERO-GRUPO VERDE",0
34,"34238",330,268,266,3,2,"RECORTES CERO-GRUPO VERDE",0
26,"26114",79,66,65,1,1,"RECORTES CERO-GRUPO VERDE",0
47,"47142",141,99,97,0,2,"RECORTES CERO-GRUPO VERDE",0
40,"40039",210,156,153,3,3,"RECORTES CERO-GRUPO VERDE",1
5,"5231",165,133,133,2,0,"RECORTES CERO-GRUPO VERDE",0
5,"5086",80,67,67,2,0,"RECORTES CERO-GRUPO VERDE",0
29,"29056",1098,757,750,5,7,"RECORTES CERO-GRUPO VERDE",2
46,"46110",21228,15563,15443,86,120,"RECORTES CERO-GRUPO VERDE",49
19,"19009",259,200,195,6,5,"RECORTES CERO-GRUPO VERDE",0
24,"24055",708,516,512,0,4,"RECORTES CERO-GRUPO VERDE",3
34,"34240",89,64,64,0,0,"RECORTES CERO-GRUPO VERDE",0
50,"50035",72,54,53,1,1,"RECORTES CERO-GRUPO VERDE",0
40,"40040",2607,1843,1828,19,15,"RECORTES CERO-GRUPO VERDE",2
15,"15056",5722,3869,3818,46,51,"RECORTES CERO-GRUPO VERDE",4
9,"9172",129,103,101,1,2,"RECORTES CERO-GRUPO VERDE",0
21,"21038",1095,705,693,4,12,"RECORTES CERO-GRUPO VERDE",0
48,"48081",1868,1361,1350,4,11,"RECORTES CERO-GRUPO VERDE",2
43,"43070",238,192,191,1,1,"RECORTES CERO-GRUPO VERDE",1
46,"46111",10930,7931,7828,44,103,"RECORTES CERO-GRUPO VERDE",15
17,"17081",246,163,162,2,1,"RECORTES CERO-GRUPO VERDE",0
9,"9307",109,81,80,0,1,"RECORTES CERO-GRUPO VERDE",0
27,"27062",605,447,444,1,3,"RECORTES CERO-GRUPO VERDE",0
50,"50227",109,79,79,0,0,"RECORTES CERO-GRUPO VERDE",0
19,"19134",24,15,15,0,0,"RECORTES CERO-GRUPO VERDE",0
36,"36054",10993,7476,7363,67,113,"RECORTES CERO-GRUPO VERDE",11
8,"8109",216,162,161,0,1,"RECORTES CERO-GRUPO VERDE",0
39,"39042",5915,4530,4474,21,56,"RECORTES CERO-GRUPO VERDE",2
48,"48082",37605,25134,24938,176,196,"RECORTES CERO-GRUPO VERDE",38
44,"44007",173,122,121,4,1,"RECORTES CERO-GRUPO VERDE",0
47,"47225",80,63,63,0,0,"RECORTES CERO-GRUPO VERDE",0
8,"8110",13315,8457,8368,73,89,"RECORTES CERO-GRUPO VERDE",29
41,"41043",639,436,427,5,9,"RECORTES CERO-GRUPO VERDE",1
13,"13009",1439,1115,1098,9,17,"RECORTES CERO-GRUPO VERDE",2
22,"22075",125,83,83,1,0,"RECORTES CERO-GRUPO VERDE",0
17,"17083",2940,1895,1876,16,19,"RECORTES CERO-GRUPO VERDE",4
4,"4068",187,154,152,0,2,"RECORTES CERO-GRUPO VERDE",0
9,"9174",794,559,552,4,7,"RECORTES CERO-GRUPO VERDE",0
27,"27064",1581,1097,1068,12,29,"RECORTES CERO-GRUPO VERDE",1
44,"44215",159,109,109,2,0,"RECORTES CERO-GRUPO VERDE",0
19,"19247",139,102,100,1,2,"RECORTES CERO-GRUPO VERDE",0
49,"49084",287,229,228,4,1,"RECORTES CERO-GRUPO VERDE",0
9,"9045",268,181,181,4,0,"RECORTES CERO-GRUPO VERDE",0
44,"44008",1613,1163,1153,6,10,"RECORTES CERO-GRUPO VERDE",1
23,"23056",3088,2243,2203,15,40,"RECORTES CERO-GRUPO VERDE",0
9,"9440",91,78,78,2,0,"RECORTES CERO-GRUPO VERDE",0
27,"27065",12444,8261,8056,112,205,"RECORTES CERO-GRUPO VERDE",25
26,"26016",28,25,24,1,1,"RECORTES CERO-GRUPO VERDE",0
26,"26120",1454,1139,1126,7,13,"RECORTES CERO-GRUPO VERDE",0
39,"39044",3849,2765,2732,21,33,"RECORTES CERO-GRUPO VERDE",3
3,"3024",3901,3067,3024,11,43,"RECORTES CERO-GRUPO VERDE",1
20,"20023",441,252,251,1,1,"RECORTES CERO-GRUPO VERDE",1
30,"30042",1922,1504,1491,7,13,"RECORTES CERO-GRUPO VERDE",3
24,"24058",208,155,154,3,1,"RECORTES CERO-GRUPO VERDE",0
19,"19248",78,63,63,0,0,"RECORTES CERO-GRUPO VERDE",1
37,"37255",49,34,34,1,0,"RECORTES CERO-GRUPO VERDE",0
43,"43074",1754,1170,1157,9,13,"RECORTES CERO-GRUPO VERDE",1
48,"48085",10338,7190,7153,39,37,"RECORTES CERO-GRUPO VERDE",18
46,"46114",569,461,458,1,3,"RECORTES CERO-GRUPO VERDE",0
17,"17202",3791,2280,2263,18,17,"RECORTES CERO-GRUPO VERDE",2
42,"42168",107,80,80,0,0,"RECORTES CERO-GRUPO VERDE",1
34,"34099",60,48,48,0,0,"RECORTES CERO-GRUPO VERDE",0
41,"41046",3023,2213,2183,5,30,"RECORTES CERO-GRUPO VERDE",1
47,"47147",116,92,92,0,0,"RECORTES CERO-GRUPO VERDE",0
22,"22078",438,319,316,3,3,"RECORTES CERO-GRUPO VERDE",2
10,"10089",1359,882,868,3,14,"RECORTES CERO-GRUPO VERDE",2
50,"50136",575,414,410,2,4,"RECORTES CERO-GRUPO VERDE",0
19,"19139",29,19,18,0,1,"RECORTES CERO-GRUPO VERDE",0
25,"25035",398,249,247,2,2,"RECORTES CERO-GRUPO VERDE",0
5,"5239",214,164,162,3,2,"RECORTES CERO-GRUPO VERDE",0
6,"6107",1581,999,995,8,4,"RECORTES CERO-GRUPO VERDE",1
26,"26051",239,193,191,1,2,"RECORTES CERO-GRUPO VERDE",2
46,"46115",378,286,282,1,4,"RECORTES CERO-GRUPO VERDE",0
43,"43076",439,300,299,0,1,"RECORTES CERO-GRUPO VERDE",1
20,"20025",1143,765,760,8,5,"RECORTES CERO-GRUPO VERDE",0
1,"1902",734,514,502,4,12,"RECORTES CERO-GRUPO VERDE",0
17,"17009",4015,2584,2567,14,17,"RECORTES CERO-GRUPO VERDE",5
19,"19058",6793,5258,5218,19,40,"RECORTES CERO-GRUPO VERDE",7
28,"28155",506,416,411,0,5,"RECORTES CERO-GRUPO VERDE",0
13,"13016",664,517,509,4,8,"RECORTES CERO-GRUPO VERDE",0
37,"37382",173,137,137,0,0,"RECORTES CERO-GRUPO VERDE",0
12,"12093",178,137,136,2,1,"RECORTES CERO-GRUPO VERDE",2
40,"40176",395,306,305,2,1,"RECORTES CERO-GRUPO VERDE",0
9,"9444",72,58,58,3,0,"RECORTES CERO-GRUPO VERDE",0
17,"17087",225,152,149,2,3,"RECORTES CERO-GRUPO VERDE",0
8,"8116",578,387,383,2,4,"RECORTES CERO-GRUPO VERDE",1
20,"20026",197,145,133,0,12,"RECORTES CERO-GRUPO VERDE",0
16,"16098",561,456,454,3,2,"RECORTES CERO-GRUPO VERDE",1
37,"37258",172,116,115,3,1,"RECORTES CERO-GRUPO VERDE",0
15,"15064",2194,1592,1556,21,36,"RECORTES CERO-GRUPO VERDE",0
26,"26020",476,349,339,3,10,"RECORTES CERO-GRUPO VERDE",2
37,"37259",44,28,28,0,0,"RECORTES CERO-GRUPO VERDE",0
21,"21047",1917,1111,1065,15,46,"RECORTES CERO-GRUPO VERDE",0
22,"22209",155,120,120,3,0,"RECORTES CERO-GRUPO VERDE",2
19,"19019",20,18,17,0,1,"RECORTES CERO-GRUPO VERDE",0
3,"3027",157,138,135,0,3,"RECORTES CERO-GRUPO VERDE",0
10,"10001",282,225,223,3,2,"RECORTES CERO-GRUPO VERDE",0
31,"31001",88,62,62,0,0,"RECORTES CERO-GRUPO VERDE",0
18,"18100",7807,5452,5398,50,54,"RECORTES CERO-GRUPO VERDE",5
25,"25167",230,138,138,3,0,"RECORTES CERO-GRUPO VERDE",0
31,"31200",761,517,508,3,9,"RECORTES CERO-GRUPO VERDE",1
50,"50043",253,171,171,0,0,"RECORTES CERO-GRUPO VERDE",1
12,"12061",373,285,282,3,3,"RECORTES CERO-GRUPO VERDE",1
37,"37260",150,116,116,1,0,"RECORTES CERO-GRUPO VERDE",0
10,"10094",234,196,196,1,0,"RECORTES CERO-GRUPO VERDE",0
44,"44013",11244,7815,7712,82,103,"RECORTES CERO-GRUPO VERDE",14
36,"36901",4103,3153,3102,19,51,"RECORTES CERO-GRUPO VERDE",5
40,"40178",98,73,71,1,2,"RECORTES CERO-GRUPO VERDE",0
6,"6021",926,645,636,8,9,"RECORTES CERO-GRUPO VERDE",0
49,"49092",129,90,89,1,1,"RECORTES CERO-GRUPO VERDE",0
8,"8008",190,110,110,5,0,"RECORTES CERO-GRUPO VERDE",0
47,"47067",174,127,126,0,1,"RECORTES CERO-GRUPO VERDE",0
31,"31002",414,288,287,3,1,"RECORTES CERO-GRUPO VERDE",2
16,"16101",154,132,132,0,0,"RECORTES CERO-GRUPO VERDE",0
45,"45057",222,180,177,1,3,"RECORTES CERO-GRUPO VERDE",0
15,"15067",8029,5789,5732,37,57,"RECORTES CERO-GRUPO VERDE",12
50,"50044",230,145,145,1,0,"RECORTES CERO-GRUPO VERDE",0
45,"45157",2128,1456,1427,13,29,"RECORTES CERO-GRUPO VERDE",6
46,"46118",3763,2940,2908,16,32,"RECORTES CERO-GRUPO VERDE",1
26,"26023",469,358,354,0,4,"RECORTES CERO-GRUPO VERDE",0
13,"13022",348,260,258,4,2,"RECORTES CERO-GRUPO VERDE",0
17,"17209",630,443,438,7,5,"RECORTES CERO-GRUPO VERDE",3
50,"50141",109,90,90,1,0,"RECORTES CERO-GRUPO VERDE",0
47,"47068",34,26,26,0,0,"RECORTES CERO-GRUPO VERDE",0
9,"9054",101,68,66,1,2,"RECORTES CERO-GRUPO VERDE",0
47,"47231",4401,3299,3277,24,22,"RECORTES CERO-GRUPO VERDE",5
16,"16103",261,222,222,0,0,"RECORTES CERO-GRUPO VERDE",0
43,"43082",365,290,286,5,4,"RECORTES CERO-GRUPO VERDE",0
37,"37003",115,93,93,0,0,"RECORTES CERO-GRUPO VERDE",0
31,"31103",42,34,34,2,0,"RECORTES CERO-GRUPO VERDE",0
33,"33057",1593,1063,1049,16,14,"RECORTES CERO-GRUPO VERDE",3
21,"21051",239,174,170,1,4,"RECORTES CERO-GRUPO VERDE",0
5,"5247",241,138,138,1,0,"RECORTES CERO-GRUPO VERDE",0
15,"15069",6745,4910,4850,43,60,"RECORTES CERO-GRUPO VERDE",11
28,"28160",8256,6102,6059,31,43,"RECORTES CERO-GRUPO VERDE",7
9,"9448",212,169,165,0,4,"RECORTES CERO-GRUPO VERDE",1
16,"16263",959,722,715,4,7,"RECORTES CERO-GRUPO VERDE",2
42,"42043",3791,2727,2682,25,45,"RECORTES CERO-GRUPO VERDE",6
8,"8011",1756,1087,1082,16,5,"RECORTES CERO-GRUPO VERDE",1
12,"12067",537,435,427,0,8,"RECORTES CERO-GRUPO VERDE",0
22,"22215",128,96,96,1,0,"RECORTES CERO-GRUPO VERDE",0
32,"32043",2561,1806,1774,9,32,"RECORTES CERO-GRUPO VERDE",2
50,"50142",26,17,17,0,0,"RECORTES CERO-GRUPO VERDE",0
25,"25085",148,107,107,0,0,"RECORTES CERO-GRUPO VERDE",0
46,"46120",1113,903,875,2,28,"RECORTES CERO-GRUPO VERDE",2
35,"35003",5211,2949,2908,13,41,"RECORTES CERO-GRUPO VERDE",3
26,"26025",87,71,70,1,1,"RECORTES CERO-GRUPO VERDE",0
44,"44018",19,19,19,0,0,"RECORTES CERO-GRUPO VERDE",0
8,"8012",1672,1075,1061,17,14,"RECORTES CERO-GRUPO VERDE",1
25,"25043",807,501,497,11,4,"RECORTES CERO-GRUPO VERDE",2
5,"5106",35,25,25,0,0,"RECORTES CERO-GRUPO VERDE",0
48,"48092",836,618,613,5,5,"RECORTES CERO-GRUPO VERDE",1
23,"23067",2460,1831,1805,11,26,"RECORTES CERO-GRUPO VERDE",4
40,"40056",34,28,28,1,0,"RECORTES CERO-GRUPO VERDE",0
8,"8013",1224,802,793,9,9,"RECORTES CERO-GRUPO VERDE",3
19,"19151",1064,744,726,1,18,"RECORTES CERO-GRUPO VERDE",0
10,"10101",185,145,141,1,4,"RECORTES CERO-GRUPO VERDE",0
44,"44019",67,50,49,0,1,"RECORTES CERO-GRUPO VERDE",0
46,"46121",105,95,94,0,1,"RECORTES CERO-GRUPO VERDE",0
9,"9057",145,108,108,0,0,"RECORTES CERO-GRUPO VERDE",0
31,"31007",131,87,86,1,1,"RECORTES CERO-GRUPO VERDE",0
48,"48093",893,653,643,7,10,"RECORTES CERO-GRUPO VERDE",1
23,"23069",5353,4310,4212,27,98,"RECORTES CERO-GRUPO VERDE",6
8,"8044",4141,2739,2726,15,13,"RECORTES CERO-GRUPO VERDE",6
47,"47019",85,74,73,0,1,"RECORTES CERO-GRUPO VERDE",0
20,"20034",3145,2026,2014,14,12,"RECORTES CERO-GRUPO VERDE",2
9,"9451",238,191,190,0,1,"RECORTES CERO-GRUPO VERDE",0
47,"47071",410,324,321,4,3,"RECORTES CERO-GRUPO VERDE",1
15,"15072",9574,6637,6562,35,75,"RECORTES CERO-GRUPO VERDE",17
5,"5254",190,160,159,0,1,"RECORTES CERO-GRUPO VERDE",0
28,"28162",2617,2029,2016,6,13,"RECORTES CERO-GRUPO VERDE",3
34,"34112",46,38,37,0,1,"RECORTES CERO-GRUPO VERDE",0
17,"17096",179,106,105,1,1,"RECORTES CERO-GRUPO VERDE",0
26,"26028",134,113,112,0,1,"RECORTES CERO-GRUPO VERDE",0
46,"46200",1903,1561,1539,3,22,"RECORTES CERO-GRUPO VERDE",2
37,"37051",85,66,66,0,0,"RECORTES CERO-GRUPO VERDE",1
22,"22903",652,514,507,1,7,"RECORTES CERO-GRUPO VERDE",0
21,"21056",2895,1990,1906,18,84,"RECORTES CERO-GRUPO VERDE",4
40,"40186",42,29,29,0,0,"RECORTES CERO-GRUPO VERDE",0
14,"14046",4485,3268,3208,33,60,"RECORTES CERO-GRUPO VERDE",0
8,"8016",1831,1136,1129,19,7,"RECORTES CERO-GRUPO VERDE",0
15,"15074",4037,2841,2796,20,45,"RECORTES CERO-GRUPO VERDE",3
28,"28009",14086,10611,10545,57,66,"RECORTES CERO-GRUPO VERDE",16
47,"47155",3228,2277,2254,18,23,"RECORTES CERO-GRUPO VERDE",3
31,"31009",677,507,505,5,2,"RECORTES CERO-GRUPO VERDE",1
47,"47073",122,103,101,1,2,"RECORTES CERO-GRUPO VERDE",0
8,"8128",563,375,372,2,3,"RECORTES CERO-GRUPO VERDE",2
37,"37270",189,152,151,2,1,"RECORTES CERO-GRUPO VERDE",0
40,"40188",90,72,70,0,2,"RECORTES CERO-GRUPO VERDE",1
19,"19300",772,595,591,5,4,"RECORTES CERO-GRUPO VERDE",3
43,"43131",4647,2934,2916,21,18,"RECORTES CERO-GRUPO VERDE",12
7,"7003",11761,6631,6541,55,90,"RECORTES CERO-GRUPO VERDE",28
49,"49100",295,212,208,5,4,"RECORTES CERO-GRUPO VERDE",1
19,"19155",66,56,56,0,0,"RECORTES CERO-GRUPO VERDE",0
23,"23072",1986,1542,1530,7,12,"RECORTES CERO-GRUPO VERDE",3
26,"26030",16,16,15,0,1,"RECORTES CERO-GRUPO VERDE",0
8,"8129",462,319,316,3,3,"RECORTES CERO-GRUPO VERDE",0
4,"4081",355,287,287,0,0,"RECORTES CERO-GRUPO VERDE",0
9,"9328",76,56,56,0,0,"RECORTES CERO-GRUPO VERDE",0
3,"3130",48,25,25,0,0,"RECORTES CERO-GRUPO VERDE",0
35,"35007",511,316,309,2,7,"RECORTES CERO-GRUPO VERDE",1
32,"32051",1427,1184,1172,6,12,"RECORTES CERO-GRUPO VERDE",1
50,"50180",119,99,99,2,0,"RECORTES CERO-GRUPO VERDE",0
38,"38048",3901,2667,2637,20,30,"RECORTES CERO-GRUPO VERDE",5
20,"20004",252,121,121,0,0,"RECORTES CERO-GRUPO VERDE",1
49,"49178",705,496,487,4,9,"RECORTES CERO-GRUPO VERDE",1
37,"37272",141,107,104,0,3,"RECORTES CERO-GRUPO VERDE",0
40,"40190",53,45,44,0,1,"RECORTES CERO-GRUPO VERDE",0
17,"17217",354,265,263,2,2,"RECORTES CERO-GRUPO VERDE",2
4,"4082",297,200,200,0,0,"RECORTES CERO-GRUPO VERDE",0
9,"9062",51,40,39,0,1,"RECORTES CERO-GRUPO VERDE",0
24,"24073",478,332,328,2,4,"RECORTES CERO-GRUPO VERDE",1
46,"46203",3606,2873,2844,9,29,"RECORTES CERO-GRUPO VERDE",4
33,"33064",234,168,167,1,1,"RECORTES CERO-GRUPO VERDE",0
32,"32052",1888,1399,1379,6,20,"RECORTES CERO-GRUPO VERDE",2
44,"44023",17,16,16,0,0,"RECORTES CERO-GRUPO VERDE",0
24,"24173",951,679,674,9,5,"RECORTES CERO-GRUPO VERDE",0
37,"37273",107,71,71,1,0,"RECORTES CERO-GRUPO VERDE",0
17,"17218",582,404,401,1,3,"RECORTES CERO-GRUPO VERDE",0
25,"25050",3233,1936,1912,25,24,"RECORTES CERO-GRUPO VERDE",2
37,"37013",119,79,76,0,3,"RECORTES CERO-GRUPO VERDE",0
18,"18115",2553,1800,1781,17,19,"RECORTES CERO-GRUPO VERDE",0
3,"3038",355,288,285,3,3,"RECORTES CERO-GRUPO VERDE",1
22,"22225",2679,1700,1665,17,35,"RECORTES CERO-GRUPO VERDE",2
19,"19037",141,115,114,1,1,"RECORTES CERO-GRUPO VERDE",0
42,"42190",89,65,64,0,1,"RECORTES CERO-GRUPO VERDE",0
47,"47076",17399,13097,12972,92,125,"RECORTES CERO-GRUPO VERDE",21
45,"45167",1440,1144,1133,6,11,"RECORTES CERO-GRUPO VERDE",4
9,"9463",264,195,195,7,0,"RECORTES CERO-GRUPO VERDE",0
20,"20040",15289,9444,9373,66,71,"RECORTES CERO-GRUPO VERDE",143
32,"32054",87167,60059,59333,540,726,"RECORTES CERO-GRUPO VERDE",161
50,"50244",201,162,161,1,1,"RECORTES CERO-GRUPO VERDE",1
48,"48902",19008,12566,12447,76,119,"RECORTES CERO-GRUPO VERDE",39
17,"17103",4954,2877,2850,25,27,"RECORTES CERO-GRUPO VERDE",3
22,"22226",767,570,562,10,8,"RECORTES CERO-GRUPO VERDE",2
45,"45168",62229,47154,46741,285,413,"RECORTES CERO-GRUPO VERDE",104
39,"39060",6679,5196,5121,29,75,"RECORTES CERO-GRUPO VERDE",5
32,"32055",1280,891,881,7,10,"RECORTES CERO-GRUPO VERDE",0
31,"31014",275,194,192,4,2,"RECORTES CERO-GRUPO VERDE",3
42,"42054",19,16,16,0,0,"RECORTES CERO-GRUPO VERDE",0
10,"10112",1571,1107,1081,9,26,"RECORTES CERO-GRUPO VERDE",1
48,"48903",1835,1361,1351,7,10,"RECORTES CERO-GRUPO VERDE",0
37,"37276",143,104,103,1,1,"RECORTES CERO-GRUPO VERDE",0
22,"22021",1971,1414,1398,17,16,"RECORTES CERO-GRUPO VERDE",3
7,"7009",738,521,510,12,11,"RECORTES CERO-GRUPO VERDE",1
13,"13040",868,678,672,4,6,"RECORTES CERO-GRUPO VERDE",2
20,"20041",255,123,123,0,0,"RECORTES CERO-GRUPO VERDE",0
44,"44059",544,425,412,9,13,"RECORTES CERO-GRUPO VERDE",0
45,"45070",1427,1147,1142,1,5,"RECORTES CERO-GRUPO VERDE",0
24,"24077",225,190,187,2,3,"RECORTES CERO-GRUPO VERDE",0
34,"34124",60,50,49,0,1,"RECORTES CERO-GRUPO VERDE",0
22,"22228",514,364,360,5,4,"RECORTES CERO-GRUPO VERDE",0
21,"21065",273,186,184,0,2,"RECORTES CERO-GRUPO VERDE",0
8,"8259",6637,4611,4577,39,34,"RECORTES CERO-GRUPO VERDE",7
22,"22099",483,379,377,4,2,"RECORTES CERO-GRUPO VERDE",1
42,"42193",14,10,10,0,0,"RECORTES CERO-GRUPO VERDE",0
9,"9199",92,72,71,1,1,"RECORTES CERO-GRUPO VERDE",0
41,"41064",5596,3517,3456,55,61,"RECORTES CERO-GRUPO VERDE",4
35,"35012",10382,5443,5392,17,51,"RECORTES CERO-GRUPO VERDE",12
37,"37278",732,532,528,3,4,"RECORTES CERO-GRUPO VERDE",0
9,"9067",437,295,294,6,1,"RECORTES CERO-GRUPO VERDE",0
31,"31016",7608,5474,5413,50,61,"RECORTES CERO-GRUPO VERDE",19
47,"47079",58,48,47,0,1,"RECORTES CERO-GRUPO VERDE",0
28,"28170",2472,1640,1622,13,18,"RECORTES CERO-GRUPO VERDE",1
15,"15082",15180,10841,10726,102,115,"RECORTES CERO-GRUPO VERDE",34
42,"42057",164,104,104,2,0,"RECORTES CERO-GRUPO VERDE",1
19,"19041",163,129,129,3,0,"RECORTES CERO-GRUPO VERDE",1
28,"28080",48554,38885,38691,164,194,"RECORTES CERO-GRUPO VERDE",38
5,"5122",134,102,101,0,1,"RECORTES CERO-GRUPO VERDE",0
19,"19163",56,41,40,0,1,"RECORTES CERO-GRUPO VERDE",0
5,"5901",263,182,180,2,2,"RECORTES CERO-GRUPO VERDE",0
35,"35013",6625,4896,4781,41,115,"RECORTES CERO-GRUPO VERDE",7
46,"46130",901,687,683,3,4,"RECORTES CERO-GRUPO VERDE",5
9,"9471",149,114,114,1,0,"RECORTES CERO-GRUPO VERDE",0
22,"22230",284,216,216,1,0,"RECORTES CERO-GRUPO VERDE",1
19,"19042",25,24,24,0,0,"RECORTES CERO-GRUPO VERDE",0
9,"9070",34,26,26,0,0,"RECORTES CERO-GRUPO VERDE",0
15,"15084",3260,2218,2191,27,27,"RECORTES CERO-GRUPO VERDE",8
5,"5124",102,83,81,0,2,"RECORTES CERO-GRUPO VERDE",0
50,"50059",769,549,544,8,5,"RECORTES CERO-GRUPO VERDE",1
17,"17110",1322,856,853,3,3,"RECORTES CERO-GRUPO VERDE",1
28,"28082",5683,4324,4286,25,38,"RECORTES CERO-GRUPO VERDE",15
31,"31018",393,292,285,4,7,"RECORTES CERO-GRUPO VERDE",1
9,"9202",25,22,22,1,0,"RECORTES CERO-GRUPO VERDE",0
49,"49111",127,98,96,4,2,"RECORTES CERO-GRUPO VERDE",0
43,"43101",145,104,102,3,2,"RECORTES CERO-GRUPO VERDE",0
45,"45073",298,233,233,1,0,"RECORTES CERO-GRUPO VERDE",1
26,"26039",39,35,35,2,0,"RECORTES CERO-GRUPO VERDE",0
3,"3138",3145,2310,2275,9,35,"RECORTES CERO-GRUPO VERDE",3
46,"46209",1933,1445,1415,5,30,"RECORTES CERO-GRUPO VERDE",5
49,"49233",93,58,55,0,3,"RECORTES CERO-GRUPO VERDE",0
34,"34129",179,130,129,1,1,"RECORTES CERO-GRUPO VERDE",0
50,"50060",172,128,127,1,1,"RECORTES CERO-GRUPO VERDE",1
21,"21070",6258,4165,4092,48,73,"RECORTES CERO-GRUPO VERDE",6
40,"40073",401,345,343,3,2,"RECORTES CERO-GRUPO VERDE",0
9,"9206",59,45,45,0,0,"RECORTES CERO-GRUPO VERDE",0
38,"38022",18450,12334,12160,62,174,"RECORTES CERO-GRUPO VERDE",12
46,"46132",2150,1803,1784,7,19,"RECORTES CERO-GRUPO VERDE",0
32,"32063",1914,1297,1279,16,18,"RECORTES CERO-GRUPO VERDE",3
47,"47082",812,640,628,8,12,"RECORTES CERO-GRUPO VERDE",4
42,"42060",38,21,19,1,2,"RECORTES CERO-GRUPO VERDE",0
33,"33072",1566,1008,994,11,14,"RECORTES CERO-GRUPO VERDE",0
26,"26040",70,60,60,0,0,"RECORTES CERO-GRUPO VERDE",0
3,"3045",210,176,172,0,4,"RECORTES CERO-GRUPO VERDE",0
28,"28084",15859,11156,11058,64,98,"RECORTES CERO-GRUPO VERDE",31
49,"49113",167,137,135,1,2,"RECORTES CERO-GRUPO VERDE",0
16,"16905",1224,920,910,4,10,"RECORTES CERO-GRUPO VERDE",4
22,"22028",371,282,280,3,2,"RECORTES CERO-GRUPO VERDE",0
25,"25061",83,46,46,0,0,"RECORTES CERO-GRUPO VERDE",1
32,"32064",529,389,388,3,1,"RECORTES CERO-GRUPO VERDE",1
15,"15087",5769,3766,3722,42,44,"RECORTES CERO-GRUPO VERDE",9
23,"23086",11511,7997,7874,91,123,"RECORTES CERO-GRUPO VERDE",35
43,"43105",162,123,122,2,1,"RECORTES CERO-GRUPO VERDE",0
5,"5128",354,281,271,2,10,"RECORTES CERO-GRUPO VERDE",0
48,"48909",209,161,161,0,0,"RECORTES CERO-GRUPO VERDE",0
24,"24182",416,294,290,2,4,"RECORTES CERO-GRUPO VERDE",0
42,"42062",22,12,12,0,0,"RECORTES CERO-GRUPO VERDE",0
12,"12082",9617,7324,7231,46,93,"RECORTES CERO-GRUPO VERDE",11
6,"6139",553,420,419,1,1,"RECORTES CERO-GRUPO VERDE",0
47,"47083",80,59,54,1,5,"RECORTES CERO-GRUPO VERDE",0
50,"50252",5138,3642,3611,24,31,"RECORTES CERO-GRUPO VERDE",1
24,"24115",54058,37780,37357,308,423,"RECORTES CERO-GRUPO VERDE",85
49,"49237",165,119,117,2,2,"RECORTES CERO-GRUPO VERDE",0
29,"29019",878,652,636,3,16,"RECORTES CERO-GRUPO VERDE",0
37,"37285",403,310,308,2,2,"RECORTES CERO-GRUPO VERDE",1
17,"17232",152,92,91,1,1,"RECORTES CERO-GRUPO VERDE",0
22,"22235",98,76,76,1,0,"RECORTES CERO-GRUPO VERDE",0
37,"37286",207,152,145,4,7,"RECORTES CERO-GRUPO VERDE",2
25,"25063",87,58,58,1,0,"RECORTES CERO-GRUPO VERDE",0
38,"38025",6880,4839,4761,30,78,"RECORTES CERO-GRUPO VERDE",10
22,"22109",261,191,190,1,1,"RECORTES CERO-GRUPO VERDE",0
50,"50253",423,330,328,4,2,"RECORTES CERO-GRUPO VERDE",3
19,"19278",28,26,26,0,0,"RECORTES CERO-GRUPO VERDE",0
45,"45077",556,428,427,1,1,"RECORTES CERO-GRUPO VERDE",2
42,"42064",86,68,68,0,0,"RECORTES CERO-GRUPO VERDE",1
24,"24084",163,116,116,0,0,"RECORTES CERO-GRUPO VERDE",0
16,"16130",571,450,448,1,2,"RECORTES CERO-GRUPO VERDE",1
10,"10032",1681,1257,1237,5,20,"RECORTES CERO-GRUPO VERDE",0
31,"31023",6956,5310,5289,85,21,"RECORTES CERO-GRUPO VERDE",23
37,"37287",310,213,210,2,3,"RECORTES CERO-GRUPO VERDE",0
15,"15090",1179,812,804,9,8,"RECORTES CERO-GRUPO VERDE",0
50,"50064",437,342,339,0,3,"RECORTES CERO-GRUPO VERDE",0
26,"26044",52,46,46,0,0,"RECORTES CERO-GRUPO VERDE",0
37,"37027",228,172,171,0,1,"RECORTES CERO-GRUPO VERDE",0
3,"3049",12088,9121,9027,52,94,"RECORTES CERO-GRUPO VERDE",6
45,"45179",525,391,386,3,5,"RECORTES CERO-GRUPO VERDE",1
8,"8146",1286,885,881,12,4,"RECORTES CERO-GRUPO VERDE",1
37,"37028",147,116,112,0,4,"RECORTES CERO-GRUPO VERDE",0
33,"33076",12258,8106,8031,63,75,"RECORTES CERO-GRUPO VERDE",8
50,"50065",53,43,43,0,0,"RECORTES CERO-GRUPO VERDE",0
9,"9214",672,427,427,4,0,"RECORTES CERO-GRUPO VERDE",1
22,"22239",88,72,72,0,0,"RECORTES CERO-GRUPO VERDE",0
8,"8025",1490,981,978,4,3,"RECORTES CERO-GRUPO VERDE",2
42,"42068",82,63,60,1,3,"RECORTES CERO-GRUPO VERDE",0
19,"19049",10,10,9,0,1,"RECORTES CERO-GRUPO VERDE",0
26,"26045",12,12,12,0,0,"RECORTES CERO-GRUPO VERDE",0
25,"25200",329,213,213,0,0,"RECORTES CERO-GRUPO VERDE",0
8,"8026",188,134,134,0,0,"RECORTES CERO-GRUPO VERDE",1
9,"9077",34,27,27,0,0,"RECORTES CERO-GRUPO VERDE",0
32,"32071",1476,1010,1005,3,5,"RECORTES CERO-GRUPO VERDE",0
13,"13057",1147,961,954,1,7,"RECORTES CERO-GRUPO VERDE",2
15,"15092",6438,3976,3903,28,73,"RECORTES CERO-GRUPO VERDE",4
46,"46058",1772,1398,1373,15,25,"RECORTES CERO-GRUPO VERDE",1
25,"25201",112,73,72,3,1,"RECORTES CERO-GRUPO VERDE",0
40,"40125",87,58,58,1,0,"RECORTES CERO-GRUPO VERDE",2
37,"37030",85,66,66,0,0,"RECORTES CERO-GRUPO VERDE",0
8,"8027",687,486,485,2,1,"RECORTES CERO-GRUPO VERDE",0
19,"19050",16,15,15,0,0,"RECORTES CERO-GRUPO VERDE",0
3,"3051",348,296,294,0,2,"RECORTES CERO-GRUPO VERDE",0
47,"47008",24,19,19,1,0,"RECORTES CERO-GRUPO VERDE",0
19,"19282",163,124,123,0,1,"RECORTES CERO-GRUPO VERDE",0
39,"39071",397,261,256,1,5,"RECORTES CERO-GRUPO VERDE",0
18,"18136",1851,1354,1337,5,17,"RECORTES CERO-GRUPO VERDE",0
20,"20053",4774,2973,2953,13,20,"RECORTES CERO-GRUPO VERDE",3
19,"19051",67,63,63,0,0,"RECORTES CERO-GRUPO VERDE",0
40,"40081",124,94,92,2,2,"RECORTES CERO-GRUPO VERDE",0
45,"45081",17875,12656,12533,82,123,"RECORTES CERO-GRUPO VERDE",25
28,"28090",8505,6654,6609,33,45,"RECORTES CERO-GRUPO VERDE",16
8,"8028",1024,648,644,4,4,"RECORTES CERO-GRUPO VERDE",1
44,"44039",221,165,159,0,6,"RECORTES CERO-GRUPO VERDE",0
39,"39072",344,198,196,2,2,"RECORTES CERO-GRUPO VERDE",0
10,"10130",1761,1300,1277,6,23,"RECORTES CERO-GRUPO VERDE",1
48,"48915",362,227,226,0,1,"RECORTES CERO-GRUPO VERDE",1
5,"5138",306,221,220,1,1,"RECORTES CERO-GRUPO VERDE",0
4,"4002",1039,748,740,2,8,"RECORTES CERO-GRUPO VERDE",1
40,"40082",114,84,82,1,2,"RECORTES CERO-GRUPO VERDE",0
20,"20054",447,286,284,2,2,"RECORTES CERO-GRUPO VERDE",0
22,"22244",52,38,37,0,1,"RECORTES CERO-GRUPO VERDE",0
12,"12089",4328,3078,3020,15,58,"RECORTES CERO-GRUPO VERDE",5
40,"40210",106,74,71,0,3,"RECORTES CERO-GRUPO VERDE",1
49,"49243",111,94,93,0,1,"RECORTES CERO-GRUPO VERDE",0
29,"29082",31885,22572,22400,152,172,"RECORTES CERO-GRUPO VERDE",42
11,"11032",53874,31273,31008,348,265,"RECORTES CERO-GRUPO VERDE",38
6,"6012",3267,2300,2277,15,23,"RECORTES CERO-GRUPO VERDE",2
19,"19175",32,28,28,0,0,"RECORTES CERO-GRUPO VERDE",0
44,"44040",201,160,157,1,3,"RECORTES CERO-GRUPO VERDE",0
4,"4003",17357,11157,11075,64,82,"RECORTES CERO-GRUPO VERDE",7
8,"8030",5122,3482,3466,21,16,"RECORTES CERO-GRUPO VERDE",3
16,"16001",76,61,61,0,0,"RECORTES CERO-GRUPO VERDE",0
22,"22245",309,267,261,1,6,"RECORTES CERO-GRUPO VERDE",0
49,"49122",782,526,520,5,6,"RECORTES CERO-GRUPO VERDE",1
20,"20055",17475,11073,10997,56,76,"RECORTES CERO-GRUPO VERDE",20
5,"5140",111,89,87,0,2,"RECORTES CERO-GRUPO VERDE",0
8,"8031",2322,1552,1537,6,15,"RECORTES CERO-GRUPO VERDE",2
25,"25205",566,382,372,8,10,"RECORTES CERO-GRUPO VERDE",1
31,"31230",106,82,82,1,0,"RECORTES CERO-GRUPO VERDE",0
4,"4099",4989,3636,3588,27,48,"RECORTES CERO-GRUPO VERDE",5
19,"19176",237,181,181,0,0,"RECORTES CERO-GRUPO VERDE",0
34,"34143",168,123,120,2,3,"RECORTES CERO-GRUPO VERDE",0
9,"9219",27509,19084,18859,146,225,"RECORTES CERO-GRUPO VERDE",42
13,"13064",1696,1231,1225,9,6,"RECORTES CERO-GRUPO VERDE",2
40,"40086",685,561,552,4,9,"RECORTES CERO-GRUPO VERDE",0
22,"22246",76,50,50,0,0,"RECORTES CERO-GRUPO VERDE",0
26,"26155",160,132,132,0,0,"RECORTES CERO-GRUPO VERDE",0
16,"16141",143,102,102,0,0,"RECORTES CERO-GRUPO VERDE",0
31,"31030",141,100,99,0,1,"RECORTES CERO-GRUPO VERDE",1
44,"44042",123,91,90,0,1,"RECORTES CERO-GRUPO VERDE",0
6,"6015",116758,77960,77205,583,755,"RECORTES CERO-GRUPO VERDE",180
9,"9084",186,136,135,4,1,"RECORTES CERO-GRUPO VERDE",0
9,"9906",1219,902,898,8,4,"RECORTES CERO-GRUPO VERDE",1
24,"24193",378,268,265,2,3,"RECORTES CERO-GRUPO VERDE",0
17,"17126",311,236,234,0,2,"RECORTES CERO-GRUPO VERDE",0
45,"45086",496,351,343,2,8,"RECORTES CERO-GRUPO VERDE",1
19,"19055",52,41,41,1,0,"RECORTES CERO-GRUPO VERDE",0
16,"16003",125,105,104,0,1,"RECORTES CERO-GRUPO VERDE",0
6,"6152",1319,945,932,4,13,"RECORTES CERO-GRUPO VERDE",0
2,"2040",559,484,483,3,1,"RECORTES CERO-GRUPO VERDE",0
38,"38035",9474,5616,5564,36,52,"RECORTES CERO-GRUPO VERDE",13
32,"32079",1333,950,939,11,11,"RECORTES CERO-GRUPO VERDE",5
45,"45119",3330,2096,2067,15,29,"RECORTES CERO-GRUPO VERDE",5
6,"6153",20377,14329,14163,103,166,"RECORTES CERO-GRUPO VERDE",14
19,"19287",148,109,108,0,1,"RECORTES CERO-GRUPO VERDE",0
46,"46141",439,351,342,2,9,"RECORTES CERO-GRUPO VERDE",2
4,"4006",7022,4792,4749,30,43,"RECORTES CERO-GRUPO VERDE",1
50,"50010",68,58,58,0,0,"RECORTES CERO-GRUPO VERDE",0
10,"10091",371,287,284,0,3,"RECORTES CERO-GRUPO VERDE",0
16,"16005",255,180,178,2,2,"RECORTES CERO-GRUPO VERDE",0
50,"50170",371,283,280,0,3,"RECORTES CERO-GRUPO VERDE",0
22,"22006",298,204,204,5,0,"RECORTES CERO-GRUPO VERDE",1
50,"50105",296,214,211,1,3,"RECORTES CERO-GRUPO VERDE",0
22,"22249",116,95,95,4,0,"RECORTES CERO-GRUPO VERDE",0
43,"43119",799,470,468,8,2,"RECORTES CERO-GRUPO VERDE",2
18,"18145",10491,7538,7477,59,61,"RECORTES CERO-GRUPO VERDE",11
9,"9088",66,45,45,0,0,"RECORTES CERO-GRUPO VERDE",0
50,"50073",2141,1592,1577,7,15,"RECORTES CERO-GRUPO VERDE",0
22,"22007",792,581,581,8,0,"RECORTES CERO-GRUPO VERDE",0
41,"41081",29189,20205,20015,196,190,"RECORTES CERO-GRUPO VERDE",37
39,"39077",236,173,171,1,2,"RECORTES CERO-GRUPO VERDE",0
8,"8157",8382,5823,5789,45,34,"RECORTES CERO-GRUPO VERDE",23
44,"44044",88,72,71,2,1,"RECORTES CERO-GRUPO VERDE",0
24,"24196",2057,1502,1485,9,17,"RECORTES CERO-GRUPO VERDE",5
22,"22124",201,144,143,1,1,"RECORTES CERO-GRUPO VERDE",0
16,"16007",1177,888,880,7,8,"RECORTES CERO-GRUPO VERDE",0
19,"19181",56,42,42,0,0,"RECORTES CERO-GRUPO VERDE",0
26,"26161",8,7,7,0,0,"RECORTES CERO-GRUPO VERDE",0
25,"25254",728,457,451,2,6,"RECORTES CERO-GRUPO VERDE",0
38,"38038",162027,104978,104035,575,943,"RECORTES CERO-GRUPO VERDE",497
46,"46221",352,305,304,0,1,"RECORTES CERO-GRUPO VERDE",0
46,"46143",4239,3104,3053,14,51,"RECORTES CERO-GRUPO VERDE",1
41,"41082",3415,2671,2647,16,24,"RECORTES CERO-GRUPO VERDE",4
5,"5148",25,15,15,0,0,"RECORTES CERO-GRUPO VERDE",0
50,"50075",80,62,61,1,1,"RECORTES CERO-GRUPO VERDE",1
19,"19182",38,34,33,0,1,"RECORTES CERO-GRUPO VERDE",0
47,"47015",200,162,160,0,2,"RECORTES CERO-GRUPO VERDE",0
25,"25078",998,628,627,7,1,"RECORTES CERO-GRUPO VERDE",0
37,"37302",290,196,195,2,1,"RECORTES CERO-GRUPO VERDE",0
26,"26055",39,32,32,0,0,"RECORTES CERO-GRUPO VERDE",0
40,"40051",38,34,34,0,0,"RECORTES CERO-GRUPO VERDE",0
9,"9091",724,500,490,4,10,"RECORTES CERO-GRUPO VERDE",0
3,"3059",20583,15125,15018,63,107,"RECORTES CERO-GRUPO VERDE",24
8,"8038",1487,959,954,15,5,"RECORTES CERO-GRUPO VERDE",0
32,"32085",10716,7279,7152,66,127,"RECORTES CERO-GRUPO VERDE",8
46,"46222",384,307,304,1,3,"RECORTES CERO-GRUPO VERDE",1
4,"4902",45437,28936,28699,214,237,"RECORTES CERO-GRUPO VERDE",38
17,"17133",1255,805,796,9,9,"RECORTES CERO-GRUPO VERDE",1
42,"42083",26,20,20,0,0,"RECORTES CERO-GRUPO VERDE",0
42,"42219",43,31,30,0,1,"RECORTES CERO-GRUPO VERDE",0
17,"17134",228,162,161,0,1,"RECORTES CERO-GRUPO VERDE",0
46,"46144",663,532,529,2,3,"RECORTES CERO-GRUPO VERDE",2
45,"45191",543,472,468,3,4,"RECORTES CERO-GRUPO VERDE",1
8,"8039",362,266,266,0,0,"RECORTES CERO-GRUPO VERDE",0
6,"6023",4302,3041,3007,16,34,"RECORTES CERO-GRUPO VERDE",5
19,"19184",71,50,48,0,2,"RECORTES CERO-GRUPO VERDE",0
44,"44047",220,137,132,2,5,"RECORTES CERO-GRUPO VERDE",1
8,"8285",10224,6396,6342,52,54,"RECORTES CERO-GRUPO VERDE",10
38,"38041",6821,4908,4861,40,47,"RECORTES CERO-GRUPO VERDE",17
25,"25215",345,240,236,0,4,"RECORTES CERO-GRUPO VERDE",0
46,"46145",21990,16337,16187,93,150,"RECORTES CERO-GRUPO VERDE",25
35,"35028",9776,5476,5401,43,75,"RECORTES CERO-GRUPO VERDE",12
16,"16011",27,22,22,1,0,"RECORTES CERO-GRUPO VERDE",0
26,"26057",48,38,38,0,0,"RECORTES CERO-GRUPO VERDE",0
17,"17015",12546,7832,7777,66,55,"RECORTES CERO-GRUPO VERDE",7
28,"28099",1748,1290,1283,7,7,"RECORTES CERO-GRUPO VERDE",2
4,"4011",2765,2119,2096,21,23,"RECORTES CERO-GRUPO VERDE",3
49,"49256",256,204,204,0,0,"RECORTES CERO-GRUPO VERDE",0
44,"44048",61,52,52,0,0,"RECORTES CERO-GRUPO VERDE",0
49,"49012",73,43,43,0,0,"RECORTES CERO-GRUPO VERDE",0
10,"10144",975,746,735,3,11,"RECORTES CERO-GRUPO VERDE",0
24,"24001",189,124,122,0,2,"RECORTES CERO-GRUPO VERDE",0
42,"42085",189,129,127,3,2,"RECORTES CERO-GRUPO VERDE",0
3,"3062",212,169,165,0,4,"RECORTES CERO-GRUPO VERDE",0
48,"48031",332,233,231,1,2,"RECORTES CERO-GRUPO VERDE",2
17,"17173",180,132,131,0,1,"RECORTES CERO-GRUPO VERDE",0
26,"26058",154,116,115,0,1,"RECORTES CERO-GRUPO VERDE",0
20,"20065",3012,1985,1967,12,18,"RECORTES CERO-GRUPO VERDE",7
12,"12098",580,451,447,5,4,"RECORTES CERO-GRUPO VERDE",0
17,"17136",178,125,124,0,1,"RECORTES CERO-GRUPO VERDE",0
16,"16013",27,24,24,0,0,"RECORTES CERO-GRUPO VERDE",0
5,"5155",52,44,44,0,0,"RECORTES CERO-GRUPO VERDE",0
35,"35030",9250,5413,5326,34,87,"RECORTES CERO-GRUPO VERDE",8
24,"24100",761,561,555,7,6,"RECORTES CERO-GRUPO VERDE",0
42,"42086",36,27,26,2,1,"RECORTES CERO-GRUPO VERDE",0
49,"49258",114,93,91,2,2,"RECORTES CERO-GRUPO VERDE",0
25,"25218",81,64,63,1,1,"RECORTES CERO-GRUPO VERDE",0
5,"5156",256,160,159,1,1,"RECORTES CERO-GRUPO VERDE",0
46,"46225",337,290,281,5,9,"RECORTES CERO-GRUPO VERDE",2
14,"14072",1048,806,795,6,11,"RECORTES CERO-GRUPO VERDE",1
9,"9230",38,32,32,0,0,"RECORTES CERO-GRUPO VERDE",0
46,"46147",16835,11920,11791,61,129,"RECORTES CERO-GRUPO VERDE",16
32,"32091",1838,1368,1362,6,6,"RECORTES CERO-GRUPO VERDE",0
49,"49015",227,179,177,0,2,"RECORTES CERO-GRUPO VERDE",0
17,"17018",480,327,322,2,5,"RECORTES CERO-GRUPO VERDE",0
50,"50238",91,66,66,1,0,"RECORTES CERO-GRUPO VERDE",1
50,"50018",953,656,655,1,1,"RECORTES CERO-GRUPO VERDE",0
9,"9100",59,45,44,0,1,"RECORTES CERO-GRUPO VERDE",0
18,"18018",634,472,468,5,4,"RECORTES CERO-GRUPO VERDE",0
22,"22015",319,234,228,3,6,"RECORTES CERO-GRUPO VERDE",0
12,"12100",1333,1065,1047,10,18,"RECORTES CERO-GRUPO VERDE",1
40,"40101",877,635,628,8,7,"RECORTES CERO-GRUPO VERDE",2
10,"10010",2290,1362,1341,7,21,"RECORTES CERO-GRUPO VERDE",3
50,"50080",33,27,27,0,0,"RECORTES CERO-GRUPO VERDE",0
22,"22130",10092,6671,6608,59,63,"RECORTES CERO-GRUPO VERDE",20
24,"24004",463,350,348,4,2,"RECORTES CERO-GRUPO VERDE",0
8,"8290",1507,1118,1110,12,8,"RECORTES CERO-GRUPO VERDE",2
48,"48064",606,447,445,4,2,"RECORTES CERO-GRUPO VERDE",1
12,"12131",63,52,52,0,0,"RECORTES CERO-GRUPO VERDE",0
49,"49136",318,220,218,1,2,"RECORTES CERO-GRUPO VERDE",0
16,"16016",224,171,168,0,3,"RECORTES CERO-GRUPO VERDE",0
5,"5007",111,81,80,3,1,"RECORTES CERO-GRUPO VERDE",0
40,"40103",159,125,123,2,2,"RECORTES CERO-GRUPO VERDE",0
17,"17020",3592,2333,2315,20,18,"RECORTES CERO-GRUPO VERDE",2
26,"26169",64,60,60,0,0,"RECORTES CERO-GRUPO VERDE",1
34,"34024",31,21,21,1,0,"RECORTES CERO-GRUPO VERDE",0
43,"43008",307,156,154,6,2,"RECORTES CERO-GRUPO VERDE",1
38,"38047",1777,1198,1170,4,28,"RECORTES CERO-GRUPO VERDE",1
24,"24206",1700,1253,1240,12,13,"RECORTES CERO-GRUPO VERDE",1
16,"16017",366,294,294,2,0,"RECORTES CERO-GRUPO VERDE",0
37,"37052",273,209,209,2,0,"RECORTES CERO-GRUPO VERDE",0
9,"9373",425,287,285,2,2,"RECORTES CERO-GRUPO VERDE",0
3,"3097",993,822,812,6,10,"RECORTES CERO-GRUPO VERDE",1
19,"19114",37,26,26,0,0,"RECORTES CERO-GRUPO VERDE",0
26,"26098",88,73,73,1,0,"RECORTES CERO-GRUPO VERDE",0
43,"43009",1403,918,905,14,13,"RECORTES CERO-GRUPO VERDE",2
20,"20069",147046,100691,100232,836,459,"RECORTES CERO-GRUPO VERDE",263
49,"49138",234,184,184,3,0,"RECORTES CERO-GRUPO VERDE",0
50,"50082",82,65,64,0,1,"RECORTES CERO-GRUPO VERDE",0
16,"16018",394,318,315,1,3,"RECORTES CERO-GRUPO VERDE",0
6,"6032",68,53,53,1,0,"RECORTES CERO-GRUPO VERDE",0
34,"34165",66,58,58,1,0,"RECORTES CERO-GRUPO VERDE",0
24,"24104",259,169,169,0,0,"RECORTES CERO-GRUPO VERDE",0
8,"8293",219,168,167,0,1,"RECORTES CERO-GRUPO VERDE",0
31,"31243",306,224,221,2,3,"RECORTES CERO-GRUPO VERDE",1
37,"37355",178,142,142,1,0,"RECORTES CERO-GRUPO VERDE",0
3,"3098",505,393,386,0,7,"RECORTES CERO-GRUPO VERDE",1
30,"30024",58746,42036,41731,206,305,"RECORTES CERO-GRUPO VERDE",68
31,"31077",5352,3908,3848,41,60,"RECORTES CERO-GRUPO VERDE",15
50,"50021",30,21,21,0,0,"RECORTES CERO-GRUPO VERDE",0
10,"10015",675,483,473,3,10,"RECORTES CERO-GRUPO VERDE",0
22,"22905",281,209,209,1,0,"RECORTES CERO-GRUPO VERDE",1
40,"40106",201,158,158,2,0,"RECORTES CERO-GRUPO VERDE",0
45,"45099",3500,2390,2361,9,29,"RECORTES CERO-GRUPO VERDE",7
24,"24209",2769,1888,1865,12,23,"RECORTES CERO-GRUPO VERDE",0
37,"37315",96,70,70,0,0,"RECORTES CERO-GRUPO VERDE",0
3,"3068",47,44,44,0,0,"RECORTES CERO-GRUPO VERDE",0
47,"47184",573,453,451,1,2,"RECORTES CERO-GRUPO VERDE",2
31,"31144",796,445,444,6,1,"RECORTES CERO-GRUPO VERDE",1
44,"44055",69,56,56,4,0,"RECORTES CERO-GRUPO VERDE",0
4,"4018",270,232,229,0,3,"RECORTES CERO-GRUPO VERDE",0
33,"33004",66857,46390,45960,426,430,"RECORTES CERO-GRUPO VERDE",86
20,"20005",1260,738,736,11,2,"RECORTES CERO-GRUPO VERDE",1
22,"22906",186,141,139,3,2,"RECORTES CERO-GRUPO VERDE",1
20,"20072",4728,2902,2886,21,16,"RECORTES CERO-GRUPO VERDE",15
31,"31046",57,39,39,1,0,"RECORTES CERO-GRUPO VERDE",0
45,"45100",188,150,150,0,0,"RECORTES CERO-GRUPO VERDE",0
49,"49142",249,180,179,0,1,"RECORTES CERO-GRUPO VERDE",0
24,"24210",503,358,356,3,2,"RECORTES CERO-GRUPO VERDE",1
3,"3069",3076,2123,2102,17,21,"RECORTES CERO-GRUPO VERDE",2
26,"26066",251,201,194,1,7,"RECORTES CERO-GRUPO VERDE",1
18,"18025",288,220,220,1,0,"RECORTES CERO-GRUPO VERDE",0
49,"49022",288,229,225,3,4,"RECORTES CERO-GRUPO VERDE",0
10,"10018",1689,1101,1081,6,20,"RECORTES CERO-GRUPO VERDE",1
36,"36002",3147,2193,2169,20,24,"RECORTES CERO-GRUPO VERDE",4
24,"24211",272,205,205,2,0,"RECORTES CERO-GRUPO VERDE",0
50,"50182",3399,2364,2335,21,29,"RECORTES CERO-GRUPO VERDE",6
28,"28041",4524,3508,3490,20,18,"RECORTES CERO-GRUPO VERDE",9
47,"47103",267,197,192,5,5,"RECORTES CERO-GRUPO VERDE",0
42,"42096",272,171,170,6,1,"RECORTES CERO-GRUPO VERDE",0
45,"45102",3610,2506,2470,14,36,"RECORTES CERO-GRUPO VERDE",5
37,"37318",208,159,158,1,1,"RECORTES CERO-GRUPO VERDE",2
19,"19079",8,8,7,0,1,"RECORTES CERO-GRUPO VERDE",0
3,"3070",2051,1455,1437,7,18,"RECORTES CERO-GRUPO VERDE",1
43,"43014",14251,8737,8624,101,113,"RECORTES CERO-GRUPO VERDE",16
49,"49023",967,673,662,10,11,"RECORTES CERO-GRUPO VERDE",0
43,"43137",1868,1254,1242,11,12,"RECORTES CERO-GRUPO VERDE",3
9,"9287",208,158,156,3,2,"RECORTES CERO-GRUPO VERDE",0
17,"17185",2265,1420,1404,15,16,"RECORTES CERO-GRUPO VERDE",1
17,"17146",2969,1868,1855,8,13,"RECORTES CERO-GRUPO VERDE",5
47,"47104",2836,2182,2121,19,61,"RECORTES CERO-GRUPO VERDE",1
4,"4055",371,310,308,0,2,"RECORTES CERO-GRUPO VERDE",0
16,"16071",20,20,20,0,0,"RECORTES CERO-GRUPO VERDE",0
19,"19232",71,57,57,1,0,"RECORTES CERO-GRUPO VERDE",0
10,"10158",330,269,267,0,2,"RECORTES CERO-GRUPO VERDE",0
37,"37060",243,187,187,1,0,"RECORTES CERO-GRUPO VERDE",2
16,"16165",61,54,53,0,1,"RECORTES CERO-GRUPO VERDE",0
19,"19196",105,84,81,0,3,"RECORTES CERO-GRUPO VERDE",0
20,"20075",4371,2692,2679,18,13,"RECORTES CERO-GRUPO VERDE",2
19,"19080",65,41,41,0,0,"RECORTES CERO-GRUPO VERDE",0
42,"42098",10,7,7,1,0,"RECORTES CERO-GRUPO VERDE",0
34,"34174",200,159,154,5,5,"RECORTES CERO-GRUPO VERDE",1
15,"15006",5321,3341,3283,49,58,"RECORTES CERO-GRUPO VERDE",5
28,"28111",596,467,467,3,0,"RECORTES CERO-GRUPO VERDE",1
10,"10160",229,190,189,2,1,"RECORTES CERO-GRUPO VERDE",0
26,"26176",53,44,44,1,0,"RECORTES CERO-GRUPO VERDE",0
8,"8055",519,331,327,4,4,"RECORTES CERO-GRUPO VERDE",0
50,"50088",302,246,237,5,9,"RECORTES CERO-GRUPO VERDE",0
20,"20076",6990,4666,4648,29,18,"RECORTES CERO-GRUPO VERDE",153
9,"9112",109,85,85,0,0,"RECORTES CERO-GRUPO VERDE",0
8,"8301",48557,32715,32533,253,182,"RECORTES CERO-GRUPO VERDE",129
46,"46233",3860,2859,2817,10,42,"RECORTES CERO-GRUPO VERDE",5
46,"46155",1029,833,822,4,11,"RECORTES CERO-GRUPO VERDE",0
16,"16029",99,72,70,0,2,"RECORTES CERO-GRUPO VERDE",0
50,"50278",197,145,145,0,0,"RECORTES CERO-GRUPO VERDE",0
44,"44062",34,25,22,0,3,"RECORTES CERO-GRUPO VERDE",0
8,"8056",42140,28129,27977,257,152,"RECORTES CERO-GRUPO VERDE",93
43,"43018",408,325,320,3,5,"RECORTES CERO-GRUPO VERDE",0
43,"43058",90,63,63,0,0,"RECORTES CERO-GRUPO VERDE",0
44,"44169",342,252,252,3,0,"RECORTES CERO-GRUPO VERDE",1
3,"3073",236,200,199,1,1,"RECORTES CERO-GRUPO VERDE",0
24,"24112",309,228,227,1,1,"RECORTES CERO-GRUPO VERDE",0
30,"30001",4582,3620,3594,18,26,"RECORTES CERO-GRUPO VERDE",3
16,"16030",24,19,19,0,0,"RECORTES CERO-GRUPO VERDE",0
17,"17150",1401,962,951,6,11,"RECORTES CERO-GRUPO VERDE",0
1,"1010",2268,1623,1603,11,20,"RECORTES CERO-GRUPO VERDE",6
45,"45005",238,193,192,3,1,"RECORTES CERO-GRUPO VERDE",0
27,"27047",1629,1106,1089,8,17,"RECORTES CERO-GRUPO VERDE",3
43,"43142",1100,698,688,5,10,"RECORTES CERO-GRUPO VERDE",0
23,"23003",8688,6326,6257,52,69,"RECORTES CERO-GRUPO VERDE",4
10,"10026",648,500,492,7,8,"RECORTES CERO-GRUPO VERDE",0
50,"50090",150,113,112,0,1,"RECORTES CERO-GRUPO VERDE",0
19,"19086",1473,1123,1111,7,12,"RECORTES CERO-GRUPO VERDE",0
17,"17151",174,111,110,3,1,"RECORTES CERO-GRUPO VERDE",0
16,"16031",46,28,28,1,0,"RECORTES CERO-GRUPO VERDE",0
47,"47189",152,119,118,0,1,"RECORTES CERO-GRUPO VERDE",0
26,"26179",41,32,31,0,1,"RECORTES CERO-GRUPO VERDE",0
43,"43143",54,47,47,3,0,"RECORTES CERO-GRUPO VERDE",0
46,"46157",2980,2321,2298,10,23,"RECORTES CERO-GRUPO VERDE",1
5,"5174",68,53,53,2,0,"RECORTES CERO-GRUPO VERDE",0
49,"49029",623,495,488,3,7,"RECORTES CERO-GRUPO VERDE",2
46,"46158",1026,811,795,6,16,"RECORTES CERO-GRUPO VERDE",2
10,"10164",737,484,475,3,9,"RECORTES CERO-GRUPO VERDE",0
45,"45107",3257,2504,2472,15,32,"RECORTES CERO-GRUPO VERDE",2
33,"33011",11260,6250,6163,83,87,"RECORTES CERO-GRUPO VERDE",6
24,"24015",2265,1649,1635,18,14,"RECORTES CERO-GRUPO VERDE",1
46,"46236",972,818,809,2,9,"RECORTES CERO-GRUPO VERDE",0
10,"10027",77,69,69,1,0,"RECORTES CERO-GRUPO VERDE",0
37,"37325",89,62,62,0,0,"RECORTES CERO-GRUPO VERDE",0
26,"26181",14,14,14,0,0,"RECORTES CERO-GRUPO VERDE",0
42,"42107",74,54,54,3,0,"RECORTES CERO-GRUPO VERDE",0
40,"40119",169,138,133,1,5,"RECORTES CERO-GRUPO VERDE",0
44,"44106",155,116,114,5,2,"RECORTES CERO-GRUPO VERDE",1
5,"5027",269,229,225,2,4,"RECORTES CERO-GRUPO VERDE",0
13,"13904",531,400,392,4,8,"RECORTES CERO-GRUPO VERDE",1
5,"5176",235,181,174,4,7,"RECORTES CERO-GRUPO VERDE",1
26,"26074",105,86,85,1,1,"RECORTES CERO-GRUPO VERDE",0
39,"39096",690,487,479,4,8,"RECORTES CERO-GRUPO VERDE",0
6,"6047",849,639,628,2,11,"RECORTES CERO-GRUPO VERDE",0
43,"43907",4374,2793,2783,24,10,"RECORTES CERO-GRUPO VERDE",10
18,"18036",3851,2870,2841,17,29,"RECORTES CERO-GRUPO VERDE",5
8,"8062",956,619,618,4,1,"RECORTES CERO-GRUPO VERDE",1
47,"47111",1020,742,732,7,10,"RECORTES CERO-GRUPO VERDE",0
9,"9119",46,28,28,0,0,"RECORTES CERO-GRUPO VERDE",0
44,"44174",428,307,304,3,3,"RECORTES CERO-GRUPO VERDE",1
47,"47030",993,766,751,6,15,"RECORTES CERO-GRUPO VERDE",1
46,"46029",20613,14964,14879,93,85,"RECORTES CERO-GRUPO VERDE",42
37,"37201",262,187,186,1,1,"RECORTES CERO-GRUPO VERDE",0
8,"8103",625,395,395,2,0,"RECORTES CERO-GRUPO VERDE",1
22,"22151",93,64,64,1,0,"RECORTES CERO-GRUPO VERDE",0
36,"36012",3732,2751,2717,9,34,"RECORTES CERO-GRUPO VERDE",8
50,"50191",470,310,308,1,2,"RECORTES CERO-GRUPO VERDE",0
6,"6049",1015,725,707,3,18,"RECORTES CERO-GRUPO VERDE",3
26,"26075",329,267,264,2,3,"RECORTES CERO-GRUPO VERDE",1
28,"28117",104,89,89,1,0,"RECORTES CERO-GRUPO VERDE",1
50,"50002",143,108,104,1,4,"RECORTES CERO-GRUPO VERDE",0
50,"50283",70,57,57,1,0,"RECORTES CERO-GRUPO VERDE",1
8,"8063",453,337,336,4,1,"RECORTES CERO-GRUPO VERDE",1
10,"10169",531,420,409,2,11,"RECORTES CERO-GRUPO VERDE",0
15,"15014",4002,2566,2524,28,42,"RECORTES CERO-GRUPO VERDE",6
24,"24221",795,543,538,7,5,"RECORTES CERO-GRUPO VERDE",0
31,"31056",174,121,120,0,1,"RECORTES CERO-GRUPO VERDE",0
10,"10215",431,311,308,2,3,"RECORTES CERO-GRUPO VERDE",1
12,"12015",93,81,78,0,3,"RECORTES CERO-GRUPO VERDE",0
46,"46082",4918,3745,3712,33,33,"RECORTES CERO-GRUPO VERDE",8
23,"23009",12861,9649,9543,72,106,"RECORTES CERO-GRUPO VERDE",6
40,"40163",53,44,43,0,1,"RECORTES CERO-GRUPO VERDE",0
9,"9123",40,35,35,0,0,"RECORTES CERO-GRUPO VERDE",0
8,"8902",3761,2570,2558,31,12,"RECORTES CERO-GRUPO VERDE",4
8,"8065",1176,797,784,10,13,"RECORTES CERO-GRUPO VERDE",2
45,"45111",65,50,50,0,0,"RECORTES CERO-GRUPO VERDE",0
19,"19091",26,20,20,0,0,"RECORTES CERO-GRUPO VERDE",0
44,"44068",659,509,503,3,6,"RECORTES CERO-GRUPO VERDE",0
39,"39099",3114,2308,2281,12,27,"RECORTES CERO-GRUPO VERDE",7
37,"37204",276,198,195,1,3,"RECORTES CERO-GRUPO VERDE",1
45,"45112",1922,1247,1211,6,36,"RECORTES CERO-GRUPO VERDE",1
5,"5036",123,101,101,1,0,"RECORTES CERO-GRUPO VERDE",0
9,"9124",1506,1040,1028,6,12,"RECORTES CERO-GRUPO VERDE",3
20,"20903",4330,2756,2734,28,22,"RECORTES CERO-GRUPO VERDE",8
16,"16181",64,52,52,2,0,"RECORTES CERO-GRUPO VERDE",0
3,"3112",628,511,507,2,4,"RECORTES CERO-GRUPO VERDE",0
31,"31091",351,220,217,1,3,"RECORTES CERO-GRUPO VERDE",1
22,"22157",192,129,128,3,1,"RECORTES CERO-GRUPO VERDE",1
44,"44070",53,48,48,0,0,"RECORTES CERO-GRUPO VERDE",0
50,"50096",39,27,27,0,0,"RECORTES CERO-GRUPO VERDE",0
26,"26078",82,70,70,0,0,"RECORTES CERO-GRUPO VERDE",0
23,"23011",2170,1515,1496,7,19,"RECORTES CERO-GRUPO VERDE",3
45,"45113",1915,1390,1366,6,24,"RECORTES CERO-GRUPO VERDE",2
24,"24021",1675,1162,1144,8,18,"RECORTES CERO-GRUPO VERDE",0
41,"41040",10541,7752,7698,68,54,"RECORTES CERO-GRUPO VERDE",23
36,"36016",1143,721,711,3,10,"RECORTES CERO-GRUPO VERDE",3
22,"22037",115,86,86,0,0,"RECORTES CERO-GRUPO VERDE",0
37,"37206",94,73,73,3,0,"RECORTES CERO-GRUPO VERDE",0
27,"27007",2805,2133,2078,38,55,"RECORTES CERO-GRUPO VERDE",1
8,"8068",6718,4373,4343,33,30,"RECORTES CERO-GRUPO VERDE",19
3,"3081",1436,1084,1075,5,9,"RECORTES CERO-GRUPO VERDE",1
42,"42117",140,101,99,0,2,"RECORTES CERO-GRUPO VERDE",0
26,"26079",634,520,512,4,8,"RECORTES CERO-GRUPO VERDE",0
48,"48050",191,147,146,0,1,"RECORTES CERO-GRUPO VERDE",0
6,"6055",2051,1453,1422,8,31,"RECORTES CERO-GRUPO VERDE",0
10,"10174",174,135,132,0,3,"RECORTES CERO-GRUPO VERDE",0
37,"37078",829,674,664,8,10,"RECORTES CERO-GRUPO VERDE",0
23,"23014",2559,1971,1942,13,29,"RECORTES CERO-GRUPO VERDE",1
10,"10037",76232,55104,54464,418,640,"RECORTES CERO-GRUPO VERDE",151
41,"41009",1222,812,805,3,7,"RECORTES CERO-GRUPO VERDE",2
20,"20906",119,87,87,1,0,"RECORTES CERO-GRUPO VERDE",0
49,"49037",185,153,151,0,2,"RECORTES CERO-GRUPO VERDE",0
12,"12018",287,246,242,1,4,"RECORTES CERO-GRUPO VERDE",0
10,"10175",1416,1006,980,4,26,"RECORTES CERO-GRUPO VERDE",1
9,"9127",56,41,39,0,2,"RECORTES CERO-GRUPO VERDE",0
5,"5040",66,50,50,1,0,"RECORTES CERO-GRUPO VERDE",0
33,"33019",3072,2020,2005,18,15,"RECORTES CERO-GRUPO VERDE",3
50,"50288",3387,2415,2398,31,17,"RECORTES CERO-GRUPO VERDE",2
19,"19323",40,31,31,0,0,"RECORTES CERO-GRUPO VERDE",0
26,"26081",16,14,14,0,0,"RECORTES CERO-GRUPO VERDE",0
18,"18044",181,107,107,0,0,"RECORTES CERO-GRUPO VERDE",0
31,"31161",338,264,259,2,5,"RECORTES CERO-GRUPO VERDE",4
17,"17162",150,86,86,1,0,"RECORTES CERO-GRUPO VERDE",0
19,"19098",19,17,17,0,0,"RECORTES CERO-GRUPO VERDE",0
44,"44075",323,248,246,0,2,"RECORTES CERO-GRUPO VERDE",1
3,"3083",5586,3971,3928,33,43,"RECORTES CERO-GRUPO VERDE",4
20,"20907",118,85,85,2,0,"RECORTES CERO-GRUPO VERDE",0
43,"43154",130,101,100,0,1,"RECORTES CERO-GRUPO VERDE",0
17,"17042",419,272,272,2,0,"RECORTES CERO-GRUPO VERDE",0
50,"50196",107,87,86,0,1,"RECORTES CERO-GRUPO VERDE",0
50,"50289",51,38,38,0,0,"RECORTES CERO-GRUPO VERDE",0
3,"3084",539,454,446,3,8,"RECORTES CERO-GRUPO VERDE",0
4,"4035",8364,5810,5766,28,44,"RECORTES CERO-GRUPO VERDE",3
23,"23016",387,321,320,0,1,"RECORTES CERO-GRUPO VERDE",1
10,"10040",441,313,307,4,6,"RECORTES CERO-GRUPO VERDE",0
19,"19099",298,200,199,6,1,"RECORTES CERO-GRUPO VERDE",0
8,"8072",10259,6462,6422,42,40,"RECORTES CERO-GRUPO VERDE",10
42,"42120",145,91,89,2,2,"RECORTES CERO-GRUPO VERDE",0
50,"50290",386,283,282,1,1,"RECORTES CERO-GRUPO VERDE",0
48,"48054",24171,16797,16711,118,86,"RECORTES CERO-GRUPO VERDE",45
7,"7027",20769,13097,12987,100,110,"RECORTES CERO-GRUPO VERDE",32
40,"40003",139,107,104,0,3,"RECORTES CERO-GRUPO VERDE",0
31,"31263",233,138,137,2,1,"RECORTES CERO-GRUPO VERDE",1
28,"28123",57078,45270,44992,215,278,"RECORTES CERO-GRUPO VERDE",91
17,"17165",656,439,435,3,4,"RECORTES CERO-GRUPO VERDE",0
17,"17044",6770,4411,4376,33,35,"RECORTES CERO-GRUPO VERDE",5
12,"12121",1107,924,893,4,31,"RECORTES CERO-GRUPO VERDE",0
16,"16046",245,180,180,1,0,"RECORTES CERO-GRUPO VERDE",0
19,"19102",98,79,78,0,1,"RECORTES CERO-GRUPO VERDE",0
23,"23018",2325,1668,1653,10,15,"RECORTES CERO-GRUPO VERDE",0
9,"9262",163,130,127,1,3,"RECORTES CERO-GRUPO VERDE",0
9,"9007",57,39,39,0,0,"RECORTES CERO-GRUPO VERDE",0
46,"46088",166,125,125,4,0,"RECORTES CERO-GRUPO VERDE",0
21,"21003",690,471,458,6,13,"RECORTES CERO-GRUPO VERDE",0
23,"23019",1536,1196,1174,2,22,"RECORTES CERO-GRUPO VERDE",0
43,"43158",85,52,52,1,0,"RECORTES CERO-GRUPO VERDE",0
26,"26084",6696,5012,4955,35,57,"RECORTES CERO-GRUPO VERDE",12
37,"37340",151,106,106,1,0,"RECORTES CERO-GRUPO VERDE",0
49,"49164",155,119,115,2,4,"RECORTES CERO-GRUPO VERDE",0
45,"45053",8005,6211,6140,42,71,"RECORTES CERO-GRUPO VERDE",2
18,"18048",2387,1683,1662,8,21,"RECORTES CERO-GRUPO VERDE",2
37,"37341",53,39,39,0,0,"RECORTES CERO-GRUPO VERDE",0
47,"47119",92,80,79,1,1,"RECORTES CERO-GRUPO VERDE",0
43,"43036",843,493,485,4,8,"RECORTES CERO-GRUPO VERDE",2
23,"23059",5837,4387,4310,40,77,"RECORTES CERO-GRUPO VERDE",3
29,"29086",793,470,470,3,0,"RECORTES CERO-GRUPO VERDE",0
29,"29063",323,250,245,1,5,"RECORTES CERO-GRUPO VERDE",1
46,"46011",7609,5249,5191,26,58,"RECORTES CERO-GRUPO VERDE",2
10,"10044",1428,1040,1025,5,15,"RECORTES CERO-GRUPO VERDE",2
34,"34902",139,106,106,0,0,"RECORTES CERO-GRUPO VERDE",0
6,"6063",3015,2268,2246,16,22,"RECORTES CERO-GRUPO VERDE",0
37,"37342",259,189,186,0,3,"RECORTES CERO-GRUPO VERDE",0
45,"45020",1290,1037,1026,6,11,"RECORTES CERO-GRUPO VERDE",1
16,"16049",149,111,110,0,1,"RECORTES CERO-GRUPO VERDE",0
31,"31901",15459,11119,11026,108,93,"RECORTES CERO-GRUPO VERDE",31
42,"42125",70,59,59,1,0,"RECORTES CERO-GRUPO VERDE",0
33,"33024",226679,158750,157564,1209,1186,"RECORTES CERO-GRUPO VERDE",367
17,"17168",380,260,258,0,2,"RECORTES CERO-GRUPO VERDE",0
21,"21006",3368,2182,2146,13,36,"RECORTES CERO-GRUPO VERDE",2
36,"36024",16455,11971,11781,109,190,"RECORTES CERO-GRUPO VERDE",23
50,"50106",134,104,104,0,0,"RECORTES CERO-GRUPO VERDE",0
4,"4041",322,240,238,6,2,"RECORTES CERO-GRUPO VERDE",0
45,"45121",6796,4743,4692,22,51,"RECORTES CERO-GRUPO VERDE",4
28,"28126",39,29,29,0,0,"RECORTES CERO-GRUPO VERDE",0
31,"31067",1922,1312,1294,10,18,"RECORTES CERO-GRUPO VERDE",4
8,"8117",2450,1602,1594,11,8,"RECORTES CERO-GRUPO VERDE",0
22,"22168",23,18,18,0,0,"RECORTES CERO-GRUPO VERDE",0
32,"32083",835,559,550,4,9,"RECORTES CERO-GRUPO VERDE",3
46,"46169",32247,24214,24053,154,161,"RECORTES CERO-GRUPO VERDE",90
50,"50107",947,738,733,4,5,"RECORTES CERO-GRUPO VERDE",0
12,"12125",216,180,177,0,3,"RECORTES CERO-GRUPO VERDE",1
37,"37344",241,175,174,2,1,"RECORTES CERO-GRUPO VERDE",0
30,"30016",151668,102093,101363,484,730,"RECORTES CERO-GRUPO VERDE",241
42,"42128",42,42,41,1,1,"RECORTES CERO-GRUPO VERDE",0
40,"40136",112,88,87,0,1,"RECORTES CERO-GRUPO VERDE",0
5,"5051",179,145,139,1,6,"RECORTES CERO-GRUPO VERDE",0
23,"23025",2802,2056,2037,9,19,"RECORTES CERO-GRUPO VERDE",0
45,"45089",1495,1102,1094,0,8,"RECORTES CERO-GRUPO VERDE",1
24,"24030",4277,3038,3007,11,31,"RECORTES CERO-GRUPO VERDE",4
39,"39018",4220,3264,3204,35,60,"RECORTES CERO-GRUPO VERDE",8
12,"12028",12586,9733,9676,62,57,"RECORTES CERO-GRUPO VERDE",16
47,"47204",256,204,198,0,6,"RECORTES CERO-GRUPO VERDE",0
40,"40138",2169,1673,1656,7,17,"RECORTES CERO-GRUPO VERDE",1
25,"25127",210,136,136,2,0,"RECORTES CERO-GRUPO VERDE",0
41,"41017",15158,10718,10616,92,102,"RECORTES CERO-GRUPO VERDE",19
26,"26091",161,146,146,0,0,"RECORTES CERO-GRUPO VERDE",0
37,"37346",273,212,211,1,1,"RECORTES CERO-GRUPO VERDE",0
47,"47124",392,316,311,3,5,"RECORTES CERO-GRUPO VERDE",0
28,"28128",444,315,314,0,1,"RECORTES CERO-GRUPO VERDE",0
16,"16198",1348,981,971,10,10,"RECORTES CERO-GRUPO VERDE",0
24,"24131",724,511,507,3,4,"RECORTES CERO-GRUPO VERDE",1
46,"46170",3417,2714,2688,10,26,"RECORTES CERO-GRUPO VERDE",2
16,"16053",426,351,347,5,4,"RECORTES CERO-GRUPO VERDE",1
42,"42176",29,25,25,0,0,"RECORTES CERO-GRUPO VERDE",0
19,"19220",2302,1519,1501,1,18,"RECORTES CERO-GRUPO VERDE",6
16,"16055",691,466,463,2,3,"RECORTES CERO-GRUPO VERDE",1
18,"18194",2128,1451,1437,9,14,"RECORTES CERO-GRUPO VERDE",0
37,"37092",1758,1225,1215,8,10,"RECORTES CERO-GRUPO VERDE",3
42,"42130",59,46,45,1,1,"RECORTES CERO-GRUPO VERDE",0
33,"33027",834,506,498,4,8,"RECORTES CERO-GRUPO VERDE",1
5,"5199",40,32,31,0,1,"RECORTES CERO-GRUPO VERDE",0
37,"37347",468,348,346,2,2,"RECORTES CERO-GRUPO VERDE",0
50,"50296",396,286,275,4,11,"RECORTES CERO-GRUPO VERDE",1
37,"37222",93,72,72,0,0,"RECORTES CERO-GRUPO VERDE",1
10,"10051",430,308,296,0,12,"RECORTES CERO-GRUPO VERDE",0
36,"36029",16077,11617,11471,100,146,"RECORTES CERO-GRUPO VERDE",24
9,"9138",85,72,70,0,2,"RECORTES CERO-GRUPO VERDE",0
21,"21011",3453,2441,2419,15,22,"RECORTES CERO-GRUPO VERDE",1
33,"33028",1276,649,641,4,8,"RECORTES CERO-GRUPO VERDE",0
27,"27025",2831,2152,2110,17,42,"RECORTES CERO-GRUPO VERDE",0
43,"43043",3130,2053,2036,18,17,"RECORTES CERO-GRUPO VERDE",5
25,"25129",175,83,83,2,0,"RECORTES CERO-GRUPO VERDE",0
19,"19065",127,104,104,3,0,"RECORTES CERO-GRUPO VERDE",0
3,"3093",19683,14633,14484,70,149,"RECORTES CERO-GRUPO VERDE",13
45,"45026",211,167,166,2,1,"RECORTES CERO-GRUPO VERDE",0
23,"23029",843,628,624,2,4,"RECORTES CERO-GRUPO VERDE",0
12,"12129",1828,1322,1298,11,24,"RECORTES CERO-GRUPO VERDE",3
16,"16203",9972,7094,7007,34,87,"RECORTES CERO-GRUPO VERDE",6
26,"26129",967,775,766,6,9,"RECORTES CERO-GRUPO VERDE",2
8,"8083",1675,1146,1144,9,2,"RECORTES CERO-GRUPO VERDE",1
26,"26094",83,70,70,0,0,"RECORTES CERO-GRUPO VERDE",0
37,"37097",39,27,27,1,0,"RECORTES CERO-GRUPO VERDE",0
36,"36031",558,465,459,7,6,"RECORTES CERO-GRUPO VERDE",1
42,"42134",2627,1927,1890,19,37,"RECORTES CERO-GRUPO VERDE",6
45,"45027",346,275,272,0,3,"RECORTES CERO-GRUPO VERDE",0
44,"44089",45,39,39,1,0,"RECORTES CERO-GRUPO VERDE",0
24,"24134",3416,2470,2417,19,53,"RECORTES CERO-GRUPO VERDE",6
25,"25905",375,249,246,3,3,"RECORTES CERO-GRUPO VERDE",0
23,"23030",1238,968,960,3,8,"RECORTES CERO-GRUPO VERDE",1
25,"25005",279,175,175,4,0,"RECORTES CERO-GRUPO VERDE",0
3,"3002",3605,2583,2557,15,26,"RECORTES CERO-GRUPO VERDE",7
37,"37224",206,183,175,3,8,"RECORTES CERO-GRUPO VERDE",0
29,"29004",312,236,233,2,3,"RECORTES CERO-GRUPO VERDE",0
18,"18017",18114,11610,11510,77,100,"RECORTES CERO-GRUPO VERDE",19
50,"50177",308,245,244,4,1,"RECORTES CERO-GRUPO VERDE",1
50,"50207",106,93,93,1,0,"RECORTES CERO-GRUPO VERDE",1
3,"3095",4579,3489,3459,25,30,"RECORTES CERO-GRUPO VERDE",8
28,"28064",129,106,106,2,0,"RECORTES CERO-GRUPO VERDE",0
49,"49175",230,172,171,1,1,"RECORTES CERO-GRUPO VERDE",0
32,"32001",4986,3488,3443,25,45,"RECORTES CERO-GRUPO VERDE",4
46,"46174",972,764,752,2,12,"RECORTES CERO-GRUPO VERDE",2
26,"26096",245,190,190,1,0,"RECORTES CERO-GRUPO VERDE",1
29,"29038",17676,11056,10970,141,86,"RECORTES CERO-GRUPO VERDE",20
47,"47128",60,52,51,0,1,"RECORTES CERO-GRUPO VERDE",0
37,"37310",178,123,123,1,0,"RECORTES CERO-GRUPO VERDE",0
50,"50239",62,50,48,0,2,"RECORTES CERO-GRUPO VERDE",0
34,"34068",27,22,22,0,0,"RECORTES CERO-GRUPO VERDE",0
40,"40144",18,14,14,0,0,"RECORTES CERO-GRUPO VERDE",0
31,"31174",110,63,63,0,0,"RECORTES CERO-GRUPO VERDE",0
31,"31075",103,63,63,0,0,"RECORTES CERO-GRUPO VERDE",0
9,"9143",27,19,18,0,1,"RECORTES CERO-GRUPO VERDE",0
22,"22177",98,75,75,0,0,"RECORTES CERO-GRUPO VERDE",0
40,"40059",110,95,95,1,0,"RECORTES CERO-GRUPO VERDE",0
42,"42140",16,12,12,0,0,"RECORTES CERO-GRUPO VERDE",0
37,"37353",126,97,97,1,0,"RECORTES CERO-GRUPO VERDE",0
10,"10058",1021,718,708,2,10,"RECORTES CERO-GRUPO VERDE",2
5,"5207",692,547,543,0,4,"RECORTES CERO-GRUPO VERDE",0
17,"17178",1059,654,650,7,4,"RECORTES CERO-GRUPO VERDE",1
22,"22178",103,82,81,0,1,"RECORTES CERO-GRUPO VERDE",0
6,"6122",6634,4427,4321,26,106,"RECORTES CERO-GRUPO VERDE",11
43,"43090",1076,565,558,6,7,"RECORTES CERO-GRUPO VERDE",1
37,"37144",363,277,276,1,1,"RECORTES CERO-GRUPO VERDE",0
40,"40104",265,198,195,0,3,"RECORTES CERO-GRUPO VERDE",0
42,"42141",112,80,80,0,0,"RECORTES CERO-GRUPO VERDE",0
25,"25009",627,444,440,8,4,"RECORTES CERO-GRUPO VERDE",0
25,"25909",148,93,92,2,1,"RECORTES CERO-GRUPO VERDE",0
31,"31076",2417,1918,1906,9,12,"RECORTES CERO-GRUPO VERDE",8
28,"28134",61008,45177,44904,263,273,"RECORTES CERO-GRUPO VERDE",105
36,"36035",14433,10333,10188,79,145,"RECORTES CERO-GRUPO VERDE",30
42,"42142",50,35,35,1,0,"RECORTES CERO-GRUPO VERDE",0
21,"21019",612,400,391,2,9,"RECORTES CERO-GRUPO VERDE",2
26,"26135",164,125,124,1,1,"RECORTES CERO-GRUPO VERDE",0
3,"3036",87,81,78,0,3,"RECORTES CERO-GRUPO VERDE",0
5,"5113",71,56,56,0,0,"RECORTES CERO-GRUPO VERDE",1
40,"40019",36,31,31,1,0,"RECORTES CERO-GRUPO VERDE",0
44,"44196",131,101,98,2,3,"RECORTES CERO-GRUPO VERDE",0
41,"41026",4314,3380,3322,18,58,"RECORTES CERO-GRUPO VERDE",3
28,"28067",4063,3102,3079,3,23,"RECORTES CERO-GRUPO VERDE",4
49,"49059",94,64,64,0,0,"RECORTES CERO-GRUPO VERDE",0
36,"36036",2518,1827,1801,18,26,"RECORTES CERO-GRUPO VERDE",1
5,"5260",105,90,90,0,0,"RECORTES CERO-GRUPO VERDE",0
25,"25010",211,113,113,2,0,"RECORTES CERO-GRUPO VERDE",0
40,"40149",514,375,369,5,6,"RECORTES CERO-GRUPO VERDE",0
34,"34221",179,144,144,3,0,"RECORTES CERO-GRUPO VERDE",0
26,"26101",44,36,35,0,1,"RECORTES CERO-GRUPO VERDE",0
45,"45133",2797,2068,2048,13,20,"RECORTES CERO-GRUPO VERDE",3
10,"10062",406,337,331,0,6,"RECORTES CERO-GRUPO VERDE",0
34,"34222",120,87,87,3,0,"RECORTES CERO-GRUPO VERDE",0
16,"16274",121,92,92,0,0,"RECORTES CERO-GRUPO VERDE",0
44,"44096",161,138,135,3,3,"RECORTES CERO-GRUPO VERDE",0
50,"50117",126,104,103,1,1,"RECORTES CERO-GRUPO VERDE",1
5,"5212",231,164,163,2,1,"RECORTES CERO-GRUPO VERDE",0
8,"8091",5244,3611,3584,17,27,"RECORTES CERO-GRUPO VERDE",6
36,"36038",66390,47750,47273,449,477,"RECORTES CERO-GRUPO VERDE",101
9,"9421",230,166,163,3,3,"RECORTES CERO-GRUPO VERDE",0
44,"44097",142,92,92,0,0,"RECORTES CERO-GRUPO VERDE",0
3,"3100",503,440,437,0,3,"RECORTES CERO-GRUPO VERDE",0
50,"50023",224,175,175,0,0,"RECORTES CERO-GRUPO VERDE",1
17,"17183",277,180,179,1,1,"RECORTES CERO-GRUPO VERDE",0
49,"49062",122,90,89,0,1,"RECORTES CERO-GRUPO VERDE",0
36,"36039",15401,10871,10609,71,262,"RECORTES CERO-GRUPO VERDE",39
41,"41028",2003,1524,1511,9,13,"RECORTES CERO-GRUPO VERDE",1
48,"48069",12798,8679,8612,55,67,"RECORTES CERO-GRUPO VERDE",17
18,"18911",7473,5098,5035,51,63,"RECORTES CERO-GRUPO VERDE",12
49,"49181",362,277,276,2,1,"RECORTES CERO-GRUPO VERDE",0
32,"32009",10803,7303,7227,48,76,"RECORTES CERO-GRUPO VERDE",16
34,"34223",218,155,155,1,0,"RECORTES CERO-GRUPO VERDE",0
50,"50119",927,724,713,5,11,"RECORTES CERO-GRUPO VERDE",0
43,"43177",299,231,230,6,1,"RECORTES CERO-GRUPO VERDE",0
37,"37359",184,130,129,0,1,"RECORTES CERO-GRUPO VERDE",0
34,"34224",47,37,37,1,0,"RECORTES CERO-GRUPO VERDE",0
16,"16070",30,26,26,1,0,"RECORTES CERO-GRUPO VERDE",0
46,"46179",2165,1760,1737,16,23,"RECORTES CERO-GRUPO VERDE",1
32,"32010",388,301,299,3,2,"RECORTES CERO-GRUPO VERDE",0
49,"49105",150,109,108,0,1,"RECORTES CERO-GRUPO VERDE",1
20,"20074",11592,7954,7914,45,40,"RECORTES CERO-GRUPO VERDE",8
42,"42149",381,277,273,2,4,"RECORTES CERO-GRUPO VERDE",1
31,"31081",338,216,212,4,4,"RECORTES CERO-GRUPO VERDE",1
37,"37016",569,406,401,2,5,"RECORTES CERO-GRUPO VERDE",0
42,"42192",42,27,27,2,0,"RECORTES CERO-GRUPO VERDE",0
19,"19267",19,13,13,0,0,"RECORTES CERO-GRUPO VERDE",0
34,"34076",587,479,479,2,0,"RECORTES CERO-GRUPO VERDE",1
33,"33038",2303,1584,1559,13,25,"RECORTES CERO-GRUPO VERDE",1
17,"17186",3788,2554,2526,27,28,"RECORTES CERO-GRUPO VERDE",8
44,"44100",185,153,151,0,2,"RECORTES CERO-GRUPO VERDE",0
47,"47134",165,128,125,1,3,"RECORTES CERO-GRUPO VERDE",0
18,"18071",5579,4044,3985,37,59,"RECORTES CERO-GRUPO VERDE",6
42,"42151",34,26,26,0,0,"RECORTES CERO-GRUPO VERDE",0
25,"25015",357,219,219,2,0,"RECORTES CERO-GRUPO VERDE",0
19,"19120",101,88,88,1,0,"RECORTES CERO-GRUPO VERDE",0
9,"9155",27,20,20,0,0,"RECORTES CERO-GRUPO VERDE",0
23,"23041",499,398,394,2,4,"RECORTES CERO-GRUPO VERDE",1
49,"49066",492,336,332,4,4,"RECORTES CERO-GRUPO VERDE",0
8,"8096",42622,28797,28615,263,182,"RECORTES CERO-GRUPO VERDE",94
29,"29047",1117,885,866,1,19,"RECORTES CERO-GRUPO VERDE",2
44,"44101",58,46,46,2,0,"RECORTES CERO-GRUPO VERDE",0
44,"44102",30,27,26,0,1,"RECORTES CERO-GRUPO VERDE",0
5,"5218",121,97,97,0,0,"RECORTES CERO-GRUPO VERDE",0
46,"46181",16955,12313,12148,95,165,"RECORTES CERO-GRUPO VERDE",15
12,"12139",318,237,233,0,4,"RECORTES CERO-GRUPO VERDE",0
10,"10069",838,626,615,2,11,"RECORTES CERO-GRUPO VERDE",2
23,"23042",292,217,213,1,4,"RECORTES CERO-GRUPO VERDE",0
37,"37363",118,88,87,0,1,"RECORTES CERO-GRUPO VERDE",0
42,"42153",14,12,12,0,0,"RECORTES CERO-GRUPO VERDE",0
47,"47053",119,98,96,0,2,"RECORTES CERO-GRUPO VERDE",0
10,"10116",3749,2726,2670,21,56,"RECORTES CERO-GRUPO VERDE",8
50,"50297",498961,362043,359558,2748,2485,"RECORTES CERO-GRUPO VERDE",891
43,"43100",3301,2183,2172,24,11,"RECORTES CERO-GRUPO VERDE",7
8,"8097",1021,715,712,8,3,"RECORTES CERO-GRUPO VERDE",0
12,"12044",468,419,412,3,7,"RECORTES CERO-GRUPO VERDE",0
37,"37364",820,607,598,6,9,"RECORTES CERO-GRUPO VERDE",1
26,"26004",67,50,50,0,0,"RECORTES CERO-GRUPO VERDE",0
3,"3013",1113,839,836,4,3,"RECORTES CERO-GRUPO VERDE",1
8,"8098",2381,1544,1534,5,10,"RECORTES CERO-GRUPO VERDE",5
10,"10208",123,94,93,1,1,"RECORTES CERO-GRUPO VERDE",0
45,"45172",689,530,522,2,8,"RECORTES CERO-GRUPO VERDE",0
9,"9427",1419,978,959,8,19,"RECORTES CERO-GRUPO VERDE",1
50,"50123",449,334,331,1,3,"RECORTES CERO-GRUPO VERDE",1
34,"34230",15,12,12,0,0,"RECORTES CERO-GRUPO VERDE",0
10,"10071",139,96,94,0,2,"RECORTES CERO-GRUPO VERDE",0
10,"10209",282,179,177,1,2,"RECORTES CERO-GRUPO VERDE",0
24,"24149",152,120,116,3,4,"RECORTES CERO-GRUPO VERDE",0
21,"21029",1562,1127,1097,14,30,"RECORTES CERO-GRUPO VERDE",5
33,"33041",7199,4922,4877,52,45,"RECORTES CERO-GRUPO VERDE",6
24,"24047",783,545,540,2,5,"RECORTES CERO-GRUPO VERDE",1
47,"47218",993,743,734,2,9,"RECORTES CERO-GRUPO VERDE",1
42,"42155",167,103,102,1,1,"RECORTES CERO-GRUPO VERDE",1
40,"40031",526,398,396,2,2,"RECORTES CERO-GRUPO VERDE",2
46,"46027",943,780,771,5,9,"RECORTES CERO-GRUPO VERDE",0
44,"44105",82,64,64,0,0,"RECORTES CERO-GRUPO VERDE",0
50,"50124",415,318,317,2,1,"RECORTES CERO-GRUPO VERDE",0
50,"50901",138,105,105,0,0,"RECORTES CERO-GRUPO VERDE",0
37,"37116",69,50,50,0,0,"RECORTES CERO-GRUPO VERDE",0
10,"10073",747,524,516,4,8,"RECORTES CERO-GRUPO VERDE",2
12,"12142",158,117,117,1,0,"RECORTES CERO-GRUPO VERDE",0
37,"37366",43,32,32,0,0,"RECORTES CERO-GRUPO VERDE",0
21,"21030",1830,1452,1430,13,22,"RECORTES CERO-GRUPO VERDE",1
50,"50219",4119,2833,2804,19,29,"RECORTES CERO-GRUPO VERDE",9
8,"8141",4563,2953,2929,34,24,"RECORTES CERO-GRUPO VERDE",0
3,"3107",2508,1755,1744,7,11,"RECORTES CERO-GRUPO VERDE",1
19,"19167",130,101,99,0,2,"RECORTES CERO-GRUPO VERDE",0
19,"19125",41,32,32,0,0,"RECORTES CERO-GRUPO VERDE",0
34,"34084",138,109,107,0,2,"RECORTES CERO-GRUPO VERDE",0
10,"10075",253,167,166,1,1,"RECORTES CERO-GRUPO VERDE",1
46,"46106",1535,1150,1140,10,10,"RECORTES CERO-GRUPO VERDE",5
21,"21031",1199,852,837,6,15,"RECORTES CERO-GRUPO VERDE",0
9,"9208",210,136,134,3,2,"RECORTES CERO-GRUPO VERDE",0
18,"18082",861,616,611,5,5,"RECORTES CERO-GRUPO VERDE",2
42,"42158",103,76,76,0,0,"RECORTES CERO-GRUPO VERDE",0
28,"28174",1795,1232,1221,7,11,"RECORTES CERO-GRUPO VERDE",1
9,"9166",97,81,81,0,0,"RECORTES CERO-GRUPO VERDE",0
3,"3109",2850,2181,2164,8,17,"RECORTES CERO-GRUPO VERDE",0
33,"33043",683,446,441,2,5,"RECORTES CERO-GRUPO VERDE",1
37,"37284",316,246,238,4,8,"RECORTES CERO-GRUPO VERDE",0
45,"45143",1170,881,874,4,7,"RECORTES CERO-GRUPO VERDE",0
46,"46133",533,415,410,6,5,"RECORTES CERO-GRUPO VERDE",0
9,"9209",4473,3223,3192,20,31,"RECORTES CERO-GRUPO VERDE",11
16,"16129",95,81,79,0,2,"RECORTES CERO-GRUPO VERDE",0
24,"24018",174,143,141,0,2,"RECORTES CERO-GRUPO VERDE",0
16,"16084",48,38,37,1,1,"RECORTES CERO-GRUPO VERDE",0
37,"37119",107,84,82,0,2,"RECORTES CERO-GRUPO VERDE",0
5,"5227",358,253,250,1,3,"RECORTES CERO-GRUPO VERDE",2
21,"21033",538,373,370,3,3,"RECORTES CERO-GRUPO VERDE",1
50,"50128",26,25,25,1,0,"RECORTES CERO-GRUPO VERDE",0
19,"19127",89,64,64,0,0,"RECORTES CERO-GRUPO VERDE",0
8,"8104",679,432,430,3,2,"RECORTES CERO-GRUPO VERDE",0
40,"40035",137,105,104,0,1,"RECORTES CERO-GRUPO VERDE",0
21,"21034",1188,798,786,8,12,"RECORTES CERO-GRUPO VERDE",0
47,"47140",115,102,102,1,0,"RECORTES CERO-GRUPO VERDE",0
31,"31256",107,59,59,0,0,"RECORTES CERO-GRUPO VERDE",0
40,"40078",161,125,124,2,1,"RECORTES CERO-GRUPO VERDE",1
33,"33045",4487,3057,2999,28,58,"RECORTES CERO-GRUPO VERDE",2
23,"23049",1813,1238,1222,9,16,"RECORTES CERO-GRUPO VERDE",0
16,"16131",130,100,97,2,3,"RECORTES CERO-GRUPO VERDE",0
13,"13002",1483,1012,998,3,14,"RECORTES CERO-GRUPO VERDE",0
41,"41039",31663,22062,21830,193,232,"RECORTES CERO-GRUPO VERDE",30
37,"37371",272,165,162,1,3,"RECORTES CERO-GRUPO VERDE",1
49,"49078",170,141,140,1,1,"RECORTES CERO-GRUPO VERDE",0
3,"3111",5436,3918,3883,18,35,"RECORTES CERO-GRUPO VERDE",5
44,"44109",108,73,73,0,0,"RECORTES CERO-GRUPO VERDE",0
23,"23050",90992,64810,64218,485,592,"RECORTES CERO-GRUPO VERDE",108
26,"26113",35,35,34,0,1,"RECORTES CERO-GRUPO VERDE",0
10,"10080",366,257,255,1,2,"RECORTES CERO-GRUPO VERDE",0
39,"39039",568,382,379,0,3,"RECORTES CERO-GRUPO VERDE",0
37,"37122",201,154,153,5,1,"RECORTES CERO-GRUPO VERDE",0
9,"9169",95,78,78,0,0,"RECORTES CERO-GRUPO VERDE",0
13,"13004",1025,807,800,4,7,"RECORTES CERO-GRUPO VERDE",0
28,"28023",4775,3755,3735,12,20,"RECORTES CERO-GRUPO VERDE",6
40,"40206",173,135,134,0,1,"RECORTES CERO-GRUPO VERDE",0
48,"48079",427,305,304,2,1,"RECORTES CERO-GRUPO VERDE",0
42,"42162",2352,1637,1601,16,36,"RECORTES CERO-GRUPO VERDE",2
49,"49197",175,123,123,1,0,"RECORTES CERO-GRUPO VERDE",0
10,"10218",1126,803,795,3,8,"RECORTES CERO-GRUPO VERDE",0
9,"9304",199,157,155,3,2,"RECORTES CERO-GRUPO VERDE",0
3,"3113",4243,3091,3046,10,45,"RECORTES CERO-GRUPO VERDE",2
46,"46032",5653,4402,4361,33,41,"RECORTES CERO-GRUPO VERDE",11
49,"49118",203,161,160,1,1,"RECORTES CERO-GRUPO VERDE",0
31,"31191",3016,2167,2147,22,20,"RECORTES CERO-GRUPO VERDE",9
37,"37374",1166,935,919,9,16,"RECORTES CERO-GRUPO VERDE",1
10,"10082",1868,1451,1412,11,39,"RECORTES CERO-GRUPO VERDE",0
50,"50131",231,167,165,0,2,"RECORTES CERO-GRUPO VERDE",0
8,"8108",5016,3501,3474,21,27,"RECORTES CERO-GRUPO VERDE",8
26,"26115",19,16,16,0,0,"RECORTES CERO-GRUPO VERDE",0
44,"44111",92,69,68,0,1,"RECORTES CERO-GRUPO VERDE",0
13,"13007",1271,993,977,8,16,"RECORTES CERO-GRUPO VERDE",1
28,"28150",3087,2294,2277,10,17,"RECORTES CERO-GRUPO VERDE",7
47,"47060",258,216,214,1,2,"RECORTES CERO-GRUPO VERDE",1
7,"7064",5315,3475,3434,31,41,"RECORTES CERO-GRUPO VERDE",12
42,"42163",50,41,40,0,1,"RECORTES CERO-GRUPO VERDE",0
5,"5087",134,87,85,1,2,"RECORTES CERO-GRUPO VERDE",0
36,"36053",5684,4099,4050,38,49,"RECORTES CERO-GRUPO VERDE",3
10,"10084",1345,888,875,4,13,"RECORTES CERO-GRUPO VERDE",2
44,"44112",429,290,290,2,0,"RECORTES CERO-GRUPO VERDE",0
29,"29058",1450,911,894,4,17,"RECORTES CERO-GRUPO VERDE",0
26,"26014",474,327,324,1,3,"RECORTES CERO-GRUPO VERDE",1
45,"45049",433,305,304,1,1,"RECORTES CERO-GRUPO VERDE",0
26,"26117",2152,1625,1605,10,20,"RECORTES CERO-GRUPO VERDE",4
17,"17199",6853,4147,4122,27,25,"RECORTES CERO-GRUPO VERDE",9
37,"37376",2233,1539,1515,6,24,"RECORTES CERO-GRUPO VERDE",2
28,"28151",3142,2235,2199,8,36,"RECORTES CERO-GRUPO VERDE",8
44,"44113",71,52,52,0,0,"RECORTES CERO-GRUPO VERDE",0
46,"46112",536,455,450,2,5,"RECORTES CERO-GRUPO VERDE",0
29,"29059",2587,1965,1922,14,43,"RECORTES CERO-GRUPO VERDE",4
42,"42031",26,21,21,0,0,"RECORTES CERO-GRUPO VERDE",0
17,"17200",613,424,422,5,2,"RECORTES CERO-GRUPO VERDE",0
16,"16188",91,65,65,0,0,"RECORTES CERO-GRUPO VERDE",0
46,"46190",48947,35638,35419,211,219,"RECORTES CERO-GRUPO VERDE",103
13,"13010",883,646,634,3,12,"RECORTES CERO-GRUPO VERDE",3
6,"6103",4796,3265,3220,20,45,"RECORTES CERO-GRUPO VERDE",4
28,"28152",16093,12945,12877,58,68,"RECORTES CERO-GRUPO VERDE",16
44,"44114",243,178,173,0,5,"RECORTES CERO-GRUPO VERDE",0
32,"32030",999,736,726,3,10,"RECORTES CERO-GRUPO VERDE",0
24,"24158",320,207,203,2,4,"RECORTES CERO-GRUPO VERDE",0
37,"37253",135,109,109,2,0,"RECORTES CERO-GRUPO VERDE",0
9,"9400",317,247,245,1,2,"RECORTES CERO-GRUPO VERDE",1
24,"24057",1373,1045,1023,11,22,"RECORTES CERO-GRUPO VERDE",4
36,"36056",5076,3584,3515,30,69,"RECORTES CERO-GRUPO VERDE",2
3,"3116",1155,877,875,6,2,"RECORTES CERO-GRUPO VERDE",0
19,"19136",18,14,14,0,0,"RECORTES CERO-GRUPO VERDE",0
29,"29060",692,510,508,1,2,"RECORTES CERO-GRUPO VERDE",0
40,"40172",39,34,34,0,0,"RECORTES CERO-GRUPO VERDE",0
47,"47146",255,206,204,1,2,"RECORTES CERO-GRUPO VERDE",1
5,"5237",162,130,124,2,6,"RECORTES CERO-GRUPO VERDE",0
50,"50135",91,70,70,3,0,"RECORTES CERO-GRUPO VERDE",0
40,"40044",145,114,113,2,1,"RECORTES CERO-GRUPO VERDE",0
19,"19015",84,69,68,0,1,"RECORTES CERO-GRUPO VERDE",0
23,"23057",766,625,619,4,6,"RECORTES CERO-GRUPO VERDE",1
13,"13013",7068,5147,5063,25,84,"RECORTES CERO-GRUPO VERDE",5
49,"49085",996,684,680,2,4,"RECORTES CERO-GRUPO VERDE",0
5,"5238",782,565,563,5,2,"RECORTES CERO-GRUPO VERDE",1
44,"44217",29,25,25,3,0,"RECORTES CERO-GRUPO VERDE",0
11,"11001",4358,2816,2767,11,49,"RECORTES CERO-GRUPO VERDE",3
19,"19249",32,29,29,0,0,"RECORTES CERO-GRUPO VERDE",0
24,"24160",684,483,474,6,9,"RECORTES CERO-GRUPO VERDE",0
6,"6106",423,274,272,5,2,"RECORTES CERO-GRUPO VERDE",0
30,"30043",24967,18981,18685,101,296,"RECORTES CERO-GRUPO VERDE",30
39,"39045",367,271,268,1,3,"RECORTES CERO-GRUPO VERDE",0
31,"31097",10410,7082,7002,75,80,"RECORTES CERO-GRUPO VERDE",27
9,"9442",375,279,277,2,2,"RECORTES CERO-GRUPO VERDE",0
34,"34901",1104,825,814,5,11,"RECORTES CERO-GRUPO VERDE",2
40,"40046",89,75,75,1,0,"RECORTES CERO-GRUPO VERDE",0
34,"34009",31,29,29,1,0,"RECORTES CERO-GRUPO VERDE",0
45,"45186",3061,2242,2214,11,28,"RECORTES CERO-GRUPO VERDE",2
36,"36059",4882,3137,3085,28,52,"RECORTES CERO-GRUPO VERDE",12
34,"34100",142,108,108,1,0,"RECORTES CERO-GRUPO VERDE",1
45,"45153",1615,1258,1243,7,15,"RECORTES CERO-GRUPO VERDE",2
37,"37172",888,572,566,3,6,"RECORTES CERO-GRUPO VERDE",0
46,"46037",1122,936,923,4,13,"RECORTES CERO-GRUPO VERDE",1
50,"50072",170,125,125,0,0,"RECORTES CERO-GRUPO VERDE",0
39,"39046",1404,1001,973,6,28,"RECORTES CERO-GRUPO VERDE",0
24,"24162",1683,1257,1246,13,11,"RECORTES CERO-GRUPO VERDE",1
8,"8156",10891,7322,7259,43,63,"RECORTES CERO-GRUPO VERDE",23
34,"34010",577,440,438,5,2,"RECORTES CERO-GRUPO VERDE",0
25,"25076",145,81,81,2,0,"RECORTES CERO-GRUPO VERDE",0
36,"36060",30323,21399,21162,164,237,"RECORTES CERO-GRUPO VERDE",50
49,"49088",87,61,60,0,1,"RECORTES CERO-GRUPO VERDE",0
43,"43078",846,543,531,8,12,"RECORTES CERO-GRUPO VERDE",0
31,"31099",62,47,47,2,0,"RECORTES CERO-GRUPO VERDE",0
6,"6109",3919,3139,3012,24,127,"RECORTES CERO-GRUPO VERDE",2
13,"13017",256,200,197,0,3,"RECORTES CERO-GRUPO VERDE",0
5,"5242",681,559,558,8,1,"RECORTES CERO-GRUPO VERDE",0
31,"31100",262,170,168,1,2,"RECORTES CERO-GRUPO VERDE",0
47,"47149",42,34,34,3,0,"RECORTES CERO-GRUPO VERDE",0
45,"45055",1020,821,790,6,31,"RECORTES CERO-GRUPO VERDE",0
9,"9179",41,32,32,1,0,"RECORTES CERO-GRUPO VERDE",0
5,"5243",85,61,60,0,1,"RECORTES CERO-GRUPO VERDE",0
40,"40177",153,125,125,1,0,"RECORTES CERO-GRUPO VERDE",1
47,"47014",51,45,45,0,0,"RECORTES CERO-GRUPO VERDE",0
18,"18011",4335,3037,3015,20,22,"RECORTES CERO-GRUPO VERDE",5
8,"8158",3082,2054,2041,21,13,"RECORTES CERO-GRUPO VERDE",13
5,"5100",278,227,223,1,4,"RECORTES CERO-GRUPO VERDE",0
9,"9445",44,32,32,3,0,"RECORTES CERO-GRUPO VERDE",0
33,"33055",1514,1109,1092,5,17,"RECORTES CERO-GRUPO VERDE",2
42,"42174",174,137,135,5,2,"RECORTES CERO-GRUPO VERDE",1
23,"23062",1454,1141,1128,1,13,"RECORTES CERO-GRUPO VERDE",0
3,"3121",21273,14569,14468,62,101,"RECORTES CERO-GRUPO VERDE",18
46,"46039",2130,1728,1699,8,29,"RECORTES CERO-GRUPO VERDE",1
24,"24063",374,254,252,2,2,"RECORTES CERO-GRUPO VERDE",1
16,"16147",64,45,45,0,0,"RECORTES CERO-GRUPO VERDE",1
41,"41903",6757,4562,4504,51,58,"RECORTES CERO-GRUPO VERDE",11
33,"33056",4997,3269,3244,22,25,"RECORTES CERO-GRUPO VERDE",1
40,"40219",587,455,444,5,11,"RECORTES CERO-GRUPO VERDE",1
38,"38003",1439,969,952,10,17,"RECORTES CERO-GRUPO VERDE",2
18,"18101",9265,6618,6560,59,58,"RECORTES CERO-GRUPO VERDE",15
42,"42175",21,16,16,0,0,"RECORTES CERO-GRUPO VERDE",0
49,"49209",505,342,341,2,1,"RECORTES CERO-GRUPO VERDE",0
45,"45156",3410,2751,2711,13,40,"RECORTES CERO-GRUPO VERDE",3
21,"21049",3361,2049,1984,17,65,"RECORTES CERO-GRUPO VERDE",4
10,"10096",3408,2440,2391,12,49,"RECORTES CERO-GRUPO VERDE",1
44,"44221",372,303,300,1,3,"RECORTES CERO-GRUPO VERDE",0
28,"28158",665,537,533,4,4,"RECORTES CERO-GRUPO VERDE",1
44,"44014",2521,1896,1867,8,29,"RECORTES CERO-GRUPO VERDE",7
22,"22213",3003,2169,2131,19,38,"RECORTES CERO-GRUPO VERDE",0
31,"31202",4305,2845,2803,31,42,"RECORTES CERO-GRUPO VERDE",7
50,"50235",2339,1664,1648,11,16,"RECORTES CERO-GRUPO VERDE",2
5,"5246",59,46,44,0,2,"RECORTES CERO-GRUPO VERDE",0
16,"16102",1205,912,905,12,7,"RECORTES CERO-GRUPO VERDE",0
15,"15068",5049,3185,3129,25,56,"RECORTES CERO-GRUPO VERDE",6
46,"46256",6853,4951,4890,25,61,"RECORTES CERO-GRUPO VERDE",5
40,"40053",83,66,65,0,1,"RECORTES CERO-GRUPO VERDE",1
37,"37263",342,237,229,0,8,"RECORTES CERO-GRUPO VERDE",0
9,"9182",80,69,67,1,2,"RECORTES CERO-GRUPO VERDE",0
40,"40221",49,39,39,0,0,"RECORTES CERO-GRUPO VERDE",0
46,"46197",1942,1527,1514,5,13,"RECORTES CERO-GRUPO VERDE",1
18,"18103",757,579,575,4,4,"RECORTES CERO-GRUPO VERDE",0
19,"19256",43,36,36,0,0,"RECORTES CERO-GRUPO VERDE",0
14,"14042",18891,14051,13848,190,203,"RECORTES CERO-GRUPO VERDE",25
19,"19148",45,32,31,0,1,"RECORTES CERO-GRUPO VERDE",0
44,"44122",1333,925,913,8,12,"RECORTES CERO-GRUPO VERDE",0
13,"13024",898,633,627,3,6,"RECORTES CERO-GRUPO VERDE",0
9,"9183",51,41,41,0,0,"RECORTES CERO-GRUPO VERDE",0
33,"33058",1796,1232,1209,11,23,"RECORTES CERO-GRUPO VERDE",2
5,"5249",105,84,82,0,2,"RECORTES CERO-GRUPO VERDE",0
33,"33059",4646,3075,3033,29,42,"RECORTES CERO-GRUPO VERDE",5
10,"10190",545,406,395,2,11,"RECORTES CERO-GRUPO VERDE",0
26,"26165",358,304,299,2,5,"RECORTES CERO-GRUPO VERDE",0
45,"45159",90,75,75,0,0,"RECORTES CERO-GRUPO VERDE",0
17,"17211",830,581,580,10,1,"RECORTES CERO-GRUPO VERDE",1
19,"19150",128,99,99,1,0,"RECORTES CERO-GRUPO VERDE",0
8,"8123",19140,13557,13484,106,73,"RECORTES CERO-GRUPO VERDE",43
18,"18016",307,235,233,0,2,"RECORTES CERO-GRUPO VERDE",0
45,"45060",173,126,125,1,1,"RECORTES CERO-GRUPO VERDE",1
37,"37265",220,181,181,0,0,"RECORTES CERO-GRUPO VERDE",0
49,"49096",170,131,124,2,7,"RECORTES CERO-GRUPO VERDE",0
22,"22217",385,287,281,1,6,"RECORTES CERO-GRUPO VERDE",0
47,"47153",108,77,77,0,0,"RECORTES CERO-GRUPO VERDE",0
5,"5252",64,45,45,1,0,"RECORTES CERO-GRUPO VERDE",0
19,"19258",90,77,77,0,0,"RECORTES CERO-GRUPO VERDE",0
31,"31205",427,299,297,4,2,"RECORTES CERO-GRUPO VERDE",1
3,"3127",350,278,273,1,5,"RECORTES CERO-GRUPO VERDE",0
44,"44124",77,64,64,3,0,"RECORTES CERO-GRUPO VERDE",0
26,"26130",203,167,167,1,0,"RECORTES CERO-GRUPO VERDE",0
16,"16266",368,264,259,1,5,"RECORTES CERO-GRUPO VERDE",0
41,"41055",14954,10068,9945,64,123,"RECORTES CERO-GRUPO VERDE",5
32,"32045",2443,1715,1690,14,25,"RECORTES CERO-GRUPO VERDE",1
43,"43086",5249,3271,3244,37,27,"RECORTES CERO-GRUPO VERDE",11
50,"50269",285,193,188,0,5,"RECORTES CERO-GRUPO VERDE",0
37,"37007",437,314,306,3,8,"RECORTES CERO-GRUPO VERDE",1
16,"16108",49,45,42,0,3,"RECORTES CERO-GRUPO VERDE",0
46,"46259",491,396,393,4,3,"RECORTES CERO-GRUPO VERDE",3
21,"21055",6975,5293,5241,48,52,"RECORTES CERO-GRUPO VERDE",9
9,"9325",190,130,129,2,1,"RECORTES CERO-GRUPO VERDE",0
9,"9454",43,34,33,0,1,"RECORTES CERO-GRUPO VERDE",0
33,"33061",378,202,200,0,2,"RECORTES CERO-GRUPO VERDE",0
44,"44125",61,44,44,0,0,"RECORTES CERO-GRUPO VERDE",0
40,"40185",863,646,642,3,4,"RECORTES CERO-GRUPO VERDE",1
50,"50019",55,41,41,0,0,"RECORTES CERO-GRUPO VERDE",2
12,"12101",358,279,275,3,4,"RECORTES CERO-GRUPO VERDE",0
47,"47181",165,135,132,3,3,"RECORTES CERO-GRUPO VERDE",0
43,"43007",641,456,455,3,1,"RECORTES CERO-GRUPO VERDE",0
25,"25046",422,279,275,2,4,"RECORTES CERO-GRUPO VERDE",1
25,"25175",186,117,117,1,0,"RECORTES CERO-GRUPO VERDE",0
37,"37009",213,172,171,3,1,"RECORTES CERO-GRUPO VERDE",0
41,"41057",269,183,181,0,2,"RECORTES CERO-GRUPO VERDE",0
5,"5159",252,165,164,0,1,"RECORTES CERO-GRUPO VERDE",0
9,"9060",145,114,113,2,1,"RECORTES CERO-GRUPO VERDE",0
32,"32048",895,574,569,5,5,"RECORTES CERO-GRUPO VERDE",1
33,"33062",400,238,233,2,5,"RECORTES CERO-GRUPO VERDE",0
31,"31108",1855,1368,1348,7,20,"RECORTES CERO-GRUPO VERDE",1
44,"44021",107,89,88,0,1,"RECORTES CERO-GRUPO VERDE",0
31,"31109",1582,1155,1150,9,5,"RECORTES CERO-GRUPO VERDE",6
44,"44052",77,56,56,0,0,"RECORTES CERO-GRUPO VERDE",0
43,"43130",195,127,127,1,0,"RECORTES CERO-GRUPO VERDE",1
9,"9102",36,30,30,0,0,"RECORTES CERO-GRUPO VERDE",0
10,"10013",276,207,200,0,7,"RECORTES CERO-GRUPO VERDE",0
24,"24171",356,197,196,0,1,"RECORTES CERO-GRUPO VERDE",0
46,"46072",3611,2871,2821,23,50,"RECORTES CERO-GRUPO VERDE",1
6,"6123",4627,3182,3120,18,62,"RECORTES CERO-GRUPO VERDE",5
17,"17216",165,110,110,1,0,"RECORTES CERO-GRUPO VERDE",0
42,"42187",62,46,45,1,1,"RECORTES CERO-GRUPO VERDE",0
10,"10106",130,109,108,2,1,"RECORTES CERO-GRUPO VERDE",0
18,"18112",123,82,82,2,0,"RECORTES CERO-GRUPO VERDE",0
11,"11014",16858,10366,10245,153,121,"RECORTES CERO-GRUPO VERDE",22
45,"45164",182,162,160,1,2,"RECORTES CERO-GRUPO VERDE",1
50,"50083",89,75,75,1,0,"RECORTES CERO-GRUPO VERDE",0
46,"46228",2348,1815,1794,7,21,"RECORTES CERO-GRUPO VERDE",5
50,"50210",38,30,30,1,0,"RECORTES CERO-GRUPO VERDE",0
46,"46202",16947,12814,12710,79,104,"RECORTES CERO-GRUPO VERDE",37
47,"47074",149,117,116,2,1,"RECORTES CERO-GRUPO VERDE",0
47,"47157",515,424,423,1,1,"RECORTES CERO-GRUPO VERDE",0
10,"10153",309,222,218,0,4,"RECORTES CERO-GRUPO VERDE",0
43,"43092",7036,4226,4185,39,41,"RECORTES CERO-GRUPO VERDE",9
22,"22223",75,58,58,0,0,"RECORTES CERO-GRUPO VERDE",0
47,"47183",130,106,105,0,1,"RECORTES CERO-GRUPO VERDE",0
40,"40062",60,51,48,0,3,"RECORTES CERO-GRUPO VERDE",0
48,"48006",290,239,239,2,0,"RECORTES CERO-GRUPO VERDE",0
50,"50053",687,513,510,2,3,"RECORTES CERO-GRUPO VERDE",0
26,"26136",107,85,85,0,0,"RECORTES CERO-GRUPO VERDE",1
48,"48007",364,240,240,5,0,"RECORTES CERO-GRUPO VERDE",1
19,"19157",55,46,46,0,0,"RECORTES CERO-GRUPO VERDE",0
45,"45132",2197,1645,1632,14,13,"RECORTES CERO-GRUPO VERDE",1
46,"46177",4690,3579,3526,19,53,"RECORTES CERO-GRUPO VERDE",4
49,"49061",150,114,112,2,2,"RECORTES CERO-GRUPO VERDE",0
25,"25051",1527,931,920,11,11,"RECORTES CERO-GRUPO VERDE",1
47,"47158",889,667,659,8,8,"RECORTES CERO-GRUPO VERDE",1
45,"45166",1617,1305,1286,8,19,"RECORTES CERO-GRUPO VERDE",1
45,"45067",2318,1791,1752,19,39,"RECORTES CERO-GRUPO VERDE",2
26,"26033",170,132,129,1,3,"RECORTES CERO-GRUPO VERDE",0
50,"50150",649,402,397,2,5,"RECORTES CERO-GRUPO VERDE",0
31,"31112",89,62,62,0,0,"RECORTES CERO-GRUPO VERDE",0
24,"24074",97,75,75,1,0,"RECORTES CERO-GRUPO VERDE",0
44,"44130",34,24,24,0,0,"RECORTES CERO-GRUPO VERDE",0
21,"21062",1392,887,879,6,8,"RECORTES CERO-GRUPO VERDE",0
10,"10110",2300,1623,1574,11,49,"RECORTES CERO-GRUPO VERDE",4
25,"25052",1555,1027,1016,14,11,"RECORTES CERO-GRUPO VERDE",1
31,"31113",133,87,86,0,1,"RECORTES CERO-GRUPO VERDE",1
49,"49104",343,234,232,0,2,"RECORTES CERO-GRUPO VERDE",0
8,"8133",128,72,72,0,0,"RECORTES CERO-GRUPO VERDE",1
40,"40192",159,117,117,2,0,"RECORTES CERO-GRUPO VERDE",2
16,"16276",21,16,16,1,0,"RECORTES CERO-GRUPO VERDE",0
10,"10111",1325,970,949,2,21,"RECORTES CERO-GRUPO VERDE",4
5,"5264",61,38,37,2,1,"RECORTES CERO-GRUPO VERDE",1
26,"26139",54,45,44,0,1,"RECORTES CERO-GRUPO VERDE",0
25,"25053",1055,671,661,7,10,"RECORTES CERO-GRUPO VERDE",0
43,"43096",99,81,80,1,1,"RECORTES CERO-GRUPO VERDE",0
21,"21064",6522,4227,4146,48,81,"RECORTES CERO-GRUPO VERDE",12
45,"45202",3894,2776,2744,14,32,"RECORTES CERO-GRUPO VERDE",1
28,"28070",117,91,91,0,0,"RECORTES CERO-GRUPO VERDE",0
43,"43015",112,87,86,0,1,"RECORTES CERO-GRUPO VERDE",0
17,"17027",2821,1896,1889,17,7,"RECORTES CERO-GRUPO VERDE",3
9,"9242",80,66,66,2,0,"RECORTES CERO-GRUPO VERDE",0
28,"28042",1173,890,883,3,7,"RECORTES CERO-GRUPO VERDE",0
41,"41030",514,387,373,3,14,"RECORTES CERO-GRUPO VERDE",0
5,"5120",36,26,26,0,0,"RECORTES CERO-GRUPO VERDE",0
9,"9198",104,83,82,1,1,"RECORTES CERO-GRUPO VERDE",0
48,"48010",458,318,317,0,1,"RECORTES CERO-GRUPO VERDE",0
23,"23079",3717,2825,2801,28,24,"RECORTES CERO-GRUPO VERDE",3
19,"19040",52,41,39,0,2,"RECORTES CERO-GRUPO VERDE",0
46,"46128",1597,1290,1250,5,40,"RECORTES CERO-GRUPO VERDE",0
9,"9066",62,48,47,0,1,"RECORTES CERO-GRUPO VERDE",0
13,"13042",920,652,648,2,4,"RECORTES CERO-GRUPO VERDE",2
8,"8136",11450,7703,7641,84,62,"RECORTES CERO-GRUPO VERDE",21
38,"38018",4402,3058,3011,16,47,"RECORTES CERO-GRUPO VERDE",4
31,"31115",165,102,101,1,1,"RECORTES CERO-GRUPO VERDE",1
16,"16121",258,202,202,3,0,"RECORTES CERO-GRUPO VERDE",0
44,"44133",21,15,15,0,0,"RECORTES CERO-GRUPO VERDE",1
45,"45170",228,176,167,0,9,"RECORTES CERO-GRUPO VERDE",0
40,"40195",885,672,669,1,3,"RECORTES CERO-GRUPO VERDE",1
44,"44028",183,151,150,4,1,"RECORTES CERO-GRUPO VERDE",0
25,"25056",235,143,143,2,0,"RECORTES CERO-GRUPO VERDE",0
46,"46207",6676,5106,5040,41,66,"RECORTES CERO-GRUPO VERDE",10
3,"3042",1393,1010,996,7,14,"RECORTES CERO-GRUPO VERDE",2
46,"46904",792,610,603,8,7,"RECORTES CERO-GRUPO VERDE",1
21,"21067",414,288,287,1,1,"RECORTES CERO-GRUPO VERDE",0
32,"32059",1790,1283,1263,7,20,"RECORTES CERO-GRUPO VERDE",6
45,"45071",1835,1426,1408,5,18,"RECORTES CERO-GRUPO VERDE",3
37,"37019",150,123,120,0,3,"RECORTES CERO-GRUPO VERDE",0
31,"31250",2810,1786,1770,19,16,"RECORTES CERO-GRUPO VERDE",5
40,"40196",30,25,25,0,0,"RECORTES CERO-GRUPO VERDE",0
26,"26142",787,612,606,3,6,"RECORTES CERO-GRUPO VERDE",2
8,"8138",4248,2638,2618,27,20,"RECORTES CERO-GRUPO VERDE",3
28,"28171",4239,2848,2820,19,28,"RECORTES CERO-GRUPO VERDE",5
37,"37020",430,326,321,1,5,"RECORTES CERO-GRUPO VERDE",1
10,"10117",255,135,134,0,1,"RECORTES CERO-GRUPO VERDE",0
3,"3137",651,492,489,5,3,"RECORTES CERO-GRUPO VERDE",0
23,"23082",1921,1425,1416,8,9,"RECORTES CERO-GRUPO VERDE",1
49,"49110",348,231,229,0,2,"RECORTES CERO-GRUPO VERDE",0
50,"50279",86,64,64,0,0,"RECORTES CERO-GRUPO VERDE",0
31,"31184",62,44,44,3,0,"RECORTES CERO-GRUPO VERDE",0
32,"32061",1081,812,809,4,3,"RECORTES CERO-GRUPO VERDE",1
9,"9294",108,86,82,0,4,"RECORTES CERO-GRUPO VERDE",0
35,"35014",11209,6016,5917,42,99,"RECORTES CERO-GRUPO VERDE",17
17,"17227",129,86,85,5,1,"RECORTES CERO-GRUPO VERDE",0
28,"28172",9077,6992,6936,31,56,"RECORTES CERO-GRUPO VERDE",9
8,"8263",20972,13710,13583,149,127,"RECORTES CERO-GRUPO VERDE",41
37,"37156",4292,2996,2966,24,30,"RECORTES CERO-GRUPO VERDE",0
24,"24080",213,164,161,3,3,"RECORTES CERO-GRUPO VERDE",0
5,"5904",127,88,87,1,1,"RECORTES CERO-GRUPO VERDE",0
50,"50156",215,181,178,2,3,"RECORTES CERO-GRUPO VERDE",0
19,"19043",84,72,72,0,0,"RECORTES CERO-GRUPO VERDE",0
10,"10119",620,460,452,1,8,"RECORTES CERO-GRUPO VERDE",0
37,"37282",204,149,148,1,1,"RECORTES CERO-GRUPO VERDE",0
48,"48908",249,181,181,0,0,"RECORTES CERO-GRUPO VERDE",1
9,"9340",77,49,49,0,0,"RECORTES CERO-GRUPO VERDE",0
6,"6136",1565,1131,1102,11,29,"RECORTES CERO-GRUPO VERDE",4
40,"40200",40,31,31,0,0,"RECORTES CERO-GRUPO VERDE",1
17,"17228",288,179,176,1,3,"RECORTES CERO-GRUPO VERDE",0
39,"39065",252,191,189,1,2,"RECORTES CERO-GRUPO VERDE",0
28,"28173",517,390,388,1,2,"RECORTES CERO-GRUPO VERDE",0
50,"50157",290,220,218,3,2,"RECORTES CERO-GRUPO VERDE",0
22,"22150",472,331,330,1,1,"RECORTES CERO-GRUPO VERDE",0
31,"31220",744,583,579,8,4,"RECORTES CERO-GRUPO VERDE",2
9,"9249",46,33,33,0,0,"RECORTES CERO-GRUPO VERDE",0
47,"47029",57,52,52,0,0,"RECORTES CERO-GRUPO VERDE",0
50,"50092",299,233,231,0,2,"RECORTES CERO-GRUPO VERDE",0
21,"21072",10262,7442,7307,85,135,"RECORTES CERO-GRUPO VERDE",16
44,"44138",135,98,94,0,4,"RECORTES CERO-GRUPO VERDE",0
37,"37200",187,136,136,0,0,"RECORTES CERO-GRUPO VERDE",0
46,"46211",1745,1387,1378,8,9,"RECORTES CERO-GRUPO VERDE",1
43,"43145",4096,2795,2760,19,35,"RECORTES CERO-GRUPO VERDE",6
16,"16128",63,50,50,0,0,"RECORTES CERO-GRUPO VERDE",0
6,"6002",4322,2819,2762,22,57,"RECORTES CERO-GRUPO VERDE",3
36,"36011",1799,1144,1122,8,22,"RECORTES CERO-GRUPO VERDE",2
29,"29074",794,586,581,0,5,"RECORTES CERO-GRUPO VERDE",0
28,"28085",3922,2972,2954,14,18,"RECORTES CERO-GRUPO VERDE",7
21,"21073",1862,1125,1109,8,16,"RECORTES CERO-GRUPO VERDE",1
26,"26183",64,49,49,0,0,"RECORTES CERO-GRUPO VERDE",0
10,"10076",832,556,541,1,15,"RECORTES CERO-GRUPO VERDE",0
46,"46159",22857,16840,16697,128,143,"RECORTES CERO-GRUPO VERDE",46
28,"28048",500,391,387,3,4,"RECORTES CERO-GRUPO VERDE",2
34,"34181",448,322,319,7,3,"RECORTES CERO-GRUPO VERDE",2
47,"47005",549,413,408,2,5,"RECORTES CERO-GRUPO VERDE",0
42,"42201",22,22,21,0,1,"RECORTES CERO-GRUPO VERDE",1
44,"44034",139,109,108,0,1,"RECORTES CERO-GRUPO VERDE",0
31,"31222",62,36,34,3,2,"RECORTES CERO-GRUPO VERDE",0
46,"46134",2357,1725,1712,14,13,"RECORTES CERO-GRUPO VERDE",3
50,"50063",61,51,51,0,0,"RECORTES CERO-GRUPO VERDE",0
33,"33075",271,154,153,2,1,"RECORTES CERO-GRUPO VERDE",0
47,"47166",259,204,197,2,7,"RECORTES CERO-GRUPO VERDE",0
31,"31122",4773,3520,3506,26,14,"RECORTES CERO-GRUPO VERDE",17
42,"42202",20,14,13,0,1,"RECORTES CERO-GRUPO VERDE",0
28,"28086",5154,3530,3493,13,37,"RECORTES CERO-GRUPO VERDE",8
47,"47057",268,197,196,0,1,"RECORTES CERO-GRUPO VERDE",0
45,"45010",415,311,310,2,1,"RECORTES CERO-GRUPO VERDE",0
38,"38026",32950,24443,24196,129,247,"RECORTES CERO-GRUPO VERDE",39
45,"45177",2110,1679,1656,3,23,"RECORTES CERO-GRUPO VERDE",1
41,"41093",18554,13978,13874,99,104,"RECORTES CERO-GRUPO VERDE",30
13,"13054",4944,3729,3678,27,51,"RECORTES CERO-GRUPO VERDE",2
8,"8145",2599,1774,1761,11,13,"RECORTES CERO-GRUPO VERDE",1
4,"4094",207,144,144,0,0,"RECORTES CERO-GRUPO VERDE",0
9,"9213",307,220,218,2,2,"RECORTES CERO-GRUPO VERDE",0
22,"22111",154,103,102,0,1,"RECORTES CERO-GRUPO VERDE",0
47,"47085",16612,11829,11706,114,123,"RECORTES CERO-GRUPO VERDE",16
32,"32069",4308,3221,3164,27,57,"RECORTES CERO-GRUPO VERDE",7
42,"42065",21,18,18,0,0,"RECORTES CERO-GRUPO VERDE",0
13,"13056",11362,8288,8198,70,90,"RECORTES CERO-GRUPO VERDE",17
37,"37163",41,34,34,0,0,"RECORTES CERO-GRUPO VERDE",0
17,"17901",987,623,620,9,3,"RECORTES CERO-GRUPO VERDE",0
46,"46214",15766,12131,12036,42,95,"RECORTES CERO-GRUPO VERDE",19
21,"21076",2121,1458,1437,17,21,"RECORTES CERO-GRUPO VERDE",1
23,"23010",14347,9669,9560,86,109,"RECORTES CERO-GRUPO VERDE",5
17,"17079",64395,41049,40699,342,350,"RECORTES CERO-GRUPO VERDE",66
45,"45180",2727,1966,1940,9,26,"RECORTES CERO-GRUPO VERDE",0
40,"40080",59,43,41,0,2,"RECORTES CERO-GRUPO VERDE",0
50,"50163",3689,2702,2680,37,22,"RECORTES CERO-GRUPO VERDE",6
31,"31125",274,194,193,6,1,"RECORTES CERO-GRUPO VERDE",2
50,"50255",209,163,163,5,0,"RECORTES CERO-GRUPO VERDE",0
9,"9215",368,256,256,2,0,"RECORTES CERO-GRUPO VERDE",2
31,"31026",144,118,117,0,1,"RECORTES CERO-GRUPO VERDE",0
19,"19321",39,30,30,1,0,"RECORTES CERO-GRUPO VERDE",0
41,"41007",12341,8039,7844,103,195,"RECORTES CERO-GRUPO VERDE",14
44,"44244",75,47,47,1,0,"RECORTES CERO-GRUPO VERDE",0
50,"50005",229,189,189,1,0,"RECORTES CERO-GRUPO VERDE",0
40,"40207",763,599,593,3,6,"RECORTES CERO-GRUPO VERDE",2
10,"10128",5697,3958,3891,32,67,"RECORTES CERO-GRUPO VERDE",7
26,"26046",1581,1175,1159,4,16,"RECORTES CERO-GRUPO VERDE",5
37,"37290",141,113,113,0,0,"RECORTES CERO-GRUPO VERDE",2
21,"21078",2726,1793,1768,17,25,"RECORTES CERO-GRUPO VERDE",1
22,"22113",495,370,368,4,2,"RECORTES CERO-GRUPO VERDE",1
50,"50164",390,247,246,6,1,"RECORTES CERO-GRUPO VERDE",0
21,"21079",722,494,490,5,4,"RECORTES CERO-GRUPO VERDE",0
6,"6009",204,153,153,0,0,"RECORTES CERO-GRUPO VERDE",0
23,"23094",3839,3009,2954,14,55,"RECORTES CERO-GRUPO VERDE",3
25,"25070",823,554,549,15,5,"RECORTES CERO-GRUPO VERDE",0
10,"10129",365,275,271,0,4,"RECORTES CERO-GRUPO VERDE",1
49,"49120",74,53,52,0,1,"RECORTES CERO-GRUPO VERDE",0
9,"9079",49,45,45,0,0,"RECORTES CERO-GRUPO VERDE",0
25,"25202",104,73,72,0,1,"RECORTES CERO-GRUPO VERDE",0
13,"13060",263,200,194,0,6,"RECORTES CERO-GRUPO VERDE",0
38,"38031",28687,21132,20858,104,274,"RECORTES CERO-GRUPO VERDE",35
44,"44146",174,153,152,2,1,"RECORTES CERO-GRUPO VERDE",0
37,"37292",104,77,77,1,0,"RECORTES CERO-GRUPO VERDE",0
6,"6011",24723,16883,16718,137,165,"RECORTES CERO-GRUPO VERDE",24
23,"23095",8735,6347,6310,14,37,"RECORTES CERO-GRUPO VERDE",4
37,"37168",439,316,311,0,5,"RECORTES CERO-GRUPO VERDE",0
46,"46060",9369,7052,6993,42,59,"RECORTES CERO-GRUPO VERDE",8
43,"43113",393,279,278,5,1,"RECORTES CERO-GRUPO VERDE",1
46,"46242",333,267,266,0,1,"RECORTES CERO-GRUPO VERDE",1
40,"40041",979,725,717,5,8,"RECORTES CERO-GRUPO VERDE",0
13,"13061",5702,3867,3822,28,45,"RECORTES CERO-GRUPO VERDE",7
25,"25071",49,31,31,0,0,"RECORTES CERO-GRUPO VERDE",0
9,"9218",369,275,275,1,0,"RECORTES CERO-GRUPO VERDE",2
31,"31229",47,35,35,0,0,"RECORTES CERO-GRUPO VERDE",0
28,"28180",5251,3927,3893,7,34,"RECORTES CERO-GRUPO VERDE",6
18,"18138",2486,1620,1606,13,14,"RECORTES CERO-GRUPO VERDE",0
16,"16246",482,361,355,3,6,"RECORTES CERO-GRUPO VERDE",0
9,"9083",37,33,33,0,0,"RECORTES CERO-GRUPO VERDE",0
49,"49003",900,612,599,5,13,"RECORTES CERO-GRUPO VERDE",0
42,"42211",82,66,66,1,0,"RECORTES CERO-GRUPO VERDE",0
50,"50167",233,183,178,1,5,"RECORTES CERO-GRUPO VERDE",0
18,"18003",14022,9938,9820,80,118,"RECORTES CERO-GRUPO VERDE",18
42,"42075",83,62,62,0,0,"RECORTES CERO-GRUPO VERDE",0
29,"29083",2107,1540,1512,9,28,"RECORTES CERO-GRUPO VERDE",1
18,"18140",43496,28038,27872,212,166,"RECORTES CERO-GRUPO VERDE",45
12,"12090",102,86,85,1,1,"RECORTES CERO-GRUPO VERDE",0
46,"46061",342,274,272,1,2,"RECORTES CERO-GRUPO VERDE",0
41,"41078",2508,1823,1810,19,13,"RECORTES CERO-GRUPO VERDE",0
49,"49123",546,391,384,1,7,"RECORTES CERO-GRUPO VERDE",1
18,"18004",714,518,509,2,9,"RECORTES CERO-GRUPO VERDE",0
8,"8277",157,108,107,0,1,"RECORTES CERO-GRUPO VERDE",0
50,"50260",33,33,32,0,1,"RECORTES CERO-GRUPO VERDE",0
35,"35023",11686,8212,8076,55,136,"RECORTES CERO-GRUPO VERDE",24
13,"13065",2854,1901,1888,9,13,"RECORTES CERO-GRUPO VERDE",2
17,"17007",1731,1191,1182,7,9,"RECORTES CERO-GRUPO VERDE",0
38,"38034",4049,2855,2807,19,48,"RECORTES CERO-GRUPO VERDE",3
9,"9220",75,56,54,1,2,"RECORTES CERO-GRUPO VERDE",0
13,"13066",2506,1971,1947,11,24,"RECORTES CERO-GRUPO VERDE",1
8,"8154",696,494,488,5,6,"RECORTES CERO-GRUPO VERDE",1
16,"16142",136,101,101,1,0,"RECORTES CERO-GRUPO VERDE",0
18,"18005",372,262,258,0,4,"RECORTES CERO-GRUPO VERDE",0
49,"49125",1391,933,918,10,15,"RECORTES CERO-GRUPO VERDE",1
35,"35024",13735,8545,8439,77,106,"RECORTES CERO-GRUPO VERDE",12
43,"43035",254,156,155,2,1,"RECORTES CERO-GRUPO VERDE",0
18,"18143",973,742,730,5,12,"RECORTES CERO-GRUPO VERDE",1
22,"22165",487,364,360,6,4,"RECORTES CERO-GRUPO VERDE",0
44,"44183",77,50,49,0,1,"RECORTES CERO-GRUPO VERDE",0
8,"8034",763,538,537,1,1,"RECORTES CERO-GRUPO VERDE",0
46,"46219",127,112,112,1,0,"RECORTES CERO-GRUPO VERDE",0
25,"25075",117,72,72,2,0,"RECORTES CERO-GRUPO VERDE",0
9,"9406",251,192,191,2,1,"RECORTES CERO-GRUPO VERDE",0
47,"47091",84,71,71,2,0,"RECORTES CERO-GRUPO VERDE",0
24,"24060",602,363,361,3,2,"RECORTES CERO-GRUPO VERDE",0
23,"23101",378,276,271,1,5,"RECORTES CERO-GRUPO VERDE",0
42,"42079",26,18,18,1,0,"RECORTES CERO-GRUPO VERDE",0
12,"12025",136,104,104,0,0,"RECORTES CERO-GRUPO VERDE",0
2,"2081",18342,13244,13075,80,169,"RECORTES CERO-GRUPO VERDE",14
5,"5046",44,38,38,1,0,"RECORTES CERO-GRUPO VERDE",0
38,"38037",12864,8287,8163,64,124,"RECORTES CERO-GRUPO VERDE",23
5,"5145",50,40,40,0,0,"RECORTES CERO-GRUPO VERDE",0
42,"42216",25,23,23,0,0,"RECORTES CERO-GRUPO VERDE",0
40,"40216",759,574,571,3,3,"RECORTES CERO-GRUPO VERDE",1
37,"37038",788,595,583,4,12,"RECORTES CERO-GRUPO VERDE",1
49,"49249",69,58,58,1,0,"RECORTES CERO-GRUPO VERDE",0
30,"30015",19171,13561,13464,61,97,"RECORTES CERO-GRUPO VERDE",10
22,"22044",252,198,197,0,1,"RECORTES CERO-GRUPO VERDE",0
44,"44151",190,151,148,0,3,"RECORTES CERO-GRUPO VERDE",1
45,"45188",2785,1960,1938,15,22,"RECORTES CERO-GRUPO VERDE",2
8,"8281",4802,3343,3318,17,25,"RECORTES CERO-GRUPO VERDE",5
13,"13070",760,583,574,11,9,"RECORTES CERO-GRUPO VERDE",1
50,"50263",193,121,121,0,0,"RECORTES CERO-GRUPO VERDE",1
36,"36025",2257,1360,1350,10,10,"RECORTES CERO-GRUPO VERDE",1
12,"12124",1840,1387,1381,33,6,"RECORTES CERO-GRUPO VERDE",1
28,"28901",799,558,554,0,4,"RECORTES CERO-GRUPO VERDE",2
28,"28096",18354,13310,13205,68,105,"RECORTES CERO-GRUPO VERDE",26
42,"42217",31,25,24,0,1,"RECORTES CERO-GRUPO VERDE",0
9,"9090",54,48,48,0,0,"RECORTES CERO-GRUPO VERDE",0
31,"31134",176,125,124,0,1,"RECORTES CERO-GRUPO VERDE",0
37,"37040",391,299,297,2,2,"RECORTES CERO-GRUPO VERDE",0
24,"24197",763,538,533,1,5,"RECORTES CERO-GRUPO VERDE",0
26,"26054",320,263,260,4,3,"RECORTES CERO-GRUPO VERDE",0
41,"41083",1147,864,856,4,8,"RECORTES CERO-GRUPO VERDE",0
31,"31903",6654,4402,4343,27,59,"RECORTES CERO-GRUPO VERDE",18
9,"9225",83,55,54,0,1,"RECORTES CERO-GRUPO VERDE",0
28,"28902",471,363,356,4,7,"RECORTES CERO-GRUPO VERDE",0
27,"27020",3524,2816,2761,28,55,"RECORTES CERO-GRUPO VERDE",11
50,"50172",193,132,129,1,3,"RECORTES CERO-GRUPO VERDE",0
26,"26163",136,118,118,0,0,"RECORTES CERO-GRUPO VERDE",0
9,"9226",63,54,54,0,0,"RECORTES CERO-GRUPO VERDE",0
50,"50264",156,115,115,0,0,"RECORTES CERO-GRUPO VERDE",0
50,"50173",182,132,131,1,1,"RECORTES CERO-GRUPO VERDE",0
8,"8160",327,208,208,1,0,"RECORTES CERO-GRUPO VERDE",0
22,"22009",617,444,441,6,3,"RECORTES CERO-GRUPO VERDE",1
22,"22125",38773,27021,26732,258,289,"RECORTES CERO-GRUPO VERDE",57
34,"34017",918,744,736,9,8,"RECORTES CERO-GRUPO VERDE",0
22,"22011",88,71,69,0,2,"RECORTES CERO-GRUPO VERDE",0
23,"23904",2796,1825,1798,8,27,"RECORTES CERO-GRUPO VERDE",1
37,"37044",466,362,360,2,2,"RECORTES CERO-GRUPO VERDE",0
9,"9093",154,121,119,0,2,"RECORTES CERO-GRUPO VERDE",0
44,"44154",256,192,188,3,4,"RECORTES CERO-GRUPO VERDE",0
47,"47095",38,31,31,0,0,"RECORTES CERO-GRUPO VERDE",0
33,"33026",8530,5397,5337,48,60,"RECORTES CERO-GRUPO VERDE",5
19,"19293",1867,1358,1342,7,16,"RECORTES CERO-GRUPO VERDE",8
37,"37178",100,76,75,0,1,"RECORTES CERO-GRUPO VERDE",0
47,"47016",69,56,55,0,1,"RECORTES CERO-GRUPO VERDE",0
34,"34018",209,168,164,1,4,"RECORTES CERO-GRUPO VERDE",1
18,"18056",3530,2641,2614,24,27,"RECORTES CERO-GRUPO VERDE",3
49,"49131",264,194,192,6,2,"RECORTES CERO-GRUPO VERDE",0
17,"17014",64,48,48,1,0,"RECORTES CERO-GRUPO VERDE",0
13,"13076",484,400,394,1,6,"RECORTES CERO-GRUPO VERDE",0
37,"37179",209,180,180,0,0,"RECORTES CERO-GRUPO VERDE",0
37,"37045",26,23,21,0,2,"RECORTES CERO-GRUPO VERDE",0
38,"38042",3802,2652,2625,14,27,"RECORTES CERO-GRUPO VERDE",1
50,"50174",91,69,68,0,1,"RECORTES CERO-GRUPO VERDE",0
24,"24099",171,132,132,0,0,"RECORTES CERO-GRUPO VERDE",0
37,"37305",216,171,170,0,1,"RECORTES CERO-GRUPO VERDE",2
37,"37306",259,186,183,1,3,"RECORTES CERO-GRUPO VERDE",0
22,"22012",111,87,86,3,1,"RECORTES CERO-GRUPO VERDE",0
41,"41020",12887,8210,8118,82,92,"RECORTES CERO-GRUPO VERDE",14
50,"50175",1002,695,688,5,7,"RECORTES CERO-GRUPO VERDE",1
37,"37046",11225,7824,7697,53,127,"RECORTES CERO-GRUPO VERDE",13
26,"26166",141,124,122,0,2,"RECORTES CERO-GRUPO VERDE",0
25,"25086",522,346,341,2,5,"RECORTES CERO-GRUPO VERDE",1
19,"19110",56,50,50,0,0,"RECORTES CERO-GRUPO VERDE",0
45,"45194",68,54,53,0,1,"RECORTES CERO-GRUPO VERDE",0
12,"12099",539,416,403,7,13,"RECORTES CERO-GRUPO VERDE",1
37,"37307",159,104,103,1,1,"RECORTES CERO-GRUPO VERDE",1
46,"46069",162,124,123,0,1,"RECORTES CERO-GRUPO VERDE",0
44,"44192",355,280,278,4,2,"RECORTES CERO-GRUPO VERDE",1
24,"24202",8008,5367,5276,53,91,"RECORTES CERO-GRUPO VERDE",6
31,"31139",159,96,95,0,1,"RECORTES CERO-GRUPO VERDE",0
19,"19297",32,24,24,1,0,"RECORTES CERO-GRUPO VERDE",0
26,"26059",1125,828,812,5,16,"RECORTES CERO-GRUPO VERDE",1
50,"50268",44,37,37,0,0,"RECORTES CERO-GRUPO VERDE",0
40,"40099",52,44,42,0,2,"RECORTES CERO-GRUPO VERDE",0
49,"49014",112,91,91,2,0,"RECORTES CERO-GRUPO VERDE",0
37,"37049",137,96,96,1,0,"RECORTES CERO-GRUPO VERDE",0
5,"5157",232,162,159,1,3,"RECORTES CERO-GRUPO VERDE",0
42,"42087",49,43,42,0,1,"RECORTES CERO-GRUPO VERDE",0
44,"44157",64,48,48,1,0,"RECORTES CERO-GRUPO VERDE",0
41,"41088",509,360,356,0,4,"RECORTES CERO-GRUPO VERDE",0
44,"44263",376,266,263,3,3,"RECORTES CERO-GRUPO VERDE",0
37,"37183",414,306,304,0,2,"RECORTES CERO-GRUPO VERDE",0
45,"45195",2141,1635,1606,7,29,"RECORTES CERO-GRUPO VERDE",0
31,"31140",117,84,84,1,0,"RECORTES CERO-GRUPO VERDE",0
4,"4014",144,117,114,1,3,"RECORTES CERO-GRUPO VERDE",0
40,"40225",1138,883,867,3,16,"RECORTES CERO-GRUPO VERDE",3
19,"19188",51,35,35,0,0,"RECORTES CERO-GRUPO VERDE",0
29,"29094",57554,38071,37696,339,375,"RECORTES CERO-GRUPO VERDE",49
32,"32047",1784,1255,1244,9,11,"RECORTES CERO-GRUPO VERDE",5
6,"6075",465,383,372,0,11,"RECORTES CERO-GRUPO VERDE",0
24,"24136",540,387,383,4,4,"RECORTES CERO-GRUPO VERDE",0
10,"10057",143,117,117,1,0,"RECORTES CERO-GRUPO VERDE",0
6,"6029",1195,855,841,3,14,"RECORTES CERO-GRUPO VERDE",1
25,"25088",96,73,72,0,1,"RECORTES CERO-GRUPO VERDE",0
40,"40228",510,390,382,1,8,"RECORTES CERO-GRUPO VERDE",1
18,"18020",1028,691,686,3,5,"RECORTES CERO-GRUPO VERDE",1
8,"8086",13582,8612,8557,75,55,"RECORTES CERO-GRUPO VERDE",33
28,"28104",14040,11151,11096,57,55,"RECORTES CERO-GRUPO VERDE",18
31,"31242",260,164,163,1,1,"RECORTES CERO-GRUPO VERDE",0
44,"44264",248,191,189,1,2,"RECORTES CERO-GRUPO VERDE",1
22,"22016",601,413,411,6,2,"RECORTES CERO-GRUPO VERDE",2
45,"45197",1906,1455,1430,8,25,"RECORTES CERO-GRUPO VERDE",3
5,"5160",323,256,253,2,3,"RECORTES CERO-GRUPO VERDE",0
27,"27032",3275,2128,2096,22,32,"RECORTES CERO-GRUPO VERDE",1
17,"17061",156,104,103,1,1,"RECORTES CERO-GRUPO VERDE",0
45,"45163",8298,5942,5855,28,87,"RECORTES CERO-GRUPO VERDE",6
37,"37312",258,201,200,2,1,"RECORTES CERO-GRUPO VERDE",0
22,"22133",115,81,80,1,1,"RECORTES CERO-GRUPO VERDE",0
24,"24207",294,241,238,3,3,"RECORTES CERO-GRUPO VERDE",0
45,"45198",1809,1475,1442,7,33,"RECORTES CERO-GRUPO VERDE",0
31,"31143",96,55,54,1,1,"RECORTES CERO-GRUPO VERDE",0
49,"49177",278,179,177,1,2,"RECORTES CERO-GRUPO VERDE",0
1,"1001",1979,1339,1318,7,21,"RECORTES CERO-GRUPO VERDE",5
26,"26063",124,94,94,2,0,"RECORTES CERO-GRUPO VERDE",0
24,"24006",472,353,347,0,6,"RECORTES CERO-GRUPO VERDE",0
27,"27034",1120,681,672,4,9,"RECORTES CERO-GRUPO VERDE",2
8,"8089",33850,22230,22096,170,134,"RECORTES CERO-GRUPO VERDE",65
44,"44022",493,323,318,7,5,"RECORTES CERO-GRUPO VERDE",1
25,"25093",640,403,395,7,8,"RECORTES CERO-GRUPO VERDE",0
14,"14075",572,448,428,1,20,"RECORTES CERO-GRUPO VERDE",1
42,"42011",18,10,10,1,0,"RECORTES CERO-GRUPO VERDE",0
25,"25177",368,226,226,0,0,"RECORTES CERO-GRUPO VERDE",0
37,"37055",123,98,94,0,4,"RECORTES CERO-GRUPO VERDE",0
6,"6034",171,121,120,4,1,"RECORTES CERO-GRUPO VERDE",0
39,"39027",3118,2322,2295,26,27,"RECORTES CERO-GRUPO VERDE",5
22,"22018",327,245,244,3,1,"RECORTES CERO-GRUPO VERDE",0
29,"29009",1468,1069,1045,8,24,"RECORTES CERO-GRUPO VERDE",0
45,"45199",2940,1848,1805,14,43,"RECORTES CERO-GRUPO VERDE",6
47,"47101",1710,1357,1336,16,21,"RECORTES CERO-GRUPO VERDE",1
20,"20071",14801,9466,9421,60,45,"RECORTES CERO-GRUPO VERDE",14
43,"43011",1077,743,737,2,6,"RECORTES CERO-GRUPO VERDE",0
49,"49020",289,214,214,2,0,"RECORTES CERO-GRUPO VERDE",1
19,"19156",970,704,699,4,5,"RECORTES CERO-GRUPO VERDE",2
28,"28136",647,528,518,2,10,"RECORTES CERO-GRUPO VERDE",0
34,"34072",152,136,135,2,1,"RECORTES CERO-GRUPO VERDE",0
17,"17024",268,153,152,1,1,"RECORTES CERO-GRUPO VERDE",0
8,"8050",141,99,99,2,0,"RECORTES CERO-GRUPO VERDE",0
36,"36001",2564,1858,1848,5,10,"RECORTES CERO-GRUPO VERDE",2
28,"28040",15811,10118,10009,56,109,"RECORTES CERO-GRUPO VERDE",22
4,"4019",249,196,196,1,0,"RECORTES CERO-GRUPO VERDE",0
40,"40234",397,298,292,2,6,"RECORTES CERO-GRUPO VERDE",2
34,"34031",30,30,29,0,1,"RECORTES CERO-GRUPO VERDE",0
47,"47132",45,36,33,1,3,"RECORTES CERO-GRUPO VERDE",0
49,"49265",128,91,91,1,0,"RECORTES CERO-GRUPO VERDE",0
13,"13090",1094,843,828,4,15,"RECORTES CERO-GRUPO VERDE",0
6,"6036",5075,3575,3535,35,40,"RECORTES CERO-GRUPO VERDE",2
8,"8174",392,283,279,3,4,"RECORTES CERO-GRUPO VERDE",0
47,"47185",99,73,71,0,2,"RECORTES CERO-GRUPO VERDE",0
5,"5016",6335,4670,4586,41,84,"RECORTES CERO-GRUPO VERDE",6
46,"46075",150,130,123,1,7,"RECORTES CERO-GRUPO VERDE",0
50,"50213",94,75,74,0,1,"RECORTES CERO-GRUPO VERDE",0
50,"50183",331,246,246,3,0,"RECORTES CERO-GRUPO VERDE",0
12,"12006",172,135,133,0,2,"RECORTES CERO-GRUPO VERDE",0
8,"8298",26471,16674,16591,139,83,"RECORTES CERO-GRUPO VERDE",20
29,"29901",43826,29318,29107,250,211,"RECORTES CERO-GRUPO VERDE",49
10,"10157",263,204,201,0,3,"RECORTES CERO-GRUPO VERDE",0
50,"50086",187,132,128,2,4,"RECORTES CERO-GRUPO VERDE",1
34,"34032",40,33,33,1,0,"RECORTES CERO-GRUPO VERDE",0
33,"33037",34454,22881,22586,243,295,"RECORTES CERO-GRUPO VERDE",40
37,"37192",356,231,227,2,4,"RECORTES CERO-GRUPO VERDE",0
9,"9026",386,301,300,0,1,"RECORTES CERO-GRUPO VERDE",1
16,"16218",191,150,150,3,0,"RECORTES CERO-GRUPO VERDE",0
1,"1047",968,673,668,5,5,"RECORTES CERO-GRUPO VERDE",1
46,"46102",19788,15154,15038,89,116,"RECORTES CERO-GRUPO VERDE",29
46,"46050",194,150,149,0,1,"RECORTES CERO-GRUPO VERDE",0
23,"23040",1480,1199,1192,2,7,"RECORTES CERO-GRUPO VERDE",0
48,"48040",1281,877,869,3,8,"RECORTES CERO-GRUPO VERDE",0
2,"2060",1294,997,983,2,14,"RECORTES CERO-GRUPO VERDE",1
28,"28043",5921,3803,3759,18,44,"RECORTES CERO-GRUPO VERDE",4
45,"45002",2564,1681,1665,17,16,"RECORTES CERO-GRUPO VERDE",2
31,"31148",92,69,69,5,0,"RECORTES CERO-GRUPO VERDE",0
24,"24010",8386,5708,5632,60,76,"RECORTES CERO-GRUPO VERDE",10
3,"3071",3982,3048,3012,26,36,"RECORTES CERO-GRUPO VERDE",2
46,"46154",808,636,631,5,5,"RECORTES CERO-GRUPO VERDE",1
5,"5169",226,187,185,1,2,"RECORTES CERO-GRUPO VERDE",0
40,"40111",58,49,49,0,0,"RECORTES CERO-GRUPO VERDE",0
10,"10022",427,349,341,0,8,"RECORTES CERO-GRUPO VERDE",0
49,"49269",229,165,162,1,3,"RECORTES CERO-GRUPO VERDE",1
9,"9289",1451,1014,1000,5,14,"RECORTES CERO-GRUPO VERDE",2
49,"49147",263,190,186,0,4,"RECORTES CERO-GRUPO VERDE",0
29,"29014",217,141,140,4,1,"RECORTES CERO-GRUPO VERDE",0
44,"44168",189,139,138,2,1,"RECORTES CERO-GRUPO VERDE",0
17,"17149",364,248,248,0,0,"RECORTES CERO-GRUPO VERDE",0
5,"5022",1588,1238,1222,5,16,"RECORTES CERO-GRUPO VERDE",1
25,"25230",1558,1008,993,13,15,"RECORTES CERO-GRUPO VERDE",0
43,"43017",124,101,101,1,0,"RECORTES CERO-GRUPO VERDE",0
18,"18030",576,413,409,6,4,"RECORTES CERO-GRUPO VERDE",0
50,"50186",42,31,31,0,0,"RECORTES CERO-GRUPO VERDE",0
34,"34176",133,102,101,0,1,"RECORTES CERO-GRUPO VERDE",0
45,"45137",1604,1032,1024,4,8,"RECORTES CERO-GRUPO VERDE",0
14,"14053",6006,4285,4232,49,53,"RECORTES CERO-GRUPO VERDE",1
46,"46208",1112,887,881,4,6,"RECORTES CERO-GRUPO VERDE",1
47,"47188",111,88,88,3,0,"RECORTES CERO-GRUPO VERDE",0
9,"9114",86,66,66,0,0,"RECORTES CERO-GRUPO VERDE",0
31,"31251",3115,2240,2205,15,35,"RECORTES CERO-GRUPO VERDE",5
29,"29015",31880,22220,21952,190,268,"RECORTES CERO-GRUPO VERDE",30
43,"43019",1381,862,846,12,16,"RECORTES CERO-GRUPO VERDE",0
25,"25232",1397,874,871,12,3,"RECORTES CERO-GRUPO VERDE",1
45,"45105",392,301,297,3,4,"RECORTES CERO-GRUPO VERDE",1
37,"37240",945,623,619,5,4,"RECORTES CERO-GRUPO VERDE",0
40,"40072",211,162,159,1,3,"RECORTES CERO-GRUPO VERDE",0
10,"10070",718,546,542,1,4,"RECORTES CERO-GRUPO VERDE",3
34,"34081",61,53,52,0,1,"RECORTES CERO-GRUPO VERDE",0
31,"31052",96,62,61,0,1,"RECORTES CERO-GRUPO VERDE",0
9,"9247",24,21,21,1,0,"RECORTES CERO-GRUPO VERDE",0
8,"8303",274,193,192,2,1,"RECORTES CERO-GRUPO VERDE",0
49,"49272",88,70,69,1,1,"RECORTES CERO-GRUPO VERDE",0
37,"37324",360,276,275,2,1,"RECORTES CERO-GRUPO VERDE",0
12,"12111",360,305,299,3,6,"RECORTES CERO-GRUPO VERDE",0
40,"40115",101,86,85,1,1,"RECORTES CERO-GRUPO VERDE",0
47,"47109",179,138,138,2,0,"RECORTES CERO-GRUPO VERDE",0
27,"27049",1409,921,909,7,12,"RECORTES CERO-GRUPO VERDE",0
25,"25104",130,76,74,1,2,"RECORTES CERO-GRUPO VERDE",0
39,"39004",1518,1090,1074,4,16,"RECORTES CERO-GRUPO VERDE",1
6,"6045",506,379,374,3,5,"RECORTES CERO-GRUPO VERDE",0
9,"9115",92,68,67,0,1,"RECORTES CERO-GRUPO VERDE",0
18,"18034",505,366,364,1,2,"RECORTES CERO-GRUPO VERDE",0
31,"31152",1328,924,900,11,24,"RECORTES CERO-GRUPO VERDE",6
24,"24217",135,109,108,1,1,"RECORTES CERO-GRUPO VERDE",0
36,"36009",4503,3056,3001,15,55,"RECORTES CERO-GRUPO VERDE",13
31,"31053",523,372,368,1,4,"RECORTES CERO-GRUPO VERDE",1
17,"17073",1873,1363,1356,15,7,"RECORTES CERO-GRUPO VERDE",2
31,"31153",2159,1403,1387,12,16,"RECORTES CERO-GRUPO VERDE",5
8,"8101",174621,113632,112942,847,690,"RECORTES CERO-GRUPO VERDE",500
1,"1054",960,654,651,4,3,"RECORTES CERO-GRUPO VERDE",1
27,"27051",8108,5503,5424,62,79,"RECORTES CERO-GRUPO VERDE",14
18,"18035",1232,992,988,6,4,"RECORTES CERO-GRUPO VERDE",0
12,"12112",99,79,78,3,1,"RECORTES CERO-GRUPO VERDE",0
36,"36047",2454,1633,1621,13,12,"RECORTES CERO-GRUPO VERDE",0
17,"17153",188,133,133,0,0,"RECORTES CERO-GRUPO VERDE",1
42,"42157",13,10,10,0,0,"RECORTES CERO-GRUPO VERDE",0
8,"8102",28296,18466,18367,172,99,"RECORTES CERO-GRUPO VERDE",33
17,"17154",92,67,66,0,1,"RECORTES CERO-GRUPO VERDE",0
25,"25149",1385,963,956,6,7,"RECORTES CERO-GRUPO VERDE",1
25,"25238",204,140,138,4,2,"RECORTES CERO-GRUPO VERDE",0
50,"50190",695,523,515,3,8,"RECORTES CERO-GRUPO VERDE",0
50,"50093",92,66,66,1,0,"RECORTES CERO-GRUPO VERDE",0
10,"10213",566,469,463,0,6,"RECORTES CERO-GRUPO VERDE",1
42,"42200",81,59,58,2,1,"RECORTES CERO-GRUPO VERDE",0
34,"34086",103,89,88,0,1,"RECORTES CERO-GRUPO VERDE",0
6,"6094",1485,929,926,2,3,"RECORTES CERO-GRUPO VERDE",0
47,"47004",1181,939,930,7,9,"RECORTES CERO-GRUPO VERDE",0
37,"37160",615,434,429,8,5,"RECORTES CERO-GRUPO VERDE",0
50,"50282",69,54,54,0,0,"RECORTES CERO-GRUPO VERDE",0
37,"37071",78,65,64,0,1,"RECORTES CERO-GRUPO VERDE",1
25,"25110",2766,1628,1602,22,26,"RECORTES CERO-GRUPO VERDE",3
27,"27001",2370,1281,1256,13,25,"RECORTES CERO-GRUPO VERDE",1
8,"8187",152377,102805,102199,805,606,"RECORTES CERO-GRUPO VERDE",303
42,"42111",303,229,227,2,2,"RECORTES CERO-GRUPO VERDE",0
19,"19203",30,24,24,0,0,"RECORTES CERO-GRUPO VERDE",0
20,"20901",1437,908,906,2,2,"RECORTES CERO-GRUPO VERDE",2
44,"44067",114,81,81,1,0,"RECORTES CERO-GRUPO VERDE",0
47,"47112",2587,2015,1988,7,27,"RECORTES CERO-GRUPO VERDE",1
33,"33014",9037,5999,5938,53,61,"RECORTES CERO-GRUPO VERDE",10
45,"45043",793,657,649,1,8,"RECORTES CERO-GRUPO VERDE",0
36,"36013",2344,1536,1514,11,22,"RECORTES CERO-GRUPO VERDE",1
8,"8269",2673,1788,1776,14,12,"RECORTES CERO-GRUPO VERDE",1
18,"18132",3291,2524,2494,9,30,"RECORTES CERO-GRUPO VERDE",4
18,"18085",720,507,499,3,8,"RECORTES CERO-GRUPO VERDE",0
25,"25152",140,86,86,1,0,"RECORTES CERO-GRUPO VERDE",0
22,"22035",234,165,159,3,6,"RECORTES CERO-GRUPO VERDE",0
39,"39008",13877,10258,10153,96,105,"RECORTES CERO-GRUPO VERDE",13
8,"8188",115,78,78,0,0,"RECORTES CERO-GRUPO VERDE",0
16,"16177",78,64,64,0,0,"RECORTES CERO-GRUPO VERDE",1
37,"37073",586,448,438,2,10,"RECORTES CERO-GRUPO VERDE",0
30,"30006",803,691,685,2,6,"RECORTES CERO-GRUPO VERDE",0
25,"25153",192,130,128,2,2,"RECORTES CERO-GRUPO VERDE",0
47,"47032",152,117,116,1,1,"RECORTES CERO-GRUPO VERDE",0
28,"28118",57,46,45,0,1,"RECORTES CERO-GRUPO VERDE",0
30,"30007",6411,4360,4329,24,31,"RECORTES CERO-GRUPO VERDE",7
24,"24020",456,314,307,4,7,"RECORTES CERO-GRUPO VERDE",0
50,"50223",920,712,701,4,11,"RECORTES CERO-GRUPO VERDE",0
40,"40079",234,179,179,3,0,"RECORTES CERO-GRUPO VERDE",1
30,"30037",18793,13150,13003,47,147,"RECORTES CERO-GRUPO VERDE",25
18,"18040",231,136,133,0,3,"RECORTES CERO-GRUPO VERDE",0
29,"29023",2081,1354,1340,4,14,"RECORTES CERO-GRUPO VERDE",1
41,"41095",41232,27076,26793,315,283,"RECORTES CERO-GRUPO VERDE",65
24,"24119",706,488,481,3,7,"RECORTES CERO-GRUPO VERDE",1
4,"4031",2338,1772,1762,2,10,"RECORTES CERO-GRUPO VERDE",0
10,"10173",577,400,399,5,1,"RECORTES CERO-GRUPO VERDE",0
45,"45146",107,84,83,0,1,"RECORTES CERO-GRUPO VERDE",0
24,"24155",471,388,384,6,4,"RECORTES CERO-GRUPO VERDE",0
28,"28120",1223,892,884,2,8,"RECORTES CERO-GRUPO VERDE",0
49,"49080",685,520,514,2,6,"RECORTES CERO-GRUPO VERDE",0
37,"37077",261,226,223,1,3,"RECORTES CERO-GRUPO VERDE",0
25,"25114",98,72,72,0,0,"RECORTES CERO-GRUPO VERDE",0
46,"46241",392,299,291,1,8,"RECORTES CERO-GRUPO VERDE",1
6,"6054",5446,3920,3833,32,87,"RECORTES CERO-GRUPO VERDE",8
34,"34048",73,59,59,1,0,"RECORTES CERO-GRUPO VERDE",0
19,"19210",21,19,18,1,1,"RECORTES CERO-GRUPO VERDE",0
47,"47195",459,345,344,4,1,"RECORTES CERO-GRUPO VERDE",0
50,"50286",77,50,50,3,0,"RECORTES CERO-GRUPO VERDE",0
24,"24022",330,230,229,0,1,"RECORTES CERO-GRUPO VERDE",3
29,"29080",6676,4469,4419,35,50,"RECORTES CERO-GRUPO VERDE",7
44,"44071",591,398,398,5,0,"RECORTES CERO-GRUPO VERDE",2
9,"9306",106,82,82,1,0,"RECORTES CERO-GRUPO VERDE",0
17,"17041",218,130,129,2,1,"RECORTES CERO-GRUPO VERDE",1
49,"49159",271,209,205,4,4,"RECORTES CERO-GRUPO VERDE",0
30,"30009",12433,9586,9503,41,83,"RECORTES CERO-GRUPO VERDE",11
24,"24225",1014,752,739,10,13,"RECORTES CERO-GRUPO VERDE",1
5,"5185",95,82,81,0,1,"RECORTES CERO-GRUPO VERDE",0
43,"43030",427,288,283,1,5,"RECORTES CERO-GRUPO VERDE",0
33,"33018",2901,2000,1976,18,24,"RECORTES CERO-GRUPO VERDE",4
45,"45015",606,437,433,2,4,"RECORTES CERO-GRUPO VERDE",3
50,"50099",3083,2148,2132,13,16,"RECORTES CERO-GRUPO VERDE",0
49,"49038",99,71,65,1,6,"RECORTES CERO-GRUPO VERDE",0
5,"5234",49,44,44,2,0,"RECORTES CERO-GRUPO VERDE",0
31,"31194",311,217,216,3,1,"RECORTES CERO-GRUPO VERDE",0
19,"19135",107,90,90,3,0,"RECORTES CERO-GRUPO VERDE",0
6,"6102",1048,843,825,6,18,"RECORTES CERO-GRUPO VERDE",1
22,"22040",144,117,115,1,2,"RECORTES CERO-GRUPO VERDE",1
47,"47197",876,673,668,8,5,"RECORTES CERO-GRUPO VERDE",0
10,"10177",1707,1228,1201,5,27,"RECORTES CERO-GRUPO VERDE",0
28,"28054",11257,8349,8273,55,76,"RECORTES CERO-GRUPO VERDE",11
43,"43072",105,74,72,0,2,"RECORTES CERO-GRUPO VERDE",0
9,"9308",67,42,42,1,0,"RECORTES CERO-GRUPO VERDE",0
31,"31029",914,638,625,6,13,"RECORTES CERO-GRUPO VERDE",1
24,"24226",199,139,137,0,2,"RECORTES CERO-GRUPO VERDE",0
50,"50134",128,91,89,2,2,"RECORTES CERO-GRUPO VERDE",0
45,"45016",4204,3146,3105,22,41,"RECORTES CERO-GRUPO VERDE",6
42,"42166",59,45,45,0,0,"RECORTES CERO-GRUPO VERDE",0
29,"29027",2326,1626,1609,12,17,"RECORTES CERO-GRUPO VERDE",0
9,"9261",469,332,329,2,3,"RECORTES CERO-GRUPO VERDE",0
49,"49162",186,142,140,1,2,"RECORTES CERO-GRUPO VERDE",0
47,"47198",69,50,50,0,0,"RECORTES CERO-GRUPO VERDE",0
44,"44076",2203,1690,1663,18,27,"RECORTES CERO-GRUPO VERDE",1
17,"17043",161,122,117,1,5,"RECORTES CERO-GRUPO VERDE",0
50,"50101",864,603,597,8,6,"RECORTES CERO-GRUPO VERDE",0
49,"49203",313,240,232,0,8,"RECORTES CERO-GRUPO VERDE",0
17,"17164",3982,2363,2350,11,13,"RECORTES CERO-GRUPO VERDE",0
30,"30012",9091,6962,6897,36,65,"RECORTES CERO-GRUPO VERDE",6
43,"43033",765,531,530,4,1,"RECORTES CERO-GRUPO VERDE",2
44,"44077",74,60,58,0,2,"RECORTES CERO-GRUPO VERDE",0
8,"8073",61814,42275,42025,294,250,"RECORTES CERO-GRUPO VERDE",138
44,"44182",197,157,157,0,0,"RECORTES CERO-GRUPO VERDE",2
47,"47199",80,63,63,0,0,"RECORTES CERO-GRUPO VERDE",0
6,"6060",5786,4146,4071,24,75,"RECORTES CERO-GRUPO VERDE",4
22,"22164",35,28,28,0,0,"RECORTES CERO-GRUPO VERDE",0
18,"18047",5903,3893,3857,28,36,"RECORTES CERO-GRUPO VERDE",11
27,"27014",3254,2103,2067,21,36,"RECORTES CERO-GRUPO VERDE",3
24,"24026",1177,864,849,7,15,"RECORTES CERO-GRUPO VERDE",2
41,"41101",5928,4209,4173,18,36,"RECORTES CERO-GRUPO VERDE",1
46,"46251",2462,1997,1956,6,41,"RECORTES CERO-GRUPO VERDE",5
8,"8114",18292,12102,12009,72,93,"RECORTES CERO-GRUPO VERDE",31
10,"10181",686,533,523,1,10,"RECORTES CERO-GRUPO VERDE",0
33,"33052",721,485,482,3,3,"RECORTES CERO-GRUPO VERDE",2
17,"17086",1729,1068,1059,8,9,"RECORTES CERO-GRUPO VERDE",3
37,"37214",129,93,91,0,2,"RECORTES CERO-GRUPO VERDE",0
49,"49165",59,51,51,0,0,"RECORTES CERO-GRUPO VERDE",0
24,"24027",1211,863,847,8,16,"RECORTES CERO-GRUPO VERDE",0
49,"49205",382,293,291,2,2,"RECORTES CERO-GRUPO VERDE",1
50,"50137",1011,772,764,8,8,"RECORTES CERO-GRUPO VERDE",0
37,"37037",117,84,82,0,2,"RECORTES CERO-GRUPO VERDE",0
8,"8004",223,165,164,2,1,"RECORTES CERO-GRUPO VERDE",0
37,"37257",52,46,46,0,0,"RECORTES CERO-GRUPO VERDE",0
47,"47148",442,342,338,2,4,"RECORTES CERO-GRUPO VERDE",0
44,"44011",52,40,38,0,2,"RECORTES CERO-GRUPO VERDE",0
49,"49126",235,155,154,2,1,"RECORTES CERO-GRUPO VERDE",1
22,"22167",493,388,381,9,7,"RECORTES CERO-GRUPO VERDE",0
49,"49043",289,217,213,1,4,"RECORTES CERO-GRUPO VERDE",0
34,"34056",1998,1452,1444,13,8,"RECORTES CERO-GRUPO VERDE",2
27,"27017",1003,674,670,4,4,"RECORTES CERO-GRUPO VERDE",1
49,"49166",1227,946,933,6,13,"RECORTES CERO-GRUPO VERDE",2
46,"46246",1058,835,823,5,12,"RECORTES CERO-GRUPO VERDE",0
32,"32036",1345,971,953,14,18,"RECORTES CERO-GRUPO VERDE",2
42,"42173",29281,20286,20035,261,251,"RECORTES CERO-GRUPO VERDE",41
46,"46012",896,682,663,1,19,"RECORTES CERO-GRUPO VERDE",0
41,"41902",4659,2679,2646,23,33,"RECORTES CERO-GRUPO VERDE",1
40,"40007",78,63,61,0,2,"RECORTES CERO-GRUPO VERDE",0
10,"10046",203,168,168,1,0,"RECORTES CERO-GRUPO VERDE",1
42,"42127",38,31,31,1,0,"RECORTES CERO-GRUPO VERDE",0
48,"48088",136,102,102,0,0,"RECORTES CERO-GRUPO VERDE",0
19,"19059",77,61,58,1,3,"RECORTES CERO-GRUPO VERDE",0
47,"47212",380,323,322,2,1,"RECORTES CERO-GRUPO VERDE",0
13,"13071",39454,26316,26107,183,209,"RECORTES CERO-GRUPO VERDE",53
34,"34205",61,50,50,0,0,"RECORTES CERO-GRUPO VERDE",0
43,"43039",99,66,66,0,0,"RECORTES CERO-GRUPO VERDE",0
34,"34058",189,172,172,2,0,"RECORTES CERO-GRUPO VERDE",1
46,"46013",17383,13569,13483,82,86,"RECORTES CERO-GRUPO VERDE",22
10,"10048",233,168,168,0,0,"RECORTES CERO-GRUPO VERDE",0
22,"22046",728,566,561,5,5,"RECORTES CERO-GRUPO VERDE",1
44,"44187",201,152,149,4,3,"RECORTES CERO-GRUPO VERDE",0
11,"11038",13737,10181,10034,99,147,"RECORTES CERO-GRUPO VERDE",14
37,"37089",67,56,56,0,0,"RECORTES CERO-GRUPO VERDE",0
43,"43121",599,354,348,1,6,"RECORTES CERO-GRUPO VERDE",0
14,"14022",4006,2977,2949,17,28,"RECORTES CERO-GRUPO VERDE",1
24,"24902",347,270,269,2,1,"RECORTES CERO-GRUPO VERDE",0
21,"21008",2658,1660,1636,10,24,"RECORTES CERO-GRUPO VERDE",1
24,"24164",370,218,217,0,1,"RECORTES CERO-GRUPO VERDE",0
18,"18193",14343,9951,9847,93,104,"RECORTES CERO-GRUPO VERDE",17
22,"22172",556,372,370,6,2,"RECORTES CERO-GRUPO VERDE",1
34,"34208",51,42,42,0,0,"RECORTES CERO-GRUPO VERDE",0
8,"8203",2390,1466,1456,8,10,"RECORTES CERO-GRUPO VERDE",5
27,"27022",4833,3022,2954,30,68,"RECORTES CERO-GRUPO VERDE",4
46,"46014",3030,2383,2350,20,33,"RECORTES CERO-GRUPO VERDE",1
43,"43041",216,152,151,0,1,"RECORTES CERO-GRUPO VERDE",0
42,"42001",278,212,210,3,2,"RECORTES CERO-GRUPO VERDE",0
8,"8080",34,26,26,3,0,"RECORTES CERO-GRUPO VERDE",0
50,"50140",166,115,115,0,0,"RECORTES CERO-GRUPO VERDE",0
37,"37042",44,28,27,0,1,"RECORTES CERO-GRUPO VERDE",0
24,"24165",354,240,238,2,2,"RECORTES CERO-GRUPO VERDE",0
20,"20030",21423,13960,13898,101,62,"RECORTES CERO-GRUPO VERDE",44
45,"45124",2140,1677,1641,10,36,"RECORTES CERO-GRUPO VERDE",0
19,"19108",111,97,96,0,1,"RECORTES CERO-GRUPO VERDE",1
9,"9014",195,115,114,1,1,"RECORTES CERO-GRUPO VERDE",0
1,"1033",651,484,479,2,5,"RECORTES CERO-GRUPO VERDE",1
28,"28159",589,468,468,5,0,"RECORTES CERO-GRUPO VERDE",0
46,"46249",9288,6746,6676,56,70,"RECORTES CERO-GRUPO VERDE",8
16,"16199",30,25,25,1,0,"RECORTES CERO-GRUPO VERDE",0
19,"19109",39,32,32,0,0,"RECORTES CERO-GRUPO VERDE",0
9,"9137",174,132,131,3,1,"RECORTES CERO-GRUPO VERDE",0
31,"31905",2843,1983,1966,15,17,"RECORTES CERO-GRUPO VERDE",9
15,"15031",23348,16380,16235,191,145,"RECORTES CERO-GRUPO VERDE",31
10,"10189",2630,1880,1851,4,29,"RECORTES CERO-GRUPO VERDE",2
22,"22049",78,64,64,0,0,"RECORTES CERO-GRUPO VERDE",0
6,"6070",7743,5438,5317,39,121,"RECORTES CERO-GRUPO VERDE",9
37,"37096",214,166,163,2,3,"RECORTES CERO-GRUPO VERDE",0
29,"29035",1567,1157,1144,11,13,"RECORTES CERO-GRUPO VERDE",1
43,"43125",933,680,677,14,3,"RECORTES CERO-GRUPO VERDE",4
31,"31005",301,212,211,3,1,"RECORTES CERO-GRUPO VERDE",1
9,"9017",89,68,67,4,1,"RECORTES CERO-GRUPO VERDE",0
36,"36030",4175,2832,2785,27,47,"RECORTES CERO-GRUPO VERDE",4
48,"48062",302,237,236,4,1,"RECORTES CERO-GRUPO VERDE",1
9,"9412",790,528,523,4,5,"RECORTES CERO-GRUPO VERDE",0
14,"14043",7574,5515,5443,81,72,"RECORTES CERO-GRUPO VERDE",2
32,"32044",876,643,634,2,9,"RECORTES CERO-GRUPO VERDE",2
44,"44088",29,21,21,0,0,"RECORTES CERO-GRUPO VERDE",0
50,"50017",1773,1276,1269,13,7,"RECORTES CERO-GRUPO VERDE",5
45,"45193",613,504,497,1,7,"RECORTES CERO-GRUPO VERDE",0
38,"38043",18892,13089,12928,87,161,"RECORTES CERO-GRUPO VERDE",42
43,"43167",375,277,275,9,2,"RECORTES CERO-GRUPO VERDE",0
18,"18061",1057,812,804,1,8,"RECORTES CERO-GRUPO VERDE",0
50,"50206",460,363,357,4,6,"RECORTES CERO-GRUPO VERDE",0
45,"45127",696,514,511,3,3,"RECORTES CERO-GRUPO VERDE",2
46,"46173",1328,1069,1057,4,12,"RECORTES CERO-GRUPO VERDE",0
22,"22050",88,77,77,0,0,"RECORTES CERO-GRUPO VERDE",0
6,"6073",733,496,484,8,12,"RECORTES CERO-GRUPO VERDE",0
5,"5204",603,456,451,1,5,"RECORTES CERO-GRUPO VERDE",0
19,"19111",155,126,126,1,0,"RECORTES CERO-GRUPO VERDE",0
41,"41054",692,560,546,3,14,"RECORTES CERO-GRUPO VERDE",0
3,"3063",26462,18591,18492,91,99,"RECORTES CERO-GRUPO VERDE",15
43,"43128",907,587,577,5,10,"RECORTES CERO-GRUPO VERDE",0
35,"35005",1048,747,737,8,10,"RECORTES CERO-GRUPO VERDE",0
43,"43046",99,68,65,1,3,"RECORTES CERO-GRUPO VERDE",0
6,"6074",4791,3513,3449,18,64,"RECORTES CERO-GRUPO VERDE",7
31,"31074",387,286,286,5,0,"RECORTES CERO-GRUPO VERDE",0
16,"16061",969,771,764,14,7,"RECORTES CERO-GRUPO VERDE",2
37,"37100",80,61,61,1,0,"RECORTES CERO-GRUPO VERDE",0
25,"25132",136,88,87,0,1,"RECORTES CERO-GRUPO VERDE",0
17,"17058",177,101,100,3,1,"RECORTES CERO-GRUPO VERDE",0
24,"24003",648,460,453,7,7,"RECORTES CERO-GRUPO VERDE",0
46,"46226",41,36,35,0,1,"RECORTES CERO-GRUPO VERDE",0
9,"9020",259,196,188,5,8,"RECORTES CERO-GRUPO VERDE",0
31,"31241",133,98,98,2,0,"RECORTES CERO-GRUPO VERDE",0
25,"25220",1015,634,632,1,2,"RECORTES CERO-GRUPO VERDE",1
46,"46097",963,733,728,4,5,"RECORTES CERO-GRUPO VERDE",4
42,"42048",66,51,51,0,0,"RECORTES CERO-GRUPO VERDE",0
43,"43170",868,566,562,5,4,"RECORTES CERO-GRUPO VERDE",0
44,"44227",74,63,62,0,1,"RECORTES CERO-GRUPO VERDE",0
49,"49222",380,279,272,0,7,"RECORTES CERO-GRUPO VERDE",0
37,"37101",160,128,125,0,3,"RECORTES CERO-GRUPO VERDE",1
9,"9276",382,251,240,3,11,"RECORTES CERO-GRUPO VERDE",3
10,"10196",301,225,225,1,0,"RECORTES CERO-GRUPO VERDE",0
14,"14018",3709,2697,2653,26,44,"RECORTES CERO-GRUPO VERDE",3
50,"50209",2601,1731,1721,13,10,"RECORTES CERO-GRUPO VERDE",6
47,"47182",1323,977,967,8,10,"RECORTES CERO-GRUPO VERDE",0
26,"26029",37,32,32,0,0,"RECORTES CERO-GRUPO VERDE",0
17,"17098",301,192,188,2,4,"RECORTES CERO-GRUPO VERDE",1
49,"49262",392,279,274,1,5,"RECORTES CERO-GRUPO VERDE",1
42,"42049",116,81,81,1,0,"RECORTES CERO-GRUPO VERDE",0
42,"42185",26,22,22,0,0,"RECORTES CERO-GRUPO VERDE",0
39,"39025",8637,6486,6378,47,108,"RECORTES CERO-GRUPO VERDE",9
18,"18907",1843,1393,1388,4,5,"RECORTES CERO-GRUPO VERDE",1
33,"33033",9873,6512,6431,68,81,"RECORTES CERO-GRUPO VERDE",7
50,"50241",588,415,410,4,5,"RECORTES CERO-GRUPO VERDE",2
47,"47211",47,35,34,0,1,"RECORTES CERO-GRUPO VERDE",0
9,"9279",174,131,130,3,1,"RECORTES CERO-GRUPO VERDE",1
1,"1042",904,653,648,6,5,"RECORTES CERO-GRUPO VERDE",2
34,"34116",62,49,49,0,0,"RECORTES CERO-GRUPO VERDE",0
46,"46124",787,653,642,4,11,"RECORTES CERO-GRUPO VERDE",1
5,"5012",133,105,102,0,3,"RECORTES CERO-GRUPO VERDE",1
3,"3006",497,384,380,1,4,"RECORTES CERO-GRUPO VERDE",1
22,"22066",702,502,498,7,4,"RECORTES CERO-GRUPO VERDE",1
8,"8169",47759,32651,32439,243,212,"RECORTES CERO-GRUPO VERDE",117
19,"19314",51,36,36,0,0,"RECORTES CERO-GRUPO VERDE",0
25,"25136",95,64,64,1,0,"RECORTES CERO-GRUPO VERDE",0
27,"27035",187,122,121,1,1,"RECORTES CERO-GRUPO VERDE",0
46,"46073",1092,888,884,6,4,"RECORTES CERO-GRUPO VERDE",1
11,"11015",62476,38177,37875,488,302,"RECORTES CERO-GRUPO VERDE",68
31,"31210",196,152,152,2,0,"RECORTES CERO-GRUPO VERDE",2
3,"3099",42319,31083,30801,165,282,"RECORTES CERO-GRUPO VERDE",28
27,"27037",1065,750,740,11,10,"RECORTES CERO-GRUPO VERDE",1
43,"43052",938,628,621,12,7,"RECORTES CERO-GRUPO VERDE",0
3,"3110",291,241,241,1,0,"RECORTES CERO-GRUPO VERDE",0
22,"22182",250,161,158,1,3,"RECORTES CERO-GRUPO VERDE",0
33,"33034",10612,6602,6536,62,66,"RECORTES CERO-GRUPO VERDE",12
44,"44197",56,36,36,0,0,"RECORTES CERO-GRUPO VERDE",0
29,"29042",14016,9368,9192,88,176,"RECORTES CERO-GRUPO VERDE",9
13,"13036",799,601,595,2,6,"RECORTES CERO-GRUPO VERDE",5
32,"32007",1517,1046,1028,8,18,"RECORTES CERO-GRUPO VERDE",0
48,"48068",1550,1130,1118,12,12,"RECORTES CERO-GRUPO VERDE",0
16,"16215",242,172,169,2,3,"RECORTES CERO-GRUPO VERDE",0
18,"18910",788,541,536,3,5,"RECORTES CERO-GRUPO VERDE",0
8,"8256",650,484,484,5,0,"RECORTES CERO-GRUPO VERDE",0
36,"36050",7561,5280,5188,25,92,"RECORTES CERO-GRUPO VERDE",13
19,"19230",505,360,357,3,3,"RECORTES CERO-GRUPO VERDE",1
9,"9281",145,114,109,1,5,"RECORTES CERO-GRUPO VERDE",0
3,"3008",168,130,129,0,1,"RECORTES CERO-GRUPO VERDE",0
46,"46178",4637,3405,3381,27,24,"RECORTES CERO-GRUPO VERDE",8
42,"42015",30,20,19,1,1,"RECORTES CERO-GRUPO VERDE",0
5,"5067",83,68,67,0,1,"RECORTES CERO-GRUPO VERDE",0
24,"24076",1277,956,947,4,9,"RECORTES CERO-GRUPO VERDE",1
8,"8093",27,21,21,0,0,"RECORTES CERO-GRUPO VERDE",0
30,"30027",48176,35521,35266,153,255,"RECORTES CERO-GRUPO VERDE",60
45,"45134",1581,1204,1192,6,12,"RECORTES CERO-GRUPO VERDE",1
49,"49063",338,272,266,4,6,"RECORTES CERO-GRUPO VERDE",0
40,"40065",493,373,373,3,0,"RECORTES CERO-GRUPO VERDE",0
41,"41029",13445,9507,9416,78,91,"RECORTES CERO-GRUPO VERDE",20
6,"6083",46149,31049,30739,234,310,"RECORTES CERO-GRUPO VERDE",63
40,"40193",229,174,172,3,2,"RECORTES CERO-GRUPO VERDE",0
26,"26103",796,616,610,6,6,"RECORTES CERO-GRUPO VERDE",3
40,"40901",384,309,307,4,2,"RECORTES CERO-GRUPO VERDE",0
5,"5018",29,22,22,0,0,"RECORTES CERO-GRUPO VERDE",0
5,"5168",3560,2589,2561,19,28,"RECORTES CERO-GRUPO VERDE",3
39,"39091",1926,1493,1476,10,17,"RECORTES CERO-GRUPO VERDE",3
50,"50276",125,104,103,2,1,"RECORTES CERO-GRUPO VERDE",0
31,"31114",366,245,241,8,4,"RECORTES CERO-GRUPO VERDE",0
43,"43178",1350,856,844,5,12,"RECORTES CERO-GRUPO VERDE",0
30,"30029",11864,8125,8058,73,67,"RECORTES CERO-GRUPO VERDE",7
47,"47051",335,268,263,2,5,"RECORTES CERO-GRUPO VERDE",0
40,"40025",136,117,115,0,2,"RECORTES CERO-GRUPO VERDE",0
37,"37236",135,105,103,1,2,"RECORTES CERO-GRUPO VERDE",0
37,"37277",75,58,58,0,0,"RECORTES CERO-GRUPO VERDE",0
10,"10205",2020,1319,1293,5,26,"RECORTES CERO-GRUPO VERDE",5
9,"9288",90,70,70,0,0,"RECORTES CERO-GRUPO VERDE",0
34,"34227",77,61,61,2,0,"RECORTES CERO-GRUPO VERDE",0
18,"18072",667,424,420,0,4,"RECORTES CERO-GRUPO VERDE",0
43,"43057",38,25,25,1,0,"RECORTES CERO-GRUPO VERDE",0
22,"22060",1164,858,850,3,8,"RECORTES CERO-GRUPO VERDE",0
24,"24078",380,289,277,0,12,"RECORTES CERO-GRUPO VERDE",0
42,"42152",78,55,55,0,0,"RECORTES CERO-GRUPO VERDE",0
27,"27044",2879,1705,1662,27,43,"RECORTES CERO-GRUPO VERDE",5
47,"47216",115,91,87,0,4,"RECORTES CERO-GRUPO VERDE",0
16,"16224",83,66,65,1,1,"RECORTES CERO-GRUPO VERDE",0
22,"22061",6630,4555,4526,40,29,"RECORTES CERO-GRUPO VERDE",7
17,"17069",374,256,251,0,5,"RECORTES CERO-GRUPO VERDE",0
27,"27045",1038,613,603,10,10,"RECORTES CERO-GRUPO VERDE",0
45,"45037",1603,1122,1111,5,11,"RECORTES CERO-GRUPO VERDE",1
50,"50122",68,52,52,1,0,"RECORTES CERO-GRUPO VERDE",0
25,"25186",213,124,122,3,2,"RECORTES CERO-GRUPO VERDE",0
5,"5171",74,52,50,1,2,"RECORTES CERO-GRUPO VERDE",0
20,"20077",5213,3614,3591,36,23,"RECORTES CERO-GRUPO VERDE",97
42,"42194",170,118,114,1,4,"RECORTES CERO-GRUPO VERDE",0
34,"34127",93,65,64,1,1,"RECORTES CERO-GRUPO VERDE",1
21,"21027",48,36,35,1,1,"RECORTES CERO-GRUPO VERDE",0
47,"47080",30,22,21,0,1,"RECORTES CERO-GRUPO VERDE",0
40,"40156",322,238,235,1,3,"RECORTES CERO-GRUPO VERDE",0
31,"31084",1940,1293,1274,16,19,"RECORTES CERO-GRUPO VERDE",0
37,"37114",84,70,69,2,1,"RECORTES CERO-GRUPO VERDE",0
37,"37280",78,53,53,0,0,"RECORTES CERO-GRUPO VERDE",0
43,"43141",106,68,67,0,1,"RECORTES CERO-GRUPO VERDE",0
34,"34229",68,57,56,1,1,"RECORTES CERO-GRUPO VERDE",0
32,"32015",874,575,573,4,2,"RECORTES CERO-GRUPO VERDE",0
44,"44103",132,102,102,1,0,"RECORTES CERO-GRUPO VERDE",0
16,"16228",172,137,137,4,0,"RECORTES CERO-GRUPO VERDE",0
3,"3106",583,480,478,2,2,"RECORTES CERO-GRUPO VERDE",0
23,"23044",4816,3663,3569,27,94,"RECORTES CERO-GRUPO VERDE",3
43,"43060",2860,1950,1926,12,24,"RECORTES CERO-GRUPO VERDE",1
4,"4059",1079,723,712,4,11,"RECORTES CERO-GRUPO VERDE",0
20,"20012",147,99,98,5,1,"RECORTES CERO-GRUPO VERDE",0
28,"28144",6010,4676,4644,22,32,"RECORTES CERO-GRUPO VERDE",5
40,"40199",105,84,84,0,0,"RECORTES CERO-GRUPO VERDE",0
30,"30032",2856,2163,2144,6,19,"RECORTES CERO-GRUPO VERDE",1
50,"50029",626,450,450,3,0,"RECORTES CERO-GRUPO VERDE",0
24,"24150",243,172,172,6,0,"RECORTES CERO-GRUPO VERDE",0
43,"43906",2102,1364,1346,15,18,"RECORTES CERO-GRUPO VERDE",2
48,"48075",1996,1364,1359,6,5,"RECORTES CERO-GRUPO VERDE",1
32,"32017",1244,870,857,6,13,"RECORTES CERO-GRUPO VERDE",2
34,"34231",229,168,167,1,1,"RECORTES CERO-GRUPO VERDE",0
42,"42156",28,16,16,1,0,"RECORTES CERO-GRUPO VERDE",0
37,"37117",1494,1067,1048,3,19,"RECORTES CERO-GRUPO VERDE",3
5,"5078",115,91,89,1,2,"RECORTES CERO-GRUPO VERDE",0
14,"14056",23581,16120,15958,143,162,"RECORTES CERO-GRUPO VERDE",10
4,"4090",304,238,234,0,4,"RECORTES CERO-GRUPO VERDE",0
5,"5127",643,519,514,3,5,"RECORTES CERO-GRUPO VERDE",0
24,"24181",1493,1054,1045,5,9,"RECORTES CERO-GRUPO VERDE",0
13,"13903",524,419,415,3,4,"RECORTES CERO-GRUPO VERDE",0
9,"9034",276,228,227,2,1,"RECORTES CERO-GRUPO VERDE",0
34,"34232",750,578,564,7,14,"RECORTES CERO-GRUPO VERDE",1
46,"46054",11293,8477,8409,47,68,"RECORTES CERO-GRUPO VERDE",20
23,"23047",1629,1258,1250,10,8,"RECORTES CERO-GRUPO VERDE",0
5,"5079",68,53,53,0,0,"RECORTES CERO-GRUPO VERDE",0
2,"2027",315,248,246,2,2,"RECORTES CERO-GRUPO VERDE",0
9,"9298",82,70,69,1,1,"RECORTES CERO-GRUPO VERDE",0
44,"44239",22,20,20,0,0,"RECORTES CERO-GRUPO VERDE",0
18,"18127",16635,11440,11332,91,108,"RECORTES CERO-GRUPO VERDE",29
22,"22197",473,354,354,1,0,"RECORTES CERO-GRUPO VERDE",0
46,"46107",1900,1516,1504,5,12,"RECORTES CERO-GRUPO VERDE",1
34,"34132",114,89,86,0,3,"RECORTES CERO-GRUPO VERDE",0
20,"20015",1265,858,851,7,7,"RECORTES CERO-GRUPO VERDE",0
25,"25037",375,247,246,5,1,"RECORTES CERO-GRUPO VERDE",1
46,"46081",10134,7771,7702,41,69,"RECORTES CERO-GRUPO VERDE",13
31,"31199",146,92,89,3,3,"RECORTES CERO-GRUPO VERDE",0
19,"19089",30,22,22,0,0,"RECORTES CERO-GRUPO VERDE",0
32,"32066",566,418,416,0,2,"RECORTES CERO-GRUPO VERDE",0
28,"28076",398,325,317,1,8,"RECORTES CERO-GRUPO VERDE",0
37,"37245",346,261,259,2,2,"RECORTES CERO-GRUPO VERDE",0
5,"5081",40,36,36,1,0,"RECORTES CERO-GRUPO VERDE",0
34,"34234",71,52,50,0,2,"RECORTES CERO-GRUPO VERDE",0
25,"25151",685,425,419,7,6,"RECORTES CERO-GRUPO VERDE",0
44,"44208",37,22,22,0,0,"RECORTES CERO-GRUPO VERDE",0
39,"39037",1987,1516,1503,8,13,"RECORTES CERO-GRUPO VERDE",2
25,"25038",1545,995,986,17,9,"RECORTES CERO-GRUPO VERDE",1
46,"46108",469,378,375,1,3,"RECORTES CERO-GRUPO VERDE",0
34,"34087",129,103,102,1,1,"RECORTES CERO-GRUPO VERDE",0
5,"5082",529,432,422,1,10,"RECORTES CERO-GRUPO VERDE",0
32,"32068",1415,982,978,5,4,"RECORTES CERO-GRUPO VERDE",2
8,"8006",11470,7210,7132,60,78,"RECORTES CERO-GRUPO VERDE",10
48,"48911",380,276,272,1,4,"RECORTES CERO-GRUPO VERDE",0
44,"44241",533,396,389,0,7,"RECORTES CERO-GRUPO VERDE",0
29,"29076",2153,1390,1360,10,30,"RECORTES CERO-GRUPO VERDE",1
19,"19007",459,341,336,0,5,"RECORTES CERO-GRUPO VERDE",0
49,"49193",467,313,308,4,5,"RECORTES CERO-GRUPO VERDE",2
49,"49239",663,458,448,3,10,"RECORTES CERO-GRUPO VERDE",0
43,"43162",4346,2983,2958,21,25,"RECORTES CERO-GRUPO VERDE",3
47,"47141",134,111,110,0,1,"RECORTES CERO-GRUPO VERDE",0
42,"42027",76,61,60,0,1,"RECORTES CERO-GRUPO VERDE",0
44,"44143",380,307,306,2,1,"RECORTES CERO-GRUPO VERDE",0
43,"43067",552,397,393,2,4,"RECORTES CERO-GRUPO VERDE",0
22,"22201",266,188,187,3,1,"RECORTES CERO-GRUPO VERDE",1
13,"13003",480,382,380,1,2,"RECORTES CERO-GRUPO VERDE",0
27,"27057",11169,7551,7386,79,165,"RECORTES CERO-GRUPO VERDE",21
39,"39070",144,96,94,2,2,"RECORTES CERO-GRUPO VERDE",0
9,"9255",89,63,62,0,1,"RECORTES CERO-GRUPO VERDE",0
31,"31225",36,27,27,0,0,"RECORTES CERO-GRUPO VERDE",0
49,"49079",106,93,92,1,1,"RECORTES CERO-GRUPO VERDE",0
44,"44210",746,554,545,3,9,"RECORTES CERO-GRUPO VERDE",1
42,"42028",75,51,51,0,0,"RECORTES CERO-GRUPO VERDE",0
12,"12052",578,452,435,3,17,"RECORTES CERO-GRUPO VERDE",0
33,"33077",1192,811,808,5,3,"RECORTES CERO-GRUPO VERDE",1
37,"37249",43,29,29,0,0,"RECORTES CERO-GRUPO VERDE",0
35,"35019",32481,19318,19067,123,251,"RECORTES CERO-GRUPO VERDE",51
47,"47114",4045,2787,2762,26,25,"RECORTES CERO-GRUPO VERDE",4
7,"7063",1418,1043,1033,6,10,"RECORTES CERO-GRUPO VERDE",7
38,"38005",5468,3425,3392,18,33,"RECORTES CERO-GRUPO VERDE",5
22,"22072",191,136,135,0,1,"RECORTES CERO-GRUPO VERDE",0
6,"6099",1145,655,638,6,17,"RECORTES CERO-GRUPO VERDE",1
49,"49199",254,193,189,3,4,"RECORTES CERO-GRUPO VERDE",1
34,"34092",288,230,226,1,4,"RECORTES CERO-GRUPO VERDE",0
43,"43069",182,136,134,1,2,"RECORTES CERO-GRUPO VERDE",0
49,"49081",1382,1016,1003,9,13,"RECORTES CERO-GRUPO VERDE",0
10,"10901",1174,752,741,4,11,"RECORTES CERO-GRUPO VERDE",1
45,"45147",581,450,446,1,4,"RECORTES CERO-GRUPO VERDE",0
37,"37375",700,578,570,4,8,"RECORTES CERO-GRUPO VERDE",1
33,"33048",154,95,94,0,1,"RECORTES CERO-GRUPO VERDE",0
44,"44145",1020,719,709,9,10,"RECORTES CERO-GRUPO VERDE",0
50,"50257",171,134,134,2,0,"RECORTES CERO-GRUPO VERDE",0
16,"16244",718,593,587,6,6,"RECORTES CERO-GRUPO VERDE",0
49,"49200",949,720,715,10,5,"RECORTES CERO-GRUPO VERDE",1
3,"3021",5613,4570,4500,26,70,"RECORTES CERO-GRUPO VERDE",2
45,"45148",292,223,223,0,0,"RECORTES CERO-GRUPO VERDE",1
49,"49082",359,304,301,6,3,"RECORTES CERO-GRUPO VERDE",0
50,"50036",104,91,90,0,1,"RECORTES CERO-GRUPO VERDE",0
32,"32028",1610,1211,1189,16,22,"RECORTES CERO-GRUPO VERDE",0
7,"7025",472,355,351,1,4,"RECORTES CERO-GRUPO VERDE",3
25,"25156",783,543,537,7,6,"RECORTES CERO-GRUPO VERDE",1
16,"16245",419,327,323,7,4,"RECORTES CERO-GRUPO VERDE",0
32,"32074",1044,710,704,4,6,"RECORTES CERO-GRUPO VERDE",1
35,"35021",14924,10477,10370,45,107,"RECORTES CERO-GRUPO VERDE",21
12,"12055",104,83,82,3,1,"RECORTES CERO-GRUPO VERDE",1
50,"50133",113,80,80,4,0,"RECORTES CERO-GRUPO VERDE",1
46,"46164",11771,8564,8483,64,81,"RECORTES CERO-GRUPO VERDE",13
39,"39073",9837,7356,7298,31,58,"RECORTES CERO-GRUPO VERDE",10
31,"31095",75,59,59,1,0,"RECORTES CERO-GRUPO VERDE",1
5,"5235",124,111,110,0,1,"RECORTES CERO-GRUPO VERDE",0
43,"43032",517,332,329,5,3,"RECORTES CERO-GRUPO VERDE",0
40,"40083",77,59,59,0,0,"RECORTES CERO-GRUPO VERDE",0
10,"10131",12861,8813,8721,52,92,"RECORTES CERO-GRUPO VERDE",11
50,"50228",268,210,208,5,2,"RECORTES CERO-GRUPO VERDE",2
10,"10903",826,578,569,3,9,"RECORTES CERO-GRUPO VERDE",0
37,"37033",95,68,68,5,0,"RECORTES CERO-GRUPO VERDE",0
47,"47171",407,303,301,6,2,"RECORTES CERO-GRUPO VERDE",1
39,"39043",1481,1122,1115,9,7,"RECORTES CERO-GRUPO VERDE",0
16,"16247",67,58,58,0,0,"RECORTES CERO-GRUPO VERDE",0
46,"46250",578719,442973,440154,2541,2819,"RECORTES CERO-GRUPO VERDE",1056
8,"8001",8907,6316,6269,46,47,"RECORTES CERO-GRUPO VERDE",32
15,"15059",10362,7258,7106,91,152,"RECORTES CERO-GRUPO VERDE",19
24,"24159",1806,1386,1366,6,20,"RECORTES CERO-GRUPO VERDE",1
32,"32031",1069,822,795,4,27,"RECORTES CERO-GRUPO VERDE",1
38,"38033",3702,2505,2464,8,41,"RECORTES CERO-GRUPO VERDE",6
40,"40212",27,23,22,2,1,"RECORTES CERO-GRUPO VERDE",1
44,"44148",90,75,73,2,2,"RECORTES CERO-GRUPO VERDE",0
24,"24191",108,79,79,0,0,"RECORTES CERO-GRUPO VERDE",0
45,"45051",1590,1171,1152,5,19,"RECORTES CERO-GRUPO VERDE",1
37,"37379",174,133,131,1,2,"RECORTES CERO-GRUPO VERDE",0
9,"9310",13,9,8,0,1,"RECORTES CERO-GRUPO VERDE",0
50,"50229",62,47,47,2,0,"RECORTES CERO-GRUPO VERDE",0
49,"49204",63,51,51,0,0,"RECORTES CERO-GRUPO VERDE",0
32,"32033",737,478,476,3,2,"RECORTES CERO-GRUPO VERDE",1
44,"44116",83,60,60,1,0,"RECORTES CERO-GRUPO VERDE",0
15,"15060",5772,4032,3958,46,74,"RECORTES CERO-GRUPO VERDE",8
50,"50230",1165,833,828,8,5,"RECORTES CERO-GRUPO VERDE",0
17,"17008",3639,2191,2171,16,20,"RECORTES CERO-GRUPO VERDE",2
22,"22247",33,20,20,0,0,"RECORTES CERO-GRUPO VERDE",0
50,"50071",132,92,92,0,0,"RECORTES CERO-GRUPO VERDE",0
45,"45152",587,458,451,0,7,"RECORTES CERO-GRUPO VERDE",1
25,"25074",178,132,128,6,4,"RECORTES CERO-GRUPO VERDE",0
50,"50169",351,269,265,0,4,"RECORTES CERO-GRUPO VERDE",0
47,"47173",880,644,638,20,6,"RECORTES CERO-GRUPO VERDE",1
28,"28001",61,46,45,0,1,"RECORTES CERO-GRUPO VERDE",1
26,"26018",10477,8053,7956,65,97,"RECORTES CERO-GRUPO VERDE",8
11,"11035",13593,8375,8276,90,99,"RECORTES CERO-GRUPO VERDE",13
9,"9907",1420,1058,1041,12,17,"RECORTES CERO-GRUPO VERDE",1
15,"15062",5887,3747,3701,36,46,"RECORTES CERO-GRUPO VERDE",13
32,"32035",1442,957,942,3,15,"RECORTES CERO-GRUPO VERDE",2
46,"46063",1756,1367,1345,15,22,"RECORTES CERO-GRUPO VERDE",0
26,"26158",251,214,210,0,4,"RECORTES CERO-GRUPO VERDE",0
24,"24194",290,212,212,3,0,"RECORTES CERO-GRUPO VERDE",0
2,"2054",386,291,290,0,1,"RECORTES CERO-GRUPO VERDE",0
19,"19179",69,56,56,1,0,"RECORTES CERO-GRUPO VERDE",0
16,"16097",156,124,121,0,3,"RECORTES CERO-GRUPO VERDE",0
31,"31022",518,332,331,4,1,"RECORTES CERO-GRUPO VERDE",0
50,"50138",46,37,37,2,0,"RECORTES CERO-GRUPO VERDE",0
26,"26008",1860,1399,1387,5,12,"RECORTES CERO-GRUPO VERDE",0
42,"42036",50,41,41,1,0,"RECORTES CERO-GRUPO VERDE",0
19,"19105",2334,1753,1739,8,14,"RECORTES CERO-GRUPO VERDE",2
46,"46168",1938,1495,1486,2,9,"RECORTES CERO-GRUPO VERDE",0
19,"19251",43,29,28,0,1,"RECORTES CERO-GRUPO VERDE",0
47,"47229",210,148,147,1,1,"RECORTES CERO-GRUPO VERDE",0
24,"24163",3962,2950,2933,24,17,"RECORTES CERO-GRUPO VERDE",4
48,"48087",427,344,338,0,6,"RECORTES CERO-GRUPO VERDE",0
37,"37133",111,78,73,1,5,"RECORTES CERO-GRUPO VERDE",0
28,"28095",1529,1119,1106,6,13,"RECORTES CERO-GRUPO VERDE",1
30,"30025",4908,3667,3630,16,37,"RECORTES CERO-GRUPO VERDE",4
50,"50149",34,24,24,0,0,"RECORTES CERO-GRUPO VERDE",0
40,"40091",119,97,95,1,2,"RECORTES CERO-GRUPO VERDE",0
37,"37134",230,168,165,0,3,"RECORTES CERO-GRUPO VERDE",0
16,"16099",203,153,147,0,6,"RECORTES CERO-GRUPO VERDE",0
23,"23035",1106,873,855,1,18,"RECORTES CERO-GRUPO VERDE",2
29,"29065",187,137,136,0,1,"RECORTES CERO-GRUPO VERDE",0
40,"40049",49,43,43,0,0,"RECORTES CERO-GRUPO VERDE",0
47,"47230",303,246,242,2,4,"RECORTES CERO-GRUPO VERDE",0
46,"46195",1962,1531,1516,11,15,"RECORTES CERO-GRUPO VERDE",2
37,"37218",67,42,41,0,1,"RECORTES CERO-GRUPO VERDE",0
10,"10185",571,409,405,2,4,"RECORTES CERO-GRUPO VERDE",1
31,"31145",172,128,128,4,0,"RECORTES CERO-GRUPO VERDE",0
15,"15078",78198,56154,55581,560,573,"RECORTES CERO-GRUPO VERDE",166
34,"34015",41,35,35,3,0,"RECORTES CERO-GRUPO VERDE",0
9,"9446",12,7,7,0,0,"RECORTES CERO-GRUPO VERDE",0
8,"8283",5963,3670,3642,24,28,"RECORTES CERO-GRUPO VERDE",6
25,"25168",509,354,352,7,2,"RECORTES CERO-GRUPO VERDE",0
46,"46255",3174,2448,2424,22,24,"RECORTES CERO-GRUPO VERDE",7
50,"50234",243,189,185,6,4,"RECORTES CERO-GRUPO VERDE",0
43,"43081",593,400,395,3,5,"RECORTES CERO-GRUPO VERDE",0
17,"17091",407,258,253,5,5,"RECORTES CERO-GRUPO VERDE",1
9,"9447",44,41,41,0,0,"RECORTES CERO-GRUPO VERDE",0
31,"31003",122,87,87,0,0,"RECORTES CERO-GRUPO VERDE",2
20,"20029",4281,2813,2802,19,11,"RECORTES CERO-GRUPO VERDE",2
47,"47177",105,76,73,1,3,"RECORTES CERO-GRUPO VERDE",0
28,"28032",4762,3428,3401,19,27,"RECORTES CERO-GRUPO VERDE",2
38,"38004",4456,3026,2983,23,43,"RECORTES CERO-GRUPO VERDE",9
8,"8161",11144,6994,6938,73,56,"RECORTES CERO-GRUPO VERDE",24
37,"37304",169,124,124,0,0,"RECORTES CERO-GRUPO VERDE",0
44,"44222",131,98,98,0,0,"RECORTES CERO-GRUPO VERDE",0
48,"48090",6001,4345,4295,28,50,"RECORTES CERO-GRUPO VERDE",6
19,"19119",82,72,71,1,1,"RECORTES CERO-GRUPO VERDE",0
40,"40180",299,246,241,1,5,"RECORTES CERO-GRUPO VERDE",0
22,"22253",61,52,52,0,0,"RECORTES CERO-GRUPO VERDE",0
2,"2046",1098,896,878,12,18,"RECORTES CERO-GRUPO VERDE",1
43,"43124",482,308,307,2,1,"RECORTES CERO-GRUPO VERDE",1
46,"46223",7801,5950,5899,34,51,"RECORTES CERO-GRUPO VERDE",7
34,"34107",81,52,51,5,1,"RECORTES CERO-GRUPO VERDE",0
31,"31037",84,66,66,1,0,"RECORTES CERO-GRUPO VERDE",0
4,"4076",1279,960,944,8,16,"RECORTES CERO-GRUPO VERDE",2
37,"37138",203,149,148,2,1,"RECORTES CERO-GRUPO VERDE",0
43,"43084",526,363,361,10,2,"RECORTES CERO-GRUPO VERDE",2
28,"28006",78966,59065,58698,267,367,"RECORTES CERO-GRUPO VERDE",115
50,"50236",102,79,77,0,2,"RECORTES CERO-GRUPO VERDE",0
20,"20031",176,90,90,0,0,"RECORTES CERO-GRUPO VERDE",0
37,"37348",115,96,95,0,1,"RECORTES CERO-GRUPO VERDE",0
28,"28100",4196,2987,2955,14,32,"RECORTES CERO-GRUPO VERDE",7
50,"50078",235,177,173,0,4,"RECORTES CERO-GRUPO VERDE",0
42,"42132",141,114,114,0,0,"RECORTES CERO-GRUPO VERDE",0
11,"11009",605,414,410,1,4,"RECORTES CERO-GRUPO VERDE",0
49,"49216",162,142,142,0,0,"RECORTES CERO-GRUPO VERDE",0
37,"37181",286,210,207,4,3,"RECORTES CERO-GRUPO VERDE",0
43,"43126",1177,782,772,4,10,"RECORTES CERO-GRUPO VERDE",2
38,"38007",1661,1114,1103,6,11,"RECORTES CERO-GRUPO VERDE",2
50,"50143",566,394,391,6,3,"RECORTES CERO-GRUPO VERDE",0
16,"16058",103,77,77,0,0,"RECORTES CERO-GRUPO VERDE",0
40,"40223",216,163,163,1,0,"RECORTES CERO-GRUPO VERDE",0
18,"18015",434,334,333,0,1,"RECORTES CERO-GRUPO VERDE",0
14,"14044",1604,1172,1165,7,7,"RECORTES CERO-GRUPO VERDE",0
43,"43127",743,528,527,2,1,"RECORTES CERO-GRUPO VERDE",2
13,"13027",3415,2380,2354,4,26,"RECORTES CERO-GRUPO VERDE",4
24,"24168",460,361,359,0,2,"RECORTES CERO-GRUPO VERDE",0
46,"46258",2652,2084,2062,16,22,"RECORTES CERO-GRUPO VERDE",2
4,"4078",1078,758,746,8,12,"RECORTES CERO-GRUPO VERDE",0
31,"31006",1927,1350,1332,13,18,"RECORTES CERO-GRUPO VERDE",3
31,"31172",373,278,272,3,6,"RECORTES CERO-GRUPO VERDE",5
16,"16154",4871,3547,3509,24,38,"RECORTES CERO-GRUPO VERDE",5
25,"25189",2110,1198,1186,10,12,"RECORTES CERO-GRUPO VERDE",4
45,"45095",689,513,505,0,8,"RECORTES CERO-GRUPO VERDE",1
44,"44050",3113,2120,2100,25,20,"RECORTES CERO-GRUPO VERDE",9
48,"48003",14339,9918,9838,53,80,"RECORTES CERO-GRUPO VERDE",18
37,"37267",200,156,147,2,9,"RECORTES CERO-GRUPO VERDE",0
8,"8249",266,211,209,2,2,"RECORTES CERO-GRUPO VERDE",0
13,"13029",84,71,71,0,0,"RECORTES CERO-GRUPO VERDE",0
38,"38009",4127,2915,2868,20,47,"RECORTES CERO-GRUPO VERDE",7
46,"46122",2704,2082,2063,10,19,"RECORTES CERO-GRUPO VERDE",1
18,"18108",850,659,656,3,3,"RECORTES CERO-GRUPO VERDE",1
50,"50114",116,89,88,0,1,"RECORTES CERO-GRUPO VERDE",0
36,"36032",3630,2587,2535,16,52,"RECORTES CERO-GRUPO VERDE",4
24,"24036",288,184,184,2,0,"RECORTES CERO-GRUPO VERDE",0
20,"20001",246,133,132,2,1,"RECORTES CERO-GRUPO VERDE",0
38,"38010",4008,2733,2661,19,72,"RECORTES CERO-GRUPO VERDE",4
37,"37351",281,229,227,0,2,"RECORTES CERO-GRUPO VERDE",1
49,"49098",219,167,165,0,2,"RECORTES CERO-GRUPO VERDE",0
35,"35032",3412,2473,2425,17,48,"RECORTES CERO-GRUPO VERDE",3
8,"8168",358,231,231,5,0,"RECORTES CERO-GRUPO VERDE",1
20,"20035",486,337,334,1,3,"RECORTES CERO-GRUPO VERDE",1
21,"21057",1041,661,657,12,4,"RECORTES CERO-GRUPO VERDE",0
45,"45063",417,310,303,1,7,"RECORTES CERO-GRUPO VERDE",0
9,"9191",38,28,27,0,1,"RECORTES CERO-GRUPO VERDE",0
50,"50147",777,552,552,2,0,"RECORTES CERO-GRUPO VERDE",0
46,"46201",64,52,51,1,1,"RECORTES CERO-GRUPO VERDE",0
49,"49137",176,139,138,0,1,"RECORTES CERO-GRUPO VERDE",1
47,"47100",138,117,117,1,0,"RECORTES CERO-GRUPO VERDE",0
17,"17215",2087,1481,1466,7,15,"RECORTES CERO-GRUPO VERDE",3
28,"28038",4952,3730,3688,34,42,"RECORTES CERO-GRUPO VERDE",5
9,"9235",156,132,131,3,1,"RECORTES CERO-GRUPO VERDE",0
37,"37313",550,386,384,2,2,"RECORTES CERO-GRUPO VERDE",0
21,"21058",2609,1883,1856,23,27,"RECORTES CERO-GRUPO VERDE",1
34,"34114",207,144,144,0,0,"RECORTES CERO-GRUPO VERDE",0
35,"35033",6398,4340,4266,19,74,"RECORTES CERO-GRUPO VERDE",17
21,"21059",221,166,163,5,3,"RECORTES CERO-GRUPO VERDE",0
26,"26134",82,68,68,2,0,"RECORTES CERO-GRUPO VERDE",0
37,"37011",121,91,91,3,0,"RECORTES CERO-GRUPO VERDE",0
44,"44033",269,191,190,0,1,"RECORTES CERO-GRUPO VERDE",1
37,"37054",250,195,192,1,3,"RECORTES CERO-GRUPO VERDE",0
34,"34070",154,123,123,2,0,"RECORTES CERO-GRUPO VERDE",0
25,"25208",331,183,182,1,1,"RECORTES CERO-GRUPO VERDE",0
5,"5080",58,45,43,0,2,"RECORTES CERO-GRUPO VERDE",0
37,"37174",1056,820,812,3,8,"RECORTES CERO-GRUPO VERDE",2
46,"46185",378,320,313,2,7,"RECORTES CERO-GRUPO VERDE",0
43,"43064",2015,1310,1296,23,14,"RECORTES CERO-GRUPO VERDE",1
23,"23073",4507,3229,3200,13,29,"RECORTES CERO-GRUPO VERDE",6
15,"15002",23083,16073,15889,159,184,"RECORTES CERO-GRUPO VERDE",50
19,"19302",59,49,49,1,0,"RECORTES CERO-GRUPO VERDE",0
21,"21060",11957,7356,7279,88,77,"RECORTES CERO-GRUPO VERDE",13
13,"13035",984,747,730,7,17,"RECORTES CERO-GRUPO VERDE",0
44,"44128",68,54,54,1,0,"RECORTES CERO-GRUPO VERDE",0
46,"46212",1620,1150,1124,9,26,"RECORTES CERO-GRUPO VERDE",1
17,"17155",14515,8393,8330,65,63,"RECORTES CERO-GRUPO VERDE",25
28,"28108",3374,2482,2465,10,17,"RECORTES CERO-GRUPO VERDE",7
6,"6080",1924,1412,1392,9,20,"RECORTES CERO-GRUPO VERDE",1
37,"37356",87,67,65,0,2,"RECORTES CERO-GRUPO VERDE",0
40,"40122",512,395,394,2,1,"RECORTES CERO-GRUPO VERDE",4
17,"17144",206,141,141,3,0,"RECORTES CERO-GRUPO VERDE",1
28,"28012",887,664,661,2,3,"RECORTES CERO-GRUPO VERDE",0
26,"26032",51,41,39,0,2,"RECORTES CERO-GRUPO VERDE",0
49,"49103",414,330,328,5,2,"RECORTES CERO-GRUPO VERDE",0
48,"48008",606,424,414,6,10,"RECORTES CERO-GRUPO VERDE",0
46,"46263",251,214,212,0,2,"RECORTES CERO-GRUPO VERDE",0
24,"24117",434,334,331,1,3,"RECORTES CERO-GRUPO VERDE",1
31,"31024",99,42,42,0,0,"RECORTES CERO-GRUPO VERDE",1
46,"46126",5556,4449,4405,24,44,"RECORTES CERO-GRUPO VERDE",8
34,"34122",83,60,60,0,0,"RECORTES CERO-GRUPO VERDE",0
41,"41061",2195,1749,1703,11,46,"RECORTES CERO-GRUPO VERDE",0
44,"44025",6009,4087,3997,25,90,"RECORTES CERO-GRUPO VERDE",3
43,"43136",10351,6279,6218,63,61,"RECORTES CERO-GRUPO VERDE",12
50,"50055",3611,2445,2407,22,38,"RECORTES CERO-GRUPO VERDE",6
37,"37317",304,238,234,1,4,"RECORTES CERO-GRUPO VERDE",0
5,"5263",173,129,129,1,0,"RECORTES CERO-GRUPO VERDE",0
18,"18163",324,235,233,2,2,"RECORTES CERO-GRUPO VERDE",0
2,"2018",829,661,653,1,8,"RECORTES CERO-GRUPO VERDE",0
29,"29067",424813,286785,284689,2351,2096,"RECORTES CERO-GRUPO VERDE",747
28,"28110",1944,1478,1463,4,15,"RECORTES CERO-GRUPO VERDE",1
41,"41062",2223,1653,1637,7,16,"RECORTES CERO-GRUPO VERDE",2
13,"13039",14366,10282,10185,81,97,"RECORTES CERO-GRUPO VERDE",19
49,"49267",88,73,69,2,4,"RECORTES CERO-GRUPO VERDE",1
25,"25139",467,294,291,5,3,"RECORTES CERO-GRUPO VERDE",0
9,"9422",17,11,11,0,0,"RECORTES CERO-GRUPO VERDE",0
40,"40151",46,33,33,0,0,"RECORTES CERO-GRUPO VERDE",0
43,"43028",2688,1659,1639,6,20,"RECORTES CERO-GRUPO VERDE",6
20,"20008",716,362,361,6,1,"RECORTES CERO-GRUPO VERDE",0
36,"36040",2575,1709,1680,15,29,"RECORTES CERO-GRUPO VERDE",0
32,"32011",932,619,613,1,6,"RECORTES CERO-GRUPO VERDE",1
16,"16119",169,127,127,0,0,"RECORTES CERO-GRUPO VERDE",0
31,"31214",91,64,62,1,2,"RECORTES CERO-GRUPO VERDE",0
19,"19039",61,54,54,1,0,"RECORTES CERO-GRUPO VERDE",0
46,"46903",6065,4790,4763,18,27,"RECORTES CERO-GRUPO VERDE",6
49,"49107",126,94,93,2,1,"RECORTES CERO-GRUPO VERDE",0
10,"10159",320,251,250,0,1,"RECORTES CERO-GRUPO VERDE",1
6,"6131",1076,843,837,2,6,"RECORTES CERO-GRUPO VERDE",0
44,"44027",164,123,123,1,0,"RECORTES CERO-GRUPO VERDE",0
47,"47161",3918,3145,3126,12,19,"RECORTES CERO-GRUPO VERDE",2
45,"45103",397,331,327,3,4,"RECORTES CERO-GRUPO VERDE",0
46,"46051",8347,6355,6302,24,53,"RECORTES CERO-GRUPO VERDE",8
44,"44235",92,62,60,0,2,"RECORTES CERO-GRUPO VERDE",0
43,"43016",3416,2335,2309,15,26,"RECORTES CERO-GRUPO VERDE",7
21,"21066",498,392,389,3,3,"RECORTES CERO-GRUPO VERDE",4
16,"16279",203,128,127,1,1,"RECORTES CERO-GRUPO VERDE",2
13,"13043",231,180,179,1,1,"RECORTES CERO-GRUPO VERDE",0
15,"15007",3303,2262,2246,15,16,"RECORTES CERO-GRUPO VERDE",4
20,"20043",1739,1090,1088,9,2,"RECORTES CERO-GRUPO VERDE",2
50,"50154",116,96,96,0,0,"RECORTES CERO-GRUPO VERDE",0
46,"46129",524,420,412,4,8,"RECORTES CERO-GRUPO VERDE",0
41,"41065",22779,14769,14636,132,133,"RECORTES CERO-GRUPO VERDE",22
10,"10115",3544,2705,2647,11,58,"RECORTES CERO-GRUPO VERDE",7
45,"45171",1361,1035,1023,0,12,"RECORTES CERO-GRUPO VERDE",0
9,"9113",449,339,332,4,7,"RECORTES CERO-GRUPO VERDE",0
42,"42195",101,62,62,0,0,"RECORTES CERO-GRUPO VERDE",0
37,"37209",412,272,270,7,2,"RECORTES CERO-GRUPO VERDE",0
25,"25057",208,141,140,0,1,"RECORTES CERO-GRUPO VERDE",1
22,"22143",217,143,141,1,2,"RECORTES CERO-GRUPO VERDE",0
12,"12078",325,235,233,0,2,"RECORTES CERO-GRUPO VERDE",1
42,"42103",575,450,445,1,5,"RECORTES CERO-GRUPO VERDE",0
47,"47001",55,46,46,0,0,"RECORTES CERO-GRUPO VERDE",0
8,"8262",6836,4175,4144,50,31,"RECORTES CERO-GRUPO VERDE",6
47,"47089",148,125,124,0,1,"RECORTES CERO-GRUPO VERDE",0
30,"30031",492,409,401,0,8,"RECORTES CERO-GRUPO VERDE",0
29,"29049",2962,2132,2110,5,22,"RECORTES CERO-GRUPO VERDE",2
20,"20011",1658,1219,1210,7,9,"RECORTES CERO-GRUPO VERDE",2
50,"50155",103,80,78,0,2,"RECORTES CERO-GRUPO VERDE",0
40,"40029",35,27,26,0,1,"RECORTES CERO-GRUPO VERDE",0
24,"24046",942,637,633,5,4,"RECORTES CERO-GRUPO VERDE",0
5,"5903",151,104,104,2,0,"RECORTES CERO-GRUPO VERDE",0
6,"6135",1092,846,828,0,18,"RECORTES CERO-GRUPO VERDE",0
42,"42059",21,15,14,0,1,"RECORTES CERO-GRUPO VERDE",0
47,"47163",290,230,228,3,2,"RECORTES CERO-GRUPO VERDE",0
11,"11022",48675,26491,26256,270,235,"RECORTES CERO-GRUPO VERDE",69
47,"47054",635,507,495,9,12,"RECORTES CERO-GRUPO VERDE",0
10,"10118",286,251,249,1,2,"RECORTES CERO-GRUPO VERDE",0
44,"44031",97,62,62,0,0,"RECORTES CERO-GRUPO VERDE",0
18,"18171",2120,1572,1551,9,21,"RECORTES CERO-GRUPO VERDE",2
50,"50091",41,36,36,0,0,"RECORTES CERO-GRUPO VERDE",0
45,"45173",9520,6938,6864,30,74,"RECORTES CERO-GRUPO VERDE",8
20,"20046",1223,739,737,5,2,"RECORTES CERO-GRUPO VERDE",1
14,"14055",18557,12950,12764,178,186,"RECORTES CERO-GRUPO VERDE",17
48,"48014",1211,806,801,7,5,"RECORTES CERO-GRUPO VERDE",0
13,"13048",504,390,387,2,3,"RECORTES CERO-GRUPO VERDE",0
5,"5905",217,165,164,0,1,"RECORTES CERO-GRUPO VERDE",0
43,"43103",880,547,545,4,2,"RECORTES CERO-GRUPO VERDE",0
2,"2066",234,189,187,1,2,"RECORTES CERO-GRUPO VERDE",0
18,"18173",8939,5922,5849,42,73,"RECORTES CERO-GRUPO VERDE",0
43,"43144",1247,842,836,6,6,"RECORTES CERO-GRUPO VERDE",2
28,"28075",5621,4186,4148,26,38,"RECORTES CERO-GRUPO VERDE",3
4,"4027",250,159,159,0,0,"RECORTES CERO-GRUPO VERDE",1
19,"19045",140,120,120,0,0,"RECORTES CERO-GRUPO VERDE",0
49,"49151",619,459,456,2,3,"RECORTES CERO-GRUPO VERDE",1
44,"44065",60,40,40,0,0,"RECORTES CERO-GRUPO VERDE",0
45,"45108",509,412,411,1,1,"RECORTES CERO-GRUPO VERDE",0
47,"47055",203,167,163,0,4,"RECORTES CERO-GRUPO VERDE",0
50,"50251",8262,5946,5872,44,74,"RECORTES CERO-GRUPO VERDE",9
40,"40075",160,139,139,0,0,"RECORTES CERO-GRUPO VERDE",0
10,"10121",7978,5517,5429,35,88,"RECORTES CERO-GRUPO VERDE",9
44,"44043",102,74,72,0,2,"RECORTES CERO-GRUPO VERDE",0
26,"26041",132,92,91,0,1,"RECORTES CERO-GRUPO VERDE",0
16,"16083",52,33,33,0,0,"RECORTES CERO-GRUPO VERDE",0
34,"34218",461,343,339,2,4,"RECORTES CERO-GRUPO VERDE",1
31,"31132",145,109,109,0,0,"RECORTES CERO-GRUPO VERDE",1
50,"50159",665,512,507,2,5,"RECORTES CERO-GRUPO VERDE",0
3,"3057",182,147,147,1,0,"RECORTES CERO-GRUPO VERDE",1
12,"12026",881,678,663,13,15,"RECORTES CERO-GRUPO VERDE",1
47,"47056",87,67,67,0,0,"RECORTES CERO-GRUPO VERDE",0
6,"6140",630,506,499,3,7,"RECORTES CERO-GRUPO VERDE",0
9,"9346",92,64,63,1,1,"RECORTES CERO-GRUPO VERDE",0
17,"17115",282,183,183,1,0,"RECORTES CERO-GRUPO VERDE",0
26,"26148",165,135,133,1,2,"RECORTES CERO-GRUPO VERDE",0
35,"35017",25676,15038,14716,94,322,"RECORTES CERO-GRUPO VERDE",38
40,"40077",842,632,619,3,13,"RECORTES CERO-GRUPO VERDE",4
8,"8077",34508,24070,23956,127,114,"RECORTES CERO-GRUPO VERDE",85
18,"18010",566,427,421,1,6,"RECORTES CERO-GRUPO VERDE",1
31,"31155",256,169,167,2,2,"RECORTES CERO-GRUPO VERDE",2
3,"3017",374,314,307,1,7,"RECORTES CERO-GRUPO VERDE",1
17,"17193",4216,2555,2525,16,30,"RECORTES CERO-GRUPO VERDE",3
31,"31034",37,25,25,0,0,"RECORTES CERO-GRUPO VERDE",0
25,"25077",463,256,253,6,3,"RECORTES CERO-GRUPO VERDE",0
34,"34152",125,96,92,1,4,"RECORTES CERO-GRUPO VERDE",0
46,"46213",15409,10924,10805,97,119,"RECORTES CERO-GRUPO VERDE",25
32,"32023",1210,862,849,4,13,"RECORTES CERO-GRUPO VERDE",1
34,"34134",50,40,40,2,0,"RECORTES CERO-GRUPO VERDE",0
31,"31123",647,369,361,5,8,"RECORTES CERO-GRUPO VERDE",5
45,"45056",2201,1260,1243,12,17,"RECORTES CERO-GRUPO VERDE",3
26,"26021",2827,2098,2076,15,22,"RECORTES CERO-GRUPO VERDE",0
35,"35018",12552,7609,7547,54,62,"RECORTES CERO-GRUPO VERDE",17
40,"40205",261,202,198,2,4,"RECORTES CERO-GRUPO VERDE",1
19,"19048",18,15,15,1,0,"RECORTES CERO-GRUPO VERDE",0
44,"44036",25,21,21,0,0,"RECORTES CERO-GRUPO VERDE",0
50,"50162",146,109,105,4,4,"RECORTES CERO-GRUPO VERDE",0
47,"47006",190,136,135,1,1,"RECORTES CERO-GRUPO VERDE",0
31,"31224",893,671,662,3,9,"RECORTES CERO-GRUPO VERDE",0
25,"25243",3646,2193,2167,33,26,"RECORTES CERO-GRUPO VERDE",8
19,"19008",37,28,27,1,1,"RECORTES CERO-GRUPO VERDE",0
46,"46188",672,544,537,8,7,"RECORTES CERO-GRUPO VERDE",1
14,"14060",4868,3473,3412,41,61,"RECORTES CERO-GRUPO VERDE",4
10,"10126",1548,1120,1102,8,18,"RECORTES CERO-GRUPO VERDE",2
44,"44037",453,317,315,0,2,"RECORTES CERO-GRUPO VERDE",1
26,"26150",112,101,95,0,6,"RECORTES CERO-GRUPO VERDE",0
7,"7022",11545,7385,7306,88,79,"RECORTES CERO-GRUPO VERDE",24
29,"29079",2416,1788,1764,10,24,"RECORTES CERO-GRUPO VERDE",1
47,"47033",196,154,154,1,0,"RECORTES CERO-GRUPO VERDE",0
10,"10081",182,142,135,2,7,"RECORTES CERO-GRUPO VERDE",0
29,"29090",1688,1144,1134,15,10,"RECORTES CERO-GRUPO VERDE",1
49,"49214",698,525,512,3,13,"RECORTES CERO-GRUPO VERDE",2
40,"40165",77,65,64,1,1,"RECORTES CERO-GRUPO VERDE",0
2,"2033",1892,1505,1474,6,31,"RECORTES CERO-GRUPO VERDE",6
2,"2073",4867,3520,3474,40,46,"RECORTES CERO-GRUPO VERDE",4
17,"17002",556,401,396,0,5,"RECORTES CERO-GRUPO VERDE",0
48,"48020",273626,184710,183628,1185,1082,"RECORTES CERO-GRUPO VERDE",366
34,"34137",27,23,22,0,1,"RECORTES CERO-GRUPO VERDE",0
17,"17903",897,568,563,2,5,"RECORTES CERO-GRUPO VERDE",1
37,"37166",214,152,151,2,1,"RECORTES CERO-GRUPO VERDE",0
47,"47169",68,59,59,0,0,"RECORTES CERO-GRUPO VERDE",0
46,"46215",1436,1154,1143,5,11,"RECORTES CERO-GRUPO VERDE",0
32,"32073",1315,973,960,5,13,"RECORTES CERO-GRUPO VERDE",4
19,"19173",45,38,36,0,2,"RECORTES CERO-GRUPO VERDE",0
10,"10083",90,59,59,2,0,"RECORTES CERO-GRUPO VERDE",0
50,"50068",1982,1348,1335,8,13,"RECORTES CERO-GRUPO VERDE",1
31,"31227",8180,5885,5809,76,76,"RECORTES CERO-GRUPO VERDE",17
42,"42070",34,27,26,1,1,"RECORTES CERO-GRUPO VERDE",0
19,"19174",109,80,79,0,1,"RECORTES CERO-GRUPO VERDE",0
11,"11031",76455,49854,49405,535,449,"RECORTES CERO-GRUPO VERDE",155
42,"42208",22,13,13,2,0,"RECORTES CERO-GRUPO VERDE",0
37,"37125",228,161,156,0,5,"RECORTES CERO-GRUPO VERDE",2
19,"19052",25,21,21,1,0,"RECORTES CERO-GRUPO VERDE",0
48,"48021",1336,908,899,1,9,"RECORTES CERO-GRUPO VERDE",1
47,"47035",921,717,715,3,2,"RECORTES CERO-GRUPO VERDE",0
15,"15057",12075,8479,8377,66,102,"RECORTES CERO-GRUPO VERDE",15
42,"42165",409,271,261,10,10,"RECORTES CERO-GRUPO VERDE",0
47,"47224",87,76,76,0,0,"RECORTES CERO-GRUPO VERDE",0
40,"40170",1320,1030,1021,7,9,"RECORTES CERO-GRUPO VERDE",2
37,"37006",138,103,103,2,0,"RECORTES CERO-GRUPO VERDE",1
40,"40001",702,560,554,3,6,"RECORTES CERO-GRUPO VERDE",0
42,"42209",140,107,106,4,1,"RECORTES CERO-GRUPO VERDE",1
47,"47145",603,448,441,3,7,"RECORTES CERO-GRUPO VERDE",0
25,"25032",64,44,44,1,0,"RECORTES CERO-GRUPO VERDE",0
28,"28101",231,187,187,0,0,"RECORTES CERO-GRUPO VERDE",2
16,"16092",158,125,125,1,0,"RECORTES CERO-GRUPO VERDE",0
40,"40015",28,26,26,1,0,"RECORTES CERO-GRUPO VERDE",0
47,"47027",2745,2036,2018,9,18,"RECORTES CERO-GRUPO VERDE",6
18,"18183",658,438,434,3,4,"RECORTES CERO-GRUPO VERDE",0
50,"50069",73,53,53,1,0,"RECORTES CERO-GRUPO VERDE",0
50,"50070",60,36,36,0,0,"RECORTES CERO-GRUPO VERDE",0
37,"37034",85,65,65,0,0,"RECORTES CERO-GRUPO VERDE",0
44,"44041",56,44,44,1,0,"RECORTES CERO-GRUPO VERDE",0
24,"24091",645,454,451,1,3,"RECORTES CERO-GRUPO VERDE",0
50,"50259",88,67,66,0,1,"RECORTES CERO-GRUPO VERDE",0
4,"4004",425,329,329,0,0,"RECORTES CERO-GRUPO VERDE",0
45,"45017",262,204,203,0,1,"RECORTES CERO-GRUPO VERDE",0
42,"42033",48,45,45,1,0,"RECORTES CERO-GRUPO VERDE",0
18,"18184",2168,1629,1607,13,22,"RECORTES CERO-GRUPO VERDE",1
24,"24123",746,488,485,2,3,"RECORTES CERO-GRUPO VERDE",0
16,"16002",187,158,158,1,0,"RECORTES CERO-GRUPO VERDE",1
37,"37035",190,150,150,2,0,"RECORTES CERO-GRUPO VERDE",0
49,"49004",126,100,100,4,0,"RECORTES CERO-GRUPO VERDE",0
45,"45185",7700,5771,5691,20,80,"RECORTES CERO-GRUPO VERDE",5
6,"6151",1070,770,766,3,4,"RECORTES CERO-GRUPO VERDE",0
24,"24092",798,606,602,1,4,"RECORTES CERO-GRUPO VERDE",0
46,"46062",4631,3511,3474,27,37,"RECORTES CERO-GRUPO VERDE",5
29,"29085",144,109,108,0,1,"RECORTES CERO-GRUPO VERDE",1
4,"4005",556,437,431,3,6,"RECORTES CERO-GRUPO VERDE",3
7,"7028",899,601,595,7,6,"RECORTES CERO-GRUPO VERDE",2
29,"29084",27359,17843,17627,176,216,"RECORTES CERO-GRUPO VERDE",19
11,"11034",2334,1549,1517,14,32,"RECORTES CERO-GRUPO VERDE",0
23,"23058",8678,6532,6461,37,71,"RECORTES CERO-GRUPO VERDE",8
7,"7029",4166,2949,2913,37,36,"RECORTES CERO-GRUPO VERDE",2
40,"40131",48,42,42,0,0,"RECORTES CERO-GRUPO VERDE",0
41,"41102",14655,10183,9919,142,264,"RECORTES CERO-GRUPO VERDE",17
45,"45187",4062,3277,3233,15,44,"RECORTES CERO-GRUPO VERDE",1
8,"8279",153025,101133,100621,840,512,"RECORTES CERO-GRUPO VERDE",367
34,"34202",29,18,18,1,0,"RECORTES CERO-GRUPO VERDE",0
5,"5191",121,106,105,1,1,"RECORTES CERO-GRUPO VERDE",0
23,"23099",4769,3359,3309,16,50,"RECORTES CERO-GRUPO VERDE",1
25,"25036",184,112,111,4,1,"RECORTES CERO-GRUPO VERDE",0
42,"42171",127,80,79,0,1,"RECORTES CERO-GRUPO VERDE",0
19,"19250",20,17,17,0,0,"RECORTES CERO-GRUPO VERDE",0
19,"19191",14,13,12,0,1,"RECORTES CERO-GRUPO VERDE",0
18,"18908",801,593,588,3,5,"RECORTES CERO-GRUPO VERDE",0
21,"21005",15523,9038,8913,56,125,"RECORTES CERO-GRUPO VERDE",7
26,"26147",30,28,27,0,1,"RECORTES CERO-GRUPO VERDE",0
9,"9345",123,93,91,2,2,"RECORTES CERO-GRUPO VERDE",0
47,"47039",185,141,140,0,1,"RECORTES CERO-GRUPO VERDE",0
34,"34233",130,107,107,1,0,"RECORTES CERO-GRUPO VERDE",0
18,"18083",247,200,196,0,4,"RECORTES CERO-GRUPO VERDE",0
34,"34101",50,41,41,0,0,"RECORTES CERO-GRUPO VERDE",0
46,"46194",15567,11156,11044,86,112,"RECORTES CERO-GRUPO VERDE",22
18,"18189",776,581,574,4,7,"RECORTES CERO-GRUPO VERDE",2
10,"10138",555,448,446,2,2,"RECORTES CERO-GRUPO VERDE",0
46,"46064",509,412,399,1,13,"RECORTES CERO-GRUPO VERDE",1
22,"22080",280,197,194,6,3,"RECORTES CERO-GRUPO VERDE",1
14,"14067",3889,2946,2899,29,47,"RECORTES CERO-GRUPO VERDE",3
9,"9418",82,62,61,1,1,"RECORTES CERO-GRUPO VERDE",0
45,"45165",62718,44420,44006,236,414,"RECORTES CERO-GRUPO VERDE",79
46,"46229",948,762,758,0,4,"RECORTES CERO-GRUPO VERDE",2
19,"19289",28,25,24,1,1,"RECORTES CERO-GRUPO VERDE",0
40,"40218",92,65,64,1,1,"RECORTES CERO-GRUPO VERDE",0
7,"7045",1295,947,936,5,11,"RECORTES CERO-GRUPO VERDE",5
21,"21020",365,223,222,1,1,"RECORTES CERO-GRUPO VERDE",0
24,"24039",2063,1597,1596,41,1,"RECORTES CERO-GRUPO VERDE",1
46,"46065",1579,1174,1163,8,11,"RECORTES CERO-GRUPO VERDE",0
44,"44152",64,46,45,0,1,"RECORTES CERO-GRUPO VERDE",0
25,"25211",680,386,379,4,7,"RECORTES CERO-GRUPO VERDE",2
16,"16196",633,508,503,2,5,"RECORTES CERO-GRUPO VERDE",1
17,"17025",1134,793,787,6,6,"RECORTES CERO-GRUPO VERDE",1
35,"35009",19905,14185,13961,89,224,"RECORTES CERO-GRUPO VERDE",28
50,"50054",58,50,50,0,0,"RECORTES CERO-GRUPO VERDE",0
9,"9025",122,83,83,1,0,"RECORTES CERO-GRUPO VERDE",0
42,"42082",8,8,8,1,0,"RECORTES CERO-GRUPO VERDE",0
8,"8078",219,112,111,3,1,"RECORTES CERO-GRUPO VERDE",0
29,"29089",3228,2377,2321,10,56,"RECORTES CERO-GRUPO VERDE",0
40,"40093",77,65,65,1,0,"RECORTES CERO-GRUPO VERDE",0
45,"45090",384,294,293,3,1,"RECORTES CERO-GRUPO VERDE",0
44,"44046",49,34,34,1,0,"RECORTES CERO-GRUPO VERDE",0
14,"14069",7524,5460,5392,43,68,"RECORTES CERO-GRUPO VERDE",6
19,"19291",1191,879,869,3,10,"RECORTES CERO-GRUPO VERDE",4
46,"46066",1263,1024,1018,9,6,"RECORTES CERO-GRUPO VERDE",1
9,"9363",965,737,734,2,3,"RECORTES CERO-GRUPO VERDE",1
39,"39019",2079,1560,1531,10,29,"RECORTES CERO-GRUPO VERDE",2
50,"50295",48,43,42,0,1,"RECORTES CERO-GRUPO VERDE",0
47,"47050",3719,2630,2598,26,32,"RECORTES CERO-GRUPO VERDE",9
37,"37360",225,174,173,1,1,"RECORTES CERO-GRUPO VERDE",1
37,"37275",118,70,69,0,1,"RECORTES CERO-GRUPO VERDE",0
9,"9152",257,183,183,0,0,"RECORTES CERO-GRUPO VERDE",0
31,"31059",186,131,131,1,0,"RECORTES CERO-GRUPO VERDE",0
8,"8053",2788,1605,1591,8,14,"RECORTES CERO-GRUPO VERDE",1
5,"5054",1224,935,924,8,11,"RECORTES CERO-GRUPO VERDE",3
47,"47042",54,37,37,0,0,"RECORTES CERO-GRUPO VERDE",0
46,"46093",2118,1647,1624,4,23,"RECORTES CERO-GRUPO VERDE",2
50,"50015",96,67,67,0,0,"RECORTES CERO-GRUPO VERDE",0
47,"47017",201,158,153,1,5,"RECORTES CERO-GRUPO VERDE",0
47,"47206",92,80,80,0,0,"RECORTES CERO-GRUPO VERDE",0
20,"20064",12503,7803,7755,52,48,"RECORTES CERO-GRUPO VERDE",20
44,"44260",137,91,89,3,2,"RECORTES CERO-GRUPO VERDE",0
16,"16151",64,61,59,0,2,"RECORTES CERO-GRUPO VERDE",0
47,"47178",172,140,140,3,0,"RECORTES CERO-GRUPO VERDE",2
49,"49132",316,235,232,1,3,"RECORTES CERO-GRUPO VERDE",0
6,"6024",1172,905,883,4,22,"RECORTES CERO-GRUPO VERDE",0
26,"26128",105,81,81,1,0,"RECORTES CERO-GRUPO VERDE",0
40,"40054",108,90,90,0,0,"RECORTES CERO-GRUPO VERDE",0
34,"34062",171,119,118,2,1,"RECORTES CERO-GRUPO VERDE",1
17,"17093",891,563,560,6,3,"RECORTES CERO-GRUPO VERDE",0
9,"9366",86,62,62,2,0,"RECORTES CERO-GRUPO VERDE",0
6,"6162",2934,2182,2162,14,20,"RECORTES CERO-GRUPO VERDE",2
46,"46094",20540,15378,15234,102,144,"RECORTES CERO-GRUPO VERDE",40
47,"47043",297,239,237,0,2,"RECORTES CERO-GRUPO VERDE",0
22,"22128",188,146,144,3,2,"RECORTES CERO-GRUPO VERDE",0
37,"37047",180,84,84,0,0,"RECORTES CERO-GRUPO VERDE",0
47,"47018",34,28,28,0,0,"RECORTES CERO-GRUPO VERDE",0
46,"46224",159,121,121,0,0,"RECORTES CERO-GRUPO VERDE",0
33,"33009",905,611,609,3,2,"RECORTES CERO-GRUPO VERDE",2
27,"27027",1929,1369,1342,11,27,"RECORTES CERO-GRUPO VERDE",3
31,"31050",6014,3489,3450,57,39,"RECORTES CERO-GRUPO VERDE",9
13,"13079",12244,8582,8450,72,132,"RECORTES CERO-GRUPO VERDE",7
38,"38044",2188,1348,1334,6,14,"RECORTES CERO-GRUPO VERDE",1
17,"17137",3437,2293,2275,19,18,"RECORTES CERO-GRUPO VERDE",7
8,"8043",3201,2056,2041,9,15,"RECORTES CERO-GRUPO VERDE",1
9,"9201",28,18,18,1,0,"RECORTES CERO-GRUPO VERDE",0
20,"20033",868,600,599,1,1,"RECORTES CERO-GRUPO VERDE",1
18,"18168",804,546,543,7,3,"RECORTES CERO-GRUPO VERDE",0
30,"30021",9099,6095,6045,20,50,"RECORTES CERO-GRUPO VERDE",14
19,"19187",48,43,43,0,0,"RECORTES CERO-GRUPO VERDE",0
43,"43005",3626,2157,2138,29,19,"RECORTES CERO-GRUPO VERDE",4
47,"47098",576,464,452,4,12,"RECORTES CERO-GRUPO VERDE",0
47,"47180",73,61,60,4,1,"RECORTES CERO-GRUPO VERDE",1
22,"22051",100,81,81,0,0,"RECORTES CERO-GRUPO VERDE",1
38,"38045",3837,2127,2111,12,16,"RECORTES CERO-GRUPO VERDE",3
26,"26060",84,62,62,2,0,"RECORTES CERO-GRUPO VERDE",0
29,"29095",3321,2376,2307,24,69,"RECORTES CERO-GRUPO VERDE",7
5,"5059",106,82,81,1,1,"RECORTES CERO-GRUPO VERDE",0
44,"44020",24,20,19,1,1,"RECORTES CERO-GRUPO VERDE",0
42,"42183",111,82,82,2,0,"RECORTES CERO-GRUPO VERDE",0
21,"21015",680,398,393,8,5,"RECORTES CERO-GRUPO VERDE",3
36,"36033",12298,8968,8788,53,180,"RECORTES CERO-GRUPO VERDE",25
8,"8167",5910,4081,4051,40,30,"RECORTES CERO-GRUPO VERDE",19
47,"47099",150,135,135,1,0,"RECORTES CERO-GRUPO VERDE",0
37,"37115",123,89,87,0,2,"RECORTES CERO-GRUPO VERDE",0
8,"8127",2225,1349,1334,14,15,"RECORTES CERO-GRUPO VERDE",3
23,"23032",566,450,448,4,2,"RECORTES CERO-GRUPO VERDE",0
18,"18906",905,664,657,3,7,"RECORTES CERO-GRUPO VERDE",0
13,"13083",2423,1693,1653,10,40,"RECORTES CERO-GRUPO VERDE",1
25,"25089",105,60,59,0,1,"RECORTES CERO-GRUPO VERDE",0
33,"33001",1588,887,880,8,7,"RECORTES CERO-GRUPO VERDE",0
5,"5008",227,170,168,1,2,"RECORTES CERO-GRUPO VERDE",0
8,"8292",1072,730,725,6,5,"RECORTES CERO-GRUPO VERDE",1
29,"29007",27491,19071,18910,153,161,"RECORTES CERO-GRUPO VERDE",33
28,"28037",1559,1177,1166,5,11,"RECORTES CERO-GRUPO VERDE",1
47,"47129",871,664,659,4,5,"RECORTES CERO-GRUPO VERDE",0
45,"45029",201,171,171,1,0,"RECORTES CERO-GRUPO VERDE",1
3,"3035",652,547,541,1,6,"RECORTES CERO-GRUPO VERDE",0
26,"26132",112,82,82,0,0,"RECORTES CERO-GRUPO VERDE",0
33,"33002",9995,6765,6672,47,93,"RECORTES CERO-GRUPO VERDE",4
5,"5161",579,459,447,3,12,"RECORTES CERO-GRUPO VERDE",1
45,"45097",1046,839,834,4,5,"RECORTES CERO-GRUPO VERDE",0
6,"6077",341,256,249,0,7,"RECORTES CERO-GRUPO VERDE",2
32,"32004",1798,1029,1023,4,6,"RECORTES CERO-GRUPO VERDE",1
12,"12103",91,69,67,0,2,"RECORTES CERO-GRUPO VERDE",0
37,"37159",90,70,70,1,0,"RECORTES CERO-GRUPO VERDE",0
37,"37328",186,135,131,1,4,"RECORTES CERO-GRUPO VERDE",0
43,"43172",344,211,209,4,2,"RECORTES CERO-GRUPO VERDE",0
9,"9086",666,462,459,2,3,"RECORTES CERO-GRUPO VERDE",1
40,"40132",56,37,36,1,1,"RECORTES CERO-GRUPO VERDE",0
40,"40202",60,46,46,0,0,"RECORTES CERO-GRUPO VERDE",0
17,"17167",2700,1765,1749,37,16,"RECORTES CERO-GRUPO VERDE",1
48,"48057",5723,3988,3962,26,26,"RECORTES CERO-GRUPO VERDE",1
37,"37369",137,95,94,0,1,"RECORTES CERO-GRUPO VERDE",0
44,"44266",115,90,90,0,0,"RECORTES CERO-GRUPO VERDE",0
43,"43051",8512,5418,5366,32,52,"RECORTES CERO-GRUPO VERDE",10
45,"45176",3706,2554,2521,22,33,"RECORTES CERO-GRUPO VERDE",10
31,"31011",693,459,456,8,3,"RECORTES CERO-GRUPO VERDE",3
49,"49264",578,383,377,5,6,"RECORTES CERO-GRUPO VERDE",0
50,"50181",993,733,720,5,13,"RECORTES CERO-GRUPO VERDE",1
18,"18037",535,402,396,2,6,"RECORTES CERO-GRUPO VERDE",2
49,"49033",714,508,505,1,3,"RECORTES CERO-GRUPO VERDE",2
17,"17076",124,86,84,3,2,"RECORTES CERO-GRUPO VERDE",1
37,"37357",262,205,203,1,2,"RECORTES CERO-GRUPO VERDE",0
37,"37232",390,341,339,1,2,"RECORTES CERO-GRUPO VERDE",0
16,"16146",83,57,57,0,0,"RECORTES CERO-GRUPO VERDE",0
42,"42025",1189,844,833,2,11,"RECORTES CERO-GRUPO VERDE",0
50,"50294",70,63,63,0,0,"RECORTES CERO-GRUPO VERDE",0
17,"17181",3372,2135,2112,12,23,"RECORTES CERO-GRUPO VERDE",5
31,"31079",73,54,53,0,1,"RECORTES CERO-GRUPO VERDE",1
16,"16115",44,35,34,0,1,"RECORTES CERO-GRUPO VERDE",0
34,"34169",404,287,286,0,1,"RECORTES CERO-GRUPO VERDE",3
5,"5034",14,13,13,0,0,"RECORTES CERO-GRUPO VERDE",0
42,"42160",254,206,205,0,1,"RECORTES CERO-GRUPO VERDE",1
26,"26077",22,22,21,1,1,"RECORTES CERO-GRUPO VERDE",0
17,"17158",476,276,274,1,2,"RECORTES CERO-GRUPO VERDE",0
43,"43135",340,235,234,1,1,"RECORTES CERO-GRUPO VERDE",0
18,"18162",938,698,686,1,12,"RECORTES CERO-GRUPO VERDE",3
25,"25012",2334,1322,1310,8,12,"RECORTES CERO-GRUPO VERDE",2
6,"6081",1074,806,792,7,14,"RECORTES CERO-GRUPO VERDE",0
33,"33006",1540,1010,1003,5,7,"RECORTES CERO-GRUPO VERDE",2
40,"40022",213,164,161,2,3,"RECORTES CERO-GRUPO VERDE",0
12,"12051",471,339,335,1,4,"RECORTES CERO-GRUPO VERDE",0
22,"22186",181,130,129,1,1,"RECORTES CERO-GRUPO VERDE",0
47,"47007",3769,2765,2736,24,29,"RECORTES CERO-GRUPO VERDE",8
10,"10019",1498,1063,1054,3,9,"RECORTES CERO-GRUPO VERDE",1
24,"24144",695,470,465,2,5,"RECORTES CERO-GRUPO VERDE",2
9,"9109",1056,619,595,8,24,"RECORTES CERO-GRUPO VERDE",4
42,"42115",61,47,47,1,0,"RECORTES CERO-GRUPO VERDE",0
37,"37029",209,137,135,1,2,"RECORTES CERO-GRUPO VERDE",0
17,"17902",1357,886,878,13,8,"RECORTES CERO-GRUPO VERDE",0
13,"13005",23298,17250,17070,140,180,"RECORTES CERO-GRUPO VERDE",37
31,"31124",208,148,148,2,0,"RECORTES CERO-GRUPO VERDE",0
28,"28149",5759,4352,4310,25,42,"RECORTES CERO-GRUPO VERDE",7
26,"26067",22,15,15,1,0,"RECORTES CERO-GRUPO VERDE",0
24,"24212",1032,773,760,4,13,"RECORTES CERO-GRUPO VERDE",1
8,"8135",6677,4813,4775,51,38,"RECORTES CERO-GRUPO VERDE",11
10,"10203",4558,3120,3079,20,41,"RECORTES CERO-GRUPO VERDE",2
26,"26140",253,208,206,0,2,"RECORTES CERO-GRUPO VERDE",0
26,"26175",51,41,41,0,0,"RECORTES CERO-GRUPO VERDE",0
40,"40902",123,99,96,1,3,"RECORTES CERO-GRUPO VERDE",0
29,"29902",2567,1577,1559,11,18,"RECORTES CERO-GRUPO VERDE",3
36,"36041",13434,9297,9181,66,116,"RECORTES CERO-GRUPO VERDE",18
46,"46206",571,453,445,2,8,"RECORTES CERO-GRUPO VERDE",1
43,"43056",854,480,470,5,10,"RECORTES CERO-GRUPO VERDE",0
47,"47105",183,158,156,0,2,"RECORTES CERO-GRUPO VERDE",0
46,"46180",682,553,549,0,4,"RECORTES CERO-GRUPO VERDE",1
9,"9110",80,63,63,0,0,"RECORTES CERO-GRUPO VERDE",0
5,"5072",81,67,67,1,0,"RECORTES CERO-GRUPO VERDE",0
32,"32012",784,505,497,2,8,"RECORTES CERO-GRUPO VERDE",1
45,"45036",656,471,469,2,2,"RECORTES CERO-GRUPO VERDE",0
36,"36042",17891,12212,12003,93,209,"RECORTES CERO-GRUPO VERDE",30
24,"24146",265,210,207,1,3,"RECORTES CERO-GRUPO VERDE",0
34,"34175",90,72,70,0,2,"RECORTES CERO-GRUPO VERDE",0
16,"16027",710,542,538,5,4,"RECORTES CERO-GRUPO VERDE",0
5,"5170",50,43,43,0,0,"RECORTES CERO-GRUPO VERDE",0
40,"40112",2555,1932,1909,8,23,"RECORTES CERO-GRUPO VERDE",7
18,"18001",251,168,167,5,1,"RECORTES CERO-GRUPO VERDE",1
30,"30030",312993,231648,230185,1207,1463,"RECORTES CERO-GRUPO VERDE",489
47,"47061",256,212,211,2,1,"RECORTES CERO-GRUPO VERDE",0
8,"8234",3200,2128,2114,21,14,"RECORTES CERO-GRUPO VERDE",3
16,"16044",39,30,30,0,0,"RECORTES CERO-GRUPO VERDE",0
48,"48052",1562,1160,1150,4,10,"RECORTES CERO-GRUPO VERDE",2
50,"50089",8225,6074,6043,43,31,"RECORTES CERO-GRUPO VERDE",14
5,"5041",1001,775,762,8,13,"RECORTES CERO-GRUPO VERDE",1
28,"28045",33328,24620,24434,146,186,"RECORTES CERO-GRUPO VERDE",53
50,"50166",255,208,206,2,2,"RECORTES CERO-GRUPO VERDE",0
9,"9472",55,45,44,0,1,"RECORTES CERO-GRUPO VERDE",0
24,"24179",290,197,192,4,5,"RECORTES CERO-GRUPO VERDE",0
33,"33070",3351,2403,2373,26,30,"RECORTES CERO-GRUPO VERDE",5
3,"3043",2911,2431,2399,13,32,"RECORTES CERO-GRUPO VERDE",0
37,"37081",930,728,722,3,6,"RECORTES CERO-GRUPO VERDE",2
24,"24148",1672,1249,1241,23,8,"RECORTES CERO-GRUPO VERDE",2
43,"43155",22873,14209,14082,153,127,"RECORTES CERO-GRUPO VERDE",31
45,"45006",1406,942,931,4,11,"RECORTES CERO-GRUPO VERDE",1
8,"8058",1730,1102,1095,6,7,"RECORTES CERO-GRUPO VERDE",3
29,"29016",251,188,188,1,0,"RECORTES CERO-GRUPO VERDE",0
40,"40030",473,369,363,3,6,"RECORTES CERO-GRUPO VERDE",2
5,"5173",60,49,49,0,0,"RECORTES CERO-GRUPO VERDE",0
44,"44063",71,54,54,0,0,"RECORTES CERO-GRUPO VERDE",0
43,"43102",480,332,324,3,8,"RECORTES CERO-GRUPO VERDE",0
12,"12141",101,83,83,0,0,"RECORTES CERO-GRUPO VERDE",0
12,"12011",4565,3331,3283,20,48,"RECORTES CERO-GRUPO VERDE",4
43,"43156",3946,2524,2470,28,54,"RECORTES CERO-GRUPO VERDE",11
10,"10042",84,63,63,0,0,"RECORTES CERO-GRUPO VERDE",0
46,"46001",795,601,592,3,9,"RECORTES CERO-GRUPO VERDE",1
4,"4026",66,54,51,0,3,"RECORTES CERO-GRUPO VERDE",0
28,"28046",4460,3447,3422,16,25,"RECORTES CERO-GRUPO VERDE",4
8,"8060",144,87,87,0,0,"RECORTES CERO-GRUPO VERDE",0
17,"17112",190,127,125,2,2,"RECORTES CERO-GRUPO VERDE",0
40,"40032",390,289,285,2,4,"RECORTES CERO-GRUPO VERDE",0
8,"8100",2001,1395,1380,25,15,"RECORTES CERO-GRUPO VERDE",1
37,"37283",123,92,90,0,2,"RECORTES CERO-GRUPO VERDE",1
42,"42061",291,214,213,3,1,"RECORTES CERO-GRUPO VERDE",0
30,"30033",10188,7403,7285,68,118,"RECORTES CERO-GRUPO VERDE",14
9,"9072",316,242,241,0,1,"RECORTES CERO-GRUPO VERDE",1
26,"26007",511,384,375,0,9,"RECORTES CERO-GRUPO VERDE",0
24,"24016",466,270,269,1,1,"RECORTES CERO-GRUPO VERDE",0
47,"47139",1040,777,767,6,10,"RECORTES CERO-GRUPO VERDE",1
19,"19004",67,53,53,1,0,"RECORTES CERO-GRUPO VERDE",0
28,"28145",2431,1760,1736,6,24,"RECORTES CERO-GRUPO VERDE",9
31,"31087",171,128,124,2,4,"RECORTES CERO-GRUPO VERDE",1
42,"42035",769,527,516,2,11,"RECORTES CERO-GRUPO VERDE",0
21,"21045",249,180,178,3,2,"RECORTES CERO-GRUPO VERDE",0
40,"40088",284,228,224,0,4,"RECORTES CERO-GRUPO VERDE",1
10,"10029",414,339,333,0,6,"RECORTES CERO-GRUPO VERDE",0
50,"50052",90,68,68,0,0,"RECORTES CERO-GRUPO VERDE",0
49,"49058",307,237,233,0,4,"RECORTES CERO-GRUPO VERDE",0
17,"17048",6241,3831,3801,36,30,"RECORTES CERO-GRUPO VERDE",10
4,"4091",334,268,267,6,1,"RECORTES CERO-GRUPO VERDE",1
5,"5225",372,285,281,1,4,"RECORTES CERO-GRUPO VERDE",0
42,"42172",29,26,26,0,0,"RECORTES CERO-GRUPO VERDE",0
26,"26087",201,153,149,3,4,"RECORTES CERO-GRUPO VERDE",2
41,"41036",3941,2674,2642,23,32,"RECORTES CERO-GRUPO VERDE",2
46,"46253",115,82,82,0,0,"RECORTES CERO-GRUPO VERDE",0
30,"30005",29526,20713,20526,121,187,"RECORTES CERO-GRUPO VERDE",30
7,"7018",382,272,269,1,3,"RECORTES CERO-GRUPO VERDE",0
23,"23008",1502,1144,1131,9,13,"RECORTES CERO-GRUPO VERDE",1
44,"44012",334,263,261,5,2,"RECORTES CERO-GRUPO VERDE",0
46,"46116",13159,10193,10135,53,58,"RECORTES CERO-GRUPO VERDE",12
47,"47066",1268,981,977,12,4,"RECORTES CERO-GRUPO VERDE",2
29,"29053",1699,1105,1091,14,14,"RECORTES CERO-GRUPO VERDE",0
16,"16238",501,428,422,3,6,"RECORTES CERO-GRUPO VERDE",0
40,"40162",392,303,302,1,1,"RECORTES CERO-GRUPO VERDE",1
14,"14020",387,269,264,2,5,"RECORTES CERO-GRUPO VERDE",0
45,"45042",187,140,140,0,0,"RECORTES CERO-GRUPO VERDE",1
22,"22170",651,498,491,5,7,"RECORTES CERO-GRUPO VERDE",2
19,"19047",64,55,55,0,0,"RECORTES CERO-GRUPO VERDE",0
6,"6005",1696,1197,1178,1,19,"RECORTES CERO-GRUPO VERDE",1
17,"17077",548,369,368,1,1,"RECORTES CERO-GRUPO VERDE",0
45,"45155",355,291,285,0,6,"RECORTES CERO-GRUPO VERDE",0
50,"50012",100,80,79,2,1,"RECORTES CERO-GRUPO VERDE",1
19,"19193",20,19,19,1,0,"RECORTES CERO-GRUPO VERDE",0
12,"12005",8062,5829,5754,64,75,"RECORTES CERO-GRUPO VERDE",3
45,"45011",278,239,233,1,6,"RECORTES CERO-GRUPO VERDE",0
49,"49034",432,327,325,2,2,"RECORTES CERO-GRUPO VERDE",0
47,"47058",200,145,143,0,2,"RECORTES CERO-GRUPO VERDE",1
48,"48048",557,395,393,5,2,"RECORTES CERO-GRUPO VERDE",1
6,"6097",2362,1750,1727,7,23,"RECORTES CERO-GRUPO VERDE",2
37,"37332",68,51,50,0,1,"RECORTES CERO-GRUPO VERDE",0
47,"47123",466,354,352,4,2,"RECORTES CERO-GRUPO VERDE",1
15,"15091",1135,771,760,13,11,"RECORTES CERO-GRUPO VERDE",3
46,"46092",276,192,189,0,3,"RECORTES CERO-GRUPO VERDE",0
48,"48913",1248,884,869,10,15,"RECORTES CERO-GRUPO VERDE",0
28,"28119",2092,1590,1582,12,8,"RECORTES CERO-GRUPO VERDE",2
17,"17159",643,413,406,3,7,"RECORTES CERO-GRUPO VERDE",2
6,"6022",2651,2089,2054,10,35,"RECORTES CERO-GRUPO VERDE",5
44,"44026",90,77,76,0,1,"RECORTES CERO-GRUPO VERDE",0
44,"44099",709,465,462,3,3,"RECORTES CERO-GRUPO VERDE",0
32,"32070",548,335,329,3,6,"RECORTES CERO-GRUPO VERDE",1
50,"50245",88,65,64,0,1,"RECORTES CERO-GRUPO VERDE",0
50,"50204",2436,1785,1770,3,15,"RECORTES CERO-GRUPO VERDE",3
37,"37262",78,64,63,0,1,"RECORTES CERO-GRUPO VERDE",0
37,"37235",224,153,148,2,5,"RECORTES CERO-GRUPO VERDE",0
7,"7023",3604,2498,2470,49,28,"RECORTES CERO-GRUPO VERDE",8
42,"42003",67,48,47,0,1,"RECORTES CERO-GRUPO VERDE",0
41,"41096",6161,4553,4476,32,77,"RECORTES CERO-GRUPO VERDE",9
43,"43151",107,90,89,0,1,"RECORTES CERO-GRUPO VERDE",0
12,"12017",161,130,128,0,2,"RECORTES CERO-GRUPO VERDE",0
31,"31259",484,291,286,2,5,"RECORTES CERO-GRUPO VERDE",0
30,"30008",13918,9757,9645,59,112,"RECORTES CERO-GRUPO VERDE",30
44,"44005",50,30,30,0,0,"RECORTES CERO-GRUPO VERDE",0
37,"37334",76,48,48,1,0,"RECORTES CERO-GRUPO VERDE",0
7,"7037",3197,1934,1917,26,17,"RECORTES CERO-GRUPO VERDE",9
42,"42131",51,37,37,1,0,"RECORTES CERO-GRUPO VERDE",0
8,"8082",1139,711,708,4,3,"RECORTES CERO-GRUPO VERDE",1
46,"46163",1866,1504,1480,8,24,"RECORTES CERO-GRUPO VERDE",1
8,"8069",3169,2161,2148,32,13,"RECORTES CERO-GRUPO VERDE",7
19,"19096",91,72,69,0,3,"RECORTES CERO-GRUPO VERDE",0
48,"48051",213,163,163,0,0,"RECORTES CERO-GRUPO VERDE",0
22,"22074",313,228,225,4,3,"RECORTES CERO-GRUPO VERDE",1
22,"22160",209,168,168,6,0,"RECORTES CERO-GRUPO VERDE",0
20,"20021",200,100,100,2,0,"RECORTES CERO-GRUPO VERDE",1
37,"37335",406,296,290,0,6,"RECORTES CERO-GRUPO VERDE",0
9,"9396",156,121,121,0,0,"RECORTES CERO-GRUPO VERDE",0
9,"9439",1028,752,744,9,8,"RECORTES CERO-GRUPO VERDE",2
24,"24121",645,492,487,1,5,"RECORTES CERO-GRUPO VERDE",0
48,"48072",977,716,713,4,3,"RECORTES CERO-GRUPO VERDE",1
33,"33039",1655,1223,1209,12,14,"RECORTES CERO-GRUPO VERDE",1
29,"29903",524,353,349,3,4,"RECORTES CERO-GRUPO VERDE",0
17,"17187",631,445,441,2,4,"RECORTES CERO-GRUPO VERDE",0
25,"25004",571,376,373,3,3,"RECORTES CERO-GRUPO VERDE",1
43,"43045",149,110,110,2,0,"RECORTES CERO-GRUPO VERDE",0
37,"37336",52,50,50,1,0,"RECORTES CERO-GRUPO VERDE",0
43,"43168",96,57,57,3,0,"RECORTES CERO-GRUPO VERDE",0
12,"12130",404,340,335,0,5,"RECORTES CERO-GRUPO VERDE",0
37,"37350",420,318,314,5,4,"RECORTES CERO-GRUPO VERDE",1
50,"50258",54,34,34,0,0,"RECORTES CERO-GRUPO VERDE",0
25,"25145",86,65,64,1,1,"RECORTES CERO-GRUPO VERDE",0
5,"5172",123,93,93,1,0,"RECORTES CERO-GRUPO VERDE",1
50,"50028",78,51,51,0,0,"RECORTES CERO-GRUPO VERDE",0
49,"49220",135,110,109,0,1,"RECORTES CERO-GRUPO VERDE",0
17,"17163",2626,1764,1747,10,17,"RECORTES CERO-GRUPO VERDE",1
50,"50146",187,145,144,3,1,"RECORTES CERO-GRUPO VERDE",1
46,"46087",120,98,97,0,1,"RECORTES CERO-GRUPO VERDE",0
12,"12021",4436,3381,3332,27,49,"RECORTES CERO-GRUPO VERDE",6
31,"31096",113,82,79,0,3,"RECORTES CERO-GRUPO VERDE",0
33,"33051",7061,4640,4587,27,53,"RECORTES CERO-GRUPO VERDE",4
31,"31129",395,234,234,0,0,"RECORTES CERO-GRUPO VERDE",0
3,"3117",362,318,313,2,5,"RECORTES CERO-GRUPO VERDE",1
22,"22205",438,322,320,0,2,"RECORTES CERO-GRUPO VERDE",0
18,"18905",14618,9789,9682,110,107,"RECORTES CERO-GRUPO VERDE",22
6,"6014",6682,4479,4409,14,70,"RECORTES CERO-GRUPO VERDE",3
3,"3003",450,378,376,2,2,"RECORTES CERO-GRUPO VERDE",0
44,"44136",49,43,43,1,0,"RECORTES CERO-GRUPO VERDE",0
47,"47037",168,138,133,0,5,"RECORTES CERO-GRUPO VERDE",1
50,"50009",105,80,80,0,0,"RECORTES CERO-GRUPO VERDE",0
31,"31064",1424,1121,1104,3,17,"RECORTES CERO-GRUPO VERDE",2
37,"37213",89,74,73,0,1,"RECORTES CERO-GRUPO VERDE",1
8,"8237",1643,1105,1096,8,9,"RECORTES CERO-GRUPO VERDE",1
41,"41079",9294,6670,6580,51,90,"RECORTES CERO-GRUPO VERDE",6
37,"37130",172,151,150,0,1,"RECORTES CERO-GRUPO VERDE",0
40,"40017",92,75,75,0,0,"RECORTES CERO-GRUPO VERDE",0
40,"40145",1103,879,870,2,9,"RECORTES CERO-GRUPO VERDE",3
19,"19016",65,49,49,0,0,"RECORTES CERO-GRUPO VERDE",0
36,"36022",9011,6310,6172,49,138,"RECORTES CERO-GRUPO VERDE",11
8,"8197",7648,5020,5000,37,20,"RECORTES CERO-GRUPO VERDE",7
28,"28056",863,630,617,4,13,"RECORTES CERO-GRUPO VERDE",0
18,"18006",4130,2904,2864,13,40,"RECORTES CERO-GRUPO VERDE",4
18,"18097",960,693,685,5,8,"RECORTES CERO-GRUPO VERDE",0
10,"10136",302,218,215,4,3,"RECORTES CERO-GRUPO VERDE",0
44,"44218",35,28,28,1,0,"RECORTES CERO-GRUPO VERDE",0
38,"38012",2347,1644,1630,7,14,"RECORTES CERO-GRUPO VERDE",2
17,"17099",81,57,57,1,0,"RECORTES CERO-GRUPO VERDE",0
24,"24038",3089,2312,2273,17,39,"RECORTES CERO-GRUPO VERDE",2
5,"5062",179,148,147,0,1,"RECORTES CERO-GRUPO VERDE",0
44,"44228",100,82,82,0,0,"RECORTES CERO-GRUPO VERDE",0
31,"31121",62,44,43,0,1,"RECORTES CERO-GRUPO VERDE",1
49,"49031",148,120,119,6,1,"RECORTES CERO-GRUPO VERDE",0
45,"45064",3858,2804,2763,20,41,"RECORTES CERO-GRUPO VERDE",3
37,"37299",219,166,163,4,3,"RECORTES CERO-GRUPO VERDE",0
29,"29087",376,270,266,1,4,"RECORTES CERO-GRUPO VERDE",0
42,"42024",86,61,59,0,2,"RECORTES CERO-GRUPO VERDE",0
16,"16145",450,363,361,5,2,"RECORTES CERO-GRUPO VERDE",0
29,"29031",1614,1107,1094,13,13,"RECORTES CERO-GRUPO VERDE",1
43,"43037",16781,10376,10265,71,111,"RECORTES CERO-GRUPO VERDE",27
46,"46090",1637,1391,1367,3,24,"RECORTES CERO-GRUPO VERDE",0
49,"49044",80,60,58,0,2,"RECORTES CERO-GRUPO VERDE",0
26,"26053",208,168,163,4,5,"RECORTES CERO-GRUPO VERDE",0
47,"47048",188,144,144,1,0,"RECORTES CERO-GRUPO VERDE",0
50,"50242",93,75,75,3,0,"RECORTES CERO-GRUPO VERDE",0
10,"10061",1628,1055,1035,8,20,"RECORTES CERO-GRUPO VERDE",0
5,"5065",471,394,392,4,2,"RECORTES CERO-GRUPO VERDE",1
8,"8214",6872,4699,4675,47,24,"RECORTES CERO-GRUPO VERDE",7
48,"48067",1158,813,810,2,3,"RECORTES CERO-GRUPO VERDE",0
29,"29020",3267,2408,2359,16,49,"RECORTES CERO-GRUPO VERDE",2
46,"46262",223,162,159,2,3,"RECORTES CERO-GRUPO VERDE",0
49,"49128",552,423,414,3,9,"RECORTES CERO-GRUPO VERDE",0
50,"50013",219,180,180,0,0,"RECORTES CERO-GRUPO VERDE",0
34,"34206",866,661,654,4,7,"RECORTES CERO-GRUPO VERDE",0
23,"23024",12435,9058,8833,55,225,"RECORTES CERO-GRUPO VERDE",12
9,"9063",209,168,167,2,1,"RECORTES CERO-GRUPO VERDE",0
49,"49180",148,103,102,2,1,"RECORTES CERO-GRUPO VERDE",0
44,"44142",35,27,27,0,0,"RECORTES CERO-GRUPO VERDE",0
29,"29021",161,108,107,4,1,"RECORTES CERO-GRUPO VERDE",0
6,"6127",2863,2112,2088,10,24,"RECORTES CERO-GRUPO VERDE",5
42,"42014",64,43,43,1,0,"RECORTES CERO-GRUPO VERDE",0
37,"37001",192,151,148,0,3,"RECORTES CERO-GRUPO VERDE",0
25,"25039",277,181,180,3,1,"RECORTES CERO-GRUPO VERDE",0
9,"9135",41,31,31,1,0,"RECORTES CERO-GRUPO VERDE",0
42,"42129",681,503,495,3,8,"RECORTES CERO-GRUPO VERDE",0
50,"50151",636,499,499,0,0,"RECORTES CERO-GRUPO VERDE",3
5,"5196",50,37,36,0,1,"RECORTES CERO-GRUPO VERDE",0
31,"31058",208,148,144,3,4,"RECORTES CERO-GRUPO VERDE",0
50,"50014",147,94,94,0,0,"RECORTES CERO-GRUPO VERDE",0
45,"45023",2177,1571,1556,6,15,"RECORTES CERO-GRUPO VERDE",3
26,"26056",419,338,332,1,6,"RECORTES CERO-GRUPO VERDE",3
19,"19160",886,558,552,2,6,"RECORTES CERO-GRUPO VERDE",2
21,"21077",1711,1224,1202,3,22,"RECORTES CERO-GRUPO VERDE",2
36,"36015",4153,2721,2677,23,44,"RECORTES CERO-GRUPO VERDE",2
42,"42191",185,136,133,0,3,"RECORTES CERO-GRUPO VERDE",0
50,"50275",108,55,55,0,0,"RECORTES CERO-GRUPO VERDE",0
18,"18087",184857,134428,133526,864,902,"RECORTES CERO-GRUPO VERDE",247
19,"19147",43,33,33,0,0,"RECORTES CERO-GRUPO VERDE",0
47,"47062",163,130,130,0,0,"RECORTES CERO-GRUPO VERDE",0
10,"10097",101,75,74,0,1,"RECORTES CERO-GRUPO VERDE",0
46,"46153",439,355,351,1,4,"RECORTES CERO-GRUPO VERDE",1
32,"32087",1765,1363,1343,13,20,"RECORTES CERO-GRUPO VERDE",3
40,"40095",477,377,369,0,8,"RECORTES CERO-GRUPO VERDE",0
8,"8040",10710,6845,6802,51,43,"RECORTES CERO-GRUPO VERDE",8
46,"46067",1753,1418,1393,1,25,"RECORTES CERO-GRUPO VERDE",8
31,"31070",2638,1808,1784,20,24,"RECORTES CERO-GRUPO VERDE",6
47,"47125",58,46,46,0,0,"RECORTES CERO-GRUPO VERDE",0
48,"48061",762,565,561,0,4,"RECORTES CERO-GRUPO VERDE",0
35,"35011",24002,15928,15684,95,244,"RECORTES CERO-GRUPO VERDE",56
4,"4056",143,113,109,0,4,"RECORTES CERO-GRUPO VERDE",0
50,"50057",1395,919,907,11,12,"RECORTES CERO-GRUPO VERDE",1
25,"25042",208,123,121,1,2,"RECORTES CERO-GRUPO VERDE",0
46,"46257",5571,4266,4224,25,42,"RECORTES CERO-GRUPO VERDE",8
49,"49095",291,221,220,0,1,"RECORTES CERO-GRUPO VERDE",0
41,"41053",21259,15147,14853,132,294,"RECORTES CERO-GRUPO VERDE",18
22,"22174",478,379,378,2,1,"RECORTES CERO-GRUPO VERDE",0
25,"25904",148,112,111,2,1,"RECORTES CERO-GRUPO VERDE",0
44,"44123",105,71,70,1,1,"RECORTES CERO-GRUPO VERDE",0
23,"23066",4347,3465,3410,15,55,"RECORTES CERO-GRUPO VERDE",5
31,"31105",1507,1167,1142,7,25,"RECORTES CERO-GRUPO VERDE",0
9,"9184",5,4,4,0,0,"RECORTES CERO-GRUPO VERDE",0
19,"19186",81,68,68,0,0,"RECORTES CERO-GRUPO VERDE",0
28,"28179",1432,1040,1037,4,3,"RECORTES CERO-GRUPO VERDE",1
17,"17029",207,127,127,1,0,"RECORTES CERO-GRUPO VERDE",0
13,"13095",85,66,66,0,0,"RECORTES CERO-GRUPO VERDE",0
4,"4067",570,441,436,2,5,"RECORTES CERO-GRUPO VERDE",0
50,"50037",136,98,96,0,2,"RECORTES CERO-GRUPO VERDE",0
32,"32029",470,357,352,4,5,"RECORTES CERO-GRUPO VERDE",2
45,"45205",6824,4424,4362,22,62,"RECORTES CERO-GRUPO VERDE",8
16,"16169",58,37,37,3,0,"RECORTES CERO-GRUPO VERDE",0
31,"31117",620,383,375,3,8,"RECORTES CERO-GRUPO VERDE",1
37,"37140",674,443,439,5,4,"RECORTES CERO-GRUPO VERDE",1
31,"31106",698,533,529,3,4,"RECORTES CERO-GRUPO VERDE",2
48,"48906",766,547,544,0,3,"RECORTES CERO-GRUPO VERDE",0
42,"42019",516,363,356,3,7,"RECORTES CERO-GRUPO VERDE",0
45,"45072",671,484,483,2,1,"RECORTES CERO-GRUPO VERDE",0
47,"47045",763,575,567,1,8,"RECORTES CERO-GRUPO VERDE",0
48,"48056",966,705,700,5,5,"RECORTES CERO-GRUPO VERDE",2
31,"31908",1004,686,682,2,4,"RECORTES CERO-GRUPO VERDE",1
19,"19112",60,46,46,0,0,"RECORTES CERO-GRUPO VERDE",0
45,"45062",1112,878,867,4,11,"RECORTES CERO-GRUPO VERDE",0
23,"23031",747,637,619,0,18,"RECORTES CERO-GRUPO VERDE",0
34,"34067",127,93,93,1,0,"RECORTES CERO-GRUPO VERDE",1
26,"26027",157,112,108,0,4,"RECORTES CERO-GRUPO VERDE",0
50,"50218",113,91,91,1,0,"RECORTES CERO-GRUPO VERDE",0
7,"7041",2044,1486,1451,13,35,"RECORTES CERO-GRUPO VERDE",4
22,"22063",169,133,129,1,4,"RECORTES CERO-GRUPO VERDE",0
5,"5141",94,80,80,1,0,"RECORTES CERO-GRUPO VERDE",0
48,"48084",22449,14670,14553,90,117,"RECORTES CERO-GRUPO VERDE",29
10,"10103",450,322,318,1,4,"RECORTES CERO-GRUPO VERDE",0
17,"17214",705,423,419,2,4,"RECORTES CERO-GRUPO VERDE",0
5,"5110",711,510,505,4,5,"RECORTES CERO-GRUPO VERDE",2
47,"47046",118,92,90,1,2,"RECORTES CERO-GRUPO VERDE",0
37,"37229",135,112,112,0,0,"RECORTES CERO-GRUPO VERDE",0
9,"9021",56,33,31,1,2,"RECORTES CERO-GRUPO VERDE",0
24,"24081",140,98,92,0,6,"RECORTES CERO-GRUPO VERDE",0
46,"46227",905,711,702,1,9,"RECORTES CERO-GRUPO VERDE",3
14,"14074",2299,1896,1866,16,30,"RECORTES CERO-GRUPO VERDE",0
12,"12102",522,423,418,1,5,"RECORTES CERO-GRUPO VERDE",0
50,"50178",293,190,187,0,3,"RECORTES CERO-GRUPO VERDE",1
50,"50270",38,26,26,0,0,"RECORTES CERO-GRUPO VERDE",1
40,"40159",142,100,99,1,1,"RECORTES CERO-GRUPO VERDE",1
34,"34163",45,38,38,0,0,"RECORTES CERO-GRUPO VERDE",0
16,"16157",211,179,179,2,0,"RECORTES CERO-GRUPO VERDE",0
8,"8088",11899,8149,8097,69,52,"RECORTES CERO-GRUPO VERDE",14
41,"41002",1473,1038,1014,9,24,"RECORTES CERO-GRUPO VERDE",0
37,"37173",1504,1129,1114,4,15,"RECORTES CERO-GRUPO VERDE",1
46,"46193",8788,6925,6871,50,54,"RECORTES CERO-GRUPO VERDE",8
37,"37131",185,139,139,0,0,"RECORTES CERO-GRUPO VERDE",0
22,"22234",794,552,544,3,8,"RECORTES CERO-GRUPO VERDE",4
43,"43050",2505,1507,1496,12,11,"RECORTES CERO-GRUPO VERDE",2
10,"10152",468,340,332,1,8,"RECORTES CERO-GRUPO VERDE",0
48,"48015",33581,22727,22528,122,199,"RECORTES CERO-GRUPO VERDE",43
38,"38024",15077,9512,9356,55,156,"RECORTES CERO-GRUPO VERDE",27
7,"7044",8439,5681,5543,48,138,"RECORTES CERO-GRUPO VERDE",13
17,"17205",208,157,155,1,2,"RECORTES CERO-GRUPO VERDE",0
50,"50079",249,175,174,0,1,"RECORTES CERO-GRUPO VERDE",0
46,"46099",901,689,684,1,5,"RECORTES CERO-GRUPO VERDE",0
11,"11036",689,407,400,3,7,"RECORTES CERO-GRUPO VERDE",1
49,"49076",321,217,217,2,0,"RECORTES CERO-GRUPO VERDE",0
5,"5163",1737,1347,1340,4,7,"RECORTES CERO-GRUPO VERDE",0
47,"47075",4856,3681,3637,24,44,"RECORTES CERO-GRUPO VERDE",6
37,"37370",328,258,254,1,4,"RECORTES CERO-GRUPO VERDE",0
26,"26009",401,325,321,4,4,"RECORTES CERO-GRUPO VERDE",0
44,"44002",47,40,40,0,0,"RECORTES CERO-GRUPO VERDE",0
49,"49032",326,259,259,1,0,"RECORTES CERO-GRUPO VERDE",0
50,"50094",1617,1173,1159,12,14,"RECORTES CERO-GRUPO VERDE",2
44,"44108",320,222,222,1,0,"RECORTES CERO-GRUPO VERDE",0
42,"42093",37,29,28,1,1,"RECORTES CERO-GRUPO VERDE",0
42,"42159",37,29,29,0,0,"RECORTES CERO-GRUPO VERDE",0
11,"11026",4782,3451,3378,26,73,"RECORTES CERO-GRUPO VERDE",6
49,"49090",197,143,141,6,2,"RECORTES CERO-GRUPO VERDE",0
5,"5116",109,89,89,1,0,"RECORTES CERO-GRUPO VERDE",0
3,"3132",534,436,435,3,1,"RECORTES CERO-GRUPO VERDE",1
22,"22236",253,200,200,0,0,"RECORTES CERO-GRUPO VERDE",1
16,"16085",138,113,112,0,1,"RECORTES CERO-GRUPO VERDE",0
44,"44129",39,32,32,0,0,"RECORTES CERO-GRUPO VERDE",0
8,"8132",383,213,212,4,1,"RECORTES CERO-GRUPO VERDE",0
47,"47167",241,204,204,1,0,"RECORTES CERO-GRUPO VERDE",0
47,"47193",1577,1251,1241,7,10,"RECORTES CERO-GRUPO VERDE",0
23,"23038",3587,2794,2770,16,24,"RECORTES CERO-GRUPO VERDE",3
37,"37274",118913,85506,84764,566,742,"RECORTES CERO-GRUPO VERDE",139
33,"33066",42963,28564,28282,300,282,"RECORTES CERO-GRUPO VERDE",63
12,"12106",1158,955,942,8,13,"RECORTES CERO-GRUPO VERDE",3
42,"42205",89,71,71,2,0,"RECORTES CERO-GRUPO VERDE",1
5,"5101",292,240,236,1,4,"RECORTES CERO-GRUPO VERDE",0
17,"17038",366,234,232,6,2,"RECORTES CERO-GRUPO VERDE",0
6,"6128",4447,2975,2935,26,40,"RECORTES CERO-GRUPO VERDE",7
44,"44004",408,303,297,0,6,"RECORTES CERO-GRUPO VERDE",0
7,"7008",5692,3956,3913,26,43,"RECORTES CERO-GRUPO VERDE",11
31,"31025",766,524,518,6,6,"RECORTES CERO-GRUPO VERDE",0
21,"21036",200,141,139,0,2,"RECORTES CERO-GRUPO VERDE",0
16,"16901",675,506,501,6,5,"RECORTES CERO-GRUPO VERDE",3
49,"49224",162,112,112,1,0,"RECORTES CERO-GRUPO VERDE",0
50,"50048",34,29,29,0,0,"RECORTES CERO-GRUPO VERDE",0
17,"17066",26562,15223,15087,150,136,"RECORTES CERO-GRUPO VERDE",109
3,"3020",99,79,79,0,0,"RECORTES CERO-GRUPO VERDE",1
43,"43097",393,291,289,1,2,"RECORTES CERO-GRUPO VERDE",1
42,"42016",18,14,14,0,0,"RECORTES CERO-GRUPO VERDE",0
45,"45136",5845,4091,4019,25,72,"RECORTES CERO-GRUPO VERDE",1
5,"5070",30,27,27,0,0,"RECORTES CERO-GRUPO VERDE",0
47,"47133",2682,2033,2015,16,18,"RECORTES CERO-GRUPO VERDE",5
4,"4086",1760,1243,1234,9,9,"RECORTES CERO-GRUPO VERDE",0
43,"43138",2672,1629,1585,37,44,"RECORTES CERO-GRUPO VERDE",2
47,"47034",72,58,58,3,0,"RECORTES CERO-GRUPO VERDE",0
39,"39051",66,57,57,0,0,"RECORTES CERO-GRUPO VERDE",0
3,"3031",41499,27031,26813,128,218,"RECORTES CERO-GRUPO VERDE",45
10,"10067",10422,7113,7014,62,99,"RECORTES CERO-GRUPO VERDE",9
26,"26141",113,87,82,0,5,"RECORTES CERO-GRUPO VERDE",0
12,"12077",4605,3439,3382,15,57,"RECORTES CERO-GRUPO VERDE",1
32,"32058",5202,3650,3607,34,43,"RECORTES CERO-GRUPO VERDE",14
28,"28140",3007,2276,2256,7,20,"RECORTES CERO-GRUPO VERDE",9
17,"17224",314,190,188,2,2,"RECORTES CERO-GRUPO VERDE",0
19,"19245",1155,855,835,5,20,"RECORTES CERO-GRUPO VERDE",0
40,"40155",3518,2656,2605,18,51,"RECORTES CERO-GRUPO VERDE",10
42,"42018",152,117,116,1,1,"RECORTES CERO-GRUPO VERDE",0
47,"47052",6576,4988,4944,40,44,"RECORTES CERO-GRUPO VERDE",12
26,"26106",86,72,72,0,0,"RECORTES CERO-GRUPO VERDE",0
11,"11042",1186,868,858,7,10,"RECORTES CERO-GRUPO VERDE",3
45,"45093",155,129,127,1,2,"RECORTES CERO-GRUPO VERDE",0
19,"19307",27,23,23,0,0,"RECORTES CERO-GRUPO VERDE",0
45,"45204",632,488,487,1,1,"RECORTES CERO-GRUPO VERDE",0
49,"49025",173,133,133,1,0,"RECORTES CERO-GRUPO VERDE",0
6,"6027",676,561,552,2,9,"RECORTES CERO-GRUPO VERDE",2
42,"42119",158,100,99,3,1,"RECORTES CERO-GRUPO VERDE",0
28,"28122",513,375,370,2,5,"RECORTES CERO-GRUPO VERDE",0
37,"37377",241,201,199,1,2,"RECORTES CERO-GRUPO VERDE",0
47,"47070",37,27,27,0,0,"RECORTES CERO-GRUPO VERDE",0
22,"22024",226,174,171,3,3,"RECORTES CERO-GRUPO VERDE",2
36,"36007",1672,1119,1099,8,20,"RECORTES CERO-GRUPO VERDE",2
50,"50176",236,165,165,3,0,"RECORTES CERO-GRUPO VERDE",1
49,"49027",140,112,108,1,4,"RECORTES CERO-GRUPO VERDE",0
21,"21018",1769,1120,1095,11,25,"RECORTES CERO-GRUPO VERDE",1
47,"47162",74,60,60,0,0,"RECORTES CERO-GRUPO VERDE",0
15,"15037",4061,2588,2552,19,36,"RECORTES CERO-GRUPO VERDE",7
7,"7902",1064,685,664,15,21,"RECORTES CERO-GRUPO VERDE",2
45,"45150",443,356,354,0,2,"RECORTES CERO-GRUPO VERDE",1
8,"8222",1895,1358,1351,14,7,"RECORTES CERO-GRUPO VERDE",1
44,"44205",700,460,453,4,7,"RECORTES CERO-GRUPO VERDE",0
37,"37021",79,60,60,0,0,"RECORTES CERO-GRUPO VERDE",0
43,"43905",14392,8444,8393,45,51,"RECORTES CERO-GRUPO VERDE",18
10,"10072",859,617,615,5,2,"RECORTES CERO-GRUPO VERDE",0
45,"45139",167,139,139,1,0,"RECORTES CERO-GRUPO VERDE",0
37,"37157",78,63,62,0,1,"RECORTES CERO-GRUPO VERDE",0
30,"30022",16913,11371,11214,93,157,"RECORTES CERO-GRUPO VERDE",17
43,"43047",4161,2359,2341,27,18,"RECORTES CERO-GRUPO VERDE",7
47,"47137",29,25,25,1,0,"RECORTES CERO-GRUPO VERDE",0
49,"49069",367,258,254,5,4,"RECORTES CERO-GRUPO VERDE",1
46,"46218",1060,910,885,7,25,"RECORTES CERO-GRUPO VERDE",1
28,"28154",5408,3806,3767,16,39,"RECORTES CERO-GRUPO VERDE",4
8,"8019",1136351,768170,764030,5799,4140,"RECORTES CERO-GRUPO VERDE",2235
37,"37068",365,267,267,1,0,"RECORTES CERO-GRUPO VERDE",0
37,"37158",246,183,183,0,0,"RECORTES CERO-GRUPO VERDE",1
32,"32078",1188,855,838,4,17,"RECORTES CERO-GRUPO VERDE",1
31,"31196",38,35,35,1,0,"RECORTES CERO-GRUPO VERDE",0
40,"40118",51,35,34,1,1,"RECORTES CERO-GRUPO VERDE",0
44,"44137",193,149,148,0,1,"RECORTES CERO-GRUPO VERDE",0
6,"6046",1255,1004,995,8,9,"RECORTES CERO-GRUPO VERDE",0
49,"49273",187,112,112,0,0,"RECORTES CERO-GRUPO VERDE",0
47,"47038",105,77,77,0,0,"RECORTES CERO-GRUPO VERDE",0
10,"10120",171,121,117,1,4,"RECORTES CERO-GRUPO VERDE",1
45,"45174",301,237,233,1,4,"RECORTES CERO-GRUPO VERDE",0
35,"35015",9950,5139,5070,29,69,"RECORTES CERO-GRUPO VERDE",16
44,"44150",28,22,21,0,1,"RECORTES CERO-GRUPO VERDE",0
50,"50179",249,214,213,2,1,"RECORTES CERO-GRUPO VERDE",0
17,"17180",8295,4958,4935,36,23,"RECORTES CERO-GRUPO VERDE",5
37,"37271",368,297,296,0,1,"RECORTES CERO-GRUPO VERDE",0
19,"19057",76,59,59,1,0,"RECORTES CERO-GRUPO VERDE",1
50,"50041",12,9,9,0,0,"RECORTES CERO-GRUPO VERDE",0
13,"13051",346,264,264,1,0,"RECORTES CERO-GRUPO VERDE",1
14,"14019",6464,4967,4909,49,58,"RECORTES CERO-GRUPO VERDE",3
11,"11025",4398,2899,2848,51,51,"RECORTES CERO-GRUPO VERDE",3
47,"47176",219,139,139,1,0,"RECORTES CERO-GRUPO VERDE",0
10,"10003",569,414,408,1,6,"RECORTES CERO-GRUPO VERDE",0
37,"37196",75,64,64,0,0,"RECORTES CERO-GRUPO VERDE",0
11,"11003",1261,836,822,7,14,"RECORTES CERO-GRUPO VERDE",2
8,"8208",5732,3976,3952,30,24,"RECORTES CERO-GRUPO VERDE",9
47,"47121",544,437,425,6,12,"RECORTES CERO-GRUPO VERDE",0
28,"28147",963,722,720,5,2,"RECORTES CERO-GRUPO VERDE",1
33,"33044",178278,125469,124554,1124,915,"RECORTES CERO-GRUPO VERDE",224
34,"34057",471,339,338,1,1,"RECORTES CERO-GRUPO VERDE",2
34,"34011",397,321,320,5,1,"RECORTES CERO-GRUPO VERDE",1
31,"31133",43,28,28,0,0,"RECORTES CERO-GRUPO VERDE",0
11,"11037",5661,4347,4265,33,82,"RECORTES CERO-GRUPO VERDE",3
36,"36037",2571,1733,1707,11,26,"RECORTES CERO-GRUPO VERDE",3
8,"8130",95,56,55,0,1,"RECORTES CERO-GRUPO VERDE",0
37,"37026",189,146,146,0,0,"RECORTES CERO-GRUPO VERDE",0
50,"50160",2238,1546,1528,12,18,"RECORTES CERO-GRUPO VERDE",0
9,"9449",86,68,66,0,2,"RECORTES CERO-GRUPO VERDE",0
20,"20020",125,71,69,3,2,"RECORTES CERO-GRUPO VERDE",0
20,"20028",2237,1373,1365,11,8,"RECORTES CERO-GRUPO VERDE",2
48,"48017",13261,8543,8482,42,61,"RECORTES CERO-GRUPO VERDE",13
42,"42038",36,28,28,1,0,"RECORTES CERO-GRUPO VERDE",0
39,"39078",1401,975,963,5,12,"RECORTES CERO-GRUPO VERDE",0
23,"23090",1312,1041,1018,5,23,"RECORTES CERO-GRUPO VERDE",1
50,"50095",12323,8628,8550,110,78,"RECORTES CERO-GRUPO VERDE",5
5,"5262",357,276,276,1,0,"RECORTES CERO-GRUPO VERDE",0
8,"8255",134,78,78,0,0,"RECORTES CERO-GRUPO VERDE",0
50,"50284",141,107,104,0,3,"RECORTES CERO-GRUPO VERDE",0
25,"25064",108,68,68,2,0,"RECORTES CERO-GRUPO VERDE",0
32,"32024",4821,3320,3254,34,66,"RECORTES CERO-GRUPO VERDE",7
28,"28176",12491,9723,9667,37,56,"RECORTES CERO-GRUPO VERDE",9
37,"37261",221,163,160,1,3,"RECORTES CERO-GRUPO VERDE",0
25,"25040",10546,6367,6300,61,67,"RECORTES CERO-GRUPO VERDE",11
50,"50034",826,567,563,5,4,"RECORTES CERO-GRUPO VERDE",1
8,"8120",6835,4708,4688,44,20,"RECORTES CERO-GRUPO VERDE",5
45,"45046",2412,1667,1654,7,13,"RECORTES CERO-GRUPO VERDE",4
45,"45145",2565,1695,1675,12,20,"RECORTES CERO-GRUPO VERDE",5
49,"49169",35,26,26,0,0,"RECORTES CERO-GRUPO VERDE",0
22,"22139",79,64,64,1,0,"RECORTES CERO-GRUPO VERDE",0
37,"37090",52,43,43,0,0,"RECORTES CERO-GRUPO VERDE",0
24,"24175",1832,1314,1297,14,17,"RECORTES CERO-GRUPO VERDE",1
17,"17212",141,104,102,0,2,"RECORTES CERO-GRUPO VERDE",1
44,"44127",68,51,51,0,0,"RECORTES CERO-GRUPO VERDE",0
24,"24178",70,59,58,0,1,"RECORTES CERO-GRUPO VERDE",0
18,"18122",16114,11098,10945,83,153,"RECORTES CERO-GRUPO VERDE",14
8,"8076",16169,10652,10563,75,89,"RECORTES CERO-GRUPO VERDE",39
11,"11011",1716,1195,1165,12,30,"RECORTES CERO-GRUPO VERDE",2
6,"6084",1093,828,818,8,10,"RECORTES CERO-GRUPO VERDE",0
45,"45047",2606,1666,1647,6,19,"RECORTES CERO-GRUPO VERDE",5
46,"46189",467,393,390,2,3,"RECORTES CERO-GRUPO VERDE",0
16,"16089",375,303,303,6,0,"RECORTES CERO-GRUPO VERDE",0
29,"29057",357,241,238,1,3,"RECORTES CERO-GRUPO VERDE",0
42,"42029",137,104,104,2,0,"RECORTES CERO-GRUPO VERDE",1
48,"48914",332,272,272,1,0,"RECORTES CERO-GRUPO VERDE",0
31,"31004",35,21,21,0,0,"RECORTES CERO-GRUPO VERDE",0
48,"48904",3511,2625,2600,22,25,"RECORTES CERO-GRUPO VERDE",2
31,"31015",1994,1412,1392,25,20,"RECORTES CERO-GRUPO VERDE",4
28,"28153",697,499,499,1,0,"RECORTES CERO-GRUPO VERDE",0
16,"16109",44,38,38,1,0,"RECORTES CERO-GRUPO VERDE",0
44,"44006",248,185,183,2,2,"RECORTES CERO-GRUPO VERDE",0
50,"50132",751,543,536,0,7,"RECORTES CERO-GRUPO VERDE",0
39,"39041",1760,1370,1354,9,16,"RECORTES CERO-GRUPO VERDE",1
43,"43112",279,175,174,0,1,"RECORTES CERO-GRUPO VERDE",2
10,"10099",583,378,374,2,4,"RECORTES CERO-GRUPO VERDE",0
47,"47170",33,28,27,2,1,"RECORTES CERO-GRUPO VERDE",0
40,"40208",766,596,589,3,7,"RECORTES CERO-GRUPO VERDE",1
34,"34001",34,28,28,2,0,"RECORTES CERO-GRUPO VERDE",0
42,"42071",171,115,115,3,0,"RECORTES CERO-GRUPO VERDE",0
50,"50185",133,108,108,1,0,"RECORTES CERO-GRUPO VERDE",1
39,"39092",894,626,620,1,6,"RECORTES CERO-GRUPO VERDE",0
26,"26003",413,331,329,2,2,"RECORTES CERO-GRUPO VERDE",0
49,"49026",226,179,176,0,3,"RECORTES CERO-GRUPO VERDE",0
22,"22204",1114,745,739,12,6,"RECORTES CERO-GRUPO VERDE",3
44,"44160",466,304,301,2,3,"RECORTES CERO-GRUPO VERDE",0
48,"48002",7829,5490,5451,44,39,"RECORTES CERO-GRUPO VERDE",3
25,"25044",188,122,120,7,2,"RECORTES CERO-GRUPO VERDE",0
3,"3033",117,96,95,0,1,"RECORTES CERO-GRUPO VERDE",0
50,"50100",329,246,241,1,5,"RECORTES CERO-GRUPO VERDE",1
12,"12032",23525,17093,16966,104,127,"RECORTES CERO-GRUPO VERDE",34
6,"6133",1775,1324,1312,15,12,"RECORTES CERO-GRUPO VERDE",0
40,"40224",22,21,21,0,0,"RECORTES CERO-GRUPO VERDE",0
42,"42050",31,18,18,0,0,"RECORTES CERO-GRUPO VERDE",0
31,"31102",143,69,69,0,0,"RECORTES CERO-GRUPO VERDE",0
37,"37230",221,159,159,2,0,"RECORTES CERO-GRUPO VERDE",0
7,"7013",6881,4693,4587,39,106,"RECORTES CERO-GRUPO VERDE",7
31,"31051",251,170,170,2,0,"RECORTES CERO-GRUPO VERDE",0
40,"40113",425,323,316,0,7,"RECORTES CERO-GRUPO VERDE",0
37,"37378",111,77,75,2,2,"RECORTES CERO-GRUPO VERDE",0
47,"47010",13729,10549,10454,81,95,"RECORTES CERO-GRUPO VERDE",19
35,"35022",48603,29443,29042,160,401,"RECORTES CERO-GRUPO VERDE",82
46,"46113",2457,1804,1782,6,22,"RECORTES CERO-GRUPO VERDE",1
3,"3128",4092,2861,2840,10,21,"RECORTES CERO-GRUPO VERDE",2
49,"49055",102,82,82,2,0,"RECORTES CERO-GRUPO VERDE",0
42,"42135",72,52,52,1,0,"RECORTES CERO-GRUPO VERDE",1
31,"31085",480,350,350,2,0,"RECORTES CERO-GRUPO VERDE",0
49,"49188",112,90,89,1,1,"RECORTES CERO-GRUPO VERDE",0
6,"6089",596,469,461,1,8,"RECORTES CERO-GRUPO VERDE",0
43,"43133",5666,3397,3356,27,41,"RECORTES CERO-GRUPO VERDE",11
43,"43002",1801,1156,1128,7,28,"RECORTES CERO-GRUPO VERDE",5
38,"38046",9113,6850,6775,40,75,"RECORTES CERO-GRUPO VERDE",11
29,"29062",654,551,545,2,6,"RECORTES CERO-GRUPO VERDE",0
31,"31031",220,131,129,0,2,"RECORTES CERO-GRUPO VERDE",0
45,"45052",2948,2321,2295,16,26,"RECORTES CERO-GRUPO VERDE",7
16,"16110",93,70,70,0,0,"RECORTES CERO-GRUPO VERDE",0
12,"12001",1051,821,800,4,21,"RECORTES CERO-GRUPO VERDE",0
37,"37185",591,423,417,2,6,"RECORTES CERO-GRUPO VERDE",2
22,"22052",925,712,710,8,2,"RECORTES CERO-GRUPO VERDE",2
37,"37380",56,47,45,0,2,"RECORTES CERO-GRUPO VERDE",0
47,"47020",280,234,231,2,3,"RECORTES CERO-GRUPO VERDE",0
17,"17191",141,92,89,1,3,"RECORTES CERO-GRUPO VERDE",0
9,"9009",163,133,131,2,2,"RECORTES CERO-GRUPO VERDE",2
49,"49006",154,99,95,0,4,"RECORTES CERO-GRUPO VERDE",0
24,"24005",378,260,257,2,3,"RECORTES CERO-GRUPO VERDE",0
50,"50130",383,240,238,2,2,"RECORTES CERO-GRUPO VERDE",0
34,"34083",1769,1218,1201,10,17,"RECORTES CERO-GRUPO VERDE",3
10,"10151",207,165,162,0,3,"RECORTES CERO-GRUPO VERDE",0
46,"46252",118,99,98,0,1,"RECORTES CERO-GRUPO VERDE",0
40,"40060",82,61,61,0,0,"RECORTES CERO-GRUPO VERDE",0
40,"40230",94,68,66,0,2,"RECORTES CERO-GRUPO VERDE",0
28,"28164",2993,2183,2168,8,15,"RECORTES CERO-GRUPO VERDE",1
45,"45131",282,234,230,0,4,"RECORTES CERO-GRUPO VERDE",0
44,"44110",49,42,42,1,0,"RECORTES CERO-GRUPO VERDE",0
18,"18021",17485,11800,11669,95,131,"RECORTES CERO-GRUPO VERDE",22
40,"40036",515,421,410,3,11,"RECORTES CERO-GRUPO VERDE",0
13,"13021",434,365,363,4,2,"RECORTES CERO-GRUPO VERDE",0
12,"12009",17445,12088,11999,75,89,"RECORTES CERO-GRUPO VERDE",17
28,"28029",520,408,406,0,2,"RECORTES CERO-GRUPO VERDE",1
23,"23060",19003,12924,12812,102,112,"RECORTES CERO-GRUPO VERDE",12
40,"40048",38,29,27,0,2,"RECORTES CERO-GRUPO VERDE",0
42,"42037",33,25,25,2,0,"RECORTES CERO-GRUPO VERDE",0
17,"17143",142,103,99,1,4,"RECORTES CERO-GRUPO VERDE",0
16,"16273",321,242,236,3,6,"RECORTES CERO-GRUPO VERDE",0
35,"35034",7873,3975,3943,27,32,"RECORTES CERO-GRUPO VERDE",11
23,"23074",3021,2317,2295,11,22,"RECORTES CERO-GRUPO VERDE",1
25,"25023",4531,2782,2763,30,19,"RECORTES CERO-GRUPO VERDE",3
3,"3901",1135,822,817,8,5,"RECORTES CERO-GRUPO VERDE",1
10,"10108",219,148,146,0,2,"RECORTES CERO-GRUPO VERDE",0
45,"45125",2305,1865,1841,8,24,"RECORTES CERO-GRUPO VERDE",3
50,"50168",28,27,27,0,0,"RECORTES CERO-GRUPO VERDE",0
31,"31203",40,28,28,0,0,"RECORTES CERO-GRUPO VERDE",0
6,"6019",2079,1451,1417,8,34,"RECORTES CERO-GRUPO VERDE",0
22,"22081",254,181,181,0,0,"RECORTES CERO-GRUPO VERDE",0
47,"47093",813,613,600,5,13,"RECORTES CERO-GRUPO VERDE",0
43,"43094",2143,1395,1375,13,20,"RECORTES CERO-GRUPO VERDE",3
41,"41016",7355,5248,5175,51,73,"RECORTES CERO-GRUPO VERDE",7
7,"7006",5178,3366,3329,52,37,"RECORTES CERO-GRUPO VERDE",11
43,"43066",158,100,98,5,2,"RECORTES CERO-GRUPO VERDE",2
41,"41006",2740,1782,1768,14,14,"RECORTES CERO-GRUPO VERDE",0
37,"37014",1155,817,808,7,9,"RECORTES CERO-GRUPO VERDE",1
42,"42218",82,55,55,0,0,"RECORTES CERO-GRUPO VERDE",0
49,"49129",853,592,574,9,18,"RECORTES CERO-GRUPO VERDE",0
26,"26022",198,164,163,1,1,"RECORTES CERO-GRUPO VERDE",0
45,"45033",343,249,243,2,6,"RECORTES CERO-GRUPO VERDE",1
45,"45104",428,324,323,1,1,"RECORTES CERO-GRUPO VERDE",0
38,"38040",5021,3136,3102,14,34,"RECORTES CERO-GRUPO VERDE",5
25,"25027",976,633,630,7,3,"RECORTES CERO-GRUPO VERDE",1
47,"47151",27,24,24,0,0,"RECORTES CERO-GRUPO VERDE",0
44,"44120",222,154,150,2,4,"RECORTES CERO-GRUPO VERDE",0
8,"8297",134,85,84,0,1,"RECORTES CERO-GRUPO VERDE",1
18,"18134",5828,3840,3800,36,40,"RECORTES CERO-GRUPO VERDE",5
28,"28137",1664,1232,1220,7,12,"RECORTES CERO-GRUPO VERDE",3
16,"16111",171,123,123,1,0,"RECORTES CERO-GRUPO VERDE",0
50,"50203",1040,748,739,7,9,"RECORTES CERO-GRUPO VERDE",1
8,"8106",7279,4871,4845,40,26,"RECORTES CERO-GRUPO VERDE",10
39,"39049",322,229,229,0,0,"RECORTES CERO-GRUPO VERDE",0
11,"11006",24455,15750,15587,193,163,"RECORTES CERO-GRUPO VERDE",14
34,"34038",277,204,203,1,1,"RECORTES CERO-GRUPO VERDE",0
44,"44249",55,44,44,2,0,"RECORTES CERO-GRUPO VERDE",0
43,"43088",1996,1271,1255,7,16,"RECORTES CERO-GRUPO VERDE",3
37,"37221",430,293,290,0,3,"RECORTES CERO-GRUPO VERDE",1
40,"40139",279,202,198,1,4,"RECORTES CERO-GRUPO VERDE",0
5,"5198",73,62,62,0,0,"RECORTES CERO-GRUPO VERDE",0
44,"44132",60,54,54,1,0,"RECORTES CERO-GRUPO VERDE",0
31,"31137",205,112,109,6,3,"RECORTES CERO-GRUPO VERDE",1
44,"44155",1090,793,782,4,11,"RECORTES CERO-GRUPO VERDE",2
24,"24176",316,247,244,1,3,"RECORTES CERO-GRUPO VERDE",0
9,"9016",85,60,59,3,1,"RECORTES CERO-GRUPO VERDE",1
8,"8258",830,557,551,6,6,"RECORTES CERO-GRUPO VERDE",0
14,"14051",1397,1018,1000,2,18,"RECORTES CERO-GRUPO VERDE",0
7,"7011",27721,17817,17720,139,97,"RECORTES CERO-GRUPO VERDE",40
43,"43083",144,109,108,0,1,"RECORTES CERO-GRUPO VERDE",0
49,"49094",224,149,149,2,0,"RECORTES CERO-GRUPO VERDE",1
47,"47152",78,60,60,0,0,"RECORTES CERO-GRUPO VERDE",0
32,"32042",1579,1094,1081,12,13,"RECORTES CERO-GRUPO VERDE",1
50,"50215",24,19,19,0,0,"RECORTES CERO-GRUPO VERDE",0
46,"46146",1654,1304,1278,7,26,"RECORTES CERO-GRUPO VERDE",2
49,"49013",246,182,181,2,1,"RECORTES CERO-GRUPO VERDE",0
32,"32089",1295,888,878,7,10,"RECORTES CERO-GRUPO VERDE",1
34,"34020",52,39,39,0,0,"RECORTES CERO-GRUPO VERDE",0
39,"39102",2277,1615,1598,9,17,"RECORTES CERO-GRUPO VERDE",2
7,"7024",6843,3657,3612,38,45,"RECORTES CERO-GRUPO VERDE",20
19,"19296",30,19,18,0,1,"RECORTES CERO-GRUPO VERDE",0
10,"10141",263,194,194,0,0,"RECORTES CERO-GRUPO VERDE",0
24,"24050",102,77,76,0,1,"RECORTES CERO-GRUPO VERDE",0
7,"7057",7169,4719,4659,47,60,"RECORTES CERO-GRUPO VERDE",17
30,"30040",732,617,607,2,10,"RECORTES CERO-GRUPO VERDE",0
43,"43031",1458,1020,1014,15,6,"RECORTES CERO-GRUPO VERDE",5
31,"31061",54,49,49,0,0,"RECORTES CERO-GRUPO VERDE",0
18,"18152",944,707,703,0,4,"RECORTES CERO-GRUPO VERDE",2
15,"15034",2885,1782,1760,18,22,"RECORTES CERO-GRUPO VERDE",1
42,"42182",56,43,41,1,2,"RECORTES CERO-GRUPO VERDE",1
46,"46057",487,321,317,1,4,"RECORTES CERO-GRUPO VERDE",0
34,"34136",179,110,110,1,0,"RECORTES CERO-GRUPO VERDE",0
5,"5197",102,85,83,1,2,"RECORTES CERO-GRUPO VERDE",0
16,"16258",194,150,150,1,0,"RECORTES CERO-GRUPO VERDE",0
42,"42207",40,33,32,0,1,"RECORTES CERO-GRUPO VERDE",1
45,"45169",189,140,138,0,2,"RECORTES CERO-GRUPO VERDE",0
37,"37339",315,251,251,4,0,"RECORTES CERO-GRUPO VERDE",0
41,"41901",2682,2107,2086,28,21,"RECORTES CERO-GRUPO VERDE",2
26,"26168",5340,3774,3717,22,57,"RECORTES CERO-GRUPO VERDE",8
44,"44051",2683,1977,1946,17,31,"RECORTES CERO-GRUPO VERDE",1
10,"10148",32850,22161,21856,177,305,"RECORTES CERO-GRUPO VERDE",77
23,"23084",935,658,653,7,5,"RECORTES CERO-GRUPO VERDE",0
27,"27048",2140,1502,1467,20,35,"RECORTES CERO-GRUPO VERDE",1
18,"18078",732,570,566,2,4,"RECORTES CERO-GRUPO VERDE",0
17,"17189",1516,1076,1070,5,6,"RECORTES CERO-GRUPO VERDE",0
28,"28132",11685,8130,8062,56,68,"RECORTES CERO-GRUPO VERDE",16
39,"39005",1380,1053,1046,9,7,"RECORTES CERO-GRUPO VERDE",2
9,"9297",323,251,250,6,1,"RECORTES CERO-GRUPO VERDE",0
37,"37372",144,111,108,0,3,"RECORTES CERO-GRUPO VERDE",0
8,"8046",13290,9054,9000,103,54,"RECORTES CERO-GRUPO VERDE",21
42,"42184",57,43,43,0,0,"RECORTES CERO-GRUPO VERDE",0
2,"2012",1835,1476,1453,7,23,"RECORTES CERO-GRUPO VERDE",3
37,"37022",268,215,215,2,0,"RECORTES CERO-GRUPO VERDE",0
44,"44064",69,49,49,0,0,"RECORTES CERO-GRUPO VERDE",0
44,"44093",80,66,66,0,0,"RECORTES CERO-GRUPO VERDE",0
25,"25060",72,46,44,1,2,"RECORTES CERO-GRUPO VERDE",0
19,"19190",2369,1760,1745,10,15,"RECORTES CERO-GRUPO VERDE",2
38,"38023",121908,81147,80333,494,814,"RECORTES CERO-GRUPO VERDE",317
46,"46175",456,389,387,3,2,"RECORTES CERO-GRUPO VERDE",0
37,"37177",289,220,219,2,1,"RECORTES CERO-GRUPO VERDE",0
49,"49047",107,75,75,0,0,"RECORTES CERO-GRUPO VERDE",0
9,"9365",29,19,19,0,0,"RECORTES CERO-GRUPO VERDE",0
23,"23903",3540,2662,2634,13,28,"RECORTES CERO-GRUPO VERDE",3
34,"34025",57,39,39,1,0,"RECORTES CERO-GRUPO VERDE",0
49,"49261",1537,1048,1033,8,15,"RECORTES CERO-GRUPO VERDE",2
47,"47156",162,136,133,0,3,"RECORTES CERO-GRUPO VERDE",0
8,"8115",3799,2589,2572,17,17,"RECORTES CERO-GRUPO VERDE",9
13,"13033",1633,1328,1290,4,38,"RECORTES CERO-GRUPO VERDE",2
22,"22181",92,61,61,2,0,"RECORTES CERO-GRUPO VERDE",0
6,"6118",192,145,144,1,1,"RECORTES CERO-GRUPO VERDE",0
34,"34060",137,111,108,0,3,"RECORTES CERO-GRUPO VERDE",1
46,"46187",1306,1017,1000,0,17,"RECORTES CERO-GRUPO VERDE",2
17,"17194",80,55,54,0,1,"RECORTES CERO-GRUPO VERDE",0
38,"38050",2462,1624,1604,8,20,"RECORTES CERO-GRUPO VERDE",3
25,"25138",569,363,360,4,3,"RECORTES CERO-GRUPO VERDE",0
26,"26068",80,61,61,1,0,"RECORTES CERO-GRUPO VERDE",0
33,"33060",14633,9647,9474,72,173,"RECORTES CERO-GRUPO VERDE",17
49,"49206",840,614,604,9,10,"RECORTES CERO-GRUPO VERDE",0
37,"37025",257,220,220,4,0,"RECORTES CERO-GRUPO VERDE",0
17,"17233",2260,1528,1514,23,14,"RECORTES CERO-GRUPO VERDE",1
41,"41070",6032,4312,4258,44,54,"RECORTES CERO-GRUPO VERDE",13
40,"40203",899,722,715,4,7,"RECORTES CERO-GRUPO VERDE",0
44,"44141",135,97,96,1,1,"RECORTES CERO-GRUPO VERDE",0
26,"26172",30,23,23,0,0,"RECORTES CERO-GRUPO VERDE",0
49,"49102",196,143,139,2,4,"RECORTES CERO-GRUPO VERDE",0
24,"24174",486,343,342,4,1,"RECORTES CERO-GRUPO VERDE",0
26,"26173",6,6,6,1,0,"RECORTES CERO-GRUPO VERDE",0
50,"50184",115,85,85,0,0,"RECORTES CERO-GRUPO VERDE",0
9,"9131",462,365,364,2,1,"RECORTES CERO-GRUPO VERDE",0
20,"20009",11452,7388,7345,62,43,"RECORTES CERO-GRUPO VERDE",18
37,"37301",74,63,63,0,0,"RECORTES CERO-GRUPO VERDE",0
49,"49008",460,332,331,5,1,"RECORTES CERO-GRUPO VERDE",0
11,"11027",67913,45219,44833,454,386,"RECORTES CERO-GRUPO VERDE",115
10,"10047",955,732,727,1,5,"RECORTES CERO-GRUPO VERDE",3
24,"24052",158,104,102,0,2,"RECORTES CERO-GRUPO VERDE",0
37,"37121",575,418,413,3,5,"RECORTES CERO-GRUPO VERDE",0
45,"45045",1318,905,888,5,17,"RECORTES CERO-GRUPO VERDE",0
17,"17037",104,69,69,1,0,"RECORTES CERO-GRUPO VERDE",0
23,"23053",9531,6704,6658,37,46,"RECORTES CERO-GRUPO VERDE",2
14,"14070",1332,986,974,10,12,"RECORTES CERO-GRUPO VERDE",0
34,"34019",125,107,105,0,2,"RECORTES CERO-GRUPO VERDE",1
46,"46171",16563,12213,12128,85,85,"RECORTES CERO-GRUPO VERDE",32
3,"3086",151,135,134,1,1,"RECORTES CERO-GRUPO VERDE",0
38,"38027",5414,3618,3571,16,47,"RECORTES CERO-GRUPO VERDE",3
25,"25079",299,198,193,2,5,"RECORTES CERO-GRUPO VERDE",0
42,"42161",137,102,101,0,1,"RECORTES CERO-GRUPO VERDE",0
25,"25067",719,467,460,7,7,"RECORTES CERO-GRUPO VERDE",0
41,"41051",2180,1529,1501,2,28,"RECORTES CERO-GRUPO VERDE",1
40,"40146",254,197,196,0,1,"RECORTES CERO-GRUPO VERDE",2
37,"37136",652,440,435,3,5,"RECORTES CERO-GRUPO VERDE",3
6,"6041",460,372,367,0,5,"RECORTES CERO-GRUPO VERDE",0
6,"6117",1424,960,938,4,22,"RECORTES CERO-GRUPO VERDE",1
46,"46183",5993,4443,4381,19,62,"RECORTES CERO-GRUPO VERDE",4
37,"37238",110,87,85,0,2,"RECORTES CERO-GRUPO VERDE",0
40,"40213",86,65,65,3,0,"RECORTES CERO-GRUPO VERDE",0
36,"36021",12073,8447,8342,89,105,"RECORTES CERO-GRUPO VERDE",17
11,"11033",20903,12949,12771,164,178,"RECORTES CERO-GRUPO VERDE",21
25,"25140",788,435,430,9,5,"RECORTES CERO-GRUPO VERDE",1
22,"22187",293,218,216,2,2,"RECORTES CERO-GRUPO VERDE",0
47,"47078",163,127,125,1,2,"RECORTES CERO-GRUPO VERDE",0
50,"50067",14119,9909,9819,112,90,"RECORTES CERO-GRUPO VERDE",15
26,"26035",17,12,11,0,1,"RECORTES CERO-GRUPO VERDE",0
50,"50246",41,28,28,0,0,"RECORTES CERO-GRUPO VERDE",0
6,"6006",4572,3088,3049,26,39,"RECORTES CERO-GRUPO VERDE",6
22,"22062",167,116,116,1,0,"RECORTES CERO-GRUPO VERDE",0
43,"43171",14599,9083,9011,72,72,"RECORTES CERO-GRUPO VERDE",31
46,"46191",1937,1530,1505,5,25,"RECORTES CERO-GRUPO VERDE",2
42,"42204",54,38,38,1,0,"RECORTES CERO-GRUPO VERDE",0
16,"16009",62,51,50,0,1,"RECORTES CERO-GRUPO VERDE",0
50,"50121",277,216,214,1,2,"RECORTES CERO-GRUPO VERDE",0
39,"39061",3478,2695,2677,13,18,"RECORTES CERO-GRUPO VERDE",1
50,"50247",823,588,581,3,7,"RECORTES CERO-GRUPO VERDE",0
3,"3052",970,769,755,8,14,"RECORTES CERO-GRUPO VERDE",1
10,"10023",835,616,607,2,9,"RECORTES CERO-GRUPO VERDE",2
42,"42100",32,30,30,0,0,"RECORTES CERO-GRUPO VERDE",1
9,"9032",109,75,73,0,2,"RECORTES CERO-GRUPO VERDE",0
7,"7016",2809,1865,1836,23,29,"RECORTES CERO-GRUPO VERDE",3
40,"40121",280,226,218,3,8,"RECORTES CERO-GRUPO VERDE",0
11,"11012",99886,70290,69673,693,617,"RECORTES CERO-GRUPO VERDE",256
47,"47084",1150,887,870,7,17,"RECORTES CERO-GRUPO VERDE",0
37,"37004",30,21,21,0,0,"RECORTES CERO-GRUPO VERDE",0
22,"22064",166,122,121,1,1,"RECORTES CERO-GRUPO VERDE",0
37,"37243",98,70,70,1,0,"RECORTES CERO-GRUPO VERDE",0
11,"11901",5648,3676,3631,67,45,"RECORTES CERO-GRUPO VERDE",6
6,"6901",2118,1559,1546,23,13,"RECORTES CERO-GRUPO VERDE",4
23,"23034",2540,1957,1934,14,23,"RECORTES CERO-GRUPO VERDE",0
8,"8284",12097,7157,7089,59,68,"RECORTES CERO-GRUPO VERDE",20
46,"46902",364,306,303,0,3,"RECORTES CERO-GRUPO VERDE",0
42,"42144",436,353,348,2,5,"RECORTES CERO-GRUPO VERDE",0
43,"43107",383,238,237,7,1,"RECORTES CERO-GRUPO VERDE",0
48,"48097",1297,900,894,8,6,"RECORTES CERO-GRUPO VERDE",1
24,"24228",660,430,422,6,8,"RECORTES CERO-GRUPO VERDE",2
34,"34179",28,21,20,0,1,"RECORTES CERO-GRUPO VERDE",0
40,"40222",168,145,144,0,1,"RECORTES CERO-GRUPO VERDE",0
42,"42076",216,179,174,5,5,"RECORTES CERO-GRUPO VERDE",0
36,"36008",21762,15447,15262,128,185,"RECORTES CERO-GRUPO VERDE",43
9,"9473",85,70,65,1,5,"RECORTES CERO-GRUPO VERDE",1
26,"26005",2381,1598,1577,23,21,"RECORTES CERO-GRUPO VERDE",2
8,"8085",1000,662,658,5,4,"RECORTES CERO-GRUPO VERDE",0
42,"42105",50,45,45,0,0,"RECORTES CERO-GRUPO VERDE",0
34,"34135",399,293,289,0,4,"RECORTES CERO-GRUPO VERDE",0
23,"23075",3298,2564,2541,18,23,"RECORTES CERO-GRUPO VERDE",3
9,"9901",371,263,259,4,4,"RECORTES CERO-GRUPO VERDE",1
40,"40034",84,70,70,0,0,"RECORTES CERO-GRUPO VERDE",0
23,"23012",4162,2907,2889,14,18,"RECORTES CERO-GRUPO VERDE",4
9,"9163",582,467,459,2,8,"RECORTES CERO-GRUPO VERDE",1
37,"37288",262,182,181,4,1,"RECORTES CERO-GRUPO VERDE",0
23,"23005",30465,20878,20630,177,248,"RECORTES CERO-GRUPO VERDE",25
50,"50250",52,44,44,0,0,"RECORTES CERO-GRUPO VERDE",0
34,"34146",51,40,39,0,1,"RECORTES CERO-GRUPO VERDE",0
21,"21016",1023,746,723,4,23,"RECORTES CERO-GRUPO VERDE",0
50,"50293",413,276,275,4,1,"RECORTES CERO-GRUPO VERDE",0
22,"22904",815,579,575,8,4,"RECORTES CERO-GRUPO VERDE",1
23,"23028",6220,4409,4369,23,40,"RECORTES CERO-GRUPO VERDE",8
50,"50256",83,53,53,0,0,"RECORTES CERO-GRUPO VERDE",0
34,"34046",41,36,35,0,1,"RECORTES CERO-GRUPO VERDE",0
24,"24019",354,272,267,3,5,"RECORTES CERO-GRUPO VERDE",0
29,"29068",7016,4300,4244,35,56,"RECORTES CERO-GRUPO VERDE",2
28,"28181",20386,16155,16069,57,86,"RECORTES CERO-GRUPO VERDE",7
44,"44153",1774,1135,1121,5,14,"RECORTES CERO-GRUPO VERDE",4
24,"24130",438,323,321,4,2,"RECORTES CERO-GRUPO VERDE",6
47,"47094",133,115,114,1,1,"RECORTES CERO-GRUPO VERDE",0
37,"37303",190,142,139,1,3,"RECORTES CERO-GRUPO VERDE",0
38,"38036",6592,4518,4440,45,78,"RECORTES CERO-GRUPO VERDE",14
28,"28031",2048,1500,1486,3,14,"RECORTES CERO-GRUPO VERDE",2
45,"45192",2491,2069,2049,2,20,"RECORTES CERO-GRUPO VERDE",0
5,"5245",353,286,285,3,1,"RECORTES CERO-GRUPO VERDE",0
16,"16264",435,366,364,2,2,"RECORTES CERO-GRUPO VERDE",0
12,"12029",702,557,555,4,2,"RECORTES CERO-GRUPO VERDE",0
24,"24108",376,280,277,2,3,"RECORTES CERO-GRUPO VERDE",0
16,"16216",315,268,265,1,3,"RECORTES CERO-GRUPO VERDE",0
27,"27039",4358,3143,3085,40,58,"RECORTES CERO-GRUPO VERDE",10
30,"30039",19277,13165,13054,75,111,"RECORTES CERO-GRUPO VERDE",21
34,"34110",88,71,71,1,0,"RECORTES CERO-GRUPO VERDE",0
44,"44082",89,78,77,0,1,"RECORTES CERO-GRUPO VERDE",0
38,"38001",20228,11032,10936,47,96,"RECORTES CERO-GRUPO VERDE",30
24,"24061",1704,1213,1204,9,9,"RECORTES CERO-GRUPO VERDE",1
8,"8147",16967,11220,11138,65,82,"RECORTES CERO-GRUPO VERDE",22
26,"26036",16986,11940,11816,66,124,"RECORTES CERO-GRUPO VERDE",24
25,"25058",4357,2624,2595,20,29,"RECORTES CERO-GRUPO VERDE",6
36,"36020",2318,1646,1620,18,26,"RECORTES CERO-GRUPO VERDE",1
30,"30010",6869,5194,5142,21,52,"RECORTES CERO-GRUPO VERDE",13
25,"25016",2107,1268,1259,14,9,"RECORTES CERO-GRUPO VERDE",2
18,"18023",15655,10879,10774,82,105,"RECORTES CERO-GRUPO VERDE",9
33,"33068",1093,645,641,4,4,"RECORTES CERO-GRUPO VERDE",1
25,"25148",219,124,124,0,0,"RECORTES CERO-GRUPO VERDE",0
8,"8037",1864,1242,1230,14,12,"RECORTES CERO-GRUPO VERDE",2
47,"47088",103,86,85,1,1,"RECORTES CERO-GRUPO VERDE",0
48,"48027",22150,15089,14982,78,107,"RECORTES CERO-GRUPO VERDE",17
50,"50139",313,241,239,3,2,"RECORTES CERO-GRUPO VERDE",0
5,"5135",425,317,315,5,2,"RECORTES CERO-GRUPO VERDE",0
43,"43163",25248,15802,15663,104,139,"RECORTES CERO-GRUPO VERDE",42
18,"18109",597,411,408,2,3,"RECORTES CERO-GRUPO VERDE",0
19,"19153",22,17,17,0,0,"RECORTES CERO-GRUPO VERDE",0
43,"43006",681,438,437,9,1,"RECORTES CERO-GRUPO VERDE",0
13,"13046",724,529,525,1,4,"RECORTES CERO-GRUPO VERDE",0
9,"9244",46,34,34,1,0,"RECORTES CERO-GRUPO VERDE",0
46,"46198",839,684,674,4,10,"RECORTES CERO-GRUPO VERDE",1
41,"41063",2695,1850,1830,13,20,"RECORTES CERO-GRUPO VERDE",1
17,"17033",5307,3264,3241,29,23,"RECORTES CERO-GRUPO VERDE",10
27,"27003",1876,1344,1320,12,24,"RECORTES CERO-GRUPO VERDE",3
16,"16240",102,78,78,0,0,"RECORTES CERO-GRUPO VERDE",0
50,"50254",180,118,116,1,2,"RECORTES CERO-GRUPO VERDE",0
26,"26105",2205,1670,1658,12,12,"RECORTES CERO-GRUPO VERDE",0
12,"12057",606,487,474,5,13,"RECORTES CERO-GRUPO VERDE",0
47,"47200",85,66,66,0,0,"RECORTES CERO-GRUPO VERDE",0
39,"39079",8874,6547,6478,47,69,"RECORTES CERO-GRUPO VERDE",6
4,"4080",209,162,162,3,0,"RECORTES CERO-GRUPO VERDE",1
42,"42010",19,14,14,1,0,"RECORTES CERO-GRUPO VERDE",0
40,"40171",32,23,23,0,0,"RECORTES CERO-GRUPO VERDE",0
5,"5183",138,111,110,0,1,"RECORTES CERO-GRUPO VERDE",0
38,"38015",4170,2862,2836,10,26,"RECORTES CERO-GRUPO VERDE",6
10,"10052",182,130,129,0,1,"RECORTES CERO-GRUPO VERDE",0
12,"12107",355,303,299,4,4,"RECORTES CERO-GRUPO VERDE",1
9,"9151",448,362,360,6,2,"RECORTES CERO-GRUPO VERDE",0
6,"6030",169,137,135,0,2,"RECORTES CERO-GRUPO VERDE",0
21,"21007",6225,4080,3999,52,81,"RECORTES CERO-GRUPO VERDE",15
9,"9194",2020,1472,1459,9,13,"RECORTES CERO-GRUPO VERDE",1
8,"8049",1293,790,779,3,11,"RECORTES CERO-GRUPO VERDE",0
16,"16175",5095,3980,3914,35,66,"RECORTES CERO-GRUPO VERDE",3
3,"3139",22437,15315,15170,100,145,"RECORTES CERO-GRUPO VERDE",33
10,"10063",173,139,137,0,2,"RECORTES CERO-GRUPO VERDE",0
37,"37151",148,125,124,2,1,"RECORTES CERO-GRUPO VERDE",0
23,"23076",827,640,630,1,10,"RECORTES CERO-GRUPO VERDE",1
8,"8159",14096,9393,9347,76,46,"RECORTES CERO-GRUPO VERDE",33
12,"12091",177,113,112,0,1,"RECORTES CERO-GRUPO VERDE",0
6,"6010",1105,819,801,5,18,"RECORTES CERO-GRUPO VERDE",0
46,"46165",7129,5436,5388,25,48,"RECORTES CERO-GRUPO VERDE",13
44,"44230",155,123,123,2,0,"RECORTES CERO-GRUPO VERDE",0
44,"44193",78,54,54,1,0,"RECORTES CERO-GRUPO VERDE",0
32,"32038",436,278,271,2,7,"RECORTES CERO-GRUPO VERDE",1
21,"21075",349,275,270,4,5,"RECORTES CERO-GRUPO VERDE",0
16,"16113",3077,2225,2202,10,23,"RECORTES CERO-GRUPO VERDE",2
32,"32021",947,634,630,5,4,"RECORTES CERO-GRUPO VERDE",0
10,"10079",894,662,648,7,14,"RECORTES CERO-GRUPO VERDE",2
39,"39010",631,480,475,7,5,"RECORTES CERO-GRUPO VERDE",0
25,"25069",451,247,246,4,1,"RECORTES CERO-GRUPO VERDE",2
15,"15011",15432,10395,10248,74,147,"RECORTES CERO-GRUPO VERDE",29
16,"16275",11,11,11,1,0,"RECORTES CERO-GRUPO VERDE",0
49,"49163",219,158,154,5,4,"RECORTES CERO-GRUPO VERDE",0
24,"24127",296,226,215,4,11,"RECORTES CERO-GRUPO VERDE",0
49,"49260",755,590,586,8,4,"RECORTES CERO-GRUPO VERDE",1
34,"34215",164,141,140,1,1,"RECORTES CERO-GRUPO VERDE",0
43,"43001",691,441,439,4,2,"RECORTES CERO-GRUPO VERDE",0
49,"49229",126,93,93,0,0,"RECORTES CERO-GRUPO VERDE",0
37,"37203",158,117,117,0,0,"RECORTES CERO-GRUPO VERDE",1
19,"19104",14,12,12,1,0,"RECORTES CERO-GRUPO VERDE",0
46,"46109",6150,4625,4556,25,69,"RECORTES CERO-GRUPO VERDE",5
39,"39059",7986,5879,5806,45,73,"RECORTES CERO-GRUPO VERDE",5
21,"21043",1871,1310,1285,9,25,"RECORTES CERO-GRUPO VERDE",6
9,"9904",478,374,370,5,4,"RECORTES CERO-GRUPO VERDE",1
37,"37233",61,48,47,1,1,"RECORTES CERO-GRUPO VERDE",0
12,"12065",188,169,169,2,0,"RECORTES CERO-GRUPO VERDE",0
10,"10036",329,241,238,1,3,"RECORTES CERO-GRUPO VERDE",1
31,"31082",617,371,365,10,6,"RECORTES CERO-GRUPO VERDE",2
29,"29061",1016,798,769,8,29,"RECORTES CERO-GRUPO VERDE",1
44,"44038",104,83,82,0,1,"RECORTES CERO-GRUPO VERDE",0
19,"19161",211,159,157,1,2,"RECORTES CERO-GRUPO VERDE",1
24,"24224",616,454,451,4,3,"RECORTES CERO-GRUPO VERDE",1
13,"13078",9041,6325,6266,47,59,"RECORTES CERO-GRUPO VERDE",7
47,"47214",1409,1087,1062,7,25,"RECORTES CERO-GRUPO VERDE",1
25,"25029",1655,1042,1029,15,13,"RECORTES CERO-GRUPO VERDE",0
44,"44173",101,81,79,2,2,"RECORTES CERO-GRUPO VERDE",0
3,"3041",5954,4218,4194,22,24,"RECORTES CERO-GRUPO VERDE",4
46,"46243",138,115,112,1,3,"RECORTES CERO-GRUPO VERDE",0
44,"44198",182,147,146,4,1,"RECORTES CERO-GRUPO VERDE",0
49,"49119",227,169,168,0,1,"RECORTES CERO-GRUPO VERDE",0
28,"28130",28293,21253,21040,116,213,"RECORTES CERO-GRUPO VERDE",60
33,"33020",13307,9011,8914,99,97,"RECORTES CERO-GRUPO VERDE",21
40,"40016",58,49,49,0,0,"RECORTES CERO-GRUPO VERDE",1
42,"42030",94,78,78,1,0,"RECORTES CERO-GRUPO VERDE",0
31,"31083",52,37,37,0,0,"RECORTES CERO-GRUPO VERDE",0
22,"22059",1149,807,800,3,7,"RECORTES CERO-GRUPO VERDE",2
40,"40013",62,49,48,0,1,"RECORTES CERO-GRUPO VERDE",0
37,"37087",862,639,635,2,4,"RECORTES CERO-GRUPO VERDE",1
50,"50153",935,713,708,6,5,"RECORTES CERO-GRUPO VERDE",1
43,"43176",785,523,520,4,3,"RECORTES CERO-GRUPO VERDE",1
36,"36057",236673,169244,167605,1366,1639,"RECORTES CERO-GRUPO VERDE",524
3,"3124",460,388,384,3,4,"RECORTES CERO-GRUPO VERDE",0
37,"37294",11692,8317,8221,71,96,"RECORTES CERO-GRUPO VERDE",16
27,"27059",2163,1570,1543,17,27,"RECORTES CERO-GRUPO VERDE",2
42,"42089",54,44,44,0,0,"RECORTES CERO-GRUPO VERDE",0
31,"31160",106,89,88,2,1,"RECORTES CERO-GRUPO VERDE",0
15,"15065",7315,5187,5099,42,88,"RECORTES CERO-GRUPO VERDE",8
17,"17084",238,146,144,5,2,"RECORTES CERO-GRUPO VERDE",1
43,"43166",1584,1029,1022,6,7,"RECORTES CERO-GRUPO VERDE",8
49,"49158",215,170,166,2,4,"RECORTES CERO-GRUPO VERDE",1
50,"50225",1570,956,950,3,6,"RECORTES CERO-GRUPO VERDE",2
6,"6085",3428,2453,2414,25,39,"RECORTES CERO-GRUPO VERDE",1
40,"40063",7096,5184,5100,36,84,"RECORTES CERO-GRUPO VERDE",5
9,"9355",98,75,75,0,0,"RECORTES CERO-GRUPO VERDE",0
16,"16134",4371,3288,3254,20,34,"RECORTES CERO-GRUPO VERDE",6
48,"48091",1121,771,765,7,6,"RECORTES CERO-GRUPO VERDE",0
43,"43089",292,190,186,0,4,"RECORTES CERO-GRUPO VERDE",2
33,"33023",3321,2299,2265,31,34,"RECORTES CERO-GRUPO VERDE",2
34,"34053",207,170,169,3,1,"RECORTES CERO-GRUPO VERDE",0
37,"37128",260,202,196,0,6,"RECORTES CERO-GRUPO VERDE",0
41,"41085",4086,3058,3012,22,46,"RECORTES CERO-GRUPO VERDE",0
12,"12137",36,23,23,0,0,"RECORTES CERO-GRUPO VERDE",0
49,"49133",304,214,213,1,1,"RECORTES CERO-GRUPO VERDE",0
12,"12115",219,179,177,0,2,"RECORTES CERO-GRUPO VERDE",0
34,"34186",52,45,45,0,0,"RECORTES CERO-GRUPO VERDE",0
49,"49241",248,177,177,0,0,"RECORTES CERO-GRUPO VERDE",0
40,"40129",177,148,147,1,1,"RECORTES CERO-GRUPO VERDE",0
28,"28175",863,670,668,5,2,"RECORTES CERO-GRUPO VERDE",0
46,"46123",1829,1407,1388,7,19,"RECORTES CERO-GRUPO VERDE",0
9,"9238",921,573,561,4,12,"RECORTES CERO-GRUPO VERDE",1
3,"3902",10254,6996,6930,34,66,"RECORTES CERO-GRUPO VERDE",6
22,"22041",163,134,134,1,0,"RECORTES CERO-GRUPO VERDE",0
6,"6130",195,164,158,0,6,"RECORTES CERO-GRUPO VERDE",0
26,"26151",448,370,368,1,2,"RECORTES CERO-GRUPO VERDE",2
19,"19189",120,91,90,2,1,"RECORTES CERO-GRUPO VERDE",0
39,"39014",883,619,614,6,5,"RECORTES CERO-GRUPO VERDE",0
50,"50240",1025,729,718,10,11,"RECORTES CERO-GRUPO VERDE",0
43,"43024",1537,993,983,8,10,"RECORTES CERO-GRUPO VERDE",0
38,"38039",10641,7547,7459,49,88,"RECORTES CERO-GRUPO VERDE",18
46,"46139",4485,3617,3574,18,43,"RECORTES CERO-GRUPO VERDE",3
34,"34079",1616,1222,1205,5,17,"RECORTES CERO-GRUPO VERDE",2
22,"22202",141,119,119,0,0,"RECORTES CERO-GRUPO VERDE",0
5,"5267",101,72,70,0,2,"RECORTES CERO-GRUPO VERDE",0
50,"50232",175,110,110,3,0,"RECORTES CERO-GRUPO VERDE",0
50,"50198",54,41,41,1,0,"RECORTES CERO-GRUPO VERDE",0
34,"34096",55,42,42,0,0,"RECORTES CERO-GRUPO VERDE",0
15,"15073",21827,14058,13864,126,194,"RECORTES CERO-GRUPO VERDE",42
17,"17201",135,87,84,0,3,"RECORTES CERO-GRUPO VERDE",1
50,"50202",152,100,99,1,1,"RECORTES CERO-GRUPO VERDE",0
18,"18094",2359,1744,1720,14,24,"RECORTES CERO-GRUPO VERDE",1
28,"28092",151841,110916,109954,582,962,"RECORTES CERO-GRUPO VERDE",278
43,"43020",2215,1508,1497,9,11,"RECORTES CERO-GRUPO VERDE",9
31,"31902",4405,3092,3061,25,31,"RECORTES CERO-GRUPO VERDE",13
23,"23017",1572,1269,1257,4,12,"RECORTES CERO-GRUPO VERDE",0
31,"31127",138,98,95,0,3,"RECORTES CERO-GRUPO VERDE",0
47,"47227",61,50,50,0,0,"RECORTES CERO-GRUPO VERDE",0
49,"49124",253,174,169,1,5,"RECORTES CERO-GRUPO VERDE",1
18,"18180",633,410,410,3,0,"RECORTES CERO-GRUPO VERDE",0
17,"17223",801,516,506,9,10,"RECORTES CERO-GRUPO VERDE",1
34,"34211",178,155,152,1,3,"RECORTES CERO-GRUPO VERDE",0
18,"18107",943,663,655,1,8,"RECORTES CERO-GRUPO VERDE",0
46,"46244",58771,42137,41867,270,270,"RECORTES CERO-GRUPO VERDE",111
44,"44149",103,78,78,3,0,"RECORTES CERO-GRUPO VERDE",0
31,"31066",855,589,579,8,10,"RECORTES CERO-GRUPO VERDE",1
12,"12088",62,59,59,0,0,"RECORTES CERO-GRUPO VERDE",0
50,"50200",511,410,403,2,7,"RECORTES CERO-GRUPO VERDE",0
3,"3023",1398,1184,1167,7,17,"RECORTES CERO-GRUPO VERDE",0
10,"10056",586,457,452,4,5,"RECORTES CERO-GRUPO VERDE",1
22,"22077",379,279,273,2,6,"RECORTES CERO-GRUPO VERDE",0
19,"19152",556,390,382,1,8,"RECORTES CERO-GRUPO VERDE",0
46,"46117",495,402,399,5,3,"REPO",0
46,"46156",2080,1697,1675,10,22,"REPO",2
46,"46036",564,383,378,5,5,"REPO",0
46,"46075",150,130,123,1,7,"REPO",0
46,"46144",663,532,529,2,3,"REPO",0
46,"46223",7801,5950,5899,34,51,"REPO",0
46,"46222",384,307,304,1,3,"REPO",0
46,"46050",194,150,149,0,1,"REPO",0
46,"46088",166,125,125,4,0,"REPO",0
46,"46169",32247,24214,24053,154,161,"REPO",16
46,"46246",1058,835,823,5,12,"REPO",0
46,"46142",787,619,602,1,17,"REPO",1
46,"46171",16563,12213,12128,85,85,"REPO",2
46,"46263",251,214,212,0,2,"REPO",0
46,"46251",2462,1997,1956,6,41,"REPO",0
46,"46062",4631,3511,3474,27,37,"REPO",0
46,"46135",9680,7682,7634,36,48,"REPO",0
46,"46119",780,653,647,5,6,"REPO",1
46,"46234",348,279,275,3,4,"REPO",0
46,"46072",3611,2871,2821,23,50,"REPO",0
46,"46038",327,242,242,3,0,"REPO",1
46,"46083",15422,11179,11049,86,130,"REPO",3
46,"46092",276,192,189,0,3,"REPO",0
46,"46023",327,280,278,2,2,"REPO",0
46,"46113",2457,1804,1782,6,22,"REPO",0
46,"46193",8788,6925,6871,50,54,"REPO",3
46,"46168",1938,1495,1486,2,9,"REPO",1
46,"46076",575,454,443,0,11,"REPO",0
46,"46160",1913,1452,1436,1,16,"REPO",2
46,"46220",48410,34644,34292,279,352,"REPO",12
46,"46188",672,544,537,8,7,"REPO",1
46,"46103",1264,1015,984,7,31,"REPO",0
46,"46189",467,393,390,2,3,"REPO",0
46,"46183",5993,4443,4381,19,62,"REPO",0
46,"46116",13159,10193,10135,53,58,"REPO",2
46,"46091",118,94,94,0,0,"REPO",0
46,"46022",15365,11093,10997,59,96,"REPO",9
46,"46071",464,383,377,0,6,"REPO",0
46,"46221",352,305,304,0,1,"REPO",0
46,"46155",1029,833,822,4,11,"REPO",0
46,"46078",28017,20288,20143,132,145,"REPO",35
46,"46146",1654,1304,1278,7,26,"REPO",0
46,"46218",1060,910,885,7,25,"REPO",0
46,"46109",6150,4625,4556,25,69,"REPO",3
46,"46051",8347,6355,6302,24,53,"REPO",1
46,"46020",3760,2916,2866,22,50,"REPO",2
46,"46025",2499,1953,1934,8,19,"REPO",0
46,"46112",536,455,450,2,5,"REPO",0
46,"46077",7496,5909,5827,45,82,"REPO",3
46,"46173",1328,1069,1057,4,12,"REPO",0
46,"46209",1933,1445,1415,5,30,"REPO",0
46,"46133",533,415,410,6,5,"REPO",0
46,"46001",795,601,592,3,9,"REPO",0
46,"46256",6853,4951,4890,25,61,"REPO",2
46,"46259",491,396,393,4,3,"REPO",0
46,"46249",9288,6746,6676,56,70,"REPO",1
46,"46154",808,636,631,5,5,"REPO",2
46,"46240",210,164,161,1,3,"REPO",0
46,"46145",21990,16337,16187,93,150,"REPO",8
46,"46058",1772,1398,1373,15,25,"REPO",1
46,"46052",499,421,417,2,4,"REPO",0
46,"46033",191,156,155,0,1,"REPO",0
46,"46125",847,689,684,5,5,"REPO",0
46,"46181",16955,12313,12148,95,165,"REPO",4
46,"46031",10535,7543,7451,66,92,"REPO",1
46,"46105",16190,11323,11206,44,117,"REPO",10
46,"46257",5571,4266,4224,25,42,"REPO",0
46,"46010",935,729,723,4,6,"REPO",0
46,"46215",1436,1154,1143,5,11,"REPO",0
46,"46084",1576,1263,1242,5,21,"REPO",0
46,"46085",11081,7938,7866,46,72,"REPO",0
46,"46192",761,576,570,5,6,"REPO",0
46,"46059",1261,1035,1019,9,16,"REPO",0
46,"46157",2980,2321,2298,10,23,"REPO",0
46,"46017",32949,23913,23685,142,228,"REPO",12
46,"46150",1831,1341,1333,7,8,"REPO",1
46,"46080",998,803,799,7,4,"REPO",0
46,"46242",333,267,266,0,1,"REPO",0
46,"46167",364,266,264,0,2,"REPO",0
46,"46219",127,112,112,1,0,"REPO",0
46,"46101",860,716,705,3,11,"REPO",0
46,"46201",64,52,51,1,1,"REPO",0
46,"46121",105,95,94,0,1,"REPO",0
46,"46208",1112,887,881,4,6,"REPO",0
46,"46138",343,275,272,1,3,"REPO",0
46,"46069",162,124,123,0,1,"REPO",0
46,"46044",4218,3222,3158,18,64,"REPO",0
46,"46018",608,515,511,0,4,"REPO",0
46,"46205",14313,10932,10834,51,98,"REPO",8
46,"46211",1745,1387,1378,8,9,"REPO",0
46,"46139",4485,3617,3574,18,43,"REPO",0
46,"46253",115,82,82,0,0,"REPO",0
46,"46003",950,791,769,1,22,"REPO",0
46,"46021",23649,17291,17153,100,138,"REPO",10
46,"46212",1620,1150,1124,9,26,"REPO",0
46,"46179",2165,1760,1737,16,23,"REPO",0
46,"46191",1937,1530,1505,5,25,"REPO",1
46,"46124",787,653,642,4,11,"REPO",0
46,"46054",11293,8477,8409,47,68,"REPO",1
46,"46128",1597,1290,1250,5,40,"REPO",0
46,"46097",963,733,728,4,5,"REPO",0
46,"46015",7244,5615,5560,40,55,"REPO",3
46,"46079",318,241,232,1,9,"REPO",0
46,"46082",4918,3745,3712,33,33,"REPO",0
46,"46227",905,711,702,1,9,"REPO",0
46,"46187",1306,1017,1000,0,17,"REPO",0
46,"46213",15409,10924,10805,97,119,"REPO",9
46,"46065",1579,1174,1163,8,11,"REPO",0
46,"46120",1113,903,875,2,28,"REPO",0
46,"46166",8155,6320,6251,30,69,"REPO",2
46,"46180",682,553,549,0,4,"REPO",0
46,"46153",439,355,351,1,4,"REPO",0
46,"46132",2150,1803,1784,7,19,"REPO",2
46,"46184",26505,20428,20223,115,205,"REPO",9
46,"46057",487,321,317,1,4,"REPO",0
46,"46049",281,232,224,0,8,"REPO",0
46,"46196",147,125,125,1,0,"REPO",0
46,"46170",3417,2714,2688,10,26,"REPO",1
46,"46147",16835,11920,11791,61,129,"REPO",7
46,"46053",553,445,436,2,9,"REPO",0
46,"46111",10930,7931,7828,44,103,"REPO",5
46,"46014",3030,2383,2350,20,33,"REPO",1
46,"46034",1758,1390,1379,4,11,"REPO",2
46,"46110",21228,15563,15443,86,120,"REPO",3
46,"46136",2537,1952,1930,11,22,"REPO",0
46,"46081",10134,7771,7702,41,69,"REPO",1
46,"46165",7129,5436,5388,25,48,"REPO",0
46,"46032",5653,4402,4361,33,41,"REPO",2
46,"46131",49431,36570,36227,231,343,"REPO",8
46,"46134",2357,1725,1712,14,13,"REPO",1
46,"46073",1092,888,884,6,4,"REPO",0
46,"46048",3452,2749,2713,14,36,"REPO",0
46,"46244",58771,42137,41867,270,270,"REPO",21
46,"46027",943,780,771,5,9,"REPO",1
46,"46114",569,461,458,1,3,"REPO",0
46,"46174",972,764,752,2,12,"REPO",0
46,"46229",948,762,758,0,4,"REPO",0
46,"46247",1006,714,710,3,4,"REPO",0
46,"46004",1922,1565,1547,11,18,"REPO",1
46,"46241",392,299,291,1,8,"REPO",0
46,"46137",270,210,207,4,3,"REPO",0
46,"46260",2581,2087,2068,22,19,"REPO",0
46,"46007",11989,8784,8711,67,73,"REPO",2
46,"46041",329,253,252,5,1,"REPO",0
46,"46902",364,306,303,0,3,"REPO",2
46,"46130",901,687,683,3,4,"REPO",0
46,"46230",13960,10351,10241,54,110,"REPO",5
46,"46016",1061,870,856,5,14,"REPO",0
46,"46129",524,420,412,4,8,"REPO",0
46,"46095",610,467,459,1,8,"REPO",0
46,"46216",5053,4109,4090,14,19,"REPO",1
46,"46164",11771,8564,8483,64,81,"REPO",11
46,"46060",9369,7052,6993,42,59,"REPO",1
46,"46199",5718,4314,4266,28,48,"REPO",3
46,"46066",1263,1024,1018,9,6,"REPO",0
46,"46042",3380,2799,2755,20,44,"REPO",0
46,"46177",4690,3579,3526,19,53,"REPO",3
46,"46202",16947,12814,12710,79,104,"REPO",3
46,"46089",2132,1602,1574,9,28,"REPO",0
46,"46024",413,314,313,2,1,"REPO",0
46,"46203",3606,2873,2844,9,29,"REPO",1
46,"46250",578719,442973,440154,2541,2819,"REPO",178
46,"46214",15766,12131,12036,42,95,"REPO",2
46,"46217",878,691,676,4,15,"REPO",0
46,"46185",378,320,313,2,7,"REPO",0
46,"46102",19788,15154,15038,89,116,"REPO",9
46,"46197",1942,1527,1514,5,13,"REPO",0
46,"46118",3763,2940,2908,16,32,"REPO",0
46,"46151",728,550,541,0,9,"REPO",0
46,"46163",1866,1504,1480,8,24,"REPO",1
46,"46149",363,271,268,2,3,"REPO",0
46,"46158",1026,811,795,6,16,"REPO",0
46,"46232",895,711,696,5,15,"REPO",1
46,"46903",6065,4790,4763,18,27,"REPO",1
46,"46045",1249,1028,1010,3,18,"REPO",0
46,"46195",1962,1531,1516,11,15,"REPO",0
46,"46210",330,277,277,2,0,"REPO",0
46,"46074",2696,2069,2038,14,31,"REPO",0
46,"46239",442,340,338,3,2,"REPO",0
46,"46030",800,627,614,5,13,"REPO",0
46,"46198",839,684,674,4,10,"REPO",1
46,"46204",6681,5256,5202,32,54,"REPO",3
46,"46178",4637,3405,3381,27,24,"REPO",0
46,"46262",223,162,159,2,3,"REPO",0
46,"46148",1513,1160,1146,7,14,"REPO",0
46,"46002",1175,941,932,5,9,"REPO",0
46,"46176",2017,1358,1349,5,9,"REPO",1
46,"46070",16950,12765,12676,61,89,"REPO",0
46,"46046",892,675,668,1,7,"REPO",0
46,"46245",511,420,415,0,5,"REPO",0
46,"46098",2482,1907,1889,11,18,"REPO",0
46,"46141",439,351,342,2,9,"REPO",0
46,"46086",82,70,69,1,1,"REPO",0
46,"46225",337,290,281,5,9,"REPO",0
46,"46248",4897,3596,3544,18,52,"REPO",0
46,"46127",2692,2120,2091,18,29,"REPO",0
46,"46126",5556,4449,4405,24,44,"REPO",5
46,"46039",2130,1728,1699,8,29,"REPO",2
46,"46206",571,453,445,2,8,"REPO",0
46,"46207",6676,5106,5040,41,66,"REPO",8
46,"46162",1189,938,929,3,9,"REPO",0
46,"46047",532,446,437,2,9,"REPO",0
46,"46026",1204,1015,1004,3,11,"REPO",1
46,"46029",20613,14964,14879,93,85,"REPO",7
46,"46099",901,689,684,1,5,"REPO",0
46,"46108",469,378,375,1,3,"REPO",0
46,"46194",15567,11156,11044,86,112,"REPO",7
46,"46064",509,412,399,1,13,"REPO",0
46,"46228",2348,1815,1794,7,21,"REPO",0
46,"46012",896,682,663,1,19,"REPO",0
46,"46904",792,610,603,8,7,"REPO",1
46,"46067",1753,1418,1393,1,25,"REPO",1
46,"46094",20540,15378,15234,102,144,"REPO",8
46,"46233",3860,2859,2817,10,42,"REPO",2
46,"46161",1483,1188,1173,7,15,"REPO",1
46,"46056",182,167,166,1,1,"REPO",1
46,"46172",5042,3504,3477,22,27,"REPO",1
46,"46236",972,818,809,2,9,"REPO",0
46,"46254",1000,785,779,6,6,"REPO",0
46,"46013",17383,13569,13483,82,86,"REPO",3
46,"46200",1903,1561,1539,3,22,"REPO",0
46,"46175",456,389,387,3,2,"REPO",0
46,"46122",2704,2082,2063,10,19,"REPO",1
46,"46123",1829,1407,1388,7,19,"REPO",0
46,"46009",3121,2459,2427,8,32,"REPO",2
46,"46043",136,124,124,0,0,"REPO",0
46,"46235",21579,15929,15763,113,166,"REPO",2
46,"46005",22918,16958,16827,102,131,"REPO",5
46,"46255",3174,2448,2424,22,24,"REPO",0
46,"46182",1266,929,922,6,7,"REPO",0
46,"46008",2651,2108,2089,21,19,"REPO",0
46,"46040",1078,888,878,7,10,"REPO",0
46,"46115",378,286,282,1,4,"REPO",0
46,"46037",1122,936,923,4,13,"REPO",0
46,"46063",1756,1367,1345,15,22,"REPO",1
46,"46068",346,276,266,6,10,"REPO",0
46,"46090",1637,1391,1367,3,24,"REPO",0
46,"46159",22857,16840,16697,128,143,"REPO",7
46,"46106",1535,1150,1140,10,10,"REPO",0
46,"46028",387,330,328,3,2,"REPO",0
46,"46096",274,209,209,1,0,"REPO",0
46,"46006",4523,3665,3623,20,42,"REPO",0
46,"46104",1940,1504,1487,7,17,"REPO",0
46,"46243",138,115,112,1,3,"REPO",0
46,"46019",8849,7072,7004,33,68,"REPO",5
46,"46152",96,68,68,0,0,"REPO",0
46,"46087",120,98,97,0,1,"REPO",0
46,"46238",13282,9786,9721,61,65,"REPO",3
46,"46186",19068,14599,14474,69,125,"REPO",4
46,"46055",1262,1025,1012,5,13,"REPO",0
46,"46190",48947,35638,35419,211,219,"REPO",9
46,"46140",344,284,279,0,5,"REPO",1
46,"46231",2421,1721,1708,14,13,"REPO",0
46,"46224",159,121,121,0,0,"REPO",0
46,"46100",286,232,230,1,2,"REPO",1
46,"46011",7609,5249,5191,26,58,"REPO",3
46,"46252",118,99,98,0,1,"REPO",0
46,"46107",1900,1516,1504,5,12,"REPO",0
46,"46093",2118,1647,1624,4,23,"REPO",0
46,"46237",7211,5395,5343,42,52,"REPO",2
46,"46061",342,274,272,1,2,"REPO",0
46,"46261",1725,1356,1337,5,19,"REPO",0
46,"46258",2652,2084,2062,16,22,"REPO",2
46,"46035",6822,5202,5142,43,60,"REPO",3
46,"46143",4239,3104,3053,14,51,"REPO",0
46,"46226",41,36,35,0,1,"REPO",0
47,"47040",64,53,53,0,0,"SAIn",0
19,"19241",43,34,34,1,0,"SAIn",0
19,"19016",65,49,49,0,0,"SAIn",2
9,"9482",33,28,28,0,0,"SAIn",0
39,"39065",252,191,189,1,2,"SAIn",0
31,"31903",6654,4402,4343,27,59,"SAIn",7
19,"19053",2008,1422,1404,10,18,"SAIn",1
28,"28176",12491,9723,9667,37,56,"SAIn",2
34,"34130",212,164,163,1,1,"SAIn",1
34,"34206",866,661,654,4,7,"SAIn",1
19,"19153",22,17,17,0,0,"SAIn",0
47,"47074",149,117,116,2,1,"SAIn",0
19,"19044",304,245,244,0,1,"SAIn",0
28,"28902",471,363,356,4,7,"SAIn",0
31,"31013",642,406,401,1,5,"SAIn",1
47,"47176",219,139,139,1,0,"SAIn",0
9,"9135",41,31,31,1,0,"SAIn",0
31,"31009",677,507,505,5,2,"SAIn",0
19,"19204",148,120,120,0,0,"SAIn",0
47,"47118",168,127,127,2,0,"SAIn",1
31,"31123",647,369,361,5,8,"SAIn",1
31,"31193",1426,1024,1013,13,11,"SAIn",2
34,"34238",330,268,266,3,2,"SAIn",0
31,"31056",174,121,120,0,1,"SAIn",0
15,"15060",5772,4032,3958,46,74,"SAIn",4
9,"9051",170,130,128,0,2,"SAIn",0
47,"47064",33,28,25,0,3,"SAIn",0
9,"9063",209,168,167,2,1,"SAIn",0
31,"31024",99,42,42,0,0,"SAIn",0
19,"19071",7840,5537,5489,45,48,"SAIn",1
9,"9211",1441,1056,1039,9,17,"SAIn",1
47,"47099",150,135,135,1,0,"SAIn",1
47,"47144",78,64,64,1,0,"SAIn",0
31,"31061",54,49,49,0,0,"SAIn",0
9,"9408",41,36,36,0,0,"SAIn",0
19,"19286",720,547,543,2,4,"SAIn",0
9,"9077",34,27,27,0,0,"SAIn",0
19,"19278",28,26,26,0,0,"SAIn",0
9,"9403",94,78,78,1,0,"SAIn",1
28,"28157",609,433,430,1,3,"SAIn",0
34,"34093",85,70,70,0,0,"SAIn",0
19,"19290",834,561,558,5,3,"SAIn",0
9,"9082",39,36,36,0,0,"SAIn",0
34,"34051",101,88,83,0,5,"SAIn",0
9,"9439",1028,752,744,9,8,"SAIn",1
31,"31027",836,532,530,2,2,"SAIn",0
19,"19232",71,57,57,1,0,"SAIn",0
19,"19175",32,28,28,0,0,"SAIn",0
34,"34140",107,67,67,0,0,"SAIn",0
47,"47005",549,413,408,2,5,"SAIn",0
28,"28122",513,375,370,2,5,"SAIn",0
31,"31901",15459,11119,11026,108,93,"SAIn",9
15,"15004",4834,3436,3391,30,45,"SAIn",2
9,"9039",58,46,46,2,0,"SAIn",0
47,"47138",241,170,164,1,6,"SAIn",0
9,"9052",29,23,23,0,0,"SAIn",0
47,"47009",107,86,85,0,1,"SAIn",0
19,"19233",80,65,63,1,2,"SAIn",0
9,"9463",264,195,195,7,0,"SAIn",0
39,"39052",18236,13537,13380,110,157,"SAIn",4
28,"28163",442,344,339,1,5,"SAIn",0
9,"9441",74,65,65,0,0,"SAIn",0
39,"39039",568,382,379,0,3,"SAIn",1
34,"34241",18,13,13,1,0,"SAIn",0
30,"30019",25857,17544,17374,125,170,"SAIn",7
9,"9148",87,70,68,3,2,"SAIn",0
31,"31166",258,181,181,1,0,"SAIn",0
35,"35021",14924,10477,10370,45,107,"SAIn",1
34,"34050",200,153,152,0,1,"SAIn",0
39,"39100",860,633,629,15,4,"SAIn",0
34,"34199",1218,918,899,10,19,"SAIn",0
34,"34112",46,38,37,0,1,"SAIn",0
31,"31257",875,634,625,8,9,"SAIn",0
15,"15058",27793,20392,20235,221,157,"SAIn",3
39,"39068",646,450,445,2,5,"SAIn",1
9,"9217",351,251,249,6,2,"SAIn",0
47,"47222",83,64,64,1,0,"SAIn",0
28,"28133",5979,4140,4098,18,42,"SAIn",0
31,"31075",103,63,63,0,0,"SAIn",1
31,"31042",2714,1974,1942,22,32,"SAIn",0
47,"47203",62,53,53,1,0,"SAIn",0
9,"9056",4919,3395,3344,20,51,"SAIn",5
19,"19211",369,289,284,0,5,"SAIn",0
34,"34192",90,75,72,0,3,"SAIn",0
34,"34063",83,76,75,1,1,"SAIn",0
9,"9476",62,43,43,0,0,"SAIn",0
31,"31122",4773,3520,3506,26,14,"SAIn",9
28,"28054",11257,8349,8273,55,76,"SAIn",1
15,"15081",1034,791,782,11,9,"SAIn",0
9,"9011",65,48,48,0,0,"SAIn",0
31,"31094",111,82,82,0,0,"SAIn",0
9,"9485",55,43,42,0,1,"SAIn",1
9,"9168",290,217,217,3,0,"SAIn",0
35,"35032",3412,2473,2425,17,48,"SAIn",4
39,"39024",1879,1390,1372,2,18,"SAIn",0
31,"31101",1373,973,966,8,7,"SAIn",0
9,"9060",145,114,113,2,1,"SAIn",0
19,"19317",139,110,109,1,1,"SAIn",0
34,"34009",31,29,29,1,0,"SAIn",0
15,"15020",3784,2476,2447,17,29,"SAIn",0
28,"28120",1223,892,884,2,8,"SAIn",1
9,"9151",448,362,360,6,2,"SAIn",0
9,"9372",212,176,176,4,0,"SAIn",0
19,"19019",20,18,17,0,1,"SAIn",0
39,"39087",41985,31178,30805,228,373,"SAIn",20
31,"31133",43,28,28,0,0,"SAIn",0
34,"34904",315,234,230,2,4,"SAIn",0
19,"19143",1738,1306,1297,12,9,"SAIn",1
19,"19125",41,32,32,0,0,"SAIn",0
34,"34179",28,21,20,0,1,"SAIn",0
19,"19319",4449,3086,3056,18,30,"SAIn",0
34,"34120",64214,47193,46683,331,510,"SAIn",28
9,"9432",182,145,138,0,7,"SAIn",0
34,"34114",207,144,144,0,0,"SAIn",0
28,"28058",139342,100637,99753,634,884,"SAIn",22
15,"15054",32106,21026,20772,259,254,"SAIn",10
19,"19252",69,60,60,0,0,"SAIn",0
34,"34029",714,587,570,3,17,"SAIn",0
39,"39048",1716,1329,1312,12,17,"SAIn",0
28,"28040",15811,10118,10009,56,109,"SAIn",1
9,"9268",95,68,66,0,2,"SAIn",0
9,"9012",89,64,63,0,1,"SAIn",0
9,"9075",112,91,91,3,0,"SAIn",0
15,"15077",8261,5186,5103,59,83,"SAIn",3
9,"9421",230,166,163,3,3,"SAIn",0
15,"15091",1135,771,760,13,11,"SAIn",0
19,"19134",24,15,15,0,0,"SAIn",0
19,"19102",98,79,78,0,1,"SAIn",0
9,"9007",57,39,39,0,0,"SAIn",0
28,"28131",12990,9512,9433,38,79,"SAIn",4
19,"19049",10,10,9,0,1,"SAIn",0
47,"47044",331,293,290,2,3,"SAIn",0
15,"15902",4598,3209,3149,51,60,"SAIn",2
31,"31113",133,87,86,0,1,"SAIn",0
34,"34185",63,38,37,2,1,"SAIn",0
19,"19037",141,115,114,1,1,"SAIn",0
28,"28137",1664,1232,1220,7,12,"SAIn",0
31,"31008",75,54,54,2,0,"SAIn",0
47,"47082",812,640,628,8,12,"SAIn",0
19,"19335",55,47,47,0,0,"SAIn",0
9,"9196",149,103,103,1,0,"SAIn",0
19,"19258",90,77,77,0,0,"SAIn",0
19,"19156",970,704,699,4,5,"SAIn",0
15,"15092",6438,3976,3903,28,73,"SAIn",2
47,"47101",1710,1357,1336,16,21,"SAIn",0
47,"47075",4856,3681,3637,24,44,"SAIn",0
31,"31004",35,21,21,0,0,"SAIn",0
19,"19105",2334,1753,1739,8,14,"SAIn",0
31,"31100",262,170,168,1,2,"SAIn",0
34,"34122",83,60,60,0,0,"SAIn",0
28,"28161",48848,35503,35203,210,300,"SAIn",6
9,"9190",86,58,56,0,2,"SAIn",0
47,"47214",1409,1087,1062,7,25,"SAIn",0
9,"9105",109,86,81,1,5,"SAIn",0
31,"31192",156,129,127,3,2,"SAIn",0
19,"19040",52,41,39,0,2,"SAIn",0
19,"19010",8,8,8,0,0,"SAIn",0
9,"9095",84,61,61,0,0,"SAIn",1
31,"31260",1238,794,788,12,6,"SAIn",0
15,"15901",3546,2247,2228,24,19,"SAIn",1
15,"15057",12075,8479,8377,66,102,"SAIn",1
19,"19048",18,15,15,1,0,"SAIn",0
34,"34155",129,104,103,2,1,"SAIn",1
19,"19194",98,69,69,1,0,"SAIn",0
28,"28166",320,254,251,2,3,"SAIn",0
31,"31197",69,56,56,2,0,"SAIn",0
28,"28118",57,46,45,0,1,"SAIn",0
31,"31017",358,242,239,0,3,"SAIn",0
47,"47006",190,136,135,1,1,"SAIn",0
31,"31003",122,87,87,0,0,"SAIn",0
34,"34127",93,65,64,1,1,"SAIn",0
19,"19195",40,32,32,1,0,"SAIn",0
9,"9201",28,18,18,1,0,"SAIn",0
19,"19011",250,184,184,0,0,"SAIn",0
31,"31223",985,704,698,4,6,"SAIn",0
9,"9472",55,45,44,0,1,"SAIn",0
34,"34017",918,744,736,9,8,"SAIn",1
15,"15083",1086,757,746,5,11,"SAIn",0
9,"9022",66,57,57,1,0,"SAIn",0
9,"9270",163,115,115,0,0,"SAIn",0
34,"34234",71,52,50,0,2,"SAIn",1
47,"47148",442,342,338,2,4,"SAIn",0
31,"31125",274,194,193,6,1,"SAIn",0
47,"47157",515,424,423,1,1,"SAIn",0
19,"19214",75,60,58,0,2,"SAIn",0
28,"28129",8030,5986,5941,42,45,"SAIn",0
28,"28052",3855,2626,2587,11,39,"SAIn",0
28,"28031",2048,1500,1486,3,14,"SAIn",0
9,"9355",98,75,75,0,0,"SAIn",0
15,"15073",21827,14058,13864,126,194,"SAIn",4
9,"9347",143,117,115,2,2,"SAIn",0
9,"9438",538,437,433,6,4,"SAIn",0
31,"31049",699,469,465,2,4,"SAIn",0
47,"47209",41,34,34,0,0,"SAIn",0
9,"9206",59,45,45,0,0,"SAIn",0
9,"9340",77,49,49,0,0,"SAIn",0
19,"19166",156,120,119,1,1,"SAIn",0
19,"19272",72,54,53,1,1,"SAIn",0
28,"28075",5621,4186,4148,26,38,"SAIn",2
31,"31053",523,372,368,1,4,"SAIn",0
31,"31203",40,28,28,0,0,"SAIn",0
9,"9163",582,467,459,2,8,"SAIn",0
47,"47015",200,162,160,0,2,"SAIn",0
9,"9003",194,147,146,0,1,"SAIn",0
34,"34147",166,118,117,0,1,"SAIn",0
47,"47033",196,154,154,1,0,"SAIn",0
19,"19269",102,81,80,0,1,"SAIn",0
19,"19057",76,59,59,1,0,"SAIn",0
9,"9321",1626,1238,1227,8,11,"SAIn",0
30,"30030",312993,231648,230185,1207,1463,"SAIn",96
47,"47142",141,99,97,0,2,"SAIn",0
47,"47007",3769,2765,2736,24,29,"SAIn",0
9,"9181",300,221,221,0,0,"SAIn",0
9,"9276",382,251,240,3,11,"SAIn",0
39,"39080",3542,2656,2628,20,28,"SAIn",1
15,"15064",2194,1592,1556,21,36,"SAIn",0
9,"9363",965,737,734,2,3,"SAIn",0
19,"19184",71,50,48,0,2,"SAIn",0
9,"9466",129,97,97,1,0,"SAIn",0
47,"47140",115,102,102,1,0,"SAIn",0
9,"9418",82,62,61,1,1,"SAIn",0
19,"19115",24,18,18,0,0,"SAIn",0
31,"31030",141,100,99,0,1,"SAIn",0
47,"47057",268,197,196,0,1,"SAIn",0
31,"31110",91,61,58,1,3,"SAIn",0
28,"28156",1019,742,738,3,4,"SAIn",0
31,"31256",107,59,59,0,0,"SAIn",0
28,"28175",863,670,668,5,2,"SAIn",0
9,"9067",437,295,294,6,1,"SAIn",0
28,"28153",697,499,499,1,0,"SAIn",6
19,"19260",42,39,39,1,0,"SAIn",0
9,"9346",92,64,63,1,1,"SAIn",0
31,"31111",95,65,65,2,0,"SAIn",0
15,"15090",1179,812,804,9,8,"SAIn",0
19,"19170",193,135,135,0,0,"SAIn",0
19,"19091",26,20,20,0,0,"SAIn",0
9,"9251",375,277,274,4,3,"SAIn",0
9,"9149",35,24,24,2,0,"SAIn",0
47,"47193",1577,1251,1241,7,10,"SAIn",0
9,"9253",109,94,91,1,3,"SAIn",1
19,"19117",1579,1135,1123,8,12,"SAIn",0
9,"9239",52,40,39,0,1,"SAIn",0
34,"34154",74,55,53,1,2,"SAIn",0
31,"31161",338,264,259,2,5,"SAIn",1
9,"9327",26,24,24,0,0,"SAIn",0
9,"9362",208,172,171,2,1,"SAIn",0
39,"39069",1972,1510,1489,12,21,"SAIn",0
19,"19254",45,34,34,0,0,"SAIn",0
19,"19283",30,25,25,0,0,"SAIn",0
19,"19246",46,36,34,2,2,"SAIn",0
28,"28149",5759,4352,4310,25,42,"SAIn",1
28,"28097",119,94,94,0,0,"SAIn",0
28,"28110",1944,1478,1463,4,15,"SAIn",0
19,"19064",70,64,64,2,0,"SAIn",0
28,"28168",1237,884,880,4,4,"SAIn",0
31,"31908",1004,686,682,2,4,"SAIn",0
9,"9246",620,451,444,2,7,"SAIn",0
39,"39070",144,96,94,2,2,"SAIn",0
15,"15038",2227,1463,1443,25,20,"SAIn",0
19,"19119",82,72,71,1,1,"SAIn",0
39,"39010",631,480,475,7,5,"SAIn",0
9,"9120",38,32,32,1,0,"SAIn",0
34,"34186",52,45,45,0,0,"SAIn",0
30,"30008",13918,9757,9645,59,112,"SAIn",4
34,"34071",171,132,132,1,0,"SAIn",0
47,"47232",102,77,74,1,3,"SAIn",0
9,"9016",85,60,59,3,1,"SAIn",0
15,"15023",6419,4348,4261,36,87,"SAIn",2
19,"19015",84,69,68,0,1,"SAIn",0
19,"19264",33,26,26,0,0,"SAIn",0
15,"15089",4291,3020,2972,28,48,"SAIn",1
9,"9395",138,104,104,0,0,"SAIn",0
31,"31248",299,165,162,0,3,"SAIn",0
9,"9257",93,81,80,4,1,"SAIn",0
31,"31182",34,28,28,0,0,"SAIn",0
47,"47096",140,110,110,0,0,"SAIn",0
34,"34062",171,119,118,2,1,"SAIn",0
28,"28034",361,274,269,1,5,"SAIn",0
47,"47043",297,239,237,0,2,"SAIn",0
19,"19052",25,21,21,1,0,"SAIn",0
19,"19146",41,35,32,0,3,"SAIn",0
19,"19024",8196,5613,5563,28,50,"SAIn",0
34,"34069",2266,1666,1637,11,29,"SAIn",0
34,"34103",98,77,76,0,1,"SAIn",0
47,"47035",921,717,715,3,2,"SAIn",0
19,"19098",19,17,17,0,0,"SAIn",0
30,"30010",6869,5194,5142,21,52,"SAIn",1
34,"34088",246,193,186,1,7,"SAIn",0
9,"9038",119,100,100,0,0,"SAIn",0
19,"19001",49,42,42,0,0,"SAIn",0
31,"31117",620,383,375,3,8,"SAIn",0
31,"31095",75,59,59,1,0,"SAIn",1
9,"9068",29,24,24,0,0,"SAIn",0
47,"47106",50,39,39,0,0,"SAIn",0
34,"34047",1782,1397,1374,12,23,"SAIn",1
19,"19108",111,97,96,0,1,"SAIn",0
35,"35013",6625,4896,4781,41,115,"SAIn",3
28,"28088",261,178,178,0,0,"SAIn",0
15,"15009",10739,7688,7559,54,129,"SAIn",4
28,"28143",72,57,57,1,0,"SAIn",0
9,"9026",386,301,300,0,1,"SAIn",1
19,"19054",192,164,164,1,0,"SAIn",0
35,"35014",11209,6016,5917,42,99,"SAIn",3
19,"19095",12,9,9,0,0,"SAIn",0
28,"28055",916,693,687,5,6,"SAIn",0
9,"9046",29,25,25,0,0,"SAIn",0
35,"35008",6131,4507,4459,34,48,"SAIn",4
31,"31001",88,62,62,0,0,"SAIn",0
19,"19080",65,41,41,0,0,"SAIn",0
31,"31115",165,102,101,1,1,"SAIn",0
31,"31130",312,214,213,3,1,"SAIn",0
47,"47164",378,313,311,1,2,"SAIn",0
9,"9906",1219,902,898,8,4,"SAIn",2
31,"31031",220,131,129,0,2,"SAIn",0
28,"28093",2096,1670,1653,10,17,"SAIn",0
47,"47172",144,124,122,0,2,"SAIn",0
34,"34246",67,53,51,0,2,"SAIn",0
39,"39014",883,619,614,6,5,"SAIn",1
9,"9311",59,46,45,0,1,"SAIn",0
9,"9310",13,9,8,0,1,"SAIn",0
28,"28025",420,320,315,4,5,"SAIn",0
47,"47230",303,246,242,2,4,"SAIn",0
19,"19038",28,24,23,0,1,"SAIn",0
31,"31006",1927,1350,1332,13,18,"SAIn",1
19,"19215",168,144,140,0,4,"SAIn",0
9,"9102",36,30,30,0,0,"SAIn",0
9,"9221",461,343,338,3,5,"SAIn",2
28,"28053",6498,4995,4955,28,40,"SAIn",4
19,"19135",107,90,90,3,0,"SAIn",0
9,"9392",53,40,37,1,3,"SAIn",0
19,"19159",93,78,77,0,1,"SAIn",0
31,"31190",45,34,32,2,2,"SAIn",0
47,"47083",80,59,54,1,5,"SAIn",0
19,"19277",19,13,13,0,0,"SAIn",0
34,"34080",5560,3723,3665,32,58,"SAIn",2
9,"9312",96,78,77,0,1,"SAIn",0
39,"39077",236,173,171,1,2,"SAIn",1
15,"15076",2611,1758,1739,17,19,"SAIn",0
28,"28076",398,325,317,1,8,"SAIn",0
19,"19179",69,56,56,1,0,"SAIn",0
9,"9050",68,56,55,1,1,"SAIn",0
9,"9908",449,307,306,3,1,"SAIn",0
28,"28002",3007,2091,2074,14,17,"SAIn",1
34,"34903",198,131,131,1,0,"SAIn",0
15,"15027",1536,1182,1155,6,27,"SAIn",0
39,"39017",569,398,391,4,7,"SAIn",0
34,"34146",51,40,39,0,1,"SAIn",0
47,"47063",103,81,80,1,1,"SAIn",0
9,"9326",140,112,111,0,1,"SAIn",0
39,"39047",1962,1385,1371,10,14,"SAIn",0
19,"19181",56,42,42,0,0,"SAIn",0
28,"28049",58480,45136,44820,242,316,"SAIn",9
31,"31134",176,125,124,0,1,"SAIn",0
19,"19145",46,41,41,1,0,"SAIn",0
34,"34012",357,269,264,5,5,"SAIn",1
19,"19060",146,119,118,1,1,"SAIn",0
19,"19182",38,34,33,0,1,"SAIn",0
35,"35001",4584,3282,3222,26,60,"SAIn",2
9,"9445",44,32,32,3,0,"SAIn",0
34,"34059",426,347,342,6,5,"SAIn",0
47,"47132",45,36,33,1,3,"SAIn",0
9,"9029",168,131,129,4,2,"SAIn",0
19,"19017",69,57,57,0,0,"SAIn",0
19,"19076",27,19,19,0,0,"SAIn",0
9,"9064",324,271,267,1,4,"SAIn",0
34,"34223",218,155,155,1,0,"SAIn",0
15,"15015",2799,2045,2008,24,37,"SAIn",0
47,"47094",133,115,114,1,1,"SAIn",0
19,"19151",1064,744,726,1,18,"SAIn",0
31,"31047",254,191,188,2,3,"SAIn",0
31,"31187",111,68,63,1,5,"SAIn",0
9,"9054",101,68,66,1,2,"SAIn",0
28,"28167",8356,6158,6106,46,52,"SAIn",1
31,"31102",143,69,69,0,0,"SAIn",0
19,"19288",21,21,20,0,1,"SAIn",0
9,"9901",371,263,259,4,4,"SAIn",1
31,"31169",2193,1472,1445,9,27,"SAIn",0
30,"30017",11605,8541,8451,46,90,"SAIn",1
47,"47068",34,26,26,0,0,"SAIn",0
39,"39101",274,197,192,3,5,"SAIn",0
31,"31226",591,342,340,2,2,"SAIn",0
9,"9317",19,16,16,0,0,"SAIn",0
19,"19281",21,15,15,2,0,"SAIn",0
34,"34136",179,110,110,1,0,"SAIn",1
39,"39009",3216,2366,2337,17,29,"SAIn",1
34,"34048",73,59,59,1,0,"SAIn",0
31,"31199",146,92,89,3,3,"SAIn",0
19,"19075",64,39,39,0,0,"SAIn",2
19,"19129",28,26,26,0,0,"SAIn",0
28,"28140",3007,2276,2256,7,20,"SAIn",1
9,"9449",86,68,66,0,2,"SAIn",1
28,"28178",1065,824,818,5,6,"SAIn",0
31,"31249",1872,1290,1273,14,17,"SAIn",0
15,"15056",5722,3869,3818,46,51,"SAIn",1
15,"15019",25888,16680,16460,186,220,"SAIn",9
28,"28151",3142,2235,2199,8,36,"SAIn",5
34,"34049",359,266,260,1,6,"SAIn",0
9,"9001",27,22,22,0,0,"SAIn",0
9,"9272",282,210,206,3,4,"SAIn",2
34,"34019",125,107,105,0,2,"SAIn",0
19,"19282",163,124,123,0,1,"SAIn",0
47,"47049",101,68,68,0,0,"SAIn",0
9,"9361",115,90,89,0,1,"SAIn",0
28,"28170",2472,1640,1622,13,18,"SAIn",0
31,"31907",10745,8067,8009,116,58,"SAIn",15
15,"15033",2472,1863,1845,8,18,"SAIn",0
31,"31039",80,61,60,0,1,"SAIn",0
47,"47097",325,266,265,0,1,"SAIn",0
31,"31168",246,172,171,1,1,"SAIn",0
39,"39073",9837,7356,7298,31,58,"SAIn",2
19,"19243",44,31,31,0,0,"SAIn",0
9,"9338",227,170,169,0,1,"SAIn",0
31,"31128",359,265,263,0,2,"SAIn",0
19,"19013",125,108,108,1,0,"SAIn",0
9,"9447",44,41,41,0,0,"SAIn",0
9,"9292",87,75,73,1,2,"SAIn",0
9,"9100",59,45,44,0,1,"SAIn",0
9,"9274",1079,848,835,12,13,"SAIn",0
39,"39084",838,631,624,2,7,"SAIn",0
19,"19112",60,46,46,0,0,"SAIn",0
28,"28008",1799,1182,1174,4,8,"SAIn",0
47,"47189",152,119,118,0,1,"SAIn",0
19,"19325",121,83,82,0,1,"SAIn",0
31,"31229",47,35,35,0,0,"SAIn",0
39,"39013",511,402,399,4,3,"SAIn",0
19,"19248",78,63,63,0,0,"SAIn",1
19,"19326",1841,1280,1272,1,8,"SAIn",1
31,"31063",92,75,73,2,2,"SAIn",0
34,"34189",56,44,44,1,0,"SAIn",0
15,"15059",10362,7258,7106,91,152,"SAIn",7
31,"31141",110,71,70,1,1,"SAIn",0
19,"19177",76,61,59,0,2,"SAIn",0
9,"9325",190,130,129,2,1,"SAIn",0
19,"19225",823,623,619,3,4,"SAIn",0
34,"34023",5236,3685,3636,30,49,"SAIn",1
34,"34161",23,16,16,0,0,"SAIn",0
31,"31108",1855,1368,1348,7,20,"SAIn",0
28,"28104",14040,11151,11096,57,55,"SAIn",1
39,"39055",1086,824,816,6,8,"SAIn",0
15,"15036",57885,39471,39096,417,375,"SAIn",17
30,"30033",10188,7403,7285,68,118,"SAIn",1
34,"34214",183,144,144,0,0,"SAIn",0
9,"9200",50,32,31,0,1,"SAIn",0
9,"9405",130,98,96,0,2,"SAIn",0
9,"9192",55,43,43,0,0,"SAIn",0
9,"9907",1420,1058,1041,12,17,"SAIn",0
9,"9235",156,132,131,3,1,"SAIn",0
9,"9061",162,124,123,0,1,"SAIn",0
9,"9184",5,4,4,0,0,"SAIn",0
47,"47205",384,266,260,0,6,"SAIn",0
19,"19323",40,31,31,0,0,"SAIn",0
47,"47165",6955,4955,4303,66,652,"SAIn",0
39,"39066",872,667,661,4,6,"SAIn",0
28,"28116",704,528,523,2,5,"SAIn",0
9,"9209",4473,3223,3192,20,31,"SAIn",3
15,"15012",3627,2659,2602,28,57,"SAIn",0
31,"31198",37,25,25,0,0,"SAIn",0
15,"15001",4765,3280,3237,25,43,"SAIn",1
34,"34233",130,107,107,1,0,"SAIn",0
47,"47121",544,437,425,6,12,"SAIn",0
28,"28066",7182,5422,5371,17,51,"SAIn",4
47,"47047",199,157,156,2,1,"SAIn",0
31,"31077",5352,3908,3848,41,60,"SAIn",2
9,"9279",174,131,130,3,1,"SAIn",0
47,"47022",59,50,49,0,1,"SAIn",0
19,"19251",43,29,28,0,1,"SAIn",0
9,"9407",28,23,23,0,0,"SAIn",0
28,"28901",799,558,554,0,4,"SAIn",0
28,"28064",129,106,106,2,0,"SAIn",0
34,"34102",205,169,168,1,1,"SAIn",0
19,"19192",1736,1324,1308,8,16,"SAIn",0
47,"47131",170,134,128,2,6,"SAIn",0
9,"9329",121,87,87,1,0,"SAIn",0
39,"39057",2330,1671,1645,7,26,"SAIn",0
31,"31211",27,15,15,1,0,"SAIn",0
47,"47184",573,453,451,1,2,"SAIn",0
34,"34072",152,136,135,2,1,"SAIn",0
15,"15002",23083,16073,15889,159,184,"SAIn",18
35,"35009",19905,14185,13961,89,224,"SAIn",7
9,"9460",176,131,131,1,0,"SAIn",3
31,"31012",793,563,555,6,8,"SAIn",0
15,"15028",1409,1038,1024,6,14,"SAIn",2
9,"9225",83,55,54,0,1,"SAIn",0
47,"47213",109,82,82,0,0,"SAIn",0
28,"28059",4323,3171,3157,11,14,"SAIn",0
19,"19092",409,306,300,1,6,"SAIn",0
31,"31157",3518,2298,2267,23,31,"SAIn",2
9,"9446",12,7,7,0,0,"SAIn",0
15,"15053",7729,5089,5043,49,46,"SAIn",5
9,"9398",75,56,56,0,0,"SAIn",0
15,"15013",6151,4237,4189,48,48,"SAIn",5
31,"31213",104,52,52,0,0,"SAIn",0
28,"28013",40471,28739,28490,188,249,"SAIn",2
34,"34089",155,124,124,2,0,"SAIn",0
47,"47024",259,208,207,1,1,"SAIn",0
9,"9380",78,58,58,0,0,"SAIn",0
19,"19220",2302,1519,1501,1,18,"SAIn",0
34,"34123",1648,1287,1258,12,29,"SAIn",1
9,"9241",202,156,154,4,2,"SAIn",0
28,"28138",60,46,46,0,0,"SAIn",0
34,"34170",61,42,42,0,0,"SAIn",0
31,"31081",338,216,212,4,4,"SAIn",2
19,"19133",83,72,72,0,0,"SAIn",0
47,"47177",105,76,73,1,3,"SAIn",0
35,"35002",23328,15495,15313,94,182,"SAIn",3
19,"19039",61,54,54,1,0,"SAIn",0
31,"31070",2638,1808,1784,20,24,"SAIn",0
31,"31071",17,16,16,0,0,"SAIn",0
31,"31023",6956,5310,5289,85,21,"SAIn",15
9,"9079",49,45,45,0,0,"SAIn",0
39,"39041",1760,1370,1354,9,16,"SAIn",0
34,"34124",60,50,49,0,1,"SAIn",0
39,"39030",1895,1225,1212,10,13,"SAIn",0
28,"28089",3677,2748,2730,10,18,"SAIn",1
9,"9154",137,98,97,2,1,"SAIn",0
28,"28169",1448,1122,1113,5,9,"SAIn",0
39,"39082",1653,1173,1157,11,16,"SAIn",0
19,"19023",124,100,98,2,2,"SAIn",0
34,"34213",57,45,44,1,1,"SAIn",0
9,"9112",109,85,85,0,0,"SAIn",0
31,"31227",8180,5885,5809,76,76,"SAIn",3
34,"34108",542,421,417,3,4,"SAIn",0
28,"28121",198,160,158,1,2,"SAIn",1
47,"47196",34,27,27,0,0,"SAIn",0
47,"47224",87,76,76,0,0,"SAIn",0
31,"31083",52,37,37,0,0,"SAIn",0
19,"19234",43,33,33,0,0,"SAIn",0
31,"31116",62,51,50,1,1,"SAIn",0
39,"39032",1463,1087,1081,7,6,"SAIn",1
19,"19078",50,44,43,0,1,"SAIn",0
28,"28109",1576,1103,1098,1,5,"SAIn",0
47,"47070",37,27,27,0,0,"SAIn",0
31,"31194",311,217,216,3,1,"SAIn",0
19,"19111",155,126,126,1,0,"SAIn",1
9,"9030",112,75,73,1,2,"SAIn",0
9,"9113",449,339,332,4,7,"SAIn",1
19,"19027",138,105,105,1,0,"SAIn",0
31,"31217",321,226,223,1,3,"SAIn",0
28,"28171",4239,2848,2820,19,28,"SAIn",0
28,"28082",5683,4324,4286,25,38,"SAIn",0
30,"30031",492,409,401,0,8,"SAIn",0
19,"19165",47,41,41,0,0,"SAIn",0
28,"28092",151841,110916,109954,582,962,"SAIn",22
9,"9189",125,90,87,2,3,"SAIn",0
34,"34196",89,68,68,1,0,"SAIn",0
30,"30011",4697,3421,3383,15,38,"SAIn",1
34,"34052",174,135,133,0,2,"SAIn",0
19,"19285",24,21,21,1,0,"SAIn",0
9,"9084",186,136,135,4,1,"SAIn",0
30,"30002",9903,7011,6943,28,68,"SAIn",5
9,"9454",43,34,33,0,1,"SAIn",0
28,"28172",9077,6992,6936,31,56,"SAIn",0
34,"34129",179,130,129,1,1,"SAIn",0
31,"31219",84,66,66,0,0,"SAIn",0
19,"19124",386,260,257,0,3,"SAIn",0
47,"47029",57,52,52,0,0,"SAIn",0
39,"39004",1518,1090,1074,4,16,"SAIn",0
47,"47028",33,21,21,0,0,"SAIn",0
47,"47218",993,743,734,2,9,"SAIn",0
39,"39095",2266,1760,1726,14,34,"SAIn",0
34,"34039",61,49,47,0,2,"SAIn",0
15,"15086",2869,1970,1950,13,20,"SAIn",2
31,"31175",71,48,48,0,0,"SAIn",0
9,"9248",78,59,59,1,0,"SAIn",2
31,"31220",744,583,579,8,4,"SAIn",1
19,"19114",37,26,26,0,0,"SAIn",0
30,"30901",10309,7821,7718,43,103,"SAIn",2
34,"34901",1104,825,814,5,11,"SAIn",0
19,"19122",96,68,68,1,0,"SAIn",0
47,"47162",74,60,60,0,0,"SAIn",0
9,"9389",73,60,60,1,0,"SAIn",0
19,"19074",72,62,62,0,0,"SAIn",0
19,"19202",8,6,6,0,0,"SAIn",0
39,"39005",1380,1053,1046,9,7,"SAIn",0
31,"31055",257,175,172,2,3,"SAIn",1
30,"30034",1129,858,844,7,14,"SAIn",0
19,"19046",21588,15689,15515,82,174,"SAIn",4
9,"9358",255,194,190,3,4,"SAIn",1
19,"19034",22,16,16,0,0,"SAIn",0
9,"9345",123,93,91,2,2,"SAIn",0
19,"19126",1627,1155,1134,11,21,"SAIn",0
34,"34086",103,89,88,0,1,"SAIn",0
9,"9166",97,81,81,0,0,"SAIn",0
31,"31022",518,332,331,4,1,"SAIn",0
28,"28107",457,312,312,0,0,"SAIn",0
9,"9088",66,45,45,0,0,"SAIn",0
31,"31177",255,169,166,2,3,"SAIn",0
28,"28095",1529,1119,1106,6,13,"SAIn",0
31,"31144",796,445,444,6,1,"SAIn",0
9,"9390",611,484,482,3,2,"SAIn",0
34,"34087",129,103,102,1,1,"SAIn",0
47,"47192",102,83,81,1,2,"SAIn",0
19,"19090",91,73,73,1,0,"SAIn",0
9,"9122",94,67,66,1,1,"SAIn",0
28,"28021",554,370,364,3,6,"SAIn",0
28,"28078",38,32,32,0,0,"SAIn",0
9,"9179",41,32,32,1,0,"SAIn",0
9,"9224",162,131,131,1,0,"SAIn",0
9,"9302",112,83,83,1,0,"SAIn",0
15,"15052",4314,2889,2838,21,51,"SAIn",2
19,"19118",11,9,9,0,0,"SAIn",0
34,"34222",120,87,87,3,0,"SAIn",0
31,"31224",893,671,662,3,9,"SAIn",0
34,"34169",404,287,286,0,1,"SAIn",0
30,"30016",151668,102093,101363,484,730,"SAIn",31
15,"15066",4009,2814,2776,33,38,"SAIn",2
34,"34121",187,148,148,3,0,"SAIn",0
19,"19219",13,9,9,0,0,"SAIn",0
19,"19279",57,55,55,0,0,"SAIn",0
34,"34135",399,293,289,0,4,"SAIn",0
31,"31025",766,524,518,6,6,"SAIn",0
28,"28148",85454,62367,61884,370,483,"SAIn",23
28,"28060",1510,1134,1117,1,17,"SAIn",0
15,"15029",5688,3590,3544,32,46,"SAIn",0
47,"47194",298,239,237,2,2,"SAIn",0
19,"19280",3464,2469,2438,14,31,"SAIn",0
9,"9394",715,533,521,3,12,"SAIn",0
47,"47059",97,76,76,2,0,"SAIn",0
19,"19050",16,15,15,0,0,"SAIn",0
9,"9065",143,122,122,1,0,"SAIn",0
47,"47169",68,59,59,0,0,"SAIn",0
31,"31180",212,154,154,5,0,"SAIn",0
9,"9287",208,158,156,3,2,"SAIn",0
31,"31158",255,180,179,3,1,"SAIn",0
31,"31258",7879,5707,5666,50,41,"SAIn",5
31,"31104",1834,1257,1235,16,22,"SAIn",1
34,"34061",106,82,82,1,0,"SAIn",0
47,"47087",381,301,297,3,4,"SAIn",0
19,"19096",91,72,69,0,3,"SAIn",0
28,"28071",60,55,53,1,2,"SAIn",0
31,"31159",1107,844,833,6,11,"SAIn",0
28,"28150",3087,2294,2277,10,17,"SAIn",0
15,"15006",5321,3341,3283,49,58,"SAIn",2
31,"31060",13744,9400,9320,72,80,"SAIn",15
19,"19173",45,38,36,0,2,"SAIn",0
31,"31148",92,69,69,5,0,"SAIn",0
31,"31093",292,188,188,2,0,"SAIn",1
19,"19081",29,22,22,1,0,"SAIn",0
9,"9396",156,121,121,0,0,"SAIn",0
28,"28090",8505,6654,6609,33,45,"SAIn",0
19,"19245",1155,855,835,5,20,"SAIn",0
9,"9172",129,103,101,1,2,"SAIn",0
31,"31138",932,601,599,2,2,"SAIn",0
35,"35004",39299,20523,20294,140,229,"SAIn",7
31,"31127",138,98,95,0,3,"SAIn",0
30,"30040",732,617,607,2,10,"SAIn",0
9,"9903",3221,2304,2281,27,23,"SAIn",0
47,"47062",163,130,130,0,0,"SAIn",0
9,"9044",46,35,34,1,1,"SAIn",0
28,"28091",5440,3596,3558,24,38,"SAIn",0
34,"34003",164,122,119,0,3,"SAIn",0
31,"31228",486,341,337,2,4,"SAIn",1
28,"28113",34751,25832,25612,120,220,"SAIn",5
19,"19187",48,43,43,0,0,"SAIn",0
31,"31051",251,170,170,2,0,"SAIn",0
19,"19270",20,17,17,0,0,"SAIn",0
9,"9308",67,42,42,1,0,"SAIn",0
9,"9160",85,64,64,0,0,"SAIn",0
15,"15072",9574,6637,6562,35,75,"SAIn",0
9,"9140",124,80,79,0,1,"SAIn",0
28,"28162",2617,2029,2016,6,13,"SAIn",0
47,"47127",137,98,97,0,1,"SAIn",0
28,"28073",12549,8788,8701,54,87,"SAIn",3
15,"15046",6332,4377,4262,40,115,"SAIn",2
9,"9058",390,283,279,1,4,"SAIn",0
9,"9261",469,332,329,2,3,"SAIn",0
9,"9354",33,29,28,2,1,"SAIn",0
9,"9369",436,319,316,1,3,"SAIn",1
9,"9400",317,247,245,1,2,"SAIn",0
34,"34005",851,673,658,4,15,"SAIn",1
31,"31129",395,234,234,0,0,"SAIn",0
9,"9219",27509,19084,18859,146,225,"SAIn",14
35,"35023",11686,8212,8076,55,136,"SAIn",2
31,"31263",233,138,137,2,1,"SAIn",1
9,"9130",74,51,50,1,1,"SAIn",0
47,"47037",168,138,133,0,5,"SAIn",0
9,"9175",127,94,93,2,1,"SAIn",0
31,"31230",106,82,82,1,0,"SAIn",0
9,"9176",63,47,46,2,1,"SAIn",0
28,"28154",5408,3806,3767,16,39,"SAIn",2
28,"28124",74,54,54,1,0,"SAIn",0
31,"31098",1903,1428,1419,19,9,"SAIn",4
9,"9033",90,74,74,1,0,"SAIn",0
19,"19103",251,208,208,2,0,"SAIn",0
28,"28056",863,630,617,4,13,"SAIn",1
9,"9047",54,47,46,1,1,"SAIn",0
15,"15037",4061,2588,2552,19,36,"SAIn",0
47,"47046",118,92,90,1,2,"SAIn",0
19,"19033",64,52,50,1,2,"SAIn",0
9,"9277",120,101,99,0,2,"SAIn",0
15,"15075",12336,8830,8725,91,105,"SAIn",1
15,"15050",1822,1004,988,13,16,"SAIn",1
31,"31087",171,128,124,2,4,"SAIn",0
9,"9103",217,184,183,1,1,"SAIn",0
9,"9430",22,18,17,0,1,"SAIn",0
19,"19216",131,98,98,0,0,"SAIn",0
39,"39016",23868,17883,17701,122,182,"SAIn",6
47,"47092",110,87,87,0,0,"SAIn",0
34,"34220",147,126,125,3,1,"SAIn",0
19,"19005",84,66,66,0,0,"SAIn",0
47,"47065",857,674,669,1,5,"SAIn",0
28,"28001",61,46,45,0,1,"SAIn",0
34,"34149",23,18,18,0,0,"SAIn",0
31,"31099",62,47,47,2,0,"SAIn",0
9,"9444",72,58,58,3,0,"SAIn",0
34,"34101",50,41,41,0,0,"SAIn",0
9,"9133",40,32,32,0,0,"SAIn",0
34,"34057",471,339,338,1,1,"SAIn",0
19,"19036",263,229,229,0,0,"SAIn",0
39,"39007",417,278,275,2,3,"SAIn",0
47,"47066",1268,981,977,12,4,"SAIn",1
28,"28096",18354,13310,13205,68,105,"SAIn",1
28,"28126",39,29,29,0,0,"SAIn",0
15,"15065",7315,5187,5099,42,88,"SAIn",3
39,"39078",1401,975,963,5,12,"SAIn",0
9,"9314",94,73,70,0,3,"SAIn",1
47,"47229",210,148,147,1,1,"SAIn",0
19,"19229",66,56,56,0,0,"SAIn",0
28,"28068",10955,8136,8076,49,60,"SAIn",3
34,"34058",189,172,172,2,0,"SAIn",0
31,"31902",4405,3092,3061,25,31,"SAIn",4
19,"19020",44,30,30,1,0,"SAIn",0
28,"28087",3186,2503,2487,19,16,"SAIn",0
31,"31167",826,606,596,9,10,"SAIn",1
9,"9180",142,107,102,1,5,"SAIn",2
15,"15078",78198,56154,55581,560,573,"SAIn",68
34,"34031",30,30,29,0,1,"SAIn",0
19,"19242",87,65,65,1,0,"SAIn",0
19,"19265",122,97,95,2,2,"SAIn",0
28,"28003",173,141,141,0,0,"SAIn",0
47,"47123",466,354,352,4,2,"SAIn",0
31,"31201",147715,105455,104658,1007,797,"SAIn",277
34,"34208",51,42,42,0,0,"SAIn",0
47,"47103",267,197,192,5,5,"SAIn",0
31,"31146",35,30,29,1,1,"SAIn",0
31,"31036",909,636,628,7,8,"SAIn",4
31,"31135",106,70,66,2,4,"SAIn",1
28,"28032",4762,3428,3401,19,27,"SAIn",0
19,"19332",92,71,69,1,2,"SAIn",0
31,"31904",1563,1029,1022,23,7,"SAIn",1
47,"47016",69,56,55,0,1,"SAIn",0
47,"47231",4401,3299,3277,24,22,"SAIn",1
35,"35020",6034,3992,3934,20,58,"SAIn",0
19,"19022",625,476,469,3,7,"SAIn",0
31,"31103",42,34,34,2,0,"SAIn",0
28,"28042",1173,890,883,3,7,"SAIn",0
15,"15055",4572,3070,3013,27,57,"SAIn",3
9,"9127",56,41,39,0,2,"SAIn",0
34,"34107",81,52,51,5,1,"SAIn",0
19,"19322",31,25,25,0,0,"SAIn",0
47,"47152",78,60,60,0,0,"SAIn",0
47,"47178",172,140,140,3,0,"SAIn",0
47,"47115",281,236,233,3,3,"SAIn",0
47,"47017",201,158,153,1,5,"SAIn",1
47,"47069",124,105,104,1,1,"SAIn",0
47,"47060",258,216,214,1,2,"SAIn",0
31,"31204",36,28,28,1,0,"SAIn",0
9,"9902",458,331,327,3,4,"SAIn",0
19,"19110",56,50,50,0,0,"SAIn",0
15,"15070",9069,6090,5976,94,114,"SAIn",4
9,"9017",89,68,67,4,1,"SAIn",0
39,"39021",487,381,376,2,5,"SAIn",0
34,"34034",123,95,95,1,0,"SAIn",0
15,"15045",3770,2184,2157,14,27,"SAIn",0
31,"31238",112,93,93,0,0,"SAIn",0
19,"19066",55,48,48,0,0,"SAIn",0
31,"31906",2562,1800,1779,26,21,"SAIn",5
47,"47126",50,41,41,0,0,"SAIn",0
47,"47018",34,28,28,0,0,"SAIn",0
34,"34158",288,186,184,3,2,"SAIn",0
47,"47179",395,293,287,0,6,"SAIn",0
28,"28101",231,187,187,0,0,"SAIn",0
30,"30020",6303,4543,4497,25,46,"SAIn",2
47,"47080",30,22,21,0,1,"SAIn",0
9,"9173",124,100,99,2,1,"SAIn",0
34,"34094",64,45,44,0,1,"SAIn",0
31,"31240",527,327,326,2,1,"SAIn",1
47,"47071",410,324,321,4,3,"SAIn",1
19,"19086",1473,1123,1111,7,12,"SAIn",0
15,"15084",3260,2218,2191,27,27,"SAIn",1
9,"9070",34,26,26,0,0,"SAIn",0
19,"19199",17,17,17,1,0,"SAIn",0
15,"15021",5127,3587,3543,38,44,"SAIn",0
28,"28180",5251,3927,3893,7,34,"SAIn",1
34,"34096",55,42,42,0,0,"SAIn",0
47,"47098",576,464,452,4,12,"SAIn",0
47,"47054",635,507,495,9,12,"SAIn",1
47,"47198",69,50,50,0,0,"SAIn",0
28,"28102",894,644,636,6,8,"SAIn",0
47,"47128",60,52,51,0,1,"SAIn",0
28,"28036",2539,1899,1878,11,21,"SAIn",0
34,"34216",66,50,50,0,0,"SAIn",0
9,"9059",136488,101469,100463,907,1006,"SAIn",187
31,"31107",1710,1255,1243,16,12,"SAIn",0
28,"28009",14086,10611,10545,57,66,"SAIn",5
9,"9020",259,196,188,5,8,"SAIn",0
9,"9415",268,175,175,2,0,"SAIn",0
31,"31174",110,63,63,0,0,"SAIn",0
39,"39085",6836,5086,5032,44,54,"SAIn",2
35,"35006",30457,21398,21118,162,280,"SAIn",14
47,"47155",3228,2277,2254,18,23,"SAIn",0
19,"19032",165,126,124,1,2,"SAIn",0
47,"47156",162,136,133,0,3,"SAIn",0
39,"39056",2286,1714,1684,8,30,"SAIn",1
19,"19261",37,25,24,0,1,"SAIn",0
34,"34113",38,36,36,0,0,"SAIn",0
31,"31264",180,105,101,2,4,"SAIn",0
31,"31032",1713,1209,1193,24,16,"SAIn",0
47,"47129",871,664,659,4,5,"SAIn",0
9,"9086",666,462,459,2,3,"SAIn",0
31,"31010",5705,3718,3680,29,38,"SAIn",2
19,"19178",33,22,22,0,0,"SAIn",0
31,"31132",145,109,109,0,0,"SAIn",0
28,"28174",1795,1232,1221,7,11,"SAIn",0
39,"39025",8637,6486,6378,47,108,"SAIn",3
28,"28106",76907,52773,52265,385,508,"SAIn",22
9,"9073",926,691,686,4,5,"SAIn",0
28,"28146",1787,1205,1194,0,11,"SAIn",0
28,"28085",3922,2972,2954,14,18,"SAIn",0
9,"9223",45,37,37,0,0,"SAIn",0
31,"31176",2869,2010,1963,33,47,"SAIn",0
9,"9035",311,227,225,2,2,"SAIn",2
39,"39026",1750,1236,1224,11,12,"SAIn",0
19,"19263",26,15,15,1,0,"SAIn",0
31,"31011",693,459,456,8,3,"SAIn",0
28,"28067",4063,3102,3079,3,23,"SAIn",0
9,"9023",1102,818,811,11,7,"SAIn",3
9,"9375",36,31,31,0,0,"SAIn",0
19,"19330",71,63,63,2,0,"SAIn",0
34,"34204",46,41,41,0,0,"SAIn",0
9,"9195",59,36,36,2,0,"SAIn",0
28,"28165",1794,1293,1285,3,8,"SAIn",0
28,"28011",442,317,316,1,1,"SAIn",0
28,"28108",3374,2482,2465,10,17,"SAIn",0
31,"31145",172,128,128,4,0,"SAIn",0
31,"31045",508,355,350,8,5,"SAIn",0
31,"31245",81,55,55,2,0,"SAIn",0
39,"39098",1402,1046,1036,8,10,"SAIn",1
47,"47093",813,613,600,5,13,"SAIn",0
19,"19193",20,19,19,1,0,"SAIn",0
47,"47076",17399,13097,12972,92,125,"SAIn",9
19,"19157",55,46,46,0,0,"SAIn",0
19,"19331",2609,1872,1844,12,28,"SAIn",0
9,"9330",1507,1108,1092,10,16,"SAIn",0
28,"28012",887,664,661,2,3,"SAIn",0
31,"31200",761,517,508,3,9,"SAIn",0
19,"19130",60145,45531,45085,286,446,"SAIn",18
31,"31068",2885,2060,2027,20,33,"SAIn",1
19,"19318",25,18,18,0,0,"SAIn",0
28,"28050",4076,2860,2839,21,21,"SAIn",0
15,"15079",1540,1027,1007,16,20,"SAIn",0
31,"31080",508,391,385,3,6,"SAIn",0
9,"9464",35,27,27,0,0,"SAIn",0
31,"31091",351,220,217,1,3,"SAIn",1
47,"47067",174,127,126,0,1,"SAIn",0
47,"47159",822,644,636,1,8,"SAIn",0
47,"47077",246,193,191,1,2,"SAIn",0
19,"19160",886,558,552,2,6,"SAIn",0
19,"19266",236,188,188,1,0,"SAIn",0
9,"9109",1056,619,595,8,24,"SAIn",1
31,"31114",366,245,241,8,4,"SAIn",0
15,"15042",3028,2033,2000,19,33,"SAIn",1
47,"47025",120,94,94,1,0,"SAIn",0
9,"9182",80,69,67,1,2,"SAIn",0
19,"19231",10,9,9,0,0,"SAIn",0
47,"47078",163,127,125,1,2,"SAIn",0
34,"34106",109,89,86,2,3,"SAIn",0
31,"31136",447,299,298,2,1,"SAIn",1
19,"19148",45,32,31,0,1,"SAIn",0
30,"30039",19277,13165,13054,75,111,"SAIn",6
15,"15093",4220,2533,2498,30,35,"SAIn",0
35,"35011",24002,15928,15684,95,244,"SAIn",7
19,"19120",101,88,88,1,0,"SAIn",0
39,"39061",3478,2695,2677,13,18,"SAIn",0
47,"47160",425,308,303,0,5,"SAIn",0
28,"28014",33085,23626,23466,113,160,"SAIn",7
31,"31181",145,112,112,0,0,"SAIn",0
9,"9199",92,72,71,1,1,"SAIn",0
28,"28160",8256,6102,6059,31,43,"SAIn",3
47,"47215",53,45,45,0,0,"SAIn",0
19,"19197",27,22,22,0,0,"SAIn",0
34,"34175",90,72,70,0,2,"SAIn",0
39,"39092",894,626,620,1,6,"SAIn",0
39,"39011",1585,1169,1160,5,9,"SAIn",0
47,"47116",416,341,339,0,2,"SAIn",0
9,"9289",1451,1014,1000,5,14,"SAIn",0
15,"15082",15180,10841,10726,102,115,"SAIn",14
39,"39062",1812,1379,1366,5,13,"SAIn",0
19,"19121",246,199,194,1,5,"SAIn",0
28,"28141",5823,4297,4262,29,35,"SAIn",1
19,"19198",14,12,12,0,0,"SAIn",0
9,"9159",60,52,51,2,1,"SAIn",0
19,"19082",85,64,64,0,0,"SAIn",0
9,"9450",28,22,21,0,1,"SAIn",0
31,"31007",131,87,86,1,1,"SAIn",0
31,"31216",3865,2702,2671,33,31,"SAIn",2
15,"15008",5627,4112,4072,36,40,"SAIn",2
31,"31150",213,156,155,1,1,"SAIn",0
19,"19163",56,41,40,0,1,"SAIn",0
34,"34177",179,149,149,2,0,"SAIn",0
47,"47180",73,61,60,4,1,"SAIn",0
9,"9019",150,92,90,0,2,"SAIn",0
47,"47019",85,74,73,0,1,"SAIn",0
19,"19259",30,25,25,1,0,"SAIn",0
47,"47154",152,128,125,1,3,"SAIn",0
39,"39063",967,697,690,9,7,"SAIn",0
28,"28083",8939,6396,6348,38,48,"SAIn",3
19,"19247",139,102,100,1,2,"SAIn",0
31,"31041",1606,1114,1101,15,13,"SAIn",0
31,"31184",62,44,44,3,0,"SAIn",0
9,"9071",41,35,35,1,0,"SAIn",0
28,"28144",6010,4676,4644,22,32,"SAIn",0
39,"39034",286,188,185,5,3,"SAIn",0
47,"47081",45,36,35,1,1,"SAIn",0
28,"28018",3768,2968,2945,26,23,"SAIn",0
39,"39064",1345,1031,1015,7,16,"SAIn",0
19,"19271",46,39,39,0,0,"SAIn",0
34,"34082",83,74,73,0,1,"SAIn",0
28,"28046",4460,3447,3422,16,25,"SAIn",0
9,"9428",108,92,91,0,1,"SAIn",0
28,"28074",138947,103687,102762,620,925,"SAIn",27
19,"19003",42,35,34,1,1,"SAIn",0
9,"9388",34,27,26,0,1,"SAIn",0
19,"19087",18,18,18,0,0,"SAIn",0
31,"31152",1328,924,900,11,24,"SAIn",1
28,"28084",15859,11156,11058,64,98,"SAIn",4
31,"31020",449,228,228,3,0,"SAIn",0
19,"19226",43,38,38,0,0,"SAIn",0
9,"9021",56,33,31,1,2,"SAIn",0
28,"28094",865,624,622,4,2,"SAIn",0
31,"31243",306,224,221,2,3,"SAIn",0
9,"9456",130,97,96,0,1,"SAIn",0
19,"19154",68,56,54,0,2,"SAIn",0
28,"28134",61008,45177,44904,263,273,"SAIn",5
31,"31254",1915,1428,1411,3,17,"SAIn",2
31,"31021",62,39,38,0,1,"SAIn",0
15,"15087",5769,3766,3722,42,44,"SAIn",1
9,"9208",210,136,134,3,2,"SAIn",1
19,"19018",155,119,118,3,1,"SAIn",0
47,"47174",267,218,215,1,3,"SAIn",0
31,"31143",96,55,54,1,1,"SAIn",0
31,"31088",5572,3897,3862,44,35,"SAIn",5
19,"19058",6793,5258,5218,19,40,"SAIn",1
30,"30035",18671,13103,12979,54,124,"SAIn",4
30,"30004",1137,870,862,3,8,"SAIn",0
15,"15088",3519,2304,2270,27,34,"SAIn",0
47,"47004",1181,939,930,7,9,"SAIn",0
19,"19127",89,64,64,0,0,"SAIn",0
30,"30005",29526,20713,20526,121,187,"SAIn",2
9,"9458",469,343,336,5,7,"SAIn",0
39,"39088",69,52,52,0,0,"SAIn",0
19,"19006",769,547,540,2,7,"SAIn",0
31,"31189",1161,720,709,6,11,"SAIn",0
35,"35017",25676,15038,14716,94,322,"SAIn",9
9,"9301",625,473,467,2,6,"SAIn",0
47,"47220",165,130,129,0,1,"SAIn",0
15,"15014",4002,2566,2524,28,42,"SAIn",0
34,"34236",156,120,119,0,1,"SAIn",1
9,"9360",30,23,23,0,0,"SAIn",0
9,"9280",28,20,20,0,0,"SAIn",0
19,"19106",89,59,59,0,0,"SAIn",0
34,"34045",76,66,66,2,0,"SAIn",0
34,"34168",52,47,47,2,0,"SAIn",0
31,"31112",89,62,62,0,0,"SAIn",0
47,"47085",16612,11829,11706,114,123,"SAIn",6
9,"9433",60,48,45,1,3,"SAIn",0
31,"31046",57,39,39,1,0,"SAIn",0
34,"34152",125,96,92,1,4,"SAIn",0
31,"31212",147,102,102,4,0,"SAIn",0
39,"39018",4220,3264,3204,35,60,"SAIn",0
28,"28158",665,537,533,4,4,"SAIn",0
19,"19171",4961,3670,3628,27,42,"SAIn",1
31,"31124",208,148,148,2,0,"SAIn",0
9,"9303",86,68,68,0,0,"SAIn",0
9,"9409",111,86,86,4,0,"SAIn",0
35,"35010",3558,2341,2301,28,40,"SAIn",0
15,"15067",8029,5789,5732,37,57,"SAIn",6
47,"47086",3906,2970,2936,24,34,"SAIn",2
9,"9124",1506,1040,1028,6,12,"SAIn",1
30,"30038",15411,10847,10767,46,80,"SAIn",2
9,"9434",1227,922,909,6,13,"SAIn",2
34,"34137",27,23,22,0,1,"SAIn",0
35,"35019",32481,19318,19067,123,251,"SAIn",6
39,"39090",756,553,542,0,11,"SAIn",0
31,"31225",36,27,27,0,0,"SAIn",0
31,"31191",3016,2167,2147,22,20,"SAIn",1
34,"34076",587,479,479,2,0,"SAIn",0
28,"28005",134246,99236,98481,583,755,"SAIn",69
34,"34156",50,45,45,0,0,"SAIn",0
31,"31905",2843,1983,1966,15,17,"SAIn",7
28,"28159",589,468,468,5,0,"SAIn",0
34,"34240",89,64,64,0,0,"SAIn",1
19,"19051",67,63,63,0,0,"SAIn",0
34,"34139",166,107,106,1,1,"SAIn",0
9,"9437",282,219,218,3,1,"SAIn",0
9,"9055",52,42,41,1,1,"SAIn",0
9,"9041",28,27,27,0,0,"SAIn",0
34,"34092",288,230,226,1,4,"SAIn",1
31,"31126",358,223,223,2,0,"SAIn",0
9,"9183",51,41,41,0,0,"SAIn",0
9,"9351",62,49,48,1,1,"SAIn",0
47,"47088",103,86,85,1,1,"SAIn",0
9,"9352",114,92,92,1,0,"SAIn",0
35,"35003",5211,2949,2908,13,41,"SAIn",1
28,"28006",78966,59065,58698,267,367,"SAIn",10
31,"31105",1507,1167,1142,7,25,"SAIn",0
47,"47061",256,212,211,2,1,"SAIn",0
34,"34190",56,41,40,2,1,"SAIn",0
31,"31261",231,173,169,3,4,"SAIn",0
9,"9258",172,141,139,5,2,"SAIn",1
39,"39042",5915,4530,4474,21,56,"SAIn",3
34,"34242",95,71,68,3,3,"SAIn",0
31,"31028",212,131,131,0,0,"SAIn",0
47,"47216",115,91,87,0,4,"SAIn",0
39,"39093",299,229,226,4,3,"SAIn",1
9,"9139",103,87,85,3,2,"SAIn",0
9,"9057",145,108,108,0,0,"SAIn",0
47,"47171",407,303,301,6,2,"SAIn",0
30,"30041",13621,8970,8889,46,81,"SAIn",0
47,"47145",603,448,441,3,7,"SAIn",0
31,"31183",691,544,542,4,2,"SAIn",0
9,"9386",54,39,38,1,1,"SAIn",0
19,"19308",56,53,53,0,0,"SAIn",0
31,"31118",164,112,111,1,1,"SAIn",0
31,"31251",3115,2240,2205,15,35,"SAIn",1
9,"9904",478,374,370,5,4,"SAIn",1
34,"34004",5608,4120,4063,43,57,"SAIn",2
19,"19213",70,62,61,2,1,"SAIn",0
19,"19237",47,38,38,0,0,"SAIn",0
47,"47146",255,206,204,1,2,"SAIn",0
31,"31096",113,82,79,0,3,"SAIn",0
30,"30012",9091,6962,6897,36,65,"SAIn",1
15,"15022",5785,3811,3771,33,40,"SAIn",2
19,"19099",298,200,199,6,1,"SAIn",0
34,"34068",27,22,22,0,0,"SAIn",0
39,"39044",3849,2765,2732,21,33,"SAIn",1
28,"28027",1203,872,857,3,15,"SAIn",0
9,"9262",163,130,127,1,3,"SAIn",0
19,"19189",120,91,90,2,1,"SAIn",0
30,"30043",24967,18981,18685,101,296,"SAIn",8
9,"9131",462,365,364,2,1,"SAIn",0
31,"31097",10410,7082,7002,75,80,"SAIn",2
30,"30013",7396,5147,5102,32,45,"SAIn",0
34,"34053",207,170,169,3,1,"SAIn",0
34,"34099",60,48,48,0,0,"SAIn",0
47,"47038",105,77,77,0,0,"SAIn",0
9,"9442",375,279,277,2,2,"SAIn",0
9,"9220",75,56,54,1,2,"SAIn",0
47,"47227",61,50,50,0,0,"SAIn",0
19,"19300",772,595,591,5,4,"SAIn",0
15,"15061",5571,3746,3691,27,55,"SAIn",3
9,"9356",42,33,32,0,1,"SAIn",0
28,"28125",3002,2180,2163,11,17,"SAIn",0
34,"34232",750,578,564,7,14,"SAIn",0
19,"19287",148,109,108,0,1,"SAIn",0
15,"15024",4393,3141,3073,32,68,"SAIn",2
39,"39015",839,647,642,4,5,"SAIn",0
34,"34056",1998,1452,1444,13,8,"SAIn",1
47,"47191",108,79,79,0,0,"SAIn",0
30,"30902",7975,5318,5273,24,45,"SAIn",1
31,"31154",224,126,126,3,0,"SAIn",0
9,"9443",179,128,124,0,4,"SAIn",0
34,"34116",62,49,49,0,0,"SAIn",0
9,"9406",251,192,191,2,1,"SAIn",1
30,"30014",1567,1174,1160,8,14,"SAIn",0
19,"19217",54,40,39,0,1,"SAIn",0
34,"34010",577,440,438,5,2,"SAIn",0
35,"35025",1797,1261,1245,4,16,"SAIn",1
31,"31066",855,589,579,8,10,"SAIn",0
15,"15025",1061,629,622,6,7,"SAIn",0
19,"19329",59,50,50,1,0,"SAIn",0
28,"28135",948,713,709,4,4,"SAIn",0
9,"9062",51,40,39,0,1,"SAIn",0
9,"9267",111,99,97,1,2,"SAIn",0
31,"31034",37,25,25,0,0,"SAIn",0
31,"31067",1922,1312,1294,10,18,"SAIn",1
28,"28127",64827,51776,51613,220,163,"SAIn",9
19,"19059",77,61,58,1,3,"SAIn",0
34,"34221",179,144,144,3,0,"SAIn",0
28,"28147",963,722,720,5,2,"SAIn",0
9,"9238",921,573,561,4,12,"SAIn",0
47,"47175",6564,4781,4728,39,53,"SAIn",1
9,"9419",78,55,55,0,0,"SAIn",0
31,"31035",59,45,43,0,2,"SAIn",0
31,"31234",144,106,106,4,0,"SAIn",0
9,"9315",378,245,243,1,2,"SAIn",0
9,"9090",54,48,48,0,0,"SAIn",0
31,"31246",140,111,107,1,4,"SAIn",2
47,"47114",4045,2787,2762,26,25,"SAIn",0
9,"9108",384,283,279,1,4,"SAIn",1
47,"47023",2995,2344,2326,18,18,"SAIn",0
31,"31235",159,117,115,2,2,"SAIn",0
31,"31002",414,288,287,3,1,"SAIn",0
9,"9091",724,500,490,4,10,"SAIn",0
30,"30027",48176,35521,35266,153,255,"SAIn",15
9,"9136",192,142,137,2,5,"SAIn",0
9,"9283",44,32,31,0,1,"SAIn",0
28,"28041",4524,3508,3490,20,18,"SAIn",5
9,"9316",105,80,80,1,0,"SAIn",0
47,"47095",38,31,31,0,0,"SAIn",0
31,"31236",1320,865,854,5,11,"SAIn",1
34,"34015",41,35,35,3,0,"SAIn",0
39,"39019",2079,1560,1531,10,29,"SAIn",0
47,"47050",3719,2630,2598,26,32,"SAIn",0
34,"34091",123,94,93,3,1,"SAIn",0
19,"19256",43,36,36,0,0,"SAIn",0
28,"28099",1748,1290,1283,7,7,"SAIn",0
28,"28119",2092,1590,1582,12,8,"SAIn",0
47,"47104",2836,2182,2121,19,61,"SAIn",1
19,"19209",40,29,29,1,0,"SAIn",0
15,"15018",1142,741,732,18,9,"SAIn",0
47,"47143",118,91,90,0,1,"SAIn",0
39,"39020",23592,15594,15384,128,210,"SAIn",5
34,"34211",178,155,152,1,3,"SAIn",0
19,"19334",35,31,31,0,0,"SAIn",0
28,"28100",4196,2987,2955,14,32,"SAIn",7
47,"47195",459,345,344,4,1,"SAIn",0
35,"35029",4152,2530,2498,32,32,"SAIn",0
39,"39051",66,57,57,0,0,"SAIn",0
9,"9412",790,528,523,4,5,"SAIn",0
9,"9288",90,70,70,0,0,"SAIn",0
28,"28062",292,231,226,1,5,"SAIn",0
19,"19222",110,82,82,0,0,"SAIn",0
9,"9467",64,43,42,1,1,"SAIn",0
19,"19162",68,49,47,0,2,"SAIn",0
28,"28079",2362038,1743924,1733354,8859,10570,"SAIn",524
28,"28080",48554,38885,38691,164,194,"SAIn",8
47,"47207",278,215,212,3,3,"SAIn",0
9,"9273",52,40,39,2,1,"SAIn",0
34,"34079",1616,1222,1205,5,17,"SAIn",0
9,"9366",86,62,62,2,0,"SAIn",0
9,"9337",117,92,91,0,1,"SAIn",0
47,"47161",3918,3145,3126,12,19,"SAIn",4
31,"31172",373,278,272,3,6,"SAIn",2
34,"34035",111,98,97,0,1,"SAIn",0
31,"31149",2305,1461,1441,8,20,"SAIn",1
9,"9384",295,211,206,0,5,"SAIn",0
31,"31250",2810,1786,1770,19,16,"SAIn",2
31,"31073",294,212,208,2,4,"SAIn",0
39,"39022",980,721,713,2,8,"SAIn",0
39,"39053",219,153,152,2,1,"SAIn",0
35,"35031",7259,5037,4942,29,95,"SAIn",2
9,"9323",61,46,46,1,0,"SAIn",0
35,"35005",1048,747,737,8,10,"SAIn",0
47,"47208",58,38,36,1,2,"SAIn",0
39,"39043",1481,1122,1115,9,7,"SAIn",0
34,"34110",88,71,71,1,0,"SAIn",0
19,"19152",556,390,382,1,8,"SAIn",0
9,"9141",616,485,483,5,2,"SAIn",1
19,"19188",51,35,35,0,0,"SAIn",0
19,"19070",74,53,53,0,0,"SAIn",0
31,"31074",387,286,286,5,0,"SAIn",0
9,"9231",69,38,38,1,0,"SAIn",0
15,"15035",11427,7779,7657,144,122,"SAIn",7
19,"19113",485,366,366,3,0,"SAIn",0
34,"34230",15,12,12,0,0,"SAIn",0
9,"9387",117,95,90,0,5,"SAIn",0
30,"30022",16913,11371,11214,93,157,"SAIn",4
31,"31207",273,182,177,2,5,"SAIn",0
47,"47163",290,230,228,3,2,"SAIn",0
47,"47020",280,234,231,2,3,"SAIn",0
19,"19200",71,52,52,1,0,"SAIn",0
9,"9101",76,56,55,1,1,"SAIn",0
31,"31164",568,421,417,5,4,"SAIn",0
34,"34217",1207,937,923,8,14,"SAIn",0
9,"9455",45,33,33,0,0,"SAIn",0
9,"9191",38,28,27,0,1,"SAIn",0
15,"15074",4037,2841,2796,20,45,"SAIn",1
31,"31242",260,164,163,1,1,"SAIn",0
9,"9416",53,35,35,0,0,"SAIn",0
47,"47091",84,71,71,2,0,"SAIn",0
28,"28019",1233,893,885,4,8,"SAIn",0
28,"28037",1559,1177,1166,5,11,"SAIn",0
47,"47021",76,64,64,0,0,"SAIn",0
31,"31065",1878,1351,1326,20,25,"SAIn",2
31,"31043",38,31,30,1,1,"SAIn",0
19,"19191",14,13,12,0,1,"SAIn",0
19,"19155",66,56,56,0,0,"SAIn",0
34,"34218",461,343,339,2,4,"SAIn",0
31,"31165",2780,1995,1960,30,35,"SAIn",1
19,"19274",902,660,651,7,9,"SAIn",0
28,"28029",520,408,406,0,2,"SAIn",0
31,"31209",155,107,106,0,1,"SAIn",0
47,"47056",87,67,67,0,0,"SAIn",0
34,"34041",90,71,71,1,0,"SAIn",0
31,"31221",1214,798,786,12,12,"SAIn",2
19,"19314",51,36,36,0,0,"SAIn",0
19,"19301",40,33,33,1,0,"SAIn",0
9,"9328",76,56,56,0,0,"SAIn",1
31,"31244",158,87,86,1,1,"SAIn",0
47,"47130",96,72,72,0,0,"SAIn",0
34,"34167",113,94,94,0,0,"SAIn",1
47,"47112",2587,2015,1988,7,27,"SAIn",1
34,"34042",296,237,234,1,3,"SAIn",0
9,"9104",53,42,42,0,0,"SAIn",0
19,"19228",26,20,20,0,0,"SAIn",0
28,"28136",647,528,518,2,10,"SAIn",0
34,"34028",143,116,113,1,3,"SAIn",0
19,"19116",12,9,9,0,0,"SAIn",0
34,"34182",786,606,597,10,9,"SAIn",0
31,"31089",242,172,170,1,2,"SAIn",2
28,"28030",1726,1320,1299,8,21,"SAIn",0
31,"31178",490,345,342,3,3,"SAIn",1
30,"30025",4908,3667,3630,16,37,"SAIn",0
15,"15003",1803,1227,1210,9,17,"SAIn",1
30,"30026",15734,10007,9901,51,106,"SAIn",0
9,"9024",156,112,110,1,2,"SAIn",0
31,"31079",73,54,53,0,1,"SAIn",0
15,"15041",9568,6828,6710,75,118,"SAIn",4
39,"39089",143,104,100,1,4,"SAIn",0
47,"47221",111,94,94,0,0,"SAIn",0
47,"47167",241,204,204,1,0,"SAIn",0
9,"9483",211,158,157,0,1,"SAIn",0
9,"9123",40,35,35,0,0,"SAIn",0
19,"19208",43,30,30,0,0,"SAIn",0
9,"9213",307,220,218,2,2,"SAIn",0
35,"35027",10344,7310,7216,50,94,"SAIn",9
28,"28004",6234,4202,4167,16,35,"SAIn",1
34,"34032",40,33,33,1,0,"SAIn",0
9,"9378",31,24,23,0,1,"SAIn",0
31,"31247",151,114,113,0,1,"SAIn",0
9,"9152",257,183,183,0,0,"SAIn",0
47,"47185",99,73,71,0,2,"SAIn",0
19,"19172",57,48,47,0,1,"SAIn",0
30,"30028",6649,4797,4726,21,71,"SAIn",1
34,"34074",707,540,531,9,9,"SAIn",0
19,"19079",8,8,7,0,1,"SAIn",0
39,"39050",270,187,186,0,1,"SAIn",0
28,"28033",3899,2805,2788,7,17,"SAIn",2
15,"15030",200176,143255,142070,1452,1185,"SAIn",81
34,"34210",103,90,90,0,0,"SAIn",0
47,"47042",54,37,37,0,0,"SAIn",0
19,"19196",105,84,81,0,3,"SAIn",0
31,"31016",7608,5474,5413,50,61,"SAIn",6
28,"28015",18736,14221,14127,68,94,"SAIn",2
34,"34225",4921,3588,3559,30,29,"SAIn",3
9,"9365",29,19,19,0,0,"SAIn",0
47,"47206",92,80,80,0,0,"SAIn",0
9,"9078",41,30,30,1,0,"SAIn",0
47,"47134",165,128,125,1,3,"SAIn",0
39,"39081",437,337,332,4,5,"SAIn",0
34,"34077",347,244,238,4,6,"SAIn",1
34,"34174",200,159,154,5,5,"SAIn",0
47,"47170",33,28,27,2,1,"SAIn",0
39,"39072",344,198,196,2,2,"SAIn",0
9,"9307",109,81,80,0,1,"SAIn",0
19,"19150",128,99,99,1,0,"SAIn",0
9,"9471",149,114,114,1,0,"SAIn",1
34,"34227",77,61,61,2,0,"SAIn",0
31,"31171",680,495,486,8,9,"SAIn",2
19,"19042",25,24,24,0,0,"SAIn",0
28,"28179",1432,1040,1037,4,3,"SAIn",0
47,"47089",148,125,124,0,1,"SAIn",0
28,"28072",5709,4356,4324,22,32,"SAIn",3
19,"19097",16,10,10,0,0,"SAIn",0
9,"9244",46,34,34,1,0,"SAIn",0
47,"47153",108,77,77,0,0,"SAIn",0
9,"9098",507,369,362,5,7,"SAIn",0
35,"35030",9250,5413,5326,34,87,"SAIn",2
34,"34229",68,57,56,1,1,"SAIn",0
34,"34176",133,102,101,0,1,"SAIn",0
9,"9427",1419,978,959,8,19,"SAIn",2
31,"31084",1940,1293,1274,16,19,"SAIn",0
9,"9114",86,66,66,0,0,"SAIn",0
19,"19284",10,10,9,0,1,"SAIn",0
9,"9414",189,148,146,0,2,"SAIn",0
35,"35022",48603,29443,29042,160,401,"SAIn",14
28,"28045",33328,24620,24434,146,186,"SAIn",4
9,"9473",85,70,65,1,5,"SAIn",0
19,"19176",237,181,181,0,0,"SAIn",0
39,"39033",568,418,415,2,3,"SAIn",0
9,"9339",128,110,110,0,0,"SAIn",0
15,"15047",2429,1576,1549,19,27,"SAIn",0
15,"15085",3332,2280,2247,25,33,"SAIn",1
30,"30001",4582,3620,3594,18,26,"SAIn",0
34,"34098",777,551,545,8,6,"SAIn",0
31,"31085",480,350,350,2,0,"SAIn",0
31,"31119",39,26,26,0,0,"SAIn",0
9,"9202",25,22,22,1,0,"SAIn",0
19,"19298",65,45,45,0,0,"SAIn",0
9,"9295",61,44,44,0,0,"SAIn",0
28,"28181",20386,16155,16069,57,86,"SAIn",4
19,"19138",255,202,201,2,1,"SAIn",0
47,"47090",2418,1728,1699,8,29,"SAIn",0
28,"28145",2431,1760,1736,6,24,"SAIn",3
19,"19238",42,28,28,0,0,"SAIn",0
39,"39035",9502,7017,6928,57,89,"SAIn",2
47,"47055",203,167,163,0,4,"SAIn",0
28,"28047",40914,30019,29788,169,231,"SAIn",14
31,"31153",2159,1403,1387,12,16,"SAIn",0
30,"30023",3780,2874,2850,12,24,"SAIn",0
28,"28182",210,171,169,0,2,"SAIn",0
9,"9478",41,32,32,1,0,"SAIn",0
19,"19045",140,120,120,0,0,"SAIn",0
28,"28164",2993,2183,2168,8,15,"SAIn",0
19,"19201",58,49,48,1,1,"SAIn",0
9,"9034",276,228,227,2,1,"SAIn",0
9,"9164",157,127,126,0,1,"SAIn",0
30,"30003",24332,16183,16040,104,143,"SAIn",1
19,"19168",292,204,198,1,6,"SAIn",0
31,"31033",49,31,31,1,0,"SAIn",0
34,"34202",29,18,18,1,0,"SAIn",0
28,"28020",145,94,94,0,0,"SAIn",0
39,"39076",3476,2594,2559,19,35,"SAIn",1
47,"47013",100,82,81,1,1,"SAIn",0
47,"47139",1040,777,767,6,10,"SAIn",0
31,"31233",97,74,74,0,0,"SAIn",0
34,"34181",448,322,319,7,3,"SAIn",0
28,"28117",104,89,89,1,0,"SAIn",0
19,"19240",51,44,42,0,2,"SAIn",0
9,"9074",794,575,569,6,6,"SAIn",1
9,"9036",37,31,30,1,1,"SAIn",0
30,"30015",19171,13561,13464,61,97,"SAIn",11
31,"31255",102,79,79,1,0,"SAIn",0
39,"39037",1987,1516,1503,8,13,"SAIn",0
9,"9431",118,98,98,0,0,"SAIn",0
47,"47166",259,204,197,2,7,"SAIn",0
35,"35026",81091,51953,51195,407,758,"SAIn",23
31,"31156",251,189,188,0,1,"SAIn",0
19,"19218",50,33,33,0,0,"SAIn",0
34,"34205",61,50,50,0,0,"SAIn",0
31,"31155",256,169,167,2,2,"SAIn",0
47,"47014",51,45,45,0,0,"SAIn",0
39,"39102",2277,1615,1598,9,17,"SAIn",0
15,"15040",2753,1905,1880,5,25,"SAIn",0
9,"9167",58,41,41,1,0,"SAIn",0
30,"30036",14698,9859,9734,41,125,"SAIn",0
9,"9076",23,17,17,1,0,"SAIn",0
47,"47102",291,230,220,1,10,"SAIn",0
34,"34073",185,149,149,0,0,"SAIn",0
9,"9377",632,485,480,1,5,"SAIn",0
34,"34237",592,462,452,6,10,"SAIn",0
47,"47204",256,204,198,0,6,"SAIn",0
9,"9013",48,37,37,0,0,"SAIn",0
47,"47113",159,129,128,0,1,"SAIn",0
47,"47041",150,112,110,2,2,"SAIn",0
30,"30006",803,691,685,2,6,"SAIn",0
28,"28903",33082,27065,26922,154,143,"SAIn",5
9,"9332",140,106,106,2,0,"SAIn",0
9,"9226",63,54,54,0,0,"SAIn",0
19,"19061",57,42,42,0,0,"SAIn",0
28,"28177",10270,8083,8030,36,53,"SAIn",1
31,"31058",208,148,144,3,4,"SAIn",0
9,"9255",89,63,62,0,1,"SAIn",0
9,"9410",3040,2117,2095,16,22,"SAIn",2
9,"9169",95,78,78,0,0,"SAIn",0
9,"9214",672,427,427,4,0,"SAIn",0
19,"19321",39,30,30,1,0,"SAIn",0
9,"9197",144,111,109,1,2,"SAIn",0
31,"31037",84,66,66,1,0,"SAIn",0
19,"19147",43,33,33,0,0,"SAIn",0
30,"30018",7978,5866,5811,30,55,"SAIn",2
39,"39040",4292,3208,3166,14,42,"SAIn",0
9,"9306",106,82,82,1,0,"SAIn",0
19,"19244",82,65,64,1,1,"SAIn",0
28,"28024",151,125,124,1,1,"SAIn",0
30,"30029",11864,8125,8058,73,67,"SAIn",1
19,"19210",21,19,18,1,1,"SAIn",0
31,"31038",1339,957,942,11,15,"SAIn",1
9,"9256",354,258,258,2,0,"SAIn",0
19,"19268",35,24,24,1,0,"SAIn",0
28,"28130",28293,21253,21040,116,213,"SAIn",7
30,"30032",2856,2163,2144,6,19,"SAIn",0
19,"19257",3403,2430,2402,19,28,"SAIn",1
47,"47026",46,40,40,1,0,"SAIn",0
31,"31082",617,371,365,10,6,"SAIn",0
9,"9138",85,72,70,0,2,"SAIn",0
30,"30009",12433,9586,9503,41,83,"SAIn",2
19,"19041",163,129,129,3,0,"SAIn",0
35,"35012",10382,5443,5392,17,51,"SAIn",0
9,"9425",517,384,378,0,6,"SAIn",0
47,"47079",58,48,47,0,1,"SAIn",0
9,"9043",192,137,133,1,4,"SAIn",0
28,"28155",506,416,411,0,5,"SAIn",0
9,"9177",1121,757,749,9,8,"SAIn",2
28,"28044",5826,4445,4409,24,36,"SAIn",2
47,"47001",55,46,46,0,0,"SAIn",0
34,"34126",277,200,199,2,1,"SAIn",0
47,"47225",80,63,63,0,0,"SAIn",0
9,"9440",91,78,78,2,0,"SAIn",0
34,"34243",325,252,248,0,4,"SAIn",1
9,"9045",268,181,181,4,0,"SAIn",0
31,"31195",182,130,128,0,2,"SAIn",1
39,"39083",1135,679,670,8,9,"SAIn",0
19,"19224",93,87,87,0,0,"SAIn",0
34,"34215",164,141,140,1,1,"SAIn",0
19,"19136",18,14,14,0,0,"SAIn",0
34,"34022",1082,873,861,9,12,"SAIn",1
28,"28132",11685,8130,8062,56,68,"SAIn",2
34,"34067",127,93,93,1,0,"SAIn",0
31,"31241",133,98,98,2,0,"SAIn",0
9,"9905",384,279,279,2,0,"SAIn",0
34,"34245",307,209,208,5,1,"SAIn",0
31,"31196",38,35,35,1,0,"SAIn",0
39,"39054",4493,3376,3334,33,42,"SAIn",0
9,"9006",59,39,39,0,0,"SAIn",0
34,"34143",168,123,120,2,3,"SAIn",0
28,"28123",57078,45270,44992,215,278,"SAIn",6
34,"34178",117,103,103,0,0,"SAIn",0
9,"9275",192,129,129,2,0,"SAIn",0
15,"15010",1887,1168,1150,13,18,"SAIn",1
31,"31078",2429,1795,1767,15,28,"SAIn",0
19,"19310",9,7,7,0,0,"SAIn",0
47,"47147",116,92,92,0,0,"SAIn",0
47,"47199",80,63,63,0,0,"SAIn",0
9,"9085",475,347,342,2,5,"SAIn",1
39,"39045",367,271,268,1,3,"SAIn",0
47,"47119",92,80,79,1,1,"SAIn",0
34,"34055",270,209,207,2,2,"SAIn",1
28,"28028",1755,1353,1344,6,9,"SAIn",1
34,"34083",1769,1218,1201,10,17,"SAIn",0
47,"47012",113,93,93,0,0,"SAIn",0
34,"34100",142,108,108,1,0,"SAIn",0
34,"34046",41,36,35,0,1,"SAIn",0
47,"47032",152,117,116,1,1,"SAIn",0
19,"19327",418,350,348,1,2,"SAIn",1
34,"34165",66,58,58,1,0,"SAIn",0
19,"19250",20,17,17,0,0,"SAIn",0
15,"15062",5887,3747,3701,36,46,"SAIn",4
39,"39036",969,743,739,2,4,"SAIn",0
34,"34027",1085,751,741,6,10,"SAIn",0
31,"31232",25155,17648,17450,196,198,"SAIn",18
31,"31044",289,230,227,1,3,"SAIn",0
28,"28038",4952,3730,3688,34,42,"SAIn",3
19,"19227",66,44,43,2,1,"SAIn",0
19,"19239",92,62,62,1,0,"SAIn",0
34,"34902",139,106,106,0,0,"SAIn",0
47,"47211",47,35,34,0,1,"SAIn",0
9,"9178",47,35,35,0,0,"SAIn",0
31,"31210",196,152,152,2,0,"SAIn",1
19,"19089",30,22,22,0,0,"SAIn",0
9,"9374",90,71,70,1,1,"SAIn",0
9,"9266",91,74,74,0,0,"SAIn",0
19,"19302",59,49,49,1,0,"SAIn",0
28,"28039",128,98,97,2,1,"SAIn",0
35,"35034",7873,3975,3943,27,32,"SAIn",3
15,"15039",1263,889,875,7,14,"SAIn",0
47,"47149",42,34,34,3,0,"SAIn",0
47,"47048",188,144,144,1,0,"SAIn",0
9,"9134",221,161,156,7,5,"SAIn",0
34,"34151",159,104,103,0,1,"SAIn",0
31,"31214",91,64,62,1,2,"SAIn",0
9,"9318",61,41,41,0,0,"SAIn",0
39,"39071",397,261,256,1,5,"SAIn",0
47,"47122",2032,1563,1535,7,28,"SAIn",0
47,"47158",889,667,659,8,8,"SAIn",0
19,"19303",43,35,35,0,0,"SAIn",0
31,"31057",1781,1287,1268,10,19,"SAIn",0
34,"34134",50,40,40,2,0,"SAIn",0
47,"47141",134,111,110,0,1,"SAIn",0
9,"9281",145,114,109,1,5,"SAIn",0
39,"39099",3114,2308,2281,12,27,"SAIn",1
15,"15016",4749,3058,3020,19,38,"SAIn",1
19,"19212",703,543,531,3,12,"SAIn",0
28,"28173",517,390,388,1,2,"SAIn",0
9,"9391",361,264,263,3,1,"SAIn",1
35,"35007",511,316,309,2,7,"SAIn",0
31,"31069",832,637,635,3,2,"SAIn",0
47,"47150",274,209,205,0,4,"SAIn",0
9,"9422",17,11,11,0,0,"SAIn",0
19,"19255",79,63,61,1,2,"SAIn",0
39,"39049",322,229,229,0,0,"SAIn",0
34,"34224",47,37,37,1,0,"SAIn",0
28,"28069",50,44,41,0,3,"SAIn",0
19,"19008",37,28,27,1,1,"SAIn",0
9,"9227",119,91,89,4,2,"SAIn",0
15,"15068",5049,3185,3129,25,56,"SAIn",2
28,"28023",4775,3755,3735,12,20,"SAIn",0
9,"9032",109,75,73,0,2,"SAIn",0
47,"47151",27,24,24,0,0,"SAIn",0
9,"9334",50,39,37,0,2,"SAIn",0
28,"28061",21389,16277,16135,67,142,"SAIn",9
31,"31237",193,155,153,2,2,"SAIn",0
19,"19333",115,82,82,0,0,"SAIn",0
34,"34033",17,17,17,0,0,"SAIn",0
19,"19065",127,104,104,3,0,"SAIn",0
31,"31259",484,291,286,2,5,"SAIn",0
9,"9411",151,102,101,0,1,"SAIn",0
31,"31137",205,112,109,6,3,"SAIn",0
19,"19186",81,68,68,0,0,"SAIn",0
19,"19109",39,32,32,0,0,"SAIn",0
9,"9115",92,68,67,0,1,"SAIn",1
9,"9247",24,21,21,1,0,"SAIn",0
9,"9381",30,24,24,1,0,"SAIn",0
34,"34018",209,168,164,1,4,"SAIn",1
9,"9335",88,68,68,0,0,"SAIn",0
47,"47008",24,19,19,1,0,"SAIn",0
15,"15007",3303,2262,2246,15,16,"SAIn",1
47,"47105",183,158,156,0,2,"SAIn",0
31,"31160",106,89,88,2,1,"SAIn",0
39,"39001",2102,1622,1601,18,21,"SAIn",1
47,"47187",84,61,58,0,3,"SAIn",0
39,"39031",1236,878,868,4,10,"SAIn",0
47,"47182",1323,977,967,8,10,"SAIn",0
34,"34184",57,46,45,0,1,"SAIn",0
39,"39086",358,256,253,0,3,"SAIn",0
9,"9343",93,66,65,0,1,"SAIn",0
34,"34159",357,253,248,4,5,"SAIn",1
28,"28063",258,194,193,1,1,"SAIn",0
15,"15071",7951,5255,5178,50,77,"SAIn",1
34,"34020",52,39,39,0,0,"SAIn",0
31,"31205",427,299,297,4,2,"SAIn",0
9,"9451",238,191,190,0,1,"SAIn",0
19,"19067",70,52,51,1,1,"SAIn",0
34,"34228",83,74,74,1,0,"SAIn",0
28,"28152",16093,12945,12877,58,68,"SAIn",2
47,"47010",13729,10549,10454,81,95,"SAIn",6
31,"31140",117,84,84,1,0,"SAIn",0
47,"47111",1020,742,732,7,10,"SAIn",0
31,"31206",2090,1461,1440,22,21,"SAIn",2
31,"31018",393,292,285,4,7,"SAIn",0
31,"31019",1785,1254,1238,9,16,"SAIn",0
47,"47181",165,135,132,3,3,"SAIn",0
47,"47045",763,575,567,1,8,"SAIn",0
39,"39094",848,655,651,3,4,"SAIn",0
28,"28114",150,101,100,1,1,"SAIn",0
9,"9294",108,86,82,0,4,"SAIn",0
47,"47137",29,25,25,1,0,"SAIn",0
19,"19031",15,9,9,0,0,"SAIn",0
47,"47011",565,461,458,5,3,"SAIn",0
31,"31252",87,61,61,0,0,"SAIn",0
19,"19294",29,27,27,0,0,"SAIn",0
19,"19289",28,25,24,1,1,"SAIn",0
19,"19185",28,21,20,0,1,"SAIn",0
9,"9162",141,101,101,0,0,"SAIn",0
47,"47190",98,80,80,1,0,"SAIn",0
19,"19055",52,41,41,1,0,"SAIn",0
47,"47100",138,117,117,1,0,"SAIn",0
31,"31109",1582,1155,1150,9,5,"SAIn",2
31,"31208",2556,1949,1920,16,29,"SAIn",1
34,"34201",193,158,155,1,3,"SAIn",0
35,"35015",9950,5139,5070,29,69,"SAIn",0
31,"31090",144,77,77,1,0,"SAIn",0
28,"28115",60892,49705,49510,209,195,"SAIn",9
19,"19007",459,341,336,0,5,"SAIn",0
47,"47058",200,145,143,0,2,"SAIn",0
39,"39096",690,487,479,4,8,"SAIn",0
19,"19073",23,19,19,0,0,"SAIn",0
34,"34025",57,39,39,1,0,"SAIn",0
9,"9048",1467,1048,1033,13,15,"SAIn",1
47,"47039",185,141,140,0,1,"SAIn",0
47,"47183",130,106,105,0,1,"SAIn",0
9,"9265",37,28,28,0,0,"SAIn",0
9,"9010",32,23,23,1,0,"SAIn",0
30,"30024",58746,42036,41731,206,305,"SAIn",10
47,"47219",41,36,34,0,2,"SAIn",0
39,"39097",697,371,368,2,3,"SAIn",0
19,"19304",219,173,171,3,2,"SAIn",0
28,"28183",1039,743,735,2,8,"SAIn",0
9,"9480",110,90,90,1,0,"SAIn",0
19,"19203",30,24,24,0,0,"SAIn",0
47,"47031",189,145,145,1,0,"SAIn",0
39,"39067",790,513,505,1,8,"SAIn",0
31,"31188",235,161,161,2,0,"SAIn",0
15,"15051",4638,3182,3153,44,29,"SAIn",1
28,"28086",5154,3530,3493,13,37,"SAIn",3
34,"34132",114,89,86,0,3,"SAIn",0
39,"39027",3118,2322,2295,26,27,"SAIn",0
34,"34011",397,321,320,5,1,"SAIn",0
47,"47034",72,58,58,3,0,"SAIn",0
47,"47002",23,21,20,1,1,"SAIn",0
31,"31170",47,42,42,3,0,"SAIn",0
9,"9072",316,242,241,0,1,"SAIn",0
9,"9137",174,132,131,3,1,"SAIn",0
39,"39058",810,559,557,2,2,"SAIn",0
9,"9216",387,270,265,1,5,"SAIn",0
28,"28111",596,467,467,3,0,"SAIn",0
28,"28043",5921,3803,3759,18,44,"SAIn",1
39,"39028",3739,2850,2817,16,33,"SAIn",0
19,"19230",505,360,357,3,3,"SAIn",0
35,"35018",12552,7609,7547,54,62,"SAIn",3
28,"28022",33479,27129,27037,133,92,"SAIn",4
47,"47052",6576,4988,4944,40,44,"SAIn",1
30,"30037",18793,13150,13003,47,147,"SAIn",4
47,"47173",880,644,638,20,6,"SAIn",0
30,"30021",9099,6095,6045,20,50,"SAIn",5
9,"9297",323,251,250,6,1,"SAIn",0
28,"28128",444,315,314,0,1,"SAIn",0
39,"39059",7986,5879,5806,45,73,"SAIn",0
34,"34060",137,111,108,0,3,"SAIn",0
28,"28070",117,91,91,0,0,"SAIn",0
31,"31014",275,194,192,4,2,"SAIn",0
30,"30007",6411,4360,4329,24,31,"SAIn",0
9,"9350",469,350,343,2,7,"SAIn",0
28,"28051",1541,1163,1149,1,14,"SAIn",1
9,"9198",104,83,82,1,1,"SAIn",0
19,"19324",176,126,125,3,1,"SAIn",0
35,"35028",9776,5476,5401,43,75,"SAIn",2
47,"47124",392,316,311,3,5,"SAIn",0
9,"9448",212,169,165,0,4,"SAIn",0
9,"9110",80,63,63,0,0,"SAIn",0
34,"34171",968,708,703,5,5,"SAIn",0
47,"47051",335,268,263,2,5,"SAIn",0
31,"31092",662,439,435,4,4,"SAIn",0
9,"9423",27,24,24,0,0,"SAIn",0
19,"19161",211,159,157,1,2,"SAIn",0
31,"31015",1994,1412,1392,25,20,"SAIn",1
39,"39091",1926,1493,1476,10,17,"SAIn",1
47,"47212",380,323,322,2,1,"SAIn",0
15,"15032",3444,2322,2269,30,53,"SAIn",0
34,"34038",277,204,203,1,1,"SAIn",0
47,"47110",450,350,346,1,4,"SAIn",0
31,"31005",301,212,211,3,1,"SAIn",0
9,"9228",160,137,136,1,1,"SAIn",0
19,"19249",32,29,29,0,0,"SAIn",0
9,"9382",33,28,28,0,0,"SAIn",0
47,"47003",227,180,179,3,1,"SAIn",0
15,"15069",6745,4910,4850,43,60,"SAIn",4
34,"34125",86,65,64,0,1,"SAIn",0
9,"9243",76,59,57,1,2,"SAIn",0
9,"9424",36,29,29,1,0,"SAIn",0
9,"9117",76,60,60,0,0,"SAIn",0
31,"31231",117,76,73,1,3,"SAIn",0
9,"9304",199,157,155,3,2,"SAIn",0
47,"47200",85,66,66,0,0,"SAIn",0
34,"34131",59,52,51,0,1,"SAIn",0
47,"47135",83,72,72,2,0,"SAIn",0
31,"31050",6014,3489,3450,57,39,"SAIn",2
31,"31072",5279,3734,3679,40,55,"SAIn",1
9,"9229",198,146,143,0,3,"SAIn",0
34,"34036",211,150,150,0,0,"SAIn",0
28,"28016",79,53,51,0,2,"SAIn",0
19,"19235",93,71,71,1,0,"SAIn",0
31,"31062",1087,830,818,3,12,"SAIn",3
15,"15034",2885,1782,1760,18,22,"SAIn",0
28,"28007",124592,94222,93521,491,701,"SAIn",27
19,"19309",26,21,21,0,0,"SAIn",0
15,"15031",23348,16380,16235,191,145,"SAIn",9
9,"9259",230,186,186,5,0,"SAIn",0
31,"31040",192,139,138,4,1,"SAIn",0
9,"9230",38,32,32,0,0,"SAIn",0
19,"19002",69,58,57,0,1,"SAIn",0
31,"31052",96,62,61,0,1,"SAIn",0
47,"47226",156,123,123,0,0,"SAIn",0
39,"39074",6902,5113,5039,40,74,"SAIn",1
19,"19047",64,55,55,0,0,"SAIn",0
47,"47109",179,138,138,2,0,"SAIn",1
31,"31151",66,46,46,1,0,"SAIn",0
9,"9027",46,42,41,0,1,"SAIn",0
31,"31086",13188,9713,9642,111,71,"SAIn",31
39,"39038",1452,997,990,8,7,"SAIn",0
9,"9143",27,19,18,0,1,"SAIn",0
47,"47125",58,46,46,0,0,"SAIn",1
34,"34157",2442,1792,1768,21,24,"SAIn",0
19,"19293",1867,1358,1342,7,16,"SAIn",0
9,"9429",56,41,41,0,0,"SAIn",0
19,"19311",82,69,67,0,2,"SAIn",0
34,"34231",229,168,167,1,1,"SAIn",0
19,"19167",130,101,99,0,2,"SAIn",0
31,"31186",299,195,194,3,1,"SAIn",1
28,"28065",126539,96997,96210,505,787,"SAIn",19
39,"39008",13877,10258,10153,96,105,"SAIn",9
9,"9215",368,256,256,2,0,"SAIn",0
28,"28026",6317,4734,4701,33,33,"SAIn",1
9,"9348",148,111,110,2,1,"SAIn",0
31,"31262",228,179,178,5,1,"SAIn",0
19,"19139",29,19,18,0,1,"SAIn",0
31,"31120",388,250,249,3,1,"SAIn",0
35,"35016",297736,192251,190256,1386,1995,"SAIn",76
9,"9066",62,48,47,0,1,"SAIn",0
47,"47210",382,282,274,3,8,"SAIn",0
39,"39046",1404,1001,973,6,28,"SAIn",0
9,"9194",2020,1472,1459,9,13,"SAIn",0
28,"28010",9963,7745,7688,25,57,"SAIn",2
19,"19901",41,38,37,0,1,"SAIn",0
34,"34037",302,218,216,1,2,"SAIn",0
31,"31048",176,132,130,4,2,"SAIn",0
15,"15005",24516,15761,15537,213,224,"SAIn",14
9,"9018",24668,17575,17369,111,206,"SAIn",7
34,"34066",59,49,48,0,1,"SAIn",0
9,"9128",80,63,63,0,0,"SAIn",0
34,"34163",45,38,38,0,0,"SAIn",0
34,"34084",138,109,107,0,2,"SAIn",0
47,"47084",1150,887,870,7,17,"SAIn",0
9,"9236",38,32,32,0,0,"SAIn",0
31,"31026",144,118,117,0,1,"SAIn",0
19,"19169",40,34,34,0,0,"SAIn",0
9,"9242",80,66,66,2,0,"SAIn",0
15,"15044",1286,937,927,8,10,"SAIn",0
47,"47053",119,98,96,0,2,"SAIn",0
19,"19299",97,79,77,1,2,"SAIn",0
31,"31064",1424,1121,1104,3,17,"SAIn",0
9,"9298",82,70,69,1,1,"SAIn",0
9,"9132",171,122,122,2,0,"SAIn",0
47,"47117",301,233,227,2,6,"SAIn",0
9,"9094",53,42,42,1,0,"SAIn",4
9,"9269",36,26,26,1,0,"SAIn",0
34,"34001",34,28,28,2,0,"SAIn",0
19,"19307",27,23,23,0,0,"SAIn",0
9,"9037",111,91,91,0,0,"SAIn",0
19,"19306",25,20,20,1,0,"SAIn",0
28,"28057",1458,1097,1088,3,9,"SAIn",0
47,"47223",157,122,118,2,4,"SAIn",0
47,"47036",228,181,181,3,0,"SAIn",0
31,"31106",698,533,529,3,4,"SAIn",0
31,"31202",4305,2845,2803,31,42,"SAIn",1
31,"31139",159,96,95,0,1,"SAIn",0
15,"15017",19420,13661,13505,175,156,"SAIn",9
19,"19088",79,61,61,0,0,"SAIn",0
47,"47186",246129,186191,184733,1198,1458,"SAIn",165
9,"9093",154,121,119,0,2,"SAIn",0
19,"19183",74,65,65,0,0,"SAIn",0
39,"39079",8874,6547,6478,47,69,"SAIn",2
31,"31179",502,348,345,0,3,"SAIn",0
15,"15080",1756,1131,1117,11,14,"SAIn",2
31,"31185",494,341,341,1,0,"SAIn",0
9,"9170",205,162,162,1,0,"SAIn",0
19,"19262",135,100,100,0,0,"SAIn",0
9,"9083",37,33,33,0,0,"SAIn",0
39,"39012",6687,5021,4957,51,64,"SAIn",1
39,"39029",618,488,481,3,7,"SAIn",0
9,"9129",104,83,83,0,0,"SAIn",0
15,"15011",15432,10395,10248,74,147,"SAIn",4
9,"9125",584,432,430,1,2,"SAIn",0
39,"39060",6679,5196,5121,29,75,"SAIn",4
28,"28017",1208,907,899,7,8,"SAIn",0
31,"31059",186,131,131,1,0,"SAIn",0
31,"31131",901,646,638,7,8,"SAIn",0
47,"47168",29,26,26,1,0,"SAIn",0
34,"34141",177,149,145,2,4,"SAIn",0
31,"31147",100,82,82,2,0,"SAIn",0
47,"47027",2745,2036,2018,9,18,"SAIn",0
9,"9218",369,275,275,1,0,"SAIn",0
31,"31239",322,211,211,5,0,"SAIn",0
19,"19223",111,83,83,3,0,"SAIn",0
39,"39023",6330,4737,4672,25,65,"SAIn",8
47,"47188",111,88,88,3,0,"SAIn",0
31,"31163",2013,1418,1383,13,35,"SAIn",1
35,"35024",13735,8545,8439,77,106,"SAIn",1
31,"31215",4676,3284,3240,36,44,"SAIn",2
28,"28048",500,391,387,3,4,"SAIn",0
47,"47133",2682,2033,2015,16,18,"SAIn",1
39,"39075",137376,99899,99048,718,851,"SAIn",63
19,"19043",84,72,72,0,0,"SAIn",0
9,"9373",425,287,285,2,2,"SAIn",0
19,"19107",294,239,237,0,2,"SAIn",0
9,"9413",436,306,302,2,4,"SAIn",0
31,"31029",914,638,625,6,13,"SAIn",0
47,"47197",876,673,668,8,5,"SAIn",0
28,"28035",1353,1006,998,2,8,"SAIn",1
9,"9353",76,57,56,1,1,"SAIn",0
9,"9174",794,559,552,4,7,"SAIn",0
34,"34133",107,91,90,0,1,"SAIn",0
34,"34024",31,21,21,1,0,"SAIn",0
9,"9232",154,119,116,0,3,"SAIn",0
9,"9417",40,32,32,1,0,"SAIn",0
19,"19291",1191,879,869,3,10,"SAIn",0
19,"19142",265,182,180,3,2,"SAIn",0
28,"28112",161,136,136,1,0,"SAIn",0
9,"9144",53,40,40,0,0,"SAIn",0
15,"15049",1098,758,752,7,6,"SAIn",0
9,"9249",46,33,33,0,0,"SAIn",0
31,"31162",47,31,31,0,0,"SAIn",0
19,"19123",40,32,31,1,1,"SAIn",0
39,"39006",1711,1307,1287,10,20,"SAIn",0
34,"34006",81,67,66,2,1,"SAIn",0
19,"19104",14,12,12,1,0,"SAIn",0
19,"19297",32,24,24,1,0,"SAIn",0
47,"47217",1910,1370,1366,1,4,"SAIn",0
9,"9250",269,196,194,1,2,"SAIn",0
31,"31076",2417,1918,1906,9,12,"SAIn",15
34,"34081",61,53,52,0,1,"SAIn",0
34,"34180",66,55,55,1,0,"SAIn",0
9,"9155",27,20,20,0,0,"SAIn",0
31,"31265",82,53,53,2,0,"SAIn",0
9,"9009",163,133,131,2,2,"SAIn",0
19,"19296",30,19,18,0,1,"SAIn",0
47,"47228",440,331,331,2,0,"SAIn",1
19,"19267",19,13,13,0,0,"SAIn",0
19,"19132",92,81,81,0,0,"SAIn",0
19,"19190",2369,1760,1745,10,15,"SAIn",1
31,"31054",462,255,250,4,5,"SAIn",1
15,"15043",5114,3476,3401,47,75,"SAIn",2
19,"19004",67,53,53,1,0,"SAIn",0
31,"31253",129,109,109,0,0,"SAIn",0
31,"31121",62,44,43,0,1,"SAIn",0
19,"19009",259,200,195,6,5,"SAIn",0
19,"19174",109,80,79,0,1,"SAIn",0
15,"15048",4839,3456,3414,36,42,"SAIn",0
9,"9025",122,83,83,1,0,"SAIn",0
9,"9014",195,115,114,1,1,"SAIn",1
9,"9368",22,17,17,2,0,"SAIn",0
34,"34104",246,185,182,1,3,"SAIn",0
30,"30042",1922,1504,1491,7,13,"SAIn",0
31,"31222",62,36,34,3,2,"SAIn",1
19,"19021",1030,759,744,7,15,"SAIn",0
34,"34160",139,115,114,3,1,"SAIn",0
35,"35033",6398,4340,4266,19,74,"SAIn",2
31,"31142",1403,958,949,10,9,"SAIn",1
47,"47030",993,766,751,6,15,"SAIn",1
19,"19221",48,38,37,1,1,"SAIn",0
19,"19305",155,116,115,0,1,"SAIn",0
9,"9309",301,224,220,0,4,"SAIn",0
34,"34109",59,48,48,0,0,"SAIn",0
9,"9119",46,28,28,0,0,"SAIn",0
39,"39002",3298,2342,2309,13,33,"SAIn",0
39,"39003",297,220,215,0,5,"SAIn",0
34,"34070",154,123,123,2,0,"SAIn",0
47,"47073",122,103,101,1,2,"SAIn",0
31,"31173",861,683,667,3,16,"SAIn",0
7,"7047",2246,1517,1482,18,35,"SI",45
7,"7057",7169,4719,4659,47,60,"SI",139
7,"7004",3854,2574,2547,30,27,"SI",64
7,"7021",230,177,174,2,3,"SI",2
7,"7049",1480,1003,993,14,10,"SI",59
7,"7030",1551,1127,1101,13,26,"SI",115
7,"7018",382,272,269,1,3,"SI",3
7,"7034",1008,743,734,7,9,"SI",13
7,"7009",738,521,510,12,11,"SI",19
7,"7033",27104,15524,15337,174,187,"SI",623
7,"7020",3581,2542,2502,43,40,"SI",46
7,"7006",5178,3366,3329,52,37,"SI",109
7,"7017",851,582,571,7,11,"SI",21
7,"7051",5215,3171,3134,39,37,"SI",100
7,"7003",11761,6631,6541,55,90,"SI",168
7,"7065",2083,1346,1328,9,18,"SI",57
7,"7061",9819,6351,6280,53,71,"SI",140
7,"7060",2568,1677,1653,16,24,"SI",147
7,"7063",1418,1043,1033,6,10,"SI",10
7,"7052",4667,2908,2886,29,22,"SI",22
7,"7058",2791,2060,2034,13,26,"SI",54
7,"7031",23833,14836,14707,124,129,"SI",197
7,"7007",421,296,293,2,3,"SI",9
7,"7036",26955,18578,18433,148,145,"SI",171
7,"7010",4880,3395,3361,32,34,"SI",69
7,"7002",6341,4295,4255,39,40,"SI",29
7,"7040",280477,173945,172463,1359,1482,"SI",1531
7,"7053",1188,926,918,16,8,"SI",20
7,"7035",1524,1078,1055,8,23,"SI",61
7,"7005",6710,4127,4090,25,37,"SI",34
7,"7025",472,355,351,1,4,"SI",5
7,"7055",7442,4604,4553,42,51,"SI",184
7,"7038",2010,1424,1412,18,12,"SI",36
7,"7901",610,462,459,7,3,"SI",35
7,"7039",4839,3136,3060,31,76,"SI",85
7,"7032",20034,12824,12710,110,114,"SI",101
7,"7028",899,601,595,7,6,"SI",35
7,"7037",3197,1934,1917,26,17,"SI",22
7,"7056",5026,3410,3375,32,35,"SI",68
7,"7064",5315,3475,3434,31,41,"SI",31
7,"7023",3604,2498,2470,49,28,"SI",52
7,"7043",3389,2290,2252,26,38,"SI",104
7,"7050",3348,2156,2139,19,17,"SI",22
7,"7902",1064,685,664,15,21,"SI",9
7,"7012",1876,1369,1353,13,16,"SI",36
7,"7014",7320,4163,4116,45,47,"SI",47
7,"7044",8439,5681,5543,48,138,"SI",269
7,"7024",6843,3657,3612,38,45,"SI",52
7,"7011",27721,17817,17720,139,97,"SI",103
7,"7001",3573,2531,2497,21,34,"SI",39
7,"7026",31074,18280,18135,168,145,"SI",97
7,"7042",10666,6680,6613,64,67,"SI",265
7,"7054",22334,12814,12708,99,106,"SI",70
7,"7062",7513,4273,4219,52,54,"SI",59
7,"7019",187,133,129,2,4,"SI",5
7,"7046",15797,9127,9043,86,84,"SI",46
7,"7045",1295,947,936,5,11,"SI",21
7,"7059",2996,2053,2013,17,40,"SI",61
7,"7041",2044,1486,1451,13,35,"SI",115
7,"7027",20769,13097,12987,100,110,"SI",314
7,"7029",4166,2949,2913,37,36,"SI",49
7,"7013",6881,4693,4587,39,106,"SI",169
7,"7008",5692,3956,3913,26,43,"SI",107
7,"7016",2809,1865,1836,23,29,"SI",33
7,"7022",11545,7385,7306,88,79,"SI",353
7,"7048",17252,10055,9984,105,71,"SI",96
7,"7015",20991,12552,12433,184,119,"SI",141
46,"46093",2118,1647,1624,4,23,"SOMVAL",4
3,"3075",147,128,128,0,0,"SOMVAL",2
3,"3069",3076,2123,2102,17,21,"SOMVAL",1
46,"46033",191,156,155,0,1,"SOMVAL",1
12,"12098",580,451,447,5,4,"SOMVAL",0
3,"3902",10254,6996,6930,34,66,"SOMVAL",4
12,"12094",847,674,665,5,9,"SOMVAL",1
46,"46256",6853,4951,4890,25,61,"SOMVAL",33
46,"46114",569,461,458,1,3,"SOMVAL",0
3,"3040",254,216,213,2,3,"SOMVAL",0
12,"12128",1393,1090,1072,10,18,"SOMVAL",0
12,"12060",446,368,364,4,4,"SOMVAL",0
46,"46215",1436,1154,1143,5,11,"SOMVAL",2
3,"3093",19683,14633,14484,70,149,"SOMVAL",7
46,"46171",16563,12213,12128,85,85,"SOMVAL",56
12,"12111",360,305,299,3,6,"SOMVAL",2
3,"3058",4951,3897,3851,30,46,"SOMVAL",1
46,"46159",22857,16840,16697,128,143,"SOMVAL",77
12,"12011",4565,3331,3283,20,48,"SOMVAL",10
46,"46241",392,299,291,1,8,"SOMVAL",1
3,"3089",9571,6775,6639,47,136,"SOMVAL",1
46,"46116",13159,10193,10135,53,58,"SOMVAL",29
46,"46064",509,412,399,1,13,"SOMVAL",2
46,"46197",1942,1527,1514,5,13,"SOMVAL",4
12,"12002",110,99,98,1,1,"SOMVAL",0
46,"46090",1637,1391,1367,3,24,"SOMVAL",6
12,"12046",191,151,150,2,1,"SOMVAL",0
46,"46010",935,729,723,4,6,"SOMVAL",5
46,"46168",1938,1495,1486,2,9,"SOMVAL",1
46,"46040",1078,888,878,7,10,"SOMVAL",2
12,"12073",152,119,117,0,2,"SOMVAL",0
46,"46149",363,271,268,2,3,"SOMVAL",0
3,"3027",157,138,135,0,3,"SOMVAL",0
3,"3030",524,448,440,5,8,"SOMVAL",2
46,"46048",3452,2749,2713,14,36,"SOMVAL",8
46,"46100",286,232,230,1,2,"SOMVAL",2
12,"12022",344,265,262,2,3,"SOMVAL",0
3,"3132",534,436,435,3,1,"SOMVAL",0
46,"46079",318,241,232,1,9,"SOMVAL",0
12,"12097",63,49,49,0,0,"SOMVAL",0
3,"3092",6743,5254,5178,37,76,"SOMVAL",10
46,"46134",2357,1725,1712,14,13,"SOMVAL",2
46,"46056",182,167,166,1,1,"SOMVAL",2
46,"46038",327,242,242,3,0,"SOMVAL",3
46,"46009",3121,2459,2427,8,32,"SOMVAL",6
3,"3102",7229,5492,5414,52,78,"SOMVAL",19
46,"46154",808,636,631,5,5,"SOMVAL",6
46,"46249",9288,6746,6676,56,70,"SOMVAL",2
3,"3091",252,217,215,2,2,"SOMVAL",0
46,"46211",1745,1387,1378,8,9,"SOMVAL",6
46,"46246",1058,835,823,5,12,"SOMVAL",2
46,"46049",281,232,224,0,8,"SOMVAL",0
46,"46206",571,453,445,2,8,"SOMVAL",0
3,"3062",212,169,165,0,4,"SOMVAL",0
3,"3120",2406,1753,1720,11,33,"SOMVAL",0
46,"46014",3030,2383,2350,20,33,"SOMVAL",6
12,"12031",3807,2941,2894,24,47,"SOMVAL",0
46,"46085",11081,7938,7866,46,72,"SOMVAL",29
46,"46201",64,52,51,1,1,"SOMVAL",0
3,"3123",7476,5557,5501,29,56,"SOMVAL",2
46,"46253",115,82,82,0,0,"SOMVAL",0
46,"46131",49431,36570,36227,231,343,"SOMVAL",128
12,"12005",8062,5829,5754,64,75,"SOMVAL",6
12,"12114",198,144,144,1,0,"SOMVAL",2
46,"46155",1029,833,822,4,11,"SOMVAL",0
46,"46107",1900,1516,1504,5,12,"SOMVAL",1
12,"12026",881,678,663,13,15,"SOMVAL",0
3,"3014",237287,167428,166445,847,983,"SOMVAL",65
12,"12101",358,279,275,3,4,"SOMVAL",0
46,"46047",532,446,437,2,9,"SOMVAL",0
46,"46061",342,274,272,1,2,"SOMVAL",5
12,"12074",785,652,648,5,4,"SOMVAL",0
46,"46247",1006,714,710,3,4,"SOMVAL",0
46,"46220",48410,34644,34292,279,352,"SOMVAL",72
46,"46202",16947,12814,12710,79,104,"SOMVAL",49
46,"46232",895,711,696,5,15,"SOMVAL",0
12,"12051",471,339,335,1,4,"SOMVAL",1
12,"12072",1101,929,911,11,18,"SOMVAL",2
46,"46254",1000,785,779,6,6,"SOMVAL",1
3,"3024",3901,3067,3024,11,43,"SOMVAL",0
12,"12038",167,120,118,2,2,"SOMVAL",0
3,"3010",325,277,275,1,2,"SOMVAL",0
46,"46036",564,383,378,5,5,"SOMVAL",1
12,"12090",102,86,85,1,1,"SOMVAL",0
12,"12029",702,557,555,4,2,"SOMVAL",0
46,"46098",2482,1907,1889,11,18,"SOMVAL",6
46,"46006",4523,3665,3623,20,42,"SOMVAL",5
46,"46160",1913,1452,1436,1,16,"SOMVAL",6
3,"3085",272,217,213,0,4,"SOMVAL",1
12,"12135",35719,26016,25793,196,223,"SOMVAL",37
3,"3067",99,85,85,0,0,"SOMVAL",0
3,"3061",1056,776,768,4,8,"SOMVAL",0
3,"3057",182,147,147,1,0,"SOMVAL",0
3,"3022",145,125,125,0,0,"SOMVAL",0
3,"3043",2911,2431,2399,13,32,"SOMVAL",0
46,"46192",761,576,570,5,6,"SOMVAL",2
3,"3035",652,547,541,1,6,"SOMVAL",1
46,"46088",166,125,125,4,0,"SOMVAL",0
46,"46119",780,653,647,5,6,"SOMVAL",2
12,"12016",1582,1307,1297,6,10,"SOMVAL",3
3,"3904",1396,1033,1026,4,7,"SOMVAL",0
12,"12052",578,452,435,3,17,"SOMVAL",0
46,"46183",5993,4443,4381,19,62,"SOMVAL",7
46,"46189",467,393,390,2,3,"SOMVAL",1
46,"46020",3760,2916,2866,22,50,"SOMVAL",9
3,"3112",628,511,507,2,4,"SOMVAL",1
46,"46099",901,689,684,1,5,"SOMVAL",1
46,"46194",15567,11156,11044,86,112,"SOMVAL",55
12,"12124",1840,1387,1381,33,6,"SOMVAL",0
46,"46139",4485,3617,3574,18,43,"SOMVAL",2
3,"3034",1376,1067,1052,5,15,"SOMVAL",1
12,"12095",959,749,742,8,7,"SOMVAL",0
46,"46231",2421,1721,1708,14,13,"SOMVAL",2
46,"46071",464,383,377,0,6,"SOMVAL",0
12,"12091",177,113,112,0,1,"SOMVAL",0
46,"46066",1263,1024,1018,9,6,"SOMVAL",10
3,"3019",15269,11520,11398,72,122,"SOMVAL",3
3,"3106",583,480,478,2,2,"SOMVAL",0
46,"46129",524,420,412,4,8,"SOMVAL",1
12,"12141",101,83,83,0,0,"SOMVAL",0
12,"12129",1828,1322,1298,11,24,"SOMVAL",1
46,"46903",6065,4790,4763,18,27,"SOMVAL",17
12,"12053",2034,1655,1633,6,22,"SOMVAL",2
46,"46039",2130,1728,1699,8,29,"SOMVAL",5
12,"12004",4170,3125,3088,19,37,"SOMVAL",2
46,"46214",15766,12131,12036,42,95,"SOMVAL",48
46,"46128",1597,1290,1250,5,40,"SOMVAL",2
12,"12084",17615,12766,12644,105,122,"SOMVAL",13
46,"46157",2980,2321,2298,10,23,"SOMVAL",6
3,"3048",4847,3719,3683,20,36,"SOMVAL",1
46,"46242",333,267,266,0,1,"SOMVAL",0
12,"12032",23525,17093,16966,104,127,"SOMVAL",56
46,"46207",6676,5106,5040,41,66,"SOMVAL",20
12,"12089",4328,3078,3020,15,58,"SOMVAL",3
46,"46051",8347,6355,6302,24,53,"SOMVAL",32
12,"12130",404,340,335,0,5,"SOMVAL",0
12,"12117",3585,2727,2677,20,50,"SOMVAL",5
46,"46030",800,627,614,5,13,"SOMVAL",3
46,"46176",2017,1358,1349,5,9,"SOMVAL",9
3,"3060",109,91,91,0,0,"SOMVAL",1
3,"3009",46657,35143,34801,223,342,"SOMVAL",31
46,"46058",1772,1398,1373,15,25,"SOMVAL",5
46,"46021",23649,17291,17153,100,138,"SOMVAL",44
12,"12902",2158,1504,1489,14,15,"SOMVAL",2
46,"46177",4690,3579,3526,19,53,"SOMVAL",15
12,"12123",48,40,40,3,0,"SOMVAL",0
12,"12069",66,49,48,0,1,"SOMVAL",0
46,"46081",10134,7771,7702,41,69,"SOMVAL",27
12,"12033",1919,1437,1404,19,33,"SOMVAL",1
46,"46087",120,98,97,0,1,"SOMVAL",0
12,"12127",75,55,55,0,0,"SOMVAL",0
46,"46136",2537,1952,1930,11,22,"SOMVAL",1
46,"46082",4918,3745,3712,33,33,"SOMVAL",15
3,"3007",166,139,137,0,2,"SOMVAL",0
12,"12039",833,717,710,4,7,"SOMVAL",2
46,"46113",2457,1804,1782,6,22,"SOMVAL",9
46,"46203",3606,2873,2844,9,29,"SOMVAL",5
12,"12121",1107,924,893,4,31,"SOMVAL",0
46,"46055",1262,1025,1012,5,13,"SOMVAL",2
46,"46133",533,415,410,6,5,"SOMVAL",0
3,"3051",348,296,294,0,2,"SOMVAL",0
3,"3020",99,79,79,0,0,"SOMVAL",0
46,"46146",1654,1304,1278,7,26,"SOMVAL",3
46,"46111",10930,7931,7828,44,103,"SOMVAL",8
46,"46230",13960,10351,10241,54,110,"SOMVAL",70
3,"3005",7769,5917,5866,19,51,"SOMVAL",3
46,"46161",1483,1188,1173,7,15,"SOMVAL",3
46,"46112",536,455,450,2,5,"SOMVAL",1
12,"12043",570,449,442,2,7,"SOMVAL",2
12,"12020",118,105,105,0,0,"SOMVAL",0
3,"3053",7226,5651,5584,32,67,"SOMVAL",6
12,"12018",287,246,242,1,4,"SOMVAL",0
3,"3082",12567,8537,8464,44,73,"SOMVAL",11
46,"46077",7496,5909,5827,45,82,"SOMVAL",5
3,"3063",26462,18591,18492,91,99,"SOMVAL",27
46,"46110",21228,15563,15443,86,120,"SOMVAL",52
46,"46188",672,544,537,8,7,"SOMVAL",0
3,"3080",1300,1035,1025,3,10,"SOMVAL",0
46,"46075",150,130,123,1,7,"SOMVAL",0
46,"46173",1328,1069,1057,4,12,"SOMVAL",3
3,"3002",3605,2583,2557,15,26,"SOMVAL",3
3,"3050",18652,13325,13234,57,91,"SOMVAL",8
46,"46240",210,164,161,1,3,"SOMVAL",0
12,"12003",976,746,736,6,10,"SOMVAL",1
12,"12044",468,419,412,3,7,"SOMVAL",0
12,"12093",178,137,136,2,1,"SOMVAL",1
46,"46243",138,115,112,1,3,"SOMVAL",1
3,"3095",4579,3489,3459,25,30,"SOMVAL",12
3,"3116",1155,877,875,6,2,"SOMVAL",1
3,"3117",362,318,313,2,5,"SOMVAL",0
3,"3099",42319,31083,30801,165,282,"SOMVAL",4
46,"46262",223,162,159,2,3,"SOMVAL",0
12,"12102",522,423,418,1,5,"SOMVAL",1
12,"12083",93,79,76,0,3,"SOMVAL",0
46,"46186",19068,14599,14474,69,125,"SOMVAL",58
12,"12008",222,193,192,1,1,"SOMVAL",1
46,"46029",20613,14964,14879,93,85,"SOMVAL",36
46,"46067",1753,1418,1393,1,25,"SOMVAL",10
12,"12041",100,81,81,0,0,"SOMVAL",0
12,"12076",84,69,69,0,0,"SOMVAL",0
46,"46024",413,314,313,2,1,"SOMVAL",0
12,"12112",99,79,78,3,1,"SOMVAL",0
46,"46053",553,445,436,2,9,"SOMVAL",0
46,"46001",795,601,592,3,9,"SOMVAL",0
46,"46140",344,284,279,0,5,"SOMVAL",0
46,"46152",96,68,68,0,0,"SOMVAL",0
3,"3903",2494,1880,1865,7,15,"SOMVAL",1
46,"46127",2692,2120,2091,18,29,"SOMVAL",5
46,"46213",15409,10924,10805,97,119,"SOMVAL",9
12,"12055",104,83,82,3,1,"SOMVAL",1
12,"12113",83,67,66,3,1,"SOMVAL",0
12,"12048",251,185,182,0,3,"SOMVAL",0
46,"46258",2652,2084,2062,16,22,"SOMVAL",2
12,"12017",161,130,128,0,2,"SOMVAL",0
46,"46902",364,306,303,0,3,"SOMVAL",2
12,"12078",325,235,233,0,2,"SOMVAL",0
12,"12137",36,23,23,0,0,"SOMVAL",0
46,"46185",378,320,313,2,7,"SOMVAL",0
12,"12096",777,587,577,6,10,"SOMVAL",0
46,"46147",16835,11920,11791,61,129,"SOMVAL",49
12,"12116",58,49,49,0,0,"SOMVAL",0
3,"3056",8676,6638,6541,34,97,"SOMVAL",12
3,"3074",1707,1397,1389,4,8,"SOMVAL",0
3,"3098",505,393,386,0,7,"SOMVAL",0
46,"46070",16950,12765,12676,61,89,"SOMVAL",50
12,"12021",4436,3381,3332,27,49,"SOMVAL",6
46,"46142",787,619,602,1,17,"SOMVAL",1
46,"46003",950,791,769,1,22,"SOMVAL",8
3,"3038",355,288,285,3,3,"SOMVAL",0
3,"3004",581,438,437,2,1,"SOMVAL",0
46,"46050",194,150,149,0,1,"SOMVAL",0
3,"3084",539,454,446,3,8,"SOMVAL",0
3,"3135",211,170,166,2,4,"SOMVAL",0
12,"12045",345,268,259,1,9,"SOMVAL",0
46,"46217",878,691,676,4,15,"SOMVAL",0
46,"46223",7801,5950,5899,34,51,"SOMVAL",24
12,"12107",355,303,299,4,4,"SOMVAL",0
12,"12088",62,59,59,0,0,"SOMVAL",0
12,"12139",318,237,233,0,4,"SOMVAL",0
12,"12027",17283,12015,11888,89,127,"SOMVAL",21
12,"12125",216,180,177,0,3,"SOMVAL",0
46,"46175",456,389,387,3,2,"SOMVAL",3
3,"3129",1194,957,938,0,19,"SOMVAL",0
12,"12115",219,179,177,0,2,"SOMVAL",0
46,"46153",439,355,351,1,4,"SOMVAL",1
46,"46042",3380,2799,2755,20,44,"SOMVAL",2
12,"12050",1305,1015,1000,6,15,"SOMVAL",2
46,"46239",442,340,338,3,2,"SOMVAL",0
12,"12028",12586,9733,9676,62,57,"SOMVAL",6
3,"3070",2051,1455,1437,7,18,"SOMVAL",0
12,"12068",48,36,35,1,1,"SOMVAL",0
46,"46162",1189,938,929,3,9,"SOMVAL",2
12,"12010",259,213,208,2,5,"SOMVAL",0
3,"3101",4808,3627,3580,22,47,"SOMVAL",8
46,"46044",4218,3222,3158,18,64,"SOMVAL",1
46,"46144",663,532,529,2,3,"SOMVAL",0
46,"46078",28017,20288,20143,132,145,"SOMVAL",107
46,"46073",1092,888,884,6,4,"SOMVAL",1
3,"3033",117,96,95,0,1,"SOMVAL",0
3,"3012",1085,852,841,3,11,"SOMVAL",0
12,"12059",231,189,188,2,1,"SOMVAL",0
46,"46096",274,209,209,1,0,"SOMVAL",1
12,"12133",59,53,52,0,1,"SOMVAL",0
12,"12013",144,121,119,0,2,"SOMVAL",0
3,"3128",4092,2861,2840,10,21,"SOMVAL",5
3,"3044",4521,3510,3465,21,45,"SOMVAL",0
46,"46084",1576,1263,1242,5,21,"SOMVAL",3
3,"3901",1135,822,817,8,5,"SOMVAL",0
46,"46004",1922,1565,1547,11,18,"SOMVAL",1
46,"46125",847,689,684,5,5,"SOMVAL",2
3,"3131",175,154,147,0,7,"SOMVAL",0
12,"12110",234,176,173,0,3,"SOMVAL",1
3,"3017",374,314,307,1,7,"SOMVAL",0
46,"46032",5653,4402,4361,33,41,"SOMVAL",21
3,"3071",3982,3048,3012,26,36,"SOMVAL",7
12,"12119",148,95,93,0,2,"SOMVAL",0
46,"46244",58771,42137,41867,270,270,"SOMVAL",179
3,"3114",1562,1198,1188,9,10,"SOMVAL",1
3,"3125",343,254,251,0,3,"SOMVAL",0
3,"3028",998,818,812,2,6,"SOMVAL",2
3,"3100",503,440,437,0,3,"SOMVAL",0
3,"3039",81,62,61,1,1,"SOMVAL",0
46,"46178",4637,3405,3381,27,24,"SOMVAL",21
46,"46002",1175,941,932,5,9,"SOMVAL",7
46,"46216",5053,4109,4090,14,19,"SOMVAL",11
46,"46904",792,610,603,8,7,"SOMVAL",7
3,"3076",8467,6238,6157,30,81,"SOMVAL",0
46,"46072",3611,2871,2821,23,50,"SOMVAL",5
3,"3073",236,200,199,1,1,"SOMVAL",0
46,"46101",860,716,705,3,11,"SOMVAL",1
12,"12007",746,651,636,3,15,"SOMVAL",2
46,"46092",276,192,189,0,3,"SOMVAL",0
46,"46023",327,280,278,2,2,"SOMVAL",0
46,"46026",1204,1015,1004,3,11,"SOMVAL",0
3,"3077",1371,1071,1060,13,11,"SOMVAL",1
12,"12085",4976,3236,3209,16,27,"SOMVAL",5
12,"12082",9617,7324,7231,46,93,"SOMVAL",11
46,"46046",892,675,668,1,7,"SOMVAL",1
46,"46121",105,95,94,0,1,"SOMVAL",0
12,"12081",608,486,480,5,6,"SOMVAL",1
46,"46263",251,214,212,0,2,"SOMVAL",0
12,"12901",3405,2626,2598,23,28,"SOMVAL",8
3,"3064",5015,3660,3611,11,49,"SOMVAL",0
46,"46018",608,515,511,0,4,"SOMVAL",0
46,"46174",972,764,752,2,12,"SOMVAL",1
46,"46097",963,733,728,4,5,"SOMVAL",3
12,"12077",4605,3439,3382,15,57,"SOMVAL",6
46,"46200",1903,1561,1539,3,22,"SOMVAL",6
46,"46076",575,454,443,0,11,"SOMVAL",0
3,"3078",478,389,389,5,0,"SOMVAL",0
12,"12065",188,169,169,2,0,"SOMVAL",0
12,"12138",19061,13010,12847,129,163,"SOMVAL",43
3,"3113",4243,3091,3046,10,45,"SOMVAL",2
3,"3127",350,278,273,1,5,"SOMVAL",0
12,"12092",111,91,90,0,1,"SOMVAL",0
12,"12009",17445,12088,11999,75,89,"SOMVAL",18
12,"12080",1932,1598,1570,10,28,"SOMVAL",3
46,"46260",2581,2087,2068,22,19,"SOMVAL",14
3,"3015",12566,9257,9177,39,80,"SOMVAL",1
12,"12142",158,117,117,1,0,"SOMVAL",0
46,"46123",1829,1407,1388,7,19,"SOMVAL",3
12,"12132",480,396,389,3,7,"SOMVAL",1
3,"3065",167284,123032,122305,711,727,"SOMVAL",68
46,"46057",487,321,317,1,4,"SOMVAL",0
3,"3086",151,135,134,1,1,"SOMVAL",0
46,"46028",387,330,328,3,2,"SOMVAL",1
12,"12049",441,322,312,1,10,"SOMVAL",0
3,"3026",1224,949,936,5,13,"SOMVAL",0
3,"3119",16636,12281,12194,57,87,"SOMVAL",6
46,"46234",348,279,275,3,4,"SOMVAL",2
46,"46103",1264,1015,984,7,31,"SOMVAL",5
46,"46199",5718,4314,4266,28,48,"SOMVAL",19
3,"3122",42425,30153,29954,154,199,"SOMVAL",21
3,"3137",651,492,489,5,3,"SOMVAL",1
3,"3003",450,378,376,2,2,"SOMVAL",0
12,"12037",17,16,14,0,2,"SOMVAL",0
3,"3109",2850,2181,2164,8,17,"SOMVAL",0
46,"46184",26505,20428,20223,115,205,"SOMVAL",25
46,"46083",15422,11179,11049,86,130,"SOMVAL",42
3,"3011",7753,5464,5415,27,49,"SOMVAL",1
3,"3079",18224,13904,13709,80,195,"SOMVAL",18
46,"46235",21579,15929,15763,113,166,"SOMVAL",55
3,"3023",1398,1184,1167,7,17,"SOMVAL",0
46,"46250",578719,442973,440154,2541,2819,"SOMVAL",2149
46,"46191",1937,1530,1505,5,25,"SOMVAL",0
3,"3037",346,282,278,3,4,"SOMVAL",1
12,"12134",141,95,94,0,1,"SOMVAL",0
3,"3013",1113,839,836,4,3,"SOMVAL",1
3,"3021",5613,4570,4500,26,70,"SOMVAL",5
46,"46209",1933,1445,1415,5,30,"SOMVAL",5
46,"46238",13282,9786,9721,61,65,"SOMVAL",26
46,"46261",1725,1356,1337,5,19,"SOMVAL",2
46,"46063",1756,1367,1345,15,22,"SOMVAL",3
46,"46210",330,277,277,2,0,"SOMVAL",0
12,"12126",24464,18533,18331,113,202,"SOMVAL",27
46,"46208",1112,887,881,4,6,"SOMVAL",1
46,"46074",2696,2069,2038,14,31,"SOMVAL",9
46,"46137",270,210,207,4,3,"SOMVAL",0
46,"46108",469,378,375,1,3,"SOMVAL",0
46,"46143",4239,3104,3053,14,51,"SOMVAL",10
12,"12136",2635,2201,2171,18,30,"SOMVAL",0
46,"46169",32247,24214,24053,154,161,"SOMVAL",87
46,"46150",1831,1341,1333,7,8,"SOMVAL",2
46,"46126",5556,4449,4405,24,44,"SOMVAL",18
46,"46205",14313,10932,10834,51,98,"SOMVAL",34
46,"46037",1122,936,923,4,13,"SOMVAL",4
46,"46080",998,803,799,7,4,"SOMVAL",0
3,"3016",93,75,75,0,0,"SOMVAL",0
46,"46225",337,290,281,5,9,"SOMVAL",1
3,"3029",245,185,183,1,2,"SOMVAL",0
3,"3134",143,112,111,0,1,"SOMVAL",1
46,"46156",2080,1697,1675,10,22,"SOMVAL",7
46,"46237",7211,5395,5343,42,52,"SOMVAL",30
3,"3036",87,81,78,0,3,"SOMVAL",0
46,"46034",1758,1390,1379,4,11,"SOMVAL",2
3,"3046",1599,1153,1143,8,10,"SOMVAL",0
46,"46052",499,421,417,2,4,"SOMVAL",1
46,"46007",11989,8784,8711,67,73,"SOMVAL",67
3,"3107",2508,1755,1744,7,11,"SOMVAL",3
46,"46182",1266,929,922,6,7,"SOMVAL",2
12,"12079",399,316,314,2,2,"SOMVAL",0
46,"46130",901,687,683,3,4,"SOMVAL",2
3,"3081",1436,1084,1075,5,9,"SOMVAL",2
46,"46163",1866,1504,1480,8,24,"SOMVAL",8
46,"46212",1620,1150,1124,9,26,"SOMVAL",1
12,"12014",184,144,143,2,1,"SOMVAL",0
46,"46179",2165,1760,1737,16,23,"SOMVAL",0
3,"3130",48,25,25,0,0,"SOMVAL",0
3,"3097",993,822,812,6,10,"SOMVAL",1
46,"46158",1026,811,795,6,16,"SOMVAL",0
46,"46135",9680,7682,7634,36,48,"SOMVAL",16
12,"12106",1158,955,942,8,13,"SOMVAL",2
46,"46120",1113,903,875,2,28,"SOMVAL",2
12,"12012",2685,2234,2202,13,32,"SOMVAL",4
46,"46094",20540,15378,15234,102,144,"SOMVAL",119
46,"46198",839,684,674,4,10,"SOMVAL",3
46,"46068",346,276,266,6,10,"SOMVAL",0
46,"46164",11771,8564,8483,64,81,"SOMVAL",24
12,"12040",117608,85588,84946,496,642,"SOMVAL",68
46,"46233",3860,2859,2817,10,42,"SOMVAL",28
46,"46229",948,762,758,0,4,"SOMVAL",0
3,"3140",26070,18999,18742,174,257,"SOMVAL",5
46,"46013",17383,13569,13483,82,86,"SOMVAL",73
3,"3104",27103,19953,19787,131,166,"SOMVAL",11
3,"3049",12088,9121,9027,52,94,"SOMVAL",3
12,"12006",172,135,133,0,2,"SOMVAL",0
46,"46011",7609,5249,5191,26,58,"SOMVAL",20
46,"46060",9369,7052,6993,42,59,"SOMVAL",29
46,"46255",3174,2448,2424,22,24,"SOMVAL",8
46,"46005",22918,16958,16827,102,131,"SOMVAL",58
12,"12120",177,152,152,0,0,"SOMVAL",0
3,"3006",497,384,380,1,4,"SOMVAL",0
46,"46045",1249,1028,1010,3,18,"SOMVAL",3
46,"46124",787,653,642,4,11,"SOMVAL",1
12,"12087",25,18,18,4,0,"SOMVAL",0
12,"12075",123,88,88,0,0,"SOMVAL",0
46,"46228",2348,1815,1794,7,21,"SOMVAL",8
46,"46227",905,711,702,1,9,"SOMVAL",2
3,"3090",17182,12487,12385,74,102,"SOMVAL",9
46,"46104",1940,1504,1487,7,17,"SOMVAL",9
46,"46008",2651,2108,2089,21,19,"SOMVAL",5
12,"12131",63,52,52,0,0,"SOMVAL",0
46,"46122",2704,2082,2063,10,19,"SOMVAL",2
3,"3041",5954,4218,4194,22,24,"SOMVAL",14
46,"46031",10535,7543,7451,66,92,"SOMVAL",38
12,"12025",136,104,104,0,0,"SOMVAL",0
46,"46065",1579,1174,1163,8,11,"SOMVAL",15
3,"3138",3145,2310,2275,9,35,"SOMVAL",4
46,"46069",162,124,123,0,1,"SOMVAL",0
12,"12140",1143,939,930,6,9,"SOMVAL",0
46,"46054",11293,8477,8409,47,68,"SOMVAL",34
12,"12024",143,125,124,0,1,"SOMVAL",0
3,"3052",970,769,755,8,14,"SOMVAL",0
46,"46062",4631,3511,3474,27,37,"SOMVAL",10
46,"46166",8155,6320,6251,30,69,"SOMVAL",33
12,"12058",71,63,62,1,1,"SOMVAL",0
3,"3055",5164,3695,3647,21,48,"SOMVAL",1
12,"12100",1333,1065,1047,10,18,"SOMVAL",0
3,"3047",9207,6309,6226,25,83,"SOMVAL",11
12,"12042",607,520,513,13,7,"SOMVAL",0
46,"46138",343,275,272,1,3,"SOMVAL",0
46,"46167",364,266,264,0,2,"SOMVAL",0
3,"3066",42121,29655,29419,214,236,"SOMVAL",14
46,"46172",5042,3504,3477,22,27,"SOMVAL",12
12,"12109",649,532,524,6,8,"SOMVAL",0
3,"3133",41576,25849,25639,127,210,"SOMVAL",3
46,"46245",511,420,415,0,5,"SOMVAL",1
3,"3072",348,289,285,0,4,"SOMVAL",1
3,"3115",255,222,220,2,2,"SOMVAL",0
46,"46151",728,550,541,0,9,"SOMVAL",0
3,"3121",21273,14569,14468,62,101,"SOMVAL",9
12,"12105",848,644,638,2,6,"SOMVAL",0
46,"46016",1061,870,856,5,14,"SOMVAL",2
46,"46259",491,396,393,4,3,"SOMVAL",0
46,"46221",352,305,304,0,1,"SOMVAL",0
46,"46043",136,124,124,0,0,"SOMVAL",0
3,"3042",1393,1010,996,7,14,"SOMVAL",1
3,"3139",22437,15315,15170,100,145,"SOMVAL",12
46,"46165",7129,5436,5388,25,48,"SOMVAL",39
12,"12057",606,487,474,5,13,"SOMVAL",1
46,"46035",6822,5202,5142,43,60,"SOMVAL",24
46,"46012",896,682,663,1,19,"SOMVAL",0
3,"3110",291,241,241,1,0,"SOMVAL",5
46,"46118",3763,2940,2908,16,32,"SOMVAL",1
46,"46252",118,99,98,0,1,"SOMVAL",0
46,"46022",15365,11093,10997,59,96,"SOMVAL",37
3,"3096",5786,4358,4289,17,69,"SOMVAL",5
12,"12104",6933,5411,5342,25,69,"SOMVAL",9
12,"12099",539,416,403,7,13,"SOMVAL",0
12,"12061",373,285,282,3,3,"SOMVAL",0
3,"3103",272,235,234,1,1,"SOMVAL",1
3,"3059",20583,15125,15018,63,107,"SOMVAL",8
46,"46105",16190,11323,11206,44,117,"SOMVAL",33
46,"46102",19788,15154,15038,89,116,"SOMVAL",41
46,"46195",1962,1531,1516,11,15,"SOMVAL",7
3,"3008",168,130,129,0,1,"SOMVAL",0
46,"46015",7244,5615,5560,40,55,"SOMVAL",62
3,"3068",47,44,44,0,0,"SOMVAL",0
46,"46180",682,553,549,0,4,"SOMVAL",2
46,"46132",2150,1803,1784,7,19,"SOMVAL",0
12,"12108",456,378,371,2,7,"SOMVAL",0
46,"46025",2499,1953,1934,8,19,"SOMVAL",20
46,"46257",5571,4266,4224,25,42,"SOMVAL",12
46,"46219",127,112,112,1,0,"SOMVAL",0
46,"46222",384,307,304,1,3,"SOMVAL",2
46,"46248",4897,3596,3544,18,52,"SOMVAL",9
46,"46196",147,125,125,1,0,"SOMVAL",0
3,"3001",337,269,268,0,1,"SOMVAL",0
12,"12067",537,435,427,0,8,"SOMVAL",0
46,"46218",1060,910,885,7,25,"SOMVAL",4
12,"12034",1424,1065,1035,3,30,"SOMVAL",4
46,"46017",32949,23913,23685,142,228,"SOMVAL",160
12,"12070",522,406,401,0,5,"SOMVAL",0
46,"46091",118,94,94,0,0,"SOMVAL",1
3,"3124",460,388,384,3,4,"SOMVAL",2
3,"3032",108,91,90,1,1,"SOMVAL",0
46,"46236",972,818,809,2,9,"SOMVAL",2
3,"3105",5373,3911,3828,15,83,"SOMVAL",1
46,"46086",82,70,69,1,1,"SOMVAL",0
46,"46145",21990,16337,16187,93,150,"SOMVAL",52
46,"46190",48947,35638,35419,211,219,"SOMVAL",113
12,"12064",91,82,81,2,1,"SOMVAL",0
46,"46187",1306,1017,1000,0,17,"SOMVAL",5
46,"46117",495,402,399,5,3,"SOMVAL",2
12,"12122",796,637,627,0,10,"SOMVAL",0
3,"3136",441,338,334,0,4,"SOMVAL",0
12,"12063",41,29,29,1,0,"SOMVAL",0
46,"46181",16955,12313,12148,95,165,"SOMVAL",31
46,"46224",159,121,121,0,0,"SOMVAL",0
12,"12001",1051,821,800,4,21,"SOMVAL",1
46,"46226",41,36,35,0,1,"SOMVAL",0
3,"3118",2437,1659,1642,4,17,"SOMVAL",0
12,"12118",72,55,53,0,2,"SOMVAL",0
3,"3018",12240,8853,8777,47,76,"SOMVAL",4
46,"46095",610,467,459,1,8,"SOMVAL",1
46,"46148",1513,1160,1146,7,14,"SOMVAL",4
12,"12071",1274,992,979,3,13,"SOMVAL",1
3,"3094",9080,6440,6396,34,44,"SOMVAL",4
46,"46019",8849,7072,7004,33,68,"SOMVAL",14
12,"12015",93,81,78,0,3,"SOMVAL",0
3,"3088",5498,4041,3989,29,52,"SOMVAL",0
46,"46251",2462,1997,1956,6,41,"SOMVAL",1
3,"3083",5586,3971,3928,33,43,"SOMVAL",9
12,"12036",581,426,421,10,5,"SOMVAL",3
46,"46041",329,253,252,5,1,"SOMVAL",0
3,"3045",210,176,172,0,4,"SOMVAL",1
46,"46193",8788,6925,6871,50,54,"SOMVAL",28
46,"46089",2132,1602,1574,9,28,"SOMVAL",5
3,"3031",41499,27031,26813,128,218,"SOMVAL",14
46,"46115",378,286,282,1,4,"SOMVAL",0
46,"46027",943,780,771,5,9,"SOMVAL",5
3,"3025",1270,950,941,2,9,"SOMVAL",0
46,"46109",6150,4625,4556,25,69,"SOMVAL",3
12,"12056",282,236,231,1,5,"SOMVAL",0
46,"46059",1261,1035,1019,9,16,"SOMVAL",1
46,"46141",439,351,342,2,9,"SOMVAL",0
3,"3054",343,277,275,3,2,"SOMVAL",0
46,"46170",3417,2714,2688,10,26,"SOMVAL",3
12,"12103",91,69,67,0,2,"SOMVAL",1
46,"46106",1535,1150,1140,10,10,"SOMVAL",0
3,"3111",5436,3918,3883,18,35,"SOMVAL",1
46,"46204",6681,5256,5202,32,54,"SOMVAL",17
44,"44210",746,554,545,3,9,"UDT",0
44,"44034",139,109,108,0,1,"UDT",1
44,"44082",89,78,77,0,1,"UDT",0
44,"44019",67,50,49,0,1,"UDT",0
44,"44008",1613,1163,1153,6,10,"UDT",0
44,"44120",222,154,150,2,4,"UDT",0
44,"44235",92,62,60,0,2,"UDT",0
44,"44264",248,191,189,1,2,"UDT",0
44,"44193",78,54,54,1,0,"UDT",0
44,"44158",1180,876,862,10,14,"UDT",0
44,"44108",320,222,222,1,0,"UDT",0
44,"44141",135,97,96,1,1,"UDT",0
44,"44189",56,41,41,0,0,"UDT",0
44,"44011",52,40,38,0,2,"UDT",0
44,"44012",334,263,261,5,2,"UDT",0
44,"44221",372,303,300,1,3,"UDT",0
44,"44184",45,34,34,0,0,"UDT",0
44,"44153",1774,1135,1121,5,14,"UDT",0
44,"44219",194,145,143,1,2,"UDT",0
44,"44116",83,60,60,1,0,"UDT",0
44,"44195",88,60,60,1,0,"UDT",0
44,"44208",37,22,22,0,0,"UDT",0
44,"44087",80,69,67,1,2,"UDT",0
44,"44085",52,35,35,0,0,"UDT",0
44,"44225",107,74,74,1,0,"UDT",0
44,"44118",164,132,131,2,1,"UDT",0
44,"44182",197,157,157,0,0,"UDT",4
44,"44212",39,37,37,1,0,"UDT",0
44,"44177",115,84,84,1,0,"UDT",0
44,"44181",76,57,56,0,1,"UDT",0
44,"44187",201,152,149,4,3,"UDT",0
44,"44093",80,66,66,0,0,"UDT",0
44,"44020",24,20,19,1,1,"UDT",0
44,"44046",49,34,34,1,0,"UDT",0
44,"44159",38,31,31,1,0,"UDT",0
44,"44183",77,50,49,0,1,"UDT",0
44,"44150",28,22,21,0,1,"UDT",0
44,"44146",174,153,152,2,1,"UDT",0
44,"44156",45,31,31,1,0,"UDT",0
44,"44124",77,64,64,3,0,"UDT",0
44,"44192",355,280,278,4,2,"UDT",0
44,"44122",1333,925,913,8,12,"UDT",0
44,"44084",54,41,41,0,0,"UDT",0
44,"44051",2683,1977,1946,17,31,"UDT",0
44,"44125",61,44,44,0,0,"UDT",0
44,"44148",90,75,73,2,2,"UDT",0
44,"44215",159,109,109,2,0,"UDT",0
44,"44213",62,50,50,0,0,"UDT",0
44,"44171",178,126,124,2,2,"UDT",1
44,"44047",220,137,132,2,5,"UDT",0
44,"44106",155,116,114,5,2,"UDT",0
44,"44243",24,20,20,0,0,"UDT",0
44,"44227",74,63,62,0,1,"UDT",0
44,"44005",50,30,30,0,0,"UDT",0
44,"44163",126,94,94,1,0,"UDT",0
44,"44009",809,596,593,7,3,"UDT",0
44,"44245",248,179,176,2,3,"UDT",0
44,"44042",123,91,90,0,1,"UDT",0
44,"44234",61,51,51,1,0,"UDT",0
44,"44060",41,32,32,0,0,"UDT",0
44,"44190",71,58,56,0,2,"UDT",0
44,"44194",109,78,73,3,5,"UDT",0
44,"44132",60,54,54,1,0,"UDT",0
44,"44076",2203,1690,1663,18,27,"UDT",5
44,"44142",35,27,27,0,0,"UDT",0
44,"44231",38,33,33,0,0,"UDT",0
44,"44049",849,616,604,9,12,"UDT",0
44,"44068",659,509,503,3,6,"UDT",0
44,"44007",173,122,121,4,1,"UDT",0
44,"44154",256,192,188,3,4,"UDT",0
44,"44237",398,304,301,4,3,"UDT",0
44,"44165",175,135,133,2,2,"UDT",0
44,"44121",60,47,47,2,0,"UDT",0
44,"44017",285,227,223,4,4,"UDT",0
44,"44180",70,61,61,0,0,"UDT",0
44,"44217",29,25,25,3,0,"UDT",0
44,"44038",104,83,82,0,1,"UDT",0
44,"44198",182,147,146,4,1,"UDT",0
44,"44013",11244,7815,7712,82,103,"UDT",7
44,"44040",201,160,157,1,3,"UDT",0
44,"44147",412,298,293,5,5,"UDT",0
44,"44127",68,51,51,0,0,"UDT",0
44,"44092",81,59,57,0,2,"UDT",0
44,"44179",337,229,226,1,3,"UDT",0
44,"44197",56,36,36,0,0,"UDT",0
44,"44112",429,290,290,2,0,"UDT",1
44,"44044",88,72,71,2,1,"UDT",0
44,"44222",131,98,98,0,0,"UDT",0
44,"44001",68,53,52,1,1,"UDT",0
44,"44089",45,39,39,1,0,"UDT",0
44,"44107",218,152,152,5,0,"UDT",0
44,"44053",105,78,78,0,0,"UDT",0
44,"44191",764,586,583,6,3,"UDT",0
44,"44045",366,274,269,2,5,"UDT",0
44,"44175",122,85,84,1,1,"UDT",0
44,"44016",482,363,360,2,3,"UDT",0
44,"44178",58,37,37,0,0,"UDT",0
44,"44244",75,47,47,1,0,"UDT",1
44,"44252",86,65,65,0,0,"UDT",0
44,"44205",700,460,453,4,7,"UDT",0
44,"44027",164,123,123,1,0,"UDT",0
44,"44067",114,81,81,1,0,"UDT",0
44,"44070",53,48,48,0,0,"UDT",0
44,"44250",19,12,12,0,0,"UDT",0
44,"44223",72,54,54,0,0,"UDT",0
44,"44080",292,229,223,3,6,"UDT",0
44,"44257",166,123,119,1,4,"UDT",0
44,"44261",739,536,529,6,7,"UDT",0
44,"44074",429,333,326,4,7,"UDT",0
44,"44113",71,52,52,0,0,"UDT",0
44,"44137",193,149,148,0,1,"UDT",0
44,"44172",301,218,216,4,2,"UDT",0
44,"44110",49,42,42,1,0,"UDT",0
44,"44157",64,48,48,1,0,"UDT",0
44,"44102",30,27,26,0,1,"UDT",0
44,"44145",1020,719,709,9,10,"UDT",0
44,"44251",254,198,191,1,7,"UDT",0
44,"44203",10,10,10,0,0,"UDT",0
44,"44065",60,40,40,0,0,"UDT",0
44,"44185",99,76,75,0,1,"UDT",0
44,"44117",340,271,268,4,3,"UDT",0
44,"44022",493,323,318,7,5,"UDT",0
44,"44054",108,85,85,2,0,"UDT",0
44,"44059",544,425,412,9,13,"UDT",0
44,"44144",346,248,245,2,3,"UDT",0
44,"44010",175,130,128,1,2,"UDT",0
44,"44204",24,21,21,0,0,"UDT",0
44,"44211",42,35,35,0,0,"UDT",0
44,"44209",833,611,602,6,9,"UDT",0
44,"44240",158,130,129,0,1,"UDT",0
44,"44063",71,54,54,0,0,"UDT",0
44,"44135",113,88,87,0,1,"UDT",0
44,"44004",408,303,297,0,6,"UDT",0
44,"44048",61,52,52,0,0,"UDT",0
44,"44226",140,98,98,2,0,"UDT",0
44,"44055",69,56,56,4,0,"UDT",1
44,"44229",152,112,111,3,1,"UDT",0
44,"44077",74,60,58,0,2,"UDT",0
44,"44099",709,465,462,3,3,"UDT",0
44,"44246",1543,1045,1027,12,18,"UDT",1
44,"44216",26555,18997,18737,168,260,"UDT",19
44,"44026",90,77,76,0,1,"UDT",0
44,"44149",103,78,78,3,0,"UDT",0
44,"44100",185,153,151,0,2,"UDT",0
44,"44031",97,62,62,0,0,"UDT",0
44,"44173",101,81,79,2,2,"UDT",0
44,"44002",47,40,40,0,0,"UDT",0
44,"44230",155,123,123,2,0,"UDT",0
44,"44061",70,54,51,0,3,"UDT",0
44,"44168",189,139,138,2,1,"UDT",0
44,"44123",105,71,70,1,1,"UDT",0
44,"44006",248,185,183,2,2,"UDT",0
44,"44036",25,21,21,0,0,"UDT",0
44,"44262",135,108,107,2,1,"UDT",0
44,"44256",38,34,34,0,0,"UDT",0
44,"44062",34,25,22,0,3,"UDT",0
44,"44224",22,14,14,0,0,"UDT",0
44,"44126",329,234,229,4,5,"UDT",0
44,"44014",2521,1896,1867,8,29,"UDT",2
44,"44109",108,73,73,0,0,"UDT",0
44,"44025",6009,4087,3997,25,90,"UDT",1
44,"44018",19,19,19,0,0,"UDT",0
44,"44228",100,82,82,0,0,"UDT",1
44,"44151",190,151,148,0,3,"UDT",0
44,"44037",453,317,315,0,2,"UDT",0
44,"44094",113,94,94,0,0,"UDT",0
44,"44218",35,28,28,1,0,"UDT",0
44,"44169",342,252,252,3,0,"UDT",1
44,"44050",3113,2120,2100,25,20,"UDT",0
44,"44086",449,342,336,3,6,"UDT",0
44,"44029",559,425,424,5,1,"UDT",0
44,"44056",501,345,342,2,3,"UDT",0
44,"44052",77,56,56,0,0,"UDT",0
44,"44241",533,396,389,0,7,"UDT",0
44,"44115",102,90,90,3,0,"UDT",0
44,"44128",68,54,54,1,0,"UDT",0
44,"44023",17,16,16,0,0,"UDT",0
44,"44064",69,49,49,0,0,"UDT",0
44,"44136",49,43,43,1,0,"UDT",0
44,"44220",121,84,83,1,1,"UDT",0
44,"44232",378,284,276,6,8,"UDT",0
44,"44071",591,398,398,5,0,"UDT",0
44,"44035",113,90,88,1,2,"UDT",0
44,"44096",161,138,135,3,3,"UDT",0
44,"44196",131,101,98,2,3,"UDT",0
44,"44265",186,141,138,2,3,"UDT",0
44,"44129",39,32,32,0,0,"UDT",0
44,"44097",142,92,92,0,0,"UDT",0
44,"44176",158,115,114,0,1,"UDT",0
44,"44088",29,21,21,0,0,"UDT",0
44,"44130",34,24,24,0,0,"UDT",0
44,"44268",25,25,24,0,1,"UDT",0
44,"44143",380,307,306,2,1,"UDT",0
44,"44260",137,91,89,3,2,"UDT",0
44,"44103",132,102,102,1,0,"UDT",0
44,"44032",16,11,11,0,0,"UDT",0
44,"44238",2323,1603,1590,5,13,"UDT",0
44,"44138",135,98,94,0,4,"UDT",0
44,"44043",102,74,72,0,2,"UDT",0
44,"44033",269,191,190,0,1,"UDT",0
44,"44131",25,20,20,0,0,"UDT",0
44,"44258",67,47,47,0,0,"UDT",0
44,"44021",107,89,88,0,1,"UDT",0
44,"44236",63,48,47,0,1,"UDT",0
44,"44266",115,90,90,0,0,"UDT",0
44,"44247",316,218,215,3,3,"UDT",1
44,"44200",39,26,26,0,0,"UDT",0
44,"44075",323,248,246,0,2,"UDT",0
44,"44167",38,31,31,0,0,"UDT",0
44,"44152",64,46,45,0,1,"UDT",0
44,"44119",130,92,91,3,1,"UDT",0
44,"44024",27,25,25,0,0,"UDT",0
44,"44105",82,64,64,0,0,"UDT",0
44,"44267",70,57,56,0,1,"UDT",0
44,"44155",1090,793,782,4,11,"UDT",1
44,"44028",183,151,150,4,1,"UDT",0
44,"44101",58,46,46,2,0,"UDT",0
44,"44239",22,20,20,0,0,"UDT",0
44,"44201",495,411,406,0,5,"UDT",0
44,"44206",114,90,87,0,3,"UDT",0
44,"44174",428,307,304,3,3,"UDT",0
44,"44164",27,23,23,0,0,"UDT",0
44,"44039",221,165,159,0,6,"UDT",0
44,"44160",466,304,301,2,3,"UDT",0
44,"44161",443,314,313,2,1,"UDT",0
44,"44133",21,15,15,0,0,"UDT",0
44,"44066",108,79,74,0,5,"UDT",0
44,"44199",44,41,41,2,0,"UDT",0
44,"44114",243,178,173,0,5,"UDT",0
44,"44090",78,53,53,0,0,"UDT",0
44,"44207",156,118,115,4,3,"UDT",0
44,"44111",92,69,68,0,1,"UDT",0
44,"44249",55,44,44,2,0,"UDT",0
44,"44041",56,44,44,1,0,"UDT",0
44,"44263",376,266,263,3,3,"UDT",0
44,"44003",19,17,17,0,0,"UDT",0
35,"35001",4584,3282,3222,26,60,"UNIDAD DEL PUEBLO",3
35,"35007",511,316,309,2,7,"UNIDAD DEL PUEBLO",0
35,"35016",297736,192251,190256,1386,1995,"UNIDAD DEL PUEBLO",219
35,"35024",13735,8545,8439,77,106,"UNIDAD DEL PUEBLO",5
35,"35015",9950,5139,5070,29,69,"UNIDAD DEL PUEBLO",4
35,"35003",5211,2949,2908,13,41,"UNIDAD DEL PUEBLO",4
35,"35014",11209,6016,5917,42,99,"UNIDAD DEL PUEBLO",12
35,"35023",11686,8212,8076,55,136,"UNIDAD DEL PUEBLO",9
35,"35012",10382,5443,5392,17,51,"UNIDAD DEL PUEBLO",8
35,"35029",4152,2530,2498,32,32,"UNIDAD DEL PUEBLO",5
35,"35018",12552,7609,7547,54,62,"UNIDAD DEL PUEBLO",9
35,"35004",39299,20523,20294,140,229,"UNIDAD DEL PUEBLO",25
35,"35020",6034,3992,3934,20,58,"UNIDAD DEL PUEBLO",2
35,"35022",48603,29443,29042,160,401,"UNIDAD DEL PUEBLO",157
35,"35031",7259,5037,4942,29,95,"UNIDAD DEL PUEBLO",6
35,"35010",3558,2341,2301,28,40,"UNIDAD DEL PUEBLO",2
35,"35030",9250,5413,5326,34,87,"UNIDAD DEL PUEBLO",5
35,"35011",24002,15928,15684,95,244,"UNIDAD DEL PUEBLO",11
35,"35025",1797,1261,1245,4,16,"UNIDAD DEL PUEBLO",1
35,"35033",6398,4340,4266,19,74,"UNIDAD DEL PUEBLO",5
35,"35019",32481,19318,19067,123,251,"UNIDAD DEL PUEBLO",19
35,"35017",25676,15038,14716,94,322,"UNIDAD DEL PUEBLO",28
35,"35009",19905,14185,13961,89,224,"UNIDAD DEL PUEBLO",14
35,"35034",7873,3975,3943,27,32,"UNIDAD DEL PUEBLO",4
35,"35002",23328,15495,15313,94,182,"UNIDAD DEL PUEBLO",15
35,"35032",3412,2473,2425,17,48,"UNIDAD DEL PUEBLO",1
35,"35008",6131,4507,4459,34,48,"UNIDAD DEL PUEBLO",10
35,"35005",1048,747,737,8,10,"UNIDAD DEL PUEBLO",0
35,"35028",9776,5476,5401,43,75,"UNIDAD DEL PUEBLO",7
35,"35006",30457,21398,21118,162,280,"UNIDAD DEL PUEBLO",22
35,"35013",6625,4896,4781,41,115,"UNIDAD DEL PUEBLO",3
35,"35026",81091,51953,51195,407,758,"UNIDAD DEL PUEBLO",62
35,"35021",14924,10477,10370,45,107,"UNIDAD DEL PUEBLO",5
35,"35027",10344,7310,7216,50,94,"UNIDAD DEL PUEBLO",2
52,"52001",53306,27373,27012,267,361,"UNIDOS PODEMOS",2638
49,"49209",505,342,341,2,1,"UPL",0
49,"49040",114,101,101,0,0,"UPL",0
24,"24183",805,555,549,6,6,"UPL",7
24,"24018",174,143,141,0,2,"UPL",0
49,"49168",93,74,74,0,0,"UPL",0
49,"49203",313,240,232,0,8,"UPL",0
24,"24120",341,246,244,1,2,"UPL",3
49,"49099",115,87,87,0,0,"UPL",0
49,"49095",291,221,220,0,1,"UPL",1
24,"24179",290,197,192,4,5,"UPL",1
24,"24092",798,606,602,1,4,"UPL",3
49,"49251",163,127,121,1,6,"UPL",0
24,"24068",457,344,340,0,4,"UPL",2
24,"24153",232,179,177,2,2,"UPL",5
49,"49174",125,95,92,1,3,"UPL",0
24,"24132",615,379,375,1,4,"UPL",1
24,"24197",763,538,533,1,5,"UPL",3
24,"24091",645,454,451,1,3,"UPL",4
24,"24167",750,505,499,4,6,"UPL",4
24,"24053",442,286,280,1,6,"UPL",4
49,"49171",646,514,508,10,6,"UPL",1
49,"49094",224,149,149,2,0,"UPL",0
49,"49056",300,211,208,2,3,"UPL",1
49,"49010",345,279,273,5,6,"UPL",1
24,"24012",290,207,205,1,2,"UPL",4
49,"49004",126,100,100,4,0,"UPL",0
24,"24198",592,412,407,2,5,"UPL",0
24,"24001",189,124,122,0,2,"UPL",2
24,"24074",97,75,75,1,0,"UPL",3
24,"24006",472,353,347,0,6,"UPL",12
49,"49069",367,258,254,5,4,"UPL",0
49,"49120",74,53,52,0,1,"UPL",0
49,"49133",304,214,213,1,1,"UPL",0
49,"49232",96,74,74,1,0,"UPL",0
49,"49246",227,190,183,2,7,"UPL",0
49,"49098",219,167,165,0,2,"UPL",0
24,"24093",360,249,248,2,1,"UPL",2
24,"24131",724,511,507,3,4,"UPL",5
49,"49170",102,72,71,0,1,"UPL",0
49,"49214",698,525,512,3,13,"UPL",0
49,"49008",460,332,331,5,1,"UPL",0
24,"24201",1090,762,759,10,3,"UPL",9
24,"24902",347,270,269,2,1,"UPL",0
49,"49181",362,277,276,2,1,"UPL",0
49,"49234",412,328,324,0,4,"UPL",0
49,"49067",367,250,249,0,1,"UPL",2
49,"49226",255,198,195,0,3,"UPL",1
24,"24188",3822,2850,2817,19,33,"UPL",22
49,"49237",165,119,117,2,2,"UPL",0
24,"24094",1385,983,968,11,15,"UPL",12
49,"49046",268,203,203,0,0,"UPL",0
24,"24124",367,244,233,3,11,"UPL",2
24,"24099",171,132,132,0,0,"UPL",0
49,"49091",260,193,193,0,0,"UPL",1
49,"49156",237,184,175,0,9,"UPL",0
24,"24160",684,483,474,6,9,"UPL",6
49,"49200",949,720,715,10,5,"UPL",0
24,"24121",645,492,487,1,5,"UPL",2
49,"49017",251,180,177,1,3,"UPL",0
49,"49160",49,33,33,0,0,"UPL",0
24,"24032",109,91,89,0,2,"UPL",0
24,"24069",41,35,35,0,0,"UPL",0
24,"24078",380,289,277,0,12,"UPL",1
49,"49219",7464,4988,4914,53,74,"UPL",7
49,"49228",54,44,43,0,1,"UPL",0
49,"49130",180,143,141,5,2,"UPL",0
49,"49027",140,112,108,1,4,"UPL",0
24,"24169",2969,2140,2118,13,22,"UPL",1
49,"49047",107,75,75,0,0,"UPL",0
24,"24008",9282,6685,6603,52,82,"UPL",31
49,"49013",246,182,181,2,1,"UPL",0
24,"24023",263,188,188,1,0,"UPL",1
49,"49250",1245,935,920,7,15,"UPL",2
24,"24143",510,358,349,0,9,"UPL",0
49,"49252",320,254,252,5,2,"UPL",0
24,"24073",478,332,328,2,4,"UPL",8
24,"24230",426,322,320,5,2,"UPL",3
24,"24003",648,460,453,7,7,"UPL",2
49,"49259",89,66,65,1,1,"UPL",0
49,"49016",247,176,174,5,2,"UPL",0
49,"49084",287,229,228,4,1,"UPL",0
24,"24180",1134,812,800,9,12,"UPL",2
49,"49179",371,238,237,0,1,"UPL",0
24,"24175",1832,1314,1297,14,17,"UPL",11
49,"49167",197,147,145,0,2,"UPL",0
49,"49173",375,230,221,3,9,"UPL",0
49,"49242",447,360,357,5,3,"UPL",0
49,"49055",102,82,82,2,0,"UPL",0
49,"49201",302,270,268,3,2,"UPL",0
49,"49037",185,153,151,0,2,"UPL",0
49,"49052",187,133,132,1,1,"UPL",0
24,"24210",503,358,356,3,2,"UPL",4
49,"49163",219,158,154,5,4,"UPL",0
24,"24171",356,197,196,0,1,"UPL",0
49,"49265",128,91,91,1,0,"UPL",0
24,"24130",438,323,321,4,2,"UPL",0
49,"49082",359,304,301,6,3,"UPL",0
24,"24087",631,470,466,7,4,"UPL",2
24,"24043",134,75,75,1,0,"UPL",1
49,"49002",63,51,49,0,2,"UPL",0
24,"24059",880,536,535,4,1,"UPL",0
24,"24127",296,226,215,4,11,"UPL",2
24,"24020",456,314,307,4,7,"UPL",4
24,"24222",14256,9996,9884,101,112,"UPL",101
24,"24189",5865,3933,3885,31,48,"UPL",33
24,"24122",1342,930,924,8,6,"UPL",1
49,"49113",167,137,135,1,2,"UPL",0
49,"49110",348,231,229,0,2,"UPL",1
24,"24155",471,388,384,6,4,"UPL",10
24,"24100",761,561,555,7,6,"UPL",0
24,"24191",108,79,79,0,0,"UPL",5
24,"24164",370,218,217,0,1,"UPL",2
49,"49044",80,60,58,0,2,"UPL",0
49,"49038",99,71,65,1,6,"UPL",0
49,"49158",215,170,166,2,4,"UPL",0
24,"24098",1193,842,831,11,11,"UPL",12
24,"24102",652,470,467,2,3,"UPL",1
49,"49076",321,217,217,2,0,"UPL",1
24,"24196",2057,1502,1485,9,17,"UPL",2
24,"24141",95,85,84,0,1,"UPL",2
49,"49059",94,64,64,0,0,"UPL",0
24,"24105",1459,1042,1025,16,17,"UPL",8
24,"24015",2265,1649,1635,18,14,"UPL",18
49,"49180",148,103,102,2,1,"UPL",0
49,"49108",466,346,344,0,2,"UPL",2
49,"49112",126,75,75,0,0,"UPL",0
24,"24055",708,516,512,0,4,"UPL",8
24,"24185",474,357,350,3,7,"UPL",5
24,"24004",463,350,348,4,2,"UPL",6
49,"49124",253,174,169,1,5,"UPL",0
49,"49204",63,51,51,0,0,"UPL",0
49,"49216",162,142,142,0,0,"UPL",0
24,"24052",158,104,102,0,2,"UPL",0
24,"24129",122,89,89,1,0,"UPL",2
24,"24174",486,343,342,4,1,"UPL",5
24,"24066",494,368,366,4,2,"UPL",2
24,"24039",2063,1597,1596,41,1,"UPL",21
49,"49227",315,230,228,2,2,"UPL",0
49,"49239",663,458,448,3,10,"UPL",0
49,"49142",249,180,179,0,1,"UPL",0
49,"49272",88,70,69,1,1,"UPL",0
24,"24033",205,158,157,0,1,"UPL",2
49,"49270",133,99,99,1,0,"UPL",0
24,"24090",343,235,233,1,2,"UPL",2
49,"49194",368,218,216,1,2,"UPL",3
24,"24218",451,330,325,2,5,"UPL",3
24,"24211",272,205,205,2,0,"UPL",1
49,"49114",43,34,33,0,1,"UPL",0
49,"49054",894,617,601,13,16,"UPL",1
49,"49092",129,90,89,1,1,"UPL",0
24,"24142",25119,17336,17141,154,195,"UPL",218
24,"24216",723,522,518,1,4,"UPL",0
49,"49225",147,91,90,0,1,"UPL",2
49,"49026",226,179,176,0,3,"UPL",0
24,"24028",388,292,288,2,4,"UPL",9
24,"24116",417,314,309,1,5,"UPL",0
49,"49153",174,136,132,0,4,"UPL",0
24,"24166",1407,1013,993,8,20,"UPL",5
24,"24064",1523,1101,1087,3,14,"UPL",0
24,"24101",397,258,257,3,1,"UPL",0
49,"49050",507,342,338,1,4,"UPL",0
49,"49012",73,43,43,0,0,"UPL",0
49,"49154",127,78,77,0,1,"UPL",0
24,"24133",356,257,257,1,0,"UPL",3
49,"49022",288,229,225,3,4,"UPL",0
49,"49208",394,248,244,2,4,"UPL",0
24,"24144",695,470,465,2,5,"UPL",4
24,"24224",616,454,451,4,3,"UPL",3
49,"49132",316,235,232,1,3,"UPL",0
49,"49036",506,374,367,2,7,"UPL",1
24,"24084",163,116,116,0,0,"UPL",0
24,"24037",360,254,250,2,4,"UPL",1
24,"24170",1908,1365,1345,8,20,"UPL",6
49,"49159",271,209,205,4,4,"UPL",0
49,"49129",853,592,574,9,18,"UPL",0
49,"49141",340,248,246,0,2,"UPL",0
24,"24036",288,184,184,2,0,"UPL",0
24,"24205",945,694,685,11,9,"UPL",3
49,"49138",234,184,184,3,0,"UPL",0
49,"49268",403,313,309,1,4,"UPL",0
49,"49100",295,212,208,5,4,"UPL",0
49,"49117",465,330,324,6,6,"UPL",0
49,"49155",79,61,60,3,1,"UPL",0
49,"49034",432,327,325,2,2,"UPL",0
49,"49236",75,58,58,0,0,"UPL",0
24,"24139",2183,1548,1525,16,23,"UPL",8
24,"24229",418,322,319,2,3,"UPL",7
24,"24168",460,361,359,0,2,"UPL",2
24,"24178",70,59,58,0,1,"UPL",0
24,"24022",330,230,229,0,1,"UPL",0
24,"24086",270,223,218,0,5,"UPL",4
24,"24173",951,679,674,9,5,"UPL",1
24,"24154",1005,673,666,4,7,"UPL",0
49,"49007",370,255,249,1,6,"UPL",0
49,"49101",153,102,99,0,3,"UPL",0
24,"24119",706,488,481,3,7,"UPL",0
49,"49157",206,163,160,2,3,"UPL",0
49,"49260",755,590,586,8,4,"UPL",0
49,"49028",115,104,103,1,1,"UPL",0
24,"24051",423,309,307,0,2,"UPL",2
24,"24046",942,637,633,5,4,"UPL",6
24,"24083",1042,727,715,6,12,"UPL",5
24,"24149",152,120,116,3,4,"UPL",1
24,"24095",320,234,232,0,2,"UPL",2
24,"24184",198,118,117,0,1,"UPL",0
49,"49166",1227,946,933,6,13,"UPL",0
49,"49175",230,172,171,1,1,"UPL",0
49,"49222",380,279,272,0,7,"UPL",0
49,"49111",127,98,96,4,2,"UPL",0
49,"49029",623,495,488,3,7,"UPL",3
24,"24065",2138,1503,1472,15,31,"UPL",14
49,"49136",318,220,218,1,2,"UPL",0
24,"24029",735,539,535,3,4,"UPL",8
24,"24227",1607,1127,1116,22,11,"UPL",27
24,"24025",297,228,227,0,1,"UPL",4
24,"24011",203,133,132,0,1,"UPL",0
24,"24070",4124,3024,2981,20,43,"UPL",7
49,"49192",130,110,109,2,1,"UPL",0
49,"49081",1382,1016,1003,9,13,"UPL",0
24,"24026",1177,864,849,7,15,"UPL",5
49,"49172",527,347,343,1,4,"UPL",0
49,"49147",263,190,186,0,4,"UPL",0
24,"24079",906,664,658,9,6,"UPL",8
49,"49269",229,165,162,1,3,"UPL",0
24,"24117",434,334,331,1,3,"UPL",1
24,"24016",466,270,269,1,1,"UPL",0
24,"24125",462,290,286,4,4,"UPL",2
49,"49030",86,69,69,0,0,"UPL",0
49,"49165",59,51,51,0,0,"UPL",0
49,"49048",124,97,95,0,2,"UPL",0
24,"24002",231,173,172,1,1,"UPL",2
49,"49053",931,709,699,8,10,"UPL",0
49,"49088",87,61,60,0,1,"UPL",0
49,"49267",88,73,69,2,4,"UPL",0
49,"49249",69,58,58,1,0,"UPL",0
24,"24061",1704,1213,1204,9,9,"UPL",7
49,"49020",289,214,214,2,0,"UPL",0
49,"49126",235,155,154,2,1,"UPL",0
24,"24017",577,426,418,1,8,"UPL",2
49,"49245",262,176,173,2,3,"UPL",0
24,"24152",464,295,291,1,4,"UPL",2
49,"49255",418,319,316,1,3,"UPL",0
49,"49115",184,136,135,0,1,"UPL",0
24,"24080",213,164,161,3,3,"UPL",0
24,"24207",294,241,238,3,3,"UPL",3
24,"24058",208,155,154,3,1,"UPL",3
24,"24213",150,122,122,1,0,"UPL",4
24,"24209",2769,1888,1865,12,23,"UPL",3
24,"24019",354,272,267,3,5,"UPL",0
49,"49078",170,141,140,1,1,"UPL",1
24,"24113",366,293,287,5,6,"UPL",3
49,"49128",552,423,414,3,9,"UPL",0
24,"24081",140,98,92,0,6,"UPL",0
24,"24040",449,329,325,2,4,"UPL",1
24,"24096",117,80,79,1,1,"UPL",0
24,"24106",248,167,166,1,1,"UPL",1
49,"49033",714,508,505,1,3,"UPL",0
49,"49123",546,391,384,1,7,"UPL",1
49,"49125",1391,933,918,10,15,"UPL",1
49,"49193",467,313,308,4,5,"UPL",1
24,"24114",3061,2025,1994,9,31,"UPL",27
24,"24005",378,260,257,2,3,"UPL",0
24,"24226",199,139,137,0,2,"UPL",0
24,"24044",168,119,118,1,1,"UPL",0
49,"49087",521,322,318,0,4,"UPL",0
49,"49247",443,283,279,2,4,"UPL",0
49,"49205",382,293,291,2,2,"UPL",0
49,"49177",278,179,177,1,2,"UPL",0
49,"49096",170,131,124,2,7,"UPL",0
24,"24057",1373,1045,1023,11,22,"UPL",1
24,"24089",102747,74428,73688,631,740,"UPL",631
49,"49240",206,162,161,2,1,"UPL",0
24,"24038",3089,2312,2273,17,39,"UPL",2
49,"49019",243,188,182,2,6,"UPL",0
49,"49183",100,77,77,2,0,"UPL",0
24,"24088",1029,791,789,10,2,"UPL",6
49,"49241",248,177,177,0,0,"UPL",0
24,"24223",2610,1917,1908,39,9,"UPL",11
49,"49011",232,168,165,6,3,"UPL",1
49,"49093",280,223,222,1,1,"UPL",1
49,"49068",462,310,304,4,6,"UPL",0
49,"49003",900,612,599,5,13,"UPL",2
49,"49162",186,142,140,1,2,"UPL",0
49,"49077",183,103,103,0,0,"UPL",0
49,"49127",2367,1668,1650,16,18,"UPL",2
24,"24163",3962,2950,2933,24,17,"UPL",28
49,"49041",432,326,322,5,4,"UPL",0
24,"24021",1675,1162,1144,8,18,"UPL",16
24,"24156",239,159,158,1,1,"UPL",1
49,"49199",254,193,189,3,4,"UPL",0
49,"49119",227,169,168,0,1,"UPL",0
49,"49185",157,123,122,2,1,"UPL",0
24,"24136",540,387,383,4,4,"UPL",4
24,"24123",746,488,485,2,3,"UPL",6
49,"49273",187,112,112,0,0,"UPL",0
49,"49146",295,216,213,3,3,"UPL",0
24,"24109",977,633,624,3,9,"UPL",1
49,"49176",667,433,431,1,2,"UPL",0
49,"49116",383,276,269,3,7,"UPL",2
24,"24157",2568,1943,1911,22,32,"UPL",70
24,"24221",795,543,538,7,5,"UPL",5
49,"49018",329,261,256,2,5,"UPL",3
24,"24137",1099,783,778,7,5,"UPL",19
49,"49262",392,279,274,1,5,"UPL",0
49,"49187",1236,896,888,4,8,"UPL",0
49,"49109",619,483,483,11,0,"UPL",3
24,"24194",290,212,212,3,0,"UPL",0
49,"49135",626,434,430,1,4,"UPL",1
49,"49075",137,120,119,0,1,"UPL",0
49,"49083",52,44,44,2,0,"UPL",0
24,"24212",1032,773,760,4,13,"UPL",16
49,"49258",114,93,91,2,2,"UPL",0
24,"24199",424,302,301,0,1,"UPL",3
49,"49064",515,346,338,6,8,"UPL",0
49,"49191",272,213,206,2,7,"UPL",0
49,"49015",227,179,177,0,2,"UPL",0
24,"24115",54058,37780,37357,308,423,"UPL",54
24,"24901",889,636,623,5,13,"UPL",4
49,"49221",245,129,127,1,2,"UPL",1
24,"24112",309,228,227,1,1,"UPL",2
49,"49061",150,114,112,2,2,"UPL",0
24,"24159",1806,1386,1366,6,20,"UPL",19
49,"49202",187,130,130,4,0,"UPL",0
49,"49261",1537,1048,1033,8,15,"UPL",4
49,"49233",93,58,55,0,3,"UPL",0
49,"49230",97,72,72,0,0,"UPL",0
24,"24007",773,550,548,4,2,"UPL",0
49,"49150",139,112,111,1,1,"UPL",0
24,"24047",783,545,540,2,5,"UPL",20
49,"49207",239,150,146,0,4,"UPL",0
24,"24146",265,210,207,1,3,"UPL",0
49,"49006",154,99,95,0,4,"UPL",0
49,"49238",254,194,193,1,1,"UPL",1
24,"24228",660,430,422,6,8,"UPL",6
24,"24082",858,629,614,8,15,"UPL",2
49,"49264",578,383,377,5,6,"UPL",0
49,"49058",307,237,233,0,4,"UPL",0
24,"24214",656,490,485,3,5,"UPL",1
49,"49014",112,91,91,2,0,"UPL",0
24,"24206",1700,1253,1240,12,13,"UPL",0
49,"49257",291,190,184,1,6,"UPL",0
49,"49243",111,94,93,0,1,"UPL",0
49,"49086",115,96,91,0,5,"UPL",1
24,"24042",63,56,56,1,0,"UPL",0
49,"49043",289,217,213,1,4,"UPL",0
24,"24181",1493,1054,1045,5,9,"UPL",1
24,"24024",692,496,491,4,5,"UPL",3
49,"49079",106,93,92,1,1,"UPL",0
49,"49042",244,178,176,1,2,"UPL",0
49,"49122",782,526,520,5,6,"UPL",1
24,"24110",1247,899,892,6,7,"UPL",2
24,"24071",1006,745,734,10,11,"UPL",3
49,"49224",162,112,112,1,0,"UPL",7
24,"24027",1211,863,847,8,16,"UPL",1
49,"49063",338,272,266,4,6,"UPL",2
49,"49152",525,339,334,2,5,"UPL",0
49,"49065",1103,836,818,2,18,"UPL",1
49,"49024",672,459,454,5,5,"UPL",0
24,"24054",430,314,313,1,1,"UPL",1
49,"49220",135,110,109,0,1,"UPL",0
49,"49188",112,90,89,1,1,"UPL",0
24,"24158",320,207,203,2,4,"UPL",0
49,"49275",52210,36205,35754,356,451,"UPL",74
49,"49009",393,293,288,2,5,"UPL",0
49,"49102",196,143,139,2,4,"UPL",0
24,"24219",516,387,386,4,1,"UPL",3
24,"24108",376,280,277,2,3,"UPL",2
49,"49131",264,194,192,6,2,"UPL",0
49,"49229",126,93,93,0,0,"UPL",0
24,"24202",8008,5367,5276,53,91,"UPL",15
49,"49164",155,119,115,2,4,"UPL",1
49,"49231",330,232,232,2,0,"UPL",0
24,"24193",378,268,265,2,3,"UPL",2
24,"24148",1672,1249,1241,23,8,"UPL",12
24,"24067",623,388,384,0,4,"UPL",1
24,"24215",152,113,113,0,0,"UPL",0
49,"49190",63,47,45,0,2,"UPL",0
49,"49021",14330,9878,9758,95,120,"UPL",34
24,"24177",476,325,322,3,3,"UPL",1
24,"24056",2883,2040,2003,11,37,"UPL",51
49,"49235",443,301,292,0,9,"UPL",0
49,"49189",202,142,142,1,0,"UPL",1
49,"49210",471,370,365,1,5,"UPL",0
24,"24034",3394,2380,2342,28,38,"UPL",3
49,"49197",175,123,123,1,0,"UPL",0
24,"24014",7425,5124,5053,32,71,"UPL",9
49,"49035",226,200,196,3,4,"UPL",0
49,"49148",260,137,134,1,3,"UPL",0
49,"49244",43,29,29,0,0,"UPL",0
24,"24190",165,123,121,1,2,"UPL",1
24,"24063",374,254,252,2,2,"UPL",1
24,"24097",218,140,139,3,1,"UPL",10
24,"24009",322,153,152,2,1,"UPL",1
49,"49023",967,673,662,10,11,"UPL",1
24,"24162",1683,1257,1246,13,11,"UPL",17
49,"49085",996,684,680,2,4,"UPL",0
49,"49149",390,273,268,3,5,"UPL",0
49,"49090",197,143,141,6,2,"UPL",0
24,"24187",857,603,593,7,10,"UPL",4
24,"24150",243,172,172,6,0,"UPL",2
49,"49271",194,145,141,1,4,"UPL",0
24,"24134",3416,2470,2417,19,53,"UPL",31
49,"49134",172,121,119,0,2,"UPL",0
49,"49103",414,330,328,5,2,"UPL",0
24,"24010",8386,5708,5632,60,76,"UPL",41
49,"49032",326,259,259,1,0,"UPL",0
49,"49263",51,36,36,0,0,"UPL",0
24,"24062",139,98,98,1,0,"UPL",5
49,"49121",365,273,273,2,0,"UPL",2
24,"24049",1483,1054,1048,6,6,"UPL",0
24,"24161",285,203,201,3,2,"UPL",0
49,"49151",619,459,456,2,3,"UPL",0
49,"49031",148,120,119,6,1,"UPL",1
49,"49080",685,520,514,2,6,"UPL",0
24,"24203",95,69,68,0,1,"UPL",1
49,"49039",338,245,239,3,6,"UPL",1
49,"49071",765,495,490,2,5,"UPL",1
49,"49186",261,188,185,0,3,"UPL",0
49,"49005",149,91,91,2,0,"UPL",0
49,"49223",752,608,600,4,8,"UPL",0
49,"49066",492,336,332,4,4,"UPL",0
49,"49105",150,109,108,0,1,"UPL",0
49,"49248",186,151,150,1,1,"UPL",0
49,"49206",840,614,604,9,10,"UPL",7
24,"24060",602,363,361,3,2,"UPL",4
49,"49143",225,163,162,0,1,"UPL",0
49,"49266",76,63,61,2,2,"UPL",0
24,"24041",538,367,366,3,1,"UPL",1
24,"24151",478,353,352,1,1,"UPL",1
24,"24030",4277,3038,3007,11,31,"UPL",1
24,"24217",135,109,108,1,1,"UPL",1
49,"49097",85,52,51,0,1,"UPL",0
49,"49145",236,162,157,0,5,"UPL",0
49,"49178",705,496,487,4,9,"UPL",4
49,"49256",256,204,204,0,0,"UPL",0
49,"49184",172,115,112,0,3,"UPL",0
24,"24182",416,294,290,2,4,"UPL",3
49,"49107",126,94,93,2,1,"UPL",0
24,"24076",1277,956,947,4,9,"UPL",10
24,"24107",236,175,173,0,2,"UPL",3
24,"24103",283,163,157,1,6,"UPL",0
24,"24031",215,172,168,0,4,"UPL",4
24,"24077",225,190,187,2,3,"UPL",1
49,"49057",109,85,83,1,2,"UPL",0
49,"49104",343,234,232,0,2,"UPL",0
24,"24145",654,463,461,2,2,"UPL",3
24,"24050",102,77,76,0,1,"UPL",1
24,"24165",354,240,238,2,2,"UPL",0
49,"49169",35,26,26,0,0,"UPL",0
24,"24172",418,255,250,2,5,"UPL",1
49,"49062",122,90,89,0,1,"UPL",0
24,"24225",1014,752,739,10,13,"UPL",4
24,"24118",126,88,88,1,0,"UPL",3
49,"49137",176,139,138,0,1,"UPL",0
49,"49118",203,161,160,1,1,"UPL",0
49,"49139",171,135,135,0,0,"UPL",1
24,"24104",259,169,169,0,0,"UPL",1
24,"24176",316,247,244,1,3,"UPL",7
49,"49025",173,133,133,1,0,"UPL",0
31,"31030",141,100,99,0,1,"UPN-PP",25
31,"31188",235,161,161,2,0,"UPN-PP",51
31,"31012",793,563,555,6,8,"UPN-PP",192
31,"31100",262,170,168,1,2,"UPN-PP",75
31,"31905",2843,1983,1966,15,17,"UPN-PP",521
31,"31052",96,62,61,0,1,"UPN-PP",23
31,"31161",338,264,259,2,5,"UPN-PP",48
31,"31195",182,130,128,0,2,"UPN-PP",27
31,"31199",146,92,89,3,3,"UPN-PP",32
31,"31233",97,74,74,0,0,"UPN-PP",36
31,"31077",5352,3908,3848,41,60,"UPN-PP",1598
31,"31184",62,44,44,3,0,"UPN-PP",16
31,"31901",15459,11119,11026,108,93,"UPN-PP",3081
31,"31180",212,154,154,5,0,"UPN-PP",59
31,"31015",1994,1412,1392,25,20,"UPN-PP",521
31,"31070",2638,1808,1784,20,24,"UPN-PP",600
31,"31234",144,106,106,4,0,"UPN-PP",40
31,"31082",617,371,365,10,6,"UPN-PP",69
31,"31007",131,87,86,1,1,"UPN-PP",37
31,"31200",761,517,508,3,9,"UPN-PP",104
31,"31172",373,278,272,3,6,"UPN-PP",100
31,"31108",1855,1368,1348,7,20,"UPN-PP",602
31,"31261",231,173,169,3,4,"UPN-PP",69
31,"31241",133,98,98,2,0,"UPN-PP",40
31,"31206",2090,1461,1440,22,21,"UPN-PP",465
31,"31105",1507,1167,1142,7,25,"UPN-PP",579
31,"31162",47,31,31,0,0,"UPN-PP",8
31,"31035",59,45,43,0,2,"UPN-PP",19
31,"31091",351,220,217,1,3,"UPN-PP",28
31,"31183",691,544,542,4,2,"UPN-PP",204
31,"31058",208,148,144,3,4,"UPN-PP",44
31,"31229",47,35,35,0,0,"UPN-PP",14
31,"31158",255,180,179,3,1,"UPN-PP",51
31,"31191",3016,2167,2147,22,20,"UPN-PP",694
31,"31255",102,79,79,1,0,"UPN-PP",37
31,"31226",591,342,340,2,2,"UPN-PP",32
31,"31129",395,234,234,0,0,"UPN-PP",16
31,"31009",677,507,505,5,2,"UPN-PP",132
31,"31159",1107,844,833,6,11,"UPN-PP",286
31,"31167",826,606,596,9,10,"UPN-PP",211
31,"31085",480,350,350,2,0,"UPN-PP",45
31,"31016",7608,5474,5413,50,61,"UPN-PP",695
31,"31084",1940,1293,1274,16,19,"UPN-PP",159
31,"31141",110,71,70,1,1,"UPN-PP",43
31,"31042",2714,1974,1942,22,32,"UPN-PP",727
31,"31196",38,35,35,1,0,"UPN-PP",10
31,"31067",1922,1312,1294,10,18,"UPN-PP",462
31,"31181",145,112,112,0,0,"UPN-PP",39
31,"31010",5705,3718,3680,29,38,"UPN-PP",630
31,"31176",2869,2010,1963,33,47,"UPN-PP",722
31,"31250",2810,1786,1770,19,16,"UPN-PP",225
31,"31014",275,194,192,4,2,"UPN-PP",70
31,"31157",3518,2298,2267,23,31,"UPN-PP",811
31,"31257",875,634,625,8,9,"UPN-PP",176
31,"31149",2305,1461,1441,8,20,"UPN-PP",169
31,"31140",117,84,84,1,0,"UPN-PP",28
31,"31051",251,170,170,2,0,"UPN-PP",57
31,"31150",213,156,155,1,1,"UPN-PP",31
31,"31151",66,46,46,1,0,"UPN-PP",17
31,"31033",49,31,31,1,0,"UPN-PP",7
31,"31045",508,355,350,8,5,"UPN-PP",84
31,"31062",1087,830,818,3,12,"UPN-PP",276
31,"31044",289,230,227,1,3,"UPN-PP",44
31,"31259",484,291,286,2,5,"UPN-PP",35
31,"31004",35,21,21,0,0,"UPN-PP",9
31,"31103",42,34,34,2,0,"UPN-PP",23
31,"31037",84,66,66,1,0,"UPN-PP",5
31,"31240",527,327,326,2,1,"UPN-PP",35
31,"31263",233,138,137,2,1,"UPN-PP",14
31,"31253",129,109,109,0,0,"UPN-PP",8
31,"31264",180,105,101,2,4,"UPN-PP",24
31,"31163",2013,1418,1383,13,35,"UPN-PP",560
31,"31902",4405,3092,3061,25,31,"UPN-PP",842
31,"31230",106,82,82,1,0,"UPN-PP",28
31,"31111",95,65,65,2,0,"UPN-PP",17
31,"31166",258,181,181,1,0,"UPN-PP",100
31,"31192",156,129,127,3,2,"UPN-PP",42
31,"31906",2562,1800,1779,26,21,"UPN-PP",440
31,"31104",1834,1257,1235,16,22,"UPN-PP",402
31,"31083",52,37,37,0,0,"UPN-PP",10
31,"31156",251,189,188,0,1,"UPN-PP",40
31,"31090",144,77,77,1,0,"UPN-PP",20
31,"31228",486,341,337,2,4,"UPN-PP",107
31,"31160",106,89,88,2,1,"UPN-PP",37
31,"31169",2193,1472,1445,9,27,"UPN-PP",597
31,"31043",38,31,30,1,1,"UPN-PP",10
31,"31079",73,54,53,0,1,"UPN-PP",24
31,"31039",80,61,60,0,1,"UPN-PP",15
31,"31244",158,87,86,1,1,"UPN-PP",23
31,"31125",274,194,193,6,1,"UPN-PP",74
31,"31080",508,391,385,3,6,"UPN-PP",122
31,"31117",620,383,375,3,8,"UPN-PP",15
31,"31041",1606,1114,1101,15,13,"UPN-PP",311
31,"31239",322,211,211,5,0,"UPN-PP",84
31,"31165",2780,1995,1960,30,35,"UPN-PP",739
31,"31022",518,332,331,4,1,"UPN-PP",27
31,"31097",10410,7082,7002,75,80,"UPN-PP",2471
31,"31908",1004,686,682,2,4,"UPN-PP",110
31,"31002",414,288,287,3,1,"UPN-PP",103
31,"31040",192,139,138,4,1,"UPN-PP",50
31,"31177",255,169,166,2,3,"UPN-PP",56
31,"31122",4773,3520,3506,26,14,"UPN-PP",817
31,"31078",2429,1795,1767,15,28,"UPN-PP",618
31,"31055",257,175,172,2,3,"UPN-PP",21
31,"31059",186,131,131,1,0,"UPN-PP",29
31,"31207",273,182,177,2,5,"UPN-PP",48
31,"31092",662,439,435,4,4,"UPN-PP",122
31,"31248",299,165,162,0,3,"UPN-PP",59
31,"31056",174,121,120,0,1,"UPN-PP",43
31,"31216",3865,2702,2671,33,31,"UPN-PP",842
31,"31201",147715,105455,104658,1007,797,"UPN-PP",36344
31,"31110",91,61,58,1,3,"UPN-PP",17
31,"31231",117,76,73,1,3,"UPN-PP",35
31,"31113",133,87,86,0,1,"UPN-PP",30
31,"31145",172,128,128,4,0,"UPN-PP",80
31,"31171",680,495,486,8,9,"UPN-PP",115
31,"31155",256,169,167,2,2,"UPN-PP",48
31,"31027",836,532,530,2,2,"UPN-PP",48
31,"31168",246,172,171,1,1,"UPN-PP",72
31,"31246",140,111,107,1,4,"UPN-PP",33
31,"31124",208,148,148,2,0,"UPN-PP",79
31,"31006",1927,1350,1332,13,18,"UPN-PP",498
31,"31003",122,87,87,0,0,"UPN-PP",13
31,"31128",359,265,263,0,2,"UPN-PP",72
31,"31064",1424,1121,1104,3,17,"UPN-PP",443
31,"31220",744,583,579,8,4,"UPN-PP",261
31,"31202",4305,2845,2803,31,42,"UPN-PP",1168
31,"31069",832,637,635,3,2,"UPN-PP",249
31,"31221",1214,798,786,12,12,"UPN-PP",167
31,"31154",224,126,126,3,0,"UPN-PP",24
31,"31212",147,102,102,4,0,"UPN-PP",57
31,"31132",145,109,109,0,0,"UPN-PP",49
31,"31210",196,152,152,2,0,"UPN-PP",45
31,"31262",228,179,178,5,1,"UPN-PP",45
31,"31173",861,683,667,3,16,"UPN-PP",322
31,"31020",449,228,228,3,0,"UPN-PP",13
31,"31256",107,59,59,0,0,"UPN-PP",16
31,"31087",171,128,124,2,4,"UPN-PP",25
31,"31152",1328,924,900,11,24,"UPN-PP",356
31,"31235",159,117,115,2,2,"UPN-PP",33
31,"31178",490,345,342,3,3,"UPN-PP",110
31,"31075",103,63,63,0,0,"UPN-PP",14
31,"31001",88,62,62,0,0,"UPN-PP",15
31,"31025",766,524,518,6,6,"UPN-PP",139
31,"31214",91,64,62,1,2,"UPN-PP",14
31,"31005",301,212,211,3,1,"UPN-PP",78
31,"31026",144,118,117,0,1,"UPN-PP",48
31,"31219",84,66,66,0,0,"UPN-PP",25
31,"31017",358,242,239,0,3,"UPN-PP",56
31,"31194",311,217,216,3,1,"UPN-PP",54
31,"31074",387,286,286,5,0,"UPN-PP",59
31,"31186",299,195,194,3,1,"UPN-PP",37
31,"31098",1903,1428,1419,19,9,"UPN-PP",415
31,"31243",306,224,221,2,3,"UPN-PP",58
31,"31236",1320,865,854,5,11,"UPN-PP",280
31,"31204",36,28,28,1,0,"UPN-PP",18
31,"31034",37,25,25,0,0,"UPN-PP",7
31,"31072",5279,3734,3679,40,55,"UPN-PP",1501
31,"31050",6014,3489,3450,57,39,"UPN-PP",885
31,"31205",427,299,297,4,2,"UPN-PP",87
31,"31061",54,49,49,0,0,"UPN-PP",32
31,"31232",25155,17648,17450,196,198,"UPN-PP",6683
31,"31118",164,112,111,1,1,"UPN-PP",29
31,"31109",1582,1155,1150,9,5,"UPN-PP",370
31,"31086",13188,9713,9642,111,71,"UPN-PP",2992
31,"31134",176,125,124,0,1,"UPN-PP",45
31,"31189",1161,720,709,6,11,"UPN-PP",110
31,"31068",2885,2060,2027,20,33,"UPN-PP",671
31,"31907",10745,8067,8009,116,58,"UPN-PP",2165
31,"31047",254,191,188,2,3,"UPN-PP",81
31,"31088",5572,3897,3862,44,35,"UPN-PP",1172
31,"31143",96,55,54,1,1,"UPN-PP",27
31,"31258",7879,5707,5666,50,41,"UPN-PP",1128
31,"31133",43,28,28,0,0,"UPN-PP",3
31,"31119",39,26,26,0,0,"UPN-PP",6
31,"31126",358,223,223,2,0,"UPN-PP",43
31,"31029",914,638,625,6,13,"UPN-PP",267
31,"31116",62,51,50,1,1,"UPN-PP",34
31,"31099",62,47,47,2,0,"UPN-PP",20
31,"31032",1713,1209,1193,24,16,"UPN-PP",367
31,"31153",2159,1403,1387,12,16,"UPN-PP",147
31,"31185",494,341,341,1,0,"UPN-PP",127
31,"31144",796,445,444,6,1,"UPN-PP",91
31,"31107",1710,1255,1243,16,12,"UPN-PP",736
31,"31096",113,82,79,0,3,"UPN-PP",44
31,"31148",92,69,69,5,0,"UPN-PP",18
31,"31093",292,188,188,2,0,"UPN-PP",44
31,"31208",2556,1949,1920,16,29,"UPN-PP",506
31,"31223",985,704,698,4,6,"UPN-PP",199
31,"31174",110,63,63,0,0,"UPN-PP",24
31,"31038",1339,957,942,11,15,"UPN-PP",345
31,"31019",1785,1254,1238,9,16,"UPN-PP",240
31,"31101",1373,973,966,8,7,"UPN-PP",277
31,"31123",647,369,361,5,8,"UPN-PP",91
31,"31254",1915,1428,1411,3,17,"UPN-PP",485
31,"31013",642,406,401,1,5,"UPN-PP",119
31,"31227",8180,5885,5809,76,76,"UPN-PP",1369
31,"31903",6654,4402,4343,27,59,"UPN-PP",764
31,"31179",502,348,345,0,3,"UPN-PP",139
31,"31224",893,671,662,3,9,"UPN-PP",294
31,"31904",1563,1029,1022,23,7,"UPN-PP",224
31,"31136",447,299,298,2,1,"UPN-PP",61
31,"31076",2417,1918,1906,9,12,"UPN-PP",1058
31,"31217",321,226,223,1,3,"UPN-PP",106
31,"31131",901,646,638,7,8,"UPN-PP",269
31,"31252",87,61,61,0,0,"UPN-PP",21
31,"31209",155,107,106,0,1,"UPN-PP",29
31,"31089",242,172,170,1,2,"UPN-PP",90
31,"31187",111,68,63,1,5,"UPN-PP",12
31,"31139",159,96,95,0,1,"UPN-PP",41
31,"31213",104,52,52,0,0,"UPN-PP",8
31,"31198",37,25,25,0,0,"UPN-PP",3
31,"31066",855,589,579,8,10,"UPN-PP",250
31,"31053",523,372,368,1,4,"UPN-PP",131
31,"31203",40,28,28,0,0,"UPN-PP",10
31,"31251",3115,2240,2205,15,35,"UPN-PP",743
31,"31130",312,214,213,3,1,"UPN-PP",60
31,"31063",92,75,73,2,2,"UPN-PP",40
31,"31081",338,216,212,4,4,"UPN-PP",44
31,"31222",62,36,34,3,2,"UPN-PP",1
31,"31021",62,39,38,0,1,"UPN-PP",10
31,"31245",81,55,55,2,0,"UPN-PP",21
31,"31215",4676,3284,3240,36,44,"UPN-PP",1219
31,"31190",45,34,32,2,2,"UPN-PP",15
31,"31238",112,93,93,0,0,"UPN-PP",17
31,"31008",75,54,54,2,0,"UPN-PP",24
31,"31106",698,533,529,3,4,"UPN-PP",203
31,"31260",1238,794,788,12,6,"UPN-PP",295
31,"31071",17,16,16,0,0,"UPN-PP",6
31,"31057",1781,1287,1268,10,19,"UPN-PP",518
31,"31018",393,292,285,4,7,"UPN-PP",85
31,"31102",143,69,69,0,0,"UPN-PP",19
31,"31046",57,39,39,1,0,"UPN-PP",26
31,"31073",294,212,208,2,4,"UPN-PP",26
31,"31065",1878,1351,1326,20,25,"UPN-PP",532
31,"31121",62,44,43,0,1,"UPN-PP",17
31,"31011",693,459,456,8,3,"UPN-PP",164
31,"31175",71,48,48,0,0,"UPN-PP",23
31,"31024",99,42,42,0,0,"UPN-PP",2
31,"31115",165,102,101,1,1,"UPN-PP",20
31,"31211",27,15,15,1,0,"UPN-PP",11
31,"31036",909,636,628,7,8,"UPN-PP",195
31,"31095",75,59,59,1,0,"UPN-PP",11
31,"31023",6956,5310,5289,85,21,"UPN-PP",1863
31,"31249",1872,1290,1273,14,17,"UPN-PP",416
31,"31237",193,155,153,2,2,"UPN-PP",58
31,"31137",205,112,109,6,3,"UPN-PP",32
31,"31247",151,114,113,0,1,"UPN-PP",37
31,"31146",35,30,29,1,1,"UPN-PP",17
31,"31265",82,53,53,2,0,"UPN-PP",16
31,"31048",176,132,130,4,2,"UPN-PP",87
31,"31094",111,82,82,0,0,"UPN-PP",46
31,"31197",69,56,56,2,0,"UPN-PP",15
31,"31114",366,245,241,8,4,"UPN-PP",60
31,"31112",89,62,62,0,0,"UPN-PP",16
31,"31028",212,131,131,0,0,"UPN-PP",30
31,"31127",138,98,95,0,3,"UPN-PP",35
31,"31120",388,250,249,3,1,"UPN-PP",84
31,"31142",1403,958,949,10,9,"UPN-PP",383
31,"31170",47,42,42,3,0,"UPN-PP",12
31,"31225",36,27,27,0,0,"UPN-PP",6
31,"31060",13744,9400,9320,72,80,"UPN-PP",2226
31,"31138",932,601,599,2,2,"UPN-PP",64
31,"31031",220,131,129,0,2,"UPN-PP",22
31,"31135",106,70,66,2,4,"UPN-PP",39
31,"31193",1426,1024,1013,13,11,"UPN-PP",302
31,"31049",699,469,465,2,4,"UPN-PP",80
31,"31054",462,255,250,4,5,"UPN-PP",50
31,"31164",568,421,417,5,4,"UPN-PP",173
31,"31147",100,82,82,2,0,"UPN-PP",34
31,"31182",34,28,28,0,0,"UPN-PP",11
31,"31242",260,164,163,1,1,"UPN-PP",57
34,"34070",154,123,123,2,0,"UPyD",0
34,"34205",61,50,50,0,0,"UPyD",0
47,"47073",122,103,101,1,2,"UPyD",0
39,"39059",7986,5879,5806,45,73,"UPyD",12
24,"24029",735,539,535,3,4,"UPyD",0
18,"18109",597,411,408,2,3,"UPyD",1
22,"22136",806,588,588,5,0,"UPyD",0
46,"46041",329,253,252,5,1,"UPyD",0
4,"4018",270,232,229,0,3,"UPyD",0
49,"49223",752,608,600,4,8,"UPyD",1
22,"22032",110,76,74,0,2,"UPyD",0
46,"46179",2165,1760,1737,16,23,"UPyD",2
18,"18023",15655,10879,10774,82,105,"UPyD",18
9,"9411",151,102,101,0,1,"UPyD",0
42,"42190",89,65,64,0,1,"UPyD",0
28,"28126",39,29,29,0,0,"UPyD",0
16,"16099",203,153,147,0,6,"UPyD",0
42,"42069",1536,1036,1019,6,17,"UPyD",0
5,"5141",94,80,80,1,0,"UPyD",1
41,"41056",3687,2841,2812,30,29,"UPyD",4
2,"2052",459,372,369,4,3,"UPyD",0
41,"41075",10212,6419,6295,49,124,"UPyD",5
2,"2047",117,88,88,2,0,"UPyD",0
35,"35034",7873,3975,3943,27,32,"UPyD",4
31,"31104",1834,1257,1235,16,22,"UPyD",1
7,"7042",10666,6680,6613,64,67,"UPyD",15
26,"26013",347,249,246,2,3,"UPyD",1
31,"31008",75,54,54,2,0,"UPyD",0
45,"45010",415,311,310,2,1,"UPyD",0
50,"50221",35,17,17,0,0,"UPyD",3
24,"24902",347,270,269,2,1,"UPyD",0
5,"5118",79,53,53,0,0,"UPyD",0
28,"28013",40471,28739,28490,188,249,"UPyD",81
35,"35024",13735,8545,8439,77,106,"UPyD",8
9,"9417",40,32,32,1,0,"UPyD",0
22,"22178",103,82,81,0,1,"UPyD",0
19,"19071",7840,5537,5489,45,48,"UPyD",13
42,"42113",534,409,399,1,10,"UPyD",0
46,"46019",8849,7072,7004,33,68,"UPyD",6
9,"9137",174,132,131,3,1,"UPyD",1
42,"42131",51,37,37,1,0,"UPyD",0
2,"2069",11490,8470,8373,41,97,"UPyD",10
42,"42177",69,60,60,1,0,"UPyD",1
14,"14054",13697,10315,10109,93,206,"UPyD",20
16,"16002",187,158,158,1,0,"UPyD",0
9,"9231",69,38,38,1,0,"UPyD",0
5,"5194",140,119,116,1,3,"UPyD",0
9,"9059",136488,101469,100463,907,1006,"UPyD",389
28,"28041",4524,3508,3490,20,18,"UPyD",16
30,"30023",3780,2874,2850,12,24,"UPyD",7
40,"40054",108,90,90,0,0,"UPyD",0
16,"16088",108,88,87,0,1,"UPyD",0
31,"31215",4676,3284,3240,36,44,"UPyD",11
1,"1016",433,228,226,5,2,"UPyD",0
19,"19021",1030,759,744,7,15,"UPyD",0
2,"2030",3065,2287,2263,6,24,"UPyD",2
2,"2084",323,231,225,0,6,"UPyD",0
14,"14059",690,533,528,4,5,"UPyD",1
19,"19249",32,29,29,0,0,"UPyD",0
33,"33036",11542,8062,7987,60,75,"UPyD",12
48,"48902",19008,12566,12447,76,119,"UPyD",8
40,"40125",87,58,58,1,0,"UPyD",0
37,"37092",1758,1225,1215,8,10,"UPyD",3
10,"10124",852,665,655,2,10,"UPyD",1
7,"7015",20991,12552,12433,184,119,"UPyD",16
2,"2006",579,464,458,3,6,"UPyD",0
9,"9901",371,263,259,4,4,"UPyD",1
12,"12065",188,169,169,2,0,"UPyD",0
5,"5231",165,133,133,2,0,"UPyD",1
2,"2058",337,234,231,0,3,"UPyD",0
5,"5153",103,78,77,1,1,"UPyD",0
12,"12060",446,368,364,4,4,"UPyD",0
19,"19330",71,63,63,2,0,"UPyD",0
9,"9372",212,176,176,4,0,"UPyD",0
2,"2018",829,661,653,1,8,"UPyD",0
7,"7046",15797,9127,9043,86,84,"UPyD",119
26,"26138",4588,3290,3247,15,43,"UPyD",1
6,"6128",4447,2975,2935,26,40,"UPyD",2
35,"35029",4152,2530,2498,32,32,"UPyD",4
35,"35012",10382,5443,5392,17,51,"UPyD",6
31,"31026",144,118,117,0,1,"UPyD",0
6,"6135",1092,846,828,0,18,"UPyD",2
31,"31245",81,55,55,2,0,"UPyD",0
26,"26009",401,325,321,4,4,"UPyD",0
20,"20043",1739,1090,1088,9,2,"UPyD",0
50,"50043",253,171,171,0,0,"UPyD",0
40,"40051",38,34,34,0,0,"UPyD",0
34,"34168",52,47,47,2,0,"UPyD",0
40,"40146",254,197,196,0,1,"UPyD",1
49,"49241",248,177,177,0,0,"UPyD",0
26,"26115",19,16,16,0,0,"UPyD",0
37,"37347",468,348,346,2,2,"UPyD",0
33,"33040",4549,2986,2942,35,44,"UPyD",3
37,"37321",168,132,132,2,0,"UPyD",0
49,"49025",173,133,133,1,0,"UPyD",0
22,"22244",52,38,37,0,1,"UPyD",0
9,"9246",620,451,444,2,7,"UPyD",1
47,"47177",105,76,73,1,3,"UPyD",1
26,"26024",228,181,181,0,0,"UPyD",0
34,"34218",461,343,339,2,4,"UPyD",0
48,"48091",1121,771,765,7,6,"UPyD",0
50,"50267",602,433,430,8,3,"UPyD",0
22,"22160",209,168,168,6,0,"UPyD",0
10,"10016",330,237,235,0,2,"UPyD",0
40,"40186",42,29,29,0,0,"UPyD",0
41,"41097",3137,2180,2134,18,46,"UPyD",2
16,"16190",5105,3945,3887,17,58,"UPyD",5
16,"16139",335,256,255,2,1,"UPyD",0
48,"48906",766,547,544,0,3,"UPyD",0
19,"19095",12,9,9,0,0,"UPyD",0
49,"49093",280,223,222,1,1,"UPyD",0
37,"37181",286,210,207,4,3,"UPyD",0
19,"19019",20,18,17,0,1,"UPyD",0
49,"49037",185,153,151,0,2,"UPyD",0
14,"14050",2391,1822,1787,14,35,"UPyD",3
41,"41058",17395,12556,12332,111,224,"UPyD",26
3,"3005",7769,5917,5866,19,51,"UPyD",20
9,"9108",384,283,279,1,4,"UPyD",2
2,"2072",1549,1086,1070,2,16,"UPyD",0
31,"31061",54,49,49,0,0,"UPyD",0
39,"39098",1402,1046,1036,8,10,"UPyD",2
18,"18179",538,376,374,6,2,"UPyD",0
19,"19048",18,15,15,1,0,"UPyD",0
2,"2080",528,406,400,2,6,"UPyD",1
40,"40138",2169,1673,1656,7,17,"UPyD",3
19,"19246",46,36,34,2,2,"UPyD",0
7,"7034",1008,743,734,7,9,"UPyD",0
46,"46023",327,280,278,2,2,"UPyD",0
13,"13075",211,164,161,1,3,"UPyD",0
26,"26127",212,181,176,0,5,"UPyD",0
9,"9130",74,51,50,1,1,"UPyD",0
4,"4099",4989,3636,3588,27,48,"UPyD",4
21,"21037",472,341,336,2,5,"UPyD",1
47,"47096",140,110,110,0,0,"UPyD",1
24,"24011",203,133,132,0,1,"UPyD",0
16,"16276",21,16,16,1,0,"UPyD",0
46,"46083",15422,11179,11049,86,130,"UPyD",9
49,"49163",219,158,154,5,4,"UPyD",0
34,"34068",27,22,22,0,0,"UPyD",0
34,"34113",38,36,36,0,0,"UPyD",0
46,"46045",1249,1028,1010,3,18,"UPyD",0
9,"9101",76,56,55,1,1,"UPyD",0
46,"46071",464,383,377,0,6,"UPyD",1
9,"9257",93,81,80,4,1,"UPyD",0
29,"29006",673,428,420,1,8,"UPyD",1
1,"1017",849,571,565,5,6,"UPyD",0
10,"10051",430,308,296,0,12,"UPyD",0
50,"50272",12904,8880,8819,84,61,"UPyD",27
31,"31129",395,234,234,0,0,"UPyD",0
31,"31229",47,35,35,0,0,"UPyD",0
22,"22906",186,141,139,3,2,"UPyD",0
24,"24160",684,483,474,6,9,"UPyD",3
19,"19016",65,49,49,0,0,"UPyD",0
24,"24038",3089,2312,2273,17,39,"UPyD",1
24,"24181",1493,1054,1045,5,9,"UPyD",0
28,"28137",1664,1232,1220,7,12,"UPyD",3
23,"23038",3587,2794,2770,16,24,"UPyD",4
22,"22222",530,384,379,3,5,"UPyD",0
6,"6122",6634,4427,4321,26,106,"UPyD",6
40,"40040",2607,1843,1828,19,15,"UPyD",6
9,"9215",368,256,256,2,0,"UPyD",0
9,"9310",13,9,8,0,1,"UPyD",0
2,"2035",1960,1483,1465,13,18,"UPyD",2
29,"29904",421,338,335,3,3,"UPyD",0
5,"5171",74,52,50,1,2,"UPyD",1
9,"9287",208,158,156,3,2,"UPyD",0
42,"42084",25,22,22,1,0,"UPyD",1
7,"7049",1480,1003,993,14,10,"UPyD",4
9,"9094",53,42,42,1,0,"UPyD",1
40,"40024",856,651,639,6,12,"UPyD",0
19,"19210",21,19,18,1,1,"UPyD",0
9,"9318",61,41,41,0,0,"UPyD",1
29,"29083",2107,1540,1512,9,28,"UPyD",0
29,"29002",1177,804,789,5,15,"UPyD",3
34,"34185",63,38,37,2,1,"UPyD",0
9,"9201",28,18,18,1,0,"UPyD",0
34,"34086",103,89,88,0,1,"UPyD",1
13,"13088",610,458,453,6,5,"UPyD",0
9,"9375",36,31,31,0,0,"UPyD",0
19,"19075",64,39,39,0,0,"UPyD",0
47,"47149",42,34,34,3,0,"UPyD",0
9,"9445",44,32,32,3,0,"UPyD",0
20,"20038",387,261,259,0,2,"UPyD",0
28,"28147",963,722,720,5,2,"UPyD",0
40,"40118",51,35,34,1,1,"UPyD",1
34,"34052",174,135,133,0,2,"UPyD",2
41,"41011",15401,10170,9986,111,184,"UPyD",10
9,"9314",94,73,70,0,3,"UPyD",0
14,"14009",2788,1852,1834,20,18,"UPyD",14
3,"3093",19683,14633,14484,70,149,"UPyD",80
26,"26021",2827,2098,2076,15,22,"UPyD",7
9,"9281",145,114,109,1,5,"UPyD",0
23,"23062",1454,1141,1128,1,13,"UPyD",0
16,"16161",57,48,46,0,2,"UPyD",0
16,"16096",274,232,229,1,3,"UPyD",1
9,"9456",130,97,96,0,1,"UPyD",0
16,"16024",129,98,97,0,1,"UPyD",0
22,"22215",128,96,96,1,0,"UPyD",0
4,"4070",1584,1184,1179,3,5,"UPyD",0
5,"5234",49,44,44,2,0,"UPyD",0
3,"3076",8467,6238,6157,30,81,"UPyD",9
50,"50285",644,436,434,2,2,"UPyD",1
16,"16009",62,51,50,0,1,"UPyD",1
9,"9447",44,41,41,0,0,"UPyD",0
14,"14010",4027,2850,2807,19,43,"UPyD",5
10,"10167",314,239,239,1,0,"UPyD",0
39,"39050",270,187,186,0,1,"UPyD",0
29,"29001",4170,3106,3068,19,38,"UPyD",0
19,"19064",70,64,64,2,0,"UPyD",0
31,"31030",141,100,99,0,1,"UPyD",2
46,"46119",780,653,647,5,6,"UPyD",1
37,"37263",342,237,229,0,8,"UPyD",0
37,"37322",2465,1592,1564,8,28,"UPyD",5
24,"24199",424,302,301,0,1,"UPyD",1
3,"3123",7476,5557,5501,29,56,"UPyD",13
16,"16056",457,306,305,3,1,"UPyD",0
45,"45080",6,6,6,0,0,"UPyD",1
6,"6054",5446,3920,3833,32,87,"UPyD",4
29,"29034",467,358,356,0,2,"UPyD",1
45,"45025",1205,831,827,2,4,"UPyD",1
41,"41052",3013,2116,2064,14,52,"UPyD",4
49,"49214",698,525,512,3,13,"UPyD",1
28,"28089",3677,2748,2730,10,18,"UPyD",14
23,"23049",1813,1238,1222,9,16,"UPyD",2
37,"37009",213,172,171,3,1,"UPyD",0
26,"26164",59,46,45,2,1,"UPyD",1
9,"9047",54,47,46,1,1,"UPyD",0
19,"19150",128,99,99,1,0,"UPyD",0
47,"47067",174,127,126,0,1,"UPyD",1
37,"37238",110,87,85,0,2,"UPyD",0
50,"50026",439,335,325,10,10,"UPyD",3
29,"29903",524,353,349,3,4,"UPyD",0
37,"37126",29,24,24,0,0,"UPyD",0
9,"9013",48,37,37,0,0,"UPyD",0
45,"45134",1581,1204,1192,6,12,"UPyD",2
28,"28047",40914,30019,29788,169,231,"UPyD",196
46,"46158",1026,811,795,6,16,"UPyD",1
48,"48039",239,190,188,0,2,"UPyD",0
9,"9396",156,121,121,0,0,"UPyD",1
47,"47103",267,197,192,5,5,"UPyD",0
28,"28903",33082,27065,26922,154,143,"UPyD",175
12,"12089",4328,3078,3020,15,58,"UPyD",7
37,"37033",95,68,68,5,0,"UPyD",1
37,"37058",58,45,45,0,0,"UPyD",1
34,"34186",52,45,45,0,0,"UPyD",0
6,"6068",446,347,345,5,2,"UPyD",1
12,"12093",178,137,136,2,1,"UPyD",0
47,"47174",267,218,215,1,3,"UPyD",2
22,"22083",463,394,390,5,4,"UPyD",0
3,"3030",524,448,440,5,8,"UPyD",1
37,"37296",336,259,254,2,5,"UPyD",0
16,"16266",368,264,259,1,5,"UPyD",0
13,"13080",351,266,266,2,0,"UPyD",0
49,"49259",89,66,65,1,1,"UPyD",0
4,"4089",742,521,518,1,3,"UPyD",0
46,"46156",2080,1697,1675,10,22,"UPyD",1
31,"31085",480,350,350,2,0,"UPyD",0
49,"49245",262,176,173,2,3,"UPyD",0
21,"21056",2895,1990,1906,18,84,"UPyD",7
42,"42048",66,51,51,0,0,"UPyD",0
6,"6074",4791,3513,3449,18,64,"UPyD",8
23,"23032",566,450,448,4,2,"UPyD",0
40,"40059",110,95,95,1,0,"UPyD",0
12,"12011",4565,3331,3283,20,48,"UPyD",10
5,"5099",491,395,386,6,9,"UPyD",0
37,"37085",4712,3366,3333,27,33,"UPyD",15
16,"16057",75,63,63,0,0,"UPyD",0
16,"16209",116,101,101,2,0,"UPyD",1
30,"30043",24967,18981,18685,101,296,"UPyD",44
9,"9232",154,119,116,0,3,"UPyD",0
42,"42168",107,80,80,0,0,"UPyD",0
31,"31032",1713,1209,1193,24,16,"UPyD",0
5,"5190",53,42,41,2,1,"UPyD",1
23,"23072",1986,1542,1530,7,12,"UPyD",2
22,"22907",1435,1059,1046,18,13,"UPyD",4
31,"31212",147,102,102,4,0,"UPyD",0
49,"49262",392,279,274,1,5,"UPyD",0
49,"49023",967,673,662,10,11,"UPyD",1
14,"14044",1604,1172,1165,7,7,"UPyD",1
10,"10009",266,201,194,0,7,"UPyD",0
20,"20003",547,308,308,3,0,"UPyD",0
9,"9345",123,93,91,2,2,"UPyD",0
39,"39073",9837,7356,7298,31,58,"UPyD",33
24,"24009",322,153,152,2,1,"UPyD",0
48,"48029",8338,5721,5683,37,38,"UPyD",7
26,"26012",23,23,23,1,0,"UPyD",0
3,"3134",143,112,111,0,1,"UPyD",0
13,"13040",868,678,672,4,6,"UPyD",1
40,"40068",26,24,24,0,0,"UPyD",0
9,"9227",119,91,89,4,2,"UPyD",0
46,"46049",281,232,224,0,8,"UPyD",0
12,"12082",9617,7324,7231,46,93,"UPyD",15
12,"12014",184,144,143,2,1,"UPyD",0
14,"14039",2604,2062,2021,12,41,"UPyD",0
4,"4072",313,247,245,2,2,"UPyD",1
22,"22066",702,502,498,7,4,"UPyD",3
34,"34182",786,606,597,10,9,"UPyD",0
24,"24219",516,387,386,4,1,"UPyD",1
48,"48047",159,111,111,0,0,"UPyD",0
5,"5163",1737,1347,1340,4,7,"UPyD",3
13,"13019",5181,3621,3579,18,42,"UPyD",7
10,"10184",756,613,604,10,9,"UPyD",0
19,"19105",2334,1753,1739,8,14,"UPyD",8
49,"49086",115,96,91,0,5,"UPyD",0
39,"39085",6836,5086,5032,44,54,"UPyD",8
34,"34161",23,16,16,0,0,"UPyD",0
10,"10200",392,306,302,1,4,"UPyD",0
9,"9416",53,35,35,0,0,"UPyD",1
50,"50013",219,180,180,0,0,"UPyD",0
39,"39099",3114,2308,2281,12,27,"UPyD",8
37,"37331",212,137,135,0,2,"UPyD",0
22,"22156",289,220,220,2,0,"UPyD",0
22,"22110",738,531,527,4,4,"UPyD",3
19,"19279",57,55,55,0,0,"UPyD",0
29,"29097",4108,2871,2821,37,50,"UPyD",5
5,"5143",66,51,49,0,2,"UPyD",0
5,"5067",83,68,67,0,1,"UPyD",0
6,"6133",1775,1324,1312,15,12,"UPyD",0
50,"50271",252,200,197,2,3,"UPyD",0
12,"12012",2685,2234,2202,13,32,"UPyD",2
34,"34073",185,149,149,0,0,"UPyD",2
12,"12136",2635,2201,2171,18,30,"UPyD",1
10,"10019",1498,1063,1054,3,9,"UPyD",5
11,"11021",6764,4434,4362,52,72,"UPyD",2
46,"46090",1637,1391,1367,3,24,"UPyD",0
2,"2001",656,527,523,1,4,"UPyD",1
2,"2027",315,248,246,2,2,"UPyD",0
37,"37160",615,434,429,8,5,"UPyD",1
28,"28110",1944,1478,1463,4,15,"UPyD",3
10,"10173",577,400,399,5,1,"UPyD",0
31,"31163",2013,1418,1383,13,35,"UPyD",0
49,"49255",418,319,316,1,3,"UPyD",1
16,"16118",1375,1106,1086,13,20,"UPyD",2
1,"1019",150,106,105,1,1,"UPyD",0
39,"39040",4292,3208,3166,14,42,"UPyD",12
3,"3092",6743,5254,5178,37,76,"UPyD",8
46,"46249",9288,6746,6676,56,70,"UPyD",18
2,"2901",2200,1440,1437,7,3,"UPyD",1
2,"2034",1382,1110,1093,7,17,"UPyD",3
45,"45081",17875,12656,12533,82,123,"UPyD",22
14,"14061",744,595,582,1,13,"UPyD",1
39,"39048",1716,1329,1312,12,17,"UPyD",2
41,"41060",15242,10021,9847,86,174,"UPyD",14
24,"24099",171,132,132,0,0,"UPyD",0
47,"47196",34,27,27,0,0,"UPyD",0
13,"13043",231,180,179,1,1,"UPyD",0
29,"29069",85684,54130,53621,455,509,"UPyD",129
37,"37079",77,73,73,1,0,"UPyD",2
6,"6055",2051,1453,1422,8,31,"UPyD",0
4,"4033",135,97,93,1,4,"UPyD",0
23,"23001",963,801,799,1,2,"UPyD",2
31,"31094",111,82,82,0,0,"UPyD",0
50,"50274",71,55,55,0,0,"UPyD",0
34,"34031",30,30,29,0,1,"UPyD",0
31,"31209",155,107,106,0,1,"UPyD",0
1,"1013",712,454,450,0,4,"UPyD",0
18,"18163",324,235,233,2,2,"UPyD",0
19,"19266",236,188,188,1,0,"UPyD",0
23,"23043",546,398,396,3,2,"UPyD",0
48,"48062",302,237,236,4,1,"UPyD",0
47,"47027",2745,2036,2018,9,18,"UPyD",5
42,"42162",2352,1637,1601,16,36,"UPyD",7
19,"19319",4449,3086,3056,18,30,"UPyD",4
40,"40080",59,43,41,0,2,"UPyD",1
47,"47231",4401,3299,3277,24,22,"UPyD",9
50,"50066",2621,1862,1851,9,11,"UPyD",5
18,"18148",817,637,634,5,3,"UPyD",0
47,"47109",179,138,138,2,0,"UPyD",1
6,"6084",1093,828,818,8,10,"UPyD",2
31,"31230",106,82,82,1,0,"UPyD",1
26,"26178",75,57,55,1,2,"UPyD",0
31,"31162",47,31,31,0,0,"UPyD",0
28,"28055",916,693,687,5,6,"UPyD",0
1,"1022",799,557,544,2,13,"UPyD",1
4,"4035",8364,5810,5766,28,44,"UPyD",4
22,"22190",119,86,85,0,1,"UPyD",0
42,"42139",23,15,15,1,0,"UPyD",0
10,"10011",560,458,448,5,10,"UPyD",0
26,"26050",113,88,85,0,3,"UPyD",0
22,"22902",221,159,156,0,3,"UPyD",0
28,"28009",14086,10611,10545,57,66,"UPyD",42
30,"30012",9091,6962,6897,36,65,"UPyD",6
26,"26096",245,190,190,1,0,"UPyD",0
46,"46157",2980,2321,2298,10,23,"UPyD",0
45,"45007",696,534,522,3,12,"UPyD",0
26,"26180",221,173,172,0,1,"UPyD",0
41,"41013",4839,3151,3094,33,57,"UPyD",1
33,"33052",721,485,482,3,3,"UPyD",1
24,"24150",243,172,172,6,0,"UPyD",1
29,"29028",1237,836,826,6,10,"UPyD",1
46,"46244",58771,42137,41867,270,270,"UPyD",104
9,"9248",78,59,59,1,0,"UPyD",0
28,"28145",2431,1760,1736,6,24,"UPyD",3
42,"42061",291,214,213,3,1,"UPyD",1
31,"31903",6654,4402,4343,27,59,"UPyD",1
46,"46022",15365,11093,10997,59,96,"UPyD",14
50,"50059",769,549,544,8,5,"UPyD",0
9,"9068",29,24,24,0,0,"UPyD",0
10,"10196",301,225,225,1,0,"UPyD",0
20,"20014",1108,611,609,4,2,"UPyD",0
7,"7003",11761,6631,6541,55,90,"UPyD",8
33,"33070",3351,2403,2373,26,30,"UPyD",5
26,"26107",94,77,77,2,0,"UPyD",0
19,"19270",20,17,17,0,0,"UPyD",0
22,"22079",118,83,83,1,0,"UPyD",0
10,"10147",1278,961,925,7,36,"UPyD",0
41,"41014",2492,1882,1852,11,30,"UPyD",1
22,"22249",116,95,95,4,0,"UPyD",0
45,"45195",2141,1635,1606,7,29,"UPyD",4
19,"19058",6793,5258,5218,19,40,"UPyD",14
18,"18007",781,521,512,5,9,"UPyD",2
6,"6063",3015,2268,2246,16,22,"UPyD",1
28,"28901",799,558,554,0,4,"UPyD",1
37,"37133",111,78,73,1,5,"UPyD",0
11,"11004",88783,51500,51015,513,485,"UPyD",210
49,"49167",197,147,145,0,2,"UPyD",1
26,"26123",126,108,107,2,1,"UPyD",0
9,"9011",65,48,48,0,0,"UPyD",1
6,"6034",171,121,120,4,1,"UPyD",0
5,"5164",26,14,14,0,0,"UPyD",0
50,"50022",530,397,390,7,7,"UPyD",0
28,"28136",647,528,518,2,10,"UPyD",2
5,"5131",99,69,69,0,0,"UPyD",0
9,"9482",33,28,28,0,0,"UPyD",1
50,"50003",128,92,91,1,1,"UPyD",0
26,"26077",22,22,21,1,1,"UPyD",0
20,"20902",14156,9664,9613,74,51,"UPyD",20
5,"5100",278,227,223,1,4,"UPyD",0
18,"18100",7807,5452,5398,50,54,"UPyD",16
9,"9134",221,161,156,7,5,"UPyD",0
28,"28127",64827,51776,51613,220,163,"UPyD",247
11,"11005",4583,3018,2967,25,51,"UPyD",6
26,"26125",2699,1931,1907,23,24,"UPyD",4
39,"39025",8637,6486,6378,47,108,"UPyD",7
50,"50092",299,233,231,0,2,"UPyD",0
47,"47147",116,92,92,0,0,"UPyD",0
26,"26018",10477,8053,7956,65,97,"UPyD",10
5,"5166",185,139,139,1,0,"UPyD",0
37,"37332",68,51,50,0,1,"UPyD",0
18,"18178",719,549,544,4,5,"UPyD",0
5,"5181",43,34,34,1,0,"UPyD",0
16,"16258",194,150,150,1,0,"UPyD",0
49,"49166",1227,946,933,6,13,"UPyD",2
19,"19255",79,63,61,1,2,"UPyD",0
29,"29086",793,470,470,3,0,"UPyD",1
18,"18102",8400,5592,5504,44,88,"UPyD",3
6,"6083",46149,31049,30739,234,310,"UPyD",101
50,"50108",48,38,38,0,0,"UPyD",0
42,"42003",67,48,47,0,1,"UPyD",0
33,"33037",34454,22881,22586,243,295,"UPyD",43
6,"6159",2329,1351,1318,16,33,"UPyD",3
10,"10005",540,377,362,3,15,"UPyD",0
47,"47125",58,46,46,0,0,"UPyD",0
37,"37044",466,362,360,2,2,"UPyD",1
10,"10219",1276,796,790,7,6,"UPyD",2
22,"22202",141,119,119,0,0,"UPyD",0
31,"31093",292,188,188,2,0,"UPyD",0
16,"16259",29,22,21,0,1,"UPyD",0
9,"9182",80,69,67,1,2,"UPyD",0
5,"5199",40,32,31,0,1,"UPyD",0
46,"46068",346,276,266,6,10,"UPyD",0
19,"19173",45,38,36,0,2,"UPyD",0
5,"5155",52,44,44,0,0,"UPyD",0
3,"3114",1562,1198,1188,9,10,"UPyD",0
14,"14071",929,642,630,2,12,"UPyD",0
30,"30009",12433,9586,9503,41,83,"UPyD",10
31,"31227",8180,5885,5809,76,76,"UPyD",11
9,"9056",4919,3395,3344,20,51,"UPyD",8
21,"21052",4583,2734,2663,22,71,"UPyD",4
19,"19023",124,100,98,2,2,"UPyD",0
23,"23015",1374,1029,1019,5,10,"UPyD",1
34,"34190",56,41,40,2,1,"UPyD",0
50,"50037",136,98,96,0,2,"UPyD",0
6,"6158",13314,9654,9507,67,147,"UPyD",31
40,"40151",46,33,33,0,0,"UPyD",0
31,"31080",508,391,385,3,6,"UPyD",0
3,"3133",41576,25849,25639,127,210,"UPyD",43
28,"28101",231,187,187,0,0,"UPyD",0
10,"10008",1319,1019,1008,6,11,"UPyD",1
24,"24178",70,59,58,0,1,"UPyD",0
19,"19284",10,10,9,0,1,"UPyD",0
37,"37336",52,50,50,1,0,"UPyD",0
10,"10050",1053,846,837,6,9,"UPyD",0
9,"9113",449,339,332,4,7,"UPyD",2
7,"7062",7513,4273,4219,52,54,"UPyD",7
31,"31140",117,84,84,1,0,"UPyD",0
24,"24215",152,113,113,0,0,"UPyD",0
9,"9114",86,66,66,0,0,"UPyD",0
21,"21068",998,605,592,11,13,"UPyD",1
14,"14045",3052,2362,2335,11,27,"UPyD",0
18,"18152",944,707,703,0,4,"UPyD",0
12,"12033",1919,1437,1404,19,33,"UPyD",1
9,"9451",238,191,190,0,1,"UPyD",0
22,"22218",43,33,33,0,0,"UPyD",0
31,"31007",131,87,86,1,1,"UPyD",0
19,"19054",192,164,164,1,0,"UPyD",0
34,"34199",1218,918,899,10,19,"UPyD",2
37,"37310",178,123,123,1,0,"UPyD",0
19,"19225",823,623,619,3,4,"UPyD",5
34,"34216",66,50,50,0,0,"UPyD",0
31,"31097",10410,7082,7002,75,80,"UPyD",10
37,"37352",207,153,152,1,1,"UPyD",0
21,"21029",1562,1127,1097,14,30,"UPyD",0
47,"47090",2418,1728,1699,8,29,"UPyD",3
26,"26131",35,33,33,1,0,"UPyD",0
16,"16109",44,38,38,1,0,"UPyD",1
1,"1039",209,155,153,0,2,"UPyD",0
35,"35006",30457,21398,21118,162,280,"UPyD",33
7,"7029",4166,2949,2913,37,36,"UPyD",1
19,"19226",43,38,38,0,0,"UPyD",0
49,"49164",155,119,115,2,4,"UPyD",0
46,"46251",2462,1997,1956,6,41,"UPyD",1
16,"16095",83,64,63,0,1,"UPyD",0
19,"19178",33,22,22,0,0,"UPyD",0
37,"37381",147,114,107,2,7,"UPyD",0
12,"12122",796,637,627,0,10,"UPyD",1
34,"34214",183,144,144,0,0,"UPyD",1
31,"31076",2417,1918,1906,9,12,"UPyD",1
26,"26098",88,73,73,1,0,"UPyD",0
46,"46124",787,653,642,4,11,"UPyD",1
19,"19125",41,32,32,0,0,"UPyD",1
26,"26146",94,73,72,0,1,"UPyD",0
29,"29082",31885,22572,22400,152,172,"UPyD",88
6,"6139",553,420,419,1,1,"UPyD",0
46,"46159",22857,16840,16697,128,143,"UPyD",45
4,"4091",334,268,267,6,1,"UPyD",0
2,"2068",337,251,246,1,5,"UPyD",0
28,"28057",1458,1097,1088,3,9,"UPyD",2
10,"10183",980,733,728,1,5,"UPyD",1
28,"28049",58480,45136,44820,242,316,"UPyD",182
12,"12104",6933,5411,5342,25,69,"UPyD",10
24,"24105",1459,1042,1025,16,17,"UPyD",1
3,"3067",99,85,85,0,0,"UPyD",0
42,"42080",157,117,115,0,2,"UPyD",0
5,"5114",1345,1067,1044,3,23,"UPyD",2
1,"1001",1979,1339,1318,7,21,"UPyD",1
48,"48037",673,481,478,5,3,"UPyD",1
40,"40231",108,90,89,0,1,"UPyD",0
28,"28011",442,317,316,1,1,"UPyD",1
50,"50201",448,339,335,7,4,"UPyD",0
21,"21006",3368,2182,2146,13,36,"UPyD",1
24,"24062",139,98,98,1,0,"UPyD",0
23,"23088",6089,4558,4472,34,86,"UPyD",2
22,"22124",201,144,143,1,1,"UPyD",0
6,"6156",1175,869,865,8,4,"UPyD",1
21,"21061",5084,3223,3177,28,46,"UPyD",1
39,"39028",3739,2850,2817,16,33,"UPyD",10
18,"18068",1569,1189,1166,6,23,"UPyD",2
37,"37274",118913,85506,84764,566,742,"UPyD",342
16,"16215",242,172,169,2,3,"UPyD",0
24,"24174",486,343,342,4,1,"UPyD",0
37,"37014",1155,817,808,7,9,"UPyD",2
29,"29011",2900,1822,1803,9,19,"UPyD",2
7,"7007",421,296,293,2,3,"UPyD",1
18,"18025",288,220,220,1,0,"UPyD",0
36,"36026",20137,13779,13596,141,183,"UPyD",28
19,"19300",772,595,591,5,4,"UPyD",1
9,"9463",264,195,195,7,0,"UPyD",0
37,"37205",231,189,182,0,7,"UPyD",0
37,"37303",190,142,139,1,3,"UPyD",0
11,"11006",24455,15750,15587,193,163,"UPyD",20
50,"50244",201,162,161,1,1,"UPyD",1
37,"37275",118,70,69,0,1,"UPyD",0
3,"3039",81,62,61,1,1,"UPyD",0
13,"13091",538,450,446,0,4,"UPyD",1
5,"5102",1780,1339,1317,3,22,"UPyD",1
28,"28023",4775,3755,3735,12,20,"UPyD",18
21,"21036",200,141,139,0,2,"UPyD",1
23,"23077",620,501,494,3,7,"UPyD",0
37,"37360",225,174,173,1,1,"UPyD",0
45,"45057",222,180,177,1,3,"UPyD",0
26,"26139",54,45,44,0,1,"UPyD",0
34,"34123",1648,1287,1258,12,29,"UPyD",2
46,"46101",860,716,705,3,11,"UPyD",0
20,"20008",716,362,361,6,1,"UPyD",0
35,"35002",23328,15495,15313,94,182,"UPyD",17
21,"21051",239,174,170,1,4,"UPyD",0
50,"50045",1243,926,925,6,1,"UPyD",2
26,"26068",80,61,61,1,0,"UPyD",0
45,"45124",2140,1677,1641,10,36,"UPyD",1
12,"12088",62,59,59,0,0,"UPyD",1
10,"10037",76232,55104,54464,418,640,"UPyD",138
28,"28120",1223,892,884,2,8,"UPyD",7
23,"23012",4162,2907,2889,14,18,"UPyD",1
22,"22254",1124,801,792,11,9,"UPyD",1
9,"9467",64,43,42,1,1,"UPyD",0
3,"3031",41499,27031,26813,128,218,"UPyD",42
50,"50175",1002,695,688,5,7,"UPyD",4
28,"28015",18736,14221,14127,68,94,"UPyD",42
37,"37278",732,532,528,3,4,"UPyD",4
19,"19162",68,49,47,0,2,"UPyD",0
5,"5121",249,185,185,4,0,"UPyD",1
34,"34125",86,65,64,0,1,"UPyD",0
5,"5021",1914,1483,1464,5,19,"UPyD",1
6,"6102",1048,843,825,6,18,"UPyD",1
3,"3022",145,125,125,0,0,"UPyD",1
26,"26089",110582,82972,82186,588,786,"UPyD",241
1,"1051",3603,2259,2235,17,24,"UPyD",2
5,"5902",284,236,232,0,4,"UPyD",2
19,"19234",43,33,33,0,0,"UPyD",0
6,"6149",10295,7651,7536,56,115,"UPyD",14
22,"22217",385,287,281,1,6,"UPyD",0
24,"24134",3416,2470,2417,19,53,"UPyD",2
48,"48093",893,653,643,7,10,"UPyD",0
14,"14053",6006,4285,4232,49,53,"UPyD",8
49,"49027",140,112,108,1,4,"UPyD",0
46,"46148",1513,1160,1146,7,14,"UPyD",3
34,"34022",1082,873,861,9,12,"UPyD",3
37,"37267",200,156,147,2,9,"UPyD",1
47,"47180",73,61,60,4,1,"UPyD",0
24,"24101",397,258,257,3,1,"UPyD",0
40,"40072",211,162,159,1,3,"UPyD",0
5,"5173",60,49,49,0,0,"UPyD",0
23,"23044",4816,3663,3569,27,94,"UPyD",1
37,"37365",172,134,133,1,1,"UPyD",1
10,"10117",255,135,134,0,1,"UPyD",0
28,"28017",1208,907,899,7,8,"UPyD",4
35,"35023",11686,8212,8076,55,136,"UPyD",10
37,"37197",84,57,57,2,0,"UPyD",0
10,"10103",450,322,318,1,4,"UPyD",0
34,"34112",46,38,37,0,1,"UPyD",0
1,"1063",1798,1269,1261,19,8,"UPyD",2
12,"12057",606,487,474,5,13,"UPyD",1
48,"48095",2347,1555,1546,12,9,"UPyD",2
36,"36045",24529,17613,17336,129,277,"UPyD",25
9,"9387",117,95,90,0,5,"UPyD",0
11,"11023",9348,6410,6349,64,61,"UPyD",14
18,"18173",8939,5922,5849,42,73,"UPyD",9
9,"9454",43,34,33,0,1,"UPyD",0
28,"28019",1233,893,885,4,8,"UPyD",4
47,"47021",76,64,64,0,0,"UPyD",0
22,"22193",276,225,224,2,1,"UPyD",0
20,"20013",5415,3602,3579,19,23,"UPyD",2
46,"46202",16947,12814,12710,79,104,"UPyD",24
10,"10105",2512,1644,1620,12,24,"UPyD",3
6,"6031",469,277,272,2,5,"UPyD",0
36,"36010",2847,2102,2076,13,26,"UPyD",6
24,"24115",54058,37780,37357,308,423,"UPyD",91
37,"37200",187,136,136,0,0,"UPyD",0
23,"23047",1629,1258,1250,10,8,"UPyD",1
24,"24070",4124,3024,2981,20,43,"UPyD",4
22,"22107",112,74,74,0,0,"UPyD",0
47,"47111",1020,742,732,7,10,"UPyD",0
37,"37174",1056,820,812,3,8,"UPyD",0
49,"49007",370,255,249,1,6,"UPyD",0
19,"19217",54,40,39,0,1,"UPyD",0
4,"4038",3084,2140,2126,16,14,"UPyD",3
9,"9119",46,28,28,0,0,"UPyD",0
18,"18188",1653,1183,1175,5,8,"UPyD",2
26,"26019",355,274,271,1,3,"UPyD",1
29,"29052",224,144,144,3,0,"UPyD",0
37,"37285",403,310,308,2,2,"UPyD",1
42,"42063",49,35,35,0,0,"UPyD",0
31,"31022",518,332,331,4,1,"UPyD",1
47,"47140",115,102,102,1,0,"UPyD",0
3,"3047",9207,6309,6226,25,83,"UPyD",16
42,"42024",86,61,59,0,2,"UPyD",1
5,"5227",358,253,250,1,3,"UPyD",0
18,"18037",535,402,396,2,6,"UPyD",2
3,"3099",42319,31083,30801,165,282,"UPyD",48
31,"31211",27,15,15,1,0,"UPyD",0
3,"3120",2406,1753,1720,11,33,"UPyD",8
26,"26032",51,41,39,0,2,"UPyD",0
45,"45066",7570,5550,5484,25,66,"UPyD",7
13,"13001",1254,934,925,6,9,"UPyD",1
7,"7019",187,133,129,2,4,"UPyD",0
19,"19204",148,120,120,0,0,"UPyD",0
12,"12084",17615,12766,12644,105,122,"UPyD",12
19,"19318",25,18,18,0,0,"UPyD",0
26,"26149",57,47,46,0,1,"UPyD",0
13,"13002",1483,1012,998,3,14,"UPyD",3
33,"33076",12258,8106,8031,63,75,"UPyD",16
24,"24184",198,118,117,0,1,"UPyD",0
40,"40078",161,125,124,2,1,"UPyD",0
46,"46230",13960,10351,10241,54,110,"UPyD",19
18,"18162",938,698,686,1,12,"UPyD",0
12,"12074",785,652,648,5,4,"UPyD",2
20,"20073",4677,3014,2995,15,19,"UPyD",1
10,"10064",1476,1092,1072,7,20,"UPyD",2
45,"45167",1440,1144,1133,6,11,"UPyD",1
46,"46135",9680,7682,7634,36,48,"UPyD",21
1,"1058",1345,799,793,7,6,"UPyD",0
37,"37288",262,182,181,4,1,"UPyD",0
47,"47142",141,99,97,0,2,"UPyD",0
48,"48049",549,416,416,1,0,"UPyD",1
31,"31102",143,69,69,0,0,"UPyD",0
31,"31236",1320,865,854,5,11,"UPyD",0
37,"37289",232,167,166,3,1,"UPyD",0
3,"3019",15269,11520,11398,72,122,"UPyD",30
47,"47133",2682,2033,2015,16,18,"UPyD",6
2,"2073",4867,3520,3474,40,46,"UPyD",3
42,"42116",45,39,38,3,1,"UPyD",0
37,"37290",141,113,113,0,0,"UPyD",0
40,"40165",77,65,64,1,1,"UPyD",0
46,"46136",2537,1952,1930,11,22,"UPyD",1
11,"11029",5430,3039,3000,44,39,"UPyD",2
47,"47087",381,301,297,3,4,"UPyD",0
31,"31126",358,223,223,2,0,"UPyD",0
13,"13058",4100,2986,2954,25,32,"UPyD",1
40,"40222",168,145,144,0,1,"UPyD",2
10,"10098",378,289,287,1,2,"UPyD",0
9,"9395",138,104,104,0,0,"UPyD",0
40,"40166",253,218,215,1,3,"UPyD",0
16,"16186",456,375,371,0,4,"UPyD",1
50,"50287",270,191,191,0,0,"UPyD",0
31,"31016",7608,5474,5413,50,61,"UPyD",7
28,"28169",1448,1122,1113,5,9,"UPyD",4
2,"2075",1670,1321,1304,4,17,"UPyD",1
19,"19134",24,15,15,0,0,"UPyD",0
26,"26117",2152,1625,1605,10,20,"UPyD",2
39,"39072",344,198,196,2,2,"UPyD",0
19,"19245",1155,855,835,5,20,"UPyD",0
10,"10902",721,548,540,4,8,"UPyD",1
9,"9127",56,41,39,0,2,"UPyD",0
40,"40168",34,29,29,1,0,"UPyD",0
5,"5156",256,160,159,1,1,"UPyD",0
31,"31172",373,278,272,3,6,"UPyD",0
35,"35030",9250,5413,5326,34,87,"UPyD",8
46,"46173",1328,1069,1057,4,12,"UPyD",1
21,"21013",10591,6580,6452,55,128,"UPyD",7
46,"46181",16955,12313,12148,95,165,"UPyD",15
45,"45072",671,484,483,2,1,"UPyD",0
31,"31051",251,170,170,2,0,"UPyD",0
13,"13062",574,453,448,3,5,"UPyD",0
3,"3137",651,492,489,5,3,"UPyD",0
35,"35013",6625,4896,4781,41,115,"UPyD",8
18,"18153",8597,6024,5972,40,52,"UPyD",19
45,"45005",238,193,192,3,1,"UPyD",0
46,"46208",1112,887,881,4,6,"UPyD",1
29,"29016",251,188,188,1,0,"UPyD",0
20,"20023",441,252,251,1,1,"UPyD",0
45,"45016",4204,3146,3105,22,41,"UPyD",12
23,"23056",3088,2243,2203,15,40,"UPyD",4
14,"14035",5966,4236,4177,39,59,"UPyD",2
24,"24058",208,155,154,3,1,"UPyD",0
13,"13064",1696,1231,1225,9,6,"UPyD",3
33,"33020",13307,9011,8914,99,97,"UPyD",18
24,"24068",457,344,340,0,4,"UPyD",1
12,"12121",1107,924,893,4,31,"UPyD",1
9,"9905",384,279,279,2,0,"UPyD",2
3,"3096",5786,4358,4289,17,69,"UPyD",9
13,"13030",139,98,96,0,2,"UPyD",0
19,"19153",22,17,17,0,0,"UPyD",0
46,"46079",318,241,232,1,9,"UPyD",0
18,"18095",1967,1450,1430,11,20,"UPyD",3
50,"50071",132,92,92,0,0,"UPyD",0
23,"23057",766,625,619,4,6,"UPyD",0
9,"9007",57,39,39,0,0,"UPyD",0
40,"40004",459,356,352,2,4,"UPyD",1
37,"37130",172,151,150,0,1,"UPyD",0
37,"37255",49,34,34,1,0,"UPyD",0
19,"19138",255,202,201,2,1,"UPyD",0
46,"46062",4631,3511,3474,27,37,"UPyD",5
48,"48014",1211,806,801,7,5,"UPyD",0
26,"26040",70,60,60,0,0,"UPyD",1
49,"49006",154,99,95,0,4,"UPyD",1
18,"18097",960,693,685,5,8,"UPyD",1
31,"31131",901,646,638,7,8,"UPyD",0
46,"46063",1756,1367,1345,15,22,"UPyD",1
40,"40174",349,254,251,2,3,"UPyD",1
4,"4027",250,159,159,0,0,"UPyD",0
10,"10059",364,253,248,1,5,"UPyD",0
6,"6032",68,53,53,1,0,"UPyD",1
3,"3140",26070,18999,18742,174,257,"UPyD",37
9,"9250",269,196,194,1,2,"UPyD",2
26,"26041",132,92,91,0,1,"UPyD",0
14,"14001",3514,2837,2789,28,48,"UPyD",1
30,"30902",7975,5318,5273,24,45,"UPyD",13
39,"39046",1404,1001,973,6,28,"UPyD",4
6,"6048",849,691,677,7,14,"UPyD",0
22,"22044",252,198,197,0,1,"UPyD",1
29,"29063",323,250,245,1,5,"UPyD",1
42,"42173",29281,20286,20035,261,251,"UPyD",52
9,"9444",72,58,58,3,0,"UPyD",0
47,"47065",857,674,669,1,5,"UPyD",3
12,"12094",847,674,665,5,9,"UPyD",2
9,"9179",41,32,32,1,0,"UPyD",0
5,"5242",681,559,558,8,1,"UPyD",1
37,"37216",302,252,248,3,4,"UPyD",0
26,"26020",476,349,339,3,10,"UPyD",0
46,"46168",1938,1495,1486,2,9,"UPyD",5
13,"13018",822,642,640,6,2,"UPyD",1
37,"37273",107,71,71,1,0,"UPyD",0
26,"26112",236,194,190,1,4,"UPyD",0
39,"39038",1452,997,990,8,7,"UPyD",2
34,"34102",205,169,168,1,1,"UPyD",1
23,"23061",7560,5303,5234,29,69,"UPyD",3
22,"22081",254,181,181,0,0,"UPyD",0
37,"37260",150,116,116,1,0,"UPyD",0
50,"50075",80,62,61,1,1,"UPyD",0
37,"37302",290,196,195,2,1,"UPyD",0
19,"19020",44,30,30,1,0,"UPyD",0
19,"19145",46,41,41,1,0,"UPyD",0
9,"9091",724,500,490,4,10,"UPyD",0
20,"20061",4273,2601,2590,21,11,"UPyD",3
24,"24164",370,218,217,0,1,"UPyD",0
24,"24096",117,80,79,1,1,"UPyD",0
45,"45201",3447,2082,2050,9,32,"UPyD",7
45,"45012",661,510,503,6,7,"UPyD",0
42,"42065",21,18,18,0,0,"UPyD",1
10,"10080",366,257,255,1,2,"UPyD",0
12,"12063",41,29,29,1,0,"UPyD",0
22,"22125",38773,27021,26732,258,289,"UPyD",77
9,"9362",208,172,171,2,1,"UPyD",1
22,"22009",617,444,441,6,3,"UPyD",2
19,"19107",294,239,237,0,2,"UPyD",0
10,"10218",1126,803,795,3,8,"UPyD",0
5,"5085",35,27,27,0,0,"UPyD",0
49,"49210",471,370,365,1,5,"UPyD",0
9,"9054",101,68,66,1,2,"UPyD",0
37,"37262",78,64,63,0,1,"UPyD",0
29,"29090",1688,1144,1134,15,10,"UPyD",1
19,"19147",43,33,33,0,0,"UPyD",0
16,"16199",30,25,25,1,0,"UPyD",0
35,"35028",9776,5476,5401,43,75,"UPyD",4
1,"1033",651,484,479,2,5,"UPyD",0
6,"6069",3065,2053,2035,14,18,"UPyD",1
26,"26057",48,38,38,0,0,"UPyD",0
2,"2046",1098,896,878,12,18,"UPyD",1
14,"14070",1332,986,974,10,12,"UPyD",0
5,"5247",241,138,138,1,0,"UPyD",1
12,"12118",72,55,53,0,2,"UPyD",0
42,"42042",45,35,35,0,0,"UPyD",0
4,"4903",4320,2858,2825,19,33,"UPyD",2
2,"2021",1017,784,778,6,6,"UPyD",0
39,"39062",1812,1379,1366,5,13,"UPyD",3
9,"9216",387,270,265,1,5,"UPyD",0
24,"24188",3822,2850,2817,19,33,"UPyD",1
9,"9017",89,68,67,4,1,"UPyD",0
19,"19294",29,27,27,0,0,"UPyD",0
10,"10007",629,459,454,5,5,"UPyD",0
2,"2048",1226,981,975,7,6,"UPyD",0
24,"24201",1090,762,759,10,3,"UPyD",3
16,"16203",9972,7094,7007,34,87,"UPyD",12
28,"28131",12990,9512,9433,38,79,"UPyD",45
10,"10054",547,431,421,1,10,"UPyD",0
36,"36054",10993,7476,7363,67,113,"UPyD",19
16,"16058",103,77,77,0,0,"UPyD",2
10,"10207",504,357,350,6,7,"UPyD",0
37,"37279",750,522,513,4,9,"UPyD",4
29,"29070",40333,25991,25728,214,263,"UPyD",78
50,"50166",255,208,206,2,2,"UPyD",1
47,"47171",407,303,301,6,2,"UPyD",3
50,"50069",73,53,53,1,0,"UPyD",0
3,"3063",26462,18591,18492,91,99,"UPyD",38
3,"3053",7226,5651,5584,32,67,"UPyD",9
12,"12068",48,36,35,1,1,"UPyD",0
20,"20033",868,600,599,1,1,"UPyD",0
24,"24168",460,361,359,0,2,"UPyD",0
9,"9369",436,319,316,1,3,"UPyD",0
9,"9100",59,45,44,0,1,"UPyD",1
2,"2050",98,83,82,0,1,"UPyD",0
9,"9414",189,148,146,0,2,"UPyD",0
19,"19027",138,105,105,1,0,"UPyD",0
12,"12100",1333,1065,1047,10,18,"UPyD",2
50,"50177",308,245,244,4,1,"UPyD",0
48,"48033",217,149,149,0,0,"UPyD",0
19,"19188",51,35,35,0,0,"UPyD",0
45,"45184",200,129,129,0,0,"UPyD",0
5,"5158",367,290,286,6,4,"UPyD",1
46,"46200",1903,1561,1539,3,22,"UPyD",4
9,"9190",86,58,56,0,2,"UPyD",0
9,"9175",127,94,93,2,1,"UPyD",0
47,"47029",57,52,52,0,0,"UPyD",0
22,"22116",1430,1004,994,5,10,"UPyD",2
10,"10149",421,283,280,1,3,"UPyD",1
49,"49260",755,590,586,8,4,"UPyD",1
2,"2051",1676,1177,1162,6,15,"UPyD",14
42,"42184",57,43,43,0,0,"UPyD",0
24,"24102",652,470,467,2,3,"UPyD",0
28,"28037",1559,1177,1166,5,11,"UPyD",0
28,"28163",442,344,339,1,5,"UPyD",0
28,"28038",4952,3730,3688,34,42,"UPyD",12
22,"22016",601,413,411,6,2,"UPyD",0
40,"40214",208,168,168,2,0,"UPyD",0
37,"37256",218,156,152,1,4,"UPyD",0
24,"24206",1700,1253,1240,12,13,"UPyD",0
39,"39055",1086,824,816,6,8,"UPyD",1
45,"45030",478,368,360,2,8,"UPyD",0
5,"5257",132,101,101,0,0,"UPyD",1
37,"37010",939,708,702,0,6,"UPyD",2
12,"12102",522,423,418,1,5,"UPyD",0
28,"28174",1795,1232,1221,7,11,"UPyD",3
10,"10121",7978,5517,5429,35,88,"UPyD",3
21,"21032",1800,1286,1259,10,27,"UPyD",1
6,"6154",2802,1923,1894,23,29,"UPyD",2
41,"41081",29189,20205,20015,196,190,"UPyD",66
42,"42200",81,59,58,2,1,"UPyD",0
9,"9478",41,32,32,1,0,"UPyD",0
31,"31199",146,92,89,3,3,"UPyD",0
16,"16083",52,33,33,0,0,"UPyD",0
40,"40148",238,188,187,2,1,"UPyD",3
10,"10060",967,648,640,2,8,"UPyD",0
20,"20070",1092,748,746,5,2,"UPyD",0
10,"10015",675,483,473,3,10,"UPyD",0
28,"28039",128,98,97,2,1,"UPyD",1
18,"18114",609,424,422,8,2,"UPyD",0
49,"49264",578,383,377,5,6,"UPyD",1
3,"3037",346,282,278,3,4,"UPyD",2
19,"19192",1736,1324,1308,8,16,"UPyD",1
2,"2015",1441,1112,1093,5,19,"UPyD",0
45,"45199",2940,1848,1805,14,43,"UPyD",3
14,"14067",3889,2946,2899,29,47,"UPyD",6
48,"48027",22150,15089,14982,78,107,"UPyD",10
41,"41016",7355,5248,5175,51,73,"UPyD",10
12,"12004",4170,3125,3088,19,37,"UPyD",9
9,"9195",59,36,36,2,0,"UPyD",0
48,"48007",364,240,240,5,0,"UPyD",0
7,"7047",2246,1517,1482,18,35,"UPyD",1
13,"13037",842,661,652,1,9,"UPyD",0
49,"49021",14330,9878,9758,95,120,"UPyD",17
19,"19303",43,35,35,0,0,"UPyD",0
3,"3069",3076,2123,2102,17,21,"UPyD",3
29,"29100",2433,1684,1667,5,17,"UPyD",2
22,"22020",115,86,86,1,0,"UPyD",0
22,"22226",767,570,562,10,8,"UPyD",0
49,"49092",129,90,89,1,1,"UPyD",2
16,"16216",315,268,265,1,3,"UPyD",1
45,"45100",188,150,150,0,0,"UPyD",0
37,"37261",221,163,160,1,3,"UPyD",0
13,"13090",1094,843,828,4,15,"UPyD",1
3,"3070",2051,1455,1437,7,18,"UPyD",4
9,"9109",1056,619,595,8,24,"UPyD",2
9,"9380",78,58,58,0,0,"UPyD",0
45,"45168",62229,47154,46741,285,413,"UPyD",140
18,"18193",14343,9951,9847,93,104,"UPyD",26
28,"28032",4762,3428,3401,19,27,"UPyD",14
23,"23040",1480,1199,1192,2,7,"UPyD",1
39,"39090",756,553,542,0,11,"UPyD",2
24,"24076",1277,956,947,4,9,"UPyD",2
35,"35010",3558,2341,2301,28,40,"UPyD",7
24,"24212",1032,773,760,4,13,"UPyD",2
10,"10020",1604,1185,1169,9,16,"UPyD",1
31,"31015",1994,1412,1392,25,20,"UPyD",0
3,"3040",254,216,213,2,3,"UPyD",0
19,"19305",155,116,115,0,1,"UPyD",1
31,"31248",299,165,162,0,3,"UPyD",1
45,"45002",2564,1681,1665,17,16,"UPyD",2
6,"6039",1840,1469,1437,9,32,"UPyD",0
34,"34171",968,708,703,5,5,"UPyD",5
19,"19333",115,82,82,0,0,"UPyD",0
37,"37166",214,152,151,2,1,"UPyD",0
40,"40081",124,94,92,2,2,"UPyD",0
5,"5233",221,191,191,1,0,"UPyD",0
42,"42207",40,33,32,0,1,"UPyD",0
10,"10159",320,251,250,0,1,"UPyD",0
28,"28100",4196,2987,2955,14,32,"UPyD",34
23,"23041",499,398,394,2,4,"UPyD",0
16,"16027",710,542,538,5,4,"UPyD",0
22,"22228",514,364,360,5,4,"UPyD",0
6,"6041",460,372,367,0,5,"UPyD",0
22,"22023",421,313,309,6,4,"UPyD",0
4,"4022",347,249,249,7,0,"UPyD",0
50,"50058",66,39,39,0,0,"UPyD",0
40,"40195",885,672,669,1,3,"UPyD",7
12,"12077",4605,3439,3382,15,57,"UPyD",7
19,"19041",163,129,129,3,0,"UPyD",1
22,"22175",197,143,142,1,1,"UPyD",0
9,"9139",103,87,85,3,2,"UPyD",2
35,"35004",39299,20523,20294,140,229,"UPyD",33
48,"48092",836,618,613,5,5,"UPyD",1
40,"40099",52,44,42,0,2,"UPyD",0
22,"22901",742,478,470,5,8,"UPyD",0
45,"45138",1091,877,871,4,6,"UPyD",1
39,"39002",3298,2342,2309,13,33,"UPyD",3
29,"29015",31880,22220,21952,190,268,"UPyD",37
46,"46121",105,95,94,0,1,"UPyD",1
46,"46199",5718,4314,4266,28,48,"UPyD",11
49,"49271",194,145,141,1,4,"UPyD",0
37,"37323",516,376,372,5,4,"UPyD",3
12,"12079",399,316,314,2,2,"UPyD",0
9,"9472",55,45,44,0,1,"UPyD",0
46,"46078",28017,20288,20143,132,145,"UPyD",52
48,"48043",4423,3118,3108,17,10,"UPyD",0
31,"31251",3115,2240,2205,15,35,"UPyD",2
49,"49233",93,58,55,0,3,"UPyD",0
45,"45901",771,547,544,3,3,"UPyD",0
42,"42105",50,45,45,0,0,"UPyD",0
2,"2065",476,394,392,1,2,"UPyD",1
2,"2024",3409,2589,2554,29,35,"UPyD",8
35,"35031",7259,5037,4942,29,95,"UPyD",7
49,"49136",318,220,218,1,2,"UPyD",0
42,"42033",48,45,45,1,0,"UPyD",0
40,"40225",1138,883,867,3,16,"UPyD",4
10,"10118",286,251,249,1,2,"UPyD",1
37,"37067",3163,2496,2467,31,29,"UPyD",6
37,"37324",360,276,275,2,1,"UPyD",0
42,"42106",14,10,10,0,0,"UPyD",0
22,"22149",305,228,228,0,0,"UPyD",0
13,"13049",799,540,531,0,9,"UPyD",1
9,"9206",59,45,45,0,0,"UPyD",1
14,"14028",314,253,249,1,4,"UPyD",1
12,"12080",1932,1598,1570,10,28,"UPyD",0
16,"16904",472,378,373,4,5,"UPyD",1
40,"40104",265,198,195,0,3,"UPyD",0
10,"10165",257,208,207,0,1,"UPyD",0
19,"19311",82,69,67,0,2,"UPyD",0
39,"39035",9502,7017,6928,57,89,"UPyD",15
47,"47082",812,640,628,8,12,"UPyD",2
30,"30003",24332,16183,16040,104,143,"UPyD",10
31,"31087",171,128,124,2,4,"UPyD",0
31,"31243",306,224,221,2,3,"UPyD",0
24,"24104",259,169,169,0,0,"UPyD",0
23,"23099",4769,3359,3309,16,50,"UPyD",2
12,"12901",3405,2626,2598,23,28,"UPyD",8
26,"26134",82,68,68,2,0,"UPyD",0
12,"12013",144,121,119,0,2,"UPyD",0
39,"39077",236,173,171,1,2,"UPyD",0
24,"24194",290,212,212,3,0,"UPyD",0
45,"45009",524,344,341,2,3,"UPyD",0
47,"47092",110,87,87,0,0,"UPyD",0
16,"16034",180,146,144,2,2,"UPyD",0
26,"26074",105,86,85,1,1,"UPyD",1
42,"42110",59,45,45,2,0,"UPyD",0
9,"9074",794,575,569,6,6,"UPyD",1
16,"16129",95,81,79,0,2,"UPyD",0
22,"22151",93,64,64,1,0,"UPyD",0
10,"10168",312,213,208,0,5,"UPyD",0
22,"22029",127,100,100,0,0,"UPyD",0
1,"1056",219,136,135,0,1,"UPyD",0
16,"16175",5095,3980,3914,35,66,"UPyD",4
16,"16908",186,152,152,1,0,"UPyD",2
42,"42094",621,444,433,10,11,"UPyD",1
16,"16159",220,159,159,0,0,"UPyD",1
46,"46152",96,68,68,0,0,"UPyD",0
28,"28175",863,670,668,5,2,"UPyD",3
48,"48017",13261,8543,8482,42,61,"UPyD",1
10,"10078",406,321,314,6,7,"UPyD",0
37,"37330",339,248,246,0,2,"UPyD",0
9,"9253",109,94,91,1,3,"UPyD",0
46,"46134",2357,1725,1712,14,13,"UPyD",6
45,"45111",65,50,50,0,0,"UPyD",0
45,"45078",1379,1129,1119,6,10,"UPyD",0
35,"35018",12552,7609,7547,54,62,"UPyD",13
6,"6142",273,205,197,2,8,"UPyD",0
10,"10125",888,635,622,4,13,"UPyD",1
30,"30037",18793,13150,13003,47,147,"UPyD",27
37,"37190",215,171,171,1,0,"UPyD",0
42,"42129",681,503,495,3,8,"UPyD",2
12,"12085",4976,3236,3209,16,27,"UPyD",4
16,"16116",77,68,68,0,0,"UPyD",0
37,"37028",147,116,112,0,4,"UPyD",0
46,"46161",1483,1188,1173,7,15,"UPyD",2
3,"3903",2494,1880,1865,7,15,"UPyD",2
4,"4031",2338,1772,1762,2,10,"UPyD",0
33,"33016",19130,13666,13526,125,140,"UPyD",24
6,"6052",4030,2735,2688,20,47,"UPyD",1
49,"49240",206,162,161,2,1,"UPyD",0
14,"14060",4868,3473,3412,41,61,"UPyD",3
19,"19209",40,29,29,1,0,"UPyD",0
48,"48019",3553,2406,2397,18,9,"UPyD",1
16,"16181",64,52,52,2,0,"UPyD",0
5,"5037",255,173,172,1,1,"UPyD",0
39,"39100",860,633,629,15,4,"UPyD",1
12,"12017",161,130,128,0,2,"UPyD",0
21,"21077",1711,1224,1202,3,22,"UPyD",1
50,"50005",229,189,189,1,0,"UPyD",0
46,"46162",1189,938,929,3,9,"UPyD",1
16,"16040",80,62,62,0,0,"UPyD",0
31,"31159",1107,844,833,6,11,"UPyD",2
24,"24224",616,454,451,4,3,"UPyD",0
45,"45047",2606,1666,1647,6,19,"UPyD",1
6,"6024",1172,905,883,4,22,"UPyD",0
24,"24098",1193,842,831,11,11,"UPyD",1
11,"11030",22775,15157,14958,149,199,"UPyD",61
37,"37207",287,195,193,1,2,"UPyD",1
39,"39101",274,197,192,3,5,"UPyD",1
46,"46024",413,314,313,2,1,"UPyD",0
41,"41008",1059,749,739,10,10,"UPyD",2
34,"34001",34,28,28,2,0,"UPyD",0
46,"46137",270,210,207,4,3,"UPyD",0
26,"26152",33,28,28,1,0,"UPyD",0
46,"46085",11081,7938,7866,46,72,"UPyD",17
19,"19322",31,25,25,0,0,"UPyD",0
47,"47116",416,341,339,0,2,"UPyD",0
24,"24157",2568,1943,1911,22,32,"UPyD",6
37,"37168",439,316,311,0,5,"UPyD",1
42,"42071",171,115,115,3,0,"UPyD",0
49,"49082",359,304,301,6,3,"UPyD",1
2,"2062",408,297,292,0,5,"UPyD",0
49,"49186",261,188,185,0,3,"UPyD",1
21,"21026",266,166,159,3,7,"UPyD",0
12,"12078",325,235,233,0,2,"UPyD",0
16,"16074",37,30,30,1,0,"UPyD",0
46,"46242",333,267,266,0,1,"UPyD",0
48,"48052",1562,1160,1150,4,10,"UPyD",0
24,"24189",5865,3933,3885,31,48,"UPyD",5
1,"1009",1265,849,845,2,4,"UPyD",0
19,"19163",56,41,40,0,1,"UPyD",0
6,"6027",676,561,552,2,9,"UPyD",1
10,"10102",529,411,405,5,6,"UPyD",0
10,"10904",745,507,504,8,3,"UPyD",1
2,"2077",55,47,47,0,0,"UPyD",0
5,"5092",152,125,122,0,3,"UPyD",3
18,"18183",658,438,434,3,4,"UPyD",1
16,"16140",27,16,16,0,0,"UPyD",0
31,"31263",233,138,137,2,1,"UPyD",0
48,"48053",895,666,662,6,4,"UPyD",0
46,"46139",4485,3617,3574,18,43,"UPyD",2
10,"10178",769,565,553,3,12,"UPyD",0
37,"37294",11692,8317,8221,71,96,"UPyD",43
40,"40003",139,107,104,0,3,"UPyD",0
45,"45084",2257,1679,1656,13,23,"UPyD",3
24,"24004",463,350,348,4,2,"UPyD",0
18,"18079",3441,2442,2411,16,31,"UPyD",1
9,"9261",469,332,329,2,3,"UPyD",2
24,"24227",1607,1127,1116,22,11,"UPyD",4
13,"13013",7068,5147,5063,25,84,"UPyD",9
6,"6151",1070,770,766,3,4,"UPyD",3
5,"5238",782,565,563,5,2,"UPyD",1
21,"21002",15478,10597,10507,94,90,"UPyD",25
41,"41101",5928,4209,4173,18,36,"UPyD",5
45,"45085",1500,1011,999,4,12,"UPyD",2
6,"6061",1084,853,837,4,16,"UPyD",0
22,"22042",117,95,92,0,3,"UPyD",1
28,"28115",60892,49705,49510,209,195,"UPyD",192
34,"34053",207,170,169,3,1,"UPyD",1
1,"1901",2354,1592,1571,8,21,"UPyD",1
26,"26157",296,241,237,4,4,"UPyD",1
23,"23019",1536,1196,1174,2,22,"UPyD",12
28,"28125",3002,2180,2163,11,17,"UPyD",5
2,"2040",559,484,483,3,1,"UPyD",0
9,"9297",323,251,250,6,1,"UPyD",1
24,"24217",135,109,108,1,1,"UPyD",0
28,"28106",76907,52773,52265,385,508,"UPyD",201
18,"18158",8358,5096,5031,28,65,"UPyD",7
18,"18127",16635,11440,11332,91,108,"UPyD",31
16,"16048",408,313,312,1,1,"UPyD",0
28,"28020",145,94,94,0,0,"UPyD",1
24,"24017",577,426,418,1,8,"UPyD",1
16,"16005",255,180,178,2,2,"UPyD",0
19,"19046",21588,15689,15515,82,174,"UPyD",66
21,"21005",15523,9038,8913,56,125,"UPyD",11
5,"5193",193,167,164,1,3,"UPyD",0
40,"40006",22,18,18,0,0,"UPyD",0
31,"31233",97,74,74,0,0,"UPyD",0
19,"19288",21,21,20,0,1,"UPyD",0
6,"6155",1874,1218,1202,16,16,"UPyD",2
50,"50042",15,15,15,1,0,"UPyD",0
10,"10092",292,236,235,1,1,"UPyD",0
34,"34903",198,131,131,1,0,"UPyD",0
2,"2082",101,80,80,1,0,"UPyD",0
16,"16098",561,456,454,3,2,"UPyD",1
50,"50263",193,121,121,0,0,"UPyD",0
19,"19218",50,33,33,0,0,"UPyD",0
2,"2029",3282,2467,2445,17,22,"UPyD",6
4,"4041",322,240,238,6,2,"UPyD",0
50,"50106",134,104,104,0,0,"UPyD",0
47,"47175",6564,4781,4728,39,53,"UPyD",26
24,"24095",320,234,232,0,2,"UPyD",1
49,"49128",552,423,414,3,9,"UPyD",3
28,"28003",173,141,141,0,0,"UPyD",0
46,"46254",1000,785,779,6,6,"UPyD",2
22,"22250",353,261,258,4,3,"UPyD",1
31,"31035",59,45,43,0,2,"UPyD",0
22,"22046",728,566,561,5,5,"UPyD",0
5,"5051",179,145,139,1,6,"UPyD",0
9,"9012",89,64,63,0,1,"UPyD",1
16,"16052",547,418,416,2,2,"UPyD",2
19,"19118",11,9,9,0,0,"UPyD",0
47,"47123",466,354,352,4,2,"UPyD",0
9,"9483",211,158,157,0,1,"UPyD",0
19,"19061",57,42,42,0,0,"UPyD",0
24,"24198",592,412,407,2,5,"UPyD",0
50,"50234",243,189,185,6,4,"UPyD",0
19,"19219",13,9,9,0,0,"UPyD",0
40,"40009",49,43,43,0,0,"UPyD",0
22,"22172",556,372,370,6,2,"UPyD",0
3,"3029",245,185,183,1,2,"UPyD",0
42,"42176",29,25,25,0,0,"UPyD",0
4,"4010",576,444,443,3,1,"UPyD",0
41,"41084",2845,2124,2081,9,43,"UPyD",0
12,"12096",777,587,577,6,10,"UPyD",0
9,"9410",3040,2117,2095,16,22,"UPyD",6
46,"46067",1753,1418,1393,1,25,"UPyD",1
22,"22252",121,86,81,0,5,"UPyD",0
18,"18013",4218,3024,2986,15,38,"UPyD",4
5,"5152",678,554,551,3,3,"UPyD",1
31,"31203",40,28,28,0,0,"UPyD",0
41,"41018",9480,6523,6455,53,68,"UPyD",5
9,"9016",85,60,59,3,1,"UPyD",2
30,"30018",7978,5866,5811,30,55,"UPyD",17
33,"33027",834,506,498,4,8,"UPyD",0
22,"22243",45,28,28,0,0,"UPyD",0
45,"45014",4010,2646,2616,22,30,"UPyD",4
13,"13024",898,633,627,3,6,"UPyD",2
6,"6161",302,236,235,1,1,"UPyD",1
4,"4011",2765,2119,2096,21,23,"UPyD",0
47,"47195",459,345,344,4,1,"UPyD",0
45,"45193",613,504,497,1,7,"UPyD",0
48,"48031",332,233,231,1,2,"UPyD",0
37,"37348",115,96,95,0,1,"UPyD",0
19,"19109",39,32,32,0,0,"UPyD",0
40,"40140",92,69,67,0,2,"UPyD",0
10,"10053",287,215,210,1,5,"UPyD",0
34,"34063",83,76,75,1,1,"UPyD",0
26,"26093",53,39,38,0,1,"UPyD",0
48,"48001",5838,3923,3898,28,25,"UPyD",0
12,"12129",1828,1322,1298,11,24,"UPyD",2
10,"10191",527,405,397,2,8,"UPyD",0
3,"3002",3605,2583,2557,15,26,"UPyD",3
19,"19223",111,83,83,3,0,"UPyD",0
9,"9098",507,369,362,5,7,"UPyD",0
19,"19098",19,17,17,0,0,"UPyD",0
47,"47117",301,233,227,2,6,"UPyD",2
19,"19111",155,126,126,1,0,"UPyD",2
9,"9274",1079,848,835,12,13,"UPyD",4
3,"3094",9080,6440,6396,34,44,"UPyD",17
50,"50144",34,29,29,2,0,"UPyD",0
12,"12130",404,340,335,0,5,"UPyD",0
10,"10055",710,505,497,1,8,"UPyD",0
34,"34177",179,149,149,2,0,"UPyD",0
19,"19067",70,52,51,1,1,"UPyD",0
5,"5253",86,70,68,0,2,"UPyD",0
3,"3064",5015,3660,3611,11,49,"UPyD",6
14,"14073",2891,2079,2016,13,63,"UPyD",2
47,"47045",763,575,567,1,8,"UPyD",1
3,"3003",450,378,376,2,2,"UPyD",0
45,"45028",3649,2701,2673,12,28,"UPyD",2
7,"7001",3573,2531,2497,21,34,"UPyD",2
47,"47127",137,98,97,0,1,"UPyD",0
34,"34067",127,93,93,1,0,"UPyD",0
10,"10194",542,415,407,2,8,"UPyD",1
39,"39074",6902,5113,5039,40,74,"UPyD",22
20,"20057",196,122,122,0,0,"UPyD",0
5,"5059",106,82,81,1,1,"UPyD",0
31,"31075",103,63,63,0,0,"UPyD",0
12,"12034",1424,1065,1035,3,30,"UPyD",3
3,"3004",581,438,437,2,1,"UPyD",3
49,"49017",251,180,177,1,3,"UPyD",0
20,"20002",346,203,203,4,0,"UPyD",0
9,"9276",382,251,240,3,11,"UPyD",2
40,"40017",92,75,75,0,0,"UPyD",2
16,"16062",24,23,23,0,0,"UPyD",0
29,"29007",27491,19071,18910,153,161,"UPyD",48
24,"24228",660,430,422,6,8,"UPyD",2
50,"50081",511,382,378,4,4,"UPyD",0
24,"24171",356,197,196,0,1,"UPyD",0
34,"34163",45,38,38,0,0,"UPyD",0
3,"3129",1194,957,938,0,19,"UPyD",6
5,"5010",152,117,116,1,1,"UPyD",0
20,"20069",147046,100691,100232,836,459,"UPyD",204
31,"31175",71,48,48,0,0,"UPyD",0
37,"37102",404,307,305,2,2,"UPyD",4
46,"46236",972,818,809,2,9,"UPyD",0
28,"28048",500,391,387,3,4,"UPyD",0
5,"5144",76,55,54,0,1,"UPyD",0
9,"9235",156,132,131,3,1,"UPyD",0
14,"14066",5856,4150,4095,48,55,"UPyD",4
29,"29030",805,620,614,4,6,"UPyD",2
47,"47191",108,79,79,0,0,"UPyD",0
16,"16193",66,49,48,0,1,"UPyD",0
9,"9148",87,70,68,3,2,"UPyD",0
49,"49138",234,184,184,3,0,"UPyD",0
16,"16212",247,203,202,0,1,"UPyD",1
10,"10152",468,340,332,1,8,"UPyD",0
49,"49101",153,102,99,0,3,"UPyD",0
5,"5013",868,728,721,6,7,"UPyD",0
10,"10153",309,222,218,0,4,"UPyD",0
39,"39088",69,52,52,0,0,"UPyD",0
20,"20005",1260,738,736,11,2,"UPyD",0
31,"31144",796,445,444,6,1,"UPyD",0
9,"9280",28,20,20,0,0,"UPyD",0
37,"37356",87,67,65,0,2,"UPyD",0
14,"14011",578,464,462,4,2,"UPyD",0
18,"18909",579,435,429,0,6,"UPyD",0
1,"1043",2304,1552,1532,13,20,"UPyD",6
2,"2056",1718,1296,1274,6,22,"UPyD",3
31,"31145",172,128,128,4,0,"UPyD",0
36,"36037",2571,1733,1707,11,26,"UPyD",9
49,"49180",148,103,102,2,1,"UPyD",0
26,"26101",44,36,35,0,1,"UPyD",0
9,"9149",35,24,24,2,0,"UPyD",1
47,"47131",170,134,128,2,6,"UPyD",0
6,"6081",1074,806,792,7,14,"UPyD",2
31,"31079",73,54,53,0,1,"UPyD",0
24,"24211",272,205,205,2,0,"UPyD",0
10,"10018",1689,1101,1081,6,20,"UPyD",1
28,"28031",2048,1500,1486,3,14,"UPyD",2
12,"12105",848,644,638,2,6,"UPyD",3
5,"5213",103,84,82,0,2,"UPyD",0
19,"19078",50,44,43,0,1,"UPyD",0
24,"24041",538,367,366,3,1,"UPyD",1
9,"9025",122,83,83,1,0,"UPyD",0
18,"18911",7473,5098,5035,51,63,"UPyD",14
20,"20007",310,218,218,3,0,"UPyD",0
29,"29901",43826,29318,29107,250,211,"UPyD",77
1,"1004",1399,1008,995,8,13,"UPyD",0
40,"40193",229,174,172,3,2,"UPyD",0
31,"31114",366,245,241,8,4,"UPyD",1
50,"50183",331,246,246,3,0,"UPyD",0
2,"2059",302,234,232,1,2,"UPyD",0
9,"9422",17,11,11,0,0,"UPyD",0
18,"18070",288,227,226,0,1,"UPyD",0
5,"5215",164,123,122,2,1,"UPyD",0
37,"37109",183,129,127,0,2,"UPyD",0
36,"36004",10161,6939,6844,63,95,"UPyD",15
1,"1006",175,140,140,0,0,"UPyD",0
45,"45102",3610,2506,2470,14,36,"UPyD",3
16,"16219",89,71,71,0,0,"UPyD",0
31,"31148",92,69,69,5,0,"UPyD",0
28,"28159",589,468,468,5,0,"UPyD",1
14,"14014",2557,2035,2007,9,28,"UPyD",3
40,"40126",79,56,54,0,2,"UPyD",0
29,"29013",1610,1238,1207,9,31,"UPyD",1
31,"31249",1872,1290,1273,14,17,"UPyD",0
9,"9382",33,28,28,0,0,"UPyD",0
34,"34174",200,159,154,5,5,"UPyD",0
49,"49185",157,123,122,2,1,"UPyD",0
37,"37152",418,290,286,2,4,"UPyD",0
26,"26176",53,44,44,1,0,"UPyD",0
36,"36042",17891,12212,12003,93,209,"UPyD",29
5,"5073",297,253,252,2,1,"UPyD",1
3,"3011",7753,5464,5415,27,49,"UPyD",11
29,"29014",217,141,140,4,1,"UPyD",0
47,"47105",183,158,156,0,2,"UPyD",0
10,"10069",838,626,615,2,11,"UPyD",1
48,"48042",1369,1068,1053,7,15,"UPyD",0
34,"34080",5560,3723,3665,32,58,"UPyD",12
37,"37113",433,334,333,3,1,"UPyD",0
40,"40223",216,163,163,1,0,"UPyD",0
9,"9273",52,40,39,2,1,"UPyD",0
31,"31017",358,242,239,0,3,"UPyD",0
13,"13045",674,508,499,1,9,"UPyD",1
20,"20011",1658,1219,1210,7,9,"UPyD",1
47,"47053",119,98,96,0,2,"UPyD",1
9,"9159",60,52,51,2,1,"UPyD",0
10,"10162",575,437,433,2,4,"UPyD",0
37,"37098",333,247,247,1,0,"UPyD",1
45,"45172",689,530,522,2,8,"UPyD",0
10,"10208",123,94,93,1,1,"UPyD",0
1,"1010",2268,1623,1603,11,20,"UPyD",0
21,"21028",375,277,271,2,6,"UPyD",1
49,"49068",462,310,304,4,6,"UPyD",0
42,"42020",4263,2877,2821,35,56,"UPyD",7
50,"50218",113,91,91,1,0,"UPyD",0
39,"39033",568,418,415,2,3,"UPyD",0
3,"3013",1113,839,836,4,3,"UPyD",0
16,"16078",41429,30053,29775,235,278,"UPyD",77
34,"34178",117,103,103,0,0,"UPyD",0
24,"24113",366,293,287,5,6,"UPyD",0
41,"41022",4290,2889,2851,21,38,"UPyD",1
5,"5206",30,22,20,1,2,"UPyD",0
13,"13902",469,367,363,0,4,"UPyD",0
14,"14027",7925,5836,5746,58,90,"UPyD",7
31,"31185",494,341,341,1,0,"UPyD",1
6,"6090",869,617,602,3,15,"UPyD",2
19,"19237",47,38,38,0,0,"UPyD",0
47,"47218",993,743,734,2,9,"UPyD",0
50,"50188",28,25,25,0,0,"UPyD",0
50,"50280",332,253,250,0,3,"UPyD",0
28,"28173",517,390,388,1,2,"UPyD",0
7,"7056",5026,3410,3375,32,35,"UPyD",7
21,"21030",1830,1452,1430,13,22,"UPyD",0
10,"10211",444,337,336,0,1,"UPyD",0
19,"19238",42,28,28,0,0,"UPyD",0
22,"22233",82,57,57,3,0,"UPyD",0
3,"3045",210,176,172,0,4,"UPyD",1
20,"20080",7910,5294,5260,49,34,"UPyD",7
24,"24218",451,330,325,2,5,"UPyD",2
49,"49030",86,69,69,0,0,"UPyD",0
9,"9249",46,33,33,0,0,"UPyD",0
49,"49058",307,237,233,0,4,"UPyD",0
40,"40132",56,37,36,1,1,"UPyD",0
37,"37011",121,91,91,3,0,"UPyD",1
46,"46002",1175,941,932,5,9,"UPyD",2
47,"47139",1040,777,767,6,10,"UPyD",1
2,"2067",1158,858,847,6,11,"UPyD",1
5,"5046",44,38,38,1,0,"UPyD",0
42,"42188",50,39,38,0,1,"UPyD",0
50,"50282",69,54,54,0,0,"UPyD",0
19,"19126",1627,1155,1134,11,21,"UPyD",0
50,"50031",154,93,93,0,0,"UPyD",0
26,"26008",1860,1399,1387,5,12,"UPyD",0
9,"9120",38,32,32,1,0,"UPyD",0
47,"47031",189,145,145,1,0,"UPyD",0
37,"37369",137,95,94,0,1,"UPyD",0
49,"49192",130,110,109,2,1,"UPyD",0
12,"12902",2158,1504,1489,14,15,"UPyD",4
19,"19317",139,110,109,1,1,"UPyD",0
46,"46029",20613,14964,14879,93,85,"UPyD",13
5,"5033",176,144,142,1,2,"UPyD",0
19,"19170",193,135,135,0,0,"UPyD",0
40,"40020",157,118,117,1,1,"UPyD",2
31,"31155",256,169,167,2,2,"UPyD",2
16,"16238",501,428,422,3,6,"UPyD",0
16,"16084",48,38,37,1,1,"UPyD",0
37,"37286",207,152,145,4,7,"UPyD",0
46,"46056",182,167,166,1,1,"UPyD",0
26,"26010",93,80,80,2,0,"UPyD",0
37,"37072",168,140,138,0,2,"UPyD",0
39,"39008",13877,10258,10153,96,105,"UPyD",41
34,"34184",57,46,45,0,1,"UPyD",0
40,"40122",512,395,394,2,1,"UPyD",3
49,"49033",714,508,505,1,3,"UPyD",1
31,"31057",1781,1287,1268,10,19,"UPyD",1
50,"50033",66,49,48,0,1,"UPyD",0
42,"42145",138,108,107,2,1,"UPyD",1
10,"10216",1538,1175,1162,4,13,"UPyD",3
9,"9123",40,35,35,0,0,"UPyD",0
31,"31058",208,148,144,3,4,"UPyD",0
16,"16039",392,261,254,1,7,"UPyD",0
49,"49194",368,218,216,1,2,"UPyD",0
19,"19208",43,30,30,0,0,"UPyD",0
19,"19130",60145,45531,45085,286,446,"UPyD",134
29,"29055",1796,1354,1336,11,18,"UPyD",1
45,"45112",1922,1247,1211,6,36,"UPyD",0
31,"31258",7879,5707,5666,50,41,"UPyD",9
9,"9169",95,78,78,0,0,"UPyD",0
6,"6098",549,385,381,7,4,"UPyD",1
47,"47222",83,64,64,1,0,"UPyD",0
50,"50004",522,390,388,0,2,"UPyD",0
41,"41095",41232,27076,26793,315,283,"UPyD",153
23,"23011",2170,1515,1496,7,19,"UPyD",1
22,"22157",192,129,128,3,1,"UPyD",0
5,"5232",102,84,79,1,5,"UPyD",0
10,"10082",1868,1451,1412,11,39,"UPyD",1
5,"5086",80,67,67,2,0,"UPyD",0
13,"13006",597,456,447,4,9,"UPyD",0
22,"22072",191,136,135,0,1,"UPyD",2
50,"50035",72,54,53,1,1,"UPyD",0
30,"30039",19277,13165,13054,75,111,"UPyD",17
31,"31170",47,42,42,3,0,"UPyD",0
18,"18088",1541,1124,1117,5,7,"UPyD",1
28,"28150",3087,2294,2277,10,17,"UPyD",3
23,"23053",9531,6704,6658,37,46,"UPyD",5
36,"36053",5684,4099,4050,38,49,"UPyD",5
19,"19133",83,72,72,0,0,"UPyD",0
39,"39011",1585,1169,1160,5,9,"UPyD",4
24,"24022",330,230,229,0,1,"UPyD",1
1,"1020",327,237,234,3,3,"UPyD",0
41,"41042",5844,4424,4378,40,46,"UPyD",11
42,"42164",1600,1150,1127,8,23,"UPyD",1
10,"10038",87,68,68,0,0,"UPyD",0
26,"26080",472,391,389,0,2,"UPyD",0
14,"14006",1330,1120,1101,8,19,"UPyD",0
16,"16043",95,73,73,1,0,"UPyD",0
16,"16244",718,593,587,6,6,"UPyD",0
40,"40082",114,84,82,1,2,"UPyD",0
28,"28053",6498,4995,4955,28,40,"UPyD",26
19,"19307",27,23,23,0,0,"UPyD",0
24,"24146",265,210,207,1,3,"UPyD",0
37,"37252",112,79,79,0,0,"UPyD",0
26,"26014",474,327,324,1,3,"UPyD",1
47,"47225",80,63,63,0,0,"UPyD",0
10,"10039",417,291,291,0,0,"UPyD",0
46,"46216",5053,4109,4090,14,19,"UPyD",12
39,"39043",1481,1122,1115,9,7,"UPyD",2
24,"24112",309,228,227,1,1,"UPyD",0
5,"5235",124,111,110,0,1,"UPyD",0
26,"26015",196,158,157,2,1,"UPyD",1
37,"37378",111,77,75,2,2,"UPyD",1
34,"34196",89,68,68,1,0,"UPyD",0
50,"50228",268,210,208,5,2,"UPyD",0
22,"22205",438,322,320,0,2,"UPyD",0
21,"21041",113337,72318,71637,748,681,"UPyD",210
6,"6104",674,491,487,3,4,"UPyD",1
21,"21001",637,462,455,6,7,"UPyD",1
47,"47226",156,123,123,0,0,"UPyD",0
46,"46243",138,115,112,1,3,"UPyD",1
33,"33051",7061,4640,4587,27,53,"UPyD",6
31,"31063",92,75,73,2,2,"UPyD",0
23,"23017",1572,1269,1257,4,12,"UPyD",1
10,"10041",1057,795,781,4,14,"UPyD",0
30,"30042",1922,1504,1491,7,13,"UPyD",0
39,"39044",3849,2765,2732,21,33,"UPyD",4
18,"18141",404,285,282,0,3,"UPyD",0
50,"50229",62,47,47,2,0,"UPyD",0
37,"37297",425,328,322,2,6,"UPyD",1
22,"22077",379,279,273,2,6,"UPyD",0
12,"12058",71,63,62,1,1,"UPyD",0
3,"3085",272,217,213,0,4,"UPyD",1
36,"36058",4994,3292,3243,33,49,"UPyD",6
46,"46036",564,383,378,5,5,"UPyD",0
42,"42034",30,22,22,0,0,"UPyD",0
9,"9176",63,47,46,2,1,"UPyD",1
19,"19286",720,547,543,2,4,"UPyD",2
45,"45052",2948,2321,2295,16,26,"UPyD",7
14,"14037",3318,2374,2320,22,54,"UPyD",2
24,"24060",602,363,361,3,2,"UPyD",0
19,"19017",69,57,57,0,0,"UPyD",0
19,"19250",20,17,17,0,0,"UPyD",0
12,"12048",251,185,182,0,3,"UPyD",0
6,"6077",341,256,249,0,7,"UPyD",0
26,"26110",152,131,129,0,2,"UPyD",0
26,"26086",16,15,15,1,0,"UPyD",0
23,"23059",5837,4387,4310,40,77,"UPyD",6
45,"45120",129,104,104,1,0,"UPyD",0
5,"5226",76,55,54,3,1,"UPyD",0
9,"9164",157,127,126,0,1,"UPyD",1
1,"1902",734,514,502,4,12,"UPyD",0
37,"37257",52,46,46,0,0,"UPyD",1
49,"49206",840,614,604,9,10,"UPyD",1
22,"22208",188,150,145,0,5,"UPyD",0
16,"16049",149,111,110,0,1,"UPyD",0
50,"50138",46,37,37,2,0,"UPyD",0
13,"13017",256,200,197,0,3,"UPyD",0
50,"50262",1170,896,887,15,9,"UPyD",1
40,"40091",119,97,95,1,2,"UPyD",0
29,"29064",503,348,339,8,9,"UPyD",0
16,"16253",337,264,263,2,1,"UPyD",1
47,"47203",62,53,53,1,0,"UPyD",0
34,"34058",189,172,172,2,0,"UPyD",0
45,"45055",1020,821,790,6,31,"UPyD",1
28,"28156",1019,742,738,3,4,"UPyD",5
46,"46038",327,242,242,3,0,"UPyD",0
5,"5243",85,61,60,0,1,"UPyD",0
21,"21007",6225,4080,3999,52,81,"UPyD",3
31,"31200",761,517,508,3,9,"UPyD",0
22,"22080",280,197,194,6,3,"UPyD",0
2,"2043",1239,937,927,3,10,"UPyD",0
16,"16147",64,45,45,0,0,"UPyD",0
13,"13020",4781,3198,3161,31,37,"UPyD",8
6,"6066",1762,1189,1182,2,7,"UPyD",0
22,"22212",79,64,62,0,2,"UPyD",1
40,"40049",49,43,43,0,0,"UPyD",0
4,"4073",330,234,233,2,1,"UPyD",0
14,"14040",3776,2873,2833,32,40,"UPyD",3
1,"1031",1169,882,863,6,19,"UPyD",0
31,"31201",147715,105455,104658,1007,797,"UPyD",203
14,"14012",6173,4364,4291,35,73,"UPyD",1
9,"9135",41,31,31,1,0,"UPyD",0
24,"24165",354,240,238,2,2,"UPyD",0
9,"9446",12,7,7,0,0,"UPyD",0
41,"41050",5150,3817,3777,19,40,"UPyD",9
39,"39049",322,229,229,0,0,"UPyD",0
12,"12126",24464,18533,18331,113,202,"UPyD",61
10,"10049",3819,3031,2950,18,81,"UPyD",1
7,"7035",1524,1078,1055,8,23,"UPyD",1
23,"23026",3586,2620,2585,16,35,"UPyD",1
40,"40052",74,60,60,0,0,"UPyD",0
14,"14013",16796,11830,11616,129,214,"UPyD",20
9,"9317",19,16,16,0,0,"UPyD",0
2,"2005",559,424,416,5,8,"UPyD",0
37,"37137",105,66,66,0,0,"UPyD",0
5,"5198",73,62,62,0,0,"UPyD",0
34,"34061",106,82,82,1,0,"UPyD",0
49,"49011",232,168,165,6,3,"UPyD",0
9,"9448",212,169,165,0,4,"UPyD",1
33,"33057",1593,1063,1049,16,14,"UPyD",2
5,"5246",59,46,44,0,2,"UPyD",0
16,"16102",1205,912,905,12,7,"UPyD",0
47,"47206",92,80,80,0,0,"UPyD",0
39,"39071",397,261,256,1,5,"UPyD",1
14,"14042",18891,14051,13848,190,203,"UPyD",25
16,"16103",261,222,222,0,0,"UPyD",0
18,"18103",757,579,575,4,4,"UPyD",1
19,"19066",55,48,48,0,0,"UPyD",0
37,"37223",110,85,83,0,2,"UPyD",0
19,"19110",56,50,50,0,0,"UPyD",0
45,"45060",173,126,125,1,1,"UPyD",0
3,"3124",460,388,384,3,4,"UPyD",0
47,"47069",124,105,104,1,1,"UPyD",0
28,"28160",8256,6102,6059,31,43,"UPyD",26
42,"42178",115,83,83,0,0,"UPyD",0
2,"2008",1193,857,847,7,10,"UPyD",1
37,"37139",205,169,168,2,1,"UPyD",0
46,"46120",1113,903,875,2,28,"UPyD",1
13,"13026",438,345,343,2,2,"UPyD",0
24,"24002",231,173,172,1,1,"UPyD",0
12,"12067",537,435,427,0,8,"UPyD",0
5,"5056",96,76,76,0,0,"UPyD",0
31,"31128",359,265,263,0,2,"UPyD",0
6,"6117",1424,960,938,4,22,"UPyD",1
50,"50237",101,74,73,1,1,"UPyD",2
6,"6118",192,145,144,1,1,"UPyD",0
48,"48002",7829,5490,5451,44,39,"UPyD",2
41,"41088",509,360,356,0,4,"UPyD",0
19,"19151",1064,744,726,1,18,"UPyD",1
42,"42045",301,206,197,2,9,"UPyD",0
37,"37141",154,122,122,2,0,"UPyD",0
31,"31040",192,139,138,4,1,"UPyD",0
28,"28064",129,106,106,2,0,"UPyD",0
36,"36032",3630,2587,2535,16,52,"UPyD",1
19,"19259",30,25,25,1,0,"UPyD",0
42,"42183",111,82,82,2,0,"UPyD",0
3,"3033",117,96,95,0,1,"UPyD",0
21,"21055",6975,5293,5241,48,52,"UPyD",8
10,"10056",586,457,452,4,5,"UPyD",0
19,"19031",15,9,9,0,0,"UPyD",0
31,"31207",273,182,177,2,5,"UPyD",0
4,"4079",51383,33777,33586,257,191,"UPyD",86
13,"13029",84,71,71,0,0,"UPyD",1
48,"48003",14339,9918,9838,53,80,"UPyD",5
9,"9326",140,112,111,0,1,"UPyD",4
49,"49098",219,167,165,0,2,"UPyD",0
16,"16269",419,336,332,2,4,"UPyD",0
46,"46122",2704,2082,2063,10,19,"UPyD",2
40,"40185",863,646,642,3,4,"UPyD",1
31,"31009",677,507,505,5,2,"UPyD",0
6,"6121",3355,2279,2248,8,31,"UPyD",2
12,"12036",581,426,421,10,5,"UPyD",1
3,"3065",167284,123032,122305,711,727,"UPyD",289
2,"2053",2998,2231,2189,16,42,"UPyD",1
47,"47074",149,117,116,2,1,"UPyD",0
31,"31142",1403,958,949,10,9,"UPyD",0
23,"23071",1715,1290,1278,7,12,"UPyD",2
49,"49261",1537,1048,1033,8,15,"UPyD",1
18,"18064",377,291,290,2,1,"UPyD",0
29,"29040",1977,1290,1278,12,12,"UPyD",4
14,"14047",1672,1187,1178,14,9,"UPyD",0
34,"34114",207,144,144,0,0,"UPyD",0
5,"5079",68,53,53,0,0,"UPyD",0
26,"26158",251,214,210,0,4,"UPyD",0
3,"3066",42121,29655,29419,214,236,"UPyD",70
19,"19033",64,52,50,1,2,"UPyD",1
50,"50083",89,75,75,1,0,"UPyD",0
26,"26122",118,102,102,0,0,"UPyD",0
19,"19018",155,119,118,3,1,"UPyD",0
19,"19034",22,16,16,0,0,"UPyD",0
13,"13086",175,137,134,0,3,"UPyD",0
10,"10107",1031,801,792,3,9,"UPyD",0
12,"12134",141,95,94,0,1,"UPyD",1
46,"46203",3606,2873,2844,9,29,"UPyD",2
16,"16064",684,568,562,4,6,"UPyD",1
16,"16019",214,156,152,0,4,"UPyD",0
48,"48006",290,239,239,2,0,"UPyD",0
7,"7005",6710,4127,4090,25,37,"UPyD",5
37,"37188",181,129,129,3,0,"UPyD",0
35,"35008",6131,4507,4459,34,48,"UPyD",4
4,"4082",297,200,200,0,0,"UPyD",1
21,"21060",11957,7356,7279,88,77,"UPyD",20
31,"31012",793,563,555,6,8,"UPyD",2
40,"40190",53,45,44,0,1,"UPyD",0
9,"9329",121,87,87,1,0,"UPyD",1
13,"13036",799,601,595,2,6,"UPyD",1
40,"40062",60,51,48,0,3,"UPyD",0
22,"22225",2679,1700,1665,17,35,"UPyD",3
16,"16113",3077,2225,2202,10,23,"UPyD",3
6,"6126",2170,1523,1507,1,16,"UPyD",1
9,"9460",176,131,131,1,0,"UPyD",0
18,"18115",2553,1800,1781,17,19,"UPyD",1
4,"4083",1776,1345,1336,6,9,"UPyD",1
10,"10110",2300,1623,1574,11,49,"UPyD",2
47,"47158",889,667,659,8,8,"UPyD",1
50,"50054",58,50,50,0,0,"UPyD",0
45,"45133",2797,2068,2048,13,20,"UPyD",1
3,"3038",355,288,285,3,3,"UPyD",1
36,"36039",15401,10871,10609,71,262,"UPyD",18
31,"31014",275,194,192,4,2,"UPyD",0
47,"47132",45,36,33,1,3,"UPyD",0
46,"46048",3452,2749,2713,14,36,"UPyD",2
19,"19265",122,97,95,2,2,"UPyD",0
50,"50151",636,499,499,0,0,"UPyD",0
18,"18116",2850,2059,2025,20,34,"UPyD",5
34,"34122",83,60,60,0,0,"UPyD",0
37,"37059",124,94,93,1,1,"UPyD",0
47,"47159",822,644,636,1,8,"UPyD",2
47,"47214",1409,1087,1062,7,25,"UPyD",0
5,"5264",61,38,37,2,1,"UPyD",0
5,"5069",73,64,63,0,1,"UPyD",0
42,"42191",185,136,133,0,3,"UPyD",0
37,"37276",143,104,103,1,1,"UPyD",0
5,"5119",32,22,22,0,0,"UPyD",0
41,"41063",2695,1850,1830,13,20,"UPyD",2
12,"12137",36,23,23,0,0,"UPyD",0
19,"19039",61,54,54,1,0,"UPyD",0
13,"13093",4103,2963,2929,21,34,"UPyD",3
24,"24176",316,247,244,1,3,"UPyD",0
31,"31081",338,216,212,4,4,"UPyD",1
49,"49024",672,459,454,5,5,"UPyD",0
37,"37138",203,149,148,2,1,"UPyD",1
28,"28043",5921,3803,3759,18,44,"UPyD",3
31,"31082",617,371,365,10,6,"UPyD",0
47,"47134",165,128,125,1,3,"UPyD",0
16,"16072",146,104,103,2,1,"UPyD",0
5,"5217",56,44,43,0,1,"UPyD",0
40,"40069",83,66,63,0,3,"UPyD",1
37,"37018",107,79,79,0,0,"UPyD",1
13,"13042",920,652,648,2,4,"UPyD",2
22,"22099",483,379,377,4,2,"UPyD",0
41,"41064",5596,3517,3456,55,61,"UPyD",2
9,"9337",117,92,91,0,1,"UPyD",0
10,"10206",215,157,157,3,0,"UPyD",0
6,"6132",855,587,582,3,5,"UPyD",0
47,"47161",3918,3145,3126,12,19,"UPyD",7
24,"24177",476,325,322,3,3,"UPyD",0
9,"9384",295,211,206,0,5,"UPyD",1
24,"24214",656,490,485,3,5,"UPyD",1
18,"18061",1057,812,804,1,8,"UPyD",1
5,"5123",97,73,73,1,0,"UPyD",0
30,"30030",312993,231648,230185,1207,1463,"UPyD",935
28,"28072",5709,4356,4324,22,32,"UPyD",10
37,"37154",140,113,110,3,3,"UPyD",0
13,"13044",2671,1960,1936,13,24,"UPyD",1
28,"28016",79,53,51,0,2,"UPyD",0
4,"4088",2454,1660,1650,15,10,"UPyD",1
23,"23081",1513,1103,1084,10,19,"UPyD",1
16,"16227",113,93,93,0,0,"UPyD",0
34,"34127",93,65,64,1,1,"UPyD",0
31,"31184",62,44,44,3,0,"UPyD",0
28,"28171",4239,2848,2820,19,28,"UPyD",4
26,"26037",128,108,108,2,0,"UPyD",0
41,"41066",1342,945,927,2,18,"UPyD",0
42,"42059",21,15,14,0,1,"UPyD",0
22,"22105",114,78,77,2,1,"UPyD",0
47,"47002",23,21,20,1,1,"UPyD",0
19,"19043",84,72,72,0,0,"UPyD",0
6,"6089",596,469,461,1,8,"UPyD",1
31,"31019",1785,1254,1238,9,16,"UPyD",1
22,"22232",93,71,69,1,2,"UPyD",0
42,"42197",75,58,56,0,2,"UPyD",0
3,"3106",583,480,478,2,2,"UPyD",1
26,"26039",39,35,35,2,0,"UPyD",0
47,"47164",378,313,311,1,2,"UPyD",1
28,"28083",8939,6396,6348,38,48,"UPyD",31
24,"24180",1134,812,800,9,12,"UPyD",3
19,"19166",156,120,119,1,1,"UPyD",1
20,"20046",1223,739,737,5,2,"UPyD",1
29,"29073",1579,1091,1080,7,11,"UPyD",1
5,"5026",195,166,164,2,2,"UPyD",0
31,"31020",449,228,228,3,0,"UPyD",0
14,"14055",18557,12950,12764,178,186,"UPyD",15
19,"19044",304,245,244,0,1,"UPyD",0
5,"5127",643,519,514,3,5,"UPyD",1
19,"19272",72,54,53,1,1,"UPyD",0
33,"33072",1566,1008,994,11,14,"UPyD",1
16,"16234",25,18,18,0,0,"UPyD",0
50,"50061",202,172,172,3,0,"UPyD",0
9,"9343",93,66,65,0,1,"UPyD",0
10,"10212",1684,1233,1203,7,30,"UPyD",3
5,"5113",71,56,56,0,0,"UPyD",0
46,"46123",1829,1407,1388,7,19,"UPyD",1
6,"6002",4322,2819,2762,22,57,"UPyD",6
50,"50902",87,79,79,2,0,"UPyD",1
47,"47083",80,59,54,1,5,"UPyD",3
49,"49236",75,58,58,0,0,"UPyD",0
45,"45175",664,545,543,5,2,"UPyD",0
45,"45076",553,368,364,3,4,"UPyD",0
50,"50062",1829,1304,1290,16,14,"UPyD",2
41,"41069",29138,18991,18683,341,308,"UPyD",50
19,"19277",19,13,13,0,0,"UPyD",0
31,"31121",62,44,43,0,1,"UPyD",0
35,"35017",25676,15038,14716,94,322,"UPyD",32
40,"40202",60,46,46,0,0,"UPyD",0
14,"14057",6136,4713,4631,47,82,"UPyD",2
48,"48910",2909,1950,1937,10,13,"UPyD",2
11,"11025",4398,2899,2848,51,51,"UPyD",7
37,"37119",107,84,82,0,2,"UPyD",0
18,"18176",250,191,189,2,2,"UPyD",0
7,"7018",382,272,269,1,3,"UPyD",0
6,"6140",630,506,499,3,7,"UPyD",0
40,"40203",899,722,715,4,7,"UPyD",1
10,"10079",894,662,648,7,14,"UPyD",1
21,"21074",2649,1755,1733,13,22,"UPyD",2
4,"4093",1882,1216,1204,11,12,"UPyD",3
22,"22067",65,50,50,1,0,"UPyD",0
40,"40162",392,303,302,1,1,"UPyD",2
34,"34134",50,40,40,2,0,"UPyD",1
13,"13054",4944,3729,3678,27,51,"UPyD",12
21,"21075",349,275,270,4,5,"UPyD",0
10,"10215",431,311,308,2,3,"UPyD",0
37,"37121",575,418,413,3,5,"UPyD",0
49,"49116",383,276,269,3,7,"UPyD",0
41,"41072",4054,2965,2933,14,32,"UPyD",1
23,"23090",1312,1041,1018,5,23,"UPyD",1
13,"13003",480,382,380,1,2,"UPyD",1
29,"29076",2153,1390,1360,10,30,"UPyD",0
31,"31257",875,634,625,8,9,"UPyD",1
30,"30006",803,691,685,2,6,"UPyD",0
31,"31025",766,524,518,6,6,"UPyD",1
16,"16910",91,69,69,1,0,"UPyD",0
34,"34237",592,462,452,6,10,"UPyD",0
34,"34135",399,293,289,0,4,"UPyD",1
47,"47007",3769,2765,2736,24,29,"UPyD",7
9,"9485",55,43,42,0,1,"UPyD",0
45,"45146",107,84,83,0,1,"UPyD",0
5,"5230",66,63,62,1,1,"UPyD",0
13,"13056",11362,8288,8198,70,90,"UPyD",31
13,"13057",1147,961,954,1,7,"UPyD",1
45,"45079",369,288,286,3,2,"UPyD",0
24,"24185",474,357,350,3,7,"UPyD",0
24,"24088",1029,791,789,10,2,"UPyD",0
41,"41040",10541,7752,7698,68,54,"UPyD",23
19,"19281",21,15,15,2,0,"UPyD",0
19,"19050",16,15,15,0,0,"UPyD",0
20,"20052",1090,779,776,8,3,"UPyD",1
23,"23093",3226,2302,2273,19,29,"UPyD",1
37,"37165",33,26,25,0,1,"UPyD",0
21,"21078",2726,1793,1768,17,25,"UPyD",1
6,"6009",204,153,153,0,0,"UPyD",0
24,"24156",239,159,158,1,1,"UPyD",0
9,"9902",458,331,327,3,4,"UPyD",0
12,"12087",25,18,18,4,0,"UPyD",0
50,"50067",14119,9909,9819,112,90,"UPyD",19
49,"49242",447,360,357,5,3,"UPyD",0
2,"2033",1892,1505,1474,6,31,"UPyD",5
49,"49119",227,169,168,0,1,"UPyD",0
19,"19282",163,124,123,0,1,"UPyD",0
47,"47061",256,212,211,2,1,"UPyD",1
37,"37167",173,143,140,2,3,"UPyD",0
50,"50165",1814,1287,1264,26,23,"UPyD",2
28,"28151",3142,2235,2199,8,36,"UPyD",10
48,"48021",1336,908,899,1,9,"UPyD",0
24,"24056",2883,2040,2003,11,37,"UPyD",2
47,"47224",87,76,76,0,0,"UPyD",0
14,"14062",1025,806,792,6,14,"UPyD",0
34,"34242",95,71,68,3,3,"UPyD",0
23,"23055",47167,31479,31198,264,281,"UPyD",50
46,"46025",2499,1953,1934,8,19,"UPyD",3
20,"20022",839,473,472,4,1,"UPyD",0
19,"19283",30,25,25,0,0,"UPyD",0
20,"20054",447,286,284,2,2,"UPyD",0
9,"9903",3221,2304,2281,27,23,"UPyD",3
4,"4098",1516,1115,1106,11,9,"UPyD",0
46,"46164",11771,8564,8483,64,81,"UPyD",14
9,"9904",478,374,370,5,4,"UPyD",0
50,"50134",128,91,89,2,2,"UPyD",1
19,"19213",70,62,61,2,1,"UPyD",1
48,"48023",600,455,452,0,3,"UPyD",0
9,"9354",33,29,28,2,1,"UPyD",1
13,"13011",4792,3112,3077,14,35,"UPyD",6
19,"19053",2008,1422,1404,10,18,"UPyD",2
26,"26049",172,125,122,1,3,"UPyD",0
12,"12090",102,86,85,1,1,"UPyD",0
6,"6013",265,212,209,3,3,"UPyD",1
31,"31029",914,638,625,6,13,"UPyD",3
26,"26155",160,132,132,0,0,"UPyD",0
6,"6150",802,602,596,4,6,"UPyD",0
11,"11033",20903,12949,12771,164,178,"UPyD",32
37,"37035",190,150,150,2,0,"UPyD",0
47,"47011",565,461,458,5,3,"UPyD",0
20,"20056",4082,2589,2570,27,19,"UPyD",0
46,"46061",342,274,272,1,2,"UPyD",0
18,"18140",43496,28038,27872,212,166,"UPyD",44
34,"34246",67,53,51,0,2,"UPyD",0
45,"45185",7700,5771,5691,20,80,"UPyD",13
45,"45151",578,417,414,0,3,"UPyD",0
29,"29084",27359,17843,17627,176,216,"UPyD",33
22,"22004",135,81,80,0,1,"UPyD",1
9,"9442",375,279,277,2,2,"UPyD",1
6,"6152",1319,945,932,4,13,"UPyD",1
46,"46140",344,284,279,0,5,"UPyD",0
3,"3055",5164,3695,3647,21,48,"UPyD",4
22,"22247",33,20,20,0,0,"UPyD",0
49,"49205",382,293,291,2,2,"UPyD",0
40,"40088",284,228,224,0,4,"UPyD",0
49,"49247",443,283,279,2,4,"UPyD",1
29,"29085",144,109,108,0,1,"UPyD",0
39,"39076",3476,2594,2559,19,35,"UPyD",10
47,"47091",84,71,71,2,0,"UPyD",0
14,"14056",23581,16120,15958,143,162,"UPyD",14
37,"37284",316,246,238,4,8,"UPyD",1
42,"42125",70,59,59,1,0,"UPyD",0
24,"24162",1683,1257,1246,13,11,"UPyD",5
4,"4006",7022,4792,4749,30,43,"UPyD",7
45,"45187",4062,3277,3233,15,44,"UPyD",5
9,"9358",255,194,190,3,4,"UPyD",0
49,"49248",186,151,150,1,1,"UPyD",0
37,"37173",1504,1129,1114,4,15,"UPyD",5
2,"2041",336,265,260,0,5,"UPyD",0
28,"28094",865,624,622,4,2,"UPyD",3
22,"22007",792,581,581,8,0,"UPyD",2
37,"37258",172,116,115,3,1,"UPyD",0
26,"26052",154,121,117,0,4,"UPyD",0
5,"5145",50,40,40,0,0,"UPyD",0
9,"9088",66,45,45,0,0,"UPyD",1
33,"33054",1682,1159,1149,12,10,"UPyD",1
22,"22122",64,57,57,2,0,"UPyD",0
16,"16006",120,98,96,3,2,"UPyD",0
46,"46194",15567,11156,11044,86,112,"UPyD",22
46,"46116",13159,10193,10135,53,58,"UPyD",14
24,"24196",2057,1502,1485,9,17,"UPyD",2
39,"39078",1401,975,963,5,12,"UPyD",1
42,"42081",145,102,100,1,2,"UPyD",0
4,"4103",1476,1018,1008,3,10,"UPyD",1
33,"33055",1514,1109,1092,5,17,"UPyD",1
41,"41082",3415,2671,2647,16,24,"UPyD",1
18,"18146",965,703,685,9,18,"UPyD",1
40,"40092",118,87,87,1,0,"UPyD",0
21,"21048",305,214,210,4,4,"UPyD",0
24,"24197",763,538,533,1,5,"UPyD",3
10,"10094",234,196,196,1,0,"UPyD",0
46,"46143",4239,3104,3053,14,51,"UPyD",8
10,"10002",364,272,270,0,2,"UPyD",0
14,"14068",538,401,398,10,3,"UPyD",0
23,"23902",2320,1867,1847,4,20,"UPyD",2
5,"5149",106,77,77,1,0,"UPyD",0
26,"26162",121,99,99,1,0,"UPyD",0
46,"46066",1263,1024,1018,9,6,"UPyD",2
23,"23903",3540,2662,2634,13,28,"UPyD",2
40,"40219",587,455,444,5,11,"UPyD",2
16,"16148",573,504,500,4,4,"UPyD",1
10,"10003",569,414,408,1,6,"UPyD",2
31,"31135",106,70,66,2,4,"UPyD",2
29,"29089",3228,2377,2321,10,56,"UPyD",3
46,"46118",3763,2940,2908,16,32,"UPyD",4
45,"45157",2128,1456,1427,13,29,"UPyD",3
50,"50235",2339,1664,1648,11,16,"UPyD",5
39,"39080",3542,2656,2628,20,28,"UPyD",2
22,"22082",291,213,212,1,1,"UPyD",0
24,"24097",218,140,139,3,1,"UPyD",0
37,"37304",169,124,124,0,0,"UPyD",0
9,"9093",154,121,119,0,2,"UPyD",0
47,"47151",27,24,24,0,0,"UPyD",0
34,"34155",129,104,103,2,1,"UPyD",0
18,"18056",3530,2641,2614,24,27,"UPyD",3
23,"23905",1868,1277,1272,6,5,"UPyD",0
19,"19184",71,50,48,0,2,"UPyD",0
20,"20063",8017,5263,5231,35,32,"UPyD",8
48,"48030",606,441,439,1,2,"UPyD",0
28,"28005",134246,99236,98481,583,755,"UPyD",437
50,"50077",221,168,167,1,1,"UPyD",0
12,"12097",63,49,49,0,0,"UPyD",1
18,"18014",6581,4584,4545,37,39,"UPyD",16
13,"13076",484,400,394,1,6,"UPyD",0
28,"28034",361,274,269,1,5,"UPyD",0
47,"47178",172,140,140,3,0,"UPyD",0
34,"34108",542,421,417,3,4,"UPyD",0
49,"49256",256,204,204,0,0,"UPyD",0
13,"13077",3489,2205,2152,18,53,"UPyD",0
18,"18150",6763,4733,4678,21,55,"UPyD",9
19,"19065",127,104,104,3,0,"UPyD",0
45,"45092",232,197,191,0,6,"UPyD",0
11,"11042",1186,868,858,7,10,"UPyD",1
1,"1034",161,124,123,1,1,"UPyD",0
50,"50047",48,36,36,0,0,"UPyD",0
5,"5200",44,31,30,1,1,"UPyD",0
47,"47126",50,41,41,0,0,"UPyD",0
41,"41087",10237,6923,6774,48,149,"UPyD",18
9,"9366",86,62,62,2,0,"UPyD",1
46,"46043",136,124,124,0,0,"UPyD",0
14,"14072",1048,806,795,6,11,"UPyD",1
31,"31139",159,96,95,0,1,"UPyD",0
16,"16153",949,778,772,7,6,"UPyD",1
22,"22129",183,120,118,1,2,"UPyD",0
10,"10101",185,145,141,1,4,"UPyD",1
19,"19297",32,24,24,1,0,"UPyD",0
24,"24003",648,460,453,7,7,"UPyD",2
26,"26059",1125,828,812,5,16,"UPyD",2
28,"28102",894,644,636,6,8,"UPyD",1
26,"26130",203,167,167,1,0,"UPyD",0
18,"18107",943,663,655,1,8,"UPyD",0
16,"16014",602,485,483,0,2,"UPyD",0
42,"42087",49,43,42,0,1,"UPyD",0
6,"6028",4233,3588,3499,30,89,"UPyD",6
28,"28036",2539,1899,1878,11,21,"UPyD",10
50,"50080",33,27,27,0,0,"UPyD",0
47,"47019",85,74,73,0,1,"UPyD",0
31,"31241",133,98,98,2,0,"UPyD",0
5,"5005",182,148,147,3,1,"UPyD",1
34,"34160",139,115,114,3,1,"UPyD",0
37,"37184",327,255,252,2,3,"UPyD",2
19,"19070",74,53,53,0,0,"UPyD",0
41,"41089",6493,4398,4331,43,67,"UPyD",9
4,"4014",144,117,114,1,3,"UPyD",0
5,"5007",111,81,80,3,1,"UPyD",0
13,"13082",25805,16871,16706,120,165,"UPyD",56
31,"31042",2714,1974,1942,22,32,"UPyD",1
42,"42089",54,44,44,0,0,"UPyD",0
16,"16016",224,171,168,0,3,"UPyD",0
22,"22903",652,514,507,1,7,"UPyD",0
16,"16270",162,137,137,0,0,"UPyD",1
24,"24037",360,254,250,2,4,"UPyD",0
5,"5008",227,170,168,1,2,"UPyD",0
9,"9373",425,287,285,2,2,"UPyD",0
34,"34024",31,21,21,1,0,"UPyD",0
19,"19299",97,79,77,1,2,"UPyD",0
21,"21057",1041,661,657,12,4,"UPyD",1
48,"48096",6577,4794,4728,31,66,"UPyD",4
19,"19262",135,100,100,0,0,"UPyD",0
22,"22133",115,81,80,1,1,"UPyD",0
7,"7002",6341,4295,4255,39,40,"UPyD",7
3,"3056",8676,6638,6541,34,97,"UPyD",11
19,"19191",14,13,12,0,1,"UPyD",0
34,"34165",66,58,58,1,0,"UPyD",0
12,"12002",110,99,98,1,1,"UPyD",0
24,"24172",418,255,250,2,5,"UPyD",0
33,"33002",9995,6765,6672,47,93,"UPyD",3
37,"37271",368,297,296,0,1,"UPyD",2
1,"1042",904,653,648,6,5,"UPyD",0
50,"50052",90,68,68,0,0,"UPyD",0
26,"26171",176,139,133,1,6,"UPyD",0
19,"19155",66,56,56,0,0,"UPyD",2
7,"7004",3854,2574,2547,30,27,"UPyD",7
45,"45198",1809,1475,1442,7,33,"UPyD",1
16,"16273",321,242,236,3,6,"UPyD",0
22,"22135",189,128,127,0,1,"UPyD",0
50,"50149",34,24,24,0,0,"UPyD",0
42,"42051",20,14,14,1,0,"UPyD",0
13,"13087",23137,15677,15480,133,197,"UPyD",52
28,"28107",457,312,312,0,0,"UPyD",1
6,"6033",1327,1011,1006,10,5,"UPyD",0
24,"24007",773,550,548,4,2,"UPyD",0
50,"50181",993,733,720,5,13,"UPyD",2
50,"50084",77,59,59,2,0,"UPyD",0
37,"37315",96,70,70,0,0,"UPyD",0
36,"36001",2564,1858,1848,5,10,"UPyD",4
20,"20071",14801,9466,9421,60,45,"UPyD",6
45,"45099",3500,2390,2361,9,29,"UPyD",0
13,"13089",1706,1368,1332,8,36,"UPyD",2
18,"18024",855,665,654,7,11,"UPyD",1
16,"16022",78,67,66,0,1,"UPyD",0
9,"9105",109,86,81,1,5,"UPyD",0
42,"42095",1773,1269,1251,15,18,"UPyD",2
28,"28108",3374,2482,2465,10,17,"UPyD",7
10,"10155",1126,773,763,5,10,"UPyD",1
34,"34169",404,287,286,0,1,"UPyD",0
39,"39089",143,104,100,1,4,"UPyD",0
26,"26173",6,6,6,1,0,"UPyD",0
40,"40234",397,298,292,2,6,"UPyD",0
50,"50182",3399,2364,2335,21,29,"UPyD",7
1,"1003",1190,782,774,2,8,"UPyD",1
31,"31046",57,39,39,1,0,"UPyD",0
9,"9378",31,24,23,0,1,"UPyD",0
37,"37317",304,238,234,1,4,"UPyD",0
49,"49022",288,229,225,3,4,"UPyD",0
22,"22095",72,58,58,1,0,"UPyD",0
12,"12006",172,135,133,0,2,"UPyD",0
7,"7008",5692,3956,3913,26,43,"UPyD",3
29,"29067",424813,286785,284689,2351,2096,"UPyD",858
31,"31247",151,114,113,0,1,"UPyD",0
42,"42054",19,16,16,0,0,"UPyD",0
31,"31147",100,82,82,2,0,"UPyD",0
37,"37191",114,78,75,1,3,"UPyD",0
12,"12107",355,303,299,4,4,"UPyD",0
48,"48040",1281,877,869,3,8,"UPyD",0
16,"16277",113,84,83,1,1,"UPyD",0
37,"37319",114,78,74,0,4,"UPyD",0
19,"19079",8,8,7,0,1,"UPyD",0
47,"47104",2836,2182,2121,19,61,"UPyD",1
22,"22141",117,91,90,1,1,"UPyD",0
49,"49064",515,346,338,6,8,"UPyD",0
50,"50087",26,17,17,1,0,"UPyD",0
50,"50184",115,85,85,0,0,"UPyD",0
16,"16119",169,127,127,0,0,"UPyD",1
9,"9381",30,24,24,1,0,"UPyD",0
18,"18120",264,209,208,1,1,"UPyD",0
19,"19306",25,20,20,1,0,"UPyD",0
12,"12108",456,378,371,2,7,"UPyD",1
34,"34034",123,95,95,1,0,"UPyD",0
6,"6040",1009,648,645,1,3,"UPyD",1
48,"48041",693,533,529,3,4,"UPyD",1
19,"19080",65,41,41,0,0,"UPyD",0
47,"47026",46,40,40,1,0,"UPyD",0
39,"39092",894,626,620,1,6,"UPyD",2
45,"45071",1835,1426,1408,5,18,"UPyD",0
5,"5170",50,43,43,0,0,"UPyD",0
19,"19197",27,22,22,0,0,"UPyD",0
22,"22142",97,75,74,1,1,"UPyD",0
26,"26036",16986,11940,11816,66,124,"UPyD",29
31,"31183",691,544,542,4,2,"UPyD",0
20,"20044",367,236,236,0,0,"UPyD",0
22,"22143",217,143,141,1,2,"UPyD",1
9,"9200",50,32,31,0,1,"UPyD",0
37,"37155",65,57,57,0,0,"UPyD",0
12,"12009",17445,12088,11999,75,89,"UPyD",28
50,"50089",8225,6074,6043,43,31,"UPyD",16
22,"22024",226,174,171,3,3,"UPyD",0
19,"19308",56,53,53,0,0,"UPyD",0
49,"49148",260,137,134,1,3,"UPyD",0
28,"28082",5683,4324,4286,25,38,"UPyD",16
5,"5023",168,146,145,1,1,"UPyD",0
50,"50248",508,387,374,2,13,"UPyD",1
5,"5172",123,93,93,1,0,"UPyD",0
10,"10025",400,327,318,1,9,"UPyD",2
23,"23003",8688,6326,6257,52,69,"UPyD",7
10,"10024",695,525,520,3,5,"UPyD",2
24,"24014",7425,5124,5053,32,71,"UPyD",9
30,"30001",4582,3620,3594,18,26,"UPyD",7
37,"37065",312,223,222,3,1,"UPyD",0
24,"24080",213,164,161,3,3,"UPyD",0
48,"48044",62774,45594,45399,287,195,"UPyD",65
47,"47081",45,36,35,1,1,"UPyD",0
30,"30002",9903,7011,6943,28,68,"UPyD",18
28,"28046",4460,3447,3422,16,25,"UPyD",19
5,"5025",94,79,78,0,1,"UPyD",0
31,"31252",87,61,61,0,0,"UPyD",0
39,"39095",2266,1760,1726,14,34,"UPyD",1
9,"9247",24,21,21,1,0,"UPyD",0
10,"10164",737,484,475,3,9,"UPyD",0
47,"47190",98,80,80,1,0,"UPyD",1
39,"39004",1518,1090,1074,4,16,"UPyD",2
16,"16903",1070,777,765,4,12,"UPyD",0
3,"3075",147,128,128,0,0,"UPyD",0
19,"19201",58,49,48,1,1,"UPyD",0
23,"23005",30465,20878,20630,177,248,"UPyD",19
37,"37199",142,105,105,1,0,"UPyD",2
18,"18035",1232,992,988,6,4,"UPyD",1
47,"47003",227,180,179,3,1,"UPyD",0
16,"16033",1714,1319,1305,6,14,"UPyD",2
10,"10028",90,73,73,0,0,"UPyD",0
19,"19274",902,660,651,7,9,"UPyD",0
5,"5161",579,459,447,3,12,"UPyD",0
10,"10166",308,206,204,0,2,"UPyD",0
37,"37069",968,695,689,7,6,"UPyD",1
42,"42023",63,51,51,0,0,"UPyD",0
39,"39096",690,487,479,4,8,"UPyD",2
49,"49275",52210,36205,35754,356,451,"UPyD",126
31,"31254",1915,1428,1411,3,17,"UPyD",0
47,"47030",993,766,751,6,15,"UPyD",0
39,"39097",697,371,368,2,3,"UPyD",0
16,"16174",185,145,143,0,2,"UPyD",1
4,"4028",221,191,190,1,1,"UPyD",0
16,"16173",205,157,156,0,1,"UPyD",0
29,"29019",878,652,636,3,16,"UPyD",0
10,"10030",465,309,309,1,0,"UPyD",0
5,"5030",45,38,38,1,0,"UPyD",0
34,"34181",448,322,319,7,3,"UPyD",0
30,"30005",29526,20713,20526,121,187,"UPyD",67
37,"37329",42,34,34,0,0,"UPyD",0
37,"37245",346,261,259,2,2,"UPyD",0
50,"50191",470,310,308,1,2,"UPyD",0
6,"6141",1719,1201,1189,8,12,"UPyD",2
19,"19278",28,26,26,0,0,"UPyD",0
41,"41004",56640,37110,36649,440,461,"UPyD",171
9,"9251",375,277,274,4,3,"UPyD",1
20,"20050",266,170,169,1,1,"UPyD",0
31,"31023",6956,5310,5289,85,21,"UPyD",9
23,"23009",12861,9649,9543,72,106,"UPyD",13
12,"12115",219,179,177,0,2,"UPyD",0
9,"9122",94,67,66,1,1,"UPyD",0
50,"50064",437,342,339,0,3,"UPyD",0
16,"16131",130,100,97,2,3,"UPyD",0
12,"12015",93,81,78,0,3,"UPyD",0
29,"29021",161,108,107,4,1,"UPyD",1
50,"50254",180,118,116,1,2,"UPyD",0
13,"13055",665,487,484,2,3,"UPyD",2
23,"23010",14347,9669,9560,86,109,"UPyD",10
19,"19091",26,20,20,0,0,"UPyD",0
41,"41094",6288,4497,4449,38,48,"UPyD",4
36,"36014",1942,1459,1444,9,15,"UPyD",2
40,"40123",147,114,106,0,8,"UPyD",0
3,"3049",12088,9121,9027,52,94,"UPyD",5
24,"24118",126,88,88,1,0,"UPyD",0
7,"7021",230,177,174,2,3,"UPyD",0
28,"28051",1541,1163,1149,1,14,"UPyD",3
46,"46005",22918,16958,16827,102,131,"UPyD",28
2,"2032",276,207,202,1,5,"UPyD",0
19,"19092",409,306,300,1,6,"UPyD",0
5,"5036",123,101,101,1,0,"UPyD",1
14,"14004",2034,1531,1518,14,13,"UPyD",2
29,"29023",2081,1354,1340,4,14,"UPyD",3
49,"49156",237,184,175,0,9,"UPyD",1
50,"50096",39,27,27,0,0,"UPyD",0
9,"9394",715,533,521,3,12,"UPyD",0
9,"9124",1506,1040,1028,6,12,"UPyD",6
24,"24223",2610,1917,1908,39,9,"UPyD",3
47,"47033",196,154,154,1,0,"UPyD",1
46,"46240",210,164,161,1,3,"UPyD",0
20,"20905",145,100,100,1,0,"UPyD",0
4,"4032",5586,3642,3623,23,19,"UPyD",3
34,"34048",73,59,59,1,0,"UPyD",0
31,"31259",484,291,286,2,5,"UPyD",0
2,"2074",5935,4193,4139,32,54,"UPyD",10
5,"5038",115,83,81,0,2,"UPyD",0
31,"31260",1238,794,788,12,6,"UPyD",1
31,"31060",13744,9400,9320,72,80,"UPyD",16
5,"5184",246,183,183,0,0,"UPyD",0
16,"16041",358,275,271,0,4,"UPyD",0
42,"42117",140,101,99,0,2,"UPyD",0
16,"16135",134,92,92,2,0,"UPyD",0
50,"50006",925,674,657,6,17,"UPyD",0
16,"16187",74,55,55,1,0,"UPyD",0
41,"41009",1222,812,805,3,7,"UPyD",3
12,"12018",287,246,242,1,4,"UPyD",1
46,"46007",11989,8784,8711,67,73,"UPyD",18
11,"11031",76455,49854,49405,535,449,"UPyD",160
50,"50288",3387,2415,2398,31,17,"UPyD",3
19,"19052",25,21,21,1,0,"UPyD",0
9,"9352",114,92,92,1,0,"UPyD",1
40,"40083",77,59,59,0,0,"UPyD",0
46,"46138",343,275,272,1,3,"UPyD",0
48,"48082",37605,25134,24938,176,196,"UPyD",27
29,"29026",1057,751,748,5,3,"UPyD",0
30,"30010",6869,5194,5142,21,52,"UPyD",6
42,"42119",158,100,99,3,1,"UPyD",1
9,"9217",351,251,249,6,2,"UPyD",1
2,"2036",95,78,78,0,0,"UPyD",0
14,"14063",1046,734,725,2,9,"UPyD",0
24,"24090",343,235,233,1,2,"UPyD",0
16,"16044",39,30,30,0,0,"UPyD",0
10,"10040",441,313,307,4,6,"UPyD",0
49,"49162",186,142,140,1,2,"UPyD",0
6,"6058",2026,1433,1416,9,17,"UPyD",4
24,"24226",199,139,137,0,2,"UPyD",0
3,"3084",539,454,446,3,8,"UPyD",0
9,"9129",104,83,83,0,0,"UPyD",0
40,"40002",36,32,32,0,0,"UPyD",0
6,"6059",1851,1268,1258,7,10,"UPyD",1
50,"50008",5097,3457,3417,31,40,"UPyD",7
2,"2078",920,675,664,1,11,"UPyD",0
46,"46165",7129,5436,5388,25,48,"UPyD",16
39,"39013",511,402,399,4,3,"UPyD",0
5,"5189",449,351,349,2,2,"UPyD",0
37,"37082",796,551,544,4,7,"UPyD",4
28,"28123",57078,45270,44992,215,278,"UPyD",180
1,"1023",267,187,186,1,1,"UPyD",0
50,"50009",105,80,80,0,0,"UPyD",0
42,"42076",216,179,174,5,5,"UPyD",0
18,"18185",541,434,432,2,2,"UPyD",0
4,"4036",226,175,175,0,0,"UPyD",1
37,"37212",104,78,74,0,4,"UPyD",1
30,"30013",7396,5147,5102,32,45,"UPyD",15
21,"21003",690,471,458,6,13,"UPyD",0
19,"19215",168,144,140,0,4,"UPyD",1
46,"46088",166,125,125,4,0,"UPyD",0
19,"19326",1841,1280,1272,1,8,"UPyD",14
22,"22165",487,364,360,6,4,"UPyD",0
26,"26084",6696,5012,4955,35,57,"UPyD",13
18,"18048",2387,1683,1662,8,21,"UPyD",2
10,"10043",800,562,553,3,9,"UPyD",0
47,"47119",92,80,79,1,1,"UPyD",0
37,"37327",185,149,146,3,3,"UPyD",0
31,"31066",855,589,579,8,10,"UPyD",2
31,"31232",25155,17648,17450,196,198,"UPyD",52
50,"50072",170,125,125,0,0,"UPyD",1
5,"5192",101,82,79,2,3,"UPyD",1
12,"12025",136,104,104,0,0,"UPyD",0
50,"50010",68,58,58,0,0,"UPyD",0
34,"34202",29,18,18,1,0,"UPyD",0
24,"24229",418,322,319,2,3,"UPyD",2
37,"37086",101,72,71,1,1,"UPyD",0
22,"22043",93,66,65,0,1,"UPyD",0
1,"1028",1070,716,710,3,6,"UPyD",0
37,"37342",259,189,186,0,3,"UPyD",0
9,"9010",32,23,23,1,0,"UPyD",0
39,"39016",23868,17883,17701,122,182,"UPyD",58
5,"5047",4163,3198,3142,17,56,"UPyD",2
35,"35025",1797,1261,1245,4,16,"UPyD",3
46,"46246",1058,835,823,5,12,"UPyD",0
12,"12026",881,678,663,13,15,"UPyD",1
10,"10046",203,168,168,1,0,"UPyD",0
2,"2042",837,618,611,1,7,"UPyD",0
5,"5048",118,104,104,0,0,"UPyD",0
18,"18189",776,581,574,4,7,"UPyD",1
31,"31902",4405,3092,3061,25,31,"UPyD",4
41,"41902",4659,2679,2646,23,33,"UPyD",4
6,"6065",311,236,228,1,8,"UPyD",0
19,"19106",89,59,59,0,0,"UPyD",0
39,"39018",4220,3264,3204,35,60,"UPyD",10
10,"10185",571,409,405,2,4,"UPyD",2
4,"4008",505,423,417,5,6,"UPyD",0
31,"31068",2885,2060,2027,20,33,"UPyD",9
34,"34152",125,96,92,1,4,"UPyD",0
34,"34206",866,661,654,4,7,"UPyD",2
45,"45022",391,285,281,3,4,"UPyD",0
18,"18192",1538,1151,1123,6,28,"UPyD",1
18,"18053",1630,1082,1076,8,6,"UPyD",0
28,"28059",4323,3171,3157,11,14,"UPyD",14
34,"34059",426,347,342,6,5,"UPyD",0
46,"46013",17383,13569,13483,82,86,"UPyD",30
46,"46092",276,192,189,0,3,"UPyD",0
9,"9409",111,86,86,4,0,"UPyD",0
5,"5196",50,37,36,0,1,"UPyD",0
3,"3091",252,217,215,2,2,"UPyD",0
40,"40136",112,88,87,0,1,"UPyD",0
50,"50203",1040,748,739,7,9,"UPyD",0
50,"50295",48,43,42,0,1,"UPyD",0
26,"26091",161,146,146,0,0,"UPyD",0
23,"23904",2796,1825,1798,8,27,"UPyD",3
45,"45123",3081,2144,2131,11,13,"UPyD",3
42,"42083",26,20,20,0,0,"UPyD",1
2,"2086",2586,1701,1687,7,14,"UPyD",0
9,"9136",192,142,137,2,5,"UPyD",1
48,"48060",3634,2143,2134,7,9,"UPyD",1
34,"34017",918,744,736,9,8,"UPyD",2
10,"10188",499,382,374,4,8,"UPyD",0
49,"49130",180,143,141,5,2,"UPyD",0
24,"24131",724,511,507,3,4,"UPyD",2
9,"9014",195,115,114,1,1,"UPyD",0
31,"31169",2193,1472,1445,9,27,"UPyD",0
10,"10189",2630,1880,1851,4,29,"UPyD",1
39,"39020",23592,15594,15384,128,210,"UPyD",41
40,"40012",269,192,191,2,1,"UPyD",0
12,"12127",75,55,55,0,0,"UPyD",0
45,"45024",1062,793,785,4,8,"UPyD",2
18,"18901",511,356,355,3,1,"UPyD",0
22,"22253",61,52,52,0,0,"UPyD",0
41,"41019",4691,3089,3056,27,33,"UPyD",2
34,"34157",2442,1792,1768,21,24,"UPyD",1
5,"5055",568,456,451,4,5,"UPyD",0
31,"31906",2562,1800,1779,26,21,"UPyD",4
42,"42004",2285,1757,1737,15,20,"UPyD",9
7,"7037",3197,1934,1917,26,17,"UPyD",1
19,"19334",35,31,31,0,0,"UPyD",0
45,"45126",260,176,175,3,1,"UPyD",0
29,"29036",632,423,416,2,7,"UPyD",0
40,"40141",842,593,584,10,9,"UPyD",2
39,"39052",18236,13537,13380,110,157,"UPyD",57
31,"31204",36,28,28,1,0,"UPyD",0
42,"42006",163,109,107,2,2,"UPyD",0
50,"50017",1773,1276,1269,13,7,"UPyD",2
13,"13079",12244,8582,8450,72,132,"UPyD",16
50,"50111",180,143,143,0,0,"UPyD",0
33,"33029",350,181,174,2,7,"UPyD",0
7,"7039",4839,3136,3060,31,76,"UPyD",6
47,"47044",331,293,290,2,3,"UPyD",1
12,"12032",23525,17093,16966,104,127,"UPyD",36
31,"31073",294,212,208,2,4,"UPyD",0
49,"49054",894,617,601,13,16,"UPyD",0
26,"26094",83,70,70,0,0,"UPyD",0
26,"26167",59,47,46,1,1,"UPyD",0
24,"24203",95,69,68,0,1,"UPyD",0
42,"42135",72,52,52,1,0,"UPyD",0
10,"10193",1412,1090,1078,6,12,"UPyD",1
34,"34215",164,141,140,1,1,"UPyD",0
46,"46174",972,764,752,2,12,"UPyD",0
50,"50207",106,93,93,1,0,"UPyD",0
1,"1037",587,411,408,1,3,"UPyD",0
9,"9019",150,92,90,0,2,"UPyD",0
46,"46096",274,209,209,1,0,"UPyD",2
12,"12131",63,52,52,0,0,"UPyD",0
31,"31074",387,286,286,5,0,"UPyD",0
24,"24036",288,184,184,2,0,"UPyD",0
16,"16205",115,88,87,0,1,"UPyD",0
31,"31174",110,63,63,0,0,"UPyD",0
41,"41023",7905,5402,5347,41,55,"UPyD",11
45,"45129",131,92,92,0,0,"UPyD",0
46,"46097",963,733,728,4,5,"UPyD",1
37,"37228",360,297,295,2,2,"UPyD",0
37,"37100",80,61,61,1,0,"UPyD",0
16,"16206",204,158,157,6,1,"UPyD",0
39,"39024",1879,1390,1372,2,18,"UPyD",2
42,"42090",91,69,67,1,2,"UPyD",0
19,"19113",485,366,366,3,0,"UPyD",0
40,"40145",1103,879,870,2,9,"UPyD",1
12,"12132",480,396,389,3,7,"UPyD",0
33,"33001",1588,887,880,8,7,"UPyD",2
49,"49018",329,261,256,2,5,"UPyD",0
22,"22904",815,579,575,8,4,"UPyD",1
34,"34217",1207,937,923,8,14,"UPyD",1
40,"40018",91,72,72,1,0,"UPyD",0
20,"20036",13210,8518,8475,67,43,"UPyD",6
19,"19114",37,26,26,0,0,"UPyD",0
9,"9144",53,40,40,0,0,"UPyD",0
13,"13085",2342,1921,1855,10,66,"UPyD",1
2,"2054",386,291,290,0,1,"UPyD",0
14,"14075",572,448,428,1,20,"UPyD",1
47,"47129",871,664,659,4,5,"UPyD",3
46,"46261",1725,1356,1337,5,19,"UPyD",2
31,"31110",91,61,58,1,3,"UPyD",0
16,"16158",535,416,413,5,3,"UPyD",0
45,"45031",2723,1835,1822,12,13,"UPyD",0
42,"42012",35,28,28,0,0,"UPyD",0
34,"34167",113,94,94,0,0,"UPyD",0
42,"42142",50,35,35,1,0,"UPyD",1
37,"37314",82,65,65,0,0,"UPyD",0
31,"31244",158,87,86,1,1,"UPyD",1
7,"7045",1295,947,936,5,11,"UPyD",0
6,"6079",652,449,442,4,7,"UPyD",0
30,"30025",4908,3667,3630,16,37,"UPyD",8
37,"37232",390,341,339,1,2,"UPyD",1
10,"10061",1628,1055,1035,8,20,"UPyD",2
23,"23037",502,404,400,6,4,"UPyD",0
50,"50117",126,104,103,1,1,"UPyD",0
9,"9418",82,62,61,1,1,"UPyD",0
21,"21020",365,223,222,1,1,"UPyD",0
45,"45032",436,283,275,1,8,"UPyD",0
34,"34072",152,136,135,2,1,"UPyD",0
47,"47212",380,323,322,2,1,"UPyD",0
22,"22182",250,161,158,1,3,"UPyD",0
12,"12039",833,717,710,4,7,"UPyD",1
37,"37106",258,165,162,0,3,"UPyD",0
37,"37107",10764,7379,7264,56,115,"UPyD",18
29,"29043",2509,1608,1576,18,32,"UPyD",0
37,"37358",159,135,133,0,2,"UPyD",0
36,"36038",66390,47750,47273,449,477,"UPyD",107
42,"42014",64,43,43,1,0,"UPyD",0
20,"20006",259,143,143,3,0,"UPyD",0
9,"9283",44,32,31,0,1,"UPyD",0
1,"1044",236,169,167,0,2,"UPyD",1
12,"12040",117608,85588,84946,496,642,"UPyD",255
21,"21022",171,107,105,0,2,"UPyD",1
3,"3008",168,130,129,0,1,"UPyD",0
50,"50024",571,437,437,6,0,"UPyD",0
46,"46153",439,355,351,1,4,"UPyD",0
46,"46231",2421,1721,1708,14,13,"UPyD",0
40,"40901",384,309,307,4,2,"UPyD",3
34,"34170",61,42,42,0,0,"UPyD",0
14,"14022",4006,2977,2949,17,28,"UPyD",3
49,"49267",88,73,69,2,4,"UPyD",1
19,"19119",82,72,71,1,1,"UPyD",1
5,"5214",38,28,28,0,0,"UPyD",0
26,"26001",195,161,157,2,4,"UPyD",1
16,"16218",191,150,150,3,0,"UPyD",0
3,"3009",46657,35143,34801,223,342,"UPyD",68
26,"26103",796,616,610,6,6,"UPyD",0
36,"36040",2575,1709,1680,15,29,"UPyD",1
4,"4055",371,310,308,0,2,"UPyD",0
21,"21024",492,338,326,6,12,"UPyD",0
28,"28042",1173,890,883,3,7,"UPyD",5
7,"7009",738,521,510,12,11,"UPyD",2
19,"19120",101,88,88,1,0,"UPyD",0
5,"5168",3560,2589,2561,19,28,"UPyD",21
47,"47051",335,268,263,2,5,"UPyD",1
40,"40903",86,67,67,0,0,"UPyD",1
1,"1049",138,109,109,1,0,"UPyD",0
10,"10067",10422,7113,7014,62,99,"UPyD",17
9,"9423",27,24,24,0,0,"UPyD",0
31,"31181",145,112,112,0,0,"UPyD",0
28,"28140",3007,2276,2256,7,20,"UPyD",5
42,"42017",140,113,112,0,1,"UPyD",0
19,"19233",80,65,63,1,2,"UPyD",2
34,"34227",77,61,61,2,0,"UPyD",0
24,"24109",977,633,624,3,9,"UPyD",0
42,"42152",78,55,55,0,0,"UPyD",0
31,"31182",34,28,28,0,0,"UPyD",0
4,"4057",1325,894,884,5,10,"UPyD",0
46,"46155",1029,833,822,4,11,"UPyD",0
12,"12109",649,532,524,6,8,"UPyD",0
46,"46077",7496,5909,5827,45,82,"UPyD",11
46,"46103",1264,1015,984,7,31,"UPyD",1
41,"41032",3984,2811,2725,27,86,"UPyD",5
50,"50122",68,52,52,1,0,"UPyD",0
22,"22229",114,80,80,1,0,"UPyD",0
22,"22189",185,145,144,5,1,"UPyD",0
42,"42154",97,69,69,1,0,"UPyD",1
42,"42019",516,363,356,3,7,"UPyD",0
3,"3104",27103,19953,19787,131,166,"UPyD",42
18,"18032",246,175,174,2,1,"UPyD",0
34,"34081",61,53,52,0,1,"UPyD",0
14,"14026",2067,1424,1405,4,19,"UPyD",2
47,"47135",83,72,72,2,0,"UPyD",0
24,"24046",942,637,633,5,4,"UPyD",2
41,"41033",5075,3313,3277,34,36,"UPyD",3
46,"46182",1266,929,922,6,7,"UPyD",1
24,"24148",1672,1249,1241,23,8,"UPyD",1
46,"46026",1204,1015,1004,3,11,"UPyD",2
19,"19123",40,32,31,1,1,"UPyD",0
7,"7054",22334,12814,12708,99,106,"UPyD",29
5,"5076",478,386,378,4,8,"UPyD",1
13,"13901",893,665,655,5,10,"UPyD",1
48,"48074",3312,2330,2309,6,21,"UPyD",3
40,"40158",17,12,12,0,0,"UPyD",0
10,"10210",543,356,355,1,1,"UPyD",0
28,"28074",138947,103687,102762,620,925,"UPyD",479
5,"5222",147,127,126,1,1,"UPyD",1
46,"46105",16190,11323,11206,44,117,"UPyD",17
50,"50124",415,318,317,2,1,"UPyD",0
1,"1053",582,321,320,4,1,"UPyD",2
46,"46183",5993,4443,4381,19,62,"UPyD",8
45,"45107",3257,2504,2472,15,32,"UPyD",5
16,"16231",46,37,37,0,0,"UPyD",1
49,"49189",202,142,142,1,0,"UPyD",0
37,"37116",69,50,50,0,0,"UPyD",0
47,"47138",241,170,164,1,6,"UPyD",2
42,"42022",221,173,171,5,2,"UPyD",0
45,"45040",1349,846,838,4,8,"UPyD",1
12,"12142",158,117,117,1,0,"UPyD",0
48,"48075",1996,1364,1359,6,5,"UPyD",3
7,"7016",2809,1865,1836,23,29,"UPyD",1
39,"39005",1380,1053,1046,9,7,"UPyD",1
23,"23046",2391,1916,1895,6,21,"UPyD",2
26,"26007",511,384,375,0,9,"UPyD",0
42,"42157",13,10,10,0,0,"UPyD",0
37,"37024",89,67,67,0,0,"UPyD",0
36,"36047",2454,1633,1621,13,12,"UPyD",0
22,"22197",473,354,354,1,0,"UPyD",0
50,"50126",2371,1573,1559,19,14,"UPyD",1
6,"6093",4447,3254,3204,15,50,"UPyD",6
14,"14029",4178,3047,3009,28,38,"UPyD",5
23,"23048",870,619,613,1,6,"UPyD",0
46,"46185",378,320,313,2,7,"UPyD",0
10,"10076",832,556,541,1,15,"UPyD",1
47,"47220",165,130,129,0,1,"UPyD",0
40,"40033",58,51,51,0,0,"UPyD",1
6,"6094",1485,929,926,2,3,"UPyD",0
31,"31188",235,161,161,2,0,"UPyD",0
7,"7058",2791,2060,2034,13,26,"UPyD",6
19,"19005",84,66,66,0,0,"UPyD",0
46,"46081",10134,7771,7702,41,69,"UPyD",8
19,"19090",91,73,73,1,0,"UPyD",0
47,"47192",102,83,81,1,2,"UPyD",0
28,"28086",5154,3530,3493,13,37,"UPyD",9
3,"3110",291,241,241,1,0,"UPyD",0
37,"37370",328,258,254,1,4,"UPyD",1
9,"9167",58,41,41,1,0,"UPyD",0
19,"19006",769,547,540,2,7,"UPyD",0
37,"37246",5304,3993,3949,26,44,"UPyD",10
41,"41038",100095,67313,66687,760,626,"UPyD",220
18,"18084",4257,3107,3075,26,32,"UPyD",19
28,"28148",85454,62367,61884,370,483,"UPyD",313
50,"50192",236,180,180,2,0,"UPyD",0
6,"6050",4106,3134,3075,25,59,"UPyD",2
9,"9037",111,91,91,0,0,"UPyD",0
47,"47141",134,111,110,0,1,"UPyD",0
48,"48048",557,395,393,5,2,"UPyD",2
24,"24154",1005,673,666,4,7,"UPyD",0
29,"29054",41997,28422,28238,189,184,"UPyD",69
42,"42026",24,20,20,0,0,"UPyD",1
5,"5229",82,68,67,0,1,"UPyD",1
14,"14003",1248,939,930,2,9,"UPyD",3
42,"42204",54,38,38,1,0,"UPyD",0
12,"12116",58,49,49,0,0,"UPyD",0
23,"23050",90992,64810,64218,485,592,"UPyD",183
16,"16086",890,740,735,6,5,"UPyD",0
42,"42161",137,102,101,0,1,"UPyD",0
46,"46187",1306,1017,1000,0,17,"UPyD",1
10,"10171",344,245,244,0,1,"UPyD",0
28,"28149",5759,4352,4310,25,42,"UPyD",35
37,"37248",152,126,125,1,1,"UPyD",0
9,"9039",58,46,46,2,0,"UPyD",0
22,"22069",429,333,331,2,2,"UPyD",1
37,"37373",748,503,499,1,4,"UPyD",1
7,"7022",11545,7385,7306,88,79,"UPyD",15
6,"6099",1145,655,638,6,17,"UPyD",2
31,"31191",3016,2167,2147,22,20,"UPyD",10
16,"16242",317,272,270,1,2,"UPyD",0
23,"23052",1125,936,922,4,14,"UPyD",0
41,"41041",9706,7239,7120,36,119,"UPyD",5
7,"7063",1418,1043,1033,6,10,"UPyD",1
45,"45147",581,450,446,1,4,"UPyD",2
12,"12053",2034,1655,1633,6,22,"UPyD",1
37,"37374",1166,935,919,9,16,"UPyD",2
14,"14033",1283,971,959,9,12,"UPyD",0
1,"1060",197,160,157,0,3,"UPyD",0
6,"6100",935,780,774,1,6,"UPyD",3
19,"19010",8,8,8,0,0,"UPyD",0
42,"42029",137,104,104,2,0,"UPyD",0
42,"42030",94,78,78,1,0,"UPyD",1
34,"34189",56,44,44,1,0,"UPyD",0
39,"39041",1760,1370,1354,9,16,"UPyD",5
46,"46111",10930,7931,7828,44,103,"UPyD",17
50,"50036",104,91,90,0,1,"UPyD",0
14,"14034",308,247,244,2,3,"UPyD",0
39,"39042",5915,4530,4474,21,56,"UPyD",26
18,"18181",223,174,172,0,2,"UPyD",0
19,"19011",250,184,184,0,0,"UPyD",0
37,"37251",124,93,92,1,1,"UPyD",1
37,"37376",2233,1539,1515,6,24,"UPyD",2
40,"40127",32,25,25,0,0,"UPyD",0
28,"28152",16093,12945,12877,58,68,"UPyD",44
48,"48022",2336,1444,1433,6,11,"UPyD",1
20,"20021",200,100,100,2,0,"UPyD",0
40,"40170",1320,1030,1021,7,9,"UPyD",0
10,"10903",826,578,569,3,9,"UPyD",0
3,"3083",5586,3971,3928,33,43,"UPyD",10
9,"9003",194,147,146,0,1,"UPyD",1
31,"31228",486,341,337,2,4,"UPyD",0
30,"30011",4697,3421,3383,15,38,"UPyD",5
16,"16093",60,49,47,0,2,"UPyD",0
47,"47062",163,130,130,0,0,"UPyD",1
6,"6103",4796,3265,3220,20,45,"UPyD",6
24,"24057",1373,1045,1023,11,22,"UPyD",2
30,"30041",13621,8970,8889,46,81,"UPyD",31
3,"3116",1155,877,875,6,2,"UPyD",2
19,"19013",125,108,108,1,0,"UPyD",1
42,"42032",146,118,118,0,0,"UPyD",1
49,"49202",187,130,130,4,0,"UPyD",0
24,"24159",1806,1386,1366,6,20,"UPyD",4
31,"31196",38,35,35,1,0,"UPyD",0
31,"31096",113,82,79,0,3,"UPyD",0
49,"49085",996,684,680,2,4,"UPyD",1
42,"42167",251,175,172,2,3,"UPyD",0
9,"9441",74,65,65,0,0,"UPyD",0
3,"3024",3901,3067,3024,11,43,"UPyD",2
49,"49203",313,240,232,0,8,"UPyD",0
48,"48084",22449,14670,14553,90,117,"UPyD",19
16,"16248",859,654,636,5,18,"UPyD",2
5,"5093",408,294,292,1,2,"UPyD",1
49,"49204",63,51,51,0,0,"UPyD",0
46,"46192",761,576,570,5,6,"UPyD",2
16,"16249",1995,1519,1499,6,20,"UPyD",0
48,"48085",10338,7190,7153,39,37,"UPyD",5
29,"29061",1016,798,769,8,29,"UPyD",0
20,"20024",386,210,209,3,1,"UPyD",0
50,"50040",89,75,75,0,0,"UPyD",0
37,"37380",56,47,45,0,2,"UPyD",0
23,"23058",8678,6532,6461,37,71,"UPyD",6
12,"12059",231,189,188,2,1,"UPyD",0
9,"9177",1121,757,749,9,8,"UPyD",3
24,"24161",285,203,201,3,2,"UPyD",2
20,"20025",1143,765,760,8,5,"UPyD",0
48,"48086",2050,1414,1401,5,13,"UPyD",0
37,"37341",53,39,39,0,0,"UPyD",0
10,"10090",513,362,353,2,9,"UPyD",0
46,"46115",378,286,282,1,4,"UPyD",0
10,"10091",371,287,284,0,3,"UPyD",0
16,"16250",76,59,59,0,0,"UPyD",0
9,"9048",1467,1048,1033,13,15,"UPyD",6
20,"20026",197,145,133,0,12,"UPyD",0
6,"6109",3919,3139,3012,24,127,"UPyD",3
28,"28001",61,46,45,0,1,"UPyD",0
37,"37382",173,137,137,0,0,"UPyD",0
49,"49088",87,61,60,0,1,"UPyD",0
40,"40047",30,25,25,0,0,"UPyD",0
41,"41048",2228,1470,1447,15,23,"UPyD",2
48,"48087",427,344,338,0,6,"UPyD",0
39,"39047",1962,1385,1371,10,14,"UPyD",3
19,"19251",43,29,28,0,1,"UPyD",0
21,"21046",1705,1099,996,16,103,"UPyD",3
48,"48057",5723,3988,3962,26,26,"UPyD",0
34,"34011",397,321,320,5,1,"UPyD",0
40,"40177",153,125,125,1,0,"UPyD",0
21,"21047",1917,1111,1065,15,46,"UPyD",1
24,"24163",3962,2950,2933,24,17,"UPyD",16
22,"22209",155,120,120,3,0,"UPyD",0
42,"42037",33,25,25,2,0,"UPyD",0
10,"10093",398,317,312,4,5,"UPyD",0
48,"48088",136,102,102,0,0,"UPyD",0
29,"29065",187,137,136,0,1,"UPyD",1
36,"36901",4103,3153,3102,19,51,"UPyD",3
37,"37134",230,168,165,0,3,"UPyD",0
16,"16254",214,174,170,2,4,"UPyD",0
6,"6111",500,337,337,1,0,"UPyD",0
45,"45089",1495,1102,1094,0,8,"UPyD",0
16,"16100",670,564,559,0,5,"UPyD",0
46,"46195",1962,1531,1516,11,15,"UPyD",2
47,"47150",274,209,205,0,4,"UPyD",0
3,"3028",998,818,812,2,6,"UPyD",0
9,"9052",29,23,23,0,0,"UPyD",1
22,"22213",3003,2169,2131,19,38,"UPyD",3
31,"31002",414,288,287,3,1,"UPyD",1
50,"50140",166,115,115,0,0,"UPyD",0
35,"35001",4584,3282,3222,26,60,"UPyD",6
47,"47230",303,246,242,2,4,"UPyD",1
4,"4074",2840,2000,1979,23,21,"UPyD",3
21,"21050",12427,8036,7969,80,67,"UPyD",8
19,"19220",2302,1519,1501,1,18,"UPyD",6
50,"50044",230,145,145,1,0,"UPyD",0
26,"26126",31,27,27,0,0,"UPyD",0
23,"23063",3829,2560,2522,21,38,"UPyD",0
26,"26023",469,358,354,0,4,"UPyD",1
6,"6023",4302,3041,3007,16,34,"UPyD",1
28,"28004",6234,4202,4167,16,35,"UPyD",3
40,"40139",279,202,198,1,4,"UPyD",1
22,"22214",128,106,105,3,1,"UPyD",0
31,"31103",42,34,34,2,0,"UPyD",0
46,"46256",6853,4951,4890,25,61,"UPyD",8
31,"31202",4305,2845,2803,31,42,"UPyD",5
40,"40053",83,66,65,0,1,"UPyD",0
49,"49094",224,149,149,2,0,"UPyD",0
45,"45058",375,311,304,1,7,"UPyD",0
50,"50236",102,79,77,0,2,"UPyD",0
24,"24166",1407,1013,993,8,20,"UPyD",4
24,"24065",2138,1503,1472,15,31,"UPyD",1
20,"20031",176,90,90,0,0,"UPyD",0
5,"5104",35,28,28,0,0,"UPyD",0
9,"9183",51,41,41,0,0,"UPyD",0
5,"5105",341,249,247,7,2,"UPyD",2
42,"42043",3791,2727,2682,25,45,"UPyD",6
16,"16104",51,41,41,0,0,"UPyD",1
40,"40182",178,133,130,2,3,"UPyD",0
41,"41053",21259,15147,14853,132,294,"UPyD",34
18,"18106",425,293,290,0,3,"UPyD",1
37,"37349",117,88,88,0,0,"UPyD",0
41,"41020",12887,8210,8118,82,92,"UPyD",8
37,"37005",74,54,54,2,0,"UPyD",0
4,"4077",295,263,261,2,2,"UPyD",0
49,"49053",931,709,699,8,10,"UPyD",0
16,"16106",2727,2009,1989,12,20,"UPyD",0
47,"47153",108,77,77,0,0,"UPyD",1
31,"31105",1507,1167,1142,7,25,"UPyD",0
3,"3125",343,254,251,0,3,"UPyD",0
37,"37266",82,63,63,2,0,"UPyD",0
39,"39053",219,153,152,2,1,"UPyD",1
46,"46258",2652,2084,2062,16,22,"UPyD",7
16,"16265",20,19,19,0,0,"UPyD",0
50,"50238",91,66,66,1,0,"UPyD",0
5,"5107",62,39,39,0,0,"UPyD",0
40,"40056",34,28,28,1,0,"UPyD",0
49,"49220",135,110,109,0,1,"UPyD",0
33,"33060",14633,9647,9474,72,173,"UPyD",13
12,"12069",66,49,48,0,1,"UPyD",0
31,"31206",2090,1461,1440,22,21,"UPyD",3
3,"3127",350,278,273,1,5,"UPyD",0
34,"34110",88,71,71,1,0,"UPyD",0
24,"24169",2969,2140,2118,13,22,"UPyD",2
18,"18108",850,659,656,3,3,"UPyD",0
6,"6120",3389,2502,2478,12,24,"UPyD",1
2,"2010",1789,1437,1421,11,16,"UPyD",2
3,"3128",4092,2861,2840,10,21,"UPyD",3
42,"42046",49,39,39,0,0,"UPyD",0
16,"16108",49,45,42,0,3,"UPyD",0
46,"46259",491,396,393,4,3,"UPyD",0
39,"39054",4493,3376,3334,33,42,"UPyD",9
37,"37268",112,76,76,0,0,"UPyD",0
19,"19260",42,39,39,1,0,"UPyD",0
37,"37142",586,430,429,1,1,"UPyD",1
31,"31108",1855,1368,1348,7,20,"UPyD",2
19,"19032",165,126,124,1,2,"UPyD",0
13,"13083",2423,1693,1653,10,40,"UPyD",0
45,"45197",1906,1455,1430,8,25,"UPyD",1
42,"42049",116,81,81,1,0,"UPyD",0
37,"37269",447,326,324,1,2,"UPyD",0
24,"24170",1908,1365,1345,8,20,"UPyD",4
5,"5062",179,148,147,0,1,"UPyD",0
7,"7043",3389,2290,2252,26,38,"UPyD",3
37,"37144",363,277,276,1,1,"UPyD",0
3,"3035",652,547,541,1,6,"UPyD",1
26,"26062",89,72,71,2,1,"UPyD",0
9,"9455",45,33,33,0,0,"UPyD",0
45,"45164",182,162,160,1,2,"UPyD",0
12,"12071",1274,992,979,3,13,"UPyD",1
9,"9192",55,43,43,0,0,"UPyD",0
16,"16111",171,123,123,1,0,"UPyD",0
50,"50210",38,30,30,1,0,"UPyD",0
33,"33063",415,320,318,3,2,"UPyD",1
50,"50116",182,136,132,0,4,"UPyD",0
10,"10197",123,90,89,0,1,"UPyD",0
9,"9061",162,124,123,0,1,"UPyD",1
26,"26030",16,16,15,0,1,"UPyD",0
46,"46020",3760,2916,2866,22,50,"UPyD",2
19,"19263",26,15,15,1,0,"UPyD",0
11,"11014",16858,10366,10245,153,121,"UPyD",15
46,"46047",532,446,437,2,9,"UPyD",1
9,"9458",469,343,336,5,7,"UPyD",1
24,"24173",951,679,674,9,5,"UPyD",0
37,"37012",154,116,115,1,1,"UPyD",1
26,"26031",106,83,83,0,0,"UPyD",0
13,"13035",984,747,730,7,17,"UPyD",0
22,"22223",75,58,58,0,0,"UPyD",1
50,"50053",687,513,510,2,3,"UPyD",0
46,"46262",223,162,159,2,3,"UPyD",0
19,"19157",55,46,46,0,0,"UPyD",1
10,"10108",219,148,146,0,2,"UPyD",0
19,"19036",263,229,229,0,0,"UPyD",0
45,"45166",1617,1305,1286,8,19,"UPyD",0
14,"14049",16309,11635,11515,115,120,"UPyD",17
19,"19037",141,115,114,1,1,"UPyD",0
16,"16275",11,11,11,1,0,"UPyD",0
47,"47076",17399,13097,12972,92,125,"UPyD",50
49,"49103",414,330,328,5,2,"UPyD",0
35,"35009",19905,14185,13961,89,224,"UPyD",19
21,"21062",1392,887,879,6,8,"UPyD",1
40,"40063",7096,5184,5100,36,84,"UPyD",20
20,"20040",15289,9444,9373,66,71,"UPyD",5
31,"31013",642,406,401,1,5,"UPyD",0
5,"5117",200,174,173,1,1,"UPyD",0
5,"5262",357,276,276,1,0,"UPyD",0
46,"46126",5556,4449,4405,24,44,"UPyD",6
46,"46205",14313,10932,10834,51,98,"UPyD",27
37,"37015",224,144,144,1,0,"UPyD",0
42,"42053",26,19,19,1,0,"UPyD",0
4,"4054",358,285,281,2,4,"UPyD",0
28,"28168",1237,884,880,4,4,"UPyD",3
19,"19038",28,24,23,0,1,"UPyD",0
5,"5263",173,129,129,1,0,"UPyD",1
47,"47077",246,193,191,1,2,"UPyD",0
4,"4085",387,304,301,2,3,"UPyD",1
50,"50152",1430,1008,994,14,14,"UPyD",1
46,"46902",364,306,303,0,3,"UPyD",0
48,"48903",1835,1361,1351,7,10,"UPyD",0
24,"24175",1832,1314,1297,14,17,"UPyD",3
47,"47160",425,308,303,0,5,"UPyD",0
20,"20041",255,123,123,0,0,"UPyD",0
11,"11018",1468,1046,1031,9,15,"UPyD",0
34,"34076",587,479,479,2,0,"UPyD",1
49,"49184",172,115,112,0,3,"UPyD",0
3,"3135",211,170,166,2,4,"UPyD",0
18,"18913",813,566,559,2,7,"UPyD",0
37,"37017",245,182,177,1,5,"UPyD",0
46,"46102",19788,15154,15038,89,116,"UPyD",41
3,"3041",5954,4218,4194,22,24,"UPyD",6
9,"9199",92,72,71,1,1,"UPyD",0
11,"11019",1826,1302,1248,7,54,"UPyD",3
2,"2020",432,365,364,1,1,"UPyD",0
14,"14052",9379,5917,5854,68,63,"UPyD",6
19,"19268",35,24,24,1,0,"UPyD",0
45,"45070",1427,1147,1142,1,5,"UPyD",2
28,"28079",2362038,1743924,1733354,8859,10570,"UPyD",7336
42,"42056",23,20,20,0,0,"UPyD",0
33,"33008",1777,1238,1229,3,9,"UPyD",1
45,"45170",228,176,167,0,9,"UPyD",0
10,"10115",3544,2705,2647,11,58,"UPyD",6
21,"21066",498,392,389,3,3,"UPyD",1
9,"9067",437,295,294,6,1,"UPyD",1
48,"48072",977,716,713,4,3,"UPyD",0
5,"5122",134,102,101,0,1,"UPyD",0
16,"16280",192,164,161,1,3,"UPyD",0
9,"9471",149,114,114,1,0,"UPyD",1
7,"7012",1876,1369,1353,13,16,"UPyD",1
46,"46129",524,420,412,4,8,"UPyD",2
40,"40196",30,25,25,0,0,"UPyD",0
9,"9338",227,170,169,0,1,"UPyD",0
19,"19269",102,81,80,0,1,"UPyD",0
41,"41065",22779,14769,14636,132,133,"UPyD",19
16,"16901",675,506,501,6,5,"UPyD",1
47,"47080",30,22,21,0,1,"UPyD",0
40,"40071",43,39,38,1,1,"UPyD",2
42,"42058",113,92,89,0,3,"UPyD",1
39,"39063",967,697,690,9,7,"UPyD",0
19,"19042",25,24,24,0,0,"UPyD",0
18,"18123",301,228,222,1,6,"UPyD",0
45,"45073",298,233,233,1,0,"UPyD",0
24,"24179",290,197,192,4,5,"UPyD",0
49,"49111",127,98,96,4,2,"UPyD",0
33,"33071",595,433,430,10,3,"UPyD",0
34,"34129",179,130,129,1,1,"UPyD",1
41,"41067",7093,4930,4866,37,64,"UPyD",11
31,"31219",84,66,66,0,0,"UPyD",1
5,"5903",151,104,104,2,0,"UPyD",1
5,"5904",127,88,87,1,1,"UPyD",0
37,"37022",268,215,215,2,0,"UPyD",0
26,"26144",188,155,155,3,0,"UPyD",0
16,"16124",1858,1476,1459,12,17,"UPyD",1
48,"48908",249,181,181,0,0,"UPyD",0
29,"29072",3262,2382,2352,17,30,"UPyD",2
9,"9476",62,43,43,0,0,"UPyD",0
46,"46131",49431,36570,36227,231,343,"UPyD",89
5,"5905",217,165,164,0,1,"UPyD",2
9,"9072",316,242,241,0,1,"UPyD",2
42,"42060",38,21,19,1,2,"UPyD",0
41,"41068",13939,9787,9674,72,113,"UPyD",10
21,"21071",203,157,153,4,4,"UPyD",0
49,"49235",443,301,292,0,9,"UPyD",1
40,"40074",255,222,219,2,3,"UPyD",0
26,"26145",246,197,197,2,0,"UPyD",0
31,"31221",1214,798,786,12,12,"UPyD",0
2,"2026",836,690,679,3,11,"UPyD",1
47,"47165",6955,4955,4303,66,652,"UPyD",9
22,"22234",794,552,544,3,8,"UPyD",3
45,"45108",509,412,411,1,1,"UPyD",0
33,"33073",8554,4945,4884,41,61,"UPyD",7
20,"20047",469,307,304,5,3,"UPyD",0
9,"9208",210,136,134,3,2,"UPyD",0
5,"5128",354,281,271,2,10,"UPyD",0
47,"47004",1181,939,930,7,9,"UPyD",2
49,"49114",43,34,33,0,1,"UPyD",2
28,"28085",3922,2972,2954,14,18,"UPyD",5
3,"3046",1599,1153,1143,8,10,"UPyD",1
20,"20048",182,100,98,2,2,"UPyD",0
23,"23087",11292,8222,8084,59,138,"UPyD",21
13,"13052",6422,4651,4580,46,71,"UPyD",7
42,"42062",22,12,12,0,0,"UPyD",0
40,"40076",6492,4768,4700,26,68,"UPyD",11
29,"29074",794,586,581,0,5,"UPyD",1
46,"46107",1900,1516,1504,5,12,"UPyD",0
42,"42025",1189,844,833,2,11,"UPyD",2
9,"9036",37,31,30,1,1,"UPyD",0
50,"50283",70,57,57,1,0,"UPyD",0
31,"31222",62,36,34,3,2,"UPyD",0
31,"31122",4773,3520,3506,26,14,"UPyD",8
50,"50253",423,330,328,4,2,"UPyD",0
47,"47084",1150,887,870,7,17,"UPyD",1
37,"37026",189,146,146,0,0,"UPyD",0
33,"33075",271,154,153,2,1,"UPyD",0
20,"20049",4122,2677,2666,15,11,"UPyD",2
14,"14058",7970,5491,5417,66,74,"UPyD",6
49,"49238",254,194,193,1,1,"UPyD",0
9,"9432",182,145,138,0,7,"UPyD",0
39,"39068",646,450,445,2,5,"UPyD",1
26,"26043",365,292,281,1,11,"UPyD",1
40,"40204",167,113,110,1,3,"UPyD",2
9,"9075",112,91,91,3,0,"UPyD",0
6,"6005",1696,1197,1178,1,19,"UPyD",3
42,"42064",86,68,68,0,0,"UPyD",0
29,"29077",199,149,146,2,3,"UPyD",0
39,"39069",1972,1510,1489,12,21,"UPyD",6
10,"10170",267,210,206,3,4,"UPyD",0
12,"12051",471,339,335,1,4,"UPyD",1
16,"16132",35,27,26,0,1,"UPyD",0
9,"9213",307,220,218,2,2,"UPyD",0
48,"48912",2308,1707,1679,14,28,"UPyD",1
42,"42068",82,63,60,1,3,"UPyD",1
3,"3112",628,511,507,2,4,"UPyD",1
49,"49118",203,161,160,1,1,"UPyD",1
19,"19280",3464,2469,2438,14,31,"UPyD",5
31,"31225",36,27,27,0,0,"UPyD",0
4,"4095",714,471,468,5,3,"UPyD",0
50,"50255",209,163,163,5,0,"UPyD",0
6,"6007",1475,1038,1032,1,6,"UPyD",0
47,"47169",68,59,59,0,0,"UPyD",0
33,"33077",1192,811,808,5,3,"UPyD",1
46,"46214",15766,12131,12036,42,95,"UPyD",26
16,"16133",4389,3358,3316,24,42,"UPyD",4
35,"35019",32481,19318,19067,123,251,"UPyD",34
22,"22242",62,45,44,0,1,"UPyD",0
26,"26046",1581,1175,1159,4,16,"UPyD",0
22,"22112",9566,6354,6305,56,49,"UPyD",5
33,"33078",142,101,99,0,2,"UPyD",0
5,"5135",425,317,315,5,2,"UPyD",4
9,"9078",41,30,30,1,0,"UPyD",0
31,"31226",591,342,340,2,2,"UPyD",0
34,"34139",166,107,106,1,1,"UPyD",0
31,"31027",836,532,530,2,2,"UPyD",0
16,"16134",4371,3288,3254,20,34,"UPyD",6
37,"37031",361,269,266,2,3,"UPyD",0
4,"4001",1062,823,814,5,9,"UPyD",4
28,"28024",151,125,124,1,1,"UPyD",0
42,"42070",34,27,26,1,1,"UPyD",0
46,"46059",1261,1035,1019,9,16,"UPyD",2
37,"37292",104,77,77,1,0,"UPyD",0
18,"18136",1851,1354,1337,5,17,"UPyD",2
7,"7065",2083,1346,1328,9,18,"UPyD",0
50,"50068",1982,1348,1335,8,13,"UPyD",1
23,"23094",3839,3009,2954,14,55,"UPyD",3
4,"4097",248,189,189,1,0,"UPyD",0
26,"26118",59,48,48,2,0,"UPyD",1
31,"31028",212,131,131,0,0,"UPyD",0
21,"21040",3170,2129,2071,20,58,"UPyD",0
26,"26048",22,22,22,0,0,"UPyD",0
6,"6011",24723,16883,16718,137,165,"UPyD",21
10,"10131",12861,8813,8721,52,92,"UPyD",22
40,"40210",106,74,71,0,3,"UPyD",0
42,"42209",140,107,106,4,1,"UPyD",0
47,"47197",876,673,668,8,5,"UPyD",0
10,"10086",320,238,233,1,5,"UPyD",0
47,"47089",148,125,124,0,1,"UPyD",0
28,"28026",6317,4734,4701,33,33,"UPyD",21
5,"5140",111,89,87,0,2,"UPyD",0
16,"16001",76,61,61,0,0,"UPyD",1
19,"19176",237,181,181,0,0,"UPyD",0
10,"10132",396,278,275,0,3,"UPyD",0
42,"42211",82,66,66,1,0,"UPyD",0
18,"18003",14022,9938,9820,80,118,"UPyD",16
40,"40211",74,64,64,0,0,"UPyD",0
24,"24091",645,454,451,1,3,"UPyD",0
50,"50070",60,36,36,0,0,"UPyD",0
18,"18004",714,518,509,2,9,"UPyD",1
34,"34143",168,123,120,2,3,"UPyD",1
9,"9219",27509,19084,18859,146,225,"UPyD",65
49,"49246",227,190,183,2,7,"UPyD",0
42,"42075",83,62,62,0,0,"UPyD",0
49,"49004",126,100,100,4,0,"UPyD",0
14,"14064",320,242,236,2,6,"UPyD",0
28,"28027",1203,872,857,3,15,"UPyD",4
34,"34006",81,67,66,2,1,"UPyD",0
24,"24191",108,79,79,0,0,"UPyD",0
9,"9084",186,136,135,4,1,"UPyD",0
23,"23098",867,713,701,1,12,"UPyD",0
16,"16142",136,101,101,1,0,"UPyD",0
39,"39075",137376,99899,99048,718,851,"UPyD",387
22,"22117",2478,1714,1693,22,21,"UPyD",6
34,"34146",51,40,39,0,1,"UPyD",0
50,"50169",351,269,265,0,4,"UPyD",1
45,"45186",3061,2242,2214,11,28,"UPyD",3
18,"18005",372,262,258,0,4,"UPyD",0
31,"31031",220,131,129,0,2,"UPyD",0
42,"42213",27,21,21,1,0,"UPyD",0
19,"19287",148,109,108,0,1,"UPyD",0
6,"6153",20377,14329,14163,103,166,"UPyD",16
37,"37298",179,127,126,0,1,"UPyD",0
11,"11035",13593,8375,8276,90,99,"UPyD",18
48,"48025",883,642,637,7,5,"UPyD",0
42,"42215",773,531,520,7,11,"UPyD",1
6,"6016",2986,2114,2078,14,36,"UPyD",5
49,"49126",235,155,154,2,1,"UPyD",0
46,"46219",127,112,112,1,0,"UPyD",0
40,"40089",222,167,164,0,3,"UPyD",0
45,"45087",8311,5828,5747,43,81,"UPyD",14
46,"46141",439,351,342,2,9,"UPyD",0
9,"9086",666,462,459,2,3,"UPyD",2
50,"50170",371,283,280,0,3,"UPyD",0
6,"6018",753,535,529,3,6,"UPyD",0
40,"40215",84,60,60,0,0,"UPyD",0
4,"4102",13694,8944,8865,50,79,"UPyD",9
28,"28029",520,408,406,0,2,"UPyD",1
31,"31033",49,31,31,1,0,"UPyD",0
18,"18145",10491,7538,7477,59,61,"UPyD",25
6,"6110",148,108,108,1,0,"UPyD",0
31,"31067",1922,1312,1294,10,18,"UPyD",4
28,"28030",1726,1320,1299,8,21,"UPyD",3
5,"5147",159,128,124,5,4,"UPyD",0
49,"49127",2367,1668,1650,16,18,"UPyD",7
10,"10138",555,448,446,2,2,"UPyD",0
49,"49008",460,332,331,5,1,"UPyD",1
47,"47093",813,613,600,5,13,"UPyD",1
19,"19182",38,34,33,0,1,"UPyD",0
29,"29088",2714,1829,1800,12,29,"UPyD",3
49,"49009",393,293,288,2,5,"UPyD",0
9,"9225",83,55,54,0,1,"UPyD",0
16,"16008",89,69,69,0,0,"UPyD",0
35,"35026",81091,51953,51195,407,758,"UPyD",89
46,"46169",32247,24214,24053,154,161,"UPyD",47
47,"47094",133,115,114,1,1,"UPyD",0
49,"49251",163,127,121,1,6,"UPyD",0
10,"10140",1106,820,808,4,12,"UPyD",1
42,"42082",8,8,8,1,0,"UPyD",0
4,"4901",545,395,394,0,1,"UPyD",0
2,"2044",1105,768,758,7,10,"UPyD",3
49,"49252",320,254,252,5,2,"UPyD",0
5,"5151",91,71,71,1,0,"UPyD",0
45,"45190",475,371,366,0,5,"UPyD",0
48,"48028",717,543,537,3,6,"UPyD",0
13,"13073",531,399,391,3,8,"UPyD",0
3,"3059",20583,15125,15018,63,107,"UPyD",25
20,"20029",4281,2813,2802,19,11,"UPyD",1
14,"14069",7524,5460,5392,43,68,"UPyD",4
46,"46144",663,532,529,2,3,"UPyD",1
13,"13074",974,835,828,3,7,"UPyD",2
50,"50076",78,66,65,0,1,"UPyD",0
4,"4902",45437,28936,28699,214,237,"UPyD",108
33,"33026",8530,5397,5337,48,60,"UPyD",8
47,"47016",69,56,55,0,1,"UPyD",0
3,"3060",109,91,91,0,0,"UPyD",1
26,"26056",419,338,332,1,6,"UPyD",1
31,"31037",84,66,66,1,0,"UPyD",0
42,"42130",59,46,45,1,1,"UPyD",0
9,"9363",965,737,734,2,3,"UPyD",5
47,"47095",38,31,31,0,0,"UPyD",0
6,"6160",3153,2176,2146,16,30,"UPyD",2
22,"22127",505,374,371,3,3,"UPyD",0
39,"39081",437,337,332,4,5,"UPyD",0
22,"22012",111,87,86,3,1,"UPyD",0
34,"34018",209,168,164,1,4,"UPyD",0
9,"9365",29,19,19,0,0,"UPyD",0
41,"41085",4086,3058,3012,22,46,"UPyD",10
16,"16151",64,61,59,0,2,"UPyD",0
37,"37306",259,186,183,1,3,"UPyD",1
11,"11041",9866,6477,6402,69,75,"UPyD",4
24,"24001",189,124,122,0,2,"UPyD",1
49,"49013",246,182,181,2,1,"UPyD",0
9,"9095",84,61,61,0,0,"UPyD",0
5,"5154",38,33,33,0,0,"UPyD",1
4,"4904",1777,1230,1221,12,9,"UPyD",3
18,"18105",3782,2450,2420,17,30,"UPyD",2
19,"19024",8196,5613,5563,28,50,"UPyD",29
6,"6901",2118,1559,1546,23,13,"UPyD",0
47,"47097",325,266,265,0,1,"UPyD",0
49,"49257",291,190,184,1,6,"UPyD",0
18,"18016",307,235,233,0,2,"UPyD",0
16,"16013",27,24,24,0,0,"UPyD",0
12,"12099",539,416,403,7,13,"UPyD",0
39,"39083",1135,679,670,8,9,"UPyD",2
46,"46069",162,124,123,0,1,"UPyD",0
31,"31240",527,327,326,2,1,"UPyD",1
10,"10146",1507,1004,977,7,27,"UPyD",3
5,"5002",1963,1422,1390,3,32,"UPyD",8
16,"16154",4871,3547,3509,24,38,"UPyD",7
50,"50079",249,175,174,0,1,"UPyD",0
46,"46225",337,290,281,5,9,"UPyD",0
20,"20066",454,236,234,1,2,"UPyD",0
6,"6903",2021,1377,1360,12,17,"UPyD",1
49,"49134",172,121,119,0,2,"UPyD",0
28,"28035",1353,1006,998,2,8,"UPyD",3
13,"13081",636,480,472,9,8,"UPyD",0
18,"18017",18114,11610,11510,77,100,"UPyD",33
10,"10010",2290,1362,1341,7,21,"UPyD",1
16,"16015",374,263,262,4,1,"UPyD",0
26,"26060",84,62,62,2,0,"UPyD",0
24,"24205",945,694,685,11,9,"UPyD",1
20,"20067",30828,19984,19882,140,102,"UPyD",17
39,"39084",838,631,624,2,7,"UPyD",0
40,"40101",877,635,628,8,7,"UPyD",4
45,"45095",689,513,505,0,8,"UPyD",1
46,"46226",41,36,35,0,1,"UPyD",0
50,"50270",38,26,26,0,0,"UPyD",0
40,"40228",510,390,382,1,8,"UPyD",1
49,"49016",247,176,174,5,2,"UPyD",1
47,"47020",280,234,231,2,3,"UPyD",1
46,"46149",363,271,268,2,3,"UPyD",0
50,"50019",55,41,41,0,0,"UPyD",1
1,"1041",149,103,100,1,3,"UPyD",0
28,"28104",14040,11151,11096,57,55,"UPyD",38
50,"50178",293,190,187,0,3,"UPyD",1
35,"35032",3412,2473,2425,17,48,"UPyD",9
10,"10150",346,285,279,3,6,"UPyD",0
13,"13031",2452,1919,1909,11,10,"UPyD",3
46,"46201",64,52,51,1,1,"UPyD",0
46,"46227",905,711,702,1,9,"UPyD",2
18,"18157",1121,815,803,3,12,"UPyD",2
23,"23033",1352,1045,1034,12,11,"UPyD",2
13,"13084",892,701,685,6,16,"UPyD",0
10,"10014",1852,1370,1346,6,24,"UPyD",3
19,"19073",23,19,19,0,0,"UPyD",0
48,"48035",413,293,292,1,1,"UPyD",0
50,"50148",316,233,229,4,4,"UPyD",0
19,"19074",72,62,62,0,0,"UPyD",0
42,"42050",31,18,18,0,0,"UPyD",0
5,"5259",124,105,105,1,0,"UPyD",0
50,"50082",82,65,64,0,1,"UPyD",0
9,"9103",217,184,183,1,1,"UPyD",0
34,"34027",1085,751,741,6,10,"UPyD",2
19,"19301",40,33,33,1,0,"UPyD",0
47,"47101",1710,1357,1336,16,21,"UPyD",2
45,"45098",2159,1632,1609,12,23,"UPyD",1
2,"2055",1127,679,668,6,11,"UPyD",1
46,"46073",1092,888,884,6,4,"UPyD",1
18,"18159",995,797,795,2,2,"UPyD",0
49,"49139",171,135,135,0,0,"UPyD",0
12,"12003",976,746,736,6,10,"UPyD",0
9,"9104",53,42,42,0,0,"UPyD",0
24,"24209",2769,1888,1865,12,23,"UPyD",0
49,"49020",289,214,214,2,0,"UPyD",0
18,"18161",212,175,174,3,1,"UPyD",0
29,"29099",950,693,685,4,8,"UPyD",0
5,"5014",5379,4009,3970,18,39,"UPyD",8
40,"40233",417,314,310,3,4,"UPyD",3
10,"10154",181,131,129,0,2,"UPyD",0
7,"7006",5178,3366,3329,52,37,"UPyD",4
48,"48038",1126,798,794,3,4,"UPyD",0
5,"5165",368,290,281,3,9,"UPyD",0
19,"19193",20,19,19,1,0,"UPyD",0
45,"45200",4592,3539,3476,14,63,"UPyD",6
19,"19076",27,19,19,0,0,"UPyD",0
37,"37316",744,563,558,3,5,"UPyD",2
26,"26066",251,201,194,1,7,"UPyD",0
28,"28109",1576,1103,1098,1,5,"UPyD",2
24,"24008",9282,6685,6603,52,82,"UPyD",13
47,"47184",573,453,451,1,2,"UPyD",1
49,"49062",122,90,89,0,1,"UPyD",0
49,"49142",249,180,179,0,1,"UPyD",0
49,"49266",76,63,61,2,2,"UPyD",0
5,"5017",85,82,81,5,1,"UPyD",1
10,"10156",97,73,72,1,1,"UPyD",0
21,"21063",2615,2001,1957,22,44,"UPyD",1
50,"50275",108,55,55,0,0,"UPyD",0
6,"6037",1748,1148,1134,9,14,"UPyD",3
19,"19304",219,173,171,3,2,"UPyD",0
34,"34032",40,33,33,1,0,"UPyD",0
24,"24107",236,175,173,0,2,"UPyD",0
50,"50086",187,132,128,2,4,"UPyD",0
10,"10157",263,204,201,0,3,"UPyD",0
13,"13092",1846,1477,1462,5,15,"UPyD",1
22,"22139",79,64,64,1,0,"UPyD",1
18,"18164",1836,1146,1126,6,20,"UPyD",0
29,"29012",9755,6689,6599,71,90,"UPyD",12
49,"49145",236,162,157,0,5,"UPyD",0
16,"16025",26,23,23,0,0,"UPyD",0
22,"22909",315,226,225,4,1,"UPyD",0
29,"29902",2567,1577,1559,11,18,"UPyD",2
5,"5265",82,66,66,1,0,"UPyD",1
18,"18165",4123,2787,2758,18,29,"UPyD",3
4,"4021",185,151,148,1,3,"UPyD",1
20,"20075",4371,2692,2679,18,13,"UPyD",3
18,"18028",928,765,758,2,7,"UPyD",0
19,"19196",105,84,81,0,3,"UPyD",0
39,"39091",1926,1493,1476,10,17,"UPyD",1
13,"13094",304,249,247,1,2,"UPyD",0
10,"10022",427,349,341,0,8,"UPyD",0
45,"45003",562,408,402,1,6,"UPyD",0
49,"49146",295,216,213,3,3,"UPyD",1
26,"26069",236,194,189,0,5,"UPyD",0
40,"40155",3518,2656,2605,18,51,"UPyD",7
1,"1008",786,513,509,11,4,"UPyD",0
9,"9243",76,59,57,1,2,"UPyD",0
9,"9112",109,85,85,0,0,"UPyD",0
39,"39001",2102,1622,1601,18,21,"UPyD",4
5,"5022",1588,1238,1222,5,16,"UPyD",0
50,"50088",302,246,237,5,9,"UPyD",1
33,"33009",905,611,609,3,2,"UPyD",0
24,"24110",1247,899,892,6,7,"UPyD",1
34,"34079",1616,1222,1205,5,17,"UPyD",1
16,"16029",99,72,70,0,2,"UPyD",0
9,"9244",46,34,34,1,0,"UPyD",0
50,"50186",42,31,31,0,0,"UPyD",0
3,"3073",236,200,199,1,1,"UPyD",0
31,"31150",213,156,155,1,1,"UPyD",0
40,"40113",425,323,316,0,7,"UPyD",3
34,"34176",133,102,101,0,1,"UPyD",0
2,"2063",1463,1073,1060,3,13,"UPyD",0
13,"13098",2092,1503,1461,8,42,"UPyD",1
31,"31151",66,46,46,1,0,"UPyD",0
16,"16169",58,37,37,3,0,"UPyD",0
40,"40905",133,103,100,1,3,"UPyD",1
26,"26071",8491,5834,5761,47,73,"UPyD",18
36,"36008",21762,15447,15262,128,185,"UPyD",22
6,"6043",665,490,484,2,6,"UPyD",0
19,"19086",1473,1123,1111,7,12,"UPyD",1
4,"4024",3074,2347,2327,20,20,"UPyD",2
7,"7014",7320,4163,4116,45,47,"UPyD",7
2,"2064",372,325,324,1,1,"UPyD",1
19,"19200",71,52,52,1,0,"UPyD",0
37,"37198",207,160,157,3,3,"UPyD",2
47,"47028",33,21,21,0,0,"UPyD",0
16,"16031",46,28,28,1,0,"UPyD",0
45,"45006",1406,942,931,4,11,"UPyD",0
50,"50091",41,36,36,0,0,"UPyD",0
19,"19087",18,18,18,0,0,"UPyD",0
33,"33011",11260,6250,6163,83,87,"UPyD",7
49,"49150",139,112,111,1,1,"UPyD",0
6,"6045",506,379,374,3,5,"UPyD",0
49,"49273",187,112,112,0,0,"UPyD",0
49,"49029",623,495,488,3,7,"UPyD",2
49,"49151",619,459,456,2,3,"UPyD",2
16,"16032",278,224,221,1,3,"UPyD",0
50,"50189",705,527,519,13,8,"UPyD",0
18,"18174",446,330,324,2,6,"UPyD",0
45,"45008",139,118,118,1,0,"UPyD",0
19,"19088",79,61,61,0,0,"UPyD",0
9,"9388",34,27,26,0,1,"UPyD",0
34,"34039",61,49,47,0,2,"UPyD",0
2,"2066",234,189,187,1,2,"UPyD",0
9,"9429",56,41,41,0,0,"UPyD",0
46,"46184",26505,20428,20223,115,205,"UPyD",29
23,"23006",4660,3687,3647,24,40,"UPyD",4
42,"42108",12,9,9,1,0,"UPyD",0
20,"20081",7470,4856,4833,40,23,"UPyD",5
10,"10029",414,339,333,0,6,"UPyD",0
5,"5029",121,96,94,0,2,"UPyD",0
34,"34180",66,55,55,1,0,"UPyD",0
6,"6047",849,639,628,2,11,"UPyD",0
37,"37328",186,135,131,1,4,"UPyD",1
3,"3077",1371,1071,1060,13,11,"UPyD",1
18,"18036",3851,2870,2841,17,29,"UPyD",6
31,"31055",257,175,172,2,3,"UPyD",0
16,"16035",261,203,198,4,5,"UPyD",0
23,"23007",3087,2205,2187,6,18,"UPyD",2
47,"47112",2587,2015,1988,7,27,"UPyD",4
5,"5178",368,284,280,0,4,"UPyD",0
50,"50094",1617,1173,1159,12,14,"UPyD",2
14,"14030",8625,6248,6181,53,67,"UPyD",7
34,"34042",296,237,234,1,3,"UPyD",0
19,"19203",30,24,24,0,0,"UPyD",0
22,"22155",76,51,51,0,0,"UPyD",0
20,"20901",1437,908,906,2,2,"UPyD",0
24,"24018",174,143,141,0,2,"UPyD",0
37,"37202",978,734,727,10,7,"UPyD",4
39,"39007",417,278,275,2,3,"UPyD",0
50,"50002",143,108,104,1,4,"UPyD",0
46,"46238",13282,9786,9721,61,65,"UPyD",17
3,"3048",4847,3719,3683,20,36,"UPyD",14
5,"5034",14,13,13,0,0,"UPyD",0
24,"24221",795,543,538,7,5,"UPyD",0
47,"47032",152,117,116,1,1,"UPyD",1
28,"28087",3186,2503,2487,19,16,"UPyD",5
31,"31156",251,189,188,0,1,"UPyD",0
16,"16177",78,64,64,0,0,"UPyD",0
47,"47193",1577,1251,1241,7,10,"UPyD",3
22,"22035",234,165,159,3,6,"UPyD",1
9,"9391",361,264,263,3,1,"UPyD",1
2,"2031",565,457,455,0,2,"UPyD",0
24,"24222",14256,9996,9884,101,112,"UPyD",38
10,"10033",423,320,320,0,0,"UPyD",0
46,"46239",442,340,338,3,2,"UPyD",0
31,"31157",3518,2298,2267,23,31,"UPyD",2
12,"12016",1582,1307,1297,6,10,"UPyD",1
24,"24020",456,314,307,4,7,"UPyD",0
29,"29022",179,137,136,0,1,"UPyD",0
41,"41007",12341,8039,7844,103,195,"UPyD",15
10,"10034",353,260,257,2,3,"UPyD",0
10,"10035",1920,1343,1315,5,28,"UPyD",0
1,"1018",1386,939,930,3,9,"UPyD",2
47,"47114",4045,2787,2762,26,25,"UPyD",5
28,"28119",2092,1590,1582,12,8,"UPyD",3
30,"30007",6411,4360,4329,24,31,"UPyD",9
37,"37333",224,142,142,1,0,"UPyD",2
9,"9256",354,258,258,2,0,"UPyD",2
9,"9125",584,432,430,1,2,"UPyD",0
39,"39010",631,480,475,7,5,"UPyD",1
5,"5183",138,111,110,0,1,"UPyD",1
46,"46084",1576,1263,1242,5,21,"UPyD",1
24,"24021",1675,1162,1144,8,18,"UPyD",2
47,"47115",281,236,233,3,3,"UPyD",0
28,"28052",3855,2626,2587,11,39,"UPyD",7
45,"45013",1758,1352,1329,8,23,"UPyD",3
34,"34049",359,266,260,1,6,"UPyD",1
14,"14005",6311,4143,4084,72,59,"UPyD",5
36,"36017",17782,12411,12240,117,171,"UPyD",22
49,"49036",506,374,367,2,7,"UPyD",0
29,"29024",386,227,219,2,8,"UPyD",0
19,"19096",91,72,69,0,3,"UPyD",0
9,"9001",27,22,22,0,0,"UPyD",0
5,"5039",54,42,41,0,1,"UPyD",0
10,"10175",1416,1006,980,4,26,"UPyD",1
48,"48051",213,163,163,0,0,"UPyD",0
29,"29025",39665,25907,25714,192,193,"UPyD",62
33,"33018",2901,2000,1976,18,24,"UPyD",1
42,"42118",23,17,17,0,0,"UPyD",0
5,"5138",306,221,220,1,1,"UPyD",0
9,"9258",172,141,139,5,2,"UPyD",0
49,"49159",271,209,205,4,4,"UPyD",1
36,"36018",3240,2198,2170,10,28,"UPyD",2
33,"33019",3072,2020,2005,18,15,"UPyD",5
12,"12119",148,95,93,0,2,"UPyD",0
19,"19212",703,543,531,3,12,"UPyD",3
16,"16188",91,65,65,0,0,"UPyD",0
41,"41076",2183,1341,1327,19,14,"UPyD",0
11,"11032",53874,31273,31008,348,265,"UPyD",53
20,"20907",118,85,85,2,0,"UPyD",0
22,"22162",130,102,102,0,0,"UPyD",0
31,"31161",338,264,259,2,5,"UPyD",0
28,"28122",513,375,370,2,5,"UPyD",0
39,"39012",6687,5021,4957,51,64,"UPyD",7
18,"18045",1126,756,742,4,14,"UPyD",0
16,"16189",264,206,205,4,1,"UPyD",0
19,"19099",298,200,199,6,1,"UPyD",0
49,"49040",114,101,101,0,0,"UPyD",0
41,"41099",3976,2369,2347,12,22,"UPyD",5
5,"5188",45,39,38,0,1,"UPyD",0
50,"50197",90,67,67,2,0,"UPyD",0
47,"47037",168,138,133,0,5,"UPyD",0
26,"26083",284,205,205,2,0,"UPyD",1
19,"19325",121,83,82,0,1,"UPyD",0
40,"40129",177,148,147,1,1,"UPyD",0
22,"22163",425,360,355,0,5,"UPyD",2
14,"14008",2839,1905,1895,19,10,"UPyD",1
36,"36020",2318,1646,1620,18,26,"UPyD",2
22,"22164",35,28,28,0,0,"UPyD",0
42,"42121",64,47,47,0,0,"UPyD",0
36,"36021",12073,8447,8342,89,105,"UPyD",16
50,"50102",859,658,653,8,5,"UPyD",1
40,"40130",130,107,106,1,1,"UPyD",0
50,"50291",96,74,74,0,0,"UPyD",0
46,"46166",8155,6320,6251,30,69,"UPyD",8
23,"23018",2325,1668,1653,10,15,"UPyD",0
19,"19102",98,79,78,0,1,"UPyD",0
16,"16047",232,175,175,2,0,"UPyD",0
5,"5045",91,66,66,0,0,"UPyD",0
5,"5191",121,106,105,1,1,"UPyD",1
47,"47199",80,63,63,0,0,"UPyD",0
31,"31065",1878,1351,1326,20,25,"UPyD",3
9,"9132",171,122,122,2,0,"UPyD",2
46,"46089",2132,1602,1574,9,28,"UPyD",3
10,"10044",1428,1040,1025,5,15,"UPyD",5
40,"40005",30,23,23,0,0,"UPyD",0
49,"49165",59,51,51,0,0,"UPyD",0
46,"46167",364,266,264,0,2,"UPyD",1
41,"41102",14655,10183,9919,142,264,"UPyD",23
39,"39015",839,647,642,4,5,"UPyD",0
22,"22167",493,388,381,9,7,"UPyD",0
19,"19329",59,50,50,1,0,"UPyD",0
3,"3088",5498,4041,3989,29,52,"UPyD",19
31,"31265",82,53,53,2,0,"UPyD",0
16,"16194",242,185,179,1,6,"UPyD",0
19,"19104",14,12,12,1,0,"UPyD",0
31,"31165",2780,1995,1960,30,35,"UPyD",1
40,"40134",731,579,570,1,9,"UPyD",2
50,"50011",122,95,94,1,1,"UPyD",0
22,"22168",23,18,18,0,0,"UPyD",0
31,"31166",258,181,181,1,0,"UPyD",0
41,"41015",5297,3478,3405,41,73,"UPyD",5
31,"31100",262,170,168,1,2,"UPyD",0
33,"33024",226679,158750,157564,1209,1186,"UPyD",416
3,"3089",9571,6775,6639,47,136,"UPyD",6
1,"1030",156,129,129,3,0,"UPyD",0
12,"12124",1840,1387,1381,33,6,"UPyD",0
23,"23021",524,431,429,0,2,"UPyD",0
9,"9267",111,99,97,1,2,"UPyD",0
47,"47122",2032,1563,1535,7,28,"UPyD",4
39,"39017",569,398,391,4,7,"UPyD",0
33,"33025",9174,5838,5786,57,52,"UPyD",8
41,"41903",6757,4562,4504,51,58,"UPyD",5
4,"4043",549,465,461,1,4,"UPyD",0
23,"23024",12435,9058,8833,55,225,"UPyD",18
45,"45056",2201,1260,1243,12,17,"UPyD",5
24,"24901",889,636,623,5,13,"UPyD",1
40,"40008",44,39,39,1,0,"UPyD",0
31,"31167",826,606,596,9,10,"UPyD",1
37,"37218",67,42,41,0,1,"UPyD",0
19,"19331",2609,1872,1844,12,28,"UPyD",2
37,"37345",163,128,128,3,0,"UPyD",0
49,"49168",93,74,74,0,0,"UPyD",0
49,"49047",107,75,75,0,0,"UPyD",1
4,"4044",1547,1166,1156,5,10,"UPyD",0
18,"18054",849,606,605,7,1,"UPyD",1
37,"37090",52,43,43,0,0,"UPyD",1
49,"49048",124,97,95,0,2,"UPyD",0
10,"10187",438,308,305,1,3,"UPyD",0
42,"42001",278,212,210,3,2,"UPyD",0
40,"40010",121,102,101,1,1,"UPyD",1
36,"36027",4430,3137,3101,15,36,"UPyD",4
46,"46170",3417,2714,2688,10,26,"UPyD",2
34,"34060",137,111,108,0,3,"UPyD",0
37,"37136",652,440,435,3,5,"UPyD",0
46,"46093",2118,1647,1624,4,23,"UPyD",3
50,"50014",147,94,94,0,0,"UPyD",1
22,"22047",243,205,203,2,2,"UPyD",0
46,"46015",7244,5615,5560,40,55,"UPyD",4
11,"11007",17964,10038,9856,197,182,"UPyD",19
22,"22173",232,152,152,3,0,"UPyD",0
31,"31905",2843,1983,1966,15,17,"UPyD",5
5,"5054",1224,935,924,8,11,"UPyD",3
4,"4045",1757,1309,1288,6,21,"UPyD",1
26,"26092",107,92,90,0,2,"UPyD",0
9,"9270",163,115,115,0,0,"UPyD",1
16,"16011",27,22,22,1,0,"UPyD",0
10,"10052",182,130,129,0,1,"UPyD",0
9,"9272",282,210,206,3,4,"UPyD",0
28,"28062",292,231,226,1,5,"UPyD",0
22,"22048",12598,8790,8731,91,59,"UPyD",16
12,"12128",1393,1090,1072,10,18,"UPyD",0
18,"18057",5305,3827,3791,27,36,"UPyD",8
33,"33028",1276,649,641,4,8,"UPyD",1
22,"22049",78,64,64,0,0,"UPyD",0
4,"4046",858,609,599,7,10,"UPyD",0
7,"7038",2010,1424,1412,18,12,"UPyD",3
23,"23029",843,628,624,2,4,"UPyD",0
23,"23028",6220,4409,4369,23,40,"UPyD",9
28,"28063",258,194,193,1,1,"UPyD",0
34,"34213",57,45,44,1,1,"UPyD",0
36,"36030",4175,2832,2785,27,47,"UPyD",9
31,"31171",680,495,486,8,9,"UPyD",2
19,"19335",55,47,47,0,0,"UPyD",0
24,"24067",623,388,384,0,4,"UPyD",0
31,"31072",5279,3734,3679,40,55,"UPyD",4
5,"5201",523,419,418,1,1,"UPyD",3
36,"36031",558,465,459,7,6,"UPyD",1
5,"5204",603,456,451,1,5,"UPyD",1
37,"37350",420,318,314,5,4,"UPyD",0
39,"39022",980,721,713,2,8,"UPyD",2
22,"22050",88,77,77,0,0,"UPyD",0
37,"37225",103,89,86,0,3,"UPyD",0
5,"5058",78,49,48,0,1,"UPyD",1
7,"7040",280477,173945,172463,1359,1482,"UPyD",590
28,"28132",11685,8130,8062,56,68,"UPyD",25
26,"26095",100,83,82,0,1,"UPyD",0
19,"19224",93,87,87,0,0,"UPyD",0
42,"42008",57,43,43,0,0,"UPyD",0
30,"30021",9099,6095,6045,20,50,"UPyD",16
45,"45128",2502,1680,1668,6,12,"UPyD",1
40,"40143",86,75,74,0,1,"UPyD",2
39,"39023",6330,4737,4672,25,65,"UPyD",12
3,"3095",4579,3489,3459,25,30,"UPyD",4
22,"22051",100,81,81,0,0,"UPyD",0
23,"23031",747,637,619,0,18,"UPyD",0
33,"33031",35120,22295,22024,271,271,"UPyD",28
37,"37226",155,123,123,2,0,"UPyD",0
48,"48064",606,447,445,4,2,"UPyD",0
16,"16061",969,771,764,14,7,"UPyD",0
47,"47128",60,52,51,0,1,"UPyD",0
9,"9141",616,485,483,5,2,"UPyD",4
22,"22177",98,75,75,0,0,"UPyD",0
5,"5256",112,100,98,1,2,"UPyD",0
37,"37353",126,97,97,1,0,"UPyD",0
42,"42009",78,63,63,0,0,"UPyD",1
34,"34069",2266,1666,1637,11,29,"UPyD",3
3,"3097",993,822,812,6,10,"UPyD",1
16,"16063",97,85,84,1,1,"UPyD",0
24,"24005",378,260,257,2,3,"UPyD",0
41,"41090",3523,2576,2512,13,64,"UPyD",6
48,"48065",3281,2271,2237,8,34,"UPyD",1
5,"5208",40,36,36,0,0,"UPyD",0
9,"9191",38,28,27,0,1,"UPyD",0
21,"21058",2609,1883,1856,23,27,"UPyD",1
9,"9060",145,114,113,2,1,"UPyD",0
46,"46176",2017,1358,1349,5,9,"UPyD",2
37,"37354",5240,3823,3771,39,52,"UPyD",22
12,"12103",91,69,67,0,2,"UPyD",0
21,"21018",1769,1120,1095,11,25,"UPyD",1
14,"14019",6464,4967,4909,49,58,"UPyD",9
26,"26099",1264,1003,991,9,12,"UPyD",0
31,"31077",5352,3908,3848,41,60,"UPyD",4
9,"9279",174,131,130,3,1,"UPyD",0
40,"40019",36,31,31,1,0,"UPyD",0
23,"23034",2540,1957,1934,14,23,"UPyD",0
36,"36036",2518,1827,1801,18,26,"UPyD",2
47,"47048",188,144,144,1,0,"UPyD",0
16,"16065",388,320,314,2,6,"UPyD",1
5,"5210",87,70,69,0,1,"UPyD",0
49,"49178",705,496,487,4,9,"UPyD",0
47,"47130",96,72,72,0,0,"UPyD",0
28,"28135",948,713,709,4,4,"UPyD",1
5,"5211",459,345,343,1,2,"UPyD",0
14,"14020",387,269,264,2,5,"UPyD",0
42,"42013",34,28,27,0,1,"UPyD",0
49,"49102",196,143,139,2,4,"UPyD",1
45,"45132",2197,1645,1632,14,13,"UPyD",6
16,"16213",36,34,34,0,0,"UPyD",0
9,"9023",1102,818,811,11,7,"UPyD",3
22,"22055",320,243,238,2,5,"UPyD",0
5,"5065",471,394,392,4,2,"UPyD",1
46,"46021",23649,17291,17153,100,138,"UPyD",46
21,"21021",12254,7339,7244,78,95,"UPyD",12
5,"5212",231,164,163,2,1,"UPyD",0
16,"16066",2325,1788,1745,19,43,"UPyD",2
19,"19230",505,360,357,3,3,"UPyD",5
9,"9151",448,362,360,6,2,"UPyD",1
50,"50212",40,36,36,0,0,"UPyD",0
33,"33035",11284,7681,7618,70,63,"UPyD",8
48,"48068",1550,1130,1118,12,12,"UPyD",0
22,"22184",184,155,155,3,0,"UPyD",0
9,"9196",149,103,103,1,0,"UPyD",0
46,"46100",286,232,230,1,2,"UPyD",0
3,"3100",503,440,437,0,3,"UPyD",1
26,"26102",6111,4486,4435,28,51,"UPyD",12
37,"37359",184,130,129,0,1,"UPyD",1
31,"31047",254,191,188,2,3,"UPyD",0
28,"28070",117,91,91,0,0,"UPyD",0
37,"37108",99,79,78,0,1,"UPyD",1
34,"34224",47,37,37,1,0,"UPyD",0
49,"49183",100,77,77,2,0,"UPyD",1
31,"31180",212,154,154,5,0,"UPyD",0
45,"45034",1353,1082,1078,6,4,"UPyD",2
9,"9152",257,183,183,0,0,"UPyD",0
3,"3101",4808,3627,3580,22,47,"UPyD",4
21,"21023",2124,1298,1264,7,34,"UPyD",2
49,"49105",150,109,108,0,1,"UPyD",1
9,"9026",386,301,300,0,1,"UPyD",1
16,"16070",30,26,26,1,0,"UPyD",0
1,"1047",968,673,668,5,5,"UPyD",1
50,"50120",52,40,40,1,0,"UPyD",0
24,"24010",8386,5708,5632,60,76,"UPyD",9
40,"40110",349,265,263,3,2,"UPyD",1
37,"37361",86,66,66,0,0,"UPyD",0
40,"40154",20,15,15,0,0,"UPyD",0
49,"49065",1103,836,818,2,18,"UPyD",1
24,"24145",654,463,461,2,2,"UPyD",0
42,"42151",34,26,26,0,0,"UPyD",0
33,"33038",2303,1584,1559,13,25,"UPyD",4
26,"26035",17,12,11,0,1,"UPyD",0
22,"22060",1164,858,850,3,8,"UPyD",0
18,"18071",5579,4044,3985,37,59,"UPyD",7
12,"12138",19061,13010,12847,129,163,"UPyD",19
22,"22188",82,60,59,6,1,"UPyD",0
49,"49108",466,346,344,0,2,"UPyD",0
6,"6086",1221,814,799,2,15,"UPyD",0
47,"47052",6576,4988,4944,40,44,"UPyD",29
10,"10068",735,570,557,2,13,"UPyD",0
37,"37363",118,88,87,0,1,"UPyD",0
9,"9425",517,384,378,0,6,"UPyD",1
19,"19121",246,199,194,1,5,"UPyD",0
28,"28141",5823,4297,4262,29,35,"UPyD",21
40,"40028",105,91,90,2,1,"UPyD",0
3,"3136",441,338,334,0,4,"UPyD",0
5,"5901",263,182,180,2,2,"UPyD",0
20,"20010",1499,992,986,9,6,"UPyD",0
5,"5074",686,564,558,5,6,"UPyD",1
36,"36043",4747,3210,3162,20,48,"UPyD",6
37,"37239",217,185,183,3,2,"UPyD",1
19,"19001",49,42,42,0,0,"UPyD",0
22,"22062",167,116,116,1,0,"UPyD",0
37,"37364",820,607,598,6,9,"UPyD",0
4,"4058",354,261,259,1,2,"UPyD",0
19,"19122",96,68,68,1,0,"UPyD",0
9,"9292",87,75,73,1,2,"UPyD",0
10,"10070",718,546,542,1,4,"UPyD",0
3,"3105",5373,3911,3828,15,83,"UPyD",6
45,"45038",3356,2376,2350,15,26,"UPyD",7
29,"29049",2962,2132,2110,5,22,"UPyD",2
10,"10071",139,96,94,0,2,"UPyD",0
26,"26005",2381,1598,1577,23,21,"UPyD",0
28,"28144",6010,4676,4644,22,32,"UPyD",14
5,"5221",351,254,250,2,4,"UPyD",1
40,"40030",473,369,363,3,6,"UPyD",2
12,"12045",345,268,259,1,9,"UPyD",0
19,"19002",69,58,57,0,1,"UPyD",0
24,"24047",783,545,540,2,5,"UPyD",1
12,"12141",101,83,83,0,0,"UPyD",0
41,"41034",23070,14805,14625,186,180,"UPyD",43
19,"19003",42,35,34,1,1,"UPyD",0
37,"37366",43,32,32,0,0,"UPyD",0
16,"16079",30,19,18,0,1,"UPyD",0
28,"28075",5621,4186,4148,26,38,"UPyD",13
3,"3015",12566,9257,9177,39,80,"UPyD",24
46,"46027",943,780,771,5,9,"UPyD",0
33,"33042",4306,2988,2970,35,18,"UPyD",9
45,"45141",884,700,689,3,11,"UPyD",1
4,"4060",445,348,345,5,3,"UPyD",1
5,"5224",102,86,84,3,2,"UPyD",0
6,"6092",577,415,405,3,10,"UPyD",0
16,"16082",291,213,212,0,1,"UPyD",0
10,"10075",253,167,166,1,1,"UPyD",0
37,"37023",1413,1072,1060,5,12,"UPyD",3
12,"12081",608,486,480,5,6,"UPyD",3
50,"50030",215,141,140,1,1,"UPyD",9
33,"33043",683,446,441,2,5,"UPyD",3
28,"28076",398,325,317,1,8,"UPyD",1
5,"5225",372,285,281,1,4,"UPyD",0
45,"45042",187,140,140,0,0,"UPyD",0
40,"40160",102,71,70,1,1,"UPyD",0
1,"1055",838,538,527,8,11,"UPyD",0
34,"34233",130,107,107,1,0,"UPyD",0
9,"9430",22,18,17,0,1,"UPyD",2
16,"16236",910,656,651,4,5,"UPyD",0
5,"5129",125,88,87,2,1,"UPyD",1
42,"42158",103,76,76,0,0,"UPyD",0
33,"33044",178278,125469,124554,1124,915,"UPyD",398
22,"22199",7000,4737,4688,104,49,"UPyD",10
19,"19127",89,64,64,0,0,"UPyD",0
40,"40161",36,28,28,2,0,"UPyD",0
12,"12114",198,144,144,1,0,"UPyD",0
19,"19240",51,44,42,0,2,"UPyD",1
24,"24051",423,309,307,0,2,"UPyD",2
31,"31089",242,172,170,1,2,"UPyD",6
29,"29053",1699,1105,1091,14,14,"UPyD",5
36,"36049",6804,4960,4860,36,100,"UPyD",9
34,"34234",71,52,50,0,2,"UPyD",0
45,"45144",783,620,618,3,2,"UPyD",1
48,"48078",38617,26366,26212,158,154,"UPyD",33
45,"45045",1318,905,888,5,17,"UPyD",0
26,"26076",129,107,106,0,1,"UPyD",0
40,"40163",53,44,43,0,1,"UPyD",0
34,"34088",246,193,186,1,7,"UPyD",0
1,"1057",240,201,200,1,1,"UPyD",0
34,"34045",76,66,66,2,0,"UPyD",0
31,"31190",45,34,32,2,2,"UPyD",0
40,"40036",515,421,410,3,11,"UPyD",3
33,"33045",4487,3057,2999,28,58,"UPyD",10
7,"7061",9819,6351,6280,53,71,"UPyD",11
37,"37247",196,163,162,3,1,"UPyD",0
20,"20903",4330,2756,2734,28,22,"UPyD",3
6,"6097",2362,1750,1727,7,23,"UPyD",5
10,"10217",526,404,402,1,2,"UPyD",0
34,"34089",155,124,124,2,0,"UPyD",1
50,"50034",826,567,563,5,4,"UPyD",1
9,"9038",119,100,100,0,0,"UPyD",20
16,"16087",208,179,177,5,2,"UPyD",0
50,"50223",920,712,701,4,11,"UPyD",0
49,"49079",106,93,92,1,1,"UPyD",0
9,"9304",199,157,155,3,2,"UPyD",0
20,"20018",11064,6719,6690,41,29,"UPyD",6
16,"16240",102,78,78,0,0,"UPyD",0
24,"24155",471,388,384,6,4,"UPyD",0
19,"19244",82,65,64,1,1,"UPyD",0
24,"24054",430,314,313,1,1,"UPyD",0
29,"29056",1098,757,750,5,7,"UPyD",0
30,"30038",15411,10847,10767,46,80,"UPyD",26
36,"36052",7292,4999,4907,45,92,"UPyD",4
46,"46110",21228,15563,15443,86,120,"UPyD",44
19,"19009",259,200,195,6,5,"UPyD",0
37,"37124",212,146,144,1,2,"UPyD",0
46,"46032",5653,4402,4361,33,41,"UPyD",8
49,"49199",254,193,189,3,4,"UPyD",0
29,"29057",357,241,238,1,3,"UPyD",1
13,"13007",1271,993,977,8,16,"UPyD",1
37,"37250",356,229,228,0,1,"UPyD",1
20,"20020",125,71,69,3,2,"UPyD",0
22,"22203",83,67,67,1,0,"UPyD",1
37,"37375",700,578,570,4,8,"UPyD",0
46,"46189",467,393,390,2,3,"UPyD",0
5,"5087",134,87,85,1,2,"UPyD",4
10,"10084",1345,888,875,4,13,"UPyD",3
9,"9172",129,103,101,1,2,"UPyD",2
22,"22204",1114,745,739,12,6,"UPyD",2
31,"31193",1426,1024,1013,13,11,"UPyD",0
13,"13008",438,299,295,0,4,"UPyD",1
13,"13009",1439,1115,1098,9,17,"UPyD",0
50,"50133",113,80,80,4,0,"UPyD",0
3,"3021",5613,4570,4500,26,70,"UPyD",5
45,"45049",433,305,304,1,1,"UPyD",0
9,"9173",124,100,99,2,1,"UPyD",0
12,"12055",104,83,82,3,1,"UPyD",0
16,"16092",158,125,125,1,0,"UPyD",0
22,"22075",125,83,83,1,0,"UPyD",0
5,"5089",485,384,376,0,8,"UPyD",5
49,"49039",338,245,239,3,6,"UPyD",1
9,"9259",230,186,186,5,0,"UPyD",1
1,"1062",313,211,210,2,1,"UPyD",0
13,"13010",883,646,634,3,12,"UPyD",0
37,"37127",214,154,151,1,3,"UPyD",0
42,"42031",26,21,21,0,0,"UPyD",0
5,"5090",77,68,68,1,0,"UPyD",0
26,"26119",197,156,155,4,1,"UPyD",0
7,"7902",1064,685,664,15,21,"UPyD",0
10,"10087",1687,1218,1212,6,6,"UPyD",0
40,"40171",32,23,23,0,0,"UPyD",0
42,"42166",59,45,45,0,0,"UPyD",0
19,"19015",84,69,68,0,1,"UPyD",0
46,"46113",2457,1804,1782,6,22,"UPyD",3
31,"31195",182,130,128,0,2,"UPyD",0
10,"10088",204,131,128,1,3,"UPyD",0
50,"50039",491,392,390,2,2,"UPyD",2
10,"10905",656,446,439,2,7,"UPyD",2
9,"9309",301,224,220,0,4,"UPyD",1
37,"37379",174,133,131,1,2,"UPyD",0
40,"40045",109,85,85,2,0,"UPyD",1
21,"21043",1871,1310,1285,9,25,"UPyD",3
4,"4069",4687,3471,3437,27,34,"UPyD",7
6,"6106",423,274,272,5,2,"UPyD",0
16,"16141",143,102,102,0,0,"UPyD",0
41,"41045",5756,3988,3924,53,64,"UPyD",12
3,"3025",1270,950,941,2,9,"UPyD",1
10,"10089",1359,882,868,3,14,"UPyD",2
4,"4100",8768,5390,5353,32,37,"UPyD",12
50,"50136",575,414,410,2,4,"UPyD",0
18,"18096",341,227,224,3,3,"UPyD",0
22,"22078",438,319,316,3,3,"UPyD",1
31,"31197",69,56,56,2,0,"UPyD",0
34,"34099",60,48,48,0,0,"UPyD",0
28,"28155",506,416,411,0,5,"UPyD",0
36,"36059",4882,3137,3085,28,52,"UPyD",3
50,"50137",1011,772,764,8,8,"UPyD",0
31,"31198",37,25,25,0,0,"UPyD",0
19,"19142",265,182,180,3,2,"UPyD",0
49,"49087",521,322,318,0,4,"UPyD",1
5,"5096",80,60,59,0,1,"UPyD",0
21,"21045",249,180,178,3,2,"UPyD",0
46,"46193",8788,6925,6871,50,54,"UPyD",10
6,"6108",2275,1567,1527,11,40,"UPyD",3
42,"42036",50,41,41,1,0,"UPyD",0
5,"5241",3063,2056,2032,15,24,"UPyD",4
18,"18098",6135,4206,4161,21,45,"UPyD",10
16,"16251",1849,1381,1366,7,15,"UPyD",4
42,"42172",29,26,26,0,0,"UPyD",0
23,"23060",19003,12924,12812,102,112,"UPyD",29
5,"5097",475,317,313,0,4,"UPyD",3
45,"45054",3959,2882,2848,12,34,"UPyD",2
46,"46253",115,82,82,0,0,"UPyD",1
45,"45088",2115,1351,1338,4,13,"UPyD",1
26,"26053",208,168,163,4,5,"UPyD",0
9,"9050",68,56,55,1,1,"UPyD",0
40,"40216",759,574,571,3,3,"UPyD",1
31,"31001",88,62,62,0,0,"UPyD",0
37,"37300",566,398,395,0,3,"UPyD",1
19,"19143",1738,1306,1297,12,9,"UPyD",5
28,"28002",3007,2091,2074,14,17,"UPyD",5
26,"26124",807,649,639,7,10,"UPyD",0
9,"9315",378,245,243,1,2,"UPyD",0
42,"42038",36,28,28,1,0,"UPyD",0
12,"12061",373,285,282,3,3,"UPyD",2
47,"47066",1268,981,977,12,4,"UPyD",3
13,"13071",39454,26316,26107,183,209,"UPyD",57
42,"42218",82,55,55,0,0,"UPyD",0
34,"34154",74,55,53,1,2,"UPyD",0
28,"28096",18354,13310,13205,68,105,"UPyD",51
34,"34103",98,77,76,0,1,"UPyD",0
40,"40179",626,503,493,2,10,"UPyD",0
28,"28158",665,537,533,4,4,"UPyD",3
6,"6112",393,323,321,2,2,"UPyD",0
19,"19146",41,35,32,0,3,"UPyD",0
5,"5101",292,240,236,1,4,"UPyD",0
20,"20028",2237,1373,1365,11,8,"UPyD",0
16,"16255",140,122,121,0,1,"UPyD",0
10,"10095",338,259,251,1,8,"UPyD",0
3,"3122",42425,30153,29954,154,199,"UPyD",85
10,"10096",3408,2440,2391,12,49,"UPyD",1
16,"16101",154,132,132,0,0,"UPyD",0
6,"6113",2721,2004,1971,7,33,"UPyD",3
46,"46255",3174,2448,2424,22,24,"UPyD",5
24,"24064",1523,1101,1087,3,14,"UPyD",2
40,"40094",374,279,276,2,3,"UPyD",1
19,"19291",1191,879,869,3,10,"UPyD",1
19,"19022",625,476,469,3,7,"UPyD",0
50,"50141",109,90,90,1,0,"UPyD",0
19,"19256",43,36,36,0,0,"UPyD",0
50,"50173",182,132,131,1,1,"UPyD",0
42,"42041",34,25,25,0,0,"UPyD",0
47,"47068",34,26,26,0,0,"UPyD",1
48,"48090",6001,4345,4295,28,50,"UPyD",8
11,"11040",397,307,292,1,15,"UPyD",1
46,"46223",7801,5950,5899,34,51,"UPyD",11
46,"46197",1942,1527,1514,5,13,"UPyD",2
36,"36028",4102,2913,2868,17,45,"UPyD",4
22,"22084",535,403,399,4,4,"UPyD",0
40,"40181",4233,3260,3219,23,41,"UPyD",12
39,"39051",66,57,57,0,0,"UPyD",0
11,"11008",17471,10952,10812,128,140,"UPyD",37
19,"19148",45,32,31,0,1,"UPyD",0
37,"37004",30,21,21,0,0,"UPyD",0
28,"28006",78966,59065,58698,267,367,"UPyD",273
45,"45158",2514,1777,1760,11,17,"UPyD",1
9,"9449",86,68,66,0,2,"UPyD",0
21,"21053",3316,2141,2107,17,34,"UPyD",5
26,"26128",105,81,81,1,0,"UPyD",0
9,"9184",5,4,4,0,0,"UPyD",0
49,"49095",291,221,220,0,1,"UPyD",0
50,"50143",566,394,391,6,3,"UPyD",1
49,"49219",7464,4988,4914,53,74,"UPyD",6
22,"22085",104,86,86,0,0,"UPyD",0
26,"26166",141,124,122,0,2,"UPyD",0
28,"28007",124592,94222,93521,491,701,"UPyD",357
34,"34109",59,48,48,0,0,"UPyD",0
5,"5252",64,45,45,1,0,"UPyD",0
3,"3032",108,91,90,1,1,"UPyD",0
13,"13027",3415,2380,2354,4,26,"UPyD",2
2,"2009",19660,14256,14116,127,140,"UPyD",28
23,"23067",2460,1831,1805,11,26,"UPyD",0
26,"26129",967,775,766,6,9,"UPyD",0
9,"9057",145,108,108,0,0,"UPyD",0
50,"50048",34,29,29,0,0,"UPyD",0
28,"28162",2617,2029,2016,6,13,"UPyD",10
45,"45061",2447,1703,1689,12,14,"UPyD",1
13,"13028",10418,8075,7976,52,99,"UPyD",37
45,"45062",1112,878,867,4,11,"UPyD",2
9,"9189",125,90,87,2,3,"UPyD",0
5,"5108",47,35,35,0,0,"UPyD",0
47,"47071",410,324,321,4,3,"UPyD",3
40,"40057",1456,1154,1148,7,6,"UPyD",0
2,"2011",632,520,516,1,4,"UPyD",0
9,"9058",390,283,279,1,4,"UPyD",4
20,"20034",3145,2026,2014,14,12,"UPyD",2
5,"5254",190,160,159,0,1,"UPyD",0
37,"37143",389,301,300,6,1,"UPyD",0
5,"5109",450,352,339,4,13,"UPyD",0
40,"40058",325,277,276,4,1,"UPyD",0
47,"47155",3228,2277,2254,18,23,"UPyD",5
18,"18154",1007,664,660,2,4,"UPyD",1
40,"40103",159,125,123,2,2,"UPyD",1
10,"10104",5119,3633,3585,15,48,"UPyD",5
22,"22221",84,58,58,0,0,"UPyD",0
22,"22088",153,110,110,2,0,"UPyD",0
12,"12070",522,406,401,0,5,"UPyD",0
45,"45163",8298,5942,5855,28,87,"UPyD",8
49,"49057",109,85,83,1,2,"UPyD",0
28,"28010",9963,7745,7688,25,57,"UPyD",36
19,"19261",37,25,24,0,1,"UPyD",1
18,"18021",17485,11800,11669,95,131,"UPyD",26
47,"47182",1323,977,967,8,10,"UPyD",0
45,"45097",1046,839,834,4,5,"UPyD",1
47,"47156",162,136,133,0,3,"UPyD",0
4,"4081",355,287,287,0,0,"UPyD",0
5,"5112",97,71,70,2,1,"UPyD",0
37,"37270",189,152,151,2,1,"UPyD",0
40,"40060",82,61,61,0,0,"UPyD",0
48,"48005",115,63,61,0,2,"UPyD",0
35,"35007",511,316,309,2,7,"UPyD",0
37,"37145",259,190,189,2,1,"UPyD",0
3,"3130",48,25,25,0,0,"UPyD",0
9,"9194",2020,1472,1459,9,13,"UPyD",8
21,"21059",221,166,163,5,3,"UPyD",0
31,"31011",693,459,456,8,3,"UPyD",1
46,"46125",847,689,684,5,5,"UPyD",0
9,"9062",51,40,39,0,1,"UPyD",0
24,"24071",1006,745,734,10,11,"UPyD",2
12,"12072",1101,929,911,11,18,"UPyD",2
14,"14048",1207,884,869,13,15,"UPyD",0
39,"39057",2330,1671,1645,7,26,"UPyD",3
48,"48097",1297,900,894,8,6,"UPyD",0
31,"31111",95,65,65,2,0,"UPyD",0
37,"37055",123,98,94,0,4,"UPyD",0
48,"48901",4839,3459,3426,32,33,"UPyD",2
28,"28166",320,254,251,2,3,"UPyD",1
39,"39058",810,559,557,2,2,"UPyD",1
33,"33004",66857,46390,45960,426,430,"UPyD",103
50,"50273",30,22,22,0,0,"UPyD",1
12,"12073",152,119,117,0,2,"UPyD",1
37,"37013",119,79,76,0,3,"UPyD",0
42,"42189",60,46,45,0,1,"UPyD",0
5,"5116",109,89,89,1,0,"UPyD",0
50,"50150",649,402,397,2,5,"UPyD",1
2,"2016",569,413,410,6,3,"UPyD",1
20,"20039",2111,1480,1472,14,8,"UPyD",1
22,"22094",101,74,74,1,0,"UPyD",0
28,"28012",887,664,661,2,3,"UPyD",4
26,"26033",170,132,129,1,3,"UPyD",0
50,"50055",3611,2445,2407,22,38,"UPyD",3
34,"34029",714,587,570,3,17,"UPyD",1
24,"24074",97,75,75,1,0,"UPyD",0
46,"46204",6681,5256,5202,32,54,"UPyD",14
23,"23075",3298,2564,2541,18,23,"UPyD",2
49,"49227",315,230,228,2,2,"UPyD",0
19,"19159",93,78,77,0,1,"UPyD",0
23,"23076",827,640,630,1,10,"UPyD",3
16,"16117",1040,787,777,4,10,"UPyD",1
13,"13039",14366,10282,10185,81,97,"UPyD",24
11,"11017",3212,2233,2203,39,30,"UPyD",4
18,"18027",2570,1711,1700,13,11,"UPyD",0
45,"45068",160,126,126,0,0,"UPyD",2
37,"37150",41,34,34,0,0,"UPyD",0
40,"40065",493,373,373,3,0,"UPyD",1
19,"19267",19,13,13,0,0,"UPyD",0
45,"45202",3894,2776,2744,14,32,"UPyD",5
6,"6129",577,438,429,0,9,"UPyD",0
14,"14051",1397,1018,1000,2,18,"UPyD",2
9,"9466",129,97,97,1,0,"UPyD",0
46,"46128",1597,1290,1250,5,40,"UPyD",2
14,"14023",2021,1660,1639,8,21,"UPyD",0
23,"23079",3717,2825,2801,28,24,"UPyD",1
5,"5266",100,86,86,0,0,"UPyD",1
49,"49229",126,93,93,0,0,"UPyD",0
50,"50153",935,713,708,6,5,"UPyD",0
10,"10113",2338,1679,1638,9,41,"UPyD",1
9,"9335",88,68,68,0,0,"UPyD",0
48,"48904",3511,2625,2600,22,25,"UPyD",2
16,"16026",82,62,61,2,1,"UPyD",0
33,"33068",1093,645,641,4,4,"UPyD",0
26,"26141",113,87,82,0,5,"UPyD",0
48,"48011",9673,6468,6423,45,45,"UPyD",2
5,"5267",101,72,70,0,2,"UPyD",0
10,"10160",229,190,189,2,1,"UPyD",0
16,"16166",243,176,174,1,2,"UPyD",0
37,"37194",251,196,195,1,1,"UPyD",0
10,"10114",953,665,660,3,5,"UPyD",0
50,"50247",823,588,581,3,7,"UPyD",1
4,"4087",182,135,135,0,0,"UPyD",0
47,"47079",58,48,47,0,1,"UPyD",0
31,"31116",62,51,50,1,1,"UPyD",0
47,"47162",74,60,60,0,0,"UPyD",0
26,"26070",183,153,153,1,0,"UPyD",0
49,"49109",619,483,483,11,0,"UPyD",0
18,"18121",129,98,98,1,0,"UPyD",0
10,"10116",3749,2726,2670,21,56,"UPyD",4
47,"47188",111,88,88,3,0,"UPyD",1
12,"12140",1143,939,930,6,9,"UPyD",0
37,"37020",430,326,321,1,5,"UPyD",1
31,"31117",620,383,375,3,8,"UPyD",0
24,"24079",906,664,658,9,6,"UPyD",0
26,"26143",220,175,173,1,2,"UPyD",0
22,"22230",284,216,216,1,0,"UPyD",1
49,"49232",96,74,74,1,0,"UPyD",1
6,"6134",547,335,332,1,3,"UPyD",3
31,"31217",321,226,223,1,3,"UPyD",0
3,"3138",3145,2310,2275,9,35,"UPyD",6
48,"48013",79716,53419,52997,345,422,"UPyD",101
40,"40198",24,19,19,0,0,"UPyD",0
37,"37281",36,33,31,0,2,"UPyD",0
26,"26038",89,68,67,0,1,"UPyD",2
9,"9473",85,70,65,1,5,"UPyD",0
21,"21069",1702,1167,1149,6,18,"UPyD",2
50,"50060",172,128,127,1,1,"UPyD",0
47,"47163",290,230,228,3,2,"UPyD",0
37,"37021",79,60,60,0,0,"UPyD",0
37,"37157",78,63,62,0,1,"UPyD",0
19,"19271",46,39,39,0,0,"UPyD",0
37,"37282",204,149,148,1,1,"UPyD",0
49,"49234",412,328,324,0,4,"UPyD",0
31,"31119",39,26,26,0,0,"UPyD",0
37,"37158",246,183,183,0,0,"UPyD",1
46,"46209",1933,1445,1415,5,30,"UPyD",3
4,"4090",304,238,234,0,4,"UPyD",0
5,"5126",70,56,55,0,1,"UPyD",0
34,"34130",212,164,163,1,1,"UPyD",1
40,"40200",40,31,31,0,0,"UPyD",0
45,"45075",143,109,108,0,1,"UPyD",0
22,"22106",22,14,14,0,0,"UPyD",2
45,"45074",414,327,323,1,4,"UPyD",0
34,"34131",59,52,51,0,1,"UPyD",0
31,"31220",744,583,579,8,4,"UPyD",1
34,"34179",28,21,20,0,1,"UPyD",0
41,"41002",1473,1038,1014,9,24,"UPyD",0
24,"24182",416,294,290,2,4,"UPyD",1
16,"16128",63,50,50,0,0,"UPyD",0
6,"6138",1047,727,715,5,12,"UPyD",0
24,"24082",858,629,614,8,15,"UPyD",1
31,"31021",62,39,38,0,1,"UPyD",0
50,"50251",8262,5946,5872,44,74,"UPyD",7
50,"50159",665,512,507,2,5,"UPyD",1
9,"9209",4473,3223,3192,20,31,"UPyD",4
13,"13051",346,264,264,1,0,"UPyD",0
9,"9073",926,691,686,4,5,"UPyD",3
37,"37201",262,187,186,1,1,"UPyD",0
21,"21073",1862,1125,1109,8,16,"UPyD",2
10,"10122",218,156,153,3,3,"UPyD",0
34,"34132",114,89,86,0,3,"UPyD",0
26,"26042",834,635,625,5,10,"UPyD",0
33,"33074",3484,2298,2274,24,24,"UPyD",4
49,"49076",321,217,217,2,0,"UPyD",1
45,"45077",556,428,427,1,1,"UPyD",0
19,"19047",64,55,55,0,0,"UPyD",0
41,"41070",6032,4312,4258,44,54,"UPyD",8
9,"9480",110,90,90,1,0,"UPyD",0
6,"6004",1600,1212,1207,2,5,"UPyD",1
22,"22235",98,76,76,1,0,"UPyD",0
31,"31056",174,121,120,0,1,"UPyD",0
48,"48911",380,276,272,1,4,"UPyD",0
28,"28021",554,370,364,3,6,"UPyD",4
46,"46212",1620,1150,1124,9,26,"UPyD",1
9,"9347",143,117,115,2,2,"UPyD",0
9,"9211",1441,1056,1039,9,17,"UPyD",1
28,"28176",12491,9723,9667,37,56,"UPyD",37
47,"47006",190,136,135,1,1,"UPyD",0
41,"41071",5586,3724,3661,22,63,"UPyD",6
49,"49239",663,458,448,3,10,"UPyD",0
11,"11027",67913,45219,44833,454,386,"UPyD",177
37,"37027",228,172,171,0,1,"UPyD",0
48,"48018",869,522,522,2,0,"UPyD",0
46,"46213",15409,10924,10805,97,119,"UPyD",32
31,"31024",99,42,42,0,0,"UPyD",0
22,"22239",88,72,72,0,0,"UPyD",0
6,"6143",3360,2353,2321,12,32,"UPyD",1
28,"28050",4076,2860,2839,21,21,"UPyD",13
37,"37029",209,137,135,1,2,"UPyD",0
5,"5133",66,53,53,0,0,"UPyD",0
26,"26045",12,12,12,0,0,"UPyD",0
19,"19049",10,10,9,0,1,"UPyD",0
9,"9214",672,427,427,4,0,"UPyD",2
42,"42205",89,71,71,2,0,"UPyD",1
6,"6144",556,431,425,0,6,"UPyD",1
9,"9077",34,27,27,0,0,"UPyD",0
24,"24087",631,470,466,7,4,"UPyD",0
39,"39070",144,96,94,2,2,"UPyD",0
28,"28088",261,178,178,0,0,"UPyD",0
42,"42206",8,8,8,1,0,"UPyD",0
47,"47034",72,58,58,3,0,"UPyD",0
5,"5134",48,38,38,0,0,"UPyD",0
26,"26151",448,370,368,1,2,"UPyD",0
50,"50256",83,53,53,0,0,"UPyD",0
29,"29079",2416,1788,1764,10,24,"UPyD",2
6,"6008",632,525,519,2,6,"UPyD",1
41,"41074",3012,2282,2257,18,25,"UPyD",1
37,"37030",85,66,66,0,0,"UPyD",2
20,"20053",4774,2973,2953,13,20,"UPyD",3
45,"45181",2315,1674,1640,7,34,"UPyD",2
29,"29080",6676,4469,4419,35,50,"UPyD",6
6,"6146",1084,838,830,1,8,"UPyD",0
22,"22113",495,370,368,4,2,"UPyD",0
37,"37291",272,207,206,0,1,"UPyD",0
46,"46215",1436,1154,1143,5,11,"UPyD",0
10,"10129",365,275,271,0,4,"UPyD",0
49,"49243",111,94,93,0,1,"UPyD",0
45,"45082",1224,1020,1011,8,9,"UPyD",0
6,"6147",354,268,268,0,0,"UPyD",0
19,"19174",109,80,79,0,1,"UPyD",0
34,"34140",107,67,67,0,0,"UPyD",0
16,"16137",54,32,31,1,1,"UPyD",0
13,"13061",5702,3867,3822,28,45,"UPyD",5
26,"26047",1947,1578,1563,8,15,"UPyD",2
28,"28025",420,320,315,4,5,"UPyD",0
37,"37293",115,84,84,1,0,"UPyD",1
9,"9353",76,57,56,1,1,"UPyD",2
34,"34003",164,122,119,0,3,"UPyD",1
19,"19175",32,28,28,0,0,"UPyD",0
26,"26153",13,12,11,0,1,"UPyD",0
37,"37032",548,401,399,0,2,"UPyD",0
18,"18182",1906,1298,1288,4,10,"UPyD",3
49,"49244",43,29,29,0,0,"UPyD",0
35,"35022",48603,29443,29042,160,401,"UPyD",49
46,"46060",9369,7052,6993,42,59,"UPyD",13
34,"34141",177,149,145,2,4,"UPyD",0
24,"24190",165,123,121,1,2,"UPyD",0
50,"50258",54,34,34,0,0,"UPyD",0
22,"22245",309,267,261,1,6,"UPyD",0
49,"49003",900,612,599,5,13,"UPyD",1
2,"2037",22865,14632,14477,91,155,"UPyD",23
34,"34004",5608,4120,4063,43,57,"UPyD",8
28,"28181",20386,16155,16069,57,86,"UPyD",56
28,"28092",151841,110916,109954,582,962,"UPyD",381
41,"41044",7423,5273,5241,34,32,"UPyD",23
37,"37170",1449,994,971,3,23,"UPyD",3
50,"50167",233,183,178,1,5,"UPyD",0
4,"4004",425,329,329,0,0,"UPyD",1
47,"47118",168,127,127,2,0,"UPyD",0
2,"2038",281,223,223,0,0,"UPyD",0
19,"19177",76,61,59,0,2,"UPyD",0
47,"47172",144,124,122,0,2,"UPyD",0
40,"40212",27,23,22,2,1,"UPyD",0
2,"2079",2875,2209,2181,12,28,"UPyD",4
37,"37171",409,317,310,2,7,"UPyD",0
48,"48024",995,757,754,7,3,"UPyD",0
49,"49124",253,174,169,1,5,"UPyD",1
12,"12091",177,113,112,0,1,"UPyD",0
9,"9262",163,130,127,1,3,"UPyD",0
37,"37172",888,572,566,3,6,"UPyD",1
34,"34147",166,118,117,0,1,"UPyD",0
14,"14065",1850,1384,1377,16,7,"UPyD",1
9,"9220",75,56,54,1,2,"UPyD",0
31,"31231",117,76,73,1,3,"UPyD",0
42,"42078",1020,717,703,7,14,"UPyD",0
18,"18143",973,742,730,5,12,"UPyD",1
22,"22119",1291,942,935,5,7,"UPyD",0
12,"12092",111,91,90,0,1,"UPyD",0
19,"19057",76,59,59,1,0,"UPyD",1
50,"50261",213,157,157,0,0,"UPyD",0
9,"9356",42,33,32,0,1,"UPyD",0
10,"10136",302,218,215,4,3,"UPyD",1
41,"41080",1274,910,892,6,18,"UPyD",1
23,"23101",378,276,271,1,5,"UPyD",0
37,"37299",219,166,163,4,3,"UPyD",0
16,"16143",16,14,14,2,0,"UPyD",0
47,"47013",100,82,81,1,1,"UPyD",0
13,"13069",660,508,499,7,9,"UPyD",0
9,"9223",45,37,37,0,0,"UPyD",1
24,"24094",1385,983,968,11,15,"UPyD",1
9,"9908",449,307,306,3,1,"UPyD",0
50,"50073",2141,1592,1577,7,15,"UPyD",1
31,"31133",43,28,28,0,0,"UPyD",0
37,"37038",788,595,583,4,12,"UPyD",1
47,"47121",544,437,425,6,12,"UPyD",1
24,"24127",296,226,215,4,11,"UPyD",0
31,"31034",37,25,25,0,0,"UPyD",0
49,"49207",239,150,146,0,4,"UPyD",0
47,"47014",51,45,45,0,0,"UPyD",0
18,"18050",1710,1165,1152,3,13,"UPyD",4
31,"31234",144,106,106,4,0,"UPyD",1
45,"45189",599,470,462,2,8,"UPyD",0
10,"10001",282,225,223,3,2,"UPyD",2
49,"49250",1245,935,920,7,15,"UPyD",2
16,"16007",1177,888,880,7,8,"UPyD",0
19,"19059",77,61,58,1,3,"UPyD",0
26,"26161",8,7,7,0,0,"UPyD",0
16,"16196",633,508,503,2,5,"UPyD",0
9,"9268",95,68,66,0,2,"UPyD",1
50,"50202",152,100,99,1,1,"UPyD",0
26,"26054",320,263,260,4,3,"UPyD",1
31,"31235",159,117,115,2,2,"UPyD",0
6,"6020",1815,1366,1345,10,21,"UPyD",0
49,"49129",853,592,574,9,18,"UPyD",0
50,"50264",156,115,115,0,0,"UPyD",1
12,"12095",959,749,742,8,7,"UPyD",0
10,"10141",263,194,194,0,0,"UPyD",0
20,"20062",973,653,653,11,0,"UPyD",1
40,"40093",77,65,65,1,0,"UPyD",0
39,"39079",8874,6547,6478,47,69,"UPyD",13
6,"6021",926,645,636,8,9,"UPyD",0
50,"50172",193,132,129,1,3,"UPyD",0
10,"10004",704,492,482,9,10,"UPyD",0
2,"2045",3665,2895,2855,21,40,"UPyD",7
37,"37177",289,220,219,2,1,"UPyD",1
16,"16149",148,124,122,2,2,"UPyD",0
12,"12028",12586,9733,9676,62,57,"UPyD",18
45,"45023",2177,1571,1556,6,15,"UPyD",3
10,"10142",832,627,621,5,6,"UPyD",0
22,"22126",88,64,64,0,0,"UPyD",0
9,"9226",63,54,54,0,0,"UPyD",0
18,"18194",2128,1451,1437,9,14,"UPyD",0
50,"50204",2436,1785,1770,3,15,"UPyD",0
50,"50296",396,286,275,4,11,"UPyD",1
10,"10143",154,112,112,0,0,"UPyD",0
28,"28129",8030,5986,5941,42,45,"UPyD",21
49,"49050",507,342,338,1,4,"UPyD",0
20,"20064",12503,7803,7755,52,48,"UPyD",17
37,"37179",209,180,180,0,0,"UPyD",1
37,"37180",75,56,56,0,0,"UPyD",0
31,"31038",1339,957,942,11,15,"UPyD",1
37,"37305",216,171,170,0,1,"UPyD",2
49,"49012",73,43,43,0,0,"UPyD",0
10,"10006",1263,978,970,2,8,"UPyD",0
3,"3061",1056,776,768,4,8,"UPyD",1
34,"34019",125,107,105,0,2,"UPyD",1
37,"37045",26,23,21,0,2,"UPyD",0
9,"9138",85,72,70,0,2,"UPyD",1
21,"21012",316,235,233,2,2,"UPyD",0
37,"37046",11225,7824,7697,53,127,"UPyD",21
50,"50078",235,177,173,0,4,"UPyD",0
26,"26058",154,116,115,0,1,"UPyD",0
46,"46146",1654,1304,1278,7,26,"UPyD",2
6,"6026",837,598,591,0,7,"UPyD",0
47,"47179",395,293,287,0,6,"UPyD",0
31,"31239",322,211,211,5,0,"UPyD",0
18,"18059",4180,2907,2870,20,37,"UPyD",1
18,"18151",260,171,170,3,1,"UPyD",0
46,"46147",16835,11920,11791,61,129,"UPyD",33
19,"19296",30,19,18,0,1,"UPyD",0
48,"48032",5743,4065,4048,29,17,"UPyD",1
45,"45094",387,298,297,1,1,"UPyD",0
19,"19187",48,43,43,0,0,"UPyD",0
37,"37182",75,56,55,0,1,"UPyD",0
45,"45027",346,275,272,0,3,"UPyD",1
29,"29093",2214,1643,1621,3,22,"UPyD",0
29,"29004",312,236,233,2,3,"UPyD",0
50,"50176",236,165,165,3,0,"UPyD",1
29,"29094",57554,38071,37696,339,375,"UPyD",65
49,"49015",227,179,177,0,2,"UPyD",0
40,"40100",270,213,211,2,2,"UPyD",3
21,"21014",4016,3025,2991,21,34,"UPyD",5
6,"6902",1667,1121,1113,13,8,"UPyD",3
42,"42088",67,47,47,1,0,"UPyD",0
18,"18018",634,472,468,5,4,"UPyD",0
10,"10148",32850,22161,21856,177,305,"UPyD",42
26,"26168",5340,3774,3717,22,57,"UPyD",9
26,"26061",1565,1160,1141,13,19,"UPyD",2
31,"31041",1606,1114,1101,15,13,"UPyD",2
31,"31141",110,71,70,1,1,"UPyD",0
47,"47181",165,135,132,3,3,"UPyD",0
16,"16155",508,398,391,2,7,"UPyD",1
29,"29095",3321,2376,2307,24,69,"UPyD",0
6,"6029",1195,855,841,3,14,"UPyD",0
5,"5159",252,165,164,0,1,"UPyD",0
50,"50114",116,89,88,0,1,"UPyD",1
14,"14018",3709,2697,2653,26,44,"UPyD",2
5,"5160",323,256,253,2,3,"UPyD",0
10,"10012",595,466,459,0,7,"UPyD",0
14,"14074",2299,1896,1866,16,30,"UPyD",1
40,"40229",36,24,24,0,0,"UPyD",0
22,"22131",82,63,63,0,0,"UPyD",0
45,"45063",417,310,303,1,7,"UPyD",0
18,"18020",1028,691,686,3,5,"UPyD",1
31,"31242",260,164,163,1,1,"UPyD",1
49,"49177",278,179,177,1,2,"UPyD",0
41,"41024",22600,14263,14048,128,215,"UPyD",16
31,"31208",2556,1949,1920,16,29,"UPyD",3
49,"49137",176,139,138,0,1,"UPyD",0
46,"46228",2348,1815,1794,7,21,"UPyD",8
10,"10013",276,207,200,0,7,"UPyD",4
46,"46150",1831,1341,1333,7,8,"UPyD",0
26,"26170",446,330,326,2,4,"UPyD",1
18,"18022",13432,8491,8407,67,84,"UPyD",11
37,"37186",104,85,85,2,0,"UPyD",0
22,"22018",327,245,244,3,1,"UPyD",0
24,"24006",472,353,347,0,6,"UPyD",0
37,"37054",250,195,192,1,3,"UPyD",0
50,"50180",119,99,99,2,0,"UPyD",0
42,"42093",37,29,28,1,1,"UPyD",0
31,"31044",289,230,227,1,3,"UPyD",0
46,"46229",948,762,758,0,4,"UPyD",1
22,"22905",281,209,209,1,0,"UPyD",0
49,"49019",243,188,182,2,6,"UPyD",0
49,"49263",51,36,36,0,0,"UPyD",0
48,"48036",24073,16076,15971,86,105,"UPyD",22
4,"4052",12274,8372,8306,93,66,"UPyD",10
4,"4017",1296,857,854,5,3,"UPyD",2
47,"47183",130,106,105,0,1,"UPyD",0
49,"49179",371,238,237,0,1,"UPyD",2
19,"19116",12,9,9,0,0,"UPyD",0
26,"26064",2275,1659,1638,17,21,"UPyD",3
31,"31045",508,355,350,8,5,"UPyD",4
31,"31178",490,345,342,3,3,"UPyD",1
16,"16020",17,10,10,0,0,"UPyD",0
29,"29009",1468,1069,1045,8,24,"UPyD",2
37,"37057",215,172,171,1,1,"UPyD",0
2,"2057",2020,1487,1461,10,26,"UPyD",1
37,"37189",121,88,88,0,0,"UPyD",0
47,"47102",291,230,220,1,10,"UPyD",0
40,"40107",100,73,73,1,0,"UPyD",0
9,"9239",52,40,39,0,1,"UPyD",0
31,"31246",140,111,107,1,4,"UPyD",0
4,"4019",249,196,196,1,0,"UPyD",0
6,"6036",5075,3575,3535,35,40,"UPyD",4
10,"10201",173,142,142,2,0,"UPyD",0
50,"50085",167,126,126,1,0,"UPyD",0
16,"16023",469,335,335,2,0,"UPyD",2
33,"33006",1540,1010,1003,5,7,"UPyD",0
45,"45101",3756,3020,2984,12,36,"UPyD",3
16,"16162",43,35,34,0,1,"UPyD",0
19,"19231",10,9,9,0,0,"UPyD",0
18,"18912",1473,994,979,3,15,"UPyD",0
45,"45001",1835,1281,1251,3,30,"UPyD",1
39,"39029",618,488,481,3,7,"UPyD",2
5,"5167",254,207,202,4,5,"UPyD",2
26,"26174",146,107,105,2,2,"UPyD",1
36,"36003",9980,7191,7110,67,81,"UPyD",12
12,"12106",1158,955,942,8,13,"UPyD",3
22,"22058",194,164,162,1,2,"UPyD",0
46,"46232",895,711,696,5,15,"UPyD",0
10,"10158",330,269,267,0,2,"UPyD",0
9,"9110",80,63,63,0,0,"UPyD",0
40,"40902",123,99,96,1,3,"UPyD",1
47,"47186",246129,186191,184733,1198,1458,"UPyD",698
47,"47025",120,94,94,1,0,"UPyD",0
34,"34033",17,17,17,0,0,"UPyD",0
24,"24213",150,122,122,1,0,"UPyD",0
37,"37236",135,105,103,1,2,"UPyD",0
16,"16165",61,54,53,0,1,"UPyD",1
2,"2060",1294,997,983,2,14,"UPyD",0
7,"7010",4880,3395,3361,32,34,"UPyD",7
20,"20009",11452,7388,7345,62,43,"UPyD",2
36,"36005",8121,5480,5400,52,80,"UPyD",6
46,"46233",3860,2859,2817,10,42,"UPyD",2
37,"37193",390,279,275,4,4,"UPyD",0
46,"46076",575,454,443,0,11,"UPyD",0
6,"6085",3428,2453,2414,25,39,"UPyD",1
42,"42018",152,117,116,1,1,"UPyD",0
23,"23042",292,217,213,1,4,"UPyD",0
3,"3103",272,235,234,1,1,"UPyD",1
26,"26177",304,255,254,7,1,"UPyD",0
12,"12008",222,193,192,1,1,"UPyD",0
36,"36006",11520,8529,8396,63,133,"UPyD",11
19,"19198",14,12,12,0,0,"UPyD",0
31,"31149",2305,1461,1441,8,20,"UPyD",0
22,"22061",6630,4555,4526,40,29,"UPyD",10
39,"39032",1463,1087,1081,7,6,"UPyD",0
20,"20077",5213,3614,3591,36,23,"UPyD",3
19,"19081",29,22,22,1,0,"UPyD",0
49,"49026",226,179,176,0,3,"UPyD",1
6,"6087",2110,1583,1561,8,22,"UPyD",1
6,"6042",1011,698,687,2,11,"UPyD",0
34,"34036",211,150,150,0,0,"UPyD",2
49,"49270",133,99,99,1,0,"UPyD",0
37,"37063",69,59,58,0,1,"UPyD",0
9,"9386",54,39,38,1,1,"UPyD",0
19,"19082",85,64,64,0,0,"UPyD",0
28,"28045",33328,24620,24434,146,186,"UPyD",172
24,"24149",152,120,116,3,4,"UPyD",0
12,"12010",259,213,208,2,5,"UPyD",0
16,"16170",692,501,493,4,8,"UPyD",0
50,"50123",449,334,331,1,3,"UPyD",0
40,"40115",101,86,85,1,1,"UPyD",0
31,"31052",96,62,61,0,1,"UPyD",0
23,"23004",436,364,358,1,6,"UPyD",0
49,"49149",390,273,268,3,5,"UPyD",0
22,"22144",243,188,187,1,1,"UPyD",0
47,"47189",152,119,118,0,1,"UPyD",0
29,"29017",6553,4744,4668,33,76,"UPyD",0
26,"26179",41,32,31,0,1,"UPyD",0
49,"49272",88,70,69,1,1,"UPyD",0
18,"18171",2120,1572,1551,9,21,"UPyD",0
49,"49028",115,104,103,1,1,"UPyD",0
9,"9428",108,92,91,0,1,"UPyD",2
46,"46235",21579,15929,15763,113,166,"UPyD",17
16,"16171",1800,1469,1443,8,26,"UPyD",1
1,"1011",235,174,171,4,3,"UPyD",0
34,"34038",277,204,203,1,1,"UPyD",0
12,"12112",99,79,78,3,1,"UPyD",1
13,"13903",524,419,415,3,4,"UPyD",2
6,"6046",1255,1004,995,8,9,"UPyD",2
22,"22027",329,221,218,0,3,"UPyD",1
24,"24016",466,270,269,1,1,"UPyD",0
22,"22028",371,282,280,3,2,"UPyD",1
5,"5176",235,181,174,4,7,"UPyD",2
26,"26073",97,78,78,0,0,"UPyD",0
9,"9034",276,228,227,2,1,"UPyD",1
37,"37159",90,70,70,1,0,"UPyD",0
40,"40032",390,289,285,2,4,"UPyD",0
13,"13904",531,400,392,4,8,"UPyD",0
31,"31154",224,126,126,3,0,"UPyD",1
49,"49152",525,339,334,2,5,"UPyD",0
9,"9389",73,60,60,1,0,"UPyD",0
19,"19202",8,6,6,0,0,"UPyD",0
1,"1014",371,280,272,4,8,"UPyD",1
19,"19314",51,36,36,0,0,"UPyD",0
34,"34041",90,71,71,1,0,"UPyD",2
50,"50093",92,66,66,1,0,"UPyD",0
47,"47219",41,36,34,0,2,"UPyD",0
40,"40121",280,226,218,3,8,"UPyD",1
39,"39006",1711,1307,1287,10,20,"UPyD",3
28,"28116",704,528,523,2,5,"UPyD",2
30,"30004",1137,870,862,3,8,"UPyD",0
46,"46237",7211,5395,5343,42,52,"UPyD",8
50,"50001",100,77,77,0,0,"UPyD",0
37,"37071",78,65,64,0,1,"UPyD",0
46,"46003",950,791,769,1,22,"UPyD",0
41,"41092",7743,5358,5311,55,47,"UPyD",10
14,"14002",10951,7706,7620,83,86,"UPyD",3
6,"6049",1015,725,707,3,18,"UPyD",1
31,"31256",107,59,59,0,0,"UPyD",0
45,"45143",1170,881,874,4,7,"UPyD",0
37,"37203",158,117,117,0,0,"UPyD",0
10,"10032",1681,1257,1237,5,20,"UPyD",0
16,"16036",126,109,106,0,3,"UPyD",0
16,"16176",38,30,30,0,0,"UPyD",0
46,"46082",4918,3745,3712,33,33,"UPyD",9
7,"7020",3581,2542,2502,43,40,"UPyD",2
28,"28118",57,46,45,0,1,"UPyD",0
18,"18038",1066,828,802,1,26,"UPyD",1
46,"46004",1922,1565,1547,11,18,"UPyD",1
5,"5035",100,84,84,0,0,"UPyD",0
18,"18177",418,258,256,0,2,"UPyD",1
9,"9392",53,40,37,1,3,"UPyD",0
41,"41006",2740,1782,1768,14,14,"UPyD",1
34,"34046",41,36,35,0,1,"UPyD",0
24,"24019",354,272,267,3,5,"UPyD",0
47,"47113",159,129,128,0,1,"UPyD",0
3,"3018",12240,8853,8777,47,76,"UPyD",11
37,"37204",276,198,195,1,3,"UPyD",0
52,"52001",53306,27373,27012,267,361,"UPyD",144
45,"45179",525,391,386,3,5,"UPyD",0
9,"9434",1227,922,909,6,13,"UPyD",2
3,"3080",1300,1035,1025,3,10,"UPyD",0
47,"47194",298,239,237,2,2,"UPyD",1
10,"10172",709,466,465,0,1,"UPyD",1
34,"34047",1782,1397,1374,12,23,"UPyD",1
9,"9255",89,63,62,0,1,"UPyD",0
36,"36015",4153,2721,2677,23,44,"UPyD",5
20,"20904",95,44,44,2,0,"UPyD",0
5,"5182",786,538,532,2,6,"UPyD",0
19,"19243",44,31,31,0,0,"UPyD",0
49,"49080",685,520,514,2,6,"UPyD",1
46,"46188",672,544,537,8,7,"UPyD",0
31,"31158",255,180,179,3,1,"UPyD",0
45,"45113",1915,1390,1366,6,24,"UPyD",1
37,"37334",76,48,48,1,0,"UPyD",0
22,"22158",11995,8197,8126,62,71,"UPyD",15
12,"12117",3585,2727,2677,20,50,"UPyD",3
10,"10036",329,241,238,1,3,"UPyD",0
48,"48050",191,147,146,0,1,"UPyD",0
30,"30008",13918,9757,9645,59,112,"UPyD",41
49,"49158",215,170,166,2,4,"UPyD",0
18,"18042",403,324,322,2,2,"UPyD",0
50,"50195",54,40,40,0,0,"UPyD",0
46,"46241",392,299,291,1,8,"UPyD",0
19,"19211",369,289,284,0,5,"UPyD",0
5,"5185",95,82,81,0,1,"UPyD",0
7,"7024",6843,3657,3612,38,45,"UPyD",3
23,"23014",2559,1971,1942,13,29,"UPyD",1
24,"24120",341,246,244,1,2,"UPyD",0
37,"37335",406,296,290,0,6,"UPyD",1
34,"34050",200,153,152,0,1,"UPyD",0
24,"24225",1014,752,739,10,13,"UPyD",0
5,"5040",66,50,50,1,0,"UPyD",0
39,"39102",2277,1615,1598,9,17,"UPyD",1
12,"12020",118,105,105,0,0,"UPyD",0
37,"37208",76,56,54,1,2,"UPyD",0
31,"31261",231,173,169,3,4,"UPyD",0
18,"18137",989,761,760,7,1,"UPyD",2
47,"47035",921,717,715,3,2,"UPyD",3
49,"49160",49,33,33,0,0,"UPyD",0
9,"9439",1028,752,744,9,8,"UPyD",5
1,"1021",473,310,309,0,1,"UPyD",0
9,"9128",80,63,63,0,0,"UPyD",0
50,"50289",51,38,38,0,0,"UPyD",0
41,"41010",4420,2960,2916,30,44,"UPyD",11
5,"5042",153,122,121,0,1,"UPyD",1
28,"28054",11257,8349,8273,55,76,"UPyD",36
7,"7026",31074,18280,18135,168,145,"UPyD",37
46,"46008",2651,2108,2089,21,19,"UPyD",2
40,"40128",129,95,93,0,2,"UPyD",0
37,"37338",79,65,64,0,1,"UPyD",0
22,"22041",163,134,134,1,0,"UPyD",0
37,"37211",224,172,172,4,0,"UPyD",1
3,"3054",343,277,275,3,2,"UPyD",0
18,"18184",2168,1629,1607,13,22,"UPyD",1
50,"50101",864,603,597,8,6,"UPyD",1
46,"46009",3121,2459,2427,8,32,"UPyD",4
37,"37254",181,142,141,0,1,"UPyD",0
50,"50290",386,283,282,1,1,"UPyD",0
10,"10179",294,231,229,2,2,"UPyD",0
39,"39014",883,619,614,6,5,"UPyD",0
37,"37083",182,156,155,0,1,"UPyD",0
36,"36057",236673,169244,167605,1366,1639,"UPyD",308
24,"24123",746,488,485,2,3,"UPyD",0
19,"19214",75,60,58,0,2,"UPyD",0
37,"37339",315,251,251,4,0,"UPyD",0
12,"12022",344,265,262,2,3,"UPyD",0
16,"16003",125,105,104,0,1,"UPyD",0
5,"5044",266,183,183,1,0,"UPyD",0
12,"12024",143,125,124,0,1,"UPyD",1
10,"10042",84,63,63,0,0,"UPyD",0
37,"37213",89,74,73,0,1,"UPyD",0
19,"19327",418,350,348,1,2,"UPyD",0
46,"46010",935,729,723,4,6,"UPyD",1
40,"40131",48,42,42,0,0,"UPyD",0
37,"37340",151,106,106,1,0,"UPyD",0
34,"34056",1998,1452,1444,13,8,"UPyD",5
16,"16192",48,31,30,1,1,"UPyD",0
9,"9406",251,192,191,2,1,"UPyD",1
48,"48056",966,705,700,5,5,"UPyD",1
1,"1027",416,257,254,3,3,"UPyD",2
30,"30014",1567,1174,1160,8,14,"UPyD",4
47,"47200",85,66,66,0,0,"UPyD",0
49,"49043",289,217,213,1,4,"UPyD",1
10,"10182",136,95,95,0,0,"UPyD",0
42,"42124",64,49,49,0,0,"UPyD",0
34,"34204",46,41,41,0,0,"UPyD",0
2,"2081",18342,13244,13075,80,169,"UPyD",25
10,"10045",1019,762,755,3,7,"UPyD",2
46,"46012",896,682,663,1,19,"UPyD",1
28,"28058",139342,100637,99753,634,884,"UPyD",412
7,"7031",23833,14836,14707,124,129,"UPyD",32
45,"45020",1290,1037,1026,6,11,"UPyD",0
36,"36060",30323,21399,21162,164,237,"UPyD",29
50,"50232",175,110,110,3,0,"UPyD",0
9,"9407",28,23,23,0,0,"UPyD",0
19,"19181",56,42,42,0,0,"UPyD",0
31,"31901",15459,11119,11026,108,93,"UPyD",19
49,"49090",197,143,141,6,2,"UPyD",0
45,"45021",2500,1708,1665,12,43,"UPyD",3
37,"37343",60,47,47,0,0,"UPyD",0
16,"16050",245,201,195,1,6,"UPyD",0
49,"49046",268,203,203,0,0,"UPyD",0
37,"37089",67,56,56,0,0,"UPyD",1
10,"10047",955,732,727,1,5,"UPyD",1
50,"50107",947,738,733,4,5,"UPyD",3
31,"31101",1373,973,966,8,7,"UPyD",2
50,"50139",313,241,239,3,2,"UPyD",0
11,"11038",13737,10181,10034,99,147,"UPyD",19
24,"24129",122,89,89,1,0,"UPyD",0
22,"22170",651,498,491,5,7,"UPyD",2
10,"10048",233,168,168,0,0,"UPyD",1
42,"42128",42,42,41,1,1,"UPyD",0
23,"23025",2802,2056,2037,9,19,"UPyD",1
12,"12027",17283,12015,11888,89,127,"UPyD",22
47,"47204",256,204,198,0,6,"UPyD",0
28,"28128",444,315,314,0,1,"UPyD",1
47,"47041",150,112,110,2,2,"UPyD",0
6,"6067",1972,1308,1292,8,16,"UPyD",3
49,"49169",35,26,26,0,0,"UPyD",0
2,"2085",322,253,252,2,1,"UPyD",0
13,"13022",348,260,258,4,2,"UPyD",0
48,"48089",3306,2341,2329,20,12,"UPyD",5
31,"31069",832,637,635,3,2,"UPyD",0
29,"29033",1122,747,730,4,17,"UPyD",1
37,"37042",44,28,27,0,1,"UPyD",0
31,"31136",447,299,298,2,1,"UPyD",0
50,"50109",103,78,78,3,0,"UPyD",0
37,"37091",177,117,116,1,1,"UPyD",0
5,"5053",82,57,57,0,0,"UPyD",0
40,"40180",299,246,241,1,5,"UPyD",2
31,"31004",35,21,21,0,0,"UPyD",0
4,"4075",5196,3735,3706,23,29,"UPyD",8
49,"49170",102,72,71,0,1,"UPyD",0
47,"47042",54,37,37,0,0,"UPyD",0
16,"16198",1348,981,971,10,10,"UPyD",0
19,"19293",1867,1358,1342,7,16,"UPyD",10
31,"31137",205,112,109,6,3,"UPyD",1
19,"19185",28,21,20,0,1,"UPyD",0
50,"50142",26,17,17,0,0,"UPyD",0
31,"31071",17,16,16,0,0,"UPyD",0
19,"19222",110,82,82,0,0,"UPyD",0
30,"30019",25857,17544,17374,125,170,"UPyD",50
34,"34062",171,119,118,2,1,"UPyD",1
34,"34211",178,155,152,1,3,"UPyD",0
29,"29035",1567,1157,1144,11,13,"UPyD",1
45,"45059",1712,1337,1311,1,26,"UPyD",0
6,"6070",7743,5438,5317,39,121,"UPyD",9
6,"6071",245,206,200,0,6,"UPyD",0
16,"16202",769,564,558,0,6,"UPyD",0
28,"28130",28293,21253,21040,116,213,"UPyD",75
50,"50110",367,256,254,0,2,"UPyD",1
22,"22174",478,379,378,2,1,"UPyD",0
14,"14015",2125,1579,1554,10,25,"UPyD",1
37,"37224",206,183,175,3,8,"UPyD",0
11,"11009",605,414,410,1,4,"UPyD",1
31,"31006",1927,1350,1332,13,18,"UPyD",4
47,"47207",278,215,212,3,3,"UPyD",0
1,"1036",14955,10052,9959,55,93,"UPyD",11
14,"14016",1337,1072,1060,2,12,"UPyD",1
41,"41021",21294,13762,13570,145,192,"UPyD",62
31,"31908",1004,686,682,2,4,"UPyD",0
45,"45127",696,514,511,3,3,"UPyD",1
11,"11010",6410,4189,4130,88,59,"UPyD",4
31,"31205",427,299,297,4,2,"UPyD",0
47,"47208",58,38,36,1,2,"UPyD",0
48,"48063",372,279,277,2,2,"UPyD",0
10,"10192",828,590,584,1,6,"UPyD",0
29,"29037",209,158,157,1,1,"UPyD",0
33,"33030",895,669,666,9,3,"UPyD",1
40,"40184",258,211,210,2,1,"UPyD",2
29,"29038",17676,11056,10970,141,86,"UPyD",32
14,"14017",10868,7764,7665,71,99,"UPyD",12
31,"31173",861,683,667,3,16,"UPyD",1
19,"19112",60,46,46,0,0,"UPyD",0
37,"37099",73,41,41,0,0,"UPyD",0
50,"50018",953,656,655,1,1,"UPyD",1
18,"18062",10393,7235,7161,63,74,"UPyD",13
37,"37008",4266,3216,3197,19,19,"UPyD",4
33,"33061",378,202,200,0,2,"UPyD",0
20,"20001",246,133,132,2,1,"UPyD",0
30,"30022",16913,11371,11214,93,157,"UPyD",24
24,"24136",540,387,383,4,4,"UPyD",1
18,"18906",905,664,657,3,7,"UPyD",0
45,"45162",669,494,486,2,8,"UPyD",1
23,"23070",3914,2433,2407,14,26,"UPyD",3
49,"49175",230,172,171,1,1,"UPyD",0
47,"47209",41,34,34,0,0,"UPyD",0
9,"9143",27,19,18,0,1,"UPyD",0
37,"37101",160,128,125,0,3,"UPyD",0
28,"28133",5979,4140,4098,18,42,"UPyD",5
29,"29096",2810,1944,1909,31,35,"UPyD",1
9,"9021",56,33,31,1,2,"UPyD",1
4,"4050",800,558,553,3,5,"UPyD",0
48,"48004",335,222,222,0,0,"UPyD",0
2,"2012",1835,1476,1453,7,23,"UPyD",1
37,"37312",258,201,200,2,1,"UPyD",0
40,"40188",90,72,70,0,2,"UPyD",0
16,"16271",633,517,516,4,1,"UPyD",1
21,"21017",3600,2187,2164,26,23,"UPyD",5
9,"9277",120,101,99,0,2,"UPyD",1
37,"37103",436,310,308,8,2,"UPyD",0
18,"18065",618,496,470,3,26,"UPyD",0
30,"30024",58746,42036,41731,206,305,"UPyD",52
4,"4051",436,360,356,1,4,"UPyD",0
10,"10198",1143,981,964,6,17,"UPyD",1
20,"20004",252,121,121,0,0,"UPyD",0
39,"39026",1750,1236,1224,11,12,"UPyD",1
24,"24139",2183,1548,1525,16,23,"UPyD",10
37,"37231",250,196,193,4,3,"UPyD",0
48,"48066",348,258,258,1,0,"UPyD",0
26,"26100",49,44,43,0,1,"UPyD",0
5,"5064",103,83,82,0,1,"UPyD",0
46,"46099",901,689,684,1,5,"UPyD",0
19,"19228",26,20,20,0,0,"UPyD",0
45,"45065",271,207,206,1,1,"UPyD",0
37,"37104",27,22,22,0,0,"UPyD",0
3,"3007",166,139,137,0,2,"UPyD",0
3,"3131",175,154,147,0,7,"UPyD",2
41,"41059",34165,24949,24709,196,240,"UPyD",74
31,"31177",255,169,166,2,3,"UPyD",0
24,"24141",95,85,84,0,1,"UPyD",0
5,"5115",523,378,373,0,5,"UPyD",0
41,"41026",4314,3380,3322,18,58,"UPyD",0
31,"31078",2429,1795,1767,15,28,"UPyD",3
46,"46178",4637,3405,3381,27,24,"UPyD",4
18,"18067",702,469,466,0,3,"UPyD",0
40,"40149",514,375,369,5,6,"UPyD",0
10,"10062",406,337,331,0,6,"UPyD",0
12,"12135",35719,26016,25793,196,223,"UPyD",56
31,"31179",502,348,345,0,3,"UPyD",0
19,"19117",1579,1135,1123,8,12,"UPyD",3
9,"9421",230,166,163,3,3,"UPyD",1
45,"45033",343,249,243,2,6,"UPyD",1
50,"50023",224,175,175,0,0,"UPyD",0
31,"31112",89,62,62,0,0,"UPyD",0
2,"2017",838,594,589,1,5,"UPyD",2
50,"50119",927,724,713,5,11,"UPyD",0
4,"4084",341,249,247,2,2,"UPyD",0
37,"37149",68,64,64,0,0,"UPyD",0
30,"30027",48176,35521,35266,153,255,"UPyD",133
34,"34223",218,155,155,1,0,"UPyD",0
40,"40192",159,117,117,2,0,"UPyD",0
49,"49228",54,44,43,0,1,"UPyD",2
42,"42148",10,10,10,1,0,"UPyD",0
26,"26034",654,497,489,1,8,"UPyD",1
42,"42015",30,20,19,1,1,"UPyD",0
41,"41029",13445,9507,9416,78,91,"UPyD",30
47,"47050",3719,2630,2598,26,32,"UPyD",8
24,"24042",63,56,56,1,0,"UPyD",1
45,"45069",1847,1391,1376,6,15,"UPyD",1
39,"39060",6679,5196,5121,29,75,"UPyD",20
40,"40152",760,592,584,3,8,"UPyD",5
46,"46180",682,553,549,0,4,"UPyD",0
41,"41030",514,387,373,3,14,"UPyD",0
42,"42016",18,14,14,0,0,"UPyD",0
10,"10066",160,122,122,0,0,"UPyD",0
39,"39030",1895,1225,1212,10,13,"UPyD",0
45,"45169",189,140,138,0,2,"UPyD",0
5,"5070",30,27,27,0,0,"UPyD",0
45,"45136",5845,4091,4019,25,72,"UPyD",2
20,"20042",3228,1967,1958,27,9,"UPyD",3
50,"50246",41,28,28,0,0,"UPyD",0
9,"9288",90,70,70,0,0,"UPyD",0
40,"40111",58,49,49,0,0,"UPyD",0
45,"45036",656,471,469,2,2,"UPyD",0
16,"16279",203,128,127,1,1,"UPyD",0
46,"46050",194,150,149,0,1,"UPyD",0
7,"7011",27721,17817,17720,139,97,"UPyD",29
45,"45103",397,331,327,3,4,"UPyD",0
9,"9289",1451,1014,1000,5,14,"UPyD",5
16,"16224",83,66,65,1,1,"UPyD",1
31,"31083",52,37,37,0,0,"UPyD",0
16,"16225",73,57,57,3,0,"UPyD",0
34,"34126",277,200,199,2,1,"UPyD",0
46,"46904",792,610,603,8,7,"UPyD",3
48,"48012",2049,1527,1512,7,15,"UPyD",0
22,"22102",179,141,138,2,3,"UPyD",0
26,"26003",413,331,329,2,2,"UPyD",0
42,"42194",170,118,114,1,4,"UPyD",0
3,"3012",1085,852,841,3,11,"UPyD",0
50,"50297",498961,362043,359558,2748,2485,"UPyD",1114
34,"34229",68,57,56,1,1,"UPyD",1
6,"6088",12616,8436,8313,70,123,"UPyD",19
21,"21027",48,36,35,1,1,"UPyD",0
37,"37114",84,70,69,2,1,"UPyD",0
12,"12044",468,419,412,3,7,"UPyD",0
20,"20078",1155,850,846,4,4,"UPyD",0
1,"1052",245,184,181,0,3,"UPyD",0
5,"5220",371,309,301,0,8,"UPyD",1
22,"22103",682,508,502,3,6,"UPyD",0
50,"50217",446,342,342,1,0,"UPyD",0
50,"50249",302,226,220,0,6,"UPyD",0
9,"9294",108,86,82,0,4,"UPyD",2
47,"47217",1910,1370,1366,1,4,"UPyD",6
9,"9162",141,101,101,0,0,"UPyD",0
45,"45139",167,139,139,1,0,"UPyD",0
16,"16228",172,137,137,4,0,"UPyD",0
37,"37241",168,131,131,1,0,"UPyD",0
4,"4059",1079,723,712,4,11,"UPyD",0
47,"47054",635,507,495,9,12,"UPyD",0
7,"7055",7442,4604,4553,42,51,"UPyD",5
33,"33010",1822,1190,1180,17,10,"UPyD",1
50,"50901",138,105,105,0,0,"UPyD",1
37,"37242",91,74,73,0,1,"UPyD",0
31,"31086",13188,9713,9642,111,71,"UPyD",20
37,"37367",201,164,161,0,3,"UPyD",0
34,"34231",229,168,167,1,1,"UPyD",0
41,"41035",1108,794,780,7,14,"UPyD",0
50,"50219",4119,2833,2804,19,29,"UPyD",3
30,"30033",10188,7403,7285,68,118,"UPyD",5
22,"22064",166,122,121,1,1,"UPyD",1
24,"24049",1483,1054,1048,6,6,"UPyD",2
31,"31186",299,195,194,3,1,"UPyD",1
5,"5078",115,91,89,1,2,"UPyD",0
19,"19167",130,101,99,0,2,"UPyD",0
26,"26109",81,69,69,0,0,"UPyD",0
16,"16905",1224,920,910,4,10,"UPyD",2
21,"21031",1199,852,837,6,15,"UPyD",0
31,"31187",111,68,63,1,5,"UPyD",0
48,"48076",308,218,217,2,1,"UPyD",0
3,"3109",2850,2181,2164,8,17,"UPyD",6
31,"31088",5572,3897,3862,44,35,"UPyD",9
41,"41036",3941,2674,2642,23,32,"UPyD",1
10,"10213",566,469,463,0,6,"UPyD",0
49,"49075",137,120,119,0,1,"UPyD",0
24,"24050",102,77,76,0,1,"UPyD",0
5,"5080",58,45,43,0,2,"UPyD",0
37,"37025",257,220,220,4,0,"UPyD",0
18,"18083",247,200,196,0,4,"UPyD",0
26,"26111",242,180,176,0,4,"UPyD",1
40,"40034",84,70,70,0,0,"UPyD",0
39,"39037",1987,1516,1503,8,13,"UPyD",2
41,"41037",3213,2376,2342,30,34,"UPyD",0
50,"50032",261,189,189,5,0,"UPyD",0
7,"7059",2996,2053,2013,17,40,"UPyD",2
9,"9431",118,98,98,0,0,"UPyD",1
24,"24153",232,179,177,2,2,"UPyD",0
4,"4062",4504,3534,3490,18,44,"UPyD",2
45,"45176",3706,2554,2521,22,33,"UPyD",4
28,"28078",38,32,32,0,0,"UPyD",0
49,"49077",183,103,103,0,0,"UPyD",1
3,"3017",374,314,307,1,7,"UPyD",0
47,"47221",111,94,94,0,0,"UPyD",0
22,"22068",79,60,60,0,0,"UPyD",0
5,"5082",529,432,422,1,10,"UPyD",0
34,"34236",156,120,119,0,1,"UPyD",0
49,"49078",170,141,140,1,1,"UPyD",0
37,"37372",144,111,108,0,3,"UPyD",0
9,"9168",290,217,217,3,0,"UPyD",1
6,"6096",220,176,171,2,5,"UPyD",0
36,"36050",7561,5280,5188,25,92,"UPyD",14
50,"50130",383,240,238,2,2,"UPyD",1
14,"14031",593,469,459,3,10,"UPyD",0
19,"19007",459,341,336,0,5,"UPyD",0
26,"26011",7321,5133,5083,38,50,"UPyD",16
47,"47085",16612,11829,11706,114,123,"UPyD",18
36,"36051",14267,9638,9493,71,145,"UPyD",16
18,"18133",2168,1648,1636,6,12,"UPyD",1
26,"26044",52,46,46,0,0,"UPyD",0
40,"40206",173,135,134,0,1,"UPyD",3
18,"18086",349,274,272,0,2,"UPyD",0
34,"34238",330,268,266,3,2,"UPyD",2
46,"46031",10535,7543,7451,66,92,"UPyD",7
4,"4064",2771,2001,1988,13,13,"UPyD",4
19,"19008",37,28,27,1,1,"UPyD",1
47,"47059",97,76,76,2,0,"UPyD",0
37,"37249",43,29,29,0,0,"UPyD",0
50,"50224",72,57,56,2,1,"UPyD",0
47,"47086",3906,2970,2936,24,34,"UPyD",2
40,"40124",237,182,177,6,5,"UPyD",0
18,"18087",184857,134428,133526,864,902,"UPyD",487
18,"18135",4568,3009,2961,14,48,"UPyD",4
9,"9437",282,219,218,3,1,"UPyD",0
20,"20019",9986,6428,6392,48,36,"UPyD",5
3,"3020",99,79,79,0,0,"UPyD",1
48,"48080",9976,6820,6763,62,57,"UPyD",7
10,"10083",90,59,59,2,0,"UPyD",0
47,"47143",118,91,90,0,1,"UPyD",1
47,"47223",157,122,118,2,4,"UPyD",0
50,"50131",231,167,165,0,2,"UPyD",0
48,"48081",1868,1361,1350,4,11,"UPyD",0
6,"6101",463,381,378,2,3,"UPyD",0
34,"34093",85,70,70,0,0,"UPyD",1
34,"34092",288,230,226,1,4,"UPyD",0
45,"45148",292,223,223,0,0,"UPyD",0
33,"33049",6322,4116,4062,43,54,"UPyD",6
50,"50227",109,79,79,0,0,"UPyD",0
18,"18089",14719,10163,10099,63,64,"UPyD",12
49,"49200",949,720,715,10,5,"UPyD",3
16,"16091",65,53,53,0,0,"UPyD",0
50,"50257",171,134,134,2,0,"UPyD",0
23,"23054",382,282,281,1,1,"UPyD",0
3,"3115",255,222,220,2,2,"UPyD",0
4,"4067",570,441,436,2,5,"UPyD",0
30,"30040",732,617,607,2,10,"UPyD",1
2,"2076",329,237,236,1,1,"UPyD",0
46,"46190",48947,35638,35419,211,219,"UPyD",110
12,"12056",282,236,231,1,5,"UPyD",0
40,"40001",702,560,554,3,6,"UPyD",2
34,"34243",325,252,248,0,4,"UPyD",0
18,"18093",2750,1793,1776,7,17,"UPyD",0
42,"42165",409,271,261,10,10,"UPyD",0
46,"46034",1758,1390,1379,4,11,"UPyD",3
9,"9174",794,559,552,4,7,"UPyD",2
4,"4068",187,154,152,0,2,"UPyD",0
34,"34096",55,42,42,0,0,"UPyD",0
37,"37253",135,109,109,2,0,"UPyD",0
16,"16247",67,58,58,0,0,"UPyD",6
45,"45150",443,356,354,0,2,"UPyD",0
22,"22076",311,201,199,0,2,"UPyD",0
42,"42120",145,91,89,2,2,"UPyD",0
21,"21042",15350,7643,7530,124,113,"UPyD",16
16,"16094",127,96,94,0,2,"UPyD",0
40,"40044",145,114,113,2,1,"UPyD",0
23,"23097",6443,4117,4063,21,54,"UPyD",12
37,"37129",251,204,201,3,3,"UPyD",1
14,"14036",3740,2747,2696,24,51,"UPyD",1
19,"19248",78,63,63,0,0,"UPyD",2
40,"40172",39,34,34,0,0,"UPyD",0
34,"34005",851,673,658,4,15,"UPyD",2
19,"19285",24,21,21,1,0,"UPyD",0
5,"5142",99,88,85,0,3,"UPyD",1
3,"3118",2437,1659,1642,4,17,"UPyD",8
24,"24059",880,536,535,4,1,"UPyD",0
49,"49041",432,326,322,5,4,"UPyD",0
19,"19055",52,41,41,1,0,"UPyD",0
28,"28093",2096,1670,1653,10,17,"UPyD",4
46,"46114",569,461,458,1,3,"UPyD",3
28,"28154",5408,3806,3767,16,39,"UPyD",21
39,"39045",367,271,268,1,3,"UPyD",0
45,"45053",8005,6211,6140,42,71,"UPyD",8
5,"5095",262,225,223,1,2,"UPyD",0
37,"37131",185,139,139,0,0,"UPyD",0
47,"47064",33,28,25,0,3,"UPyD",0
29,"29062",654,551,545,2,6,"UPyD",0
3,"3119",16636,12281,12194,57,87,"UPyD",20
45,"45153",1615,1258,1243,7,15,"UPyD",1
3,"3026",1224,949,936,5,13,"UPyD",0
46,"46252",118,99,98,0,1,"UPyD",0
34,"34100",142,108,108,1,0,"UPyD",1
50,"50231",250,195,192,4,3,"UPyD",0
30,"30901",10309,7821,7718,43,103,"UPyD",31
41,"41047",10117,7515,7422,74,93,"UPyD",18
33,"33053",1141,742,732,6,10,"UPyD",1
40,"40176",395,306,305,2,1,"UPyD",1
31,"31099",62,47,47,2,0,"UPyD",0
9,"9178",47,35,35,0,0,"UPyD",0
34,"34101",50,41,41,0,0,"UPyD",0
24,"24061",1704,1213,1204,9,9,"UPyD",3
47,"47148",442,342,338,2,4,"UPyD",0
29,"29087",376,270,266,1,4,"UPyD",0
46,"46064",509,412,399,1,13,"UPyD",0
9,"9224",162,131,131,1,0,"UPyD",0
26,"26087",201,153,149,3,4,"UPyD",1
11,"11037",5661,4347,4265,33,82,"UPyD",1
46,"46142",787,619,602,1,17,"UPyD",2
6,"6019",2079,1451,1417,8,34,"UPyD",3
19,"19252",69,60,60,0,0,"UPyD",0
28,"28157",609,433,430,1,3,"UPyD",0
41,"41049",9299,6896,6771,98,125,"UPyD",9
9,"9051",170,130,128,0,2,"UPyD",2
36,"36061",8606,6232,6133,41,99,"UPyD",9
42,"42174",174,137,135,5,2,"UPyD",0
37,"37040",391,299,297,2,2,"UPyD",0
3,"3058",4951,3897,3851,30,46,"UPyD",10
48,"48058",968,647,646,2,1,"UPyD",0
9,"9090",54,48,48,0,0,"UPyD",1
18,"18011",4335,3037,3015,20,22,"UPyD",6
9,"9180",142,107,102,1,5,"UPyD",0
19,"19254",45,34,34,0,0,"UPyD",0
9,"9316",105,80,80,1,0,"UPyD",0
40,"40178",98,73,71,1,2,"UPyD",0
2,"2003",132346,95878,95217,630,661,"UPyD",233
45,"45156",3410,2751,2711,13,40,"UPyD",0
49,"49091",260,193,193,0,0,"UPyD",0
26,"26022",198,164,163,1,1,"UPyD",1
2,"2004",612,479,473,5,6,"UPyD",0
34,"34104",246,185,182,1,3,"UPyD",0
18,"18147",3729,2335,2304,16,31,"UPyD",1
50,"50265",79,61,61,0,0,"UPyD",0
21,"21049",3361,2049,1984,17,65,"UPyD",2
31,"31036",909,636,628,7,8,"UPyD",1
24,"24030",4277,3038,3007,11,31,"UPyD",1
16,"16197",59,42,42,0,0,"UPyD",0
45,"45091",394,269,267,3,2,"UPyD",0
14,"14041",3182,2296,2251,33,45,"UPyD",3
23,"23064",1655,1363,1353,1,10,"UPyD",0
47,"47124",392,316,311,3,5,"UPyD",3
21,"21010",14687,8293,8220,92,73,"UPyD",13
28,"28061",21389,16277,16135,67,142,"UPyD",65
12,"12064",91,82,81,2,1,"UPyD",0
46,"46040",1078,888,878,7,10,"UPyD",1
16,"16055",691,466,463,2,3,"UPyD",0
7,"7036",26955,18578,18433,148,145,"UPyD",45
19,"19108",111,97,96,0,1,"UPyD",0
28,"28099",1748,1290,1283,7,7,"UPyD",2
9,"9228",160,137,136,1,1,"UPyD",0
6,"6115",1261,841,832,5,9,"UPyD",0
50,"50046",178,133,133,5,0,"UPyD",0
24,"24167",750,505,499,4,6,"UPyD",0
2,"2007",1030,824,818,4,6,"UPyD",1
16,"16263",959,722,715,4,7,"UPyD",0
4,"4076",1279,960,944,8,16,"UPyD",0
6,"6025",5106,3571,3523,44,48,"UPyD",7
31,"31005",301,212,211,3,1,"UPyD",1
40,"40013",62,49,48,0,1,"UPyD",0
6,"6116",1587,1171,1160,10,11,"UPyD",0
24,"24066",494,368,366,4,2,"UPyD",1
14,"14043",7574,5515,5443,81,72,"UPyD",7
26,"26025",87,71,70,1,1,"UPyD",0
46,"46257",5571,4266,4224,25,42,"UPyD",4
24,"24100",761,561,555,7,6,"UPyD",0
31,"31039",80,61,60,0,1,"UPyD",0
37,"37307",159,104,103,1,1,"UPyD",0
9,"9321",1626,1238,1227,8,11,"UPyD",3
46,"46042",3380,2799,2755,20,44,"UPyD",4
42,"42086",36,27,26,2,1,"UPyD",0
42,"42044",54,42,39,0,3,"UPyD",0
19,"19258",90,77,77,0,0,"UPyD",0
37,"37006",138,103,103,2,0,"UPyD",1
37,"37049",137,96,96,1,0,"UPyD",0
18,"18903",889,669,661,5,8,"UPyD",3
41,"41054",692,560,546,3,14,"UPyD",0
4,"4078",1078,758,746,8,12,"UPyD",0
4,"4013",141378,94872,94288,741,584,"UPyD",275
37,"37309",44,30,30,1,0,"UPyD",0
28,"28008",1799,1182,1174,4,8,"UPyD",0
23,"23069",5353,4310,4212,27,98,"UPyD",8
42,"42182",56,43,41,1,2,"UPyD",0
47,"47154",152,128,125,1,3,"UPyD",0
22,"22086",215,161,159,1,2,"UPyD",0
6,"6119",689,501,499,4,2,"UPyD",0
50,"50239",62,50,48,0,2,"UPyD",0
35,"35005",1048,747,737,8,10,"UPyD",1
19,"19189",120,91,90,2,1,"UPyD",0
49,"49135",626,434,430,1,4,"UPyD",3
9,"9325",190,130,129,2,1,"UPyD",3
48,"48094",3161,2094,2073,12,21,"UPyD",0
26,"26028",134,113,112,0,1,"UPyD",0
19,"19298",65,45,45,0,0,"UPyD",0
45,"45096",1004,807,799,1,8,"UPyD",2
12,"12101",358,279,275,3,4,"UPyD",1
47,"47099",150,135,135,1,0,"UPyD",0
14,"14046",4485,3268,3208,33,60,"UPyD",2
50,"50147",777,552,552,2,0,"UPyD",0
50,"50051",816,616,614,2,2,"UPyD",0
20,"20035",486,337,334,1,3,"UPyD",0
26,"26132",112,82,82,0,0,"UPyD",0
49,"49099",115,87,87,0,0,"UPyD",0
24,"24137",1099,783,778,7,5,"UPyD",2
31,"31043",38,31,30,1,1,"UPyD",0
9,"9327",26,24,24,0,0,"UPyD",0
47,"47100",138,117,117,1,0,"UPyD",0
19,"19190",2369,1760,1745,10,15,"UPyD",7
5,"5258",111,95,95,0,0,"UPyD",0
2,"2013",119,92,90,0,2,"UPyD",0
10,"10106",130,109,108,2,1,"UPyD",0
42,"42187",62,46,45,1,1,"UPyD",0
28,"28164",2993,2183,2168,8,15,"UPyD",6
20,"20037",99,64,64,2,0,"UPyD",0
18,"18112",123,82,82,2,0,"UPyD",0
49,"49224",162,112,112,1,0,"UPyD",0
16,"16112",1497,1031,1021,9,10,"UPyD",2
2,"2014",356,283,280,1,3,"UPyD",0
22,"22090",99,71,71,0,0,"UPyD",0
19,"19156",970,704,699,4,5,"UPyD",1
46,"46046",892,675,668,1,7,"UPyD",1
23,"23073",4507,3229,3200,13,29,"UPyD",8
47,"47157",515,424,423,1,1,"UPyD",0
34,"34028",143,116,113,1,3,"UPyD",0
11,"11015",62476,38177,37875,488,302,"UPyD",107
34,"34120",64214,47193,46683,331,510,"UPyD",147
42,"42144",436,353,348,2,5,"UPyD",1
40,"40106",201,158,158,2,0,"UPyD",0
16,"16274",121,92,92,0,0,"UPyD",0
37,"37272",141,107,104,0,3,"UPyD",0
28,"28067",4063,3102,3079,3,23,"UPyD",10
24,"24039",2063,1597,1596,41,1,"UPyD",1
22,"22019",180,151,150,2,1,"UPyD",0
23,"23074",3021,2317,2295,11,22,"UPyD",2
37,"37147",193,134,132,1,2,"UPyD",1
19,"19264",33,26,26,0,0,"UPyD",0
24,"24073",478,332,328,2,4,"UPyD",2
11,"11016",14929,9426,9302,123,124,"UPyD",15
42,"42052",15,13,13,0,0,"UPyD",0
3,"3132",534,436,435,3,1,"UPyD",0
9,"9330",1507,1108,1092,10,16,"UPyD",4
28,"28167",8356,6158,6106,46,52,"UPyD",44
31,"31113",133,87,86,0,1,"UPyD",0
34,"34222",120,87,87,3,0,"UPyD",0
5,"5066",453,367,367,5,0,"UPyD",1
46,"46263",251,214,212,0,2,"UPyD",1
47,"47213",109,82,82,0,0,"UPyD",0
22,"22137",1069,727,718,3,9,"UPyD",2
22,"22908",197,142,140,3,2,"UPyD",0
16,"16068",137,98,97,1,1,"UPyD",0
7,"7048",17252,10055,9984,105,71,"UPyD",22
18,"18117",506,383,373,1,10,"UPyD",1
4,"4020",288,201,197,0,4,"UPyD",0
47,"47024",259,208,207,1,1,"UPyD",0
9,"9241",202,156,154,4,2,"UPyD",2
20,"20074",11592,7954,7914,45,40,"UPyD",1
10,"10111",1325,970,949,2,21,"UPyD",6
26,"26067",22,15,15,1,0,"UPyD",0
24,"24144",695,470,465,2,5,"UPyD",3
2,"2019",2405,1871,1835,12,36,"UPyD",1
10,"10112",1571,1107,1081,9,26,"UPyD",1
28,"28014",33085,23626,23466,113,160,"UPyD",90
21,"21064",6522,4227,4146,48,81,"UPyD",14
24,"24077",225,190,187,2,3,"UPyD",0
48,"48010",458,318,317,0,1,"UPyD",0
9,"9066",62,48,47,0,1,"UPyD",0
24,"24108",376,280,277,2,3,"UPyD",0
26,"26140",253,208,206,0,2,"UPyD",0
4,"4086",1760,1243,1234,9,9,"UPyD",1
47,"47078",163,127,125,1,2,"UPyD",0
34,"34077",347,244,238,4,6,"UPyD",0
5,"5169",226,187,185,1,2,"UPyD",0
35,"35011",24002,15928,15684,95,244,"UPyD",37
6,"6131",1076,843,837,2,6,"UPyD",0
46,"46207",6676,5106,5040,41,66,"UPyD",12
37,"37320",95,72,72,0,0,"UPyD",0
2,"2061",637,516,511,4,5,"UPyD",1
9,"9424",36,29,29,1,0,"UPyD",0
28,"28071",60,55,53,1,2,"UPyD",0
49,"49230",97,72,72,0,0,"UPyD",0
50,"50154",116,96,96,0,0,"UPyD",0
23,"23080",1762,1332,1322,4,10,"UPyD",0
24,"24078",380,289,277,0,12,"UPyD",0
40,"40070",149,107,105,1,2,"UPyD",0
34,"34175",90,72,70,0,2,"UPyD",0
28,"28112",161,136,136,1,0,"UPyD",0
39,"39093",299,229,226,4,3,"UPyD",0
13,"13096",7652,5480,5415,19,65,"UPyD",4
28,"28080",48554,38885,38691,164,194,"UPyD",135
45,"45205",6824,4424,4362,22,62,"UPyD",10
31,"31216",3865,2702,2671,33,31,"UPyD",2
18,"18915",745,533,525,2,8,"UPyD",0
16,"16122",249,188,187,0,1,"UPyD",0
2,"2023",568,486,479,3,7,"UPyD",1
3,"3043",2911,2431,2399,13,32,"UPyD",3
42,"42195",101,62,62,0,0,"UPyD",1
49,"49067",367,250,249,0,1,"UPyD",0
9,"9070",34,26,26,0,0,"UPyD",0
11,"11022",48675,26491,26256,270,235,"UPyD",45
46,"46234",348,279,275,3,4,"UPyD",0
46,"46130",901,687,683,3,4,"UPyD",4
40,"40906",2003,1569,1550,12,19,"UPyD",2
13,"13046",724,529,525,1,4,"UPyD",2
39,"39064",1345,1031,1015,7,16,"UPyD",3
13,"13047",5760,4295,4224,23,71,"UPyD",12
29,"29071",934,596,588,3,8,"UPyD",0
19,"19165",47,41,41,0,0,"UPyD",0
10,"10026",648,500,492,7,8,"UPyD",2
50,"50156",215,181,178,2,3,"UPyD",0
9,"9202",25,22,22,1,0,"UPyD",0
26,"26072",281,254,254,0,0,"UPyD",1
9,"9071",41,35,35,1,0,"UPyD",0
18,"18124",381,277,277,2,0,"UPyD",0
45,"45173",9520,6938,6864,30,74,"UPyD",22
28,"28172",9077,6992,6936,31,56,"UPyD",41
50,"50250",52,44,44,0,0,"UPyD",0
31,"31120",388,250,249,3,1,"UPyD",0
20,"20079",17886,11860,11799,91,61,"UPyD",5
6,"6137",972,744,737,1,7,"UPyD",3
3,"3139",22437,15315,15170,100,145,"UPyD",42
37,"37283",123,92,90,0,2,"UPyD",1
10,"10120",171,121,117,1,4,"UPyD",0
16,"16126",770,634,624,3,10,"UPyD",0
22,"22150",472,331,330,1,1,"UPyD",2
45,"45174",301,237,233,1,4,"UPyD",0
31,"31253",129,109,109,0,0,"UPyD",0
21,"21072",10262,7442,7307,85,135,"UPyD",16
46,"46054",11293,8477,8409,47,68,"UPyD",11
19,"19045",140,120,120,0,0,"UPyD",0
39,"39066",872,667,661,4,6,"UPyD",1
18,"18126",1483,1081,1074,15,7,"UPyD",2
11,"11024",6723,4696,4634,44,62,"UPyD",6
48,"48909",209,161,161,0,0,"UPyD",0
5,"5177",158,130,129,0,1,"UPyD",1
19,"19168",292,204,198,1,6,"UPyD",0
19,"19239",92,62,62,1,0,"UPyD",0
33,"33013",446,321,318,3,3,"UPyD",0
39,"39067",790,513,505,1,8,"UPyD",0
22,"22109",261,191,190,1,1,"UPyD",0
50,"50190",695,523,515,3,8,"UPyD",0
50,"50252",5138,3642,3611,24,31,"UPyD",5
26,"26147",30,28,27,0,1,"UPyD",0
40,"40077",842,632,619,3,13,"UPyD",9
34,"34133",107,91,90,0,1,"UPyD",0
42,"42202",20,14,13,0,1,"UPyD",0
12,"12083",93,79,76,0,3,"UPyD",0
50,"50160",2238,1546,1528,12,18,"UPyD",0
24,"24084",163,116,116,0,0,"UPyD",1
23,"23008",1502,1144,1131,9,13,"UPyD",0
41,"41093",18554,13978,13874,99,104,"UPyD",42
29,"29020",3267,2408,2359,16,49,"UPyD",2
49,"49154",127,78,77,0,1,"UPyD",0
18,"18132",3291,2524,2494,9,30,"UPyD",4
3,"3902",10254,6996,6930,34,66,"UPyD",10
22,"22236",253,200,200,0,0,"UPyD",0
16,"16909",699,535,532,0,3,"UPyD",0
45,"45177",2110,1679,1656,3,23,"UPyD",2
16,"16085",138,113,112,0,1,"UPyD",0
37,"37287",310,213,210,2,3,"UPyD",1
4,"4030",1119,819,812,5,7,"UPyD",3
3,"3079",18224,13904,13709,80,195,"UPyD",42
9,"9076",23,17,17,1,0,"UPyD",0
37,"37163",41,34,34,0,0,"UPyD",1
31,"31124",208,148,148,2,0,"UPyD",1
23,"23091",729,555,553,5,2,"UPyD",0
50,"50095",12323,8628,8550,110,78,"UPyD",10
42,"42115",61,47,47,1,0,"UPyD",0
45,"45145",2565,1695,1675,12,20,"UPyD",3
22,"22201",266,188,187,3,1,"UPyD",0
3,"3111",5436,3918,3883,18,35,"UPyD",5
19,"19172",57,48,47,0,1,"UPyD",0
41,"41073",1707,1055,1041,5,14,"UPyD",2
11,"11028",32488,21971,21672,316,299,"UPyD",95
46,"46057",487,321,317,1,4,"UPyD",0
50,"50193",651,514,501,2,13,"UPyD",3
47,"47168",29,26,26,1,0,"UPyD",0
48,"48913",1248,884,869,10,15,"UPyD",0
3,"3904",1396,1033,1026,4,7,"UPyD",3
33,"33047",1107,852,843,9,9,"UPyD",0
13,"13005",23298,17250,17070,140,180,"UPyD",45
14,"14032",423,334,330,4,4,"UPyD",2
40,"40039",210,156,153,3,3,"UPyD",1
3,"3050",18652,13325,13234,57,91,"UPyD",40
49,"49157",206,163,160,2,3,"UPyD",0
34,"34137",27,23,22,0,1,"UPyD",0
48,"48020",273626,184710,183628,1185,1082,"UPyD",286
6,"6145",922,696,694,5,2,"UPyD",0
13,"13059",202,160,156,0,4,"UPyD",0
9,"9351",62,49,48,1,1,"UPyD",1
50,"50194",88,63,63,1,0,"UPyD",0
10,"10128",5697,3958,3891,32,67,"UPyD",15
16,"16185",43,37,37,0,0,"UPyD",0
33,"33017",3144,2094,2071,35,23,"UPyD",7
24,"24089",102747,74428,73688,631,740,"UPyD",211
29,"29081",261,197,197,1,0,"UPyD",0
40,"40208",766,596,589,3,7,"UPyD",0
6,"6010",1105,819,801,5,18,"UPyD",1
35,"35021",14924,10477,10370,45,107,"UPyD",18
19,"19051",67,63,63,0,0,"UPyD",0
9,"9079",49,45,45,0,0,"UPyD",1
31,"31127",138,98,95,0,3,"UPyD",2
41,"41098",5004,3665,3630,26,35,"UPyD",4
49,"49121",365,273,273,2,0,"UPyD",0
3,"3052",970,769,755,8,14,"UPyD",3
28,"28090",8505,6654,6609,33,45,"UPyD",29
4,"4002",1039,748,740,2,8,"UPyD",3
10,"10085",323,235,233,0,2,"UPyD",0
42,"42208",22,13,13,2,0,"UPyD",0
28,"28179",1432,1040,1037,4,3,"UPyD",6
47,"47145",603,448,441,3,7,"UPyD",0
49,"49201",302,270,268,3,2,"UPyD",0
6,"6148",966,691,678,8,13,"UPyD",0
37,"37169",176,127,126,0,1,"UPyD",1
47,"47010",13729,10549,10454,81,95,"UPyD",50
18,"18138",2486,1620,1606,13,14,"UPyD",1
20,"20055",17475,11073,10997,56,76,"UPyD",3
9,"9083",37,33,33,0,0,"UPyD",0
9,"9218",369,275,275,1,0,"UPyD",2
22,"22002",107,95,95,0,0,"UPyD",0
22,"22115",360,257,256,3,1,"UPyD",0
26,"26154",13,10,10,0,0,"UPyD",0
22,"22246",76,50,50,0,0,"UPyD",0
3,"3023",1398,1184,1167,7,17,"UPyD",3
46,"46191",1937,1530,1505,5,25,"UPyD",0
46,"46217",878,691,676,4,15,"UPyD",0
10,"10133",1206,956,945,5,11,"UPyD",0
48,"48054",24171,16797,16711,118,86,"UPyD",18
31,"31262",228,179,178,5,1,"UPyD",0
46,"46087",120,98,97,0,1,"UPyD",1
50,"50259",88,67,66,0,1,"UPyD",0
24,"24092",798,606,602,1,4,"UPyD",0
41,"41100",1013,692,673,6,19,"UPyD",1
24,"24025",297,228,227,0,1,"UPyD",0
45,"45118",1991,1351,1339,6,12,"UPyD",1
31,"31064",1424,1121,1104,3,17,"UPyD",0
11,"11034",2334,1549,1517,14,32,"UPyD",0
9,"9046",29,25,25,0,0,"UPyD",0
6,"6060",5786,4146,4071,24,75,"UPyD",5
33,"33021",4573,3024,2971,22,53,"UPyD",4
13,"13066",2506,1971,1947,11,24,"UPyD",2
26,"26051",239,193,191,1,2,"UPyD",0
46,"46218",1060,910,885,7,25,"UPyD",0
9,"9906",1219,902,898,8,4,"UPyD",0
28,"28028",1755,1353,1344,6,9,"UPyD",11
20,"20058",755,529,525,3,4,"UPyD",1
9,"9907",1420,1058,1041,12,17,"UPyD",6
9,"9085",475,347,342,2,5,"UPyD",0
49,"49125",1391,933,918,10,15,"UPyD",3
16,"16004",259,198,197,2,1,"UPyD",2
22,"22006",298,204,204,5,0,"UPyD",0
34,"34149",23,18,18,0,0,"UPyD",0
4,"4101",4266,2909,2876,26,33,"UPyD",2
18,"18144",781,567,558,4,9,"UPyD",2
46,"46245",511,420,415,0,5,"UPyD",1
45,"45152",587,458,451,0,7,"UPyD",0
20,"20059",8874,5873,5855,29,18,"UPyD",3
6,"6017",272,222,221,1,1,"UPyD",0
19,"19179",69,56,56,1,0,"UPyD",0
31,"31132",145,109,109,0,0,"UPyD",0
49,"49249",69,58,58,1,0,"UPyD",0
42,"42079",26,18,18,1,0,"UPyD",0
48,"48026",1140,830,823,5,7,"UPyD",0
36,"36024",16455,11971,11781,109,190,"UPyD",16
9,"9266",91,74,74,0,0,"UPyD",0
37,"37087",862,639,635,2,4,"UPyD",4
3,"3057",182,147,147,1,0,"UPyD",0
46,"46220",48410,34644,34292,279,352,"UPyD",100
4,"4007",734,524,522,1,2,"UPyD",0
19,"19289",28,25,24,1,1,"UPyD",2
37,"37039",301,217,213,0,4,"UPyD",1
50,"50074",6366,4230,4165,31,65,"UPyD",6
23,"23901",1154,970,964,3,6,"UPyD",1
37,"37301",74,63,63,0,0,"UPyD",0
37,"37175",403,314,312,6,2,"UPyD",2
10,"10139",114,82,78,1,4,"UPyD",0
9,"9408",41,36,36,0,0,"UPyD",0
30,"30016",151668,102093,101363,484,730,"UPyD",320
26,"26088",37,32,31,0,1,"UPyD",1
37,"37344",241,175,174,2,1,"UPyD",0
40,"40218",92,65,64,1,1,"UPyD",0
9,"9361",115,90,89,0,1,"UPyD",0
46,"46247",1006,714,710,3,4,"UPyD",1
31,"31134",176,125,124,0,1,"UPyD",0
46,"46065",1579,1174,1163,8,11,"UPyD",1
47,"47176",219,139,139,1,0,"UPyD",0
19,"19290",834,561,558,5,3,"UPyD",3
6,"6157",443,321,316,1,5,"UPyD",0
37,"37041",78,52,52,0,0,"UPyD",0
42,"42219",43,31,30,0,1,"UPyD",0
26,"26163",136,118,118,0,0,"UPyD",1
10,"10186",977,795,778,1,17,"UPyD",0
29,"29066",334,234,233,4,1,"UPyD",0
28,"28097",119,94,94,0,0,"UPyD",0
5,"5197",102,85,83,1,2,"UPyD",0
45,"45090",384,294,293,3,1,"UPyD",1
35,"35027",10344,7310,7216,50,94,"UPyD",18
37,"37346",273,212,211,1,1,"UPyD",0
37,"37178",100,76,75,0,1,"UPyD",0
45,"45191",543,472,468,3,4,"UPyD",1
22,"22011",88,71,69,0,2,"UPyD",0
34,"34106",109,89,86,2,3,"UPyD",0
37,"37002",139,87,86,0,1,"UPyD",0
50,"50015",96,67,67,0,0,"UPyD",1
24,"24031",215,172,168,0,4,"UPyD",2
20,"20030",21423,13960,13898,101,62,"UPyD",11
10,"10097",101,75,74,0,1,"UPyD",0
49,"49268",403,313,309,1,4,"UPyD",2
24,"24043",134,75,75,1,0,"UPyD",0
18,"18149",5230,3903,3864,20,39,"UPyD",6
45,"45192",2491,2069,2049,2,20,"UPyD",4
47,"47017",201,158,153,1,5,"UPyD",0
34,"34156",50,45,45,0,0,"UPyD",0
49,"49132",316,235,232,1,3,"UPyD",0
12,"12098",580,451,447,5,4,"UPyD",0
42,"42085",189,129,127,3,2,"UPyD",0
46,"46094",20540,15378,15234,102,144,"UPyD",38
10,"10190",545,406,395,2,11,"UPyD",3
13,"13025",302,244,244,1,0,"UPyD",1
24,"24132",615,379,375,1,4,"UPyD",0
34,"34158",288,186,184,3,2,"UPyD",0
24,"24202",8008,5367,5276,53,91,"UPyD",6
13,"13078",9041,6325,6266,47,59,"UPyD",15
29,"29092",570,397,390,4,7,"UPyD",3
46,"46172",5042,3504,3477,22,27,"UPyD",3
4,"4012",191,161,161,0,0,"UPyD",2
20,"20065",3012,1985,1967,12,18,"UPyD",4
49,"49014",112,91,91,2,0,"UPyD",0
31,"31907",10745,8067,8009,116,58,"UPyD",17
50,"50268",44,37,37,0,0,"UPyD",0
2,"2049",823,573,564,1,9,"UPyD",0
9,"9230",38,32,32,0,0,"UPyD",0
24,"24034",3394,2380,2342,28,38,"UPyD",1
16,"16107",109,86,85,1,1,"UPyD",0
40,"40183",130,120,119,2,1,"UPyD",0
22,"22014",243,192,188,3,4,"UPyD",3
6,"6073",733,496,484,8,12,"UPyD",0
18,"18904",775,565,558,1,7,"UPyD",0
5,"5157",232,162,159,1,3,"UPyD",0
34,"34066",59,49,48,0,1,"UPyD",0
37,"37351",281,229,227,0,2,"UPyD",0
40,"40224",22,21,21,0,0,"UPyD",0
4,"4048",1503,1090,1085,9,5,"UPyD",1
49,"49174",125,95,92,1,3,"UPyD",0
22,"22130",10092,6671,6608,59,63,"UPyD",14
37,"37183",414,306,304,0,2,"UPyD",2
47,"47098",576,464,452,4,12,"UPyD",0
21,"21015",680,398,393,8,5,"UPyD",0
50,"50269",285,193,188,0,5,"UPyD",0
22,"22220",166,126,125,2,1,"UPyD",1
34,"34023",5236,3685,3636,30,49,"UPyD",12
20,"20068",190,135,135,3,0,"UPyD",0
36,"36033",12298,8968,8788,53,180,"UPyD",15
46,"46175",456,389,387,3,2,"UPyD",0
6,"6075",465,383,372,0,11,"UPyD",1
22,"22052",925,712,710,8,2,"UPyD",1
6,"6030",169,137,135,0,2,"UPyD",0
37,"37051",85,66,66,0,0,"UPyD",0
37,"37311",227,182,182,3,0,"UPyD",1
12,"12001",1051,821,800,4,21,"UPyD",1
4,"4015",124,96,96,2,0,"UPyD",1
37,"37185",591,423,417,2,6,"UPyD",1
24,"24103",283,163,157,1,6,"UPyD",0
16,"16110",93,70,70,0,0,"UPyD",0
37,"37229",135,112,112,0,0,"UPyD",0
34,"34025",57,39,39,1,0,"UPyD",0
41,"41057",269,183,181,0,2,"UPyD",1
4,"4080",209,162,162,3,0,"UPyD",0
10,"10151",207,165,162,0,3,"UPyD",0
4,"4016",2138,1551,1536,9,15,"UPyD",3
39,"39086",358,256,253,0,3,"UPyD",0
22,"22017",866,650,642,5,8,"UPyD",0
9,"9022",66,57,57,1,0,"UPyD",0
37,"37313",550,386,384,2,2,"UPyD",0
24,"24207",294,241,238,3,3,"UPyD",0
40,"40105",47,42,42,2,0,"UPyD",0
5,"5209",85,70,70,0,0,"UPyD",0
35,"35033",6398,4340,4266,19,74,"UPyD",6
31,"31143",96,55,54,1,1,"UPyD",1
45,"45131",282,234,230,0,4,"UPyD",1
5,"5012",133,105,102,0,3,"UPyD",0
47,"47022",59,50,49,0,1,"UPyD",0
29,"29098",1253,917,895,9,22,"UPyD",2
29,"29008",14596,9519,9407,94,112,"UPyD",12
29,"29041",3175,2090,2045,24,45,"UPyD",5
12,"12038",167,120,118,2,2,"UPyD",0
34,"34221",179,144,144,3,0,"UPyD",1
31,"31210",196,152,152,2,0,"UPyD",0
10,"10199",165,112,111,1,1,"UPyD",0
24,"24142",25119,17336,17141,154,195,"UPyD",40
49,"49059",94,64,64,0,0,"UPyD",2
49,"49225",147,91,90,0,1,"UPyD",0
10,"10214",214,181,177,2,4,"UPyD",0
16,"16160",60,44,42,1,2,"UPyD",0
1,"1002",8124,5722,5654,31,68,"UPyD",4
26,"26172",30,23,23,0,0,"UPyD",0
9,"9238",921,573,561,4,12,"UPyD",0
24,"24210",503,358,356,3,2,"UPyD",0
28,"28040",15811,10118,10009,56,109,"UPyD",28
47,"47023",2995,2344,2326,18,18,"UPyD",8
19,"19194",98,69,69,1,0,"UPyD",0
6,"6035",937,696,681,5,15,"UPyD",2
33,"33005",1449,936,924,11,12,"UPyD",3
9,"9377",632,485,480,1,5,"UPyD",1
41,"41061",2195,1749,1703,11,46,"UPyD",1
13,"13038",1630,1230,1207,7,23,"UPyD",3
28,"28069",50,44,41,0,3,"UPyD",0
16,"16115",44,35,34,0,1,"UPyD",0
4,"4053",12320,8946,8866,70,80,"UPyD",14
47,"47049",101,68,68,0,0,"UPyD",0
49,"49143",225,163,162,0,1,"UPyD",1
9,"9197",144,111,109,1,2,"UPyD",1
18,"18069",502,362,357,0,5,"UPyD",4
49,"49181",362,277,276,2,1,"UPyD",1
16,"16217",74,62,62,0,0,"UPyD",0
10,"10065",206,156,155,1,1,"UPyD",0
45,"45135",4269,3340,3288,8,52,"UPyD",2
40,"40109",73,59,59,1,0,"UPyD",1
48,"48070",544,362,362,4,0,"UPyD",0
41,"41062",2223,1653,1637,7,16,"UPyD",0
9,"9065",143,122,122,1,0,"UPyD",0
12,"12007",746,651,636,3,15,"UPyD",1
9,"9242",80,66,66,2,0,"UPyD",0
5,"5018",29,22,22,0,0,"UPyD",0
37,"37192",356,231,227,2,4,"UPyD",0
46,"46154",808,636,631,5,5,"UPyD",0
37,"37206",94,73,73,3,0,"UPyD",0
36,"36016",1143,721,711,3,10,"UPyD",0
26,"26104",13,10,10,0,0,"UPyD",0
50,"50276",125,104,103,2,1,"UPyD",0
10,"10021",5147,3744,3648,31,96,"UPyD",8
6,"6130",195,164,158,0,6,"UPyD",0
3,"3010",325,277,275,1,2,"UPyD",1
45,"45203",2563,1801,1771,8,30,"UPyD",3
28,"28111",596,467,467,3,0,"UPyD",0
31,"31049",699,469,465,2,4,"UPyD",0
5,"5072",81,67,67,1,0,"UPyD",0
40,"40026",119,109,109,0,0,"UPyD",0
19,"19040",52,41,39,0,2,"UPyD",1
20,"20076",6990,4666,4648,29,18,"UPyD",7
14,"14024",1903,1405,1376,16,29,"UPyD",4
50,"50185",133,108,108,1,0,"UPyD",0
13,"13095",85,66,66,0,0,"UPyD",0
16,"16167",316,249,244,1,5,"UPyD",0
28,"28044",5826,4445,4409,24,36,"UPyD",21
9,"9029",168,131,129,4,2,"UPyD",2
45,"45037",1603,1122,1111,5,11,"UPyD",0
18,"18914",1649,1238,1213,3,25,"UPyD",1
42,"42057",164,104,104,2,0,"UPyD",0
10,"10161",76,53,53,0,0,"UPyD",0
46,"46051",8347,6355,6302,24,53,"UPyD",11
42,"42100",32,30,30,0,0,"UPyD",0
49,"49147",263,190,186,0,4,"UPyD",1
42,"42153",14,12,12,0,0,"UPyD",0
40,"40156",322,238,235,1,3,"UPyD",1
18,"18168",804,546,543,7,3,"UPyD",0
19,"19235",93,71,71,1,0,"UPyD",1
19,"19199",17,17,17,1,0,"UPyD",0
12,"12110",234,176,173,0,3,"UPyD",0
9,"9032",109,75,73,0,2,"UPyD",0
30,"30031",492,409,401,0,8,"UPyD",0
37,"37240",945,623,619,5,4,"UPyD",5
18,"18076",804,551,549,1,2,"UPyD",0
23,"23082",1921,1425,1416,8,9,"UPyD",1
34,"34037",302,218,216,1,2,"UPyD",0
10,"10163",350,293,290,2,3,"UPyD",0
5,"5024",224,169,168,3,1,"UPyD",2
50,"50090",150,113,112,0,1,"UPyD",0
19,"19309",26,21,21,0,0,"UPyD",0
3,"3014",237287,167428,166445,847,983,"UPyD",451
10,"10209",282,179,177,1,2,"UPyD",0
28,"28114",150,101,100,1,1,"UPyD",0
5,"5174",68,53,53,2,0,"UPyD",1
50,"50298",5333,3949,3902,39,47,"UPyD",7
18,"18078",732,570,566,2,4,"UPyD",0
41,"41001",1596,1183,1159,5,24,"UPyD",1
10,"10072",859,617,615,5,2,"UPyD",0
37,"37325",89,62,62,0,0,"UPyD",0
10,"10027",77,69,69,1,0,"UPyD",0
37,"37068",365,267,267,1,0,"UPyD",0
23,"23045",2132,1260,1247,5,13,"UPyD",1
16,"16081",48,34,34,0,0,"UPyD",1
49,"49071",765,495,490,2,5,"UPyD",0
9,"9117",76,60,60,0,0,"UPyD",0
42,"42107",74,54,54,3,0,"UPyD",0
16,"16172",325,268,267,1,1,"UPyD",0
40,"40159",142,100,99,1,1,"UPyD",0
5,"5027",269,229,225,2,4,"UPyD",0
40,"40201",49,42,42,0,0,"UPyD",0
23,"23086",11511,7997,7874,91,123,"UPyD",16
37,"37243",98,70,70,1,0,"UPyD",0
46,"46080",998,803,799,7,4,"UPyD",1
49,"49031",148,120,119,6,1,"UPyD",0
36,"36011",1799,1144,1122,8,22,"UPyD",1
41,"41091",541987,385251,382091,3298,3160,"UPyD",1095
19,"19089",30,22,22,0,0,"UPyD",0
28,"28146",1787,1205,1194,0,11,"UPyD",2
39,"39036",969,743,739,2,4,"UPyD",3
40,"40120",192,170,166,0,4,"UPyD",0
37,"37118",123,92,90,0,2,"UPyD",1
37,"37070",529,399,392,1,7,"UPyD",1
49,"49032",326,259,259,1,0,"UPyD",0
9,"9035",311,227,225,2,2,"UPyD",0
41,"41003",2333,1693,1671,13,22,"UPyD",1
26,"26075",329,267,264,2,3,"UPyD",1
20,"20015",1265,858,851,7,7,"UPyD",0
10,"10077",677,479,472,1,7,"UPyD",0
36,"36048",5331,3653,3603,22,50,"UPyD",7
50,"50903",2214,1602,1585,8,17,"UPyD",4
3,"3078",478,389,389,5,0,"UPyD",2
5,"5179",214,178,176,1,2,"UPyD",0
9,"9301",625,473,467,2,6,"UPyD",0
34,"34057",471,339,338,1,1,"UPyD",1
24,"24116",417,314,309,1,5,"UPyD",1
20,"20016",1520,826,821,2,5,"UPyD",0
28,"28117",104,89,89,1,0,"UPyD",0
12,"12050",1305,1015,1000,6,15,"UPyD",3
51,"51001",59125,31093,30737,316,356,"UPyD",71
46,"46160",1913,1452,1436,1,16,"UPyD",1
50,"50284",141,107,104,0,3,"UPyD",0
5,"5180",86,67,63,3,4,"UPyD",0
16,"16239",135,110,105,0,5,"UPyD",1
4,"4063",1096,776,768,2,8,"UPyD",0
7,"7060",2568,1677,1653,16,24,"UPyD",6
33,"33015",1540,998,986,8,12,"UPyD",1
16,"16038",38,31,31,0,0,"UPyD",0
49,"49034",432,327,325,2,2,"UPyD",0
50,"50129",235,161,158,2,3,"UPyD",0
13,"13004",1025,807,800,4,7,"UPyD",1
21,"21035",9617,6033,5943,76,90,"UPyD",3
9,"9303",86,68,68,0,0,"UPyD",0
5,"5084",74,53,53,0,0,"UPyD",0
31,"31091",351,220,217,1,3,"UPyD",0
23,"23051",2758,2171,2144,9,27,"UPyD",5
42,"42027",76,61,60,0,1,"UPyD",0
49,"49035",226,200,196,3,4,"UPyD",0
26,"26078",82,70,70,0,0,"UPyD",0
10,"10126",1548,1120,1102,8,18,"UPyD",2
39,"39009",3216,2366,2337,17,29,"UPyD",4
45,"45046",2412,1667,1654,7,13,"UPyD",1
26,"26114",79,66,65,1,1,"UPyD",0
9,"9350",469,350,343,2,7,"UPyD",0
26,"26150",112,101,95,0,6,"UPyD",0
28,"28177",10270,8083,8030,36,53,"UPyD",30
1,"1059",186557,126506,125278,798,1228,"UPyD",253
6,"6053",602,454,444,3,10,"UPyD",0
31,"31092",662,439,435,4,4,"UPyD",0
22,"22059",1149,807,800,3,7,"UPyD",0
50,"50214",27,18,17,0,1,"UPyD",0
19,"19321",39,30,30,1,0,"UPyD",0
41,"41096",6161,4553,4476,32,77,"UPyD",10
31,"31059",186,131,131,1,0,"UPyD",0
31,"31192",156,129,127,3,2,"UPyD",0
46,"46006",4523,3665,3623,20,42,"UPyD",3
21,"21011",3453,2441,2419,15,22,"UPyD",2
37,"37125",228,161,156,0,5,"UPyD",1
47,"47060",258,216,214,1,2,"UPyD",1
22,"22037",115,86,86,0,0,"UPyD",0
22,"22039",863,671,667,4,4,"UPyD",0
28,"28121",198,160,158,1,2,"UPyD",0
18,"18043",123,80,79,1,1,"UPyD",0
20,"20906",119,87,87,1,0,"UPyD",0
45,"45114",588,447,447,0,0,"UPyD",0
19,"19323",40,31,31,0,0,"UPyD",0
40,"40041",979,725,717,5,8,"UPyD",3
48,"48915",362,227,226,0,1,"UPyD",0
5,"5186",1575,1225,1194,3,31,"UPyD",4
37,"37080",225,171,167,0,4,"UPyD",0
3,"3082",12567,8537,8464,44,73,"UPyD",13
22,"22001",225,151,151,1,0,"UPyD",0
18,"18002",553,395,393,1,2,"UPyD",0
10,"10176",371,262,261,0,1,"UPyD",2
46,"46095",610,467,459,1,8,"UPyD",0
49,"49083",52,44,44,2,0,"UPyD",0
5,"5041",1001,775,762,8,13,"UPyD",1
6,"6057",576,479,471,0,8,"UPyD",1
45,"45116",687,509,505,1,4,"UPyD",0
5,"5187",1754,1323,1303,7,20,"UPyD",0
37,"37337",139,124,124,0,0,"UPyD",0
36,"36019",1625,1042,1029,9,13,"UPyD",0
34,"34051",101,88,83,0,5,"UPyD",0
50,"50007",45,34,34,1,0,"UPyD",0
9,"9398",75,56,56,0,0,"UPyD",0
31,"31062",1087,830,818,3,12,"UPyD",0
47,"47036",228,181,181,3,0,"UPyD",0
37,"37034",85,65,65,0,0,"UPyD",0
18,"18046",1832,1160,1140,6,20,"UPyD",0
9,"9400",317,247,245,1,2,"UPyD",0
9,"9006",59,39,39,0,0,"UPyD",0
26,"26120",1454,1139,1126,7,13,"UPyD",2
46,"46035",6822,5202,5142,43,60,"UPyD",6
45,"45051",1590,1171,1152,5,19,"UPyD",1
45,"45017",262,204,203,0,1,"UPyD",0
5,"5043",84,66,66,0,0,"UPyD",0
50,"50168",28,27,27,0,0,"UPyD",0
41,"41078",2508,1823,1810,19,13,"UPyD",0
49,"49123",546,391,384,1,7,"UPyD",1
6,"6014",6682,4479,4409,14,70,"UPyD",3
7,"7028",899,601,595,7,6,"UPyD",0
16,"16191",899,675,671,2,4,"UPyD",1
41,"41079",9294,6670,6580,51,90,"UPyD",19
31,"31130",312,214,213,3,1,"UPyD",0
28,"28124",74,54,54,1,0,"UPyD",0
34,"34009",31,29,29,1,0,"UPyD",0
31,"31264",180,105,101,2,4,"UPyD",1
9,"9131",462,365,364,2,1,"UPyD",0
34,"34201",193,158,155,1,3,"UPyD",0
45,"45119",3330,2096,2067,15,29,"UPyD",2
28,"28056",863,630,617,4,13,"UPyD",4
33,"33022",893,578,567,11,11,"UPyD",1
3,"3086",151,135,134,1,1,"UPyD",0
36,"36023",8395,5965,5884,41,81,"UPyD",14
50,"50104",348,271,269,2,2,"UPyD",0
50,"50292",125,102,102,1,0,"UPyD",0
6,"6062",594,441,437,5,4,"UPyD",2
24,"24027",1211,863,847,8,16,"UPyD",0
18,"18006",4130,2904,2864,13,40,"UPyD",4
10,"10181",686,533,523,1,10,"UPyD",0
9,"9311",59,46,45,0,1,"UPyD",0
37,"37215",136,104,103,1,1,"UPyD",0
33,"33023",3321,2299,2265,31,34,"UPyD",1
41,"41901",2682,2107,2086,28,21,"UPyD",2
50,"50105",296,214,211,1,3,"UPyD",0
9,"9133",40,32,32,0,0,"UPyD",0
50,"50293",413,276,275,4,1,"UPyD",0
11,"11003",1261,836,822,7,14,"UPyD",0
9,"9312",96,78,77,0,1,"UPyD",0
37,"37132",351,256,253,2,3,"UPyD",1
6,"6064",841,666,656,2,10,"UPyD",0
21,"21019",612,400,391,2,9,"UPyD",0
26,"26160",709,552,549,2,3,"UPyD",1
9,"9360",30,23,23,0,0,"UPyD",0
36,"36025",2257,1360,1350,10,10,"UPyD",3
48,"48067",1158,813,810,2,3,"UPyD",0
37,"37088",207,163,162,3,1,"UPyD",0
2,"2083",219,191,191,0,0,"UPyD",0
50,"50294",70,63,63,0,0,"UPyD",0
22,"22045",82,65,64,1,1,"UPyD",0
50,"50012",100,80,79,2,1,"UPyD",0
34,"34904",315,234,230,2,4,"UPyD",0
5,"5049",401,272,266,1,6,"UPyD",0
29,"29032",6657,5031,4977,33,54,"UPyD",8
34,"34012",357,269,264,5,5,"UPyD",2
31,"31168",246,172,171,1,1,"UPyD",0
42,"42127",38,31,31,1,0,"UPyD",0
45,"45122",5212,4004,3961,16,43,"UPyD",9
12,"12125",216,180,177,0,3,"UPyD",0
21,"21008",2658,1660,1636,10,24,"UPyD",0
24,"24130",438,323,321,4,2,"UPyD",0
48,"48059",400,294,291,0,3,"UPyD",0
21,"21009",857,532,523,4,9,"UPyD",1
5,"5052",95,77,76,0,1,"UPyD",0
37,"37219",173,109,108,0,1,"UPyD",0
24,"24063",374,254,252,2,2,"UPyD",1
46,"46014",3030,2383,2350,20,33,"UPyD",1
46,"46196",147,125,125,1,0,"UPyD",0
26,"26055",39,32,32,0,0,"UPyD",0
30,"30017",11605,8541,8451,46,90,"UPyD",4
31,"31904",1563,1029,1022,23,7,"UPyD",1
1,"1032",517,361,354,1,7,"UPyD",2
19,"19332",92,71,69,1,2,"UPyD",0
12,"12029",702,557,555,4,2,"UPyD",1
16,"16053",426,351,347,5,4,"UPyD",0
37,"37221",430,293,290,0,3,"UPyD",0
34,"34210",103,90,90,0,0,"UPyD",0
5,"5103",72,52,52,0,0,"UPyD",0
41,"41051",2180,1529,1501,2,28,"UPyD",2
37,"37003",115,93,93,0,0,"UPyD",0
33,"33067",784,587,579,9,8,"UPyD",1
37,"37151",148,125,124,2,1,"UPyD",0
34,"34124",60,50,49,0,1,"UPyD",0
16,"16150",97,72,72,0,0,"UPyD",0
31,"31237",193,155,153,2,2,"UPyD",0
34,"34107",81,52,51,5,1,"UPyD",0
19,"19221",48,38,37,1,1,"UPyD",0
16,"16278",70,55,55,0,0,"UPyD",0
37,"37222",93,72,72,0,0,"UPyD",0
39,"39021",487,381,376,2,5,"UPyD",1
23,"23065",1597,1170,1149,2,21,"UPyD",0
33,"33058",1796,1232,1209,11,23,"UPyD",3
39,"39061",3478,2695,2677,13,18,"UPyD",5
46,"46016",1061,870,856,5,14,"UPyD",0
24,"24032",109,91,89,0,2,"UPyD",0
45,"45026",211,167,166,2,1,"UPyD",0
3,"3001",337,269,268,0,1,"UPyD",1
5,"5251",60,42,42,1,0,"UPyD",0
40,"40097",128,93,92,0,1,"UPyD",0
30,"30020",6303,4543,4497,25,46,"UPyD",5
10,"10100",799,578,574,4,4,"UPyD",0
20,"20032",8797,5672,5630,40,42,"UPyD",7
37,"37140",674,443,439,5,4,"UPyD",1
37,"37097",39,27,27,1,0,"UPyD",0
40,"40112",2555,1932,1909,8,23,"UPyD",14
42,"42134",2627,1927,1890,19,37,"UPyD",5
47,"47070",37,27,27,0,0,"UPyD",0
11,"11901",5648,3676,3631,67,45,"UPyD",6
50,"50206",460,363,357,4,6,"UPyD",0
5,"5057",2465,1969,1953,15,16,"UPyD",4
26,"26026",1321,1039,1025,6,14,"UPyD",0
9,"9018",24668,17575,17369,111,206,"UPyD",68
16,"16060",744,565,554,7,11,"UPyD",0
16,"16204",261,199,199,1,0,"UPyD",0
19,"19901",41,38,37,0,1,"UPyD",1
50,"50113",618,489,484,2,5,"UPyD",0
31,"31106",698,533,529,3,4,"UPyD",0
7,"7053",1188,926,918,16,8,"UPyD",1
50,"50146",187,145,144,3,1,"UPyD",0
7,"7041",2044,1486,1451,13,35,"UPyD",0
9,"9275",192,129,129,2,0,"UPyD",0
37,"37050",66,52,52,0,0,"UPyD",0
46,"46070",16950,12765,12676,61,89,"UPyD",35
40,"40157",47,44,44,0,0,"UPyD",0
18,"18905",14618,9789,9682,110,107,"UPyD",36
45,"45161",13688,9007,8902,32,105,"UPyD",24
45,"45196",1400,1047,1033,5,14,"UPyD",1
24,"24216",723,522,518,1,4,"UPyD",1
3,"3034",1376,1067,1052,5,15,"UPyD",0
9,"9415",268,175,175,2,0,"UPyD",1
18,"18063",1200,679,675,2,4,"UPyD",1
42,"42140",16,12,12,0,0,"UPyD",0
6,"6076",831,611,607,2,4,"UPyD",0
10,"10057",143,117,117,1,0,"UPyD",0
33,"33032",11395,7592,7465,90,127,"UPyD",15
36,"36034",3475,2403,2367,11,36,"UPyD",1
50,"50020",809,564,559,2,5,"UPyD",1
5,"5061",252,186,184,3,2,"UPyD",1
45,"45029",201,171,171,1,0,"UPyD",0
50,"50209",2601,1731,1721,13,10,"UPyD",7
16,"16157",211,179,179,2,0,"UPyD",0
47,"47210",382,282,274,3,8,"UPyD",1
46,"46260",2581,2087,2068,22,19,"UPyD",2
49,"49100",295,212,208,5,4,"UPyD",0
42,"42185",26,22,22,0,0,"UPyD",0
42,"42011",18,10,10,1,0,"UPyD",0
45,"45064",3858,2804,2763,20,41,"UPyD",7
33,"33033",9873,6512,6431,68,81,"UPyD",11
18,"18908",801,593,588,3,5,"UPyD",0
42,"42141",112,80,80,0,0,"UPyD",0
9,"9374",90,71,70,1,1,"UPyD",0
34,"34220",147,126,125,3,1,"UPyD",1
22,"22181",92,61,61,2,0,"UPyD",1
47,"47047",199,157,156,2,1,"UPyD",0
12,"12133",59,53,52,0,1,"UPyD",0
46,"46098",2482,1907,1889,11,18,"UPyD",2
46,"46177",4690,3579,3526,19,53,"UPyD",5
18,"18066",2107,1392,1384,4,8,"UPyD",1
37,"37146",117,96,95,1,1,"UPyD",0
45,"45165",62718,44420,44006,236,414,"UPyD",121
5,"5260",105,90,90,0,0,"UPyD",0
29,"29075",12934,8234,8147,69,87,"UPyD",3
6,"6125",1743,1285,1269,7,16,"UPyD",1
50,"50242",93,75,75,3,0,"UPyD",0
33,"33064",234,168,167,1,1,"UPyD",0
13,"13053",14328,10164,10041,72,123,"UPyD",59
3,"3901",1135,822,817,8,5,"UPyD",2
5,"5081",40,36,36,1,0,"UPyD",0
29,"29042",14016,9368,9192,88,176,"UPyD",37
6,"6080",1924,1412,1392,9,20,"UPyD",2
37,"37357",262,205,203,1,2,"UPyD",0
49,"49061",150,114,112,2,2,"UPyD",1
26,"26136",107,85,85,0,0,"UPyD",0
22,"22057",370,271,270,3,1,"UPyD",0
19,"19229",66,56,56,0,0,"UPyD",0
41,"41028",2003,1524,1511,9,13,"UPyD",8
40,"40150",69,61,61,1,0,"UPyD",1
28,"28068",10955,8136,8076,49,60,"UPyD",28
5,"5015",82,61,61,1,0,"UPyD",0
37,"37233",61,48,47,1,1,"UPyD",1
45,"45067",2318,1791,1752,19,39,"UPyD",2
16,"16067",123,87,87,0,0,"UPyD",0
40,"40191",215,181,179,1,2,"UPyD",1
37,"37148",427,298,295,3,3,"UPyD",0
5,"5016",6335,4670,4586,41,84,"UPyD",14
46,"46074",2696,2069,2038,14,31,"UPyD",2
40,"40108",112,82,82,0,0,"UPyD",0
9,"9064",324,271,267,1,4,"UPyD",0
12,"12075",123,88,88,0,0,"UPyD",0
48,"48009",783,586,575,1,11,"UPyD",0
19,"19195",40,32,32,1,0,"UPyD",0
10,"10202",606,473,463,4,10,"UPyD",0
29,"29045",1684,1178,1168,8,10,"UPyD",1
28,"28138",60,46,46,0,0,"UPyD",0
37,"37318",208,159,158,1,1,"UPyD",2
30,"30028",6649,4797,4726,21,71,"UPyD",6
9,"9334",50,39,37,0,2,"UPyD",0
22,"22096",301,240,240,0,0,"UPyD",3
10,"10203",4558,3120,3079,20,41,"UPyD",5
50,"50025",4562,3158,3124,31,34,"UPyD",7
39,"39039",568,382,379,0,3,"UPyD",0
42,"42097",23,14,11,0,3,"UPyD",0
34,"34091",123,94,93,3,1,"UPyD",1
21,"21065",273,186,184,0,2,"UPyD",0
5,"5216",220,171,168,0,3,"UPyD",0
7,"7050",3348,2156,2139,19,17,"UPyD",5
22,"22022",552,414,408,6,6,"UPyD",3
21,"21038",1095,705,693,4,12,"UPyD",1
5,"5120",36,26,26,0,0,"UPyD",0
29,"29068",7016,4300,4244,35,56,"UPyD",3
46,"46903",6065,4790,4763,18,27,"UPyD",6
16,"16089",375,303,303,6,0,"UPyD",1
47,"47144",78,64,64,1,0,"UPyD",0
9,"9155",27,20,20,0,0,"UPyD",0
7,"7051",5215,3171,3134,39,37,"UPyD",4
18,"18029",1833,1196,1190,12,6,"UPyD",1
37,"37362",4632,3389,3351,25,38,"UPyD",11
16,"16073",185,164,164,1,0,"UPyD",0
50,"50216",235,186,184,5,2,"UPyD",1
49,"49066",492,336,332,4,4,"UPyD",2
31,"31050",6014,3489,3450,57,39,"UPyD",2
16,"16121",258,202,202,3,0,"UPyD",1
45,"45171",1361,1035,1023,0,12,"UPyD",1
37,"37195",46,36,36,1,0,"UPyD",0
3,"3042",1393,1010,996,7,14,"UPyD",0
23,"23095",8735,6347,6310,14,37,"UPyD",5
2,"2022",351,281,279,1,2,"UPyD",0
12,"12043",570,449,442,2,7,"UPyD",0
31,"31084",1940,1293,1274,16,19,"UPyD",0
48,"48073",6910,4306,4271,31,35,"UPyD",2
40,"40029",35,27,26,0,1,"UPyD",0
50,"50155",103,80,78,0,2,"UPyD",0
5,"5075",107,72,72,0,0,"UPyD",0
28,"28143",72,57,57,1,0,"UPyD",1
13,"13097",2270,1687,1671,7,16,"UPyD",0
9,"9339",128,110,110,0,0,"UPyD",1
48,"48907",348,266,266,2,0,"UPyD",0
31,"31018",393,292,285,4,7,"UPyD",1
41,"41077",8702,5983,5875,29,108,"UPyD",5
42,"42196",10,7,7,0,0,"UPyD",0
16,"16123",82,61,61,3,0,"UPyD",0
50,"50028",78,51,51,0,0,"UPyD",0
34,"34230",15,12,12,0,0,"UPyD",0
42,"42021",83,55,55,3,0,"UPyD",0
26,"26082",112,87,87,1,0,"UPyD",0
12,"12111",360,305,299,3,6,"UPyD",0
40,"40031",526,398,396,2,2,"UPyD",2
42,"42155",167,103,102,1,1,"UPyD",0
13,"13012",413,274,273,1,1,"UPyD",0
9,"9115",92,68,67,0,1,"UPyD",1
45,"45140",1087,833,823,3,10,"UPyD",0
35,"35014",11209,6016,5917,42,99,"UPyD",23
22,"22063",169,133,129,1,4,"UPyD",0
6,"6091",3774,2709,2666,23,43,"UPyD",4
19,"19124",386,260,257,0,3,"UPyD",0
23,"23084",935,658,653,7,5,"UPyD",0
4,"4026",66,54,51,0,3,"UPyD",0
10,"10119",620,460,452,1,8,"UPyD",0
42,"42156",28,16,16,1,0,"UPyD",0
29,"29051",40391,25780,25419,232,361,"UPyD",44
1,"1054",960,654,651,4,3,"UPyD",0
16,"16125",1667,1249,1231,3,18,"UPyD",1
37,"37117",1494,1067,1048,3,19,"UPyD",4
9,"9163",582,467,459,2,8,"UPyD",0
23,"23085",2252,1655,1644,6,11,"UPyD",3
35,"35016",297736,192251,190256,1386,1995,"UPyD",450
45,"45041",3752,2633,2597,12,36,"UPyD",2
46,"46106",1535,1150,1140,10,10,"UPyD",2
47,"47056",87,67,67,0,0,"UPyD",0
24,"24151",478,353,352,1,1,"UPyD",2
3,"3016",93,75,75,0,0,"UPyD",0
26,"26181",14,14,14,0,0,"UPyD",0
26,"26183",64,49,49,0,0,"UPyD",0
49,"49190",63,47,45,0,2,"UPyD",0
49,"49191",272,213,206,2,7,"UPyD",0
37,"37368",17,17,17,0,0,"UPyD",0
48,"48077",3364,2437,2431,18,6,"UPyD",0
16,"16906",80,67,67,1,0,"UPyD",0
18,"18175",11670,8200,8097,36,103,"UPyD",11
12,"12049",441,322,312,1,10,"UPyD",0
24,"24083",1042,727,715,6,12,"UPyD",2
4,"4092",2838,2127,2103,10,24,"UPyD",5
23,"23035",1106,873,855,1,18,"UPyD",2
9,"9346",92,64,63,1,1,"UPyD",0
21,"21033",538,373,370,3,3,"UPyD",0
9,"9166",97,81,81,0,0,"UPyD",0
34,"34151",159,104,103,0,1,"UPyD",0
20,"20027",2814,1761,1750,15,11,"UPyD",1
50,"50233",106,81,81,0,0,"UPyD",0
45,"45110",1786,1403,1398,5,5,"UPyD",0
31,"31189",1161,720,709,6,11,"UPyD",0
47,"47005",549,413,408,2,5,"UPyD",0
37,"37162",204,152,151,0,1,"UPyD",0
46,"46186",19068,14599,14474,69,125,"UPyD",37
46,"46030",800,627,614,5,13,"UPyD",0
40,"40035",137,105,104,0,1,"UPyD",0
46,"46108",469,378,375,1,3,"UPyD",0
31,"31223",985,704,698,4,6,"UPyD",0
49,"49155",79,61,60,3,1,"UPyD",0
26,"26113",35,35,34,0,1,"UPyD",0
5,"5228",174,121,120,0,1,"UPyD",0
31,"31090",144,77,77,1,0,"UPyD",0
40,"40079",234,179,179,3,0,"UPyD",2
40,"40205",261,202,198,2,4,"UPyD",1
47,"47167",241,204,204,1,0,"UPyD",0
5,"5132",960,669,657,1,12,"UPyD",0
31,"31123",647,369,361,5,8,"UPyD",0
11,"11039",10018,6186,6109,103,77,"UPyD",13
50,"50163",3689,2702,2680,37,22,"UPyD",9
34,"34136",179,110,110,1,0,"UPyD",1
48,"48079",427,305,304,2,1,"UPyD",0
21,"21076",2121,1458,1437,17,21,"UPyD",2
22,"22036",92,77,77,0,0,"UPyD",0
37,"37074",150,123,120,0,3,"UPyD",0
6,"6022",2651,2089,2054,10,35,"UPyD",1
23,"23092",27775,19734,19541,175,193,"UPyD",24
19,"19132",92,81,81,0,0,"UPyD",0
37,"37123",177,126,126,0,0,"UPyD",3
31,"31003",122,87,87,0,0,"UPyD",0
47,"47205",384,266,260,0,6,"UPyD",1
24,"24187",857,603,593,7,10,"UPyD",2
13,"13023",8973,6291,6242,44,49,"UPyD",6
31,"31213",104,52,52,0,0,"UPyD",0
22,"22227",206,163,160,3,3,"UPyD",1
49,"49081",1382,1016,1003,9,13,"UPyD",0
24,"24055",708,516,512,0,4,"UPyD",0
16,"16243",407,338,334,3,4,"UPyD",1
40,"40207",763,599,593,3,6,"UPyD",0
50,"50266",122,90,90,0,0,"UPyD",0
40,"40095",477,377,369,0,8,"UPyD",0
7,"7023",3604,2498,2470,49,28,"UPyD",6
42,"42163",50,41,40,0,1,"UPyD",0
10,"10144",975,746,735,3,11,"UPyD",1
35,"35020",6034,3992,3934,20,58,"UPyD",4
33,"33048",154,95,94,0,1,"UPyD",0
46,"46033",191,156,155,0,1,"UPyD",0
34,"34241",18,13,13,1,0,"UPyD",0
9,"9043",192,137,133,1,4,"UPyD",1
16,"16042",1157,933,921,4,12,"UPyD",2
45,"45115",2552,1999,1966,8,33,"UPyD",2
9,"9438",538,437,433,6,4,"UPyD",3
45,"45048",358,278,275,1,3,"UPyD",0
16,"16245",419,327,323,7,4,"UPyD",0
50,"50100",329,246,241,1,5,"UPyD",0
49,"49038",99,71,65,1,6,"UPyD",0
5,"5106",35,25,25,0,0,"UPyD",0
42,"42181",412,313,307,2,6,"UPyD",1
28,"28161",48848,35503,35203,210,300,"UPyD",135
46,"46112",536,455,450,2,5,"UPyD",0
7,"7901",610,462,459,7,3,"UPyD",0
41,"41043",639,436,427,5,9,"UPyD",1
9,"9082",39,36,36,0,0,"UPyD",0
29,"29059",2587,1965,1922,14,43,"UPyD",3
9,"9044",46,35,34,1,1,"UPyD",0
9,"9440",91,78,78,2,0,"UPyD",0
49,"49084",287,229,228,4,1,"UPyD",1
5,"5236",123,91,90,1,1,"UPyD",2
26,"26016",28,25,24,1,1,"UPyD",0
46,"46018",608,515,511,0,4,"UPyD",1
16,"16045",222,172,171,1,1,"UPyD",0
50,"50038",1502,1121,1111,7,10,"UPyD",2
29,"29060",692,510,508,1,2,"UPyD",0
37,"37128",260,202,196,0,6,"UPyD",0
7,"7027",20769,13097,12987,100,110,"UPyD",23
11,"11011",1716,1195,1165,12,30,"UPyD",3
19,"19136",18,14,14,0,0,"UPyD",0
5,"5237",162,130,124,2,6,"UPyD",0
34,"34245",307,209,208,5,1,"UPyD",0
28,"28018",3768,2968,2945,26,23,"UPyD",5
16,"16046",245,180,180,1,0,"UPyD",0
22,"22003",137,110,107,1,3,"UPyD",1
42,"42212",69,43,43,1,0,"UPyD",2
41,"41046",3023,2213,2183,5,30,"UPyD",2
47,"47227",61,50,50,0,0,"UPyD",0
41,"41012",3290,2071,2030,20,41,"UPyD",2
45,"45018",498,333,330,4,3,"UPyD",0
50,"50260",33,33,32,0,1,"UPyD",0
9,"9403",94,78,78,1,0,"UPyD",0
6,"6015",116758,77960,77205,583,755,"UPyD",174
13,"13014",492,398,397,1,1,"UPyD",0
22,"22207",125,72,71,2,1,"UPyD",0
31,"31098",1903,1428,1419,19,9,"UPyD",1
19,"19139",29,19,18,0,1,"UPyD",0
26,"26121",25,22,22,0,0,"UPyD",0
34,"34901",1104,825,814,5,11,"UPyD",4
6,"6107",1581,999,995,8,4,"UPyD",2
13,"13015",5431,3993,3950,17,43,"UPyD",3
5,"5240",3374,2283,2257,7,26,"UPyD",4
42,"42035",769,527,516,2,11,"UPyD",1
4,"4071",394,338,337,3,1,"UPyD",0
47,"47228",440,331,331,2,0,"UPyD",0
50,"50241",588,415,410,4,5,"UPyD",0
28,"28066",7182,5422,5371,17,51,"UPyD",20
6,"6078",507,409,404,1,5,"UPyD",0
46,"46037",1122,936,923,4,13,"UPyD",1
13,"13016",664,517,509,4,8,"UPyD",1
34,"34010",577,440,438,5,2,"UPyD",3
16,"16097",156,124,121,0,3,"UPyD",0
40,"40048",38,29,27,0,2,"UPyD",0
11,"11036",689,407,400,3,7,"UPyD",1
30,"30015",19171,13561,13464,61,97,"UPyD",9
16,"16145",450,363,361,5,2,"UPyD",0
37,"37244",131,98,98,0,0,"UPyD",1
50,"50211",249,176,173,0,3,"UPyD",0
34,"34071",171,132,132,1,0,"UPyD",0
26,"26148",165,135,133,1,2,"UPyD",0
39,"39027",3118,2322,2295,26,27,"UPyD",5
10,"10169",531,420,409,2,11,"UPyD",0
4,"4029",8859,5834,5790,35,44,"UPyD",29
18,"18099",1584,1228,1206,14,22,"UPyD",0
2,"2002",470,394,389,3,5,"UPyD",0
3,"3027",157,138,135,0,3,"UPyD",0
40,"40007",78,63,61,0,2,"UPyD",0
3,"3090",17182,12487,12385,74,102,"UPyD",25
49,"49265",128,91,91,1,0,"UPyD",0
7,"7032",20034,12824,12710,110,114,"UPyD",17
18,"18051",1147,817,810,8,7,"UPyD",0
37,"37176",133,110,110,0,0,"UPyD",0
7,"7033",27104,15524,15337,174,187,"UPyD",27
45,"45155",355,291,285,0,6,"UPyD",0
5,"5244",50,39,39,1,0,"UPyD",0
46,"46117",495,402,399,5,3,"UPyD",1
42,"42039",226,138,138,4,0,"UPyD",0
19,"19183",74,65,65,0,0,"UPyD",0
33,"33056",4997,3269,3244,22,25,"UPyD",7
41,"41083",1147,864,856,4,8,"UPyD",1
36,"36002",3147,2193,2169,20,24,"UPyD",6
28,"28060",1510,1134,1117,1,17,"UPyD",4
34,"34015",41,35,35,3,0,"UPyD",0
13,"13021",434,365,363,4,2,"UPyD",0
18,"18012",2278,1662,1641,13,21,"UPyD",2
37,"37235",224,153,148,2,5,"UPyD",1
39,"39019",2079,1560,1531,10,29,"UPyD",0
42,"42096",272,171,170,6,1,"UPyD",0
16,"16010",152,115,112,0,3,"UPyD",1
40,"40220",66,50,46,1,4,"UPyD",1
46,"46222",384,307,304,1,3,"UPyD",0
10,"10127",4703,3183,3132,21,51,"UPyD",5
50,"50056",409,300,300,3,0,"UPyD",1
31,"31070",2638,1808,1784,20,24,"UPyD",4
22,"22021",1971,1414,1398,17,16,"UPyD",0
26,"26027",157,112,108,0,4,"UPyD",0
33,"33007",1514,946,942,12,4,"UPyD",2
16,"16163",74,62,62,0,0,"UPyD",0
50,"50245",88,65,64,0,1,"UPyD",0
29,"29091",8957,6186,6078,56,108,"UPyD",8
28,"28033",3899,2805,2788,7,17,"UPyD",4
9,"9154",137,98,97,2,1,"UPyD",0
16,"16071",20,20,20,0,0,"UPyD",0
9,"9055",52,42,41,1,1,"UPyD",0
5,"5249",105,84,82,0,2,"UPyD",0
37,"37060",243,187,187,1,0,"UPyD",1
45,"45125",2305,1865,1841,8,24,"UPyD",5
42,"42098",10,7,7,1,0,"UPyD",0
47,"47152",78,60,60,0,0,"UPyD",0
42,"42193",14,10,10,0,0,"UPyD",0
40,"40055",37,26,26,0,0,"UPyD",0
35,"35003",5211,2949,2908,13,41,"UPyD",2
10,"10099",583,378,374,2,4,"UPyD",0
16,"16012",84,72,71,0,1,"UPyD",0
50,"50016",52,40,40,0,0,"UPyD",0
31,"31138",932,601,599,2,2,"UPyD",3
9,"9229",198,146,143,0,3,"UPyD",1
34,"34020",52,39,39,0,0,"UPyD",0
49,"49133",304,214,213,1,1,"UPyD",0
24,"24012",290,207,205,1,2,"UPyD",1
26,"26142",787,612,606,3,6,"UPyD",1
10,"10023",835,616,607,2,9,"UPyD",0
34,"34159",357,253,248,4,5,"UPyD",0
40,"40014",58,46,45,0,1,"UPyD",0
45,"45194",68,54,53,0,1,"UPyD",0
9,"9450",28,22,21,0,1,"UPyD",0
45,"45160",1109,874,864,6,10,"UPyD",1
49,"49096",170,131,124,2,7,"UPyD",0
5,"5205",74,57,55,1,2,"UPyD",1
37,"37196",75,64,64,0,0,"UPyD",0
40,"40015",28,26,26,1,0,"UPyD",0
37,"37007",437,314,306,3,8,"UPyD",0
9,"9427",1419,978,959,8,19,"UPyD",7
46,"46052",499,421,417,2,4,"UPyD",0
5,"5124",102,83,81,0,2,"UPyD",1
39,"39087",41985,31178,30805,228,373,"UPyD",105
41,"41055",14954,10068,9945,64,123,"UPyD",14
22,"22176",173,134,130,1,4,"UPyD",0
7,"7013",6881,4693,4587,39,106,"UPyD",8
49,"49188",112,90,89,1,1,"UPyD",0
31,"31107",1710,1255,1243,16,12,"UPyD",4
29,"29005",4358,2859,2817,28,42,"UPyD",4
40,"40086",685,561,552,4,9,"UPyD",0
29,"29050",421,306,302,3,4,"UPyD",0
9,"9020",259,196,188,5,8,"UPyD",0
40,"40016",58,49,49,0,0,"UPyD",1
5,"5060",116,95,95,0,0,"UPyD",0
2,"2025",7461,5759,5618,34,141,"UPyD",16
49,"49222",380,279,272,0,7,"UPyD",1
24,"24069",41,35,35,0,0,"UPyD",1
11,"11012",99886,70290,69673,693,617,"UPyD",246
5,"5110",711,510,505,4,5,"UPyD",1
50,"50115",3235,2128,2109,14,19,"UPyD",0
10,"10058",1021,718,708,2,10,"UPyD",11
21,"21016",1023,746,723,4,23,"UPyD",0
28,"28065",126539,96997,96210,505,787,"UPyD",418
31,"31153",2159,1403,1387,12,16,"UPyD",0
9,"9102",36,30,30,0,0,"UPyD",0
50,"50179",249,214,213,2,1,"UPyD",0
26,"26169",64,60,60,0,0,"UPyD",0
31,"31010",5705,3718,3680,29,38,"UPyD",7
16,"16018",394,318,315,1,3,"UPyD",0
6,"6123",4627,3182,3120,18,62,"UPyD",4
16,"16272",221,176,175,0,1,"UPyD",0
31,"31054",462,255,250,4,5,"UPyD",0
45,"45142",7871,6007,5927,37,80,"UPyD",5
34,"34084",138,109,107,0,2,"UPyD",0
3,"3098",505,393,386,0,7,"UPyD",1
37,"37230",221,159,159,2,0,"UPyD",1
9,"9328",76,56,56,0,0,"UPyD",1
6,"6124",1708,1202,1165,8,37,"UPyD",0
40,"40061",67,55,54,1,1,"UPyD",0
47,"47211",47,35,34,0,1,"UPyD",0
37,"37187",572,427,423,1,4,"UPyD",0
9,"9181",300,221,221,0,0,"UPyD",1
49,"49044",80,60,58,0,2,"UPyD",0
19,"19169",40,34,34,0,0,"UPyD",1
5,"5130",90,85,85,0,0,"UPyD",0
31,"31125",274,194,193,6,1,"UPyD",0
6,"6003",823,627,616,1,11,"UPyD",0
13,"13070",760,583,574,11,9,"UPyD",2
28,"28095",1529,1119,1106,6,13,"UPyD",3
10,"10031",165,135,134,1,1,"UPyD",0
36,"36012",3732,2751,2717,9,34,"UPyD",2
37,"37056",37,30,29,0,1,"UPyD",0
33,"33034",10612,6602,6536,62,66,"UPyD",14
33,"33065",1102,722,713,7,9,"UPyD",3
45,"45043",793,657,649,1,8,"UPyD",2
9,"9063",209,168,167,2,1,"UPyD",2
10,"10017",825,620,611,3,9,"UPyD",0
49,"49226",255,198,195,0,3,"UPyD",1
26,"26065",50,43,42,0,1,"UPyD",1
34,"34121",187,148,148,3,0,"UPyD",0
50,"50243",331,250,246,0,4,"UPyD",0
6,"6127",2863,2112,2088,10,24,"UPyD",2
14,"14021",260178,181773,180348,1872,1425,"UPyD",388
33,"33066",42963,28564,28282,300,282,"UPyD",58
9,"9419",78,55,55,0,0,"UPyD",0
47,"47058",200,145,143,0,2,"UPyD",1
41,"41039",31663,22062,21830,193,232,"UPyD",30
49,"49117",465,330,324,6,6,"UPyD",0
9,"9269",36,26,26,1,0,"UPyD",0
23,"23039",2204,1596,1558,11,38,"UPyD",1
22,"22186",181,130,129,1,1,"UPyD",0
34,"34074",707,540,531,9,9,"UPyD",1
18,"18040",231,136,133,0,3,"UPyD",1
50,"50213",94,75,74,0,1,"UPyD",0
18,"18134",5828,3840,3800,36,40,"UPyD",14
47,"47185",99,73,71,0,2,"UPyD",0
42,"42149",381,277,273,2,4,"UPyD",2
49,"49197",175,123,123,1,0,"UPyD",0
46,"46104",1940,1504,1487,7,17,"UPyD",0
40,"40164",177,139,138,0,1,"UPyD",1
19,"19160",886,558,552,2,6,"UPyD",0
33,"33050",592,387,376,2,11,"UPyD",1
45,"45106",7439,5613,5534,52,79,"UPyD",9
37,"37016",569,406,401,2,5,"UPyD",0
26,"26175",51,41,41,0,0,"UPyD",0
47,"47146",255,206,204,1,2,"UPyD",2
31,"31115",165,102,101,1,1,"UPyD",0
40,"40194",39602,29382,29042,206,340,"UPyD",136
10,"10174",174,135,132,0,3,"UPyD",0
24,"24119",706,488,481,3,7,"UPyD",0
37,"37061",225,168,168,1,0,"UPyD",0
5,"5019",44555,33259,32939,277,320,"UPyD",186
26,"26165",358,304,299,2,5,"UPyD",0
42,"42055",164,121,121,0,0,"UPyD",0
3,"3051",348,296,294,0,2,"UPyD",0
47,"47009",107,86,85,0,1,"UPyD",0
49,"49120",74,53,52,0,1,"UPyD",0
39,"39031",1236,878,868,4,10,"UPyD",1
12,"12139",318,237,233,0,4,"UPyD",0
50,"50215",24,19,19,0,0,"UPyD",0
49,"49231",330,232,232,2,0,"UPyD",2
11,"11020",165378,109810,108830,1188,980,"UPyD",318
14,"14025",2924,2466,2422,14,44,"UPyD",3
23,"23002",17428,12820,12644,70,176,"UPyD",25
40,"40904",357,308,306,3,2,"UPyD",0
28,"28170",2472,1640,1622,13,18,"UPyD",1
1,"1061",154,127,127,1,0,"UPyD",0
45,"45015",606,437,433,2,4,"UPyD",7
45,"45004",567,410,406,1,4,"UPyD",1
48,"48905",2553,1792,1771,12,21,"UPyD",1
42,"42103",575,450,445,1,5,"UPyD",0
9,"9030",112,75,73,1,2,"UPyD",0
37,"37280",78,53,53,0,0,"UPyD",0
45,"45105",392,301,297,3,4,"UPyD",1
28,"28113",34751,25832,25612,120,220,"UPyD",112
18,"18074",262,201,200,2,1,"UPyD",0
42,"42073",75,58,58,0,0,"UPyD",1
16,"16030",24,19,19,0,0,"UPyD",0
46,"46133",533,415,410,6,5,"UPyD",0
45,"45083",472,368,365,0,3,"UPyD",2
45,"45117",747,606,601,4,5,"UPyD",1
48,"48046",12611,8836,8794,39,42,"UPyD",1
9,"9390",611,484,482,3,2,"UPyD",0
3,"3044",4521,3510,3465,21,45,"UPyD",3
37,"37156",4292,2996,2966,24,30,"UPyD",3
13,"13034",58191,42423,42027,291,396,"UPyD",134
22,"22206",193,129,128,1,1,"UPyD",0
39,"39034",286,188,185,5,3,"UPyD",0
22,"22025",1071,676,669,18,7,"UPyD",0
45,"45039",224,192,190,0,2,"UPyD",0
13,"13065",2854,1901,1888,9,13,"UPyD",0
37,"37115",123,89,87,0,2,"UPyD",0
46,"46053",553,445,436,2,9,"UPyD",0
36,"36009",4503,3056,3001,15,55,"UPyD",3
26,"26006",1800,1419,1405,8,14,"UPyD",4
12,"12046",191,151,150,2,1,"UPyD",0
21,"21070",6258,4165,4092,48,73,"UPyD",5
31,"31152",1328,924,900,11,24,"UPyD",2
5,"5077",158,140,139,1,1,"UPyD",0
46,"46001",795,601,592,3,9,"UPyD",1
24,"24081",140,98,92,0,6,"UPyD",0
49,"49112",126,75,75,0,0,"UPyD",0
35,"35015",9950,5139,5070,29,69,"UPyD",5
40,"40119",169,138,133,1,5,"UPyD",1
2,"2039",984,790,786,10,4,"UPyD",1
19,"19004",67,53,53,1,0,"UPyD",0
31,"31053",523,372,368,1,4,"UPyD",2
49,"49113",167,137,135,1,2,"UPyD",0
46,"46132",2150,1803,1784,7,19,"UPyD",3
6,"6001",686,522,515,0,7,"UPyD",1
40,"40075",160,139,139,0,0,"UPyD",0
48,"48015",33581,22727,22528,122,199,"UPyD",34
11,"11002",4273,2835,2815,16,20,"UPyD",3
5,"5162",86,66,63,0,3,"UPyD",0
3,"3006",497,384,380,1,4,"UPyD",0
34,"34232",750,578,564,7,14,"UPyD",0
30,"30034",1129,858,844,7,14,"UPyD",0
13,"13068",1061,747,740,4,7,"UPyD",0
49,"49122",782,526,520,5,6,"UPyD",3
31,"31255",102,79,79,1,0,"UPyD",0
12,"12123",48,40,40,3,0,"UPyD",0
6,"6114",137,112,112,0,0,"UPyD",0
45,"45050",457,333,328,1,5,"UPyD",0
46,"46072",3611,2871,2821,23,50,"UPyD",1
9,"9236",38,32,32,0,0,"UPyD",0
40,"40025",136,117,115,0,2,"UPyD",0
31,"31214",91,64,62,1,2,"UPyD",0
16,"16237",110,87,87,0,0,"UPyD",0
49,"49153",174,136,132,0,4,"UPyD",0
42,"42159",37,29,29,0,0,"UPyD",0
18,"18010",566,427,421,1,6,"UPyD",0
22,"22008",173,137,133,3,4,"UPyD",1
36,"36013",2344,1536,1514,11,22,"UPyD",0
33,"33014",9037,5999,5938,53,61,"UPyD",9
29,"29031",1614,1107,1094,13,13,"UPyD",0
41,"41027",3922,2660,2604,23,56,"UPyD",1
16,"16130",571,450,448,1,2,"UPyD",1
20,"20017",8559,5478,5435,24,43,"UPyD",4
18,"18085",720,507,499,3,8,"UPyD",0
19,"19129",28,26,26,0,0,"UPyD",0
22,"22200",244,184,182,5,2,"UPyD",0
24,"24117",434,334,331,1,3,"UPyD",0
31,"31224",893,671,662,3,9,"UPyD",0
9,"9348",148,111,110,2,1,"UPyD",0
37,"37073",586,448,438,2,10,"UPyD",6
37,"37122",201,154,153,5,1,"UPyD",0
42,"42175",21,16,16,0,0,"UPyD",0
19,"19060",146,119,118,1,1,"UPyD",1
13,"13072",768,579,572,5,7,"UPyD",0
34,"34208",51,42,42,0,0,"UPyD",0
22,"22251",364,284,284,0,0,"UPyD",0
5,"5245",353,286,285,3,1,"UPyD",2
45,"45180",2727,1966,1940,9,26,"UPyD",1
9,"9332",140,106,106,2,0,"UPyD",0
37,"37164",256,191,189,5,2,"UPyD",0
48,"48069",12798,8679,8612,55,67,"UPyD",7
46,"46248",4897,3596,3544,18,52,"UPyD",7
10,"10081",182,142,135,2,7,"UPyD",0
46,"46028",387,330,328,3,2,"UPyD",0
28,"28091",5440,3596,3558,24,38,"UPyD",10
9,"9140",124,80,79,0,1,"UPyD",0
49,"49097",85,52,51,0,1,"UPyD",0
24,"24230",426,322,320,5,2,"UPyD",3
47,"47198",69,50,50,0,0,"UPyD",0
46,"46250",578719,442973,440154,2541,2819,"UPyD",1066
48,"48083",6958,4885,4856,40,29,"UPyD",8
50,"50050",98,64,64,2,0,"UPyD",0
26,"26079",634,520,512,4,8,"UPyD",1
4,"4096",266,209,208,0,1,"UPyD",1
49,"49131",264,194,192,6,2,"UPyD",0
49,"49107",126,94,93,2,1,"UPyD",0
49,"49171",646,514,508,10,6,"UPyD",1
46,"46145",21990,16337,16187,93,150,"UPyD",24
37,"37110",113,86,86,1,0,"UPyD",0
23,"23027",723,576,572,3,4,"UPyD",0
50,"50132",751,543,536,0,7,"UPyD",1
10,"10205",2020,1319,1293,5,26,"UPyD",2
5,"5136",96,61,60,3,1,"UPyD",0
50,"50099",3083,2148,2132,13,16,"UPyD",0
22,"22074",313,228,225,4,3,"UPyD",0
21,"21039",311,225,223,1,2,"UPyD",0
5,"5088",30,23,23,0,0,"UPyD",0
47,"47170",33,28,27,2,1,"UPyD",0
47,"47088",103,86,85,1,1,"UPyD",0
10,"10130",1761,1300,1277,6,23,"UPyD",0
31,"31160",106,89,88,2,1,"UPyD",0
45,"45093",155,129,127,1,2,"UPyD",0
37,"37047",180,84,84,0,0,"UPyD",0
47,"47106",50,39,39,0,0,"UPyD",1
49,"49258",114,93,91,2,2,"UPyD",0
9,"9308",67,42,42,1,0,"UPyD",0
45,"45149",556,446,440,0,6,"UPyD",0
5,"5139",74,65,65,0,0,"UPyD",0
46,"46086",82,70,69,1,1,"UPyD",0
40,"40084",62,55,52,0,3,"UPyD",0
23,"23096",2642,2164,2138,9,26,"UPyD",4
23,"23030",1238,968,960,3,8,"UPyD",0
40,"40022",213,164,161,2,3,"UPyD",2
23,"23020",1590,1370,1349,9,21,"UPyD",2
42,"42216",25,23,23,0,0,"UPyD",0
46,"46151",728,550,541,0,9,"UPyD",0
18,"18122",16114,11098,10945,83,153,"UPyD",24
34,"34902",139,106,106,0,0,"UPyD",0
24,"24028",388,292,288,2,4,"UPyD",0
3,"3036",87,81,78,0,3,"UPyD",0
46,"46075",150,130,123,1,7,"UPyD",1
47,"47137",29,25,25,1,0,"UPyD",0
12,"12021",4436,3381,3332,27,49,"UPyD",2
26,"26017",381,293,293,5,0,"UPyD",2
36,"36056",5076,3584,3515,30,69,"UPyD",4
6,"6044",28875,19791,19616,145,175,"UPyD",39
10,"10134",567,401,396,2,5,"UPyD",0
50,"50198",54,41,41,1,0,"UPyD",0
30,"30032",2856,2163,2144,6,19,"UPyD",3
45,"45154",1493,1079,1074,6,5,"UPyD",3
13,"13048",504,390,387,2,3,"UPyD",2
11,"11001",4358,2816,2767,11,49,"UPyD",1
49,"49176",667,433,431,1,2,"UPyD",0
24,"24026",1177,864,849,7,15,"UPyD",1
10,"10180",4134,2643,2601,25,42,"UPyD",2
18,"18047",5903,3893,3857,28,36,"UPyD",10
47,"47012",113,93,93,0,0,"UPyD",0
47,"47173",880,644,638,20,6,"UPyD",0
24,"24193",378,268,265,2,3,"UPyD",0
10,"10073",747,524,516,4,8,"UPyD",0
24,"24093",360,249,248,2,1,"UPyD",0
9,"9221",461,343,338,3,5,"UPyD",4
37,"37037",117,84,82,0,2,"UPyD",0
28,"28183",1039,743,735,2,8,"UPyD",5
18,"18049",595,459,452,3,7,"UPyD",0
36,"36022",9011,6310,6172,49,138,"UPyD",13
18,"18187",557,383,379,0,4,"UPyD",0
40,"40230",94,68,66,0,2,"UPyD",0
18,"18082",861,616,611,5,5,"UPyD",0
7,"7017",851,582,571,7,11,"UPyD",1
45,"45130",317,253,250,1,3,"UPyD",0
12,"12037",17,16,14,0,2,"UPyD",1
22,"22040",144,117,115,1,2,"UPyD",0
49,"49187",1236,896,888,4,8,"UPyD",2
36,"36007",1672,1119,1099,8,20,"UPyD",0
4,"4023",138,96,95,2,1,"UPyD",1
2,"2028",126,98,98,0,0,"UPyD",0
42,"42007",113,86,86,5,0,"UPyD",1
26,"26004",67,50,50,0,0,"UPyD",0
46,"46044",4218,3222,3158,18,64,"UPyD",4
22,"22015",319,234,228,3,6,"UPyD",2
45,"45035",281,212,209,1,3,"UPyD",0
24,"24183",805,555,549,6,6,"UPyD",1
45,"45188",2785,1960,1938,15,22,"UPyD",2
30,"30035",18671,13103,12979,54,124,"UPyD",26
46,"46055",1262,1025,1012,5,13,"UPyD",0
16,"16146",83,57,57,0,0,"UPyD",0
50,"50171",106,79,79,0,0,"UPyD",0
12,"12076",84,69,69,0,0,"UPyD",0
47,"47229",210,148,147,1,1,"UPyD",0
42,"42217",31,25,24,0,1,"UPyD",0
3,"3068",47,44,44,0,0,"UPyD",0
47,"47040",64,53,53,0,0,"UPyD",0
5,"5148",25,15,15,0,0,"UPyD",0
10,"10063",173,139,137,0,2,"UPyD",0
29,"29010",1651,1278,1237,4,41,"UPyD",1
46,"46221",352,305,304,0,1,"UPyD",0
28,"28902",471,363,356,4,7,"UPyD",2
49,"49010",345,279,273,5,6,"UPyD",3
4,"4009",162,123,122,2,1,"UPyD",0
24,"24086",270,223,218,0,5,"UPyD",0
50,"50065",53,43,43,0,0,"UPyD",0
28,"28022",33479,27129,27037,133,92,"UPyD",80
49,"49209",505,342,341,2,1,"UPyD",0
37,"37135",1207,905,899,15,6,"UPyD",0
31,"31146",35,30,29,1,1,"UPyD",0
49,"49104",343,234,232,0,2,"UPyD",0
40,"40037",41,29,29,0,0,"UPyD",0
9,"9464",35,27,27,0,0,"UPyD",0
6,"6082",383,287,286,2,1,"UPyD",0
29,"29044",809,561,561,3,0,"UPyD",1
41,"41025",2020,1361,1320,7,41,"UPyD",6
18,"18907",1843,1393,1388,4,5,"UPyD",1
5,"5063",32,28,27,0,1,"UPyD",0
33,"33003",646,355,352,9,3,"UPyD",1
4,"4003",17357,11157,11075,64,82,"UPyD",9
40,"40189",512,401,392,2,9,"UPyD",0
34,"34116",62,49,49,0,0,"UPyD",0
22,"22089",302,225,223,0,2,"UPyD",1
47,"47001",55,46,46,0,0,"UPyD",0
39,"39094",848,655,651,3,4,"UPyD",2
11,"11902",3629,2275,2252,25,23,"UPyD",1
50,"50174",91,69,68,0,1,"UPyD",1
26,"26002",830,632,622,0,10,"UPyD",0
9,"9170",205,162,162,1,0,"UPyD",0
50,"50057",1395,919,907,11,12,"UPyD",0
19,"19232",71,57,57,1,0,"UPyD",0
50,"50205",90,63,61,0,2,"UPyD",2
9,"9045",268,181,181,4,0,"UPyD",0
47,"47232",102,77,74,1,3,"UPyD",0
50,"50225",1570,956,950,3,6,"UPyD",1
13,"13060",263,200,194,0,6,"UPyD",0
9,"9027",46,42,41,0,1,"UPyD",0
18,"18015",434,334,333,0,1,"UPyD",0
22,"22128",188,146,144,3,2,"UPyD",0
39,"39082",1653,1173,1157,11,16,"UPyD",2
49,"49216",162,142,142,0,0,"UPyD",0
45,"45159",90,75,75,0,0,"UPyD",0
12,"12031",3807,2941,2894,24,47,"UPyD",7
47,"47043",297,239,237,0,2,"UPyD",0
10,"10145",127,97,95,0,2,"UPyD",0
31,"31250",2810,1786,1770,19,16,"UPyD",0
37,"37019",150,123,120,0,3,"UPyD",0
18,"18044",181,107,107,0,0,"UPyD",0
3,"3072",348,289,285,0,4,"UPyD",0
9,"9413",436,306,302,2,4,"UPyD",0
21,"21054",8100,5656,5571,46,85,"UPyD",5
40,"40142",53,39,37,0,2,"UPyD",0
4,"4047",2281,1893,1878,11,15,"UPyD",2
6,"6072",2307,1696,1681,12,15,"UPyD",0
9,"9323",61,46,46,1,0,"UPyD",0
46,"46127",2692,2120,2091,18,29,"UPyD",2
1,"1046",601,432,428,3,4,"UPyD",1
10,"10177",1707,1228,1201,5,27,"UPyD",2
50,"50196",107,87,86,0,1,"UPyD",0
45,"45109",2883,2271,2214,9,57,"UPyD",4
40,"40043",1802,1400,1381,8,19,"UPyD",5
28,"28073",12549,8788,8701,54,87,"UPyD",26
28,"28180",5251,3927,3893,7,34,"UPyD",6
26,"26063",124,94,94,2,0,"UPyD",0
50,"50187",69,44,44,0,0,"UPyD",0
14,"14007",15207,10558,10417,82,141,"UPyD",22
16,"16902",137,107,107,0,0,"UPyD",0
20,"20012",147,99,98,5,1,"UPyD",0
40,"40199",105,84,84,0,0,"UPyD",0
29,"29027",2326,1626,1609,12,17,"UPyD",1
39,"39003",297,220,215,0,5,"UPyD",1
24,"24015",2265,1649,1635,18,14,"UPyD",2
24,"24040",449,329,325,2,4,"UPyD",0
36,"36029",16077,11617,11471,100,146,"UPyD",26
5,"5125",55,47,47,0,0,"UPyD",0
16,"16156",97,78,77,0,1,"UPyD",0
9,"9033",90,74,74,1,0,"UPyD",3
16,"16017",366,294,294,2,0,"UPyD",1
48,"48034",12866,8798,8747,43,51,"UPyD",10
33,"33062",400,238,233,2,5,"UPyD",0
18,"18034",505,366,364,1,2,"UPyD",0
5,"5175",159,131,131,1,0,"UPyD",1
48,"48045",5167,3809,3757,28,52,"UPyD",1
31,"31164",568,421,417,5,4,"UPyD",0
9,"9295",61,44,44,0,0,"UPyD",0
42,"42010",19,14,14,1,0,"UPyD",0
37,"37052",273,209,209,2,0,"UPyD",0
19,"19310",9,7,7,0,0,"UPyD",0
42,"42092",56,44,42,1,2,"UPyD",0
28,"28134",61008,45177,44904,263,273,"UPyD",180
37,"37355",178,142,142,1,0,"UPyD",0
29,"29018",2010,1472,1420,9,52,"UPyD",0
45,"45019",7377,5307,5251,37,56,"UPyD",10
19,"19115",24,18,18,0,0,"UPyD",0
9,"9298",82,70,69,1,1,"UPyD",1
9,"9160",85,64,64,0,0,"UPyD",0
47,"47216",115,91,87,0,4,"UPyD",0
36,"36035",14433,10333,10188,79,145,"UPyD",18
31,"31194",311,217,216,3,1,"UPyD",0
18,"18094",2359,1744,1720,14,24,"UPyD",3
50,"50200",511,410,403,2,7,"UPyD",0
47,"47039",185,141,140,0,1,"UPyD",1
4,"4034",160,99,99,2,0,"UPyD",0
47,"47075",4856,3681,3637,24,44,"UPyD",6
23,"23016",387,321,320,0,1,"UPyD",0
37,"37077",261,226,223,1,3,"UPyD",2
29,"29046",2675,1825,1807,14,18,"UPyD",2
47,"47057",268,197,196,0,1,"UPyD",1
49,"49237",165,119,117,2,2,"UPyD",1
45,"45121",6796,4743,4692,22,51,"UPyD",9
49,"49115",184,136,135,0,1,"UPyD",0
37,"37277",75,58,58,0,0,"UPyD",0
42,"42111",303,229,227,2,2,"UPyD",1
37,"37264",65,40,40,0,0,"UPyD",0
46,"46171",16563,12213,12128,85,85,"UPyD",31
9,"9302",112,83,83,1,0,"UPyD",0
10,"10109",1762,1149,1125,14,24,"UPyD",4
49,"49141",340,248,246,0,2,"UPyD",0
50,"50222",1622,1091,1071,7,20,"UPyD",3
9,"9433",60,48,45,1,3,"UPyD",0
12,"12005",8062,5829,5754,64,75,"UPyD",8
30,"30026",15734,10007,9901,51,106,"UPyD",20
48,"48008",606,424,414,6,10,"UPyD",0
24,"24143",510,358,349,0,9,"UPyD",0
46,"46091",118,94,94,0,0,"UPyD",0
46,"46039",2130,1728,1699,8,29,"UPyD",0
41,"41017",15158,10718,10616,92,102,"UPyD",45
6,"6051",1571,1192,1178,7,14,"UPyD",0
45,"45104",428,324,323,1,1,"UPyD",0
34,"34035",111,98,97,0,1,"UPyD",2
5,"5001",191,148,147,2,1,"UPyD",1
37,"37234",345,247,247,1,0,"UPyD",1
46,"46109",6150,4625,4556,25,69,"UPyD",9
22,"22111",154,103,102,0,1,"UPyD",1
16,"16211",370,263,263,3,0,"UPyD",0
7,"7044",8439,5681,5543,48,138,"UPyD",5
45,"45183",2220,1444,1428,3,16,"UPyD",18
19,"19154",68,56,54,0,2,"UPyD",0
24,"24023",263,188,188,1,0,"UPyD",0
5,"5219",38,30,30,0,0,"UPyD",0
29,"29048",1405,1121,1110,8,11,"UPyD",0
6,"6012",3267,2300,2277,15,23,"UPyD",3
26,"26135",164,125,124,1,1,"UPyD",0
19,"19324",176,126,125,3,1,"UPyD",0
19,"19135",107,90,90,3,0,"UPyD",0
31,"31118",164,112,111,1,1,"UPyD",0
3,"3117",362,318,313,2,5,"UPyD",0
37,"37078",829,674,664,8,10,"UPyD",2
42,"42192",42,27,27,2,0,"UPyD",0
46,"46058",1772,1398,1373,15,25,"UPyD",2
40,"40221",49,39,39,0,0,"UPyD",0
6,"6105",624,418,417,1,1,"UPyD",1
9,"9198",104,83,82,1,1,"UPyD",1
47,"47215",53,45,45,0,0,"UPyD",0
12,"12041",100,81,81,0,0,"UPyD",0
40,"40073",401,345,343,3,2,"UPyD",3
4,"4066",13571,8786,8724,50,62,"UPyD",9
47,"47187",84,61,58,0,3,"UPyD",0
49,"49269",229,165,162,1,3,"UPyD",0
24,"24044",168,119,118,1,1,"UPyD",0
50,"50121",277,216,214,1,2,"UPyD",1
33,"33039",1655,1223,1209,12,14,"UPyD",4
18,"18072",667,424,420,0,4,"UPyD",0
5,"5218",121,97,97,0,0,"UPyD",0
18,"18030",576,413,409,6,4,"UPyD",1
9,"9412",790,528,523,4,5,"UPyD",1
22,"22114",123,81,81,0,0,"UPyD",0
37,"37112",161,112,111,2,1,"UPyD",0
50,"50157",290,220,218,3,2,"UPyD",0
33,"33012",5201,3466,3432,25,34,"UPyD",6
50,"50281",73,51,50,0,1,"UPyD",0
37,"37062",83,65,64,1,1,"UPyD",2
50,"50027",225,178,177,2,1,"UPyD",1
26,"26106",86,72,72,0,0,"UPyD",2
36,"36055",13620,9580,9400,62,180,"UPyD",18
19,"19171",4961,3670,3628,27,42,"UPyD",23
26,"26029",37,32,32,0,0,"UPyD",0
37,"37377",241,201,199,1,2,"UPyD",0
21,"21004",1631,1045,1028,13,17,"UPyD",3
14,"14038",32322,22117,21887,179,230,"UPyD",39
28,"28165",1794,1293,1285,3,8,"UPyD",1
10,"10137",397,320,317,3,3,"UPyD",0
34,"34192",90,75,72,0,3,"UPyD",0
37,"37209",412,272,270,7,2,"UPyD",1
34,"34083",1769,1218,1201,10,17,"UPyD",2
49,"49055",102,82,82,2,0,"UPyD",0
31,"31048",176,132,130,4,2,"UPyD",1
50,"50135",91,70,70,3,0,"UPyD",2
48,"48016",5271,3694,3674,24,20,"UPyD",5
18,"18033",282,201,200,5,1,"UPyD",1
47,"47063",103,81,80,1,1,"UPyD",0
37,"37259",44,28,28,0,0,"UPyD",0
3,"3074",1707,1397,1389,4,8,"UPyD",0
16,"16195",497,392,390,1,2,"UPyD",0
22,"22187",293,218,216,2,2,"UPyD",0
49,"49052",187,133,132,1,1,"UPyD",0
49,"49056",300,211,208,2,3,"UPyD",0
24,"24033",205,158,157,0,1,"UPyD",0
47,"47055",203,167,163,0,4,"UPyD",1
36,"36046",4036,2971,2921,15,50,"UPyD",5
5,"5207",692,547,543,0,4,"UPyD",3
42,"42123",164,117,116,4,1,"UPyD",0
4,"4037",1314,969,955,6,14,"UPyD",0
3,"3107",2508,1755,1744,7,11,"UPyD",5
50,"50199",334,244,242,3,2,"UPyD",2
24,"24114",3061,2025,1994,9,31,"UPyD",3
7,"7030",1551,1127,1101,13,26,"UPyD",3
9,"9265",37,28,28,0,0,"UPyD",0
18,"18101",9265,6618,6560,59,58,"UPyD",21
46,"46011",7609,5249,5191,26,58,"UPyD",4
37,"37217",58,45,44,0,1,"UPyD",0
50,"50041",12,9,9,0,0,"UPyD",0
19,"19227",66,44,43,2,1,"UPyD",0
12,"12113",83,67,66,3,1,"UPyD",0
47,"47038",105,77,77,0,0,"UPyD",0
24,"24024",692,496,491,4,5,"UPyD",0
21,"21067",414,288,287,1,1,"UPyD",1
16,"16246",482,361,355,3,6,"UPyD",1
10,"10204",429,331,329,6,2,"UPyD",0
24,"24122",1342,930,924,8,6,"UPyD",0
19,"19247",139,102,100,1,2,"UPyD",1
37,"37081",930,728,722,3,6,"UPyD",0
50,"50021",30,21,21,0,0,"UPyD",0
21,"21034",1188,798,786,8,12,"UPyD",2
37,"37120",99,82,78,0,4,"UPyD",0
19,"19241",43,34,34,1,0,"UPyD",1
19,"19152",556,390,382,1,8,"UPyD",2
12,"12052",578,452,435,3,17,"UPyD",0
13,"13041",244,170,165,1,5,"UPyD",0
37,"37161",136,106,106,1,0,"UPyD",0
42,"42201",22,22,21,0,1,"UPyD",0
24,"24053",442,286,280,1,6,"UPyD",2
10,"10123",578,481,475,1,6,"UPyD",0
42,"42028",75,51,51,0,0,"UPyD",0
20,"20060",88,67,67,2,0,"UPyD",0
18,"18128",343,270,269,1,1,"UPyD",0
13,"13063",3706,2539,2514,33,25,"UPyD",3
10,"10135",1302,981,969,3,12,"UPyD",0
9,"9443",179,128,124,0,4,"UPyD",0
16,"16051",142,120,119,0,1,"UPyD",0
19,"19302",59,49,49,1,0,"UPyD",0
37,"37371",272,165,162,1,3,"UPyD",1
41,"41005",9068,6366,6281,58,85,"UPyD",16
18,"18039",3490,2406,2378,33,28,"UPyD",0
22,"22053",789,520,513,9,7,"UPyD",2
4,"4094",207,144,144,0,0,"UPyD",0
2,"2070",403,332,328,4,4,"UPyD",0
6,"6006",4572,3088,3049,26,39,"UPyD",5
26,"26105",2205,1670,1658,12,12,"UPyD",4
50,"50230",1165,833,828,8,5,"UPyD",2
47,"47166",259,204,197,2,7,"UPyD",1
21,"21079",722,494,490,5,4,"UPyD",0
47,"47018",34,28,28,0,0,"UPyD",0
49,"49063",338,272,266,4,6,"UPyD",3
20,"20051",6877,4699,4679,34,20,"UPyD",2
18,"18111",2765,1949,1936,18,13,"UPyD",5
7,"7057",7169,4719,4659,47,60,"UPyD",7
3,"3102",7229,5492,5414,52,78,"UPyD",3
49,"49069",367,258,254,5,4,"UPyD",0
50,"50098",174,130,124,0,6,"UPyD",0
22,"22054",1542,1091,1077,13,14,"UPyD",5
50,"50220",40,32,32,0,0,"UPyD",0
26,"26081",16,14,14,0,0,"UPyD",0
45,"45086",496,351,343,2,8,"UPyD",0
49,"49005",149,91,91,2,0,"UPyD",1
19,"19097",16,10,10,0,0,"UPyD",0
50,"50279",86,64,64,0,0,"UPyD",0
20,"20045",46626,30525,30353,197,172,"UPyD",73
49,"49110",348,231,229,0,2,"UPyD",1
4,"4065",363,284,282,7,2,"UPyD",0
18,"18001",251,168,167,5,1,"UPyD",0
6,"6056",479,407,399,1,8,"UPyD",0
24,"24121",645,492,487,1,5,"UPyD",0
28,"28153",697,499,499,1,0,"UPyD",1
3,"3113",4243,3091,3046,10,45,"UPyD",5
26,"26108",266,215,213,0,2,"UPyD",0
49,"49002",63,51,49,0,2,"UPyD",0
47,"47015",200,162,160,0,2,"UPyD",0
50,"50277",50,42,41,0,1,"UPyD",0
9,"9307",109,81,80,0,1,"UPyD",0
46,"46163",1866,1504,1480,8,24,"UPyD",6
9,"9306",106,82,82,1,0,"UPyD",0
3,"3062",212,169,165,0,4,"UPyD",0
49,"49173",375,230,221,3,9,"UPyD",0
31,"31109",1582,1155,1150,9,5,"UPyD",3
50,"50128",26,25,25,1,0,"UPyD",0
34,"34228",83,74,74,1,0,"UPyD",0
19,"19186",81,68,68,0,0,"UPyD",0
5,"5094",139,116,116,1,0,"UPyD",0
50,"50162",146,109,105,4,4,"UPyD",0
18,"18167",1895,1258,1250,4,8,"UPyD",0
6,"6136",1565,1131,1102,11,29,"UPyD",0
11,"11013",2312,1547,1518,15,29,"UPyD",4
31,"31095",75,59,59,1,0,"UPyD",0
9,"9368",22,17,17,2,0,"UPyD",0
34,"34094",64,45,44,0,1,"UPyD",0
3,"3081",1436,1084,1075,5,9,"UPyD",1
3,"3071",3982,3048,3012,26,36,"UPyD",0
40,"40173",138,99,93,1,6,"UPyD",0
34,"34098",777,551,545,8,6,"UPyD",2
24,"24158",320,207,203,2,4,"UPyD",0
18,"18180",633,410,410,3,0,"UPyD",1
11,"11026",4782,3451,3378,26,73,"UPyD",4
19,"19161",211,159,157,1,2,"UPyD",0
24,"24124",367,244,233,3,11,"UPyD",0
50,"50240",1025,729,718,10,11,"UPyD",3
9,"9355",98,75,75,0,0,"UPyD",1
46,"46206",571,453,445,2,8,"UPyD",2
18,"18119",1702,1298,1283,13,15,"UPyD",0
50,"50029",626,450,450,3,0,"UPyD",0
42,"42198",23,16,16,4,0,"UPyD",0
19,"19216",131,98,98,0,0,"UPyD",0
47,"47110",450,350,346,1,4,"UPyD",0
50,"50063",61,51,51,0,0,"UPyD",0
2,"2071",1011,831,825,5,6,"UPyD",0
3,"3121",21273,14569,14468,62,101,"UPyD",24
7,"7025",472,355,351,1,4,"UPyD",0
29,"29003",983,754,743,1,11,"UPyD",2
13,"13032",1137,841,835,2,6,"UPyD",1
13,"13033",1633,1328,1290,4,38,"UPyD",1
47,"47046",118,92,90,1,2,"UPyD",0
40,"40144",18,14,14,0,0,"UPyD",0
39,"39056",2286,1714,1684,8,30,"UPyD",2
42,"42171",127,80,79,0,1,"UPyD",0
6,"6038",805,543,541,2,2,"UPyD",1
28,"28178",1065,824,818,5,6,"UPyD",6
9,"9405",130,98,96,0,2,"UPyD",1
34,"34225",4921,3588,3559,30,29,"UPyD",8
36,"36044",2541,1674,1646,7,28,"UPyD",1
50,"50286",77,50,50,3,0,"UPyD",0
19,"19103",251,208,208,2,0,"UPyD",0
46,"46211",1745,1387,1378,8,9,"UPyD",1
7,"7064",5315,3475,3434,31,41,"UPyD",6
4,"4061",638,506,498,4,8,"UPyD",2
34,"34055",270,209,207,2,2,"UPyD",2
49,"49221",245,129,127,1,2,"UPyD",0
34,"34240",89,64,64,0,0,"UPyD",0
50,"50118",2165,1552,1540,10,12,"UPyD",0
5,"5195",220,169,169,2,0,"UPyD",1
24,"24152",464,295,291,1,4,"UPyD",1
37,"37265",220,181,181,0,0,"UPyD",0
31,"31238",112,93,93,0,0,"UPyD",0
48,"48055",2668,1872,1849,11,23,"UPyD",1
28,"28182",210,171,169,0,2,"UPyD",2
5,"5083",140,110,105,1,5,"UPyD",0
22,"22248",116,92,90,1,2,"UPyD",0
24,"24106",248,167,166,1,1,"UPyD",0
12,"12120",177,152,152,0,0,"UPyD",0
30,"30036",14698,9859,9734,41,125,"UPyD",22
40,"40021",27,27,26,0,1,"UPyD",0
50,"50125",360,248,246,3,2,"UPyD",0
13,"13067",351,281,279,0,2,"UPyD",0
37,"37001",192,151,148,0,3,"UPyD",0
37,"37036",61,44,43,0,1,"UPyD",0
49,"49193",467,313,308,4,5,"UPyD",0
33,"33069",3491,2430,2390,17,40,"UPyD",2
50,"50161",106,75,72,0,3,"UPyD",1
42,"42160",254,206,205,0,1,"UPyD",0
50,"50278",197,145,145,0,0,"UPyD",1
21,"21044",17591,10679,10558,118,121,"UPyD",13
18,"18910",788,541,536,3,5,"UPyD",0
24,"24125",462,290,286,4,4,"UPyD",0
46,"46017",32949,23913,23685,142,228,"UPyD",45
18,"18170",330,219,217,0,2,"UPyD",1
21,"21025",4026,2433,2396,30,37,"UPyD",2
16,"16152",38,32,32,0,0,"UPyD",0
34,"34087",129,103,102,1,1,"UPyD",0
24,"24052",158,104,102,0,2,"UPyD",0
33,"33059",4646,3075,3033,29,42,"UPyD",6
9,"9024",156,112,110,1,2,"UPyD",0
45,"45011",278,239,233,1,6,"UPyD",0
7,"7052",4667,2908,2886,29,22,"UPyD",5
33,"33046",499,379,367,5,12,"UPyD",1
46,"46210",330,277,277,2,0,"UPyD",0
48,"48061",762,565,561,0,4,"UPyD",2
24,"24133",356,257,257,1,0,"UPyD",0
42,"42132",141,114,114,0,0,"UPyD",0
40,"40046",89,75,75,1,0,"UPyD",1
29,"29039",2666,1898,1873,22,25,"UPyD",2
22,"22087",67,45,45,2,0,"UPyD",0
46,"46198",839,684,674,4,10,"UPyD",1
5,"5261",41,26,26,0,0,"UPyD",0
4,"4049",5313,3620,3579,18,41,"UPyD",6
41,"41086",16170,10162,10088,73,74,"UPyD",36
46,"46224",159,121,121,0,0,"UPyD",0
50,"50164",390,247,246,6,1,"UPyD",0
22,"22195",235,182,181,3,1,"UPyD",0
9,"9009",163,133,131,2,2,"UPyD",0
31,"31176",2869,2010,1963,33,47,"UPyD",3
40,"40135",283,236,231,2,5,"UPyD",2
5,"5239",214,164,162,3,2,"UPyD",0
41,"41031",1238,825,814,11,11,"UPyD",2
47,"47008",24,19,19,1,0,"UPyD",0
50,"50208",1774,1207,1195,10,12,"UPyD",3
45,"45182",1034,806,791,1,15,"UPyD",1
9,"9340",77,49,49,0,0,"UPyD",0
45,"45204",632,488,487,1,1,"UPyD",0
22,"22013",288,216,210,3,6,"UPyD",1
29,"29029",403,298,294,2,4,"UPyD",0
37,"37237",324,244,240,1,4,"UPyD",2
10,"10195",7709,5572,5481,37,91,"UPyD",10
34,"34082",83,74,73,0,1,"UPyD",1
13,"13050",493,378,375,3,3,"UPyD",0
45,"45137",1604,1032,1024,4,8,"UPyD",1
36,"36041",13434,9297,9181,66,116,"UPyD",11
40,"40213",86,65,65,3,0,"UPyD",0
12,"12042",607,520,513,13,7,"UPyD",0
16,"16264",435,366,364,2,2,"UPyD",0
37,"37214",129,93,91,0,2,"UPyD",0
49,"49042",244,178,176,1,2,"UPyD",0
28,"28084",15859,11156,11058,64,98,"UPyD",123
40,"40087",92,71,70,1,1,"UPyD",1
48,"48914",332,272,272,1,0,"UPyD",0
39,"39065",252,191,189,1,2,"UPyD",1
9,"9041",28,27,27,0,0,"UPyD",0
48,"48071",6087,4294,4254,32,40,"UPyD",5
23,"23066",4347,3465,3410,15,55,"UPyD",5
4,"4056",143,113,109,0,4,"UPyD",0
18,"18902",816,632,620,4,12,"UPyD",1
20,"20072",4728,2902,2886,21,16,"UPyD",4
33,"33041",7199,4922,4877,52,45,"UPyD",8
4,"4005",556,437,431,3,6,"UPyD",0
49,"49172",527,347,343,1,4,"UPyD",0
29,"29047",1117,885,866,1,19,"UPyD",1
37,"37096",214,166,163,2,3,"UPyD",0
49,"49208",394,248,244,2,4,"UPyD",1
19,"19257",3403,2430,2402,19,28,"UPyD",7
6,"6162",2934,2182,2162,14,20,"UPyD",4
10,"10901",1174,752,741,4,11,"UPyD",0
19,"19242",87,65,65,1,0,"UPyD",0
6,"6095",9504,6621,6475,96,146,"UPyD",5
30,"30029",11864,8125,8058,73,67,"UPyD",13
29,"29058",1450,911,894,4,17,"UPyD",1
48,"48002",7829,5490,5451,44,39,"VOX",8
25,"25166",181,110,109,2,1,"VOX",0
18,"18174",446,330,324,2,6,"VOX",0
42,"42173",29281,20286,20035,261,251,"VOX",36
26,"26110",152,131,129,0,2,"VOX",0
46,"46136",2537,1952,1930,11,22,"VOX",6
9,"9236",38,32,32,0,0,"VOX",0
15,"15084",3260,2218,2191,27,27,"VOX",1
46,"46256",6853,4951,4890,25,61,"VOX",8
28,"28048",500,391,387,3,4,"VOX",1
28,"28120",1223,892,884,2,8,"VOX",6
16,"16045",222,172,171,1,1,"VOX",0
26,"26046",1581,1175,1159,4,16,"VOX",0
16,"16174",185,145,143,0,2,"VOX",1
48,"48906",766,547,544,0,3,"VOX",0
3,"3104",27103,19953,19787,131,166,"VOX",28
9,"9270",163,115,115,0,0,"VOX",1
3,"3110",291,241,241,1,0,"VOX",0
47,"47121",544,437,425,6,12,"VOX",5
11,"11010",6410,4189,4130,88,59,"VOX",3
25,"25128",136,75,75,0,0,"VOX",0
47,"47031",189,145,145,1,0,"VOX",1
19,"19172",57,48,47,0,1,"VOX",0
25,"25201",112,73,72,3,1,"VOX",0
25,"25102",707,420,407,6,13,"VOX",0
22,"22175",197,143,142,1,1,"VOX",0
18,"18016",307,235,233,0,2,"VOX",1
3,"3077",1371,1071,1060,13,11,"VOX",0
14,"14029",4178,3047,3009,28,38,"VOX",2
16,"16029",99,72,70,0,2,"VOX",0
6,"6114",137,112,112,0,0,"VOX",0
19,"19259",30,25,25,1,0,"VOX",0
21,"21033",538,373,370,3,3,"VOX",0
6,"6013",265,212,209,3,3,"VOX",0
3,"3044",4521,3510,3465,21,45,"VOX",8
9,"9256",354,258,258,2,0,"VOX",0
45,"45184",200,129,129,0,0,"VOX",1
28,"28049",58480,45136,44820,242,316,"VOX",122
50,"50028",78,51,51,0,0,"VOX",0
10,"10146",1507,1004,977,7,27,"VOX",0
42,"42003",67,48,47,0,1,"VOX",0
18,"18170",330,219,217,0,2,"VOX",0
21,"21054",8100,5656,5571,46,85,"VOX",7
3,"3010",325,277,275,1,2,"VOX",0
26,"26125",2699,1931,1907,23,24,"VOX",0
39,"39002",3298,2342,2309,13,33,"VOX",1
16,"16083",52,33,33,0,0,"VOX",0
24,"24105",1459,1042,1025,16,17,"VOX",3
16,"16065",388,320,314,2,6,"VOX",2
47,"47007",3769,2765,2736,24,29,"VOX",9
9,"9901",371,263,259,4,4,"VOX",0
26,"26057",48,38,38,0,0,"VOX",0
25,"25149",1385,963,956,6,7,"VOX",2
19,"19202",8,6,6,0,0,"VOX",0
28,"28099",1748,1290,1283,7,7,"VOX",2
12,"12076",84,69,69,0,0,"VOX",0
40,"40053",83,66,65,0,1,"VOX",0
46,"46006",4523,3665,3623,20,42,"VOX",3
18,"18014",6581,4584,4545,37,39,"VOX",9
15,"15066",4009,2814,2776,33,38,"VOX",3
12,"12068",48,36,35,1,1,"VOX",0
46,"46069",162,124,123,0,1,"VOX",0
9,"9093",154,121,119,0,2,"VOX",1
10,"10162",575,437,433,2,4,"VOX",0
42,"42092",56,44,42,1,2,"VOX",0
45,"45124",2140,1677,1641,10,36,"VOX",1
50,"50117",126,104,103,1,1,"VOX",0
9,"9407",28,23,23,0,0,"VOX",0
9,"9070",34,26,26,0,0,"VOX",0
9,"9316",105,80,80,1,0,"VOX",0
24,"24157",2568,1943,1911,22,32,"VOX",1
16,"16096",274,232,229,1,3,"VOX",0
47,"47205",384,266,260,0,6,"VOX",0
18,"18123",301,228,222,1,6,"VOX",0
19,"19064",70,64,64,2,0,"VOX",0
40,"40018",91,72,72,1,0,"VOX",0
9,"9100",59,45,44,0,1,"VOX",1
11,"11902",3629,2275,2252,25,23,"VOX",1
46,"46138",343,275,272,1,3,"VOX",1
16,"16151",64,61,59,0,2,"VOX",0
42,"42116",45,39,38,3,1,"VOX",1
21,"21022",171,107,105,0,2,"VOX",0
45,"45122",5212,4004,3961,16,43,"VOX",14
42,"42128",42,42,41,1,1,"VOX",0
25,"25029",1655,1042,1029,15,13,"VOX",0
21,"21049",3361,2049,1984,17,65,"VOX",3
9,"9352",114,92,92,1,0,"VOX",0
12,"12074",785,652,648,5,4,"VOX",1
12,"12075",123,88,88,0,0,"VOX",0
14,"14025",2924,2466,2422,14,44,"VOX",3
46,"46176",2017,1358,1349,5,9,"VOX",2
41,"41089",6493,4398,4331,43,67,"VOX",8
10,"10054",547,431,421,1,10,"VOX",0
40,"40139",279,202,198,1,4,"VOX",1
50,"50110",367,256,254,0,2,"VOX",0
6,"6047",849,639,628,2,11,"VOX",0
46,"46036",564,383,378,5,5,"VOX",4
48,"48025",883,642,637,7,5,"VOX",0
50,"50236",102,79,77,0,2,"VOX",0
39,"39087",41985,31178,30805,228,373,"VOX",48
19,"19132",92,81,81,0,0,"VOX",0
9,"9152",257,183,183,0,0,"VOX",1
45,"45168",62229,47154,46741,285,413,"VOX",202
45,"45135",4269,3340,3288,8,52,"VOX",7
19,"19082",85,64,64,0,0,"VOX",0
23,"23901",1154,970,964,3,6,"VOX",1
14,"14014",2557,2035,2007,9,28,"VOX",1
45,"45076",553,368,364,3,4,"VOX",0
9,"9908",449,307,306,3,1,"VOX",0
41,"41032",3984,2811,2725,27,86,"VOX",0
24,"24164",370,218,217,0,1,"VOX",0
4,"4070",1584,1184,1179,3,5,"VOX",1
9,"9307",109,81,80,0,1,"VOX",0
41,"41046",3023,2213,2183,5,30,"VOX",3
41,"41066",1342,945,927,2,18,"VOX",2
16,"16276",21,16,16,1,0,"VOX",0
1,"1009",1265,849,845,2,4,"VOX",0
47,"47101",1710,1357,1336,16,21,"VOX",1
47,"47039",185,141,140,0,1,"VOX",0
39,"39016",23868,17883,17701,122,182,"VOX",41
19,"19288",21,21,20,0,1,"VOX",0
24,"24063",374,254,252,2,2,"VOX",0
28,"28159",589,468,468,5,0,"VOX",2
9,"9350",469,350,343,2,7,"VOX",0
16,"16251",1849,1381,1366,7,15,"VOX",4
19,"19022",625,476,469,3,7,"VOX",3
19,"19018",155,119,118,3,1,"VOX",0
42,"42035",769,527,516,2,11,"VOX",2
28,"28017",1208,907,899,7,8,"VOX",6
19,"19070",74,53,53,0,0,"VOX",0
24,"24121",645,492,487,1,5,"VOX",0
3,"3099",42319,31083,30801,165,282,"VOX",78
9,"9110",80,63,63,0,0,"VOX",0
28,"28035",1353,1006,998,2,8,"VOX",2
24,"24148",1672,1249,1241,23,8,"VOX",3
33,"33056",4997,3269,3244,22,25,"VOX",2
41,"41072",4054,2965,2933,14,32,"VOX",1
46,"46197",1942,1527,1514,5,13,"VOX",1
50,"50003",128,92,91,1,1,"VOX",0
10,"10090",513,362,353,2,9,"VOX",0
19,"19192",1736,1324,1308,8,16,"VOX",1
50,"50251",8262,5946,5872,44,74,"VOX",8
12,"12109",649,532,524,6,8,"VOX",0
12,"12021",4436,3381,3332,27,49,"VOX",10
29,"29052",224,144,144,3,0,"VOX",0
12,"12129",1828,1322,1298,11,24,"VOX",1
46,"46234",348,279,275,3,4,"VOX",0
16,"16025",26,23,23,0,0,"VOX",0
25,"25222",66,52,52,1,0,"VOX",0
19,"19327",418,350,348,1,2,"VOX",0
50,"50051",816,616,614,2,2,"VOX",2
25,"25238",204,140,138,4,2,"VOX",0
48,"48913",1248,884,869,10,15,"VOX",3
40,"40136",112,88,87,0,1,"VOX",0
41,"41059",34165,24949,24709,196,240,"VOX",53
22,"22079",118,83,83,1,0,"VOX",0
9,"9277",120,101,99,0,2,"VOX",0
28,"28168",1237,884,880,4,4,"VOX",2
6,"6084",1093,828,818,8,10,"VOX",0
40,"40145",1103,879,870,2,9,"VOX",2
33,"33002",9995,6765,6672,47,93,"VOX",9
9,"9280",28,20,20,0,0,"VOX",0
10,"10031",165,135,134,1,1,"VOX",1
19,"19078",50,44,43,0,1,"VOX",0
47,"47220",165,130,129,0,1,"VOX",0
25,"25124",166,106,105,1,1,"VOX",0
41,"41048",2228,1470,1447,15,23,"VOX",3
40,"40009",49,43,43,0,0,"VOX",1
48,"48028",717,543,537,3,6,"VOX",0
4,"4017",1296,857,854,5,3,"VOX",0
42,"42010",19,14,14,1,0,"VOX",0
26,"26166",141,124,122,0,2,"VOX",1
22,"22105",114,78,77,2,1,"VOX",0
47,"47057",268,197,196,0,1,"VOX",0
9,"9347",143,117,115,2,2,"VOX",0
25,"25085",148,107,107,0,0,"VOX",0
26,"26079",634,520,512,4,8,"VOX",4
6,"6142",273,205,197,2,8,"VOX",0
28,"28062",292,231,226,1,5,"VOX",0
45,"45111",65,50,50,0,0,"VOX",0
9,"9078",41,30,30,1,0,"VOX",0
3,"3050",18652,13325,13234,57,91,"VOX",37
26,"26089",110582,82972,82186,588,786,"VOX",205
14,"14048",1207,884,869,13,15,"VOX",1
30,"30001",4582,3620,3594,18,26,"VOX",9
50,"50064",437,342,339,0,3,"VOX",0
1,"1044",236,169,167,0,2,"VOX",0
3,"3070",2051,1455,1437,7,18,"VOX",2
10,"10156",97,73,72,1,1,"VOX",0
45,"45032",436,283,275,1,8,"VOX",0
6,"6148",966,691,678,8,13,"VOX",1
39,"39073",9837,7356,7298,31,58,"VOX",20
30,"30902",7975,5318,5273,24,45,"VOX",18
25,"25031",52,29,29,0,0,"VOX",0
28,"28151",3142,2235,2199,8,36,"VOX",9
46,"46101",860,716,705,3,11,"VOX",1
47,"47132",45,36,33,1,3,"VOX",0
45,"45200",4592,3539,3476,14,63,"VOX",3
50,"50241",588,415,410,4,5,"VOX",0
25,"25052",1555,1027,1016,14,11,"VOX",1
12,"12017",161,130,128,0,2,"VOX",0
50,"50005",229,189,189,1,0,"VOX",3
23,"23043",546,398,396,3,2,"VOX",0
4,"4089",742,521,518,1,3,"VOX",1
46,"46110",21228,15563,15443,86,120,"VOX",31
26,"26115",19,16,16,0,0,"VOX",0
41,"41018",9480,6523,6455,53,68,"VOX",4
9,"9266",91,74,74,0,0,"VOX",3
15,"15020",3784,2476,2447,17,29,"VOX",1
9,"9437",282,219,218,3,1,"VOX",1
40,"40065",493,373,373,3,0,"VOX",0
16,"16040",80,62,62,0,0,"VOX",0
28,"28030",1726,1320,1299,8,21,"VOX",2
21,"21052",4583,2734,2663,22,71,"VOX",2
14,"14018",3709,2697,2653,26,44,"VOX",10
16,"16140",27,16,16,0,0,"VOX",0
18,"18059",4180,2907,2870,20,37,"VOX",3
26,"26093",53,39,38,0,1,"VOX",0
41,"41012",3290,2071,2030,20,41,"VOX",3
48,"48095",2347,1555,1546,12,9,"VOX",0
1,"1901",2354,1592,1571,8,21,"VOX",2
9,"9458",469,343,336,5,7,"VOX",2
3,"3063",26462,18591,18492,91,99,"VOX",28
40,"40144",18,14,14,0,0,"VOX",0
21,"21070",6258,4165,4092,48,73,"VOX",9
18,"18915",745,533,525,2,8,"VOX",0
50,"50278",197,145,145,0,0,"VOX",1
46,"46238",13282,9786,9721,61,65,"VOX",6
12,"12092",111,91,90,0,1,"VOX",0
23,"23047",1629,1258,1250,10,8,"VOX",1
24,"24218",451,330,325,2,5,"VOX",2
9,"9035",311,227,225,2,2,"VOX",2
22,"22197",473,354,354,1,0,"VOX",1
19,"19032",165,126,124,1,2,"VOX",1
48,"48013",79716,53419,52997,345,422,"VOX",87
24,"24202",8008,5367,5276,53,91,"VOX",3
28,"28101",231,187,187,0,0,"VOX",0
3,"3094",9080,6440,6396,34,44,"VOX",18
42,"42162",2352,1637,1601,16,36,"VOX",3
50,"50228",268,210,208,5,2,"VOX",1
16,"16048",408,313,312,1,1,"VOX",0
47,"47014",51,45,45,0,0,"VOX",0
46,"46029",20613,14964,14879,93,85,"VOX",42
23,"23061",7560,5303,5234,29,69,"VOX",6
40,"40177",153,125,125,1,0,"VOX",0
15,"15068",5049,3185,3129,25,56,"VOX",2
6,"6145",922,696,694,5,2,"VOX",1
14,"14009",2788,1852,1834,20,18,"VOX",1
40,"40171",32,23,23,0,0,"VOX",0
24,"24190",165,123,121,1,2,"VOX",1
25,"25087",60,43,43,0,0,"VOX",0
47,"47058",200,145,143,0,2,"VOX",4
22,"22052",925,712,710,8,2,"VOX",2
28,"28135",948,713,709,4,4,"VOX",3
25,"25216",226,138,136,1,2,"VOX",0
9,"9163",582,467,459,2,8,"VOX",0
26,"26076",129,107,106,0,1,"VOX",0
1,"1003",1190,782,774,2,8,"VOX",5
19,"19254",45,34,34,0,0,"VOX",0
25,"25167",230,138,138,3,0,"VOX",0
23,"23097",6443,4117,4063,21,54,"VOX",8
50,"50261",213,157,157,0,0,"VOX",0
9,"9343",93,66,65,0,1,"VOX",0
45,"45166",1617,1305,1286,8,19,"VOX",3
47,"47210",382,282,274,3,8,"VOX",0
16,"16173",205,157,156,0,1,"VOX",1
22,"22057",370,271,270,3,1,"VOX",0
28,"28109",1576,1103,1098,1,5,"VOX",7
25,"25098",253,151,150,0,1,"VOX",0
19,"19319",4449,3086,3056,18,30,"VOX",8
45,"45187",4062,3277,3233,15,44,"VOX",3
29,"29067",424813,286785,284689,2351,2096,"VOX",900
14,"14040",3776,2873,2833,32,40,"VOX",9
6,"6124",1708,1202,1165,8,37,"VOX",2
45,"45054",3959,2882,2848,12,34,"VOX",1
12,"12113",83,67,66,3,1,"VOX",1
46,"46262",223,162,159,2,3,"VOX",0
50,"50038",1502,1121,1111,7,10,"VOX",1
9,"9151",448,362,360,6,2,"VOX",0
46,"46041",329,253,252,5,1,"VOX",0
28,"28005",134246,99236,98481,583,755,"VOX",381
50,"50015",96,67,67,0,0,"VOX",0
10,"10188",499,382,374,4,8,"VOX",0
21,"21051",239,174,170,1,4,"VOX",0
50,"50283",70,57,57,1,0,"VOX",0
1,"1055",838,538,527,8,11,"VOX",0
40,"40234",397,298,292,2,6,"VOX",0
12,"12005",8062,5829,5754,64,75,"VOX",9
19,"19301",40,33,33,1,0,"VOX",0
19,"19066",55,48,48,0,0,"VOX",0
24,"24167",750,505,499,4,6,"VOX",0
25,"25169",173,112,111,3,1,"VOX",0
12,"12008",222,193,192,1,1,"VOX",0
25,"25020",289,206,205,3,1,"VOX",0
24,"24197",763,538,533,1,5,"VOX",1
16,"16012",84,72,71,0,1,"VOX",0
6,"6132",855,587,582,3,5,"VOX",0
29,"29069",85684,54130,53621,455,509,"VOX",118
16,"16245",419,327,323,7,4,"VOX",1
9,"9249",46,33,33,0,0,"VOX",0
24,"24156",239,159,158,1,1,"VOX",0
45,"45101",3756,3020,2984,12,36,"VOX",8
45,"45156",3410,2751,2711,13,40,"VOX",6
22,"22226",767,570,562,10,8,"VOX",8
9,"9476",62,43,43,0,0,"VOX",0
46,"46025",2499,1953,1934,8,19,"VOX",5
9,"9082",39,36,36,0,0,"VOX",0
25,"25004",571,376,373,3,3,"VOX",0
19,"19258",90,77,77,0,0,"VOX",0
46,"46043",136,124,124,0,0,"VOX",0
9,"9323",61,46,46,1,0,"VOX",0
48,"48033",217,149,149,0,0,"VOX",0
24,"24133",356,257,257,1,0,"VOX",0
50,"50047",48,36,36,0,0,"VOX",0
23,"23092",27775,19734,19541,175,193,"VOX",27
15,"15030",200176,143255,142070,1452,1185,"VOX",279
19,"19255",79,63,61,1,2,"VOX",0
25,"25017",236,169,167,7,2,"VOX",0
46,"46087",120,98,97,0,1,"VOX",1
47,"47127",137,98,97,0,1,"VOX",1
6,"6028",4233,3588,3499,30,89,"VOX",0
28,"28008",1799,1182,1174,4,8,"VOX",6
16,"16015",374,263,262,4,1,"VOX",1
47,"47081",45,36,35,1,1,"VOX",0
28,"28033",3899,2805,2788,7,17,"VOX",7
22,"22036",92,77,77,0,0,"VOX",0
9,"9410",3040,2117,2095,16,22,"VOX",2
12,"12088",62,59,59,0,0,"VOX",0
21,"21027",48,36,35,1,1,"VOX",0
3,"3096",5786,4358,4289,17,69,"VOX",5
22,"22086",215,161,159,1,2,"VOX",0
45,"45133",2797,2068,2048,13,20,"VOX",5
9,"9059",136488,101469,100463,907,1006,"VOX",387
16,"16176",38,30,30,0,0,"VOX",0
29,"29024",386,227,219,2,8,"VOX",0
22,"22087",67,45,45,2,0,"VOX",0
3,"3065",167284,123032,122305,711,727,"VOX",254
29,"29039",2666,1898,1873,22,25,"VOX",2
10,"10058",1021,718,708,2,10,"VOX",2
25,"25047",1014,675,674,8,1,"VOX",0
22,"22002",107,95,95,0,0,"VOX",0
18,"18183",658,438,434,3,4,"VOX",0
46,"46181",16955,12313,12148,95,165,"VOX",25
50,"50274",71,55,55,0,0,"VOX",0
16,"16905",1224,920,910,4,10,"VOX",0
23,"23006",4660,3687,3647,24,40,"VOX",1
24,"24171",356,197,196,0,1,"VOX",1
18,"18021",17485,11800,11669,95,131,"VOX",32
46,"46124",787,653,642,4,11,"VOX",2
16,"16049",149,111,110,0,1,"VOX",0
47,"47200",85,66,66,0,0,"VOX",1
25,"25093",640,403,395,7,8,"VOX",1
4,"4038",3084,2140,2126,16,14,"VOX",4
15,"15011",15432,10395,10248,74,147,"VOX",18
16,"16271",633,517,516,4,1,"VOX",0
16,"16093",60,49,47,0,2,"VOX",0
18,"18096",341,227,224,3,3,"VOX",0
15,"15025",1061,629,622,6,7,"VOX",0
40,"40148",238,188,187,2,1,"VOX",2
6,"6125",1743,1285,1269,7,16,"VOX",1
10,"10198",1143,981,964,6,17,"VOX",0
28,"28165",1794,1293,1285,3,8,"VOX",3
47,"47075",4856,3681,3637,24,44,"VOX",9
16,"16112",1497,1031,1021,9,10,"VOX",2
21,"21060",11957,7356,7279,88,77,"VOX",12
6,"6109",3919,3139,3012,24,127,"VOX",3
46,"46167",364,266,264,0,2,"VOX",0
24,"24193",378,268,265,2,3,"VOX",0
3,"3067",99,85,85,0,0,"VOX",0
25,"25007",1405,850,841,8,9,"VOX",2
9,"9017",89,68,67,4,1,"VOX",0
3,"3902",10254,6996,6930,34,66,"VOX",15
42,"42043",3791,2727,2682,25,45,"VOX",4
25,"25251",707,443,442,2,1,"VOX",1
9,"9195",59,36,36,2,0,"VOX",0
35,"35009",19905,14185,13961,89,224,"VOX",8
19,"19318",25,18,18,0,0,"VOX",0
33,"33065",1102,722,713,7,9,"VOX",1
48,"48038",1126,798,794,3,4,"VOX",0
40,"40107",100,73,73,1,0,"VOX",0
19,"19329",59,50,50,1,0,"VOX",0
47,"47076",17399,13097,12972,92,125,"VOX",38
24,"24029",735,539,535,3,4,"VOX",1
23,"23076",827,640,630,1,10,"VOX",0
15,"15029",5688,3590,3544,32,46,"VOX",1
19,"19021",1030,759,744,7,15,"VOX",1
19,"19146",41,35,32,0,3,"VOX",0
28,"28158",665,537,533,4,4,"VOX",6
18,"18178",719,549,544,4,5,"VOX",0
45,"45167",1440,1144,1133,6,11,"VOX",4
11,"11017",3212,2233,2203,39,30,"VOX",1
25,"25097",84,65,65,3,0,"VOX",0
9,"9334",50,39,37,0,2,"VOX",0
18,"18100",7807,5452,5398,50,54,"VOX",8
10,"10048",233,168,168,0,0,"VOX",2
19,"19220",2302,1519,1501,1,18,"VOX",7
25,"25154",122,74,72,0,2,"VOX",0
22,"22096",301,240,240,0,0,"VOX",1
10,"10065",206,156,155,1,1,"VOX",2
23,"23077",620,501,494,3,7,"VOX",0
42,"42016",18,14,14,0,0,"VOX",0
46,"46127",2692,2120,2091,18,29,"VOX",0
21,"21024",492,338,326,6,12,"VOX",0
45,"45121",6796,4743,4692,22,51,"VOX",29
9,"9178",47,35,35,0,0,"VOX",0
50,"50296",396,286,275,4,11,"VOX",0
41,"41084",2845,2124,2081,9,43,"VOX",0
24,"24037",360,254,250,2,4,"VOX",0
28,"28166",320,254,251,2,3,"VOX",0
19,"19124",386,260,257,0,3,"VOX",0
11,"11042",1186,868,858,7,10,"VOX",0
28,"28114",150,101,100,1,1,"VOX",0
21,"21021",12254,7339,7244,78,95,"VOX",9
25,"25228",3035,1933,1921,26,12,"VOX",2
50,"50046",178,133,133,5,0,"VOX",0
50,"50267",602,433,430,8,3,"VOX",1
3,"3124",460,388,384,3,4,"VOX",0
46,"46257",5571,4266,4224,25,42,"VOX",1
25,"25156",783,543,537,7,6,"VOX",1
10,"10115",3544,2705,2647,11,58,"VOX",3
10,"10176",371,262,261,0,1,"VOX",1
48,"48022",2336,1444,1433,6,11,"VOX",0
19,"19323",40,31,31,0,0,"VOX",1
46,"46095",610,467,459,1,8,"VOX",0
40,"40142",53,39,37,0,2,"VOX",0
16,"16265",20,19,19,0,0,"VOX",0
47,"47001",55,46,46,0,0,"VOX",0
12,"12139",318,237,233,0,4,"VOX",0
45,"45105",392,301,297,3,4,"VOX",3
47,"47080",30,22,21,0,1,"VOX",0
12,"12078",325,235,233,0,2,"VOX",0
6,"6149",10295,7651,7536,56,115,"VOX",16
6,"6133",1775,1324,1312,15,12,"VOX",2
9,"9030",112,75,73,1,2,"VOX",0
45,"45117",747,606,601,4,5,"VOX",0
48,"48064",606,447,445,4,2,"VOX",0
28,"28091",5440,3596,3558,24,38,"VOX",7
33,"33030",895,669,666,9,3,"VOX",0
40,"40906",2003,1569,1550,12,19,"VOX",4
47,"47163",290,230,228,3,2,"VOX",0
46,"46156",2080,1697,1675,10,22,"VOX",3
22,"22062",167,116,116,1,0,"VOX",0
10,"10118",286,251,249,1,2,"VOX",0
19,"19080",65,41,41,0,0,"VOX",0
33,"33007",1514,946,942,12,4,"VOX",2
18,"18068",1569,1189,1166,6,23,"VOX",3
26,"26088",37,32,31,0,1,"VOX",0
9,"9105",109,86,81,1,5,"VOX",1
16,"16209",116,101,101,2,0,"VOX",1
12,"12073",152,119,117,0,2,"VOX",0
40,"40004",459,356,352,2,4,"VOX",3
12,"12004",4170,3125,3088,19,37,"VOX",7
16,"16026",82,62,61,2,1,"VOX",0
18,"18108",850,659,656,3,3,"VOX",0
40,"40200",40,31,31,0,0,"VOX",0
45,"45162",669,494,486,2,8,"VOX",0
19,"19166",156,120,119,1,1,"VOX",1
29,"29018",2010,1472,1420,9,52,"VOX",1
40,"40131",48,42,42,0,0,"VOX",0
10,"10043",800,562,553,3,9,"VOX",0
19,"19238",42,28,28,0,0,"VOX",0
14,"14074",2299,1896,1866,16,30,"VOX",1
12,"12081",608,486,480,5,6,"VOX",0
47,"47147",116,92,92,0,0,"VOX",1
29,"29062",654,551,545,2,6,"VOX",0
35,"35015",9950,5139,5070,29,69,"VOX",9
4,"4027",250,159,159,0,0,"VOX",0
9,"9119",46,28,28,0,0,"VOX",0
50,"50210",38,30,30,1,0,"VOX",0
1,"1041",149,103,100,1,3,"VOX",0
19,"19126",1627,1155,1134,11,21,"VOX",5
40,"40160",102,71,70,1,1,"VOX",0
22,"22028",371,282,280,3,2,"VOX",1
50,"50902",87,79,79,2,0,"VOX",0
14,"14038",32322,22117,21887,179,230,"VOX",36
42,"42036",50,41,41,1,0,"VOX",0
39,"39057",2330,1671,1645,7,26,"VOX",3
47,"47084",1150,887,870,7,17,"VOX",2
47,"47183",130,106,105,0,1,"VOX",0
10,"10077",677,479,472,1,7,"VOX",2
19,"19240",51,44,42,0,2,"VOX",0
39,"39097",697,371,368,2,3,"VOX",0
19,"19277",19,13,13,0,0,"VOX",0
24,"24152",464,295,291,1,4,"VOX",3
48,"48910",2909,1950,1937,10,13,"VOX",2
26,"26075",329,267,264,2,3,"VOX",0
45,"45177",2110,1679,1656,3,23,"VOX",2
16,"16062",24,23,23,0,0,"VOX",0
25,"25220",1015,634,632,1,2,"VOX",0
11,"11030",22775,15157,14958,149,199,"VOX",18
10,"10047",955,732,727,1,5,"VOX",0
12,"12018",287,246,242,1,4,"VOX",1
50,"50135",91,70,70,3,0,"VOX",0
48,"48078",38617,26366,26212,158,154,"VOX",18
10,"10215",431,311,308,2,3,"VOX",0
24,"24052",158,104,102,0,2,"VOX",0
16,"16274",121,92,92,0,0,"VOX",0
4,"4093",1882,1216,1204,11,12,"VOX",1
19,"19048",18,15,15,1,0,"VOX",0
46,"46056",182,167,166,1,1,"VOX",0
25,"25138",569,363,360,4,3,"VOX",0
16,"16067",123,87,87,0,0,"VOX",1
29,"29100",2433,1684,1667,5,17,"VOX",1
39,"39049",322,229,229,0,0,"VOX",0
26,"26067",22,15,15,1,0,"VOX",0
1,"1046",601,432,428,3,4,"VOX",0
25,"25226",253,155,152,3,3,"VOX",0
40,"40052",74,60,60,0,0,"VOX",0
46,"46135",9680,7682,7634,36,48,"VOX",14
46,"46239",442,340,338,3,2,"VOX",0
15,"15017",19420,13661,13505,175,156,"VOX",33
46,"46083",15422,11179,11049,86,130,"VOX",18
19,"19209",40,29,29,1,0,"VOX",0
19,"19147",43,33,33,0,0,"VOX",0
9,"9014",195,115,114,1,1,"VOX",0
16,"16258",194,150,150,1,0,"VOX",1
47,"47168",29,26,26,1,0,"VOX",0
19,"19243",44,31,31,0,0,"VOX",0
6,"6099",1145,655,638,6,17,"VOX",0
40,"40080",59,43,41,0,2,"VOX",1
22,"22069",429,333,331,2,2,"VOX",0
47,"47086",3906,2970,2936,24,34,"VOX",3
28,"28178",1065,824,818,5,6,"VOX",3
15,"15092",6438,3976,3903,28,73,"VOX",2
28,"28023",4775,3755,3735,12,20,"VOX",16
16,"16098",561,456,454,3,2,"VOX",0
9,"9211",1441,1056,1039,9,17,"VOX",2
46,"46047",532,446,437,2,9,"VOX",0
47,"47155",3228,2277,2254,18,23,"VOX",9
25,"25185",692,400,397,6,3,"VOX",0
33,"33001",1588,887,880,8,7,"VOX",0
16,"16160",60,44,42,1,2,"VOX",0
9,"9172",129,103,101,1,2,"VOX",0
9,"9902",458,331,327,3,4,"VOX",0
10,"10007",629,459,454,5,5,"VOX",0
46,"46215",1436,1154,1143,5,11,"VOX",1
10,"10160",229,190,189,2,1,"VOX",1
48,"48041",693,533,529,3,4,"VOX",1
42,"42132",141,114,114,0,0,"VOX",0
45,"45082",1224,1020,1011,8,9,"VOX",1
45,"45049",433,305,304,1,1,"VOX",1
22,"22204",1114,745,739,12,6,"VOX",3
16,"16091",65,53,53,0,0,"VOX",0
46,"46051",8347,6355,6302,24,53,"VOX",14
9,"9338",227,170,169,0,1,"VOX",1
16,"16225",73,57,57,3,0,"VOX",0
29,"29025",39665,25907,25714,192,193,"VOX",57
1,"1021",473,310,309,0,1,"VOX",1
35,"35022",48603,29443,29042,160,401,"VOX",27
3,"3022",145,125,125,0,0,"VOX",0
9,"9439",1028,752,744,9,8,"VOX",2
10,"10116",3749,2726,2670,21,56,"VOX",5
4,"4098",1516,1115,1106,11,9,"VOX",1
16,"16189",264,206,205,4,1,"VOX",0
29,"29026",1057,751,748,5,3,"VOX",2
30,"30041",13621,8970,8889,46,81,"VOX",17
16,"16266",368,264,259,1,5,"VOX",0
23,"23016",387,321,320,0,1,"VOX",1
3,"3116",1155,877,875,6,2,"VOX",1
22,"22115",360,257,256,3,1,"VOX",6
46,"46061",342,274,272,1,2,"VOX",0
16,"16001",76,61,61,0,0,"VOX",0
48,"48023",600,455,452,0,3,"VOX",0
19,"19270",20,17,17,0,0,"VOX",0
19,"19054",192,164,164,1,0,"VOX",0
22,"22253",61,52,52,0,0,"VOX",0
18,"18189",776,581,574,4,7,"VOX",2
23,"23021",524,431,429,0,2,"VOX",0
46,"46178",4637,3405,3381,27,24,"VOX",24
12,"12034",1424,1065,1035,3,30,"VOX",0
18,"18099",1584,1228,1206,14,22,"VOX",3
9,"9467",64,43,42,1,1,"VOX",0
10,"10057",143,117,117,1,0,"VOX",0
25,"25146",227,140,140,3,0,"VOX",0
9,"9084",186,136,135,4,1,"VOX",0
3,"3139",22437,15315,15170,100,145,"VOX",31
16,"16191",899,675,671,2,4,"VOX",2
16,"16142",136,101,101,1,0,"VOX",0
45,"45096",1004,807,799,1,8,"VOX",3
22,"22088",153,110,110,2,0,"VOX",0
42,"42034",30,22,22,0,0,"VOX",0
19,"19016",65,49,49,0,0,"VOX",0
40,"40046",89,75,75,1,0,"VOX",0
9,"9297",323,251,250,6,1,"VOX",0
30,"30033",10188,7403,7285,68,118,"VOX",15
16,"16004",259,198,197,2,1,"VOX",0
12,"12059",231,189,188,2,1,"VOX",0
47,"47064",33,28,25,0,3,"VOX",0
45,"45120",129,104,104,1,0,"VOX",0
3,"3076",8467,6238,6157,30,81,"VOX",12
19,"19216",131,98,98,0,0,"VOX",0
50,"50292",125,102,102,1,0,"VOX",0
48,"48015",33581,22727,22528,122,199,"VOX",17
22,"22044",252,198,197,0,1,"VOX",0
9,"9164",157,127,126,0,1,"VOX",0
9,"9298",82,70,69,1,1,"VOX",0
28,"28001",61,46,45,0,1,"VOX",0
24,"24061",1704,1213,1204,9,9,"VOX",3
16,"16019",214,156,152,0,4,"VOX",0
48,"48087",427,344,338,0,6,"VOX",0
16,"16006",120,98,96,3,2,"VOX",0
24,"24196",2057,1502,1485,9,17,"VOX",1
4,"4102",13694,8944,8865,50,79,"VOX",9
9,"9223",45,37,37,0,0,"VOX",0
45,"45188",2785,1960,1938,15,22,"VOX",5
45,"45154",1493,1079,1074,6,5,"VOX",6
39,"39098",1402,1046,1036,8,10,"VOX",0
25,"25110",2766,1628,1602,22,26,"VOX",0
6,"6090",869,617,602,3,15,"VOX",2
6,"6096",220,176,171,2,5,"VOX",1
41,"41009",1222,812,805,3,7,"VOX",3
1,"1053",582,321,320,4,1,"VOX",0
47,"47229",210,148,147,1,1,"VOX",0
6,"6156",1175,869,865,8,4,"VOX",0
4,"4103",1476,1018,1008,3,10,"VOX",5
9,"9445",44,32,32,3,0,"VOX",0
18,"18085",720,507,499,3,8,"VOX",0
9,"9361",115,90,89,0,1,"VOX",0
12,"12095",959,749,742,8,7,"VOX",3
46,"46065",1579,1174,1163,8,11,"VOX",0
40,"40092",118,87,87,1,0,"VOX",0
22,"22081",254,181,181,0,0,"VOX",0
22,"22046",728,566,561,5,5,"VOX",2
22,"22907",1435,1059,1046,18,13,"VOX",5
24,"24130",438,323,321,4,2,"VOX",0
25,"25168",509,354,352,7,2,"VOX",0
9,"9392",53,40,37,1,3,"VOX",0
22,"22125",38773,27021,26732,258,289,"VOX",114
46,"46022",15365,11093,10997,59,96,"VOX",17
9,"9226",63,54,54,0,0,"VOX",0
45,"45057",222,180,177,1,3,"VOX",0
19,"19107",294,239,237,0,2,"VOX",1
46,"46170",3417,2714,2688,10,26,"VOX",5
45,"45146",107,84,83,0,1,"VOX",0
30,"30007",6411,4360,4329,24,31,"VOX",18
24,"24199",424,302,301,0,1,"VOX",1
16,"16133",4389,3358,3316,24,42,"VOX",9
40,"40220",66,50,46,1,4,"VOX",0
26,"26056",419,338,332,1,6,"VOX",0
48,"48029",8338,5721,5683,37,38,"VOX",7
19,"19184",71,50,48,0,2,"VOX",0
35,"35028",9776,5476,5401,43,75,"VOX",15
45,"45191",543,472,468,3,4,"VOX",0
29,"29001",4170,3106,3068,19,38,"VOX",1
10,"10143",154,112,112,0,0,"VOX",0
26,"26024",228,181,181,0,0,"VOX",1
12,"12065",188,169,169,2,0,"VOX",0
19,"19256",43,36,36,0,0,"VOX",0
21,"21007",6225,4080,3999,52,81,"VOX",5
1,"1063",1798,1269,1261,19,8,"VOX",9
23,"23005",30465,20878,20630,177,248,"VOX",27
40,"40204",167,113,110,1,3,"VOX",0
22,"22074",313,228,225,4,3,"VOX",0
1,"1034",161,124,123,1,1,"VOX",0
28,"28100",4196,2987,2955,14,32,"VOX",7
50,"50067",14119,9909,9819,112,90,"VOX",24
16,"16264",435,366,364,2,2,"VOX",1
10,"10190",545,406,395,2,11,"VOX",1
29,"29092",570,397,390,4,7,"VOX",1
19,"19097",16,10,10,0,0,"VOX",0
22,"22013",288,216,210,3,6,"VOX",0
40,"40097",128,93,92,0,1,"VOX",0
29,"29058",1450,911,894,4,17,"VOX",4
40,"40082",114,84,82,1,2,"VOX",0
25,"25118",346,198,189,3,9,"VOX",0
21,"21040",3170,2129,2071,20,58,"VOX",5
3,"3083",5586,3971,3928,33,43,"VOX",13
46,"46147",16835,11920,11791,61,129,"VOX",35
35,"35004",39299,20523,20294,140,229,"VOX",61
25,"25217",10625,6319,6260,99,59,"VOX",9
6,"6901",2118,1559,1546,23,13,"VOX",2
24,"24002",231,173,172,1,1,"VOX",1
25,"25044",188,122,120,7,2,"VOX",0
22,"22085",104,86,86,0,0,"VOX",0
24,"24101",397,258,257,3,1,"VOX",1
1,"1022",799,557,544,2,13,"VOX",2
3,"3095",4579,3489,3459,25,30,"VOX",3
19,"19199",17,17,17,1,0,"VOX",0
46,"46017",32949,23913,23685,142,228,"VOX",49
42,"42182",56,43,41,1,2,"VOX",1
18,"18107",943,663,655,1,8,"VOX",0
15,"15035",11427,7779,7657,144,122,"VOX",10
22,"22130",10092,6671,6608,59,63,"VOX",21
50,"50080",33,27,27,0,0,"VOX",0
25,"25219",141,102,101,0,1,"VOX",0
14,"14008",2839,1905,1895,19,10,"VOX",0
4,"4035",8364,5810,5766,28,44,"VOX",6
29,"29027",2326,1626,1609,12,17,"VOX",4
6,"6004",1600,1212,1207,2,5,"VOX",3
9,"9346",92,64,63,1,1,"VOX",0
48,"48058",968,647,646,2,1,"VOX",0
14,"14052",9379,5917,5854,68,63,"VOX",5
40,"40103",159,125,123,2,2,"VOX",0
46,"46235",21579,15929,15763,113,166,"VOX",19
47,"47090",2418,1728,1699,8,29,"VOX",5
16,"16156",97,78,77,0,1,"VOX",1
18,"18154",1007,664,660,2,4,"VOX",0
10,"10012",595,466,459,0,7,"VOX",0
29,"29096",2810,1944,1909,31,35,"VOX",0
24,"24206",1700,1253,1240,12,13,"VOX",1
14,"14037",3318,2374,2320,22,54,"VOX",2
24,"24103",283,163,157,1,6,"VOX",0
19,"19190",2369,1760,1745,10,15,"VOX",0
46,"46201",64,52,51,1,1,"VOX",0
14,"14065",1850,1384,1377,16,7,"VOX",2
18,"18097",960,693,685,5,8,"VOX",0
48,"48005",115,63,61,0,2,"VOX",0
10,"10059",364,253,248,1,5,"VOX",1
25,"25135",1028,600,593,10,7,"VOX",0
18,"18157",1121,815,803,3,12,"VOX",1
29,"29086",793,470,470,3,0,"VOX",0
14,"14047",1672,1187,1178,14,9,"VOX",3
19,"19300",772,595,591,5,4,"VOX",2
10,"10136",302,218,215,4,3,"VOX",0
45,"45098",2159,1632,1609,12,23,"VOX",4
1,"1902",734,514,502,4,12,"VOX",0
11,"11036",689,407,400,3,7,"VOX",0
16,"16273",321,242,236,3,6,"VOX",0
48,"48036",24073,16076,15971,86,105,"VOX",8
24,"24071",1006,745,734,10,11,"VOX",0
50,"50083",89,75,75,1,0,"VOX",0
42,"42188",50,39,38,0,1,"VOX",0
15,"15001",4765,3280,3237,25,43,"VOX",11
24,"24104",259,169,169,0,0,"VOX",0
24,"24006",472,353,347,0,6,"VOX",1
25,"25179",162,103,103,2,0,"VOX",0
50,"50263",193,121,121,0,0,"VOX",0
25,"25077",463,256,253,6,3,"VOX",1
15,"15064",2194,1592,1556,21,36,"VOX",3
22,"22016",601,413,411,6,2,"VOX",0
16,"16269",419,336,332,2,4,"VOX",0
29,"29031",1614,1107,1094,13,13,"VOX",0
22,"22045",82,65,64,1,1,"VOX",0
14,"14049",16309,11635,11515,115,120,"VOX",19
26,"26032",51,41,39,0,2,"VOX",0
46,"46230",13960,10351,10241,54,110,"VOX",15
3,"3068",47,44,44,0,0,"VOX",0
9,"9239",52,40,39,0,1,"VOX",0
25,"25224",126,70,70,5,0,"VOX",0
28,"28108",3374,2482,2465,10,17,"VOX",18
22,"22906",186,141,139,3,2,"VOX",0
48,"48069",12798,8679,8612,55,67,"VOX",4
25,"25225",564,356,356,1,0,"VOX",0
46,"46254",1000,785,779,6,6,"VOX",3
29,"29010",1651,1278,1237,4,41,"VOX",0
26,"26033",170,132,129,1,3,"VOX",0
9,"9362",208,172,171,2,1,"VOX",2
19,"19230",505,360,357,3,3,"VOX",2
50,"50264",156,115,115,0,0,"VOX",0
47,"47077",246,193,191,1,2,"VOX",0
24,"24107",236,175,173,0,2,"VOX",0
9,"9378",31,24,23,0,1,"VOX",0
16,"16162",43,35,34,0,1,"VOX",0
24,"24009",322,153,152,2,1,"VOX",0
41,"41095",41232,27076,26793,315,283,"VOX",35
10,"10217",526,404,402,1,2,"VOX",0
45,"45024",1062,793,785,4,8,"VOX",0
10,"10112",1571,1107,1081,9,26,"VOX",0
14,"14051",1397,1018,1000,2,18,"VOX",0
6,"6129",577,438,429,0,9,"VOX",0
47,"47214",1409,1087,1062,7,25,"VOX",3
16,"16277",113,84,83,1,1,"VOX",0
16,"16163",74,62,62,0,0,"VOX",0
48,"48010",458,318,317,0,1,"VOX",0
11,"11018",1468,1046,1031,9,15,"VOX",1
45,"45002",2564,1681,1665,17,16,"VOX",1
42,"42097",23,14,11,0,3,"VOX",0
40,"40180",299,246,241,1,5,"VOX",3
10,"10189",2630,1880,1851,4,29,"VOX",2
40,"40134",731,579,570,1,9,"VOX",2
42,"42064",86,68,68,0,0,"VOX",0
48,"48030",606,441,439,1,2,"VOX",0
47,"47017",201,158,153,1,5,"VOX",1
16,"16219",89,71,71,0,0,"VOX",0
3,"3041",5954,4218,4194,22,24,"VOX",10
19,"19040",52,41,39,0,2,"VOX",0
3,"3072",348,289,285,0,4,"VOX",0
9,"9112",109,85,85,0,0,"VOX",0
46,"46154",808,636,631,5,5,"VOX",0
14,"14071",929,642,630,2,12,"VOX",0
9,"9067",437,295,294,6,1,"VOX",1
50,"50154",116,96,96,0,0,"VOX",1
22,"22229",114,80,80,1,0,"VOX",0
19,"19223",111,83,83,3,0,"VOX",0
1,"1051",3603,2259,2235,17,24,"VOX",0
23,"23029",843,628,624,2,4,"VOX",1
25,"25904",148,112,111,2,1,"VOX",0
25,"25186",213,124,122,3,2,"VOX",0
42,"42019",516,363,356,3,7,"VOX",1
28,"28072",5709,4356,4324,22,32,"VOX",40
39,"39032",1463,1087,1081,7,6,"VOX",1
25,"25101",561,364,358,2,6,"VOX",0
22,"22143",217,143,141,1,2,"VOX",0
12,"12009",17445,12088,11999,75,89,"VOX",25
25,"25231",486,330,330,4,0,"VOX",0
9,"9384",295,211,206,0,5,"VOX",1
47,"47137",29,25,25,1,0,"VOX",0
15,"15021",5127,3587,3543,38,44,"VOX",4
23,"23044",4816,3663,3569,27,94,"VOX",6
15,"15009",10739,7688,7559,54,129,"VOX",16
46,"46052",499,421,417,2,4,"VOX",0
26,"26178",75,57,55,1,2,"VOX",0
16,"16902",137,107,107,0,0,"VOX",0
11,"11022",48675,26491,26256,270,235,"VOX",62
24,"24179",290,197,192,4,5,"VOX",1
4,"4048",1503,1090,1085,9,5,"VOX",0
21,"21028",375,277,271,2,6,"VOX",2
24,"24113",366,293,287,5,6,"VOX",0
12,"12001",1051,821,800,4,21,"VOX",0
16,"16103",261,222,222,0,0,"VOX",0
9,"9441",74,65,65,0,0,"VOX",0
9,"9387",117,95,90,0,5,"VOX",0
9,"9033",90,74,74,1,0,"VOX",0
26,"26028",134,113,112,0,1,"VOX",0
48,"48094",3161,2094,2073,12,21,"VOX",2
15,"15010",1887,1168,1150,13,18,"VOX",0
19,"19087",18,18,18,0,0,"VOX",0
39,"39095",2266,1760,1726,14,34,"VOX",0
14,"14055",18557,12950,12764,178,186,"VOX",8
47,"47082",812,640,628,8,12,"VOX",1
3,"3097",993,822,812,6,10,"VOX",1
39,"39004",1518,1090,1074,4,16,"VOX",1
12,"12112",99,79,78,3,1,"VOX",0
3,"3045",210,176,172,0,4,"VOX",0
40,"40032",390,289,285,2,4,"VOX",1
16,"16126",770,634,624,3,10,"VOX",3
48,"48909",209,161,161,0,0,"VOX",0
50,"50061",202,172,172,3,0,"VOX",0
45,"45174",301,237,233,1,4,"VOX",0
47,"47111",1020,742,732,7,10,"VOX",3
15,"15075",12336,8830,8725,91,105,"VOX",11
10,"10121",7978,5517,5429,35,88,"VOX",6
25,"25061",83,46,46,0,0,"VOX",0
6,"6001",686,522,515,0,7,"VOX",0
25,"25109",231,163,162,2,1,"VOX",0
46,"46080",998,803,799,7,4,"VOX",0
50,"50282",69,54,54,0,0,"VOX",0
42,"42079",26,18,18,1,0,"VOX",0
6,"6017",272,222,221,1,1,"VOX",1
46,"46211",1745,1387,1378,8,9,"VOX",4
10,"10122",218,156,153,3,3,"VOX",0
11,"11025",4398,2899,2848,51,51,"VOX",4
41,"41070",6032,4312,4258,44,54,"VOX",16
19,"19127",89,64,64,0,0,"VOX",0
9,"9390",611,484,482,3,2,"VOX",2
46,"46003",950,791,769,1,22,"VOX",0
47,"47192",102,83,81,1,2,"VOX",0
19,"19090",91,73,73,1,0,"VOX",0
24,"24073",478,332,328,2,4,"VOX",0
12,"12014",184,144,143,2,1,"VOX",0
29,"29020",3267,2408,2359,16,49,"VOX",3
26,"26020",476,349,339,3,10,"VOX",4
24,"24008",9282,6685,6603,52,82,"VOX",17
46,"46073",1092,888,884,6,4,"VOX",1
19,"19241",43,34,34,1,0,"VOX",0
40,"40162",392,303,302,1,1,"VOX",1
26,"26148",165,135,133,1,2,"VOX",0
18,"18038",1066,828,802,1,26,"VOX",3
46,"46212",1620,1150,1124,9,26,"VOX",0
6,"6050",4106,3134,3075,25,59,"VOX",1
18,"18177",418,258,256,0,2,"VOX",0
22,"22032",110,76,74,0,2,"VOX",0
48,"48017",13261,8543,8482,42,61,"VOX",2
23,"23009",12861,9649,9543,72,106,"VOX",31
41,"41027",3922,2660,2604,23,56,"VOX",1
6,"6158",13314,9654,9507,67,147,"VOX",15
28,"28003",173,141,141,0,0,"VOX",2
46,"46263",251,214,212,0,2,"VOX",1
26,"26077",22,22,21,1,1,"VOX",0
33,"33036",11542,8062,7987,60,75,"VOX",11
25,"25243",3646,2193,2167,33,26,"VOX",6
19,"19208",43,30,30,0,0,"VOX",0
11,"11028",32488,21971,21672,316,299,"VOX",45
10,"10172",709,466,465,0,1,"VOX",0
15,"15016",4749,3058,3020,19,38,"VOX",2
22,"22095",72,58,58,1,0,"VOX",0
40,"40193",229,174,172,3,2,"VOX",0
22,"22112",9566,6354,6305,56,49,"VOX",23
16,"16181",64,52,52,2,0,"VOX",0
23,"23011",2170,1515,1496,7,19,"VOX",1
19,"19095",12,9,9,0,0,"VOX",0
11,"11029",5430,3039,3000,44,39,"VOX",5
22,"22157",192,129,128,3,1,"VOX",1
50,"50066",2621,1862,1851,9,11,"VOX",6
12,"12117",3585,2727,2677,20,50,"VOX",5
50,"50194",88,63,63,1,0,"VOX",0
18,"18042",403,324,322,2,2,"VOX",0
9,"9125",584,432,430,1,2,"VOX",0
42,"42163",50,41,40,0,1,"VOX",2
6,"6070",7743,5438,5317,39,121,"VOX",8
9,"9182",80,69,67,1,2,"VOX",0
29,"29091",8957,6186,6078,56,108,"VOX",7
46,"46128",1597,1290,1250,5,40,"VOX",2
22,"22188",82,60,59,6,1,"VOX",0
9,"9351",62,49,48,1,1,"VOX",2
29,"29080",6676,4469,4419,35,50,"VOX",5
16,"16041",358,275,271,0,4,"VOX",0
47,"47196",34,27,27,0,0,"VOX",0
18,"18043",123,80,79,1,1,"VOX",0
24,"24120",341,246,244,1,2,"VOX",0
26,"26036",16986,11940,11816,66,124,"VOX",38
14,"14034",308,247,244,2,3,"VOX",0
47,"47009",107,86,85,0,1,"VOX",1
3,"3082",12567,8537,8464,44,73,"VOX",22
15,"15901",3546,2247,2228,24,19,"VOX",2
6,"6147",354,268,268,0,0,"VOX",1
22,"22061",6630,4555,4526,40,29,"VOX",9
46,"46077",7496,5909,5827,45,82,"VOX",4
9,"9001",27,22,22,0,0,"VOX",0
15,"15902",4598,3209,3149,51,60,"VOX",6
42,"42209",140,107,106,4,1,"VOX",0
40,"40001",702,560,554,3,6,"VOX",2
45,"45015",606,437,433,2,4,"VOX",0
19,"19283",30,25,25,0,0,"VOX",0
9,"9903",3221,2304,2281,27,23,"VOX",7
46,"46216",5053,4109,4090,14,19,"VOX",18
29,"29082",31885,22572,22400,152,172,"VOX",36
10,"10086",320,238,233,1,5,"VOX",0
6,"6058",2026,1433,1416,9,17,"VOX",0
41,"41010",4420,2960,2916,30,44,"VOX",6
25,"25158",1620,1019,1012,15,7,"VOX",0
19,"19284",10,10,9,0,1,"VOX",0
19,"19099",298,200,199,6,1,"VOX",1
26,"26082",112,87,87,1,0,"VOX",0
42,"42032",146,118,118,0,0,"VOX",0
9,"9006",59,39,39,0,0,"VOX",0
22,"22025",1071,676,669,18,7,"VOX",1
42,"42075",83,62,62,0,0,"VOX",0
50,"50229",62,47,47,2,0,"VOX",0
40,"40086",685,561,552,4,9,"VOX",1
45,"45063",417,310,303,1,7,"VOX",1
25,"25046",422,279,275,2,4,"VOX",0
16,"16141",143,102,102,0,0,"VOX",0
24,"24004",463,350,348,4,2,"VOX",0
47,"47028",33,21,21,0,0,"VOX",0
39,"39034",286,188,185,5,3,"VOX",0
22,"22042",117,95,92,0,3,"VOX",0
6,"6060",5786,4146,4071,24,75,"VOX",2
24,"24228",660,430,422,6,8,"VOX",2
10,"10042",84,63,63,0,0,"VOX",0
48,"48054",24171,16797,16711,118,86,"VOX",13
46,"46244",58771,42137,41867,270,270,"VOX",128
28,"28028",1755,1353,1344,6,9,"VOX",2
24,"24026",1177,864,849,7,15,"VOX",1
9,"9131",462,365,364,2,1,"VOX",1
18,"18143",973,742,730,5,12,"VOX",3
40,"40005",30,23,23,0,0,"VOX",0
4,"4005",556,437,431,3,6,"VOX",0
1,"1027",416,257,254,3,3,"VOX",0
28,"28155",506,416,411,0,5,"VOX",0
3,"3086",151,135,134,1,1,"VOX",0
22,"22165",487,364,360,6,4,"VOX",0
10,"10182",136,95,95,0,0,"VOX",0
26,"26158",251,214,210,0,4,"VOX",0
25,"25208",331,183,182,1,1,"VOX",0
41,"41014",2492,1882,1852,11,30,"VOX",0
14,"14010",4027,2850,2807,19,43,"VOX",4
14,"14066",5856,4150,4095,48,55,"VOX",3
47,"47030",993,766,751,6,15,"VOX",0
46,"46046",892,675,668,1,7,"VOX",0
40,"40215",84,60,60,0,0,"VOX",0
16,"16194",242,185,179,1,6,"VOX",0
24,"24127",296,226,215,4,11,"VOX",0
39,"39046",1404,1001,973,6,28,"VOX",5
22,"22122",64,57,57,2,0,"VOX",0
3,"3057",182,147,147,1,0,"VOX",4
4,"4072",313,247,245,2,2,"VOX",0
10,"10092",292,236,235,1,1,"VOX",0
35,"35025",1797,1261,1245,4,16,"VOX",0
41,"41004",56640,37110,36649,440,461,"VOX",89
50,"50105",296,214,211,1,3,"VOX",0
30,"30015",19171,13561,13464,61,97,"VOX",48
9,"9251",375,277,274,4,3,"VOX",1
50,"50191",470,310,308,1,2,"VOX",0
42,"42202",20,14,13,0,1,"VOX",0
39,"39048",1716,1329,1312,12,17,"VOX",4
46,"46168",1938,1495,1486,2,9,"VOX",0
9,"9011",65,48,48,0,0,"VOX",0
26,"26161",8,7,7,0,0,"VOX",0
19,"19182",38,34,33,0,1,"VOX",0
26,"26054",320,263,260,4,3,"VOX",0
3,"3058",4951,3897,3851,30,46,"VOX",10
16,"16100",670,564,559,0,5,"VOX",0
25,"25255",417,298,296,2,2,"VOX",0
9,"9225",83,55,54,0,1,"VOX",2
42,"42038",36,28,28,1,0,"VOX",0
16,"16068",137,98,97,1,1,"VOX",0
50,"50244",201,162,161,1,1,"VOX",2
4,"4043",549,465,461,1,4,"VOX",1
16,"16052",547,418,416,2,2,"VOX",0
9,"9013",48,37,37,0,0,"VOX",0
16,"16197",59,42,42,0,0,"VOX",0
45,"45123",3081,2144,2131,11,13,"VOX",4
3,"3091",252,217,215,2,2,"VOX",0
28,"28128",444,315,314,0,1,"VOX",0
24,"24064",1523,1101,1087,3,14,"VOX",3
48,"48049",549,416,416,1,0,"VOX",0
50,"50224",72,57,56,2,1,"VOX",0
39,"39050",270,187,186,0,1,"VOX",0
50,"50044",230,145,145,1,0,"VOX",0
21,"21010",14687,8293,8220,92,73,"VOX",11
9,"9136",192,142,137,2,5,"VOX",0
22,"22172",556,372,370,6,2,"VOX",3
12,"12029",702,557,555,4,2,"VOX",3
40,"40010",121,102,101,1,1,"VOX",0
10,"10050",1053,846,837,6,9,"VOX",1
50,"50109",103,78,78,3,0,"VOX",0
19,"19333",115,82,82,0,0,"VOX",0
47,"47206",92,80,80,0,0,"VOX",0
45,"45091",394,269,267,3,2,"VOX",0
9,"9227",119,91,89,4,2,"VOX",3
45,"45181",2315,1674,1640,7,34,"VOX",1
16,"16165",61,54,53,0,1,"VOX",0
46,"46249",9288,6746,6676,56,70,"VOX",19
19,"19221",48,38,37,1,1,"VOX",0
39,"39021",487,381,376,2,5,"VOX",1
28,"28130",28293,21253,21040,116,213,"VOX",57
45,"45092",232,197,191,0,6,"VOX",0
40,"40182",178,133,130,2,3,"VOX",0
9,"9183",51,41,41,0,0,"VOX",1
25,"25171",2185,1416,1410,8,6,"VOX",0
12,"12031",3807,2941,2894,24,47,"VOX",11
4,"4046",858,609,599,7,10,"VOX",0
41,"41020",12887,8210,8118,82,92,"VOX",13
47,"47207",278,215,212,3,3,"VOX",1
18,"18044",181,107,107,0,0,"VOX",0
22,"22039",863,671,667,4,4,"VOX",0
22,"22114",123,81,81,0,0,"VOX",0
3,"3093",19683,14633,14484,70,149,"VOX",30
28,"28131",12990,9512,9433,38,79,"VOX",96
25,"25218",81,64,63,1,1,"VOX",0
15,"15033",2472,1863,1845,8,18,"VOX",2
45,"45026",211,167,166,2,1,"VOX",0
10,"10192",828,590,584,1,6,"VOX",0
42,"42007",113,86,86,5,0,"VOX",0
11,"11901",5648,3676,3631,67,45,"VOX",0
9,"9140",124,80,79,0,1,"VOX",0
11,"11032",53874,31273,31008,348,265,"VOX",43
25,"25906",218,125,125,1,0,"VOX",0
23,"23031",747,637,619,0,18,"VOX",0
23,"23030",1238,968,960,3,8,"VOX",1
12,"12130",404,340,335,0,5,"VOX",0
10,"10193",1412,1090,1078,6,12,"VOX",1
19,"19027",138,105,105,1,0,"VOX",0
21,"21014",4016,3025,2991,21,34,"VOX",2
9,"9414",189,148,146,0,2,"VOX",0
41,"41088",509,360,356,0,4,"VOX",0
6,"6119",689,501,499,4,2,"VOX",0
50,"50269",285,193,188,0,5,"VOX",0
39,"39074",6902,5113,5039,40,74,"VOX",6
16,"16155",508,398,391,2,7,"VOX",0
6,"6105",624,418,417,1,1,"VOX",0
16,"16270",162,137,137,0,0,"VOX",2
16,"16231",46,37,37,0,0,"VOX",0
18,"18095",1967,1450,1430,11,20,"VOX",2
28,"28104",14040,11151,11096,57,55,"VOX",53
19,"19298",65,45,45,0,0,"VOX",1
6,"6075",465,383,372,0,11,"VOX",0
45,"45129",131,92,92,0,0,"VOX",0
47,"47209",41,34,34,0,0,"VOX",0
33,"33031",35120,22295,22024,271,271,"VOX",41
50,"50114",116,89,88,0,1,"VOX",0
9,"9327",26,24,24,0,0,"VOX",0
3,"3004",581,438,437,2,1,"VOX",0
9,"9416",53,35,35,0,0,"VOX",0
42,"42140",16,12,12,0,0,"VOX",0
6,"6031",469,277,272,2,5,"VOX",0
22,"22904",815,579,575,8,4,"VOX",1
39,"39025",8637,6486,6378,47,108,"VOX",13
42,"42011",18,10,10,1,0,"VOX",0
18,"18907",1843,1393,1388,4,5,"VOX",3
47,"47047",199,157,156,2,1,"VOX",1
18,"18065",618,496,470,3,26,"VOX",0
35,"35033",6398,4340,4266,19,74,"VOX",3
3,"3005",7769,5917,5866,19,51,"VOX",18
50,"50082",82,65,64,0,1,"VOX",0
10,"10151",207,165,162,0,3,"VOX",0
46,"46228",2348,1815,1794,7,21,"VOX",17
25,"25123",193,134,131,2,3,"VOX",0
23,"23007",3087,2205,2187,6,18,"VOX",2
47,"47157",515,424,423,1,1,"VOX",0
42,"42093",37,29,28,1,1,"VOX",0
42,"42142",50,35,35,1,0,"VOX",0
29,"29008",14596,9519,9407,94,112,"VOX",20
25,"25910",100,63,61,2,2,"VOX",0
40,"40020",157,118,117,1,1,"VOX",3
22,"22181",92,61,61,2,0,"VOX",0
12,"12038",167,120,118,2,2,"VOX",0
50,"50273",30,22,22,0,0,"VOX",0
24,"24028",388,292,288,2,4,"VOX",0
4,"4052",12274,8372,8306,93,66,"VOX",9
24,"24039",2063,1597,1596,41,1,"VOX",3
4,"4041",322,240,238,6,2,"VOX",3
50,"50201",448,339,335,7,4,"VOX",1
28,"28156",1019,742,738,3,4,"VOX",4
22,"22225",2679,1700,1665,17,35,"VOX",1
10,"10155",1126,773,763,5,10,"VOX",1
19,"19302",59,49,49,1,0,"VOX",1
33,"33035",11284,7681,7618,70,63,"VOX",21
42,"42013",34,28,27,0,1,"VOX",0
28,"28068",10955,8136,8076,49,60,"VOX",59
25,"25911",451,273,271,7,2,"VOX",2
19,"19157",55,46,46,0,0,"VOX",0
16,"16216",315,268,265,1,3,"VOX",0
6,"6035",937,696,681,5,15,"VOX",0
48,"48068",1550,1130,1118,12,12,"VOX",0
4,"4901",545,395,394,0,1,"VOX",0
21,"21008",2658,1660,1636,10,24,"VOX",1
16,"16161",57,48,46,0,2,"VOX",0
3,"3069",3076,2123,2102,17,21,"VOX",6
21,"21063",2615,2001,1957,22,44,"VOX",0
39,"39089",143,104,100,1,4,"VOX",0
42,"42015",30,20,19,1,1,"VOX",0
24,"24143",510,358,349,0,9,"VOX",0
18,"18069",502,362,357,0,5,"VOX",2
48,"48903",1835,1361,1351,7,10,"VOX",1
42,"42191",185,136,133,0,3,"VOX",1
39,"39029",618,488,481,3,7,"VOX",0
26,"26174",146,107,105,2,2,"VOX",1
9,"9380",78,58,58,0,0,"VOX",0
26,"26139",54,45,44,0,1,"VOX",0
6,"6038",805,543,541,2,2,"VOX",0
39,"39060",6679,5196,5121,29,75,"VOX",7
46,"46179",2165,1760,1737,16,23,"VOX",3
16,"16070",30,26,26,1,0,"VOX",0
15,"15042",3028,2033,2000,19,33,"VOX",2
19,"19119",82,72,71,1,1,"VOX",0
6,"6039",1840,1469,1437,9,32,"VOX",1
1,"1006",175,140,140,0,0,"VOX",0
48,"48040",1281,877,869,3,8,"VOX",0
48,"48091",1121,771,765,7,6,"VOX",0
46,"46223",7801,5950,5899,34,51,"VOX",12
26,"26002",830,632,622,0,10,"VOX",1
29,"29013",1610,1238,1207,9,31,"VOX",2
22,"22141",117,91,90,1,1,"VOX",0
39,"39091",1926,1493,1476,10,17,"VOX",3
28,"28169",1448,1122,1113,5,9,"VOX",18
30,"30029",11864,8125,8058,73,67,"VOX",7
18,"18120",264,209,208,1,1,"VOX",0
26,"26176",53,44,44,1,0,"VOX",0
47,"47134",165,128,125,1,3,"VOX",1
24,"24109",977,633,624,3,9,"VOX",0
35,"35012",10382,5443,5392,17,51,"VOX",3
24,"24011",203,133,132,0,1,"VOX",0
11,"11009",605,414,410,1,4,"VOX",1
25,"25130",195,113,112,2,1,"VOX",1
1,"1036",14955,10052,9959,55,93,"VOX",10
3,"3042",1393,1010,996,7,14,"VOX",1
14,"14053",6006,4285,4232,49,53,"VOX",1
46,"46129",524,420,412,4,8,"VOX",1
21,"21026",266,166,159,3,7,"VOX",0
12,"12043",570,449,442,2,7,"VOX",1
50,"50297",498961,362043,359558,2748,2485,"VOX",1240
6,"6088",12616,8436,8313,70,123,"VOX",8
30,"30031",492,409,401,0,8,"VOX",2
42,"42153",14,12,12,0,0,"VOX",0
10,"10070",718,546,542,1,4,"VOX",0
48,"48043",4423,3118,3108,17,10,"VOX",4
16,"16078",41429,30053,29775,235,278,"VOX",97
14,"14054",13697,10315,10109,93,206,"VOX",12
33,"33040",4549,2986,2942,35,44,"VOX",3
19,"19308",56,53,53,0,0,"VOX",0
12,"12010",259,213,208,2,5,"VOX",0
9,"9386",54,39,38,1,1,"VOX",0
19,"19002",69,58,57,0,1,"VOX",0
47,"47002",23,21,20,1,1,"VOX",0
9,"9247",24,21,21,1,0,"VOX",0
26,"26083",284,205,205,2,0,"VOX",0
9,"9326",140,112,111,0,1,"VOX",0
28,"28092",151841,110916,109954,582,962,"VOX",380
50,"50009",105,80,80,0,0,"VOX",0
47,"47046",118,92,90,1,2,"VOX",0
28,"28144",6010,4676,4644,22,32,"VOX",27
45,"45107",3257,2504,2472,15,32,"VOX",7
16,"16079",30,19,18,0,1,"VOX",0
26,"26006",1800,1419,1405,8,14,"VOX",2
29,"29050",421,306,302,3,4,"VOX",0
16,"16904",472,378,373,4,5,"VOX",1
25,"25105",125,92,92,2,0,"VOX",1
19,"19201",58,49,48,1,1,"VOX",4
6,"6092",577,415,405,3,10,"VOX",0
42,"42107",74,54,54,3,0,"VOX",0
24,"24082",858,629,614,8,15,"VOX",6
22,"22195",235,182,181,3,1,"VOX",1
15,"15049",1098,758,752,7,6,"VOX",2
19,"19003",42,35,34,1,1,"VOX",0
29,"29051",40391,25780,25419,232,361,"VOX",56
19,"19045",140,120,120,0,0,"VOX",0
47,"47191",108,79,79,0,0,"VOX",0
28,"28115",60892,49705,49510,209,195,"VOX",380
10,"10166",308,206,204,0,2,"VOX",0
24,"24017",577,426,418,1,8,"VOX",0
9,"9430",22,18,17,0,1,"VOX",0
16,"16236",910,656,651,4,5,"VOX",0
3,"3109",2850,2181,2164,8,17,"VOX",4
9,"9010",32,23,23,1,0,"VOX",0
42,"42125",70,59,59,1,0,"VOX",0
47,"47166",259,204,197,2,7,"VOX",2
19,"19089",30,22,22,0,0,"VOX",0
6,"6002",4322,2819,2762,22,57,"VOX",6
40,"40202",60,46,46,0,0,"VOX",0
15,"15088",3519,2304,2270,27,34,"VOX",0
9,"9166",97,81,81,0,0,"VOX",0
42,"42024",86,61,59,0,2,"VOX",0
47,"47140",115,102,102,1,0,"VOX",0
3,"3017",374,314,307,1,7,"VOX",0
50,"50001",100,77,77,0,0,"VOX",0
18,"18084",4257,3107,3075,26,32,"VOX",7
15,"15014",4002,2566,2524,28,42,"VOX",3
21,"21074",2649,1755,1733,13,22,"VOX",1
45,"45099",3500,2390,2361,9,29,"VOX",3
50,"50063",61,51,51,0,0,"VOX",0
22,"22236",253,200,200,0,0,"VOX",1
19,"19170",193,135,135,0,0,"VOX",0
26,"26112",236,194,190,1,4,"VOX",1
28,"28078",38,32,32,0,0,"VOX",0
30,"30006",803,691,685,2,6,"VOX",0
24,"24153",232,179,177,2,2,"VOX",0
30,"30036",14698,9859,9734,41,125,"VOX",40
45,"45144",783,620,618,3,2,"VOX",0
9,"9391",361,264,263,3,1,"VOX",0
1,"1057",240,201,200,1,1,"VOX",0
28,"28040",15811,10118,10009,56,109,"VOX",33
48,"48008",606,424,414,6,10,"VOX",0
40,"40164",177,139,138,0,1,"VOX",1
25,"25152",140,86,86,1,0,"VOX",0
6,"6051",1571,1192,1178,7,14,"VOX",1
42,"42115",61,47,47,1,0,"VOX",0
18,"18040",231,136,133,0,3,"VOX",0
40,"40123",147,114,106,0,8,"VOX",0
12,"12016",1582,1307,1297,6,10,"VOX",5
39,"39039",568,382,379,0,3,"VOX",0
16,"16240",102,78,78,0,0,"VOX",0
10,"10081",182,142,135,2,7,"VOX",0
39,"39100",860,633,629,15,4,"VOX",0
50,"50096",39,27,27,0,0,"VOX",0
26,"26114",79,66,65,1,1,"VOX",0
22,"22202",141,119,119,0,0,"VOX",0
24,"24155",471,388,384,6,4,"VOX",0
9,"9039",58,46,46,2,0,"VOX",0
45,"45047",2606,1666,1647,6,19,"VOX",13
29,"29056",1098,757,750,5,7,"VOX",0
18,"18134",5828,3840,3800,36,40,"VOX",9
42,"42028",75,51,51,0,0,"VOX",0
21,"21037",472,341,336,2,5,"VOX",0
9,"9170",205,162,162,1,0,"VOX",1
46,"46188",672,544,537,8,7,"VOX",1
1,"1059",186557,126506,125278,798,1228,"VOX",228
46,"46076",575,454,443,0,11,"VOX",0
25,"25115",824,489,487,7,2,"VOX",1
50,"50006",925,674,657,6,17,"VOX",0
50,"50195",54,40,40,0,0,"VOX",0
40,"40126",79,56,54,0,2,"VOX",1
19,"19096",91,72,69,0,3,"VOX",1
6,"6100",935,780,774,1,6,"VOX",0
12,"12053",2034,1655,1633,6,22,"VOX",1
45,"45048",358,278,275,1,3,"VOX",1
19,"19010",8,8,8,0,0,"VOX",2
19,"19134",24,15,15,0,0,"VOX",0
28,"28025",420,320,315,4,5,"VOX",2
30,"30009",12433,9586,9503,41,83,"VOX",26
18,"18136",1851,1354,1337,5,17,"VOX",0
46,"46163",1866,1504,1480,8,24,"VOX",3
42,"42165",409,271,261,10,10,"VOX",0
39,"39062",1812,1379,1366,5,13,"VOX",2
12,"12055",104,83,82,3,1,"VOX",0
47,"47061",256,212,211,2,1,"VOX",1
10,"10175",1416,1006,980,4,26,"VOX",1
25,"25247",123,66,66,1,0,"VOX",0
12,"12020",118,105,105,0,0,"VOX",2
10,"10903",826,578,569,3,9,"VOX",0
18,"18093",2750,1793,1776,7,17,"VOX",6
46,"46060",9369,7052,6993,42,59,"VOX",18
12,"12056",282,236,231,1,5,"VOX",1
47,"47010",13729,10549,10454,81,95,"VOX",26
50,"50008",5097,3457,3417,31,40,"VOX",5
9,"9174",794,559,552,4,7,"VOX",0
6,"6103",4796,3265,3220,20,45,"VOX",4
10,"10040",441,313,307,4,6,"VOX",0
10,"10177",1707,1228,1201,5,27,"VOX",1
41,"41043",639,436,427,5,9,"VOX",3
21,"21041",113337,72318,71637,748,681,"VOX",170
3,"3053",7226,5651,5584,32,67,"VOX",17
15,"15059",10362,7258,7106,91,152,"VOX",7
9,"9083",37,33,33,0,0,"VOX",0
16,"16190",5105,3945,3887,17,58,"VOX",6
18,"18140",43496,28038,27872,212,166,"VOX",44
12,"12121",1107,924,893,4,31,"VOX",0
25,"25161",360,219,218,2,1,"VOX",0
9,"9101",76,56,55,1,1,"VOX",1
42,"42089",54,44,44,0,0,"VOX",0
41,"41067",7093,4930,4866,37,64,"VOX",8
12,"12057",606,487,474,5,13,"VOX",1
9,"9403",94,78,78,1,0,"VOX",0
30,"30042",1922,1504,1491,7,13,"VOX",6
25,"25034",2326,1361,1340,15,21,"VOX",1
40,"40045",109,85,85,2,0,"VOX",0
33,"33052",721,485,482,3,3,"VOX",0
23,"23058",8678,6532,6461,37,71,"VOX",6
22,"22164",35,28,28,0,0,"VOX",0
23,"23018",2325,1668,1653,10,15,"VOX",0
46,"46251",2462,1997,1956,6,41,"VOX",1
46,"46088",166,125,125,4,0,"VOX",0
19,"19139",29,19,18,0,1,"VOX",0
46,"46192",761,576,570,5,6,"VOX",0
45,"45053",8005,6211,6140,42,71,"VOX",13
25,"25035",398,249,247,2,2,"VOX",2
40,"40173",138,99,93,1,6,"VOX",0
48,"48085",10338,7190,7153,39,37,"VOX",6
15,"15061",5571,3746,3691,27,55,"VOX",0
21,"21004",1631,1045,1028,13,17,"VOX",4
33,"33023",3321,2299,2265,31,34,"VOX",1
35,"35024",13735,8545,8439,77,106,"VOX",16
24,"24194",290,212,212,3,0,"VOX",0
50,"50200",511,410,403,2,7,"VOX",0
6,"6093",4447,3254,3204,15,50,"VOX",5
15,"15038",2227,1463,1443,25,20,"VOX",1
50,"50041",12,9,9,0,0,"VOX",0
12,"12060",446,368,364,4,4,"VOX",0
22,"22208",188,150,145,0,5,"VOX",0
15,"15062",5887,3747,3701,36,46,"VOX",12
26,"26019",355,274,271,1,3,"VOX",1
12,"12093",178,137,136,2,1,"VOX",0
4,"4007",734,524,522,1,2,"VOX",0
29,"29087",376,270,266,1,4,"VOX",0
46,"46246",1058,835,823,5,12,"VOX",7
29,"29064",503,348,339,8,9,"VOX",0
46,"46194",15567,11156,11044,86,112,"VOX",26
6,"6110",148,108,108,1,0,"VOX",0
19,"19251",43,29,28,0,1,"VOX",0
45,"45077",556,428,427,1,1,"VOX",1
1,"1030",156,129,129,3,0,"VOX",0
22,"22124",201,144,143,1,1,"VOX",2
16,"16253",337,264,263,2,1,"VOX",2
19,"19252",69,60,60,0,0,"VOX",0
9,"9179",41,32,32,1,0,"VOX",0
16,"16008",89,69,69,0,0,"VOX",0
9,"9315",378,245,243,1,2,"VOX",0
23,"23902",2320,1867,1847,4,20,"VOX",0
25,"25038",1545,995,986,17,9,"VOX",0
21,"21048",305,214,210,4,4,"VOX",1
10,"10003",569,414,408,1,6,"VOX",1
6,"6097",2362,1750,1727,7,23,"VOX",0
9,"9180",142,107,102,1,5,"VOX",0
22,"22213",3003,2169,2131,19,38,"VOX",1
47,"47067",174,127,126,0,1,"VOX",1
48,"48089",3306,2341,2329,20,12,"VOX",3
18,"18101",9265,6618,6560,59,58,"VOX",22
9,"9446",12,7,7,0,0,"VOX",0
12,"12063",41,29,29,1,0,"VOX",0
10,"10095",338,259,251,1,8,"VOX",0
45,"45023",2177,1571,1556,6,15,"VOX",6
30,"30017",11605,8541,8451,46,90,"VOX",11
21,"21050",12427,8036,7969,80,67,"VOX",14
16,"16010",152,115,112,0,3,"VOX",0
26,"26163",136,118,118,0,0,"VOX",1
35,"35001",4584,3282,3222,26,60,"VOX",3
25,"25040",10546,6367,6300,61,67,"VOX",3
50,"50045",1243,926,925,6,1,"VOX",4
15,"15067",8029,5789,5732,37,57,"VOX",5
50,"50235",2339,1664,1648,11,16,"VOX",4
28,"28004",6234,4202,4167,16,35,"VOX",31
16,"16259",29,22,21,0,1,"VOX",0
3,"3123",7476,5557,5501,29,56,"VOX",5
4,"4075",5196,3735,3706,23,29,"VOX",4
10,"10097",101,75,74,0,1,"VOX",0
11,"11007",17964,10038,9856,197,182,"VOX",12
15,"15055",4572,3070,3013,27,57,"VOX",3
9,"9016",85,60,59,3,1,"VOX",0
3,"3030",524,448,440,5,8,"VOX",1
9,"9055",52,42,41,1,1,"VOX",0
14,"14042",18891,14051,13848,190,203,"VOX",20
22,"22215",128,96,96,1,0,"VOX",0
25,"25903",236,161,161,3,0,"VOX",0
50,"50175",1002,695,688,5,7,"VOX",0
39,"39082",1653,1173,1157,11,16,"VOX",1
50,"50078",235,177,173,0,4,"VOX",0
3,"3031",41499,27031,26813,128,218,"VOX",58
19,"19023",124,100,98,2,2,"VOX",0
35,"35003",5211,2949,2908,13,41,"VOX",5
10,"10099",583,378,374,2,4,"VOX",0
47,"47069",124,105,104,1,1,"VOX",0
22,"22174",478,379,378,2,1,"VOX",1
42,"42030",94,78,78,1,0,"VOX",0
40,"40014",58,46,45,0,1,"VOX",0
28,"28006",78966,59065,58698,267,367,"VOX",274
42,"42087",49,43,42,0,1,"VOX",0
9,"9273",52,40,39,2,1,"VOX",0
24,"24067",623,388,384,0,4,"VOX",1
9,"9450",28,22,21,0,1,"VOX",0
42,"42044",54,42,39,0,3,"VOX",0
10,"10101",185,145,141,1,4,"VOX",0
25,"25172",1797,1170,1146,10,24,"VOX",0
39,"39052",18236,13537,13380,110,157,"VOX",46
6,"6118",192,145,144,1,1,"VOX",0
16,"16204",261,199,199,1,0,"VOX",0
40,"40015",28,26,26,1,0,"VOX",0
21,"21055",6975,5293,5241,48,52,"VOX",0
48,"48003",14339,9918,9838,53,80,"VOX",7
9,"9325",190,130,129,2,1,"VOX",0
12,"12033",1919,1437,1404,19,33,"VOX",1
25,"25173",1705,1156,1143,14,13,"VOX",1
22,"22218",43,33,33,0,0,"VOX",0
42,"42008",57,43,43,0,0,"VOX",0
42,"42088",67,47,47,1,0,"VOX",0
9,"9451",238,191,190,0,1,"VOX",0
4,"4079",51383,33777,33586,257,191,"VOX",51
40,"40101",877,635,628,8,7,"VOX",3
10,"10087",1687,1218,1212,6,6,"VOX",2
47,"47109",179,138,138,2,0,"VOX",2
19,"19248",78,63,63,0,0,"VOX",0
6,"6121",3355,2279,2248,8,31,"VOX",2
40,"40185",863,646,642,3,4,"VOX",1
47,"47071",410,324,321,4,3,"VOX",3
47,"47073",122,103,101,1,2,"VOX",0
42,"42184",57,43,43,0,0,"VOX",2
24,"24170",1908,1365,1345,8,20,"VOX",0
16,"16109",44,38,38,1,0,"VOX",0
35,"35006",30457,21398,21118,162,280,"VOX",41
39,"39024",1879,1390,1372,2,18,"VOX",0
4,"4080",209,162,162,3,0,"VOX",1
48,"48004",335,222,222,0,0,"VOX",0
9,"9455",45,33,33,0,0,"VOX",1
28,"28009",14086,10611,10545,57,66,"VOX",49
21,"21057",1041,661,657,12,4,"VOX",0
26,"26132",112,82,82,0,0,"VOX",0
6,"6122",6634,4427,4321,26,106,"VOX",5
47,"47156",162,136,133,0,3,"VOX",0
24,"24070",4124,3024,2981,20,43,"VOX",2
46,"46261",1725,1356,1337,5,19,"VOX",5
40,"40060",82,61,61,0,0,"VOX",0
29,"29097",4108,2871,2821,37,50,"VOX",3
26,"26099",1264,1003,991,9,12,"VOX",1
46,"46037",1122,936,923,4,13,"VOX",2
16,"16035",261,203,198,4,5,"VOX",0
45,"45164",182,162,160,1,2,"VOX",0
9,"9328",76,56,56,0,0,"VOX",1
11,"11014",16858,10366,10245,153,121,"VOX",16
19,"19263",26,15,15,1,0,"VOX",0
50,"50242",93,75,75,3,0,"VOX",0
46,"46203",3606,2873,2844,9,29,"VOX",2
46,"46125",847,689,684,5,5,"VOX",0
19,"19155",66,56,56,0,0,"VOX",0
10,"10107",1031,801,792,3,9,"VOX",1
22,"22223",75,58,58,0,0,"VOX",0
47,"47130",96,72,72,0,0,"VOX",0
1,"1002",8124,5722,5654,31,68,"VOX",24
9,"9314",94,73,70,0,3,"VOX",2
29,"29099",950,693,685,4,8,"VOX",0
47,"47184",573,453,451,1,2,"VOX",1
24,"24210",503,358,356,3,2,"VOX",0
9,"9330",1507,1108,1092,10,16,"VOX",1
9,"9062",51,40,39,0,1,"VOX",0
23,"23074",3021,2317,2295,11,22,"VOX",1
26,"26136",107,85,85,0,0,"VOX",0
46,"46126",5556,4449,4405,24,44,"VOX",9
22,"22019",180,151,150,2,1,"VOX",1
9,"9063",209,168,167,2,1,"VOX",1
40,"40191",215,181,179,1,2,"VOX",0
12,"12105",848,644,638,2,6,"VOX",1
9,"9012",89,64,63,0,1,"VOX",0
19,"19076",27,19,19,0,0,"VOX",0
10,"10063",173,139,137,0,2,"VOX",0
10,"10064",1476,1092,1072,7,20,"VOX",0
28,"28041",4524,3508,3490,20,18,"VOX",14
14,"14050",2391,1822,1787,14,35,"VOX",7
15,"15041",9568,6828,6710,75,118,"VOX",11
46,"46048",3452,2749,2713,14,36,"VOX",5
18,"18116",2850,2059,2025,20,34,"VOX",3
9,"9463",264,195,195,7,0,"VOX",0
40,"40901",384,309,307,4,2,"VOX",1
9,"9197",144,111,109,1,2,"VOX",1
9,"9064",324,271,267,1,4,"VOX",1
45,"45068",160,126,126,0,0,"VOX",1
48,"48009",783,586,575,1,11,"VOX",0
45,"45202",3894,2776,2744,14,32,"VOX",8
28,"28070",117,91,91,0,0,"VOX",0
22,"22058",194,164,162,1,2,"VOX",0
4,"4085",387,304,301,2,3,"VOX",0
42,"42054",19,16,16,0,0,"VOX",0
46,"46206",571,453,445,2,8,"VOX",3
46,"46049",281,232,224,0,8,"VOX",1
19,"19039",61,54,54,1,0,"VOX",0
25,"25183",499,326,323,7,3,"VOX",2
40,"40902",123,99,96,1,3,"VOX",0
25,"25082",285,186,178,5,8,"VOX",0
15,"15044",1286,937,927,8,10,"VOX",1
10,"10204",429,331,329,6,2,"VOX",1
28,"28071",60,55,53,1,2,"VOX",0
50,"50025",4562,3158,3124,31,34,"VOX",15
42,"42017",140,113,112,0,1,"VOX",0
21,"21025",4026,2433,2396,30,37,"VOX",3
22,"22099",483,379,377,4,2,"VOX",0
45,"45104",428,324,323,1,1,"VOX",0
28,"28015",18736,14221,14127,68,94,"VOX",58
16,"16121",258,202,202,3,0,"VOX",1
22,"22102",179,141,138,2,3,"VOX",1
18,"18029",1833,1196,1190,12,6,"VOX",1
23,"23080",1762,1332,1322,4,10,"VOX",0
15,"15082",15180,10841,10726,102,115,"VOX",17
15,"15045",3770,2184,2157,14,27,"VOX",2
10,"10053",287,215,210,1,5,"VOX",0
50,"50027",225,178,177,2,1,"VOX",1
9,"9289",1451,1014,1000,5,14,"VOX",1
50,"50089",8225,6074,6043,43,31,"VOX",19
16,"16073",185,164,164,1,0,"VOX",0
46,"46207",6676,5106,5040,41,66,"VOX",9
24,"24178",70,59,58,0,1,"VOX",0
42,"42057",164,104,104,2,0,"VOX",0
42,"42195",101,62,62,0,0,"VOX",0
19,"19269",102,81,80,0,1,"VOX",0
35,"35013",6625,4896,4781,41,115,"VOX",6
25,"25189",2110,1198,1186,10,12,"VOX",2
4,"4058",354,261,259,1,2,"VOX",0
14,"14026",2067,1424,1405,4,19,"VOX",5
40,"40113",425,323,316,0,7,"VOX",1
25,"25232",1397,874,871,12,3,"VOX",0
9,"9339",128,110,110,0,0,"VOX",0
39,"39064",1345,1031,1015,7,16,"VOX",2
16,"16123",82,61,61,3,0,"VOX",1
19,"19235",93,71,71,1,0,"VOX",0
45,"45172",689,530,522,2,8,"VOX",0
26,"26038",89,68,67,0,1,"VOX",1
46,"46104",1940,1504,1487,7,17,"VOX",1
10,"10164",737,484,475,3,9,"VOX",0
45,"45161",13688,9007,8902,32,105,"VOX",40
10,"10088",204,131,128,1,3,"VOX",0
50,"50113",618,489,484,2,5,"VOX",0
4,"4024",3074,2347,2327,20,20,"VOX",3
18,"18124",381,277,277,2,0,"VOX",1
18,"18078",732,570,566,2,4,"VOX",1
50,"50250",52,44,44,0,0,"VOX",0
28,"28083",8939,6396,6348,38,48,"VOX",24
19,"19044",304,245,244,0,1,"VOX",0
24,"24081",140,98,92,0,6,"VOX",0
46,"46131",49431,36570,36227,231,343,"VOX",95
6,"6137",972,744,737,1,7,"VOX",1
41,"41002",1473,1038,1014,9,24,"VOX",0
24,"24181",1493,1054,1045,5,9,"VOX",9
25,"25021",2607,1490,1481,20,9,"VOX",1
24,"24049",1483,1054,1048,6,6,"VOX",2
22,"22233",82,57,57,3,0,"VOX",0
25,"25060",72,46,44,1,2,"VOX",0
47,"47164",378,313,311,1,2,"VOX",1
40,"40201",49,42,42,0,0,"VOX",0
50,"50030",215,141,140,1,1,"VOX",0
46,"46236",972,818,809,2,9,"VOX",0
47,"47083",80,59,54,1,5,"VOX",0
25,"25022",104,79,79,0,0,"VOX",0
42,"42023",63,51,51,0,0,"VOX",0
33,"33073",8554,4945,4884,41,61,"VOX",5
3,"3046",1599,1153,1143,8,10,"VOX",0
28,"28085",3922,2972,2954,14,18,"VOX",10
9,"9443",179,128,124,0,4,"VOX",0
10,"10212",1684,1233,1203,7,30,"VOX",6
9,"9209",4473,3223,3192,20,31,"VOX",4
18,"18127",16635,11440,11332,91,108,"VOX",25
16,"16034",180,146,144,2,2,"VOX",0
24,"24083",1042,727,715,6,12,"VOX",2
22,"22235",98,76,76,1,0,"VOX",0
47,"47004",1181,939,930,7,9,"VOX",1
48,"48016",5271,3694,3674,24,20,"VOX",1
46,"46055",1262,1025,1012,5,13,"VOX",3
14,"14057",6136,4713,4631,47,82,"VOX",3
16,"16237",110,87,87,0,0,"VOX",0
24,"24084",163,116,116,0,0,"VOX",0
25,"25194",423,246,244,6,2,"VOX",0
6,"6049",1015,725,707,3,18,"VOX",0
24,"24018",174,143,141,0,2,"VOX",0
16,"16036",126,109,106,0,3,"VOX",0
39,"39068",646,450,445,2,5,"VOX",8
47,"47032",152,117,116,1,1,"VOX",0
19,"19047",64,55,55,0,0,"VOX",0
6,"6141",1719,1201,1189,8,12,"VOX",0
50,"50222",1622,1091,1071,7,20,"VOX",1
28,"28021",554,370,364,3,6,"VOX",0
9,"9482",33,28,28,0,0,"VOX",0
26,"26149",57,47,46,0,1,"VOX",0
40,"40078",161,125,124,2,1,"VOX",1
35,"35018",12552,7609,7547,54,62,"VOX",11
12,"12039",833,717,710,4,7,"VOX",0
26,"26011",7321,5133,5083,38,50,"VOX",3
48,"48079",427,305,304,2,1,"VOX",0
12,"12116",58,49,49,0,0,"VOX",0
30,"30037",18793,13150,13003,47,147,"VOX",28
50,"50192",236,180,180,2,0,"VOX",0
24,"24118",126,88,88,1,0,"VOX",0
19,"19171",4961,3670,3628,27,42,"VOX",13
6,"6006",4572,3088,3049,26,39,"VOX",2
23,"23091",729,555,553,5,2,"VOX",0
48,"48912",2308,1707,1679,14,28,"VOX",7
3,"3080",1300,1035,1025,3,10,"VOX",5
16,"16087",208,179,177,5,2,"VOX",0
23,"23051",2758,2171,2144,9,27,"VOX",2
24,"24185",474,357,350,3,7,"VOX",0
26,"26045",12,12,12,0,0,"VOX",0
9,"9077",34,27,27,0,0,"VOX",0
48,"48019",3553,2406,2397,18,9,"VOX",0
25,"25200",329,213,213,0,0,"VOX",0
29,"29079",2416,1788,1764,10,24,"VOX",0
10,"10035",1920,1343,1315,5,28,"VOX",0
3,"3904",1396,1033,1026,4,7,"VOX",3
46,"46240",210,164,161,1,3,"VOX",0
6,"6144",556,431,425,0,6,"VOX",0
25,"25068",556,346,341,11,5,"VOX",1
6,"6008",632,525,519,2,6,"VOX",2
46,"46058",1772,1398,1373,15,25,"VOX",2
1,"1060",197,160,157,0,3,"VOX",0
14,"14061",744,595,582,1,13,"VOX",0
22,"22160",209,168,168,6,0,"VOX",0
46,"46189",467,393,390,2,3,"VOX",0
6,"6101",463,381,378,2,3,"VOX",1
6,"6009",204,153,153,0,0,"VOX",0
28,"28024",151,125,124,1,1,"VOX",1
41,"41075",10212,6419,6295,49,124,"VOX",15
15,"15093",4220,2533,2498,30,35,"VOX",1
9,"9257",93,81,80,4,1,"VOX",1
26,"26117",2152,1625,1605,10,20,"VOX",0
23,"23054",382,282,281,1,1,"VOX",0
40,"40127",32,25,25,0,0,"VOX",0
42,"42071",171,115,115,3,0,"VOX",0
26,"26152",33,28,28,1,0,"VOX",1
16,"16137",54,32,31,1,1,"VOX",4
24,"24189",5865,3933,3885,31,48,"VOX",7
48,"48915",362,227,226,0,1,"VOX",0
48,"48082",37605,25134,24938,176,196,"VOX",24
9,"9217",351,251,249,6,2,"VOX",0
45,"45183",2220,1444,1428,3,16,"VOX",6
42,"42073",75,58,58,0,0,"VOX",0
40,"40083",77,59,59,0,0,"VOX",0
47,"47062",163,130,130,0,0,"VOX",0
26,"26153",13,12,11,0,1,"VOX",0
18,"18045",1126,756,742,4,14,"VOX",0
50,"50069",73,53,53,1,0,"VOX",1
24,"24091",645,454,451,1,3,"VOX",1
19,"19213",70,62,61,2,1,"VOX",0
19,"19136",18,14,14,0,0,"VOX",0
46,"46034",1758,1390,1379,4,11,"VOX",2
18,"18138",2486,1620,1606,13,14,"VOX",0
40,"40084",62,55,52,0,3,"VOX",0
19,"19098",19,17,17,0,0,"VOX",0
25,"25204",1231,731,724,5,7,"VOX",2
45,"45084",2257,1679,1656,13,23,"VOX",1
22,"22246",76,50,50,0,0,"VOX",0
48,"48053",895,666,662,6,4,"VOX",0
46,"46250",578719,442973,440154,2541,2819,"VOX",1459
6,"6150",802,602,596,4,6,"VOX",0
41,"41056",3687,2841,2812,30,29,"VOX",2
25,"25233",275,178,178,4,0,"VOX",0
19,"19285",24,21,21,1,0,"VOX",0
22,"22116",1430,1004,994,5,10,"VOX",1
24,"24025",297,228,227,0,1,"VOX",0
6,"6014",6682,4479,4409,14,70,"VOX",5
50,"50071",132,92,92,0,0,"VOX",0
14,"14064",320,242,236,2,6,"VOX",0
25,"25206",260,150,150,5,0,"VOX",0
50,"50168",28,27,27,0,0,"VOX",0
29,"29084",27359,17843,17627,176,216,"VOX",35
6,"6107",1581,999,995,8,4,"VOX",0
23,"23098",867,713,701,1,12,"VOX",0
11,"11034",2334,1549,1517,14,32,"VOX",1
26,"26018",10477,8053,7956,65,97,"VOX",6
47,"47091",84,71,71,2,0,"VOX",0
46,"46062",4631,3511,3474,27,37,"VOX",3
6,"6152",1319,945,932,4,13,"VOX",0
19,"19287",148,109,108,0,1,"VOX",0
6,"6153",20377,14329,14163,103,166,"VOX",18
41,"41080",1274,910,892,6,18,"VOX",1
9,"9086",666,462,459,2,3,"VOX",1
3,"3056",8676,6638,6541,34,97,"VOX",11
45,"45086",496,351,343,2,8,"VOX",1
16,"16193",66,49,48,0,1,"VOX",0
30,"30014",1567,1174,1160,8,14,"VOX",0
21,"21045",249,180,178,3,2,"VOX",0
26,"26146",94,73,72,0,1,"VOX",0
48,"48026",1140,830,823,5,7,"VOX",0
46,"46141",439,351,342,2,9,"VOX",0
9,"9907",1420,1058,1041,12,17,"VOX",4
50,"50262",1170,896,887,15,9,"VOX",2
22,"22007",792,581,581,8,0,"VOX",0
23,"23101",378,276,271,1,5,"VOX",0
42,"42216",25,23,23,0,0,"VOX",0
46,"46253",115,82,82,0,0,"VOX",1
50,"50232",175,110,110,3,0,"VOX",0
39,"39047",1962,1385,1371,10,14,"VOX",3
24,"24094",1385,983,968,11,15,"VOX",2
26,"26160",709,552,549,2,3,"VOX",0
28,"28058",139342,100637,99753,634,884,"VOX",299
22,"22249",116,95,95,4,0,"VOX",1
19,"19059",77,61,58,1,3,"VOX",0
22,"22080",280,197,194,6,3,"VOX",0
19,"19105",2334,1753,1739,8,14,"VOX",9
24,"24095",320,234,232,0,2,"VOX",0
48,"48027",22150,15089,14982,78,107,"VOX",11
47,"47175",6564,4781,4728,39,53,"VOX",14
19,"19060",146,119,118,1,1,"VOX",0
12,"12061",373,285,282,3,3,"VOX",0
22,"22008",173,137,133,3,4,"VOX",0
16,"16196",633,508,503,2,5,"VOX",0
10,"10002",364,272,270,0,2,"VOX",0
25,"25078",998,628,627,7,1,"VOX",2
33,"33055",1514,1109,1092,5,17,"VOX",3
6,"6111",500,337,337,1,0,"VOX",0
28,"28096",18354,13310,13205,68,105,"VOX",54
24,"24096",117,80,79,1,1,"VOX",0
18,"18147",3729,2335,2304,16,31,"VOX",7
47,"47094",133,115,114,1,1,"VOX",0
40,"40093",77,65,65,1,0,"VOX",0
50,"50075",80,62,61,1,1,"VOX",0
50,"50172",193,132,129,1,3,"VOX",1
11,"11039",10018,6186,6109,103,77,"VOX",3
41,"41083",1147,864,856,4,8,"VOX",0
4,"4074",2840,2000,1979,23,21,"VOX",6
16,"16198",1348,981,971,10,10,"VOX",2
46,"46248",4897,3596,3544,18,52,"VOX",3
28,"28060",1510,1134,1117,1,17,"VOX",2
4,"4902",45437,28936,28699,214,237,"VOX",44
25,"25212",233,154,153,6,1,"VOX",0
28,"28032",4762,3428,3401,19,27,"VOX",16
10,"10142",832,627,621,5,6,"VOX",1
47,"47016",69,56,55,0,1,"VOX",0
9,"9363",965,737,734,2,3,"VOX",3
3,"3060",109,91,91,0,0,"VOX",0
10,"10005",540,377,362,3,15,"VOX",0
46,"46067",1753,1418,1393,1,25,"VOX",1
40,"40095",477,377,369,0,8,"VOX",1
22,"22127",505,374,371,3,3,"VOX",1
47,"47068",34,26,26,0,0,"VOX",0
23,"23064",1655,1363,1353,1,10,"VOX",1
16,"16011",27,22,22,1,0,"VOX",0
4,"4903",4320,2858,2825,19,33,"VOX",2
19,"19294",29,27,27,0,0,"VOX",0
50,"50266",122,90,90,0,0,"VOX",0
40,"40181",4233,3260,3219,23,41,"VOX",6
24,"24066",494,368,366,4,2,"VOX",0
26,"26128",105,81,81,1,0,"VOX",0
10,"10052",182,130,129,0,1,"VOX",0
50,"50077",221,168,167,1,1,"VOX",0
47,"47096",140,110,110,0,0,"VOX",0
19,"19065",127,104,104,3,0,"VOX",0
18,"18150",6763,4733,4678,21,55,"VOX",6
10,"10145",127,97,95,0,2,"VOX",1
29,"29003",983,754,743,1,11,"VOX",1
33,"33029",350,181,174,2,7,"VOX",0
50,"50237",101,74,73,1,1,"VOX",0
19,"19187",48,43,43,0,0,"VOX",0
45,"45126",260,176,175,3,1,"VOX",0
40,"40056",34,28,28,1,0,"VOX",0
46,"46146",1654,1304,1278,7,26,"VOX",7
10,"10008",1319,1019,1008,6,11,"VOX",3
16,"16013",27,24,24,0,0,"VOX",0
45,"45127",696,514,511,3,3,"VOX",1
29,"29004",312,236,233,2,3,"VOX",0
26,"26059",1125,828,812,5,16,"VOX",0
4,"4013",141378,94872,94288,741,584,"VOX",180
50,"50268",44,37,37,0,0,"VOX",0
50,"50207",106,93,93,1,0,"VOX",0
9,"9019",150,92,90,0,2,"VOX",0
26,"26095",100,83,82,0,1,"VOX",0
30,"30021",9099,6095,6045,20,50,"VOX",19
42,"42045",301,206,197,2,9,"VOX",0
46,"46148",1513,1160,1146,7,14,"VOX",4
24,"24003",648,460,453,7,7,"VOX",1
19,"19297",32,24,24,1,0,"VOX",0
18,"18904",775,565,558,1,7,"VOX",1
16,"16060",744,565,554,7,11,"VOX",1
3,"3034",1376,1067,1052,5,15,"VOX",1
50,"50259",88,67,66,0,1,"VOX",0
9,"9355",98,75,75,0,0,"VOX",0
39,"39054",4493,3376,3334,33,42,"VOX",4
4,"4014",144,117,114,1,3,"VOX",0
47,"47099",150,135,135,1,0,"VOX",0
9,"9231",69,38,38,1,0,"VOX",0
25,"25088",96,73,72,0,1,"VOX",0
19,"19071",7840,5537,5489,45,48,"VOX",34
10,"10011",560,458,448,5,10,"VOX",0
40,"40228",510,390,382,1,8,"VOX",0
24,"24205",945,694,685,11,9,"VOX",2
50,"50178",293,190,187,0,3,"VOX",0
9,"9102",36,30,30,0,0,"VOX",0
35,"35032",3412,2473,2425,17,48,"VOX",4
41,"41090",3523,2576,2512,13,64,"VOX",7
26,"26169",64,60,60,0,0,"VOX",0
22,"22131",82,63,63,0,0,"VOX",0
25,"25221",122,81,81,0,0,"VOX",0
42,"42090",91,69,67,1,2,"VOX",0
9,"9235",156,132,131,3,1,"VOX",0
46,"46071",464,383,377,0,6,"VOX",0
22,"22133",115,81,80,1,1,"VOX",0
9,"9060",145,114,113,2,1,"VOX",1
48,"48035",413,293,292,1,1,"VOX",0
12,"12102",522,423,418,1,5,"VOX",0
24,"24207",294,241,238,3,3,"VOX",1
19,"19073",23,19,19,0,0,"VOX",0
42,"42215",773,531,520,7,11,"VOX",4
15,"15076",2611,1758,1739,17,19,"VOX",0
9,"9194",2020,1472,1459,9,13,"VOX",0
10,"10060",967,648,640,2,8,"VOX",2
22,"22135",189,128,127,0,1,"VOX",0
42,"42050",31,18,18,0,0,"VOX",0
12,"12103",91,69,67,0,2,"VOX",0
12,"12003",976,746,736,6,10,"VOX",0
46,"46072",3611,2871,2821,23,50,"VOX",0
9,"9104",53,42,42,0,0,"VOX",0
26,"26064",2275,1659,1638,17,21,"VOX",1
22,"22018",327,245,244,3,1,"VOX",0
25,"25094",137,98,95,1,3,"VOX",0
50,"50022",530,397,390,7,7,"VOX",0
18,"18024",855,665,654,7,11,"VOX",0
33,"33004",66857,46390,45960,426,430,"VOX",103
50,"50243",331,250,246,0,4,"VOX",3
26,"26172",30,23,23,0,0,"VOX",0
35,"35034",7873,3975,3943,27,32,"VOX",9
9,"9238",921,573,561,4,12,"VOX",1
15,"15002",23083,16073,15889,159,184,"VOX",44
19,"19193",20,19,19,1,0,"VOX",0
42,"42189",60,46,45,0,1,"VOX",0
24,"24106",248,167,166,1,1,"VOX",0
46,"46152",96,68,68,0,0,"VOX",0
50,"50212",40,36,36,0,0,"VOX",1
26,"26173",6,6,6,1,0,"VOX",0
50,"50023",224,175,175,0,0,"VOX",0
9,"9332",140,106,106,2,0,"VOX",0
19,"19037",141,115,114,1,1,"VOX",4
40,"40192",159,117,117,2,0,"VOX",0
26,"26066",251,201,194,1,7,"VOX",0
50,"50055",3611,2445,2407,22,38,"VOX",2
16,"16023",469,335,335,2,0,"VOX",5
47,"47103",267,197,192,5,5,"VOX",0
16,"16024",129,98,97,0,1,"VOX",0
46,"46074",2696,2069,2038,14,31,"VOX",5
50,"50085",167,126,126,1,0,"VOX",0
24,"24042",63,56,56,1,0,"VOX",0
33,"33006",1540,1010,1003,5,7,"VOX",1
50,"50183",331,246,246,3,0,"VOX",2
35,"35010",3558,2341,2301,28,40,"VOX",3
24,"24175",1832,1314,1297,14,17,"VOX",2
24,"24212",1032,773,760,4,13,"VOX",0
19,"19195",40,32,32,1,0,"VOX",0
18,"18027",2570,1711,1700,13,11,"VOX",1
29,"29012",9755,6689,6599,71,90,"VOX",5
10,"10158",330,269,267,0,2,"VOX",0
28,"28042",1173,890,883,3,7,"VOX",5
12,"12007",746,651,636,3,15,"VOX",0
22,"22909",315,226,225,4,1,"VOX",0
18,"18028",928,765,758,2,7,"VOX",1
26,"26068",80,61,61,1,0,"VOX",0
15,"15006",5321,3341,3283,49,58,"VOX",6
12,"12107",355,303,299,4,4,"VOX",2
19,"19196",105,84,81,0,3,"VOX",0
6,"6131",1076,843,837,2,6,"VOX",2
50,"50276",125,104,103,2,1,"VOX",1
22,"22228",514,364,360,5,4,"VOX",2
16,"16166",243,176,174,1,2,"VOX",0
50,"50277",50,42,41,0,1,"VOX",0
40,"40903",86,67,67,0,0,"VOX",0
50,"50247",823,588,581,3,7,"VOX",2
9,"9382",33,28,28,0,0,"VOX",0
22,"22142",97,75,74,1,1,"VOX",0
45,"45071",1835,1426,1408,5,18,"VOX",1
50,"50058",66,39,39,0,0,"VOX",0
47,"47162",74,60,60,0,0,"VOX",0
48,"48011",9673,6468,6423,45,45,"VOX",6
19,"19121",246,199,194,1,5,"VOX",2
25,"25057",208,141,140,0,1,"VOX",0
25,"25056",235,143,143,2,0,"VOX",0
24,"24110",1247,899,892,6,7,"VOX",2
24,"24012",290,207,205,1,2,"VOX",0
29,"29904",421,338,335,3,3,"VOX",0
42,"42103",575,450,445,1,5,"VOX",0
6,"6042",1011,698,687,2,11,"VOX",1
47,"47106",50,39,39,0,0,"VOX",0
10,"10024",695,525,520,3,5,"VOX",1
39,"39063",967,697,690,9,7,"VOX",2
50,"50059",769,549,544,8,5,"VOX",1
19,"19122",96,68,68,1,0,"VOX",0
26,"26107",94,77,77,2,0,"VOX",0
23,"23003",8688,6326,6257,52,69,"VOX",6
47,"47189",152,119,118,0,1,"VOX",0
12,"12110",234,176,173,0,3,"VOX",0
46,"46130",901,687,683,3,4,"VOX",0
22,"22144",243,188,187,1,1,"VOX",0
25,"25145",86,65,64,1,1,"VOX",0
42,"42059",21,15,14,0,1,"VOX",0
40,"40072",211,162,159,1,3,"VOX",1
22,"22902",221,159,156,0,3,"VOX",0
10,"10149",421,283,280,1,3,"VOX",1
24,"24015",2265,1649,1635,18,14,"VOX",5
40,"40158",17,12,12,0,0,"VOX",0
28,"28046",4460,3447,3422,16,25,"VOX",13
19,"19043",84,72,72,0,0,"VOX",0
16,"16031",46,28,28,1,0,"VOX",0
29,"29017",6553,4744,4668,33,76,"VOX",2
19,"19200",71,52,52,1,0,"VOX",0
46,"46079",318,241,232,1,9,"VOX",0
24,"24180",1134,812,800,9,12,"VOX",3
12,"12080",1932,1598,1570,10,28,"VOX",6
50,"50189",705,527,519,13,8,"VOX",3
4,"4026",66,54,51,0,3,"VOX",0
33,"33072",1566,1008,994,11,14,"VOX",2
24,"24016",466,270,269,1,1,"VOX",0
12,"12012",2685,2234,2202,13,32,"VOX",2
15,"15012",3627,2659,2602,28,57,"VOX",1
22,"22150",472,331,330,1,1,"VOX",0
45,"45041",3752,2633,2597,12,36,"VOX",3
10,"10120",171,121,117,1,4,"VOX",0
6,"6046",1255,1004,995,8,9,"VOX",0
42,"42061",291,214,213,3,1,"VOX",0
39,"39066",872,667,661,4,6,"VOX",0
26,"26181",14,14,14,0,0,"VOX",0
18,"18036",3851,2870,2841,17,29,"VOX",10
28,"28047",40914,30019,29788,169,231,"VOX",127
47,"47219",41,36,34,0,2,"VOX",1
10,"10167",314,239,239,1,0,"VOX",0
30,"30004",1137,870,862,3,8,"VOX",5
48,"48046",12611,8836,8794,39,42,"VOX",9
39,"39067",790,513,505,1,8,"VOX",1
1,"1014",371,280,272,4,8,"VOX",1
25,"25062",750,486,482,1,4,"VOX",0
12,"12114",198,144,144,1,0,"VOX",0
48,"48047",159,111,111,0,0,"VOX",0
30,"30005",29526,20713,20526,121,187,"VOX",93
25,"25239",590,258,256,5,2,"VOX",0
46,"46081",10134,7771,7702,41,69,"VOX",23
42,"42110",59,45,45,2,0,"VOX",0
47,"47112",2587,2015,1988,7,27,"VOX",7
11,"11026",4782,3451,3378,26,73,"VOX",5
28,"28175",863,670,668,5,2,"VOX",3
26,"26042",834,635,625,5,10,"VOX",0
35,"35017",25676,15038,14716,94,322,"VOX",33
9,"9167",58,41,41,1,0,"VOX",0
41,"41093",18554,13978,13874,99,104,"VOX",42
22,"22155",76,51,51,0,0,"VOX",0
24,"24221",795,543,538,7,5,"VOX",0
28,"28118",57,46,45,0,1,"VOX",1
12,"12115",219,179,177,0,2,"VOX",0
24,"24019",354,272,267,3,5,"VOX",1
28,"28050",4076,2860,2839,21,21,"VOX",15
50,"50095",12323,8628,8550,110,78,"VOX",11
39,"39008",13877,10258,10153,96,105,"VOX",14
19,"19204",148,120,120,0,0,"VOX",1
47,"47194",298,239,237,2,2,"VOX",1
10,"10080",366,257,255,1,2,"VOX",0
18,"18039",3490,2406,2378,33,28,"VOX",2
45,"45112",1922,1247,1211,6,36,"VOX",2
1,"1018",1386,939,930,3,9,"VOX",0
24,"24222",14256,9996,9884,101,112,"VOX",18
29,"29022",179,137,136,0,1,"VOX",1
46,"46161",1483,1188,1173,7,15,"VOX",6
47,"47222",83,64,64,1,0,"VOX",0
47,"47033",196,154,154,1,0,"VOX",0
4,"4095",714,471,468,5,3,"VOX",1
9,"9485",55,43,42,0,1,"VOX",0
19,"19092",409,306,300,1,6,"VOX",1
45,"45113",1915,1390,1366,6,24,"VOX",0
6,"6053",602,454,444,3,10,"VOX",1
14,"14004",2034,1531,1518,14,13,"VOX",0
48,"48050",191,147,146,0,1,"VOX",0
24,"24021",1675,1162,1144,8,18,"VOX",1
30,"30038",15411,10847,10767,46,80,"VOX",30
25,"25244",361,223,220,5,3,"VOX",0
16,"16088",108,88,87,0,1,"VOX",0
24,"24223",2610,1917,1908,39,9,"VOX",2
48,"48080",9976,6820,6763,62,57,"VOX",7
46,"46162",1189,938,929,3,9,"VOX",14
1,"1019",150,106,105,1,1,"VOX",0
19,"19281",21,15,15,2,0,"VOX",0
47,"47034",72,58,58,3,0,"VOX",0
25,"25202",104,73,72,0,1,"VOX",0
4,"4096",266,209,208,0,1,"VOX",0
28,"28089",3677,2748,2730,10,18,"VOX",8
40,"40125",87,58,58,1,0,"VOX",0
47,"47195",459,345,344,4,1,"VOX",0
1,"1020",327,237,234,3,3,"VOX",0
6,"6055",2051,1453,1422,8,31,"VOX",7
16,"16186",456,375,371,0,4,"VOX",3
46,"46241",392,299,291,1,8,"VOX",2
50,"50257",171,134,134,2,0,"VOX",0
46,"46059",1261,1035,1019,9,16,"VOX",0
16,"16187",74,55,55,1,0,"VOX",0
23,"23014",2559,1971,1942,13,29,"VOX",2
39,"39102",2277,1615,1598,9,17,"VOX",4
14,"14006",1330,1120,1101,8,19,"VOX",1
47,"47035",921,717,715,3,2,"VOX",1
23,"23015",1374,1029,1019,5,10,"VOX",0
15,"15019",25888,16680,16460,186,220,"VOX",14
24,"24225",1014,752,739,10,13,"VOX",1
9,"9128",80,63,63,0,0,"VOX",0
26,"26081",16,14,14,0,0,"VOX",0
3,"3052",970,769,755,8,14,"VOX",0
45,"45116",687,509,505,1,4,"VOX",0
42,"42119",158,100,99,3,1,"VOX",0
9,"9129",104,83,83,0,0,"VOX",0
9,"9308",67,42,42,1,0,"VOX",0
50,"50258",54,34,34,0,0,"VOX",0
14,"14007",15207,10558,10417,82,141,"VOX",14
47,"47117",301,233,227,2,6,"VOX",1
41,"41099",3976,2369,2347,12,22,"VOX",0
22,"22205",438,322,320,0,2,"VOX",0
28,"28152",16093,12945,12877,58,68,"VOX",113
42,"42166",59,45,45,0,0,"VOX",0
25,"25120",92002,55658,55214,587,444,"VOX",72
11,"11033",20903,12949,12771,164,178,"VOX",23
41,"41077",8702,5983,5875,29,108,"VOX",12
46,"46243",138,115,112,1,3,"VOX",0
9,"9400",317,247,245,1,2,"VOX",0
23,"23017",1572,1269,1257,4,12,"VOX",0
50,"50198",54,41,41,1,0,"VOX",0
47,"47037",168,138,133,0,5,"VOX",1
42,"42033",48,45,45,1,0,"VOX",0
40,"40130",130,107,106,1,1,"VOX",0
12,"12022",344,265,262,2,3,"VOX",0
18,"18184",2168,1629,1607,13,22,"VOX",3
41,"41101",5928,4209,4173,18,36,"VOX",1
9,"9262",163,130,127,1,3,"VOX",0
12,"12122",796,637,627,0,10,"VOX",0
26,"26084",6696,5012,4955,35,57,"VOX",13
24,"24124",367,244,233,3,11,"VOX",0
48,"48055",2668,1872,1849,11,23,"VOX",1
28,"28124",74,54,54,1,0,"VOX",0
45,"45118",1991,1351,1339,6,12,"VOX",5
46,"46166",8155,6320,6251,30,69,"VOX",7
6,"6061",1084,853,837,4,16,"VOX",0
10,"10181",686,533,523,1,10,"VOX",0
25,"25252",548,343,342,9,1,"VOX",2
24,"24125",462,290,286,4,4,"VOX",0
9,"9405",130,98,96,0,2,"VOX",0
46,"46089",2132,1602,1574,9,28,"VOX",2
19,"19104",14,12,12,1,0,"VOX",0
19,"19057",76,59,59,1,0,"VOX",0
9,"9221",461,343,338,3,5,"VOX",0
18,"18006",4130,2904,2864,13,40,"VOX",1
50,"50199",334,244,242,3,2,"VOX",0
46,"46245",511,420,415,0,5,"VOX",1
29,"29030",805,620,614,4,6,"VOX",0
22,"22043",93,66,65,0,1,"VOX",0
9,"9406",251,192,191,2,1,"VOX",1
6,"6063",3015,2268,2246,16,22,"VOX",5
40,"40006",22,18,18,0,0,"VOX",0
3,"3088",5498,4041,3989,29,52,"VOX",9
6,"6018",753,535,529,3,6,"VOX",1
28,"28095",1529,1119,1106,6,13,"VOX",4
19,"19058",6793,5258,5218,19,40,"VOX",28
21,"21006",3368,2182,2146,13,36,"VOX",1
12,"12026",881,678,663,13,15,"VOX",0
26,"26087",201,153,149,3,4,"VOX",0
28,"28126",39,29,29,0,0,"VOX",0
42,"42127",38,31,31,1,0,"VOX",0
41,"41902",4659,2679,2646,23,33,"VOX",3
10,"10093",398,317,312,4,5,"VOX",0
46,"46116",13159,10193,10135,53,58,"VOX",19
42,"42174",174,137,135,5,2,"VOX",1
47,"47203",62,53,53,1,0,"VOX",0
18,"18051",1147,817,810,8,7,"VOX",0
16,"16195",497,392,390,1,2,"VOX",1
10,"10185",571,409,405,2,4,"VOX",0
28,"28902",471,363,356,4,7,"VOX",1
9,"9408",41,36,36,0,0,"VOX",0
41,"41016",7355,5248,5175,51,73,"VOX",8
39,"39079",8874,6547,6478,47,69,"VOX",6
6,"6157",443,321,316,1,5,"VOX",0
9,"9135",41,31,31,1,0,"VOX",0
47,"47204",256,204,198,0,6,"VOX",2
46,"46169",32247,24214,24053,154,161,"VOX",46
47,"47123",466,354,352,4,2,"VOX",0
25,"25126",290,200,198,2,2,"VOX",0
50,"50013",219,180,180,0,0,"VOX",4
19,"19219",13,9,9,0,0,"VOX",0
12,"12028",12586,9733,9676,62,57,"VOX",21
10,"10187",438,308,305,1,3,"VOX",0
6,"6022",2651,2089,2054,10,35,"VOX",3
21,"21009",857,532,523,4,9,"VOX",1
25,"25127",210,136,136,2,0,"VOX",1
46,"46118",3763,2940,2908,16,32,"VOX",1
50,"50203",1040,748,739,7,9,"VOX",3
6,"6068",446,347,345,5,2,"VOX",1
40,"40138",2169,1673,1656,7,17,"VOX",7
42,"42001",278,212,210,3,2,"VOX",1
24,"24131",724,511,507,3,4,"VOX",0
50,"50204",2436,1785,1770,3,15,"VOX",4
6,"6069",3065,2053,2035,14,18,"VOX",4
47,"47124",392,316,311,3,5,"VOX",1
25,"25001",144,73,73,0,0,"VOX",0
16,"16055",691,466,463,2,3,"VOX",2
9,"9137",174,132,131,3,1,"VOX",0
18,"18149",5230,3903,3864,20,39,"VOX",15
10,"10006",1263,978,970,2,8,"VOX",0
23,"23027",723,576,572,3,4,"VOX",0
22,"22173",232,152,152,3,0,"VOX",0
28,"28129",8030,5986,5941,42,45,"VOX",18
29,"29035",1567,1157,1144,11,13,"VOX",0
25,"25129",175,83,83,2,0,"VOX",0
41,"41086",16170,10162,10088,73,74,"VOX",15
46,"46068",346,276,266,6,10,"VOX",0
12,"12098",580,451,447,5,4,"VOX",1
46,"46016",1061,870,856,5,14,"VOX",0
19,"19334",35,31,31,0,0,"VOX",0
16,"16057",75,63,63,0,0,"VOX",0
47,"47043",297,239,237,0,2,"VOX",0
23,"23028",6220,4409,4369,23,40,"VOX",7
14,"14015",2125,1579,1554,10,25,"VOX",1
41,"41053",21259,15147,14853,132,294,"VOX",31
18,"18151",260,171,170,3,1,"VOX",0
47,"47044",331,293,290,2,3,"VOX",0
26,"26058",154,116,115,0,1,"VOX",0
24,"24168",460,361,359,0,2,"VOX",0
21,"21013",10591,6580,6452,55,128,"VOX",15
46,"46173",1328,1069,1057,4,12,"VOX",1
45,"45160",1109,874,864,6,10,"VOX",4
26,"26094",83,70,70,0,0,"VOX",0
19,"19111",155,126,126,1,0,"VOX",0
9,"9139",103,87,85,3,2,"VOX",0
19,"19224",93,87,87,0,0,"VOX",1
22,"22050",88,77,77,0,0,"VOX",1
41,"41021",21294,13762,13570,145,192,"VOX",25
46,"46200",1903,1561,1539,3,22,"VOX",1
25,"25045",57,40,40,0,0,"VOX",0
48,"48063",372,279,277,2,2,"VOX",0
19,"19112",60,46,46,0,0,"VOX",0
45,"45128",2502,1680,1668,6,12,"VOX",4
46,"46174",972,764,752,2,12,"VOX",1
41,"41055",14954,10068,9945,64,123,"VOX",12
47,"47154",152,128,125,1,3,"VOX",0
40,"40184",258,211,210,2,1,"VOX",0
19,"19260",42,39,39,1,0,"VOX",2
10,"10103",450,322,318,1,4,"VOX",0
6,"6074",4791,3513,3449,18,64,"VOX",1
29,"29005",4358,2859,2817,28,42,"VOX",12
40,"40143",86,75,74,0,1,"VOX",1
28,"28132",11685,8130,8062,56,68,"VOX",30
50,"50208",1774,1207,1195,10,12,"VOX",7
25,"25907",494,266,265,6,1,"VOX",0
19,"19113",485,366,366,3,0,"VOX",4
42,"42009",78,63,63,0,0,"VOX",0
9,"9276",382,251,240,3,11,"VOX",0
19,"19225",823,623,619,3,4,"VOX",4
46,"46175",456,389,387,3,2,"VOX",0
47,"47128",60,52,51,0,1,"VOX",0
26,"26098",88,73,73,1,0,"VOX",0
19,"19226",43,38,38,0,0,"VOX",0
9,"9021",56,33,31,1,2,"VOX",1
45,"45029",201,171,171,1,0,"VOX",0
40,"40017",92,75,75,0,0,"VOX",0
18,"18064",377,291,290,2,1,"VOX",0
16,"16063",97,85,84,1,1,"VOX",0
28,"28066",7182,5422,5371,17,51,"VOX",28
22,"22178",103,82,81,0,1,"VOX",0
46,"46019",8849,7072,7004,33,68,"VOX",12
50,"50209",2601,1731,1721,13,10,"VOX",2
9,"9144",53,40,40,0,0,"VOX",0
6,"6078",507,409,404,1,5,"VOX",0
23,"23072",1986,1542,1530,7,12,"VOX",0
42,"42187",62,46,45,1,1,"VOX",0
12,"12133",59,53,52,0,1,"VOX",0
50,"50052",90,68,68,0,0,"VOX",0
35,"35007",511,316,309,2,7,"VOX",0
10,"10015",675,483,473,3,10,"VOX",0
48,"48066",348,258,258,1,0,"VOX",0
19,"19115",24,18,18,0,0,"VOX",0
42,"42012",35,28,28,0,0,"VOX",0
46,"46177",4690,3579,3526,19,53,"VOX",5
39,"39026",1750,1236,1224,11,12,"VOX",1
23,"23035",1106,873,855,1,18,"VOX",1
10,"10199",165,112,111,1,1,"VOX",0
25,"25137",8585,5143,5095,56,48,"VOX",5
28,"28011",442,317,316,1,1,"VOX",1
47,"47023",2995,2344,2326,18,18,"VOX",9
21,"21020",365,223,222,1,1,"VOX",1
10,"10154",181,131,129,0,2,"VOX",0
42,"42094",621,444,433,10,11,"VOX",0
9,"9460",176,131,131,1,0,"VOX",0
24,"24040",449,329,325,2,4,"VOX",1
40,"40149",514,375,369,5,6,"VOX",2
46,"46021",23649,17291,17153,100,138,"VOX",24
26,"26101",44,36,35,0,1,"VOX",0
6,"6034",171,121,120,4,1,"VOX",0
18,"18115",2553,1800,1781,17,19,"VOX",5
28,"28136",647,528,518,2,10,"VOX",2
26,"26065",50,43,42,0,1,"VOX",0
19,"19117",1579,1135,1123,8,12,"VOX",0
22,"22020",115,86,86,1,0,"VOX",0
9,"9108",384,283,279,1,4,"VOX",0
10,"10017",825,620,611,3,9,"VOX",1
40,"40108",112,82,82,0,0,"VOX",1
28,"28137",1664,1232,1220,7,12,"VOX",4
40,"40150",69,61,61,1,0,"VOX",0
29,"29044",809,561,561,3,0,"VOX",0
50,"50151",636,499,499,0,0,"VOX",1
15,"15078",78198,56154,55581,560,573,"VOX",107
47,"47213",109,82,82,0,0,"VOX",0
15,"15079",1540,1027,1007,16,20,"VOX",0
45,"45034",1353,1082,1078,6,4,"VOX",0
9,"9422",17,11,11,0,0,"VOX",0
41,"41029",13445,9507,9416,78,91,"VOX",11
9,"9109",1056,619,595,8,24,"VOX",0
18,"18163",324,235,233,2,2,"VOX",1
48,"48070",544,362,362,4,0,"VOX",0
25,"25140",788,435,430,9,5,"VOX",1
33,"33067",784,587,579,9,8,"VOX",1
23,"23040",1480,1199,1192,2,7,"VOX",2
10,"10066",160,122,122,0,0,"VOX",0
19,"19232",71,57,57,1,0,"VOX",0
3,"3071",3982,3048,3012,26,36,"VOX",5
47,"47133",2682,2033,2015,16,18,"VOX",2
29,"29046",2675,1825,1807,14,18,"VOX",2
4,"4055",371,310,308,0,2,"VOX",0
22,"22187",293,218,216,2,2,"VOX",0
47,"47051",335,268,263,2,5,"VOX",6
10,"10159",320,251,250,0,1,"VOX",1
16,"16071",20,20,20,0,0,"VOX",1
46,"46180",682,553,549,0,4,"VOX",1
9,"9288",90,70,70,0,0,"VOX",0
12,"12138",19061,13010,12847,129,163,"VOX",31
1,"1049",138,109,109,1,0,"VOX",0
45,"45103",397,331,327,3,4,"VOX",0
3,"3103",272,235,234,1,1,"VOX",1
47,"47052",6576,4988,4944,40,44,"VOX",6
47,"47187",84,61,58,0,3,"VOX",0
50,"50216",235,186,184,5,2,"VOX",1
9,"9424",36,29,29,1,0,"VOX",0
9,"9029",168,131,129,4,2,"VOX",1
28,"28016",79,53,51,0,2,"VOX",1
50,"50186",42,31,31,0,0,"VOX",0
15,"15008",5627,4112,4072,36,40,"VOX",4
9,"9159",60,52,51,2,1,"VOX",0
41,"41065",22779,14769,14636,132,133,"VOX",14
46,"46103",1264,1015,984,7,31,"VOX",0
9,"9200",50,32,31,0,1,"VOX",0
26,"26106",86,72,72,0,0,"VOX",0
10,"10069",838,626,615,2,11,"VOX",4
45,"45138",1091,877,871,4,6,"VOX",1
10,"10207",504,357,350,6,7,"VOX",0
9,"9425",517,384,378,0,6,"VOX",0
26,"26071",8491,5834,5761,47,73,"VOX",13
18,"18168",804,546,543,7,3,"VOX",0
9,"9427",1419,978,959,8,19,"VOX",3
24,"24046",942,637,633,5,4,"VOX",2
46,"46182",1266,929,922,6,7,"VOX",1
22,"22103",682,508,502,3,6,"VOX",2
6,"6089",596,469,461,1,8,"VOX",0
9,"9472",55,45,44,0,1,"VOX",0
3,"3105",5373,3911,3828,15,83,"VOX",5
39,"39003",297,220,215,0,5,"VOX",0
50,"50280",332,253,250,0,3,"VOX",0
10,"10026",648,500,492,7,8,"VOX",1
16,"16171",1800,1469,1443,8,26,"VOX",1
39,"39065",252,191,189,1,2,"VOX",0
24,"24047",783,545,540,2,5,"VOX",1
19,"19086",1473,1123,1111,7,12,"VOX",0
23,"23045",2132,1260,1247,5,13,"VOX",3
12,"12045",345,268,259,1,9,"VOX",1
4,"4059",1079,723,712,4,11,"VOX",0
47,"47218",993,743,734,2,9,"VOX",1
45,"45140",1087,833,823,3,10,"VOX",0
3,"3107",2508,1755,1744,7,11,"VOX",2
26,"26180",221,173,172,0,1,"VOX",0
14,"14028",314,253,249,1,4,"VOX",0
10,"10211",444,337,336,0,1,"VOX",1
25,"25104",130,76,74,1,2,"VOX",0
23,"23046",2391,1916,1895,6,21,"VOX",0
26,"26109",81,69,69,0,0,"VOX",0
12,"12142",158,117,117,1,0,"VOX",0
28,"28145",2431,1760,1736,6,24,"VOX",5
45,"45075",143,109,108,0,1,"VOX",0
18,"18035",1232,992,988,6,4,"VOX",0
19,"19239",92,62,62,1,0,"VOX",0
39,"39005",1380,1053,1046,9,7,"VOX",1
47,"47056",87,67,67,0,0,"VOX",0
21,"21031",1199,852,837,6,15,"VOX",1
45,"45142",7871,6007,5927,37,80,"VOX",11
15,"15050",1822,1004,988,13,16,"VOX",2
50,"50159",665,512,507,2,5,"VOX",0
3,"3016",93,75,75,0,0,"VOX",0
19,"19314",51,36,36,0,0,"VOX",0
39,"39036",969,743,739,2,4,"VOX",1
41,"41003",2333,1693,1671,13,22,"VOX",3
40,"40161",36,28,28,2,0,"VOX",0
9,"9250",269,196,194,1,2,"VOX",1
12,"12049",441,322,312,1,10,"VOX",0
30,"30035",18671,13103,12979,54,124,"VOX",52
46,"46185",378,320,313,2,7,"VOX",0
39,"39037",1987,1516,1503,8,13,"VOX",0
9,"9431",118,98,98,0,0,"VOX",0
15,"15051",4638,3182,3153,44,29,"VOX",6
42,"42159",37,29,29,0,0,"VOX",0
1,"1016",433,228,226,5,2,"VOX",0
18,"18176",250,191,189,2,2,"VOX",0
18,"18037",535,402,396,2,6,"VOX",1
14,"14002",10951,7706,7620,83,86,"VOX",4
28,"28086",5154,3530,3493,13,37,"VOX",26
10,"10078",406,321,314,6,7,"VOX",0
25,"25024",351,226,223,2,3,"VOX",0
41,"41037",3213,2376,2342,30,34,"VOX",3
16,"16238",501,428,422,3,6,"VOX",0
29,"29076",2153,1390,1360,10,30,"VOX",4
28,"28087",3186,2503,2487,19,16,"VOX",22
10,"10079",894,662,648,7,14,"VOX",2
41,"41039",31663,22062,21830,193,232,"VOX",27
19,"19007",459,341,336,0,5,"VOX",1
42,"42204",54,38,38,1,0,"VOX",0
22,"22239",88,72,72,0,0,"VOX",1
47,"47141",134,111,110,0,1,"VOX",0
21,"21035",9617,6033,5943,76,90,"VOX",4
23,"23010",14347,9669,9560,86,109,"VOX",15
40,"40036",515,421,410,3,11,"VOX",3
9,"9168",290,217,217,3,0,"VOX",0
40,"40079",234,179,179,3,0,"VOX",0
42,"42065",21,18,18,0,0,"VOX",0
19,"19008",37,28,27,1,1,"VOX",2
14,"14059",690,533,528,4,5,"VOX",0
40,"40124",237,182,177,6,5,"VOX",1
41,"41040",10541,7752,7698,68,54,"VOX",12
46,"46031",10535,7543,7451,66,92,"VOX",18
9,"9169",95,78,78,0,0,"VOX",0
3,"3019",15269,11520,11398,72,122,"VOX",26
16,"16242",317,272,270,1,2,"VOX",0
10,"10218",1126,803,795,3,8,"VOX",1
42,"42068",82,63,60,1,3,"VOX",0
50,"50163",3689,2702,2680,37,22,"VOX",6
42,"42205",89,71,71,2,0,"VOX",1
19,"19009",259,200,195,6,5,"VOX",1
16,"16185",43,37,37,0,0,"VOX",0
16,"16243",407,338,334,3,4,"VOX",1
9,"9041",28,27,27,0,0,"VOX",0
3,"3113",4243,3091,3046,10,45,"VOX",8
50,"50035",72,54,53,1,1,"VOX",0
10,"10037",76232,55104,54464,418,640,"VOX",114
23,"23012",4162,2907,2889,14,18,"VOX",11
39,"39101",274,197,192,3,5,"VOX",0
16,"16089",375,303,303,6,0,"VOX",0
42,"42164",1600,1150,1127,8,23,"VOX",4
45,"45147",581,450,446,1,4,"VOX",0
41,"41042",5844,4424,4378,40,46,"VOX",2
39,"39041",1760,1370,1354,9,16,"VOX",4
4,"4033",135,97,93,1,4,"VOX",0
24,"24022",330,230,229,0,1,"VOX",0
39,"39042",5915,4530,4474,21,56,"VOX",5
46,"46033",191,156,155,0,1,"VOX",0
18,"18089",14719,10163,10099,63,64,"VOX",18
47,"47224",87,76,76,0,0,"VOX",0
10,"10084",1345,888,875,4,13,"VOX",1
45,"45148",292,223,223,0,0,"VOX",0
50,"50133",113,80,80,4,0,"VOX",0
40,"40168",34,29,29,1,0,"VOX",0
19,"19011",250,184,184,0,0,"VOX",0
10,"10085",323,235,233,0,2,"VOX",0
1,"1061",154,127,127,1,0,"VOX",0
9,"9353",76,57,56,1,1,"VOX",0
33,"33019",3072,2020,2005,18,15,"VOX",6
47,"47171",407,303,301,6,2,"VOX",3
9,"9218",369,275,275,1,0,"VOX",0
28,"28054",11257,8349,8273,55,76,"VOX",68
1,"1062",313,211,210,2,1,"VOX",0
10,"10904",745,507,504,8,3,"VOX",0
46,"46190",48947,35638,35419,211,219,"VOX",78
25,"25072",5850,3493,3444,29,49,"VOX",6
18,"18003",14022,9938,9820,80,118,"VOX",24
22,"22245",309,267,261,1,6,"VOX",0
19,"19176",237,181,181,0,0,"VOX",0
47,"47198",69,50,50,0,0,"VOX",1
24,"24227",1607,1127,1116,22,11,"VOX",1
19,"19015",84,69,68,0,1,"VOX",0
46,"46191",1937,1530,1505,5,25,"VOX",3
46,"46113",2457,1804,1782,6,22,"VOX",3
24,"24159",1806,1386,1366,6,20,"VOX",1
4,"4069",4687,3471,3437,27,34,"VOX",4
22,"22077",379,279,273,2,6,"VOX",1
39,"39044",3849,2765,2732,21,33,"VOX",2
9,"9310",13,9,8,0,1,"VOX",0
45,"45151",578,417,414,0,3,"VOX",0
50,"50039",491,392,390,2,2,"VOX",0
10,"10089",1359,882,868,3,14,"VOX",3
19,"19249",32,29,29,0,0,"VOX",0
9,"9442",375,279,277,2,2,"VOX",1
39,"39045",367,271,268,1,3,"VOX",1
28,"28154",5408,3806,3767,16,39,"VOX",12
3,"3118",2437,1659,1642,4,17,"VOX",8
50,"50230",1165,833,828,8,5,"VOX",0
45,"45052",2948,2321,2295,16,26,"VOX",6
30,"30043",24967,18981,18685,101,296,"VOX",81
21,"21044",17591,10679,10558,118,121,"VOX",14
9,"9356",42,33,32,0,1,"VOX",0
26,"26121",25,22,22,0,0,"VOX",0
46,"46063",1756,1367,1345,15,22,"VOX",0
50,"50010",68,58,58,0,0,"VOX",0
18,"18187",557,383,379,0,4,"VOX",0
18,"18049",595,459,452,3,7,"VOX",1
16,"16250",76,59,59,0,0,"VOX",0
25,"25164",376,242,238,4,4,"VOX",2
25,"25165",285,179,176,2,3,"VOX",0
23,"23059",5837,4387,4310,40,77,"VOX",3
11,"11003",1261,836,822,7,14,"VOX",0
40,"40174",349,254,251,2,3,"VOX",3
10,"10091",371,287,284,0,3,"VOX",0
21,"21046",1705,1099,996,16,103,"VOX",1
23,"23020",1590,1370,1349,9,21,"VOX",0
9,"9444",72,58,58,3,0,"VOX",0
50,"50042",15,15,15,1,0,"VOX",0
40,"40176",395,306,305,2,1,"VOX",0
26,"26123",126,108,107,2,1,"VOX",0
3,"3120",2406,1753,1720,11,33,"VOX",6
10,"10045",1019,762,755,3,7,"VOX",1
28,"28002",3007,2091,2074,14,17,"VOX",12
22,"22209",155,120,120,3,0,"VOX",0
26,"26053",208,168,163,4,5,"VOX",0
18,"18010",566,427,421,1,6,"VOX",0
11,"11038",13737,10181,10034,99,147,"VOX",15
19,"19143",1738,1306,1297,12,9,"VOX",1
16,"16254",214,174,170,2,4,"VOX",1
9,"9051",170,130,128,0,2,"VOX",0
50,"50139",313,241,239,3,2,"VOX",2
4,"4073",330,234,233,2,1,"VOX",1
41,"41049",9299,6896,6771,98,125,"VOX",8
22,"22212",79,64,62,0,2,"VOX",0
3,"3121",21273,14569,14468,62,101,"VOX",29
26,"26021",2827,2098,2076,15,22,"VOX",4
45,"45056",2201,1260,1243,12,17,"VOX",4
3,"3028",998,818,812,2,6,"VOX",2
40,"40178",98,73,71,1,2,"VOX",0
25,"25039",277,181,180,3,1,"VOX",0
46,"46039",2130,1728,1699,8,29,"VOX",4
40,"40051",38,34,34,0,0,"VOX",0
42,"42039",226,138,138,4,0,"VOX",1
16,"16255",140,122,121,0,1,"VOX",0
47,"47230",303,246,242,2,4,"VOX",1
16,"16053",426,351,347,5,4,"VOX",1
22,"22082",291,213,212,1,1,"VOX",0
50,"50108",48,38,38,0,0,"VOX",0
29,"29066",334,234,233,4,1,"VOX",0
14,"14041",3182,2296,2251,33,45,"VOX",4
16,"16102",1205,912,905,12,7,"VOX",0
18,"18102",8400,5592,5504,44,88,"VOX",4
23,"23063",3829,2560,2522,21,38,"VOX",3
41,"41051",2180,1529,1501,2,28,"VOX",4
35,"35002",23328,15495,15313,94,182,"VOX",28
22,"22083",463,394,390,5,4,"VOX",1
9,"9054",101,68,66,1,2,"VOX",0
22,"22214",128,106,105,3,1,"VOX",1
25,"25041",568,347,344,4,3,"VOX",0
12,"12064",91,82,81,2,1,"VOX",0
42,"42042",45,35,35,0,0,"VOX",1
16,"16199",30,25,25,1,0,"VOX",0
40,"40221",49,39,39,0,0,"VOX",0
6,"6023",4302,3041,3007,16,34,"VOX",1
39,"39051",66,57,57,0,0,"VOX",0
46,"46119",780,653,647,5,6,"VOX",0
25,"25170",266,169,167,1,2,"VOX",1
33,"33028",1276,649,641,4,8,"VOX",0
4,"4076",1279,960,944,8,16,"VOX",0
6,"6116",1587,1171,1160,10,11,"VOX",0
25,"25042",208,123,121,1,2,"VOX",0
41,"41052",3013,2116,2064,14,52,"VOX",3
33,"33058",1796,1232,1209,11,23,"VOX",2
45,"45059",1712,1337,1311,1,26,"VOX",7
9,"9449",86,68,66,0,2,"VOX",1
45,"45159",90,75,75,0,0,"VOX",0
24,"24033",205,158,157,0,1,"VOX",0
28,"28063",258,194,193,1,1,"VOX",0
46,"46042",3380,2799,2755,20,44,"VOX",0
25,"25043",807,501,497,11,4,"VOX",1
6,"6026",837,598,591,0,7,"VOX",0
46,"46121",105,95,94,0,1,"VOX",0
26,"26025",87,71,70,1,1,"VOX",0
10,"10191",527,405,397,2,8,"VOX",2
26,"26129",967,775,766,6,9,"VOX",1
40,"40183",130,120,119,2,1,"VOX",0
19,"19151",1064,744,726,1,18,"VOX",1
9,"9368",22,17,17,2,0,"VOX",0
1,"1037",587,411,408,1,3,"VOX",0
33,"33060",14633,9647,9474,72,173,"VOX",14
9,"9274",1079,848,835,12,13,"VOX",2
25,"25905",375,249,246,3,3,"VOX",0
46,"46122",2704,2082,2063,10,19,"VOX",3
23,"23069",5353,4310,4212,27,98,"VOX",12
26,"26130",203,167,167,1,0,"VOX",1
26,"26027",157,112,108,0,4,"VOX",0
19,"19188",51,35,35,0,0,"VOX",2
18,"18153",8597,6024,5972,40,52,"VOX",15
14,"14017",10868,7764,7665,71,99,"VOX",9
22,"22220",166,126,125,2,1,"VOX",0
39,"39023",6330,4737,4672,25,65,"VOX",3
50,"50239",62,50,48,0,2,"VOX",0
24,"24169",2969,2140,2118,13,22,"VOX",0
23,"23070",3914,2433,2407,14,26,"VOX",0
21,"21056",2895,1990,1906,18,84,"VOX",2
46,"46259",491,396,393,4,3,"VOX",2
10,"10102",529,411,405,5,6,"VOX",1
15,"15073",21827,14058,13864,126,194,"VOX",15
35,"35005",1048,747,737,8,10,"VOX",1
45,"45062",1112,878,867,4,11,"VOX",2
12,"12070",522,406,401,0,5,"VOX",0
28,"28163",442,344,339,1,5,"VOX",0
14,"14046",4485,3268,3208,33,60,"VOX",2
40,"40059",110,95,95,1,0,"VOX",0
47,"47074",149,117,116,2,1,"VOX",3
3,"3035",652,547,541,1,6,"VOX",1
41,"41057",269,183,181,0,2,"VOX",0
10,"10104",5119,3633,3585,15,48,"VOX",11
9,"9191",38,28,27,0,1,"VOX",0
42,"42185",26,22,22,0,0,"VOX",0
11,"11013",2312,1547,1518,15,29,"VOX",5
42,"42049",116,81,81,1,0,"VOX",1
40,"40188",90,72,70,0,2,"VOX",0
10,"10105",2512,1644,1620,12,24,"VOX",3
26,"26029",37,32,32,0,0,"VOX",0
3,"3130",48,25,25,0,0,"VOX",0
26,"26170",446,330,326,2,4,"VOX",1
22,"22054",1542,1091,1077,13,14,"VOX",3
21,"21059",221,166,163,5,3,"VOX",0
45,"45131",282,234,230,0,4,"VOX",0
40,"40019",36,31,31,1,0,"VOX",0
22,"22089",302,225,223,0,2,"VOX",4
18,"18112",123,82,82,2,0,"VOX",0
9,"9103",217,184,183,1,1,"VOX",0
46,"46229",948,762,758,0,4,"VOX",2
40,"40061",67,55,54,1,1,"VOX",0
40,"40189",512,401,392,2,9,"VOX",0
33,"33064",234,168,167,1,1,"VOX",0
47,"47211",47,35,34,0,1,"VOX",0
48,"48037",673,481,478,5,3,"VOX",0
11,"11015",62476,38177,37875,488,302,"VOX",90
22,"22090",99,71,71,0,0,"VOX",0
24,"24209",2769,1888,1865,12,23,"VOX",1
19,"19075",64,39,39,0,0,"VOX",0
15,"15077",8261,5186,5103,59,83,"VOX",2
40,"40190",53,45,44,0,1,"VOX",1
40,"40233",417,314,310,3,4,"VOX",0
18,"18023",15655,10879,10774,82,105,"VOX",14
9,"9149",35,24,24,2,0,"VOX",0
15,"15003",1803,1227,1210,9,17,"VOX",1
24,"24174",486,343,342,4,1,"VOX",0
6,"6126",2170,1523,1507,1,16,"VOX",3
28,"28012",887,664,661,2,3,"VOX",4
3,"3100",503,440,437,0,3,"VOX",0
25,"25012",2334,1322,1310,8,12,"VOX",1
47,"47049",101,68,68,0,0,"VOX",0
26,"26102",6111,4486,4435,28,51,"VOX",4
42,"42053",26,19,19,1,0,"VOX",0
10,"10110",2300,1623,1574,11,49,"VOX",1
23,"23075",3298,2564,2541,18,23,"VOX",0
18,"18025",288,220,220,1,0,"VOX",0
46,"46231",2421,1721,1708,14,13,"VOX",2
19,"19159",93,78,77,0,1,"VOX",0
42,"42096",272,171,170,6,1,"VOX",0
19,"19231",10,9,9,0,0,"VOX",0
4,"4084",341,249,247,2,2,"VOX",0
39,"39059",7986,5879,5806,45,73,"VOX",6
6,"6128",4447,2975,2935,26,40,"VOX",4
50,"50152",1430,1008,994,14,14,"VOX",7
9,"9026",386,301,300,0,1,"VOX",1
19,"19160",886,558,552,2,6,"VOX",2
45,"45069",1847,1391,1376,6,15,"VOX",4
6,"6037",1748,1148,1134,9,14,"VOX",0
25,"25182",1036,660,655,9,5,"VOX",0
3,"3134",143,112,111,0,1,"VOX",0
19,"19267",19,13,13,0,0,"VOX",0
42,"42055",164,121,121,0,0,"VOX",0
24,"24108",376,280,277,2,3,"VOX",0
9,"9242",80,66,66,2,0,"VOX",0
41,"41030",514,387,373,3,14,"VOX",1
4,"4021",185,151,148,1,3,"VOX",0
50,"50153",935,713,708,6,5,"VOX",0
4,"4086",1760,1243,1234,9,9,"VOX",1
48,"48071",6087,4294,4254,32,40,"VOX",2
25,"25055",169,105,104,4,1,"VOX",0
29,"29068",7016,4300,4244,35,56,"VOX",6
50,"50057",1395,919,907,11,12,"VOX",2
42,"42056",23,20,20,0,0,"VOX",0
11,"11019",1826,1302,1248,7,54,"VOX",4
46,"46050",194,150,149,0,1,"VOX",0
40,"40195",885,672,669,1,3,"VOX",4
16,"16279",203,128,127,1,1,"VOX",0
45,"45170",228,176,167,0,9,"VOX",0
45,"45070",1427,1147,1142,1,5,"VOX",1
40,"40111",58,49,49,0,0,"VOX",0
19,"19041",163,129,129,3,0,"VOX",0
26,"26003",413,331,329,2,2,"VOX",1
25,"25142",364,229,225,2,4,"VOX",1
19,"19234",43,33,33,0,0,"VOX",0
24,"24079",906,664,658,9,6,"VOX",0
26,"26177",304,255,254,7,1,"VOX",0
21,"21067",414,288,287,1,1,"VOX",0
19,"19081",29,22,22,1,0,"VOX",0
33,"33070",3351,2403,2373,26,30,"VOX",2
26,"26037",128,108,108,2,0,"VOX",0
45,"45171",1361,1035,1023,0,12,"VOX",6
28,"28171",4239,2848,2820,19,28,"VOX",3
21,"21068",998,605,592,11,13,"VOX",3
10,"10208",123,94,93,1,1,"VOX",0
9,"9292",87,75,73,1,2,"VOX",0
45,"45072",671,484,483,2,1,"VOX",0
40,"40071",43,39,38,1,1,"VOX",0
24,"24080",213,164,161,3,3,"VOX",0
28,"28143",72,57,57,1,0,"VOX",0
50,"50249",302,226,220,0,6,"VOX",1
9,"9032",109,75,73,0,2,"VOX",0
21,"21069",1702,1167,1149,6,18,"VOX",1
29,"29049",2962,2132,2110,5,22,"VOX",0
1,"1010",2268,1623,1603,11,20,"VOX",2
26,"26144",188,155,155,3,0,"VOX",4
26,"26039",39,35,35,2,0,"VOX",0
23,"23004",436,364,358,1,6,"VOX",0
9,"9071",41,35,35,1,0,"VOX",0
21,"21029",1562,1127,1097,14,30,"VOX",0
16,"16124",1858,1476,1459,12,17,"VOX",2
9,"9202",25,22,22,1,0,"VOX",0
28,"28172",9077,6992,6936,31,56,"VOX",25
25,"25059",805,527,523,7,4,"VOX",2
16,"16903",1070,777,765,4,12,"VOX",2
46,"46209",1933,1445,1415,5,30,"VOX",0
41,"41068",13939,9787,9674,72,113,"VOX",6
11,"11023",9348,6410,6349,64,61,"VOX",8
50,"50157",290,220,218,3,2,"VOX",0
22,"22064",166,122,121,1,1,"VOX",0
48,"48014",1211,806,801,7,5,"VOX",0
42,"42198",23,16,16,4,0,"VOX",0
25,"25191",334,205,204,4,1,"VOX",0
26,"26145",246,197,197,2,0,"VOX",1
41,"41091",541987,385251,382091,3298,3160,"VOX",1078
16,"16082",291,213,212,0,1,"VOX",0
50,"50281",73,51,50,0,1,"VOX",0
47,"47165",6955,4955,4303,66,652,"VOX",90
4,"4091",334,268,267,6,1,"VOX",0
22,"22234",794,552,544,3,8,"VOX",0
11,"11024",6723,4696,4634,44,62,"VOX",2
46,"46054",11293,8477,8409,47,68,"VOX",15
24,"24115",54058,37780,37357,308,423,"VOX",80
42,"42062",22,12,12,0,0,"VOX",0
46,"46106",1535,1150,1140,10,10,"VOX",3
50,"50062",1829,1304,1290,16,14,"VOX",3
22,"22107",112,74,74,0,0,"VOX",1
41,"41069",29138,18991,18683,341,308,"VOX",17
26,"26041",132,92,91,0,1,"VOX",0
4,"4028",221,191,190,1,1,"VOX",0
33,"33074",3484,2298,2274,24,24,"VOX",2
9,"9073",926,691,686,4,5,"VOX",1
9,"9345",123,93,91,2,2,"VOX",0
18,"18128",343,270,269,1,1,"VOX",0
42,"42063",49,35,35,0,0,"VOX",0
16,"16908",186,152,152,1,0,"VOX",0
22,"22109",261,191,190,1,1,"VOX",0
3,"3047",9207,6309,6226,25,83,"VOX",12
24,"24183",805,555,549,6,6,"VOX",1
19,"19169",40,34,34,0,0,"VOX",0
42,"42160",254,206,205,0,1,"VOX",0
40,"40077",842,632,619,3,13,"VOX",1
48,"48911",380,276,272,1,4,"VOX",0
9,"9074",794,575,569,6,6,"VOX",2
33,"33075",271,154,153,2,1,"VOX",0
39,"39007",417,278,275,2,3,"VOX",1
25,"25196",113,57,57,0,0,"VOX",0
9,"9122",94,67,66,1,1,"VOX",0
50,"50161",106,75,72,0,3,"VOX",0
6,"6005",1696,1197,1178,1,19,"VOX",0
21,"21075",349,275,270,4,5,"VOX",0
22,"22200",244,184,182,5,2,"VOX",0
10,"10171",344,245,244,0,1,"VOX",0
47,"47167",241,204,204,1,0,"VOX",2
4,"4094",207,144,144,0,0,"VOX",0
40,"40163",53,44,43,0,1,"VOX",0
9,"9348",148,111,110,2,1,"VOX",0
48,"48018",869,522,522,2,0,"VOX",0
1,"1058",1345,799,793,7,6,"VOX",1
42,"42161",137,102,101,0,1,"VOX",0
9,"9214",672,427,427,4,0,"VOX",0
42,"42027",76,61,60,0,1,"VOX",0
4,"4064",2771,2001,1988,13,13,"VOX",4
3,"3903",2494,1880,1865,7,15,"VOX",5
46,"46057",487,321,317,1,4,"VOX",0
10,"10126",1548,1120,1102,8,18,"VOX",4
19,"19049",10,10,9,0,1,"VOX",0
26,"26151",448,370,368,1,2,"VOX",0
10,"10127",4703,3183,3132,21,51,"VOX",5
45,"45013",1758,1352,1329,8,23,"VOX",0
30,"30008",13918,9757,9645,59,112,"VOX",34
47,"47114",4045,2787,2762,26,25,"VOX",8
50,"50286",77,50,50,3,0,"VOX",0
19,"19244",82,65,64,1,1,"VOX",0
40,"40165",77,65,64,1,1,"VOX",1
40,"40207",763,599,593,3,6,"VOX",0
22,"22243",45,28,28,0,0,"VOX",0
16,"16134",4371,3288,3254,20,34,"VOX",4
14,"14005",6311,4143,4084,72,59,"VOX",2
15,"15018",1142,741,732,18,9,"VOX",0
10,"10083",90,59,59,2,0,"VOX",0
41,"41074",3012,2282,2257,18,25,"VOX",1
40,"40081",124,94,92,2,2,"VOX",1
25,"25069",451,247,246,4,1,"VOX",0
16,"16135",134,92,92,2,0,"VOX",0
33,"33078",142,101,99,0,2,"VOX",0
21,"21079",722,494,490,5,4,"VOX",1
16,"16244",718,593,587,6,6,"VOX",0
50,"50132",751,543,536,0,7,"VOX",1
42,"42208",22,13,13,2,0,"VOX",0
19,"19282",163,124,123,0,1,"VOX",0
35,"35021",14924,10477,10370,45,107,"VOX",25
46,"46137",270,210,207,4,3,"VOX",0
22,"22001",225,151,151,1,0,"VOX",0
26,"26047",1947,1578,1563,8,15,"VOX",0
14,"14062",1025,806,792,6,14,"VOX",1
25,"25071",49,31,31,0,0,"VOX",0
10,"10130",1761,1300,1277,6,23,"VOX",0
23,"23095",8735,6347,6310,14,37,"VOX",12
41,"41076",2183,1341,1327,19,14,"VOX",0
4,"4002",1039,748,740,2,8,"VOX",0
46,"46242",333,267,266,0,1,"VOX",1
48,"48083",6958,4885,4856,40,29,"VOX",1
19,"19212",703,543,531,3,12,"VOX",2
9,"9398",75,56,56,0,0,"VOX",0
16,"16246",482,361,355,3,6,"VOX",0
6,"6012",3267,2300,2277,15,23,"VOX",2
14,"14063",1046,734,725,2,9,"VOX",1
23,"23096",2642,2164,2138,9,26,"VOX",1
40,"40128",129,95,93,0,2,"VOX",1
22,"22162",130,102,102,0,0,"VOX",0
9,"9045",268,181,181,4,0,"VOX",1
10,"10132",396,278,275,0,3,"VOX",3
28,"28181",20386,16155,16069,57,86,"VOX",93
24,"24058",208,155,154,3,1,"VOX",0
50,"50070",60,36,36,0,0,"VOX",0
3,"3054",343,277,275,3,2,"VOX",0
46,"46139",4485,3617,3574,18,43,"VOX",9
26,"26050",113,88,85,0,3,"VOX",0
4,"4004",425,329,329,0,0,"VOX",0
4,"4099",4989,3636,3588,27,48,"VOX",5
47,"47172",144,124,122,0,2,"VOX",0
6,"6151",1070,770,766,3,4,"VOX",0
50,"50260",33,33,32,0,1,"VOX",0
41,"41078",2508,1823,1810,19,13,"VOX",0
18,"18004",714,518,509,2,9,"VOX",1
48,"48024",995,757,754,7,3,"VOX",0
47,"47173",880,644,638,20,6,"VOX",1
10,"10134",567,401,396,2,5,"VOX",0
4,"4100",8768,5390,5353,32,37,"VOX",3
46,"46218",1060,910,885,7,25,"VOX",0
25,"25074",178,132,128,6,4,"VOX",0
6,"6015",116758,77960,77205,583,755,"VOX",159
22,"22247",33,20,20,0,0,"VOX",0
19,"19286",720,547,543,2,4,"VOX",6
41,"41079",9294,6670,6580,51,90,"VOX",14
4,"4037",1314,969,955,6,14,"VOX",0
9,"9085",475,347,342,2,5,"VOX",2
24,"24229",418,322,319,2,3,"VOX",0
22,"22006",298,204,204,5,0,"VOX",1
4,"4101",4266,2909,2876,26,33,"VOX",3
9,"9312",96,78,77,0,1,"VOX",0
50,"50231",250,195,192,4,3,"VOX",0
15,"15024",4393,3141,3073,32,68,"VOX",5
9,"9009",163,133,131,2,2,"VOX",0
28,"28029",520,408,406,0,2,"VOX",2
47,"47013",100,82,81,1,1,"VOX",0
16,"16005",255,180,178,2,2,"VOX",0
47,"47174",267,218,215,1,3,"VOX",0
18,"18007",781,521,512,5,9,"VOX",1
39,"39077",236,173,171,1,2,"VOX",0
40,"40089",222,167,164,0,3,"VOX",0
6,"6154",2802,1923,1894,23,29,"VOX",2
6,"6155",1874,1218,1202,16,16,"VOX",0
46,"46064",509,412,399,1,13,"VOX",1
50,"50011",122,95,94,1,1,"VOX",0
16,"16050",245,201,195,1,6,"VOX",1
10,"10046",203,168,168,1,0,"VOX",0
28,"28901",799,558,554,0,4,"VOX",4
9,"9224",162,131,131,1,0,"VOX",0
39,"39017",569,398,391,4,7,"VOX",1
25,"25253",159,105,105,1,0,"VOX",0
11,"11004",88783,51500,51015,513,485,"VOX",115
29,"29088",2714,1829,1800,12,29,"VOX",2
25,"25210",1108,685,677,3,8,"VOX",1
18,"18146",965,703,685,9,18,"VOX",0
6,"6020",1815,1366,1345,10,21,"VOX",4
16,"16007",1177,888,880,7,8,"VOX",0
50,"50074",6366,4230,4165,31,65,"VOX",12
45,"45089",1495,1102,1094,0,8,"VOX",0
42,"42081",145,102,100,1,2,"VOX",0
46,"46143",4239,3104,3053,14,51,"VOX",2
46,"46221",352,305,304,0,1,"VOX",0
42,"42082",8,8,8,1,0,"VOX",0
23,"23024",12435,9058,8833,55,225,"VOX",20
28,"28031",2048,1500,1486,3,14,"VOX",3
19,"19290",834,561,558,5,3,"VOX",6
28,"28097",119,94,94,0,0,"VOX",0
4,"4009",162,123,122,2,1,"VOX",0
22,"22251",364,284,284,0,0,"VOX",0
16,"16148",573,504,500,4,4,"VOX",1
42,"42083",26,20,20,0,0,"VOX",0
24,"24097",218,140,139,3,1,"VOX",0
46,"46196",147,125,125,1,0,"VOX",1
48,"48059",400,294,291,0,3,"VOX",0
22,"22011",88,71,69,0,2,"VOX",0
46,"46222",384,307,304,1,3,"VOX",0
22,"22252",121,86,81,0,5,"VOX",0
19,"19061",57,42,42,0,0,"VOX",0
24,"24198",592,412,407,2,5,"VOX",0
46,"46144",663,532,529,2,3,"VOX",3
47,"47177",105,76,73,1,3,"VOX",0
4,"4010",576,444,443,3,1,"VOX",1
26,"26164",59,46,45,2,1,"VOX",0
18,"18194",2128,1451,1437,9,14,"VOX",0
26,"26092",107,92,90,0,2,"VOX",0
1,"1033",651,484,479,2,5,"VOX",0
26,"26127",212,181,176,0,5,"VOX",0
46,"46171",16563,12213,12128,85,85,"VOX",24
9,"9411",151,102,101,0,1,"VOX",0
16,"16150",97,72,72,0,0,"VOX",0
50,"50174",91,69,68,0,1,"VOX",0
41,"41085",4086,3058,3012,22,46,"VOX",8
9,"9448",212,169,165,0,4,"VOX",0
3,"3061",1056,776,768,4,8,"VOX",1
9,"9095",84,61,61,0,0,"VOX",0
19,"19186",81,68,68,0,0,"VOX",0
26,"26165",358,304,299,2,5,"VOX",0
40,"40222",168,145,144,0,1,"VOX",0
18,"18015",434,334,333,0,1,"VOX",0
22,"22254",1124,801,792,11,9,"VOX",2
45,"45193",613,504,497,1,7,"VOX",2
6,"6025",5106,3571,3523,44,48,"VOX",5
19,"19024",8196,5613,5563,28,50,"VOX",13
48,"48031",332,233,231,1,2,"VOX",0
22,"22128",188,146,144,3,2,"VOX",0
10,"10100",799,578,574,4,4,"VOX",1
12,"12067",537,435,427,0,8,"VOX",1
3,"3062",212,169,165,0,4,"VOX",0
48,"48032",5743,4065,4048,29,17,"VOX",5
42,"42181",412,313,307,2,6,"VOX",0
3,"3125",343,254,251,0,3,"VOX",1
41,"41087",10237,6923,6774,48,149,"VOX",19
45,"45194",68,54,53,0,1,"VOX",0
19,"19901",41,38,37,0,1,"VOX",0
10,"10147",1278,961,925,7,36,"VOX",1
29,"29094",57554,38071,37696,339,375,"VOX",85
26,"26026",1321,1039,1025,6,14,"VOX",1
15,"15071",7951,5255,5178,50,77,"VOX",7
47,"47019",85,74,73,0,1,"VOX",1
10,"10010",2290,1362,1341,7,21,"VOX",4
14,"14073",2891,2079,2016,13,63,"VOX",3
18,"18152",944,707,703,0,4,"VOX",0
9,"9058",390,283,279,1,4,"VOX",1
16,"16205",115,88,87,0,1,"VOX",0
14,"14045",3052,2362,2335,11,27,"VOX",6
6,"6903",2021,1377,1360,12,17,"VOX",0
26,"26168",5340,3774,3717,22,57,"VOX",8
3,"3064",5015,3660,3611,11,49,"VOX",6
26,"26061",1565,1160,1141,13,19,"VOX",1
28,"28102",894,644,636,6,8,"VOX",0
24,"24102",652,470,467,2,3,"VOX",0
29,"29095",3321,2376,2307,24,69,"VOX",2
28,"28037",1559,1177,1166,5,11,"VOX",3
21,"21016",1023,746,723,4,23,"VOX",1
45,"45028",3649,2701,2673,12,28,"VOX",4
46,"46227",905,711,702,1,9,"VOX",2
50,"50270",38,26,26,0,0,"VOX",0
22,"22903",652,514,507,1,7,"VOX",0
4,"4015",124,96,96,2,0,"VOX",0
12,"12101",358,279,275,3,4,"VOX",0
47,"47021",76,64,64,0,0,"VOX",0
25,"25089",105,60,59,0,1,"VOX",0
16,"16017",366,294,294,2,0,"VOX",1
6,"6030",169,137,135,0,2,"VOX",0
14,"14075",572,448,428,1,20,"VOX",0
22,"22017",866,650,642,5,8,"VOX",0
16,"16018",394,318,315,1,3,"VOX",4
19,"19191",14,13,12,0,1,"VOX",0
46,"46150",1831,1341,1333,7,8,"VOX",0
45,"45097",1046,839,834,4,5,"VOX",1
6,"6032",68,53,53,1,0,"VOX",1
16,"16211",370,263,263,3,0,"VOX",1
33,"33003",646,355,352,9,3,"VOX",1
42,"42141",112,80,80,0,0,"VOX",1
3,"3036",87,81,78,0,3,"VOX",0
50,"50148",316,233,229,4,4,"VOX",0
25,"25177",368,226,226,0,0,"VOX",0
40,"40231",108,90,89,0,1,"VOX",0
6,"6033",1327,1011,1006,10,5,"VOX",3
19,"19074",72,62,62,0,0,"VOX",0
29,"29041",3175,2090,2045,24,45,"VOX",4
46,"46098",2482,1907,1889,11,18,"VOX",0
25,"25223",922,553,543,8,10,"VOX",1
18,"18159",995,797,795,2,2,"VOX",0
46,"46151",728,550,541,0,9,"VOX",2
50,"50149",34,24,24,0,0,"VOX",0
26,"26100",49,44,43,0,1,"VOX",0
39,"39088",69,52,52,0,0,"VOX",0
50,"50084",77,59,59,2,0,"VOX",0
10,"10016",330,237,235,0,2,"VOX",0
19,"19116",12,9,9,0,0,"VOX",0
22,"22182",250,161,158,1,3,"VOX",0
22,"22136",806,588,588,5,0,"VOX",1
9,"9281",145,114,109,1,5,"VOX",1
4,"4018",270,232,229,0,3,"VOX",0
18,"18067",702,469,466,0,3,"VOX",1
47,"47102",291,230,220,1,10,"VOX",0
24,"24142",25119,17336,17141,154,195,"VOX",36
29,"29043",2509,1608,1576,18,32,"VOX",5
39,"39028",3739,2850,2817,16,33,"VOX",4
9,"9377",632,485,480,1,5,"VOX",0
16,"16116",77,68,68,0,0,"VOX",0
24,"24074",97,75,75,1,0,"VOX",0
4,"4019",249,196,196,1,0,"VOX",0
24,"24211",272,205,205,2,0,"VOX",0
47,"47024",259,208,207,1,1,"VOX",0
30,"30027",48176,35521,35266,153,255,"VOX",105
21,"21062",1392,887,879,6,8,"VOX",1
48,"48039",239,190,188,0,2,"VOX",0
28,"28069",50,44,41,0,3,"VOX",0
46,"46205",14313,10932,10834,51,98,"VOX",23
14,"14022",4006,2977,2949,17,28,"VOX",2
42,"42148",10,10,10,1,0,"VOX",0
1,"1004",1399,1008,995,8,13,"VOX",0
10,"10019",1498,1063,1054,3,9,"VOX",3
9,"9464",35,27,27,0,0,"VOX",1
12,"12006",172,135,133,0,2,"VOX",0
50,"50086",187,132,128,2,4,"VOX",0
14,"14023",2021,1660,1639,8,21,"VOX",1
39,"39090",756,553,542,0,11,"VOX",1
18,"18164",1836,1146,1126,6,20,"VOX",2
24,"24010",8386,5708,5632,60,76,"VOX",23
47,"47186",246129,186191,184733,1198,1458,"VOX",626
19,"19079",8,8,7,0,1,"VOX",0
12,"12137",36,23,23,0,0,"VOX",0
40,"40109",73,59,59,1,0,"VOX",0
42,"42151",34,26,26,0,0,"VOX",0
25,"25227",652,402,400,4,2,"VOX",0
29,"29902",2567,1577,1559,11,18,"VOX",0
19,"19306",25,20,20,1,0,"VOX",0
50,"50184",115,85,85,0,0,"VOX",0
18,"18165",4123,2787,2758,18,29,"VOX",3
22,"22022",552,414,408,6,6,"VOX",0
28,"28043",5921,3803,3759,18,44,"VOX",18
28,"28111",596,467,467,3,0,"VOX",3
23,"23001",963,801,799,1,2,"VOX",3
45,"45204",632,488,487,1,1,"VOX",1
16,"16027",710,542,538,5,4,"VOX",0
47,"47026",46,40,40,1,0,"VOX",0
24,"24044",168,119,118,1,1,"VOX",0
9,"9155",27,20,20,0,0,"VOX",0
19,"19197",27,22,22,0,0,"VOX",0
9,"9337",117,92,91,0,1,"VOX",0
42,"42194",170,118,114,1,4,"VOX",0
40,"40196",30,25,25,0,0,"VOX",0
50,"50088",302,246,237,5,9,"VOX",0
22,"22189",185,145,144,5,1,"VOX",0
39,"39092",894,626,620,1,6,"VOX",1
45,"45004",567,410,406,1,4,"VOX",0
46,"46233",3860,2859,2817,10,42,"VOX",2
19,"19307",27,23,23,0,0,"VOX",0
10,"10161",76,53,53,0,0,"VOX",0
19,"19198",14,12,12,0,0,"VOX",0
28,"28113",34751,25832,25612,120,220,"VOX",88
29,"29070",40333,25991,25728,214,263,"VOX",60
45,"45005",238,193,192,3,1,"VOX",0
10,"10025",400,327,318,1,9,"VOX",1
6,"6043",665,490,484,2,6,"VOX",3
26,"26070",183,153,153,1,0,"VOX",0
18,"18122",16114,11098,10945,83,153,"VOX",8
40,"40157",47,44,44,0,0,"VOX",0
3,"3138",3145,2310,2275,9,35,"VOX",5
41,"41033",5075,3313,3277,34,36,"VOX",5
23,"23082",1921,1425,1416,8,9,"VOX",2
45,"45139",167,139,139,1,0,"VOX",0
16,"16170",692,501,493,4,8,"VOX",7
18,"18033",282,201,200,5,1,"VOX",0
25,"25103",135,76,76,4,0,"VOX",0
6,"6044",28875,19791,19616,145,175,"VOX",21
23,"23084",935,658,653,7,5,"VOX",4
41,"41001",1596,1183,1159,5,24,"VOX",1
50,"50188",28,25,25,0,0,"VOX",0
50,"50091",41,36,36,0,0,"VOX",0
47,"47054",635,507,495,9,12,"VOX",3
47,"47190",98,80,80,1,0,"VOX",0
12,"12011",4565,3331,3283,20,48,"VOX",4
16,"16032",278,224,221,1,3,"VOX",1
24,"24217",135,109,108,1,1,"VOX",0
3,"3075",147,128,128,0,0,"VOX",1
19,"19310",9,7,7,0,0,"VOX",0
10,"10027",77,69,69,1,0,"VOX",0
40,"40118",51,35,34,1,1,"VOX",0
19,"19088",79,61,61,0,0,"VOX",0
16,"16033",1714,1319,1305,6,14,"VOX",2
4,"4060",445,348,345,5,3,"VOX",0
50,"50219",4119,2833,2804,19,29,"VOX",10
10,"10075",253,167,166,1,1,"VOX",0
1,"1013",712,454,450,0,4,"VOX",0
22,"22149",305,228,228,0,0,"VOX",1
47,"47139",1040,777,767,6,10,"VOX",1
19,"19311",82,69,67,0,2,"VOX",0
28,"28146",1787,1205,1194,0,11,"VOX",3
3,"3140",26070,18999,18742,174,257,"VOX",41
40,"40033",58,51,51,0,0,"VOX",0
4,"4061",638,506,498,4,8,"VOX",0
9,"9389",73,60,60,1,0,"VOX",0
50,"50190",695,523,515,3,8,"VOX",0
14,"14001",3514,2837,2789,28,48,"VOX",2
26,"26183",64,49,49,0,0,"VOX",0
25,"25150",181,115,113,3,2,"VOX",0
46,"46159",22857,16840,16697,128,143,"VOX",25
10,"10030",465,309,309,1,0,"VOX",0
19,"19203",30,24,24,0,0,"VOX",0
12,"12013",144,121,119,0,2,"VOX",0
6,"6048",849,691,677,7,14,"VOX",1
22,"22029",127,100,100,0,0,"VOX",1
10,"10168",312,213,208,0,5,"VOX",0
18,"18175",11670,8200,8097,36,103,"VOX",10
45,"45009",524,344,341,2,3,"VOX",1
9,"9120",38,32,32,1,0,"VOX",0
50,"50160",2238,1546,1528,12,18,"VOX",1
23,"23008",1502,1144,1131,9,13,"VOX",1
3,"3078",478,389,389,5,0,"VOX",0
40,"40122",512,395,394,2,1,"VOX",0
10,"10169",531,420,409,2,11,"VOX",1
26,"26009",401,325,321,4,4,"VOX",1
47,"47193",1577,1251,1241,7,10,"VOX",5
45,"45043",793,657,649,1,8,"VOX",2
10,"10032",1681,1257,1237,5,20,"VOX",1
46,"46082",4918,3745,3712,33,33,"VOX",1
47,"47113",159,129,128,0,1,"VOX",0
16,"16038",38,31,31,0,0,"VOX",0
28,"28176",12491,9723,9667,37,56,"VOX",45
41,"41006",2740,1782,1768,14,14,"VOX",0
22,"22156",289,220,220,2,0,"VOX",1
16,"16039",392,261,254,1,7,"VOX",0
41,"41094",6288,4497,4449,38,48,"VOX",12
29,"29021",161,108,107,4,1,"VOX",0
15,"15091",1135,771,760,13,11,"VOX",0
24,"24184",198,118,117,0,1,"VOX",1
9,"9433",60,48,45,1,3,"VOX",0
6,"6143",3360,2353,2321,12,32,"VOX",3
28,"28088",261,178,178,0,0,"VOX",1
28,"28149",5759,4352,4310,25,42,"VOX",19
9,"9124",1506,1040,1028,6,12,"VOX",5
41,"41007",12341,8039,7844,103,195,"VOX",6
46,"46005",22918,16958,16827,102,131,"VOX",37
33,"33016",19130,13666,13526,125,140,"VOX",37
28,"28119",2092,1590,1582,12,8,"VOX",2
23,"23052",1125,936,922,4,14,"VOX",2
14,"14032",423,334,330,4,4,"VOX",0
9,"9394",715,533,521,3,12,"VOX",0
25,"25153",192,130,128,2,2,"VOX",0
50,"50004",522,390,388,0,2,"VOX",1
26,"26012",23,23,23,1,0,"VOX",0
10,"10036",329,241,238,1,3,"VOX",0
3,"3081",1436,1084,1075,5,9,"VOX",1
10,"10174",174,135,132,0,3,"VOX",0
42,"42206",8,8,8,1,0,"VOX",0
41,"41096",6161,4553,4476,32,77,"VOX",8
35,"35020",6034,3992,3934,20,58,"VOX",2
42,"42117",140,101,99,0,2,"VOX",1
39,"39010",631,480,475,7,5,"VOX",1
41,"41008",1059,749,739,10,10,"VOX",0
45,"45114",588,447,447,0,0,"VOX",0
25,"25114",98,72,72,0,0,"VOX",0
39,"39011",1585,1169,1160,5,9,"VOX",0
12,"12118",72,55,53,0,2,"VOX",0
42,"42207",40,33,32,0,1,"VOX",0
41,"41097",3137,2180,2134,18,46,"VOX",0
9,"9396",156,121,121,0,0,"VOX",1
50,"50287",270,191,191,0,0,"VOX",0
45,"45115",2552,1999,1966,8,33,"VOX",13
48,"48051",213,163,163,0,0,"VOX",0
19,"19211",369,289,284,0,5,"VOX",0
18,"18181",223,174,172,0,2,"VOX",0
10,"10038",87,68,68,0,0,"VOX",1
4,"4067",570,441,436,2,5,"VOX",0
16,"16043",95,73,73,1,0,"VOX",0
42,"42118",23,17,17,0,0,"VOX",0
50,"50288",3387,2415,2398,31,17,"VOX",5
25,"25203",8931,5003,4955,72,48,"VOX",3
11,"11031",76455,49854,49405,535,449,"VOX",146
40,"40043",1802,1400,1381,8,19,"VOX",1
16,"16044",39,30,30,0,0,"VOX",0
6,"6011",24723,16883,16718,137,165,"VOX",68
24,"24226",199,139,137,0,2,"VOX",1
50,"50100",329,246,241,1,5,"VOX",0
46,"46008",2651,2108,2089,21,19,"VOX",3
4,"4068",187,154,152,0,2,"VOX",0
39,"39043",1481,1122,1115,9,7,"VOX",4
9,"9904",478,374,370,5,4,"VOX",1
19,"19247",139,102,100,1,2,"VOX",1
39,"39013",511,402,399,4,3,"VOX",1
9,"9354",33,29,28,2,1,"VOX",0
10,"10178",769,565,553,3,12,"VOX",0
47,"47036",228,181,181,3,0,"VOX",0
3,"3084",539,454,446,3,8,"VOX",0
9,"9261",469,332,329,2,3,"VOX",1
46,"46165",7129,5436,5388,25,48,"VOX",12
10,"10041",1057,795,781,4,14,"VOX",5
19,"19325",121,83,82,0,1,"VOX",0
19,"19214",75,60,58,0,2,"VOX",0
21,"21002",15478,10597,10507,94,90,"VOX",16
40,"40172",39,34,34,0,0,"VOX",0
1,"1023",267,187,186,1,1,"VOX",0
30,"30012",9091,6962,6897,36,65,"VOX",10
9,"9130",74,51,50,1,1,"VOX",0
18,"18185",541,434,432,2,2,"VOX",2
18,"18047",5903,3893,3857,28,36,"VOX",8
29,"29028",1237,836,826,6,10,"VOX",1
3,"3085",272,217,213,0,4,"VOX",1
19,"19102",98,79,78,0,1,"VOX",0
9,"9007",57,39,39,0,0,"VOX",0
19,"19326",1841,1280,1272,1,8,"VOX",13
46,"46010",935,729,723,4,6,"VOX",3
46,"46140",344,284,279,0,5,"VOX",0
19,"19103",251,208,208,2,0,"VOX",0
25,"25075",117,72,72,2,0,"VOX",0
10,"10044",1428,1040,1025,5,15,"VOX",0
50,"50104",348,271,269,2,2,"VOX",0
4,"4006",7022,4792,4749,30,43,"VOX",2
22,"22119",1291,942,935,5,7,"VOX",1
30,"30901",10309,7821,7718,43,103,"VOX",20
46,"46115",378,286,282,1,4,"VOX",0
41,"41102",14655,10183,9919,142,264,"VOX",20
48,"48056",966,705,700,5,5,"VOX",0
12,"12025",136,104,104,0,0,"VOX",0
45,"45019",7377,5307,5251,37,56,"VOX",20
26,"26086",16,15,15,1,0,"VOX",0
10,"10183",980,733,728,1,5,"VOX",2
46,"46012",896,682,663,1,19,"VOX",0
42,"42124",64,49,49,0,0,"VOX",0
22,"22167",493,388,381,9,7,"VOX",0
6,"6064",841,666,656,2,10,"VOX",0
24,"24162",1683,1257,1246,13,11,"VOX",3
15,"15027",1536,1182,1155,6,27,"VOX",1
18,"18098",6135,4206,4161,21,45,"VOX",5
24,"24230",426,322,320,5,2,"VOX",0
40,"40007",78,63,61,0,2,"VOX",0
40,"40048",38,29,27,0,2,"VOX",0
24,"24163",3962,2950,2933,24,17,"VOX",5
11,"11037",5661,4347,4265,33,82,"VOX",2
14,"14039",2604,2062,2021,12,41,"VOX",1
50,"50233",106,81,81,0,0,"VOX",1
12,"12125",216,180,177,0,3,"VOX",0
24,"24901",889,636,623,5,13,"VOX",1
14,"14011",578,464,462,4,2,"VOX",0
9,"9268",95,68,66,0,2,"VOX",0
47,"47122",2032,1563,1535,7,28,"VOX",1
45,"45021",2500,1708,1665,12,43,"VOX",3
22,"22170",651,498,491,5,7,"VOX",1
1,"1031",1169,882,863,6,19,"VOX",3
46,"46013",17383,13569,13483,82,86,"VOX",35
46,"46091",118,94,94,0,0,"VOX",0
6,"6066",1762,1189,1182,2,7,"VOX",0
46,"46195",1962,1531,1516,11,15,"VOX",6
47,"47041",150,112,110,2,2,"VOX",0
9,"9409",111,86,86,4,0,"VOX",0
10,"10186",977,795,778,1,17,"VOX",2
29,"29033",1122,747,730,4,17,"VOX",0
18,"18193",14343,9951,9847,93,104,"VOX",32
10,"10049",3819,3031,2950,18,81,"VOX",2
42,"42129",681,503,495,3,8,"VOX",0
41,"41050",5150,3817,3777,19,40,"VOX",7
40,"40179",626,503,493,2,10,"VOX",3
18,"18054",849,606,605,7,1,"VOX",1
41,"41017",15158,10718,10616,92,102,"VOX",28
1,"1032",517,361,354,1,7,"VOX",0
22,"22047",243,205,203,2,2,"VOX",1
14,"14013",16796,11830,11616,129,214,"VOX",27
33,"33026",8530,5397,5337,48,60,"VOX",11
30,"30018",7978,5866,5811,30,55,"VOX",28
46,"46015",7244,5615,5560,40,55,"VOX",9
42,"42177",69,60,60,1,0,"VOX",0
45,"45058",375,311,304,1,7,"VOX",1
47,"47151",27,24,24,0,0,"VOX",0
42,"42084",25,22,22,1,0,"VOX",0
25,"25215",345,240,236,0,4,"VOX",1
23,"23905",1868,1277,1272,6,5,"VOX",0
47,"47125",58,46,46,0,0,"VOX",0
10,"10051",430,308,296,0,12,"VOX",0
30,"30019",25857,17544,17374,125,170,"VOX",66
48,"48061",762,565,561,0,4,"VOX",1
18,"18901",511,356,355,3,1,"VOX",0
16,"16202",769,564,558,0,6,"VOX",0
3,"3001",337,269,268,0,1,"VOX",0
50,"50016",52,40,40,0,0,"VOX",1
40,"40140",92,69,67,0,2,"VOX",0
41,"41019",4691,3089,3056,27,33,"VOX",8
19,"19222",110,82,82,0,0,"VOX",0
24,"24132",615,379,375,1,4,"VOX",0
24,"24032",109,91,89,0,2,"VOX",1
19,"19110",56,50,50,0,0,"VOX",0
40,"40013",62,49,48,0,1,"VOX",0
30,"30020",6303,4543,4497,25,46,"VOX",3
21,"21012",316,235,233,2,2,"VOX",0
25,"25086",522,346,341,2,5,"VOX",0
6,"6117",1424,960,938,4,22,"VOX",0
3,"3002",3605,2583,2557,15,26,"VOX",3
45,"45093",155,129,127,1,2,"VOX",0
18,"18903",889,669,661,5,8,"VOX",0
16,"16203",9972,7094,7007,34,87,"VOX",16
4,"4047",2281,1893,1878,11,15,"VOX",0
14,"14072",1048,806,795,6,11,"VOX",0
50,"50111",180,143,143,0,0,"VOX",1
14,"14016",1337,1072,1060,2,12,"VOX",0
15,"15034",2885,1782,1760,18,22,"VOX",3
22,"22176",173,134,130,1,4,"VOX",0
6,"6073",733,496,484,8,12,"VOX",0
9,"9189",125,90,87,2,3,"VOX",0
10,"10055",710,505,497,1,8,"VOX",1
45,"45027",346,275,272,0,3,"VOX",0
50,"50238",91,66,66,1,0,"VOX",0
24,"24068",457,344,340,0,4,"VOX",0
46,"46226",41,36,35,0,1,"VOX",0
46,"46044",4218,3222,3158,18,64,"VOX",6
9,"9372",212,176,176,4,0,"VOX",0
41,"41022",4290,2889,2851,21,38,"VOX",0
3,"3003",450,378,376,2,2,"VOX",0
10,"10056",586,457,452,4,5,"VOX",0
28,"28064",129,106,106,2,0,"VOX",0
40,"40016",58,49,49,0,0,"VOX",0
24,"24136",540,387,383,4,4,"VOX",0
1,"1039",209,155,153,0,2,"VOX",0
16,"16206",204,158,157,6,1,"VOX",1
42,"42046",49,39,39,0,0,"VOX",0
12,"12069",66,49,48,0,1,"VOX",0
15,"15036",57885,39471,39096,417,375,"VOX",67
46,"46018",608,515,511,0,4,"VOX",3
41,"41023",7905,5402,5347,41,55,"VOX",2
9,"9415",268,175,175,2,0,"VOX",2
50,"50115",3235,2128,2109,14,19,"VOX",4
6,"6076",831,611,607,2,4,"VOX",0
33,"33032",11395,7592,7465,90,127,"VOX",18
19,"19114",37,26,26,0,0,"VOX",0
21,"21017",3600,2187,2164,26,23,"VOX",4
12,"12132",480,396,389,3,7,"VOX",0
48,"48065",3281,2271,2237,8,34,"VOX",0
45,"45130",317,253,250,1,3,"VOX",1
46,"46097",963,733,728,4,5,"VOX",8
25,"25048",1651,1051,1040,11,11,"VOX",0
45,"45064",3858,2804,2763,20,41,"VOX",9
28,"28164",2993,2183,2168,8,15,"VOX",17
6,"6123",4627,3182,3120,18,62,"VOX",3
19,"19033",64,52,50,1,2,"VOX",0
16,"16064",684,568,562,4,6,"VOX",1
23,"23034",2540,1957,1934,14,23,"VOX",0
50,"50116",182,136,132,0,4,"VOX",0
50,"50021",30,21,21,0,0,"VOX",0
16,"16212",247,203,202,0,1,"VOX",0
30,"30024",58746,42036,41731,206,305,"VOX",103
26,"26030",16,16,15,0,1,"VOX",0
24,"24038",3089,2312,2273,17,39,"VOX",4
45,"45031",2723,1835,1822,12,13,"VOX",5
6,"6079",652,449,442,4,7,"VOX",0
50,"50211",249,176,173,0,3,"VOX",0
42,"42144",436,353,348,2,5,"VOX",1
19,"19036",263,229,229,0,0,"VOX",0
22,"22055",320,243,238,2,5,"VOX",0
41,"41026",4314,3380,3322,18,58,"VOX",1
18,"18909",579,435,429,0,6,"VOX",0
48,"48901",4839,3459,3426,32,33,"VOX",3
19,"19229",66,56,56,0,0,"VOX",0
9,"9329",121,87,87,1,0,"VOX",0
6,"6080",1924,1412,1392,9,20,"VOX",2
47,"47131",170,134,128,2,6,"VOX",1
47,"47212",380,323,322,2,1,"VOX",5
16,"16022",78,67,66,0,1,"VOX",0
12,"12083",93,79,76,0,3,"VOX",0
39,"39038",1452,997,990,8,7,"VOX",3
50,"50054",58,50,50,0,0,"VOX",0
14,"14021",260178,181773,180348,1872,1425,"VOX",384
22,"22137",1069,727,718,3,9,"VOX",1
6,"6081",1074,806,792,7,14,"VOX",0
10,"10201",173,142,142,2,0,"VOX",0
19,"19118",11,9,9,0,0,"VOX",0
41,"41028",2003,1524,1511,9,13,"VOX",16
9,"9196",149,103,103,1,0,"VOX",0
19,"19303",43,35,35,0,0,"VOX",0
42,"42190",89,65,64,0,1,"VOX",0
46,"46902",364,306,303,0,3,"VOX",1
22,"22186",181,130,129,1,1,"VOX",0
3,"3133",41576,25849,25639,127,210,"VOX",87
42,"42149",381,277,273,2,4,"VOX",0
9,"9283",44,32,31,0,1,"VOX",0
23,"23039",2204,1596,1558,11,38,"VOX",5
45,"45001",1835,1281,1251,3,30,"VOX",1
25,"25139",467,294,291,5,3,"VOX",0
24,"24144",695,470,465,2,5,"VOX",0
16,"16117",1040,787,777,4,10,"VOX",3
46,"46903",6065,4790,4763,18,27,"VOX",13
12,"12041",100,81,81,0,0,"VOX",0
19,"19266",236,188,188,1,0,"VOX",1
18,"18070",288,227,226,0,1,"VOX",1
45,"45035",281,212,209,1,3,"VOX",0
15,"15080",1756,1131,1117,11,14,"VOX",2
40,"40152",760,592,584,3,8,"VOX",5
3,"3102",7229,5492,5414,52,78,"VOX",10
18,"18071",5579,4044,3985,37,59,"VOX",5
9,"9154",137,98,97,2,1,"VOX",0
1,"1047",968,673,668,5,5,"VOX",1
50,"50120",52,40,40,1,0,"VOX",0
6,"6085",3428,2453,2414,25,39,"VOX",2
19,"19120",101,88,88,1,0,"VOX",0
10,"10205",2020,1319,1293,5,26,"VOX",1
39,"39031",1236,878,868,4,10,"VOX",1
14,"14024",1903,1405,1376,16,29,"VOX",3
50,"50215",24,19,19,0,0,"VOX",0
16,"16072",146,104,103,2,1,"VOX",0
39,"39061",3478,2695,2677,13,18,"VOX",5
47,"47079",58,48,47,0,1,"VOX",0
4,"4056",143,113,109,0,4,"VOX",0
42,"42152",78,55,55,0,0,"VOX",0
19,"19233",80,65,63,1,2,"VOX",0
23,"23002",17428,12820,12644,70,176,"VOX",28
48,"48072",977,716,713,4,3,"VOX",0
28,"28080",48554,38885,38691,164,194,"VOX",242
3,"3136",441,338,334,0,4,"VOX",0
40,"40112",2555,1932,1909,8,23,"VOX",8
19,"19163",56,41,40,0,1,"VOX",0
30,"30030",312993,231648,230185,1207,1463,"VOX",1144
3,"3012",1085,852,841,3,11,"VOX",1
40,"40156",322,238,235,1,3,"VOX",0
19,"19001",49,42,42,0,0,"VOX",0
25,"25143",84,56,55,0,1,"VOX",0
26,"26004",67,50,50,0,0,"VOX",0
16,"16074",37,30,30,1,0,"VOX",0
9,"9160",85,64,64,0,0,"VOX",0
42,"42154",97,69,69,1,0,"VOX",0
12,"12140",1143,939,930,6,9,"VOX",2
9,"9201",28,18,18,1,0,"VOX",0
39,"39033",568,418,415,2,3,"VOX",0
10,"10117",255,135,134,0,1,"VOX",0
16,"16228",172,137,137,4,0,"VOX",0
19,"19165",47,41,41,0,0,"VOX",0
12,"12141",101,83,83,0,0,"VOX",0
42,"42021",83,55,55,3,0,"VOX",0
30,"30002",9903,7011,6943,28,68,"VOX",11
33,"33011",11260,6250,6163,83,87,"VOX",7
24,"24216",723,522,518,1,4,"VOX",1
50,"50218",113,91,91,1,0,"VOX",0
48,"48074",3312,2330,2309,6,21,"VOX",3
25,"25019",4572,2726,2698,34,28,"VOX",3
29,"29072",3262,2382,2352,17,30,"VOX",1
50,"50298",5333,3949,3902,39,47,"VOX",19
10,"10072",859,617,615,5,2,"VOX",0
21,"21030",1830,1452,1430,13,22,"VOX",5
14,"14027",7925,5836,5746,58,90,"VOX",2
45,"45141",884,700,689,3,11,"VOX",1
45,"45040",1349,846,838,4,8,"VOX",2
40,"40031",526,398,396,2,2,"VOX",2
9,"9295",61,44,44,0,0,"VOX",0
41,"41035",1108,794,780,7,14,"VOX",0
25,"25148",219,124,124,0,0,"VOX",0
21,"21071",203,157,153,4,4,"VOX",1
23,"23085",2252,1655,1644,6,11,"VOX",1
45,"45008",139,118,118,1,0,"VOX",0
33,"33043",683,446,441,2,5,"VOX",0
18,"18173",8939,5922,5849,42,73,"VOX",8
9,"9478",41,32,32,1,0,"VOX",0
24,"24151",478,353,352,1,1,"VOX",0
40,"40075",160,139,139,0,0,"VOX",0
48,"48076",308,218,217,2,1,"VOX",0
25,"25193",759,485,480,2,5,"VOX",1
28,"28174",1795,1232,1221,7,11,"VOX",4
21,"21072",10262,7442,7307,85,135,"VOX",8
50,"50220",40,32,32,0,0,"VOX",0
42,"42158",103,76,76,0,0,"VOX",0
21,"21032",1800,1286,1259,10,27,"VOX",0
40,"40076",6492,4768,4700,26,68,"VOX",10
41,"41036",3941,2674,2642,23,32,"VOX",1
22,"22066",702,502,498,7,4,"VOX",2
10,"10213",566,469,463,0,6,"VOX",2
23,"23048",870,619,613,1,6,"VOX",1
18,"18083",247,200,196,0,4,"VOX",1
50,"50252",5138,3642,3611,24,31,"VOX",11
46,"46107",1900,1516,1504,5,12,"VOX",0
24,"24051",423,309,307,0,2,"VOX",0
50,"50903",2214,1602,1585,8,17,"VOX",4
29,"29053",1699,1105,1091,14,14,"VOX",1
15,"15089",4291,3020,2972,28,48,"VOX",2
21,"21034",1188,798,786,8,12,"VOX",5
15,"15052",4314,2889,2838,21,51,"VOX",4
9,"9302",112,83,83,1,0,"VOX",0
9,"9036",37,31,30,1,1,"VOX",0
50,"50128",26,25,25,1,0,"VOX",0
18,"18132",3291,2524,2494,9,30,"VOX",0
46,"46134",2357,1725,1712,14,13,"VOX",7
24,"24062",139,98,98,1,0,"VOX",0
19,"19145",46,41,41,1,0,"VOX",0
41,"41038",100095,67313,66687,760,626,"VOX",130
24,"24053",442,286,280,1,6,"VOX",0
19,"19242",87,65,65,1,0,"VOX",0
24,"24154",1005,673,666,4,7,"VOX",0
47,"47221",111,94,94,0,0,"VOX",0
14,"14031",593,469,459,3,10,"VOX",0
4,"4063",1096,776,768,2,8,"VOX",2
28,"28148",85454,62367,61884,370,483,"VOX",194
50,"50162",146,109,105,4,4,"VOX",0
45,"45045",1318,905,888,5,17,"VOX",0
33,"33045",4487,3057,2999,28,58,"VOX",4
25,"25067",719,467,460,7,7,"VOX",0
16,"16132",35,27,26,0,1,"VOX",0
19,"19130",60145,45531,45085,286,446,"VOX",210
47,"47059",97,76,76,2,0,"VOX",1
50,"50223",920,712,701,4,11,"VOX",0
40,"40037",41,29,29,0,0,"VOX",0
14,"14060",4868,3473,3412,41,61,"VOX",1
45,"45080",6,6,6,0,0,"VOX",0
33,"33047",1107,852,843,9,9,"VOX",2
28,"28051",1541,1163,1149,1,14,"VOX",10
45,"45012",661,510,503,6,7,"VOX",1
33,"33027",834,506,498,4,8,"VOX",0
10,"10082",1868,1451,1412,11,39,"VOX",1
47,"47115",281,236,233,3,3,"VOX",4
25,"25155",647,421,418,0,3,"VOX",0
47,"47223",157,122,118,2,4,"VOX",1
4,"4065",363,284,282,7,2,"VOX",1
18,"18180",633,410,410,3,0,"VOX",0
29,"29057",357,241,238,1,3,"VOX",0
10,"10901",1174,752,741,4,11,"VOX",3
40,"40166",253,218,215,1,3,"VOX",0
47,"47060",258,216,214,1,2,"VOX",0
40,"40040",2607,1843,1828,19,15,"VOX",3
24,"24089",102747,74428,73688,631,740,"VOX",234
16,"16042",1157,933,921,4,12,"VOX",0
19,"19245",1155,855,835,5,20,"VOX",2
47,"47144",78,64,64,1,0,"VOX",0
33,"33049",6322,4116,4062,43,54,"VOX",5
9,"9043",192,137,133,1,4,"VOX",0
26,"26014",474,327,324,1,3,"VOX",2
15,"15056",5722,3869,3818,46,51,"VOX",5
25,"25070",823,554,549,15,5,"VOX",0
4,"4097",248,189,189,1,0,"VOX",0
24,"24090",343,235,233,1,2,"VOX",0
30,"30040",732,617,607,2,10,"VOX",4
40,"40041",979,725,717,5,8,"VOX",3
6,"6102",1048,843,825,6,18,"VOX",2
42,"42031",26,21,21,0,0,"VOX",0
47,"47197",876,673,668,8,5,"VOX",2
24,"24023",263,188,188,1,0,"VOX",0
46,"46086",82,70,69,1,1,"VOX",0
50,"50197",90,67,67,2,0,"VOX",0
19,"19135",107,90,90,3,0,"VOX",0
26,"26119",197,156,155,4,1,"VOX",0
46,"46112",536,455,450,2,5,"VOX",1
47,"47089",148,125,124,0,1,"VOX",0
19,"19053",2008,1422,1404,10,18,"VOX",5
4,"4003",17357,11157,11075,64,82,"VOX",9
12,"12090",102,86,85,1,1,"VOX",1
47,"47226",156,123,123,0,0,"VOX",0
6,"6059",1851,1268,1258,7,10,"VOX",1
42,"42167",251,175,172,2,3,"VOX",0
26,"26120",1454,1139,1126,7,13,"VOX",0
16,"16247",67,58,58,0,0,"VOX",0
3,"3117",362,318,313,2,5,"VOX",0
29,"29083",2107,1540,1512,9,28,"VOX",0
46,"46035",6822,5202,5142,43,60,"VOX",10
3,"3024",3901,3067,3024,11,43,"VOX",11
25,"25205",566,382,372,8,10,"VOX",1
9,"9175",127,94,93,2,1,"VOX",0
45,"45185",7700,5771,5691,20,80,"VOX",10
42,"42168",107,80,80,0,0,"VOX",0
16,"16248",859,654,636,5,18,"VOX",9
48,"48084",22449,14670,14553,90,117,"VOX",23
23,"23057",766,625,619,4,6,"VOX",0
6,"6106",423,274,272,5,2,"VOX",0
9,"9047",54,47,46,1,1,"VOX",0
11,"11001",4358,2816,2767,11,49,"VOX",4
47,"47227",61,50,50,0,0,"VOX",0
3,"3025",1270,950,941,2,9,"VOX",4
28,"28182",210,171,169,0,2,"VOX",1
45,"45085",1500,1011,999,4,12,"VOX",4
28,"28056",863,630,617,4,13,"VOX",1
40,"40214",208,168,168,2,0,"VOX",0
12,"12024",143,125,124,0,1,"VOX",1
29,"29085",144,109,108,0,1,"VOX",0
45,"45152",587,458,451,0,7,"VOX",0
28,"28125",3002,2180,2163,11,17,"VOX",11
33,"33022",893,578,567,11,11,"VOX",3
6,"6016",2986,2114,2078,14,36,"VOX",3
47,"47119",92,80,79,1,1,"VOX",1
9,"9048",1467,1048,1033,13,15,"VOX",2
47,"47228",440,331,331,2,0,"VOX",2
26,"26122",118,102,102,0,0,"VOX",0
47,"47065",857,674,669,1,5,"VOX",1
24,"24161",285,203,201,3,2,"VOX",0
28,"28183",1039,743,735,2,8,"VOX",4
45,"45153",1615,1258,1243,7,15,"VOX",3
25,"25036",184,112,111,4,1,"VOX",0
23,"23060",19003,12924,12812,102,112,"VOX",23
3,"3027",157,138,135,0,3,"VOX",0
18,"18188",1653,1183,1175,5,8,"VOX",0
46,"46038",327,242,242,3,0,"VOX",0
18,"18050",1710,1165,1152,3,13,"VOX",3
45,"45020",1290,1037,1026,6,11,"VOX",4
21,"21005",15523,9038,8913,56,125,"VOX",16
12,"12094",847,674,665,5,9,"VOX",1
16,"16146",83,57,57,0,0,"VOX",0
19,"19217",54,40,39,0,1,"VOX",0
14,"14067",3889,2946,2899,29,47,"VOX",11
19,"19289",28,25,24,1,1,"VOX",0
11,"11005",4583,3018,2967,25,51,"VOX",1
45,"45055",1020,821,790,6,31,"VOX",1
42,"42037",33,25,25,2,0,"VOX",0
16,"16066",2325,1788,1745,19,43,"VOX",1
25,"25240",1383,925,919,16,6,"VOX",1
45,"45155",355,291,285,0,6,"VOX",0
46,"46117",495,402,399,5,3,"VOX",0
48,"48088",136,102,102,0,0,"VOX",0
47,"47066",1268,981,977,12,4,"VOX",1
28,"28157",609,433,430,1,3,"VOX",1
42,"42218",82,55,55,0,0,"VOX",2
26,"26055",39,32,32,0,0,"VOX",0
25,"25211",680,386,379,4,7,"VOX",0
3,"3059",20583,15125,15018,63,107,"VOX",58
47,"47176",219,139,139,1,0,"VOX",0
50,"50234",243,189,185,6,4,"VOX",1
42,"42175",21,16,16,0,0,"VOX",0
6,"6113",2721,2004,1971,7,33,"VOX",3
9,"9091",724,500,490,4,10,"VOX",0
6,"6159",2329,1351,1318,16,33,"VOX",1
46,"46255",3174,2448,2424,22,24,"VOX",5
24,"24165",354,240,238,2,2,"VOX",0
26,"26022",198,164,163,1,1,"VOX",0
47,"47231",4401,3299,3277,24,22,"VOX",10
40,"40094",374,279,276,2,3,"VOX",1
48,"48090",6001,4345,4295,28,50,"VOX",3
9,"9317",19,16,16,0,0,"VOX",0
23,"23904",2796,1825,1798,8,27,"VOX",6
25,"25053",1055,671,661,7,10,"VOX",0
46,"46093",2118,1647,1624,4,23,"VOX",0
24,"24166",1407,1013,993,8,20,"VOX",2
40,"40012",269,192,191,2,1,"VOX",2
4,"4045",1757,1309,1288,6,21,"VOX",2
12,"12097",63,49,49,0,0,"VOX",0
39,"39081",437,337,332,4,5,"VOX",0
24,"24098",1193,842,831,11,11,"VOX",2
15,"15069",6745,4910,4850,43,60,"VOX",9
11,"11041",9866,6477,6402,69,75,"VOX",6
9,"9318",61,41,41,0,0,"VOX",0
23,"23066",4347,3465,3410,15,55,"VOX",6
24,"24065",2138,1503,1472,15,31,"VOX",6
45,"45158",2514,1777,1760,11,17,"VOX",0
16,"16104",51,41,41,0,0,"VOX",0
14,"14043",7574,5515,5443,81,72,"VOX",5
40,"40055",37,26,26,0,0,"VOX",0
45,"45060",173,126,125,1,1,"VOX",0
46,"46120",1113,903,875,2,28,"VOX",0
45,"45025",1205,831,827,2,4,"VOX",0
16,"16153",949,778,772,7,6,"VOX",0
41,"41054",692,560,546,3,14,"VOX",1
9,"9321",1626,1238,1227,8,11,"VOX",3
48,"48001",5838,3923,3898,28,25,"VOX",2
47,"47070",37,27,27,0,0,"VOX",0
39,"39022",980,721,713,2,8,"VOX",0
50,"50176",236,165,165,3,0,"VOX",0
23,"23067",2460,1831,1805,11,26,"VOX",5
46,"46199",5718,4314,4266,28,48,"VOX",7
16,"16107",109,86,85,1,1,"VOX",0
12,"12100",1333,1065,1047,10,18,"VOX",4
14,"14044",1604,1172,1165,7,7,"VOX",4
46,"46258",2652,2084,2062,16,22,"VOX",4
26,"26060",84,62,62,2,0,"VOX",0
45,"45094",387,298,297,1,1,"VOX",1
40,"40057",1456,1154,1148,7,6,"VOX",2
50,"50048",34,29,29,0,0,"VOX",0
50,"50146",187,145,144,3,1,"VOX",0
9,"9190",86,58,56,0,2,"VOX",0
50,"50050",98,64,64,2,0,"VOX",0
19,"19152",556,390,382,1,8,"VOX",3
6,"6120",3389,2502,2478,12,24,"VOX",0
9,"9454",43,34,33,0,1,"VOX",0
50,"50177",308,245,244,4,1,"VOX",1
33,"33061",378,202,200,0,2,"VOX",0
9,"9141",616,485,483,5,2,"VOX",2
4,"4049",5313,3620,3579,18,41,"VOX",2
25,"25175",186,117,117,1,0,"VOX",0
16,"16110",93,70,70,0,0,"VOX",0
40,"40058",325,277,276,4,1,"VOX",0
42,"42048",66,51,51,0,0,"VOX",0
50,"50240",1025,729,718,10,11,"VOX",2
24,"24069",41,35,35,0,0,"VOX",0
33,"33062",400,238,233,2,5,"VOX",0
50,"50147",777,552,552,2,0,"VOX",0
40,"40186",42,29,29,0,0,"VOX",0
19,"19261",37,25,24,0,1,"VOX",0
25,"25176",309,216,211,1,5,"VOX",0
46,"46045",1249,1028,1010,3,18,"VOX",0
21,"21058",2609,1883,1856,23,27,"VOX",0
39,"39055",1086,824,816,6,8,"VOX",7
4,"4016",2138,1551,1536,9,15,"VOX",1
50,"50179",249,214,213,2,1,"VOX",0
28,"28038",4952,3730,3688,34,42,"VOX",9
25,"25909",148,93,92,2,1,"VOX",0
25,"25009",627,444,440,8,4,"VOX",0
19,"19034",22,16,16,0,0,"VOX",0
18,"18111",2765,1949,1936,18,13,"VOX",4
24,"24172",418,255,250,2,5,"VOX",0
48,"48096",6577,4794,4728,31,66,"VOX",5
41,"41058",17395,12556,12332,111,224,"VOX",25
48,"48097",1297,900,894,8,6,"VOX",0
18,"18158",8358,5096,5031,28,65,"VOX",3
9,"9374",90,71,70,1,1,"VOX",0
47,"47022",59,50,49,0,1,"VOX",0
28,"28039",128,98,97,2,1,"VOX",0
45,"45065",271,207,206,1,1,"VOX",0
18,"18114",609,424,422,8,2,"VOX",0
15,"15039",1263,889,875,7,14,"VOX",1
3,"3131",175,154,147,0,7,"VOX",0
40,"40062",60,51,48,0,3,"VOX",0
35,"35008",6131,4507,4459,34,48,"VOX",10
50,"50181",993,733,720,5,13,"VOX",4
9,"9023",1102,818,811,11,7,"VOX",3
26,"26031",106,83,83,0,0,"VOX",0
46,"46099",901,689,684,1,5,"VOX",1
25,"25050",3233,1936,1912,25,24,"VOX",3
15,"15040",2753,1905,1880,5,25,"VOX",1
25,"25010",211,113,113,2,0,"VOX",2
45,"45010",415,311,310,2,1,"VOX",0
16,"16147",64,45,45,0,0,"VOX",0
41,"41071",5586,3724,3661,22,63,"VOX",4
23,"23037",502,404,400,6,4,"VOX",0
9,"9024",156,112,110,1,2,"VOX",1
48,"48902",19008,12566,12447,76,119,"VOX",7
47,"47159",822,644,636,1,8,"VOX",0
33,"33066",42963,28564,28282,300,282,"VOX",66
26,"26138",4588,3290,3247,15,43,"VOX",4
19,"19194",98,69,69,1,0,"VOX",0
23,"23038",3587,2794,2770,16,24,"VOX",4
50,"50275",108,55,55,0,0,"VOX",0
28,"28167",8356,6158,6106,46,52,"VOX",15
46,"46100",286,232,230,1,2,"VOX",0
46,"46109",6150,4625,4556,25,69,"VOX",7
50,"50024",571,437,437,6,0,"VOX",0
25,"25181",172,123,120,4,3,"VOX",1
24,"24076",1277,956,947,4,9,"VOX",0
3,"3039",81,62,61,1,1,"VOX",0
19,"19038",28,24,23,0,1,"VOX",0
28,"28138",60,46,46,0,0,"VOX",0
3,"3101",4808,3627,3580,22,47,"VOX",6
18,"18117",506,383,373,1,10,"VOX",0
46,"46153",439,355,351,1,4,"VOX",0
9,"9447",44,41,41,0,0,"VOX",0
50,"50245",88,65,64,0,1,"VOX",0
22,"22021",1971,1414,1398,17,16,"VOX",3
22,"22139",79,64,64,1,0,"VOX",0
16,"16218",191,150,150,3,0,"VOX",0
9,"9199",92,72,71,1,1,"VOX",0
47,"47160",425,308,303,0,5,"VOX",2
40,"40194",39602,29382,29042,206,340,"VOX",115
6,"6130",195,164,158,0,6,"VOX",0
42,"42193",14,10,10,0,0,"VOX",0
48,"48904",3511,2625,2600,22,25,"VOX",1
47,"47104",2836,2182,2121,19,61,"VOX",4
9,"9466",129,97,97,1,0,"VOX",1
19,"19268",35,24,24,1,0,"VOX",0
47,"47161",3918,3145,3126,12,19,"VOX",16
9,"9335",88,68,68,0,0,"VOX",0
24,"24177",476,325,322,3,3,"VOX",2
10,"10022",427,349,341,0,8,"VOX",0
40,"40154",20,15,15,0,0,"VOX",0
47,"47215",53,45,45,0,0,"VOX",0
6,"6040",1009,648,645,1,3,"VOX",0
33,"33069",3491,2430,2390,17,40,"VOX",6
40,"40028",105,91,90,2,1,"VOX",0
48,"48905",2553,1792,1771,12,21,"VOX",0
24,"24214",656,490,485,3,5,"VOX",1
15,"15007",3303,2262,2246,15,16,"VOX",2
1,"1008",786,513,509,11,4,"VOX",2
16,"16167",316,249,244,1,5,"VOX",0
16,"16122",249,188,187,0,1,"VOX",0
28,"28170",2472,1640,1622,13,18,"VOX",4
48,"48012",2049,1527,1512,7,15,"VOX",0
11,"11021",6764,4434,4362,52,72,"VOX",6
4,"4088",2454,1660,1650,15,10,"VOX",5
9,"9471",149,114,114,1,0,"VOX",1
26,"26143",220,175,173,1,2,"VOX",1
50,"50155",103,80,78,0,2,"VOX",0
6,"6134",547,335,332,1,3,"VOX",0
42,"42058",113,92,89,0,3,"VOX",1
47,"47053",119,98,96,0,2,"VOX",0
47,"47135",83,72,72,2,0,"VOX",1
45,"45038",3356,2376,2350,15,26,"VOX",16
46,"46208",1112,887,881,4,6,"VOX",1
50,"50187",69,44,44,0,0,"VOX",0
46,"46078",28017,20288,20143,132,145,"VOX",27
9,"9114",86,66,66,0,0,"VOX",0
40,"40199",105,84,84,0,0,"VOX",0
50,"50156",215,181,178,2,3,"VOX",0
45,"45039",224,192,190,0,2,"VOX",0
15,"15085",3332,2280,2247,25,33,"VOX",1
6,"6135",1092,846,828,0,18,"VOX",0
6,"6136",1565,1131,1102,11,29,"VOX",3
10,"10163",350,293,290,2,3,"VOX",2
45,"45173",9520,6938,6864,30,74,"VOX",21
42,"42197",75,58,56,0,2,"VOX",0
42,"42060",38,21,19,1,2,"VOX",0
9,"9473",85,70,65,1,5,"VOX",0
46,"46157",2980,2321,2298,10,23,"VOX",10
4,"4090",304,238,234,0,4,"VOX",0
28,"28084",15859,11156,11058,64,98,"VOX",32
9,"9206",59,45,45,0,0,"VOX",1
9,"9072",316,242,241,0,1,"VOX",0
15,"15086",2869,1970,1950,13,20,"VOX",2
9,"9117",76,60,60,0,0,"VOX",0
33,"33012",5201,3466,3432,25,34,"VOX",4
26,"26007",511,384,375,0,9,"VOX",1
46,"46158",1026,811,795,6,16,"VOX",3
42,"42157",13,10,10,0,0,"VOX",0
28,"28019",1233,893,885,4,8,"VOX",4
19,"19004",67,53,53,1,0,"VOX",0
16,"16128",63,50,50,0,0,"VOX",0
45,"45175",664,545,543,5,2,"VOX",0
50,"50031",154,93,93,0,0,"VOX",0
46,"46028",387,330,328,3,2,"VOX",0
29,"29074",794,586,581,0,5,"VOX",0
19,"19046",21588,15689,15515,82,174,"VOX",72
24,"24182",416,294,290,2,4,"VOX",0
28,"28116",704,528,523,2,5,"VOX",5
12,"12901",3405,2626,2598,23,28,"VOX",2
45,"45109",2883,2271,2214,9,57,"VOX",5
40,"40121",280,226,218,3,8,"VOX",0
15,"15013",6151,4237,4189,48,48,"VOX",3
16,"16906",80,67,67,1,0,"VOX",0
22,"22151",93,64,64,1,0,"VOX",0
12,"12082",9617,7324,7231,46,93,"VOX",23
47,"47005",549,413,408,2,5,"VOX",2
16,"16130",571,450,448,1,2,"VOX",0
23,"23088",6089,4558,4472,34,86,"VOX",4
24,"24116",417,314,309,1,5,"VOX",1
40,"40203",899,722,715,4,7,"VOX",3
9,"9480",110,90,90,1,0,"VOX",2
28,"28117",104,89,89,1,0,"VOX",0
24,"24219",516,387,386,4,1,"VOX",1
42,"42111",303,229,227,2,2,"VOX",2
19,"19317",139,110,109,1,1,"VOX",0
4,"4008",505,423,417,5,6,"VOX",0
10,"10061",1628,1055,1035,8,20,"VOX",1
40,"40218",92,65,64,1,1,"VOX",0
11,"11027",67913,45219,44833,454,386,"VOX",132
47,"47006",190,136,135,1,1,"VOX",1
19,"19279",57,55,55,0,0,"VOX",0
3,"3048",4847,3719,3683,20,36,"VOX",20
15,"15090",1179,812,804,9,8,"VOX",0
24,"24086",270,223,218,0,5,"VOX",1
16,"16910",91,69,69,1,0,"VOX",0
21,"21076",2121,1458,1437,17,21,"VOX",0
25,"25112",273,192,188,4,4,"VOX",0
9,"9213",307,220,218,2,2,"VOX",1
26,"26044",52,46,46,0,0,"VOX",0
40,"40205",261,202,198,2,4,"VOX",0
46,"46187",1306,1017,1000,0,17,"VOX",1
25,"25901",293,202,202,7,0,"VOX",0
22,"22111",154,103,102,0,1,"VOX",0
12,"12085",4976,3236,3209,16,27,"VOX",11
50,"50254",180,118,116,1,2,"VOX",0
21,"21077",1711,1224,1202,3,22,"VOX",3
39,"39070",144,96,94,2,2,"VOX",0
4,"4031",2338,1772,1762,2,10,"VOX",1
19,"19321",39,30,30,1,0,"VOX",0
6,"6007",1475,1038,1032,1,6,"VOX",0
39,"39009",3216,2366,2337,17,29,"VOX",9
10,"10111",1325,970,949,2,21,"VOX",1
42,"42041",34,25,25,0,0,"VOX",0
18,"18087",184857,134428,133526,864,902,"VOX",379
12,"12052",578,452,435,3,17,"VOX",0
22,"22113",495,370,368,4,2,"VOX",0
18,"18135",4568,3009,2961,14,48,"VOX",6
24,"24088",1029,791,789,10,2,"VOX",1
9,"9215",368,256,256,2,0,"VOX",1
39,"39071",397,261,256,1,5,"VOX",0
42,"42069",1536,1036,1019,6,17,"VOX",3
33,"33017",3144,2094,2071,35,23,"VOX",2
41,"41041",9706,7239,7120,36,119,"VOX",11
19,"19210",21,19,18,1,1,"VOX",0
6,"6146",1084,838,830,1,8,"VOX",0
19,"19133",83,72,72,0,0,"VOX",0
3,"3021",5613,4570,4500,26,70,"VOX",7
39,"39072",344,198,196,2,2,"VOX",0
42,"42070",34,27,26,1,1,"VOX",0
50,"50068",1982,1348,1335,8,13,"VOX",0
23,"23094",3839,3009,2954,14,55,"VOX",3
47,"47088",103,86,85,1,1,"VOX",0
46,"46007",11989,8784,8711,67,73,"VOX",13
46,"46111",10930,7931,7828,44,103,"VOX",15
9,"9258",172,141,139,5,2,"VOX",0
6,"6056",479,407,399,1,8,"VOX",2
19,"19052",25,21,21,1,0,"VOX",0
18,"18002",553,395,393,1,2,"VOX",0
19,"19175",32,28,28,0,0,"VOX",0
10,"10131",12861,8813,8721,52,92,"VOX",19
16,"16092",158,125,125,1,0,"VOX",1
29,"29059",2587,1965,1922,14,43,"VOX",1
50,"50227",109,79,79,0,0,"VOX",0
29,"29060",692,510,508,1,2,"VOX",0
18,"18182",1906,1298,1288,4,10,"VOX",11
9,"9259",230,186,186,5,0,"VOX",1
50,"50196",107,87,86,0,1,"VOX",1
30,"30010",6869,5194,5142,21,52,"VOX",17
6,"6057",576,479,471,0,8,"VOX",5
26,"26048",22,22,22,0,0,"VOX",0
23,"23056",3088,2243,2203,15,40,"VOX",4
28,"28026",6317,4734,4701,33,33,"VOX",31
50,"50289",51,38,38,0,0,"VOX",0
22,"22163",425,360,355,0,5,"VOX",3
30,"30011",4697,3421,3383,15,38,"VOX",12
50,"50101",864,603,597,8,6,"VOX",2
22,"22041",163,134,134,1,0,"VOX",0
28,"28123",57078,45270,44992,215,278,"VOX",115
24,"24092",798,606,602,1,4,"VOX",2
26,"26155",160,132,132,0,0,"VOX",0
41,"41100",1013,692,673,6,19,"VOX",1
40,"40212",27,23,22,2,1,"VOX",0
16,"16046",245,180,180,1,0,"VOX",0
9,"9905",384,279,279,2,0,"VOX",1
24,"24191",108,79,79,0,0,"VOX",0
42,"42212",69,43,43,1,0,"VOX",1
39,"39075",137376,99899,99048,718,851,"VOX",304
22,"22117",2478,1714,1693,22,21,"VOX",1
12,"12091",177,113,112,0,1,"VOX",0
35,"35023",11686,8212,8076,55,136,"VOX",6
19,"19055",52,41,41,1,0,"VOX",1
28,"28093",2096,1670,1653,10,17,"VOX",9
21,"21003",690,471,458,6,13,"VOX",0
42,"42123",164,117,116,4,1,"VOX",0
26,"26157",296,241,237,4,4,"VOX",0
15,"15023",6419,4348,4261,36,87,"VOX",6
24,"24093",360,249,248,2,1,"VOX",0
30,"30013",7396,5147,5102,32,45,"VOX",8
16,"16143",16,14,14,2,0,"VOX",1
50,"50072",170,125,125,0,0,"VOX",1
19,"19142",265,182,180,3,2,"VOX",0
46,"46011",7609,5249,5191,26,58,"VOX",8
16,"16097",156,124,121,0,3,"VOX",0
47,"47199",80,63,63,0,0,"VOX",0
9,"9358",255,194,190,3,4,"VOX",1
47,"47092",110,87,87,0,0,"VOX",1
46,"46219",127,112,112,1,0,"VOX",0
40,"40088",284,228,224,0,4,"VOX",0
19,"19179",69,56,56,1,0,"VOX",1
16,"16145",450,363,361,5,2,"VOX",1
50,"50170",371,283,280,0,3,"VOX",0
25,"25209",1495,995,978,9,17,"VOX",3
18,"18144",781,567,558,4,9,"VOX",4
33,"33054",1682,1159,1149,12,10,"VOX",1
28,"28107",457,312,312,0,0,"VOX",1
41,"41015",5297,3478,3405,41,73,"VOX",6
25,"25037",375,247,246,5,1,"VOX",0
12,"12124",1840,1387,1381,33,6,"VOX",3
41,"41901",2682,2107,2086,28,21,"VOX",0
3,"3089",9571,6775,6639,47,136,"VOX",1
9,"9088",66,45,45,0,0,"VOX",0
9,"9050",68,56,55,1,1,"VOX",1
46,"46142",787,619,602,1,17,"VOX",0
45,"45189",599,470,462,2,8,"VOX",3
10,"10139",114,82,78,1,4,"VOX",0
42,"42217",31,25,24,0,1,"VOX",0
45,"45132",2197,1645,1632,14,13,"VOX",2
28,"28147",963,722,720,5,2,"VOX",3
14,"14058",7970,5491,5417,66,74,"VOX",11
39,"39018",4220,3264,3204,35,60,"VOX",3
22,"22250",353,261,258,4,3,"VOX",0
23,"23025",2802,2056,2037,9,19,"VOX",1
25,"25254",728,457,451,2,6,"VOX",0
14,"14012",6173,4364,4291,35,73,"VOX",3
9,"9134",221,161,156,7,5,"VOX",0
16,"16051",142,120,119,0,1,"VOX",0
18,"18011",4335,3037,3015,20,22,"VOX",5
14,"14068",538,401,398,10,3,"VOX",0
9,"9269",36,26,26,1,0,"VOX",0
25,"25079",299,198,193,2,5,"VOX",0
6,"6021",926,645,636,8,9,"VOX",1
40,"40219",587,455,444,5,11,"VOX",2
9,"9483",211,158,157,0,1,"VOX",0
26,"26091",161,146,146,0,0,"VOX",0
14,"14069",7524,5460,5392,43,68,"VOX",2
10,"10004",704,492,482,9,10,"VOX",0
28,"28903",33082,27065,26922,154,143,"VOX",157
22,"22126",88,64,64,0,0,"VOX",0
50,"50076",78,66,65,0,1,"VOX",0
50,"50295",48,43,42,0,1,"VOX",0
18,"18013",4218,3024,2986,15,38,"VOX",2
25,"25081",308,189,189,2,0,"VOX",0
29,"29077",199,149,146,2,3,"VOX",0
29,"29901",43826,29318,29107,250,211,"VOX",75
33,"33057",1593,1063,1049,16,14,"VOX",5
15,"15031",23348,16380,16235,191,145,"VOX",20
26,"26023",469,358,354,0,4,"VOX",0
25,"25002",482,316,314,2,2,"VOX",0
45,"45125",2305,1865,1841,8,24,"VOX",3
12,"12127",75,55,55,0,0,"VOX",0
47,"47095",38,31,31,0,0,"VOX",0
22,"22012",111,87,86,3,1,"VOX",0
22,"22084",535,403,399,4,4,"VOX",3
45,"45192",2491,2069,2049,2,20,"VOX",2
9,"9228",160,137,136,1,1,"VOX",1
24,"24099",171,132,132,0,0,"VOX",1
6,"6161",302,236,235,1,1,"VOX",0
47,"47178",172,140,140,3,0,"VOX",0
42,"42004",2285,1757,1737,15,20,"VOX",11
29,"29002",1177,804,789,5,15,"VOX",6
4,"4011",2765,2119,2096,21,23,"VOX",2
19,"19150",128,99,99,1,0,"VOX",0
47,"47179",395,293,287,0,6,"VOX",0
42,"42086",36,27,26,2,1,"VOX",0
19,"19296",30,19,18,0,1,"VOX",0
9,"9184",5,4,4,0,0,"VOX",0
16,"16106",2727,2009,1989,12,20,"VOX",4
4,"4012",191,161,161,0,0,"VOX",1
28,"28034",361,274,269,1,5,"VOX",0
6,"6162",2934,2182,2162,14,20,"VOX",3
28,"28007",124592,94222,93521,491,701,"VOX",417
48,"48092",836,618,613,5,5,"VOX",0
18,"18106",425,293,290,0,3,"VOX",2
40,"40141",842,593,584,10,9,"VOX",2
47,"47018",34,28,28,0,0,"VOX",0
12,"12099",539,416,403,7,13,"VOX",2
9,"9098",507,369,362,5,7,"VOX",0
6,"6902",1667,1121,1113,13,8,"VOX",0
24,"24134",3416,2470,2417,19,53,"VOX",1
40,"40224",22,21,21,0,0,"VOX",0
35,"35031",7259,5037,4942,29,95,"VOX",4
25,"25005",279,175,175,4,0,"VOX",0
42,"42135",72,52,52,1,0,"VOX",0
19,"19067",70,52,51,1,1,"VOX",0
16,"16154",4871,3547,3509,24,38,"VOX",5
47,"47208",58,38,36,1,2,"VOX",0
9,"9369",436,319,316,1,3,"VOX",0
46,"46070",16950,12765,12676,61,89,"VOX",28
28,"28036",2539,1899,1878,11,21,"VOX",5
47,"47181",165,135,132,3,3,"VOX",1
19,"19189",120,91,90,2,1,"VOX",1
10,"10148",32850,22161,21856,177,305,"VOX",40
22,"22177",98,75,75,0,0,"VOX",0
39,"39085",6836,5086,5032,44,54,"VOX",5
47,"47045",763,575,567,1,8,"VOX",2
24,"24036",288,184,184,2,0,"VOX",0
25,"25133",706,432,427,8,5,"VOX",0
29,"29006",673,428,420,1,8,"VOX",0
46,"46149",363,271,268,2,3,"VOX",0
18,"18109",597,411,408,2,3,"VOX",0
9,"9373",425,287,285,2,2,"VOX",0
45,"45197",1906,1455,1430,8,25,"VOX",1
19,"19299",97,79,77,1,2,"VOX",0
24,"24005",378,260,257,2,3,"VOX",0
25,"25134",623,369,366,3,3,"VOX",0
28,"28106",76907,52773,52265,385,508,"VOX",221
39,"39086",358,256,253,0,3,"VOX",1
40,"40104",265,198,195,0,3,"VOX",3
12,"12002",110,99,98,1,1,"VOX",0
28,"28010",9963,7745,7688,25,57,"VOX",37
47,"47182",1323,977,967,8,10,"VOX",1
9,"9456",130,97,96,0,1,"VOX",0
16,"16272",221,176,175,0,1,"VOX",0
18,"18908",801,593,588,3,5,"VOX",0
3,"3066",42121,29655,29419,214,236,"VOX",61
45,"45198",1809,1475,1442,7,33,"VOX",2
1,"1001",1979,1339,1318,7,21,"VOX",2
10,"10014",1852,1370,1346,6,24,"VOX",1
40,"40105",47,42,42,2,0,"VOX",0
41,"41025",2020,1361,1320,7,41,"VOX",2
48,"48077",3364,2437,2431,18,6,"VOX",3
50,"50180",119,99,99,2,0,"VOX",0
21,"21019",612,400,391,2,9,"VOX",0
41,"41092",7743,5358,5311,55,47,"VOX",18
47,"47048",188,144,144,1,0,"VOX",3
48,"48006",290,239,239,2,0,"VOX",0
18,"18161",212,175,174,3,1,"VOX",1
16,"16159",220,159,159,0,0,"VOX",0
45,"45199",2940,1848,1805,14,43,"VOX",14
9,"9148",87,70,68,3,2,"VOX",0
16,"16113",3077,2225,2202,10,23,"VOX",2
48,"48067",1158,813,810,2,3,"VOX",1
10,"10108",219,148,146,0,2,"VOX",1
30,"30025",4908,3667,3630,16,37,"VOX",10
1,"1043",2304,1552,1532,13,20,"VOX",2
12,"12902",2158,1504,1489,14,15,"VOX",2
18,"18192",1538,1151,1123,6,28,"VOX",2
19,"19106",89,59,59,0,0,"VOX",0
19,"19091",26,20,20,0,0,"VOX",0
46,"46108",469,378,375,1,3,"VOX",0
4,"4053",12320,8946,8866,70,80,"VOX",7
50,"50182",3399,2364,2335,21,29,"VOX",11
45,"45201",3447,2082,2050,9,32,"VOX",11
18,"18910",788,541,536,3,5,"VOX",0
45,"45033",343,249,243,2,6,"VOX",0
42,"42095",1773,1269,1251,15,18,"VOX",9
40,"40022",213,164,161,2,3,"VOX",0
33,"33005",1449,936,924,11,12,"VOX",3
10,"10018",1689,1101,1081,6,20,"VOX",2
18,"18162",938,698,686,1,12,"VOX",1
6,"6127",2863,2112,2088,10,24,"VOX",1
39,"39019",2079,1560,1531,10,29,"VOX",1
45,"45145",2565,1695,1675,12,20,"VOX",4
3,"3009",46657,35143,34801,223,342,"VOX",73
22,"22908",197,142,140,3,2,"VOX",0
10,"10157",263,204,201,0,3,"VOX",0
12,"12106",1158,955,942,8,13,"VOX",1
10,"10020",1604,1185,1169,9,16,"VOX",1
47,"47185",99,73,71,0,2,"VOX",0
50,"50056",409,300,300,3,0,"VOX",0
9,"9065",143,122,122,1,0,"VOX",0
19,"19108",111,97,96,0,1,"VOX",1
18,"18056",3530,2641,2614,24,27,"VOX",6
45,"45203",2563,1801,1771,8,30,"VOX",5
21,"21023",2124,1298,1264,7,34,"VOX",1
39,"39030",1895,1225,1212,10,13,"VOX",3
26,"26035",17,12,11,0,1,"VOX",0
9,"9287",208,158,156,3,2,"VOX",1
29,"29045",1684,1178,1168,8,10,"VOX",2
25,"25141",153,95,95,0,0,"VOX",0
25,"25099",1273,761,752,7,9,"VOX",0
26,"26175",51,41,41,0,0,"VOX",0
9,"9381",30,24,24,1,0,"VOX",0
28,"28140",3007,2276,2256,7,20,"VOX",11
9,"9243",76,59,57,1,2,"VOX",0
24,"24213",150,122,122,1,0,"VOX",0
12,"12108",456,378,371,2,7,"VOX",1
50,"50087",26,17,17,1,0,"VOX",0
45,"45003",562,408,402,1,6,"VOX",4
12,"12042",607,520,513,13,7,"VOX",1
3,"3135",211,170,166,2,4,"VOX",0
29,"29047",1117,885,866,1,19,"VOX",0
10,"10068",735,570,557,2,13,"VOX",2
18,"18030",576,413,409,6,4,"VOX",0
11,"11020",165378,109810,108830,1188,980,"VOX",222
40,"40904",357,308,306,3,2,"VOX",2
18,"18072",667,424,420,0,4,"VOX",0
33,"33039",1655,1223,1209,12,14,"VOX",1
28,"28044",5826,4445,4409,24,36,"VOX",22
26,"26069",236,194,189,0,5,"VOX",0
33,"33009",905,611,609,3,2,"VOX",0
9,"9113",449,339,332,4,7,"VOX",0
47,"47027",2745,2036,2018,9,18,"VOX",5
18,"18032",246,175,174,2,1,"VOX",0
48,"48042",1369,1068,1053,7,15,"VOX",2
9,"9246",620,451,444,2,7,"VOX",1
16,"16169",58,37,37,3,0,"VOX",3
47,"47188",111,88,88,3,0,"VOX",0
16,"16030",24,19,19,0,0,"VOX",0
40,"40905",133,103,100,1,3,"VOX",0
19,"19042",25,24,24,0,0,"VOX",0
47,"47216",115,91,87,0,4,"VOX",0
29,"29071",934,596,588,3,8,"VOX",1
15,"15046",6332,4377,4262,40,115,"VOX",5
22,"22190",119,86,85,0,1,"VOX",1
50,"50217",446,342,342,1,0,"VOX",1
42,"42105",50,45,45,0,0,"VOX",0
48,"48044",62774,45594,45399,287,195,"VOX",64
33,"33010",1822,1190,1180,17,10,"VOX",3
29,"29016",251,188,188,1,0,"VOX",0
1,"1011",235,174,171,4,3,"VOX",0
12,"12111",360,305,299,3,6,"VOX",0
45,"45106",7439,5613,5534,52,79,"VOX",15
9,"9428",108,92,91,0,1,"VOX",0
33,"33041",7199,4922,4877,52,45,"VOX",8
9,"9162",141,101,101,0,0,"VOX",0
39,"39014",883,619,614,6,5,"VOX",0
10,"10179",294,231,229,2,2,"VOX",0
12,"12046",191,151,150,2,1,"VOX",0
22,"22027",329,221,218,0,3,"VOX",0
9,"9248",78,59,59,1,0,"VOX",2
6,"6045",506,379,374,3,5,"VOX",0
18,"18034",505,366,364,1,2,"VOX",1
16,"16172",325,268,267,1,1,"VOX",0
48,"48075",1996,1364,1359,6,5,"VOX",0
33,"33042",4306,2988,2970,35,18,"VOX",11
40,"40074",255,222,219,2,3,"VOX",0
28,"28075",5621,4186,4148,26,38,"VOX",8
39,"39096",690,487,479,4,8,"VOX",1
45,"45007",696,534,522,3,12,"VOX",1
16,"16234",25,18,18,0,0,"VOX",0
26,"26040",70,60,60,0,0,"VOX",0
46,"46210",330,277,277,2,0,"VOX",0
46,"46132",2150,1803,1784,7,19,"VOX",4
14,"14056",23581,16120,15958,143,162,"VOX",22
6,"6138",1047,727,715,5,12,"VOX",0
46,"46002",1175,941,932,5,9,"VOX",5
40,"40120",192,170,166,0,4,"VOX",0
10,"10029",414,339,333,0,6,"VOX",3
50,"50126",2371,1573,1559,19,14,"VOX",0
26,"26074",105,86,85,1,1,"VOX",0
47,"47148",442,342,338,2,4,"VOX",2
45,"45042",187,140,140,0,0,"VOX",0
26,"26008",1860,1399,1387,5,12,"VOX",4
41,"41081",29189,20205,20015,196,190,"VOX",26
10,"10076",832,556,541,1,15,"VOX",0
29,"29019",878,652,636,3,16,"VOX",0
25,"25063",87,58,58,1,0,"VOX",1
50,"50094",1617,1173,1159,12,14,"VOX",1
33,"33014",9037,5999,5938,53,61,"VOX",12
50,"50032",261,189,189,5,0,"VOX",0
46,"46186",19068,14599,14474,69,125,"VOX",23
4,"4029",8859,5834,5790,35,44,"VOX",5
9,"9301",625,473,467,2,6,"VOX",1
14,"14030",8625,6248,6181,53,67,"VOX",5
25,"25023",4531,2782,2763,30,19,"VOX",7
50,"50202",152,100,99,1,1,"VOX",0
23,"23049",1813,1238,1222,9,16,"VOX",0
29,"29065",187,137,136,0,1,"VOX",0
46,"46247",1006,714,710,3,4,"VOX",1
19,"19020",44,30,30,1,0,"VOX",0
3,"3079",18224,13904,13709,80,195,"VOX",32
29,"29054",41997,28422,28238,189,184,"VOX",64
10,"10170",267,210,206,3,4,"VOX",0
45,"45011",278,239,233,1,6,"VOX",1
14,"14003",1248,939,930,2,9,"VOX",0
16,"16177",78,64,64,0,0,"VOX",0
33,"33015",1540,998,986,8,12,"VOX",1
50,"50129",235,161,158,2,3,"VOX",0
9,"9123",40,35,35,0,0,"VOX",0
33,"33046",499,379,367,5,12,"VOX",0
42,"42113",534,409,399,1,10,"VOX",4
18,"18012",2278,1662,1641,13,21,"VOX",2
23,"23903",3540,2662,2634,13,28,"VOX",5
18,"18086",349,274,272,0,2,"VOX",0
25,"25113",1168,811,803,8,8,"VOX",0
26,"26078",82,70,70,0,0,"VOX",0
10,"10034",353,260,257,2,3,"VOX",0
9,"9255",89,63,62,0,1,"VOX",0
35,"35019",32481,19318,19067,123,251,"VOX",23
6,"6098",549,385,381,7,4,"VOX",1
50,"50285",644,436,434,2,2,"VOX",0
26,"26034",654,497,489,1,8,"VOX",0
25,"25197",133,89,88,1,1,"VOX",0
47,"47142",141,99,97,0,2,"VOX",1
9,"9304",199,157,155,3,2,"VOX",0
50,"50098",174,130,124,0,6,"VOX",0
29,"29023",2081,1354,1340,4,14,"VOX",2
10,"10173",577,400,399,5,1,"VOX",0
45,"45014",4010,2646,2616,22,30,"VOX",1
22,"22037",115,86,86,0,0,"VOX",0
4,"4032",5586,3642,3623,23,19,"VOX",4
14,"14033",1283,971,959,9,12,"VOX",0
47,"47143",118,91,90,0,1,"VOX",0
48,"48081",1868,1361,1350,4,11,"VOX",0
42,"42029",137,104,104,2,0,"VOX",0
4,"4001",1062,823,814,5,9,"VOX",0
19,"19322",31,25,25,0,0,"VOX",0
21,"21039",311,225,223,1,2,"VOX",0
47,"47116",416,341,339,0,2,"VOX",2
28,"28053",6498,4995,4955,28,40,"VOX",21
26,"26080",472,391,389,0,2,"VOX",2
9,"9127",56,41,39,0,2,"VOX",0
33,"33048",154,95,94,0,1,"VOX",0
46,"46085",11081,7938,7866,46,72,"VOX",10
33,"33018",2901,2000,1976,18,24,"VOX",2
28,"28090",8505,6654,6609,33,45,"VOX",35
50,"50037",136,98,96,0,2,"VOX",0
47,"47170",33,28,27,2,1,"VOX",0
15,"15057",12075,8479,8377,66,102,"VOX",5
19,"19246",46,36,34,2,2,"VOX",0
12,"12032",23525,17093,16966,104,127,"VOX",40
48,"48052",1562,1160,1150,4,10,"VOX",0
46,"46225",337,290,281,5,9,"VOX",0
16,"16188",91,65,65,0,0,"VOX",0
25,"25032",64,44,44,1,0,"VOX",0
19,"19013",125,108,108,1,0,"VOX",0
9,"9440",91,78,78,2,0,"VOX",1
45,"45149",556,446,440,0,6,"VOX",2
16,"16139",335,256,255,2,1,"VOX",2
24,"24057",1373,1045,1023,11,22,"VOX",3
42,"42211",82,66,66,1,0,"VOX",0
15,"15058",27793,20392,20235,221,157,"VOX",48
50,"50166",255,208,206,2,2,"VOX",1
6,"6104",674,491,487,3,4,"VOX",1
18,"18094",2359,1744,1720,14,24,"VOX",5
9,"9309",301,224,220,0,4,"VOX",0
26,"26016",28,25,24,1,1,"VOX",0
33,"33051",7061,4640,4587,27,53,"VOX",8
40,"40129",177,148,147,1,1,"VOX",2
41,"41011",15401,10170,9986,111,184,"VOX",11
46,"46217",878,691,676,4,15,"VOX",0
28,"28055",916,693,687,5,6,"VOX",2
45,"45051",1590,1171,1152,5,19,"VOX",1
50,"50167",233,183,178,1,5,"VOX",0
45,"45017",262,204,203,0,1,"VOX",0
50,"50060",172,128,127,1,1,"VOX",0
10,"10195",7709,5572,5481,37,91,"VOX",12
10,"10180",4134,2643,2601,25,42,"VOX",4
46,"46114",569,461,458,1,3,"VOX",0
25,"25121",644,415,410,8,5,"VOX",0
4,"4036",226,175,175,0,0,"VOX",0
47,"47038",105,77,77,0,0,"VOX",0
9,"9176",63,47,46,2,1,"VOX",0
26,"26051",239,193,191,1,2,"VOX",0
41,"41045",5756,3988,3924,53,64,"VOX",5
19,"19215",168,144,140,0,4,"VOX",2
41,"41013",4839,3151,3094,33,57,"VOX",2
25,"25207",6212,3710,3680,47,30,"VOX",0
16,"16047",232,175,175,2,0,"VOX",0
24,"24027",1211,863,847,8,16,"VOX",1
47,"47012",113,93,93,0,0,"VOX",0
3,"3119",16636,12281,12194,57,87,"VOX",25
28,"28057",1458,1097,1088,3,9,"VOX",6
50,"50137",1011,772,764,8,8,"VOX",1
29,"29029",403,298,294,2,4,"VOX",1
4,"4071",394,338,337,3,1,"VOX",0
46,"46252",118,99,98,0,1,"VOX",1
48,"48086",2050,1414,1401,5,13,"VOX",1
42,"42172",29,26,26,0,0,"VOX",0
46,"46090",1637,1391,1367,3,24,"VOX",1
39,"39056",2286,1714,1684,8,30,"VOX",3
25,"25076",145,81,81,2,0,"VOX",0
9,"9133",40,32,32,0,0,"VOX",0
29,"29098",1253,917,895,9,22,"VOX",2
3,"3006",497,384,380,1,4,"VOX",1
50,"50272",12904,8880,8819,84,61,"VOX",32
48,"48057",5723,3988,3962,26,26,"VOX",0
50,"50293",413,276,275,4,1,"VOX",0
28,"28067",4063,3102,3079,3,23,"VOX",17
9,"9418",82,62,61,1,1,"VOX",0
9,"9267",111,99,97,1,2,"VOX",0
40,"40216",759,574,571,3,3,"VOX",6
18,"18145",10491,7538,7477,59,61,"VOX",12
21,"21047",1917,1111,1065,15,46,"VOX",1
24,"24129",122,89,89,1,0,"VOX",0
40,"40049",49,43,43,0,0,"VOX",0
35,"35026",81091,51953,51195,407,758,"VOX",70
46,"46160",1913,1452,1436,1,16,"VOX",6
16,"16909",699,535,532,0,3,"VOX",1
29,"29032",6657,5031,4977,33,54,"VOX",4
50,"50043",253,171,171,0,0,"VOX",0
30,"30016",151668,102093,101363,484,730,"VOX",395
28,"28127",64827,51776,51613,220,163,"VOX",353
45,"45022",391,285,281,3,4,"VOX",2
3,"3090",17182,12487,12385,74,102,"VOX",23
40,"40008",44,39,39,1,0,"VOX",0
42,"42052",15,13,13,0,0,"VOX",0
10,"10140",1106,820,808,4,12,"VOX",2
24,"24030",4277,3038,3007,11,31,"VOX",3
18,"18053",1630,1082,1076,8,6,"VOX",0
22,"22184",184,155,155,3,0,"VOX",1
22,"22201",266,188,187,3,1,"VOX",0
10,"10141",263,194,194,0,0,"VOX",1
16,"16101",154,132,132,0,0,"VOX",1
6,"6067",1972,1308,1292,8,16,"VOX",3
4,"4044",1547,1166,1156,5,10,"VOX",1
50,"50014",147,94,94,0,0,"VOX",0
46,"46040",1078,888,878,7,10,"VOX",0
24,"24031",215,172,168,0,4,"VOX",0
33,"33077",1192,811,808,5,3,"VOX",0
42,"42176",29,25,25,0,0,"VOX",0
16,"16009",62,51,50,0,1,"VOX",0
47,"47025",120,94,94,1,0,"VOX",0
23,"23026",3586,2620,2585,16,35,"VOX",2
3,"3092",6743,5254,5178,37,76,"VOX",11
50,"50141",109,90,90,1,0,"VOX",0
11,"11040",397,307,292,1,15,"VOX",0
22,"22048",12598,8790,8731,91,59,"VOX",92
29,"29034",467,358,356,0,2,"VOX",1
46,"46145",21990,16337,16187,93,150,"VOX",21
6,"6160",3153,2176,2146,16,30,"VOX",44
19,"19109",39,32,32,0,0,"VOX",0
42,"42131",51,37,37,1,0,"VOX",0
15,"15032",3444,2322,2269,30,53,"VOX",9
16,"16056",457,306,305,3,1,"VOX",0
18,"18057",5305,3827,3791,27,36,"VOX",12
9,"9056",4919,3395,3344,20,51,"VOX",7
9,"9138",85,72,70,0,2,"VOX",0
6,"6071",245,206,200,0,6,"VOX",0
50,"50205",90,63,61,0,2,"VOX",0
22,"22049",78,64,64,0,0,"VOX",1
29,"29036",632,423,416,2,7,"VOX",0
42,"42006",163,109,107,2,2,"VOX",0
16,"16152",38,32,32,0,0,"VOX",0
9,"9366",86,62,62,2,0,"VOX",0
15,"15070",9069,6090,5976,94,114,"VOX",5
21,"21053",3316,2141,2107,17,34,"VOX",1
29,"29014",217,141,140,4,1,"VOX",0
46,"46172",5042,3504,3477,22,27,"VOX",4
40,"40070",149,107,105,1,2,"VOX",0
46,"46155",1029,833,822,4,11,"VOX",0
26,"26142",787,612,606,3,6,"VOX",0
9,"9018",24668,17575,17369,111,206,"VOX",44
42,"42134",2627,1927,1890,19,37,"VOX",0
24,"24034",3394,2380,2342,28,38,"VOX",2
29,"29037",209,158,157,1,1,"VOX",0
48,"48093",893,653,643,7,10,"VOX",0
15,"15072",9574,6637,6562,35,75,"VOX",8
4,"4078",1078,758,746,8,12,"VOX",0
18,"18017",18114,11610,11510,77,100,"VOX",22
26,"26167",59,47,46,1,1,"VOX",0
50,"50079",249,175,174,0,1,"VOX",0
9,"9230",38,32,32,0,0,"VOX",0
3,"3127",350,278,273,1,5,"VOX",0
29,"29038",17676,11056,10970,141,86,"VOX",21
30,"30022",16913,11371,11214,93,157,"VOX",20
21,"21015",680,398,393,8,5,"VOX",1
16,"16061",969,771,764,14,7,"VOX",0
26,"26096",245,190,190,1,0,"VOX",0
25,"25006",340,201,200,6,1,"VOX",2
19,"19031",15,9,9,0,0,"VOX",0
40,"40225",1138,883,867,3,16,"VOX",2
33,"33071",595,433,430,10,3,"VOX",0
10,"10133",1206,956,945,5,11,"VOX",1
16,"16094",127,96,94,0,2,"VOX",2
10,"10194",542,415,407,2,8,"VOX",0
21,"21043",1871,1310,1285,9,25,"VOX",2
18,"18063",1200,679,675,2,4,"VOX",1
50,"50081",511,382,378,4,4,"VOX",2
9,"9020",259,196,188,5,8,"VOX",3
28,"28133",5979,4140,4098,18,42,"VOX",16
22,"22053",789,520,513,9,7,"VOX",2
9,"9232",154,119,116,0,3,"VOX",0
23,"23033",1352,1045,1034,12,11,"VOX",1
4,"4050",800,558,553,3,5,"VOX",4
29,"29040",1977,1290,1278,12,12,"VOX",1
19,"19227",66,44,43,2,1,"VOX",0
47,"47100",138,117,117,1,0,"VOX",0
47,"47020",280,234,231,2,3,"VOX",0
12,"12071",1274,992,979,3,13,"VOX",0
26,"26062",89,72,71,2,1,"VOX",0
10,"10013",276,207,200,0,7,"VOX",1
16,"16111",171,123,123,1,0,"VOX",0
4,"4051",436,360,356,1,4,"VOX",0
1,"1042",904,653,648,6,5,"VOX",1
9,"9279",174,131,130,3,1,"VOX",0
33,"33063",415,320,318,3,2,"VOX",0
45,"45030",478,368,360,2,8,"VOX",1
24,"24050",102,77,76,0,1,"VOX",1
10,"10152",468,340,332,1,8,"VOX",1
28,"28076",398,325,317,1,8,"VOX",4
39,"39006",1711,1307,1287,10,20,"VOX",5
50,"50221",35,17,17,0,0,"VOX",0
46,"46237",7211,5395,5343,42,52,"VOX",13
33,"33034",10612,6602,6536,62,66,"VOX",9
16,"16213",36,34,34,0,0,"VOX",0
1,"1056",219,136,135,0,1,"VOX",0
25,"25151",685,425,419,7,6,"VOX",0
19,"19264",33,26,26,0,0,"VOX",0
16,"16020",17,10,10,0,0,"VOX",0
45,"45165",62718,44420,44006,236,414,"VOX",111
10,"10062",406,337,331,0,6,"VOX",0
29,"29042",14016,9368,9192,88,176,"VOX",7
10,"10214",214,181,177,2,4,"VOX",0
39,"39078",1401,975,963,5,12,"VOX",0
19,"19181",56,42,42,0,0,"VOX",0
16,"16099",203,153,147,0,6,"VOX",3
23,"23062",1454,1141,1128,1,13,"VOX",1
45,"45078",1379,1129,1119,6,10,"VOX",5
21,"21061",5084,3223,3177,28,46,"VOX",1
42,"42014",64,43,43,1,0,"VOX",0
12,"12135",35719,26016,25793,196,223,"VOX",43
47,"47158",889,667,659,8,8,"VOX",1
46,"46204",6681,5256,5202,32,54,"VOX",5
9,"9421",230,166,163,3,3,"VOX",0
26,"26113",35,35,34,0,1,"VOX",0
45,"45134",1581,1204,1192,6,12,"VOX",2
6,"6082",383,287,286,2,1,"VOX",1
25,"25096",902,534,525,10,9,"VOX",0
4,"4030",1119,819,812,5,7,"VOX",1
6,"6112",393,323,321,2,2,"VOX",0
45,"45179",525,391,386,3,5,"VOX",0
28,"28177",10270,8083,8030,36,53,"VOX",53
12,"12040",117608,85588,84946,496,642,"VOX",283
50,"50213",94,75,74,0,1,"VOX",0
6,"6083",46149,31049,30739,234,310,"VOX",64
26,"26001",195,161,157,2,4,"VOX",0
26,"26103",796,616,610,6,6,"VOX",0
25,"25013",2146,1240,1226,16,14,"VOX",2
45,"45090",384,294,293,3,1,"VOX",0
50,"50119",927,724,713,5,11,"VOX",3
21,"21036",200,141,139,0,2,"VOX",1
47,"47150",274,209,205,0,4,"VOX",1
40,"40068",26,24,24,0,0,"VOX",0
3,"3040",254,216,213,2,3,"VOX",2
28,"28110",1944,1478,1463,4,15,"VOX",3
22,"22227",206,163,160,3,3,"VOX",0
28,"28014",33085,23626,23466,113,160,"VOX",68
9,"9198",104,83,82,1,1,"VOX",3
18,"18913",813,566,559,2,7,"VOX",1
26,"26104",13,10,10,0,0,"VOX",0
30,"30028",6649,4797,4726,21,71,"VOX",12
40,"40069",83,66,63,0,3,"VOX",0
25,"25014",260,165,165,5,0,"VOX",0
45,"45136",5845,4091,4019,25,72,"VOX",3
46,"46102",19788,15154,15038,89,116,"VOX",33
23,"23041",499,398,394,2,4,"VOX",2
42,"42018",152,117,116,1,1,"VOX",0
10,"10114",953,665,660,3,5,"VOX",0
25,"25015",357,219,219,2,0,"VOX",0
40,"40026",119,109,109,0,0,"VOX",0
45,"45037",1603,1122,1111,5,11,"VOX",8
6,"6086",1221,814,799,2,15,"VOX",0
3,"3011",7753,5464,5415,27,49,"VOX",20
50,"50122",68,52,52,1,0,"VOX",0
16,"16280",192,164,161,1,3,"VOX",0
24,"24078",380,289,277,0,12,"VOX",0
45,"45182",1034,806,791,1,15,"VOX",2
42,"42100",32,30,30,0,0,"VOX",0
48,"48021",1336,908,899,1,9,"VOX",1
3,"3032",108,91,90,1,1,"VOX",0
22,"22023",421,313,309,6,4,"VOX",1
4,"4057",1325,894,884,5,10,"VOX",1
28,"28141",5823,4297,4262,29,35,"VOX",20
6,"6087",2110,1583,1561,8,22,"VOX",2
18,"18074",262,201,200,2,1,"VOX",0
28,"28082",5683,4324,4286,25,38,"VOX",9
29,"29048",1405,1121,1110,8,11,"VOX",1
16,"16901",675,506,501,6,5,"VOX",5
48,"48073",6910,4306,4271,31,35,"VOX",2
45,"45083",472,368,365,0,3,"VOX",6
40,"40029",35,27,26,0,1,"VOX",0
45,"45073",298,233,233,1,0,"VOX",0
1,"1052",245,184,181,0,3,"VOX",0
3,"3137",651,492,489,5,3,"VOX",2
24,"24149",152,120,116,3,4,"VOX",0
22,"22193",276,225,224,2,1,"VOX",0
42,"42155",167,103,102,1,1,"VOX",0
26,"26108",266,215,213,0,2,"VOX",1
9,"9294",108,86,82,0,4,"VOX",0
28,"28074",138947,103687,102762,620,925,"VOX",357
19,"19123",40,32,31,1,1,"VOX",0
48,"48908",249,181,181,0,0,"VOX",0
9,"9219",27509,19084,18859,146,225,"VOX",41
50,"50090",150,113,112,0,1,"VOX",1
47,"47217",1910,1370,1366,1,4,"VOX",1
28,"28153",697,499,499,1,0,"VOX",1
16,"16002",187,158,158,1,0,"VOX",1
9,"9429",56,41,41,0,0,"VOX",0
42,"42156",28,16,16,1,0,"VOX",0
46,"46183",5993,4443,4381,19,62,"VOX",9
24,"24150",243,172,172,6,0,"VOX",0
47,"47055",203,167,163,0,4,"VOX",0
16,"16125",1667,1249,1231,3,18,"VOX",4
45,"45074",414,327,323,1,4,"VOX",0
40,"40119",169,138,133,1,5,"VOX",0
25,"25234",4279,2546,2508,23,38,"VOX",3
16,"16081",48,34,34,0,0,"VOX",0
46,"46184",26505,20428,20223,115,205,"VOX",35
1,"1054",960,654,651,4,3,"VOX",0
50,"50125",360,248,246,3,2,"VOX",1
23,"23086",11511,7997,7874,91,123,"VOX",9
19,"19167",130,101,99,0,2,"VOX",0
42,"42200",81,59,58,2,1,"VOX",1
35,"35016",297736,192251,190256,1386,1995,"VOX",354
25,"25192",743,449,436,2,13,"VOX",0
18,"18082",861,616,611,5,5,"VOX",0
19,"19005",84,66,66,0,0,"VOX",0
10,"10137",397,320,317,3,3,"VOX",1
45,"45087",8311,5828,5747,43,81,"VOX",12
1,"1028",1070,716,710,3,6,"VOX",2
50,"50138",46,37,37,2,0,"VOX",0
40,"40132",56,37,36,1,1,"VOX",0
50,"50093",92,66,66,1,0,"VOX",0
29,"29075",12934,8234,8147,69,87,"VOX",15
23,"23073",4507,3229,3200,13,29,"VOX",8
19,"19156",970,704,699,4,5,"VOX",2
12,"12072",1101,929,911,11,18,"VOX",3
6,"6140",630,506,499,3,7,"VOX",0
23,"23087",11292,8222,8084,59,138,"VOX",10
42,"42025",1189,844,833,2,11,"VOX",6
6,"6003",823,627,616,1,11,"VOX",0
45,"45110",1786,1403,1398,5,5,"VOX",1
41,"41082",3415,2671,2647,16,24,"VOX",2
45,"45143",1170,881,874,4,7,"VOX",1
14,"14020",387,269,264,2,5,"VOX",0
9,"9090",54,48,48,0,0,"VOX",0
40,"40091",119,97,95,1,2,"VOX",0
45,"45088",2115,1351,1338,4,13,"VOX",4
9,"9432",182,145,138,0,7,"VOX",1
24,"24117",434,334,331,1,3,"VOX",0
46,"46030",800,627,614,5,13,"VOX",0
50,"50033",66,49,48,0,1,"VOX",0
15,"15053",7729,5089,5043,49,46,"VOX",3
23,"23050",90992,64810,64218,485,592,"VOX",197
19,"19265",122,97,95,2,2,"VOX",0
16,"16131",130,100,97,2,3,"VOX",0
16,"16085",138,113,112,0,1,"VOX",0
23,"23090",1312,1041,1018,5,23,"VOX",7
47,"47015",200,162,160,0,2,"VOX",1
46,"46092",276,192,189,0,3,"VOX",1
46,"46066",1263,1024,1018,9,6,"VOX",0
19,"19332",92,71,69,1,2,"VOX",0
9,"9303",86,68,68,0,0,"VOX",0
3,"3112",628,511,507,2,4,"VOX",2
9,"9076",23,17,17,1,0,"VOX",0
12,"12051",471,339,335,1,4,"VOX",0
6,"6052",4030,2735,2688,20,47,"VOX",2
19,"19050",16,15,15,0,0,"VOX",0
4,"4054",358,285,281,2,4,"VOX",0
45,"45180",2727,1966,1940,9,26,"VOX",6
29,"29089",3228,2377,2321,10,56,"VOX",1
12,"12089",4328,3078,3020,15,58,"VOX",4
3,"3043",2911,2431,2399,13,32,"VOX",3
45,"45157",2128,1456,1427,13,29,"VOX",2
46,"46232",895,711,696,5,15,"VOX",1
22,"22072",191,136,135,0,1,"VOX",0
46,"46032",5653,4402,4361,33,41,"VOX",7
3,"3020",99,79,79,0,0,"VOX",1
10,"10219",1276,796,790,7,6,"VOX",1
28,"28150",3087,2294,2277,10,17,"VOX",9
50,"50164",390,247,246,6,1,"VOX",1
24,"24224",616,454,451,4,3,"VOX",0
18,"18088",1541,1124,1117,5,7,"VOX",0
21,"21038",1095,705,693,4,12,"VOX",2
16,"16263",959,722,715,4,7,"VOX",0
10,"10129",365,275,271,0,4,"VOX",2
47,"47008",24,19,19,1,0,"VOX",0
3,"3114",1562,1198,1188,9,10,"VOX",1
50,"50225",1570,956,950,3,6,"VOX",5
10,"10902",721,548,540,4,8,"VOX",0
24,"24056",2883,2040,2003,11,37,"VOX",4
50,"50165",1814,1287,1264,26,23,"VOX",3
50,"50036",104,91,90,0,1,"VOX",0
22,"22203",83,67,67,1,0,"VOX",0
47,"47152",78,60,60,0,0,"VOX",1
18,"18137",989,761,760,7,1,"VOX",2
46,"46224",159,121,121,0,0,"VOX",0
28,"28179",1432,1040,1037,4,3,"VOX",4
4,"4077",295,263,261,2,2,"VOX",0
6,"6041",460,372,367,0,5,"VOX",0
25,"25100",211,125,124,1,1,"VOX",0
6,"6072",2307,1696,1681,12,15,"VOX",2
4,"4034",160,99,99,2,0,"VOX",1
28,"28122",513,375,370,2,5,"VOX",4
46,"46164",11771,8564,8483,64,81,"VOX",6
9,"9003",194,147,146,0,1,"VOX",0
24,"24122",1342,930,924,8,6,"VOX",1
9,"9044",46,35,34,1,1,"VOX",0
47,"47145",603,448,441,3,7,"VOX",2
39,"39053",219,153,152,2,1,"VOX",0
40,"40211",74,64,64,0,0,"VOX",0
21,"21018",1769,1120,1095,11,25,"VOX",1
30,"30034",1129,858,844,7,14,"VOX",1
25,"25249",182,99,98,1,1,"VOX",0
12,"12120",177,152,152,0,0,"VOX",0
40,"40002",36,32,32,0,0,"VOX",0
45,"45016",4204,3146,3105,22,41,"VOX",10
26,"26049",172,125,122,1,3,"VOX",3
19,"19177",76,61,59,0,2,"VOX",0
15,"15022",5785,3811,3771,33,40,"VOX",2
25,"25073",582,328,324,8,4,"VOX",0
28,"28027",1203,872,857,3,15,"VOX",2
26,"26072",281,254,254,0,0,"VOX",1
25,"25190",262,185,183,0,2,"VOX",0
3,"3106",583,480,478,2,2,"VOX",0
46,"46123",1829,1407,1388,7,19,"VOX",2
19,"19237",47,38,38,0,0,"VOX",0
16,"16003",125,105,104,0,1,"VOX",0
16,"16095",83,64,63,0,1,"VOX",0
50,"50136",575,414,410,2,4,"VOX",0
29,"29061",1016,798,769,8,29,"VOX",2
19,"19178",33,22,22,0,0,"VOX",0
19,"19138",255,202,201,2,1,"VOX",0
15,"15060",5772,4032,3958,46,74,"VOX",7
26,"26017",381,293,293,5,0,"VOX",0
15,"15074",4037,2841,2796,20,45,"VOX",1
45,"45163",8298,5942,5855,28,87,"VOX",16
9,"9906",1219,902,898,8,4,"VOX",2
39,"39076",3476,2594,2559,19,35,"VOX",1
12,"12123",48,40,40,3,0,"VOX",2
28,"28094",865,624,622,4,2,"VOX",6
9,"9311",59,46,45,0,1,"VOX",0
6,"6062",594,441,437,5,4,"VOX",2
6,"6108",2275,1567,1527,11,40,"VOX",0
18,"18048",2387,1683,1662,8,21,"VOX",2
41,"41047",10117,7515,7422,74,93,"VOX",17
26,"26052",154,121,117,0,4,"VOX",0
19,"19250",20,17,17,0,0,"VOX",0
18,"18022",13432,8491,8407,67,84,"VOX",14
16,"16158",535,416,413,5,3,"VOX",1
47,"47129",871,664,659,4,5,"VOX",2
18,"18911",7473,5098,5035,51,63,"VOX",12
22,"22901",742,478,470,5,8,"VOX",0
16,"16014",602,485,483,0,2,"VOX",0
6,"6094",1485,929,926,2,3,"VOX",0
18,"18066",2107,1392,1384,4,8,"VOX",0
46,"46133",533,415,410,6,5,"VOX",0
26,"26135",164,125,124,1,1,"VOX",1
10,"10153",309,222,218,0,4,"VOX",0
46,"46220",48410,34644,34292,279,352,"VOX",53
12,"12134",141,95,94,0,1,"VOX",0
10,"10138",555,448,446,2,2,"VOX",0
6,"6095",9504,6621,6475,96,146,"VOX",9
10,"10001",282,225,223,3,2,"VOX",1
9,"9066",62,48,47,0,1,"VOX",0
42,"42080",157,117,115,0,2,"VOX",1
9,"9360",30,23,23,0,0,"VOX",0
50,"50002",143,108,104,1,4,"VOX",0
15,"15065",7315,5187,5099,42,88,"VOX",1
6,"6065",311,236,228,1,8,"VOX",0
12,"12027",17283,12015,11888,89,127,"VOX",16
40,"40135",283,236,231,2,5,"VOX",0
41,"41903",6757,4562,4504,51,58,"VOX",1
50,"50118",2165,1552,1540,10,12,"VOX",2
9,"9075",112,91,91,3,0,"VOX",1
6,"6036",5075,3575,3535,35,40,"VOX",4
25,"25051",1527,931,920,11,11,"VOX",0
19,"19183",74,65,65,0,0,"VOX",0
24,"24041",538,367,366,3,1,"VOX",0
10,"10109",1762,1149,1125,14,24,"VOX",4
45,"45190",475,371,366,0,5,"VOX",2
41,"41005",9068,6366,6281,58,85,"VOX",4
16,"16149",148,124,122,2,2,"VOX",1
39,"39080",3542,2656,2628,20,28,"VOX",2
9,"9052",29,23,23,0,0,"VOX",0
26,"26126",31,27,27,0,0,"VOX",0
9,"9181",300,221,221,0,0,"VOX",1
29,"29090",1688,1144,1134,15,10,"VOX",1
45,"45079",369,288,286,3,2,"VOX",1
29,"29011",2900,1822,1803,9,19,"VOX",3
40,"40100",270,213,211,2,2,"VOX",0
14,"14019",6464,4967,4909,49,58,"VOX",4
50,"50073",2141,1592,1577,7,15,"VOX",2
19,"19305",155,116,115,0,1,"VOX",0
45,"45102",3610,2506,2470,14,36,"VOX",6
28,"28061",21389,16277,16135,67,142,"VOX",97
47,"47042",54,37,37,0,0,"VOX",0
48,"48060",3634,2143,2134,7,9,"VOX",0
26,"26140",253,208,206,0,2,"VOX",0
21,"21065",273,186,184,0,2,"VOX",0
19,"19293",1867,1358,1342,7,16,"VOX",7
40,"40054",108,90,90,0,0,"VOX",0
10,"10098",378,289,287,1,2,"VOX",2
40,"40115",101,86,85,1,1,"VOX",0
11,"11008",17471,10952,10812,128,140,"VOX",18
24,"24201",1090,762,759,10,3,"VOX",2
12,"12128",1393,1090,1072,10,18,"VOX",4
42,"42178",115,83,83,0,0,"VOX",0
6,"6115",1261,841,832,5,9,"VOX",0
33,"33059",4646,3075,3033,29,42,"VOX",1
46,"46198",839,684,674,4,10,"VOX",0
50,"50143",566,394,391,6,3,"VOX",6
50,"50142",26,17,17,0,0,"VOX",0
12,"12077",4605,3439,3382,15,57,"VOX",2
4,"4904",1777,1230,1221,12,9,"VOX",4
33,"33008",1777,1238,1229,3,9,"VOX",1
41,"41098",5004,3665,3630,26,35,"VOX",5
18,"18167",1895,1258,1250,4,8,"VOX",0
9,"9244",46,34,34,1,0,"VOX",0
21,"21066",498,392,389,3,3,"VOX",0
25,"25230",1558,1008,993,13,15,"VOX",1
9,"9229",198,146,143,0,3,"VOX",0
6,"6027",676,561,552,2,9,"VOX",0
47,"47153",108,77,77,0,0,"VOX",0
35,"35030",9250,5413,5326,34,87,"VOX",6
47,"47097",325,266,265,0,1,"VOX",0
22,"22129",183,120,118,1,2,"VOX",0
29,"29015",31880,22220,21952,190,268,"VOX",25
40,"40146",254,197,196,0,1,"VOX",0
50,"50130",383,240,238,2,2,"VOX",0
26,"26015",196,158,157,2,1,"VOX",1
26,"26154",13,10,10,0,0,"VOX",0
9,"9275",192,129,129,2,0,"VOX",0
18,"18905",14618,9789,9682,110,107,"VOX",19
11,"11011",1716,1195,1165,12,30,"VOX",7
16,"16108",49,45,42,0,3,"VOX",0
6,"6029",1195,855,841,3,14,"VOX",0
19,"19153",22,17,17,0,0,"VOX",0
18,"18018",634,472,468,5,4,"VOX",0
50,"50018",953,656,655,1,1,"VOX",1
28,"28162",2617,2029,2016,6,13,"VOX",6
47,"47180",73,61,60,4,1,"VOX",0
26,"26111",242,180,176,0,4,"VOX",0
22,"22003",137,110,107,1,3,"VOX",0
28,"28079",2362038,1743924,1733354,8859,10570,"VOX",9252
42,"42076",216,179,174,5,5,"VOX",0
11,"11012",99886,70290,69673,693,617,"VOX",155
9,"9340",77,49,49,0,0,"VOX",0
10,"10119",620,460,452,1,8,"VOX",1
3,"3129",1194,957,938,0,19,"VOX",3
23,"23071",1715,1290,1278,7,12,"VOX",0
12,"12036",581,426,421,10,5,"VOX",0
50,"50020",809,564,559,2,5,"VOX",1
9,"9034",276,228,227,2,1,"VOX",0
6,"6091",3774,2709,2666,23,43,"VOX",4
19,"19262",135,100,100,0,0,"VOX",0
30,"30023",3780,2874,2850,12,24,"VOX",2
25,"25908",226,144,143,3,1,"VOX",0
42,"42078",1020,717,703,7,14,"VOX",1
40,"40229",36,24,24,0,0,"VOX",0
11,"11035",13593,8375,8276,90,99,"VOX",24
6,"6077",341,256,249,0,7,"VOX",0
33,"33033",9873,6512,6431,68,81,"VOX",15
22,"22222",530,384,379,3,5,"VOX",4
26,"26134",82,68,68,2,0,"VOX",0
26,"26063",124,94,94,2,0,"VOX",0
15,"15087",5769,3766,3722,42,44,"VOX",3
9,"9061",162,124,123,0,1,"VOX",0
24,"24087",631,470,466,7,4,"VOX",3
22,"22075",125,83,83,1,0,"VOX",0
10,"10197",123,90,89,0,1,"VOX",0
28,"28180",5251,3927,3893,7,34,"VOX",11
9,"9057",145,108,108,0,0,"VOX",1
42,"42108",12,9,9,1,0,"VOX",0
10,"10203",4558,3120,3079,20,41,"VOX",6
24,"24007",773,550,548,4,2,"VOX",1
4,"4092",2838,2127,2103,10,24,"VOX",2
22,"22067",65,50,50,1,0,"VOX",0
39,"39027",3118,2322,2295,26,27,"VOX",3
33,"33044",178278,125469,124554,1124,915,"VOX",409
3,"3037",346,282,278,3,4,"VOX",13
6,"6019",2079,1451,1417,8,34,"VOX",0
10,"10067",10422,7113,7014,62,99,"VOX",17
19,"19185",28,21,20,0,1,"VOX",0
50,"50123",449,334,331,1,3,"VOX",0
41,"41064",5596,3517,3456,55,61,"VOX",2
47,"47093",813,613,600,5,13,"VOX",1
22,"22110",738,531,527,4,4,"VOX",3
25,"25064",108,68,68,2,0,"VOX",0
40,"40063",7096,5184,5100,36,84,"VOX",14
10,"10200",392,306,302,1,4,"VOX",0
16,"16215",242,172,169,2,3,"VOX",0
47,"47085",16612,11829,11706,114,123,"VOX",33
41,"41061",2195,1749,1703,11,46,"VOX",0
50,"50065",53,43,43,0,0,"VOX",0
10,"10033",423,320,320,0,0,"VOX",0
45,"45100",188,150,150,0,0,"VOX",0
40,"40035",137,105,104,0,1,"VOX",0
39,"39099",3114,2308,2281,12,27,"VOX",0
25,"25025",1353,871,864,16,7,"VOX",0
12,"12126",24464,18533,18331,113,202,"VOX",28
46,"46014",3030,2383,2350,20,33,"VOX",12
40,"40151",46,33,33,0,0,"VOX",0
19,"19304",219,173,171,3,2,"VOX",1
28,"28013",40471,28739,28490,188,249,"VOX",129
9,"9241",202,156,154,4,2,"VOX",3
15,"15004",4834,3436,3391,30,45,"VOX",14
16,"16217",74,62,62,0,0,"VOX",0
12,"12119",148,95,93,0,2,"VOX",0
28,"28134",61008,45177,44904,263,273,"VOX",161
42,"42219",43,31,30,0,1,"VOX",1
9,"9022",66,57,57,1,0,"VOX",1
24,"24203",95,69,68,0,1,"VOX",0
18,"18076",804,551,549,1,2,"VOX",0
33,"33037",34454,22881,22586,243,295,"VOX",30
50,"50214",27,18,17,0,1,"VOX",0
24,"24077",225,190,187,2,3,"VOX",0
24,"24187",857,603,593,7,10,"VOX",0
47,"47087",381,301,297,3,4,"VOX",1
24,"24176",316,247,244,1,3,"VOX",0
9,"9423",27,24,24,0,0,"VOX",0
41,"41034",23070,14805,14625,186,180,"VOX",27
47,"47098",576,464,452,4,12,"VOX",1
47,"47078",163,127,125,1,2,"VOX",0
6,"6024",1172,905,883,4,22,"VOX",0
16,"16119",169,127,127,0,0,"VOX",0
45,"45036",656,471,469,2,2,"VOX",3
50,"50246",41,28,28,0,0,"VOX",0
19,"19161",211,159,157,1,2,"VOX",1
24,"24145",654,463,461,2,2,"VOX",1
16,"16224",83,66,65,1,1,"VOX",0
4,"4022",347,249,249,7,0,"VOX",0
28,"28160",8256,6102,6059,31,43,"VOX",48
10,"10023",835,616,607,2,9,"VOX",2
28,"28121",198,160,158,1,2,"VOX",1
50,"50026",439,335,325,10,10,"VOX",1
40,"40210",106,74,71,0,3,"VOX",0
45,"45205",6824,4424,4362,22,62,"VOX",15
45,"45137",1604,1032,1024,4,8,"VOX",1
29,"29903",524,353,349,3,4,"VOX",0
23,"23081",1513,1103,1084,10,19,"VOX",0
22,"22230",284,216,216,1,0,"VOX",0
28,"28112",161,136,136,1,0,"VOX",0
40,"40198",24,19,19,0,0,"VOX",0
24,"24014",7425,5124,5053,32,71,"VOX",8
9,"9068",29,24,24,0,0,"VOX",0
22,"22024",226,174,171,3,3,"VOX",0
3,"3098",505,393,386,0,7,"VOX",0
28,"28022",33479,27129,27037,133,92,"VOX",197
10,"10009",266,201,194,0,7,"VOX",0
45,"45195",2141,1635,1606,7,29,"VOX",4
9,"9434",1227,922,909,6,13,"VOX",8
48,"48062",302,237,236,4,1,"VOX",0
45,"45150",443,356,354,0,2,"VOX",0
45,"45901",771,547,544,3,3,"VOX",0
3,"3074",1707,1397,1389,4,8,"VOX",5
12,"12079",399,316,314,2,2,"VOX",2
22,"22232",93,71,69,1,2,"VOX",1
40,"40073",401,345,343,3,2,"VOX",0
35,"35014",11209,6016,5917,42,99,"VOX",64
26,"26179",41,32,31,0,1,"VOX",0
45,"45066",7570,5550,5484,25,66,"VOX",13
3,"3901",1135,822,817,8,5,"VOX",0
19,"19271",46,39,39,0,0,"VOX",0
15,"15047",2429,1576,1549,19,27,"VOX",2
50,"50290",386,283,282,1,1,"VOX",1
42,"42121",64,47,47,0,0,"VOX",0
9,"9220",75,56,54,1,2,"VOX",0
18,"18005",372,262,258,0,4,"VOX",2
29,"29073",1579,1091,1080,7,11,"VOX",1
28,"28173",517,390,388,1,2,"VOX",4
10,"10165",257,208,207,0,1,"VOX",0
24,"24114",3061,2025,1994,9,31,"VOX",5
10,"10150",346,285,279,3,6,"VOX",1
10,"10196",301,225,225,1,0,"VOX",0
26,"26073",97,78,78,0,0,"VOX",0
50,"50092",299,233,231,0,2,"VOX",1
9,"9388",34,27,26,0,1,"VOX",0
47,"47110",450,350,346,1,4,"VOX",2
9,"9265",37,28,28,0,0,"VOX",0
42,"42171",127,80,79,0,1,"VOX",0
3,"3026",1224,949,936,5,13,"VOX",3
9,"9177",1121,757,749,9,8,"VOX",3
12,"12048",251,185,182,0,3,"VOX",0
19,"19274",902,660,651,7,9,"VOX",2
19,"19168",292,204,198,1,6,"VOX",0
9,"9417",40,32,32,1,0,"VOX",0
50,"50255",209,163,163,5,0,"VOX",0
50,"50144",34,29,29,2,0,"VOX",0
46,"46202",16947,12814,12710,79,104,"VOX",15
4,"4023",138,96,95,2,1,"VOX",0
50,"50206",460,363,357,4,6,"VOX",1
3,"3073",236,200,199,1,1,"VOX",0
26,"26118",59,48,48,2,0,"VOX",0
10,"10905",656,446,439,2,7,"VOX",1
46,"46214",15766,12131,12036,42,95,"VOX",16
22,"22905",281,209,209,1,0,"VOX",1
9,"9375",36,31,31,0,0,"VOX",0
4,"4062",4504,3534,3490,18,44,"VOX",5
50,"50053",687,513,510,2,3,"VOX",0
16,"16084",48,38,37,1,1,"VOX",0
22,"22059",1149,807,800,3,7,"VOX",1
22,"22158",11995,8197,8126,62,71,"VOX",24
40,"40106",201,158,158,2,0,"VOX",0
14,"14070",1332,986,974,10,12,"VOX",3
30,"30039",19277,13165,13054,75,111,"VOX",20
50,"50106",134,104,104,0,0,"VOX",0
19,"19331",2609,1872,1844,12,28,"VOX",3
22,"22168",23,18,18,0,0,"VOX",0
22,"22068",79,60,60,0,0,"VOX",0
10,"10216",1538,1175,1162,4,13,"VOX",0
10,"10124",852,665,655,2,10,"VOX",5
19,"19330",71,63,63,2,0,"VOX",0
22,"22035",234,165,159,3,6,"VOX",0
22,"22094",101,74,74,1,0,"VOX",0
30,"30026",15734,10007,9901,51,106,"VOX",16
9,"9253",109,94,91,1,3,"VOX",0
41,"41060",15242,10021,9847,86,174,"VOX",15
25,"25180",234,143,143,1,0,"VOX",0
45,"45067",2318,1791,1752,19,39,"VOX",5
12,"12015",93,81,78,0,3,"VOX",0
33,"33038",2303,1584,1559,13,25,"VOX",3
3,"3049",12088,9121,9027,52,94,"VOX",16
39,"39069",1972,1510,1489,12,21,"VOX",5
24,"24020",456,314,307,4,7,"VOX",0
40,"40206",173,135,134,0,1,"VOX",0
50,"50034",826,567,563,5,4,"VOX",1
50,"50007",45,34,34,1,0,"VOX",0
10,"10106",130,109,108,2,1,"VOX",0
10,"10096",3408,2440,2391,12,49,"VOX",6
47,"47050",3719,2630,2598,26,32,"VOX",6
18,"18148",817,637,634,5,3,"VOX",0
3,"3122",42425,30153,29954,154,199,"VOX",59
25,"25248",891,592,586,6,6,"VOX",0
3,"3115",255,222,220,2,2,"VOX",0
22,"22206",193,129,128,1,1,"VOX",0
12,"12087",25,18,18,4,0,"VOX",0
48,"48914",332,272,272,1,0,"VOX",0
42,"42130",59,46,45,1,1,"VOX",0
40,"40025",136,117,115,0,2,"VOX",0
24,"24119",706,488,481,3,7,"VOX",3
45,"45196",1400,1047,1033,5,14,"VOX",1
42,"42139",23,15,15,1,0,"VOX",0
9,"9365",29,19,19,0,0,"VOX",0
9,"9115",92,68,67,0,1,"VOX",0
47,"47105",183,158,156,0,2,"VOX",1
6,"6054",5446,3920,3833,32,87,"VOX",9
22,"22244",52,38,37,0,1,"VOX",0
29,"29081",261,197,197,1,0,"VOX",0
19,"19174",109,80,79,0,1,"VOX",0
45,"45081",17875,12656,12533,82,123,"VOX",60
9,"9438",538,437,433,6,4,"VOX",0
19,"19051",67,63,63,0,0,"VOX",0
40,"40155",3518,2656,2605,18,51,"VOX",8
39,"39001",2102,1622,1601,18,21,"VOX",4
22,"22217",385,287,281,1,6,"VOX",2
9,"9079",49,45,45,0,0,"VOX",0
26,"26141",113,87,82,0,5,"VOX",0
18,"18914",1649,1238,1213,3,25,"VOX",0
23,"23099",4769,3359,3309,16,50,"VOX",11
45,"45186",3061,2242,2214,11,28,"VOX",5
9,"9173",124,100,99,2,1,"VOX",0
24,"24158",320,207,203,2,4,"VOX",0
25,"25157",181,115,114,7,1,"VOX",0
23,"23055",47167,31479,31198,264,281,"VOX",53
40,"40170",1320,1030,1021,7,9,"VOX",1
33,"33013",446,321,318,3,3,"VOX",2
50,"50173",182,132,131,1,1,"VOX",0
15,"15083",1086,757,746,5,11,"VOX",0
14,"14035",5966,4236,4177,39,59,"VOX",3
45,"45061",2447,1703,1689,12,14,"VOX",0
50,"50248",508,387,374,2,13,"VOX",0
9,"9025",122,83,83,1,0,"VOX",2
28,"28161",48848,35503,35203,210,300,"VOX",176
3,"3033",117,96,95,0,1,"VOX",0
21,"21042",15350,7643,7530,124,113,"VOX",15
22,"22076",311,201,199,0,2,"VOX",0
40,"40044",145,114,113,2,1,"VOX",0
45,"45095",689,513,505,0,8,"VOX",0
24,"24123",746,488,485,2,3,"VOX",0
24,"24173",951,679,674,9,5,"VOX",2
22,"22199",7000,4737,4688,104,49,"VOX",3
48,"48907",348,266,266,2,0,"VOX",0
26,"26147",30,28,27,0,1,"VOX",0
19,"19309",26,21,21,0,0,"VOX",0
42,"42196",10,7,7,0,0,"VOX",0
45,"45018",498,333,330,4,3,"VOX",3
12,"12058",71,63,62,1,1,"VOX",0
30,"30003",24332,16183,16040,104,143,"VOX",35
22,"22004",135,81,80,0,1,"VOX",0
50,"50102",859,658,653,8,5,"VOX",0
24,"24059",880,536,535,4,1,"VOX",0
48,"48034",12866,8798,8747,43,51,"VOX",5
19,"19125",41,32,32,0,0,"VOX",0
46,"46053",553,445,436,2,9,"VOX",0
29,"29007",27491,19071,18910,153,161,"VOX",50
50,"50291",96,74,74,0,0,"VOX",3
45,"45119",3330,2096,2067,15,29,"VOX",0
25,"25111",117,72,70,2,2,"VOX",0
9,"9037",111,91,91,0,0,"VOX",1
23,"23019",1536,1196,1174,2,22,"VOX",0
25,"25122",1915,1208,1197,16,11,"VOX",2
9,"9192",55,43,43,0,0,"VOX",0
46,"46193",8788,6925,6871,50,54,"VOX",11
11,"11002",4273,2835,2815,16,20,"VOX",1
29,"29063",323,250,245,1,5,"VOX",0
50,"50265",79,61,61,0,0,"VOX",0
50,"50017",1773,1276,1269,13,7,"VOX",5
41,"41062",2223,1653,1637,7,16,"VOX",0
41,"41073",1707,1055,1041,5,14,"VOX",0
50,"50169",351,269,265,0,4,"VOX",2
25,"25913",86,67,67,3,0,"VOX",0
47,"47225",80,63,63,0,0,"VOX",1
40,"40099",52,44,42,0,2,"VOX",0
28,"28045",33328,24620,24434,146,186,"VOX",131
46,"46075",150,130,123,1,7,"VOX",0
6,"6139",553,420,419,1,1,"VOX",0
16,"16175",5095,3980,3914,35,66,"VOX",9
19,"19228",26,20,20,0,0,"VOX",0
21,"21073",1862,1125,1109,8,16,"VOX",1
15,"15043",5114,3476,3401,47,75,"VOX",1
39,"39040",4292,3208,3166,14,42,"VOX",6
42,"42201",22,22,21,0,1,"VOX",0
18,"18119",1702,1298,1283,13,15,"VOX",3
23,"23079",3717,2825,2801,28,24,"VOX",2
24,"24001",189,124,122,0,2,"VOX",0
25,"25003",3762,2215,2195,22,20,"VOX",3
25,"25125",417,250,250,5,0,"VOX",0
10,"10094",234,196,196,1,0,"VOX",0
19,"19019",20,18,17,0,1,"VOX",0
50,"50012",100,80,79,2,1,"VOX",0
50,"50294",70,63,63,0,0,"VOX",0
16,"16115",44,35,34,0,1,"VOX",0
15,"15015",2799,2045,2008,24,37,"VOX",2
48,"48048",557,395,393,5,2,"VOX",0
39,"39058",810,559,557,2,2,"VOX",2
33,"33076",12258,8106,8031,63,75,"VOX",29
22,"22221",84,58,58,0,0,"VOX",1
50,"50271",252,200,197,2,3,"VOX",1
9,"9419",78,55,55,0,0,"VOX",0
26,"26010",93,80,80,2,0,"VOX",0
24,"24902",347,270,269,2,1,"VOX",0
11,"11006",24455,15750,15587,193,163,"VOX",15
22,"22009",617,444,441,6,3,"VOX",1
19,"19291",1191,879,869,3,10,"VOX",2
9,"9413",436,306,302,2,4,"VOX",0
40,"40047",30,25,25,0,0,"VOX",1
24,"24112",309,228,227,1,1,"VOX",0
24,"24024",692,496,491,4,5,"VOX",0
40,"40024",856,651,639,6,12,"VOX",0
24,"24215",152,113,113,0,0,"VOX",0
15,"15054",32106,21026,20772,259,254,"VOX",33
26,"26162",121,99,99,1,0,"VOX",0
46,"46213",15409,10924,10805,97,119,"VOX",41
21,"21001",637,462,455,6,7,"VOX",0
25,"25902",567,365,356,8,9,"VOX",2
46,"46023",327,280,278,2,2,"VOX",0
28,"28052",3855,2626,2587,11,39,"VOX",19
9,"9395",138,104,104,0,0,"VOX",0
26,"26131",35,33,33,1,0,"VOX",0
50,"50124",415,318,317,2,1,"VOX",0
41,"41063",2695,1850,1830,13,20,"VOX",5
3,"3128",4092,2861,2840,10,21,"VOX",6
26,"26171",176,139,133,1,6,"VOX",0
33,"33068",1093,645,641,4,4,"VOX",1
10,"10021",5147,3744,3648,31,96,"VOX",3
19,"19148",45,32,31,0,1,"VOX",0
9,"9094",53,42,42,1,0,"VOX",0
9,"9027",46,42,41,0,1,"VOX",0
23,"23053",9531,6704,6658,37,46,"VOX",2
4,"4066",13571,8786,8724,50,62,"VOX",10
40,"40223",216,163,163,1,0,"VOX",0
19,"19335",55,47,47,0,0,"VOX",0
50,"50121",277,216,214,1,2,"VOX",0
24,"24146",265,210,207,1,3,"VOX",0
24,"24100",761,561,555,7,6,"VOX",1
50,"50185",133,108,108,1,0,"VOX",0
3,"3038",355,288,285,3,3,"VOX",2
50,"50284",141,107,104,0,3,"VOX",0
48,"48045",5167,3809,3757,28,52,"VOX",0
18,"18906",905,664,657,3,7,"VOX",2
18,"18061",1057,812,804,1,8,"VOX",0
47,"47126",50,41,41,0,0,"VOX",0
39,"39083",1135,679,670,8,9,"VOX",2
29,"29093",2214,1643,1621,3,22,"VOX",2
18,"18912",1473,994,979,3,15,"VOX",0
12,"12037",17,16,14,0,2,"VOX",0
25,"25008",1124,715,702,10,13,"VOX",1
22,"22078",438,319,316,3,3,"VOX",0
19,"19280",3464,2469,2438,14,31,"VOX",15
33,"33050",592,387,376,2,11,"VOX",0
22,"22014",243,192,188,3,4,"VOX",0
50,"50279",86,64,64,0,0,"VOX",0
42,"42020",4263,2877,2821,35,56,"VOX",5
39,"39084",838,631,624,2,7,"VOX",0
42,"42183",111,82,82,2,0,"VOX",0
22,"22051",100,81,81,0,0,"VOX",0
39,"39094",848,655,651,3,4,"VOX",1
4,"4082",297,200,200,0,0,"VOX",0
19,"19006",769,547,540,2,7,"VOX",1
46,"46096",274,209,209,1,0,"VOX",0
42,"42051",20,14,14,1,0,"VOX",0
45,"45169",189,140,138,0,2,"VOX",1
26,"26005",2381,1598,1577,23,21,"VOX",5
22,"22242",62,45,44,0,1,"VOX",0
48,"48007",364,240,240,5,0,"VOX",0
3,"3013",1113,839,836,4,3,"VOX",3
9,"9046",29,25,25,0,0,"VOX",0
46,"46027",943,780,771,5,9,"VOX",7
16,"16016",224,171,168,0,3,"VOX",0
18,"18020",1028,691,686,3,5,"VOX",2
47,"47138",241,170,164,1,6,"VOX",0
28,"28065",126539,96997,96210,505,787,"VOX",321
23,"23032",566,450,448,4,2,"VOX",0
47,"47029",57,52,52,0,0,"VOX",0
16,"16157",211,179,179,2,0,"VOX",0
10,"10206",215,157,157,3,0,"VOX",0
10,"10028",90,73,73,0,0,"VOX",0
45,"45046",2412,1667,1654,7,13,"VOX",1
1,"1017",849,571,565,5,6,"VOX",2
42,"42213",27,21,21,1,0,"VOX",0
9,"9132",171,122,122,2,0,"VOX",1
4,"4081",355,287,287,0,0,"VOX",0
40,"40230",94,68,66,0,2,"VOX",0
4,"4020",288,201,197,0,4,"VOX",1
18,"18121",129,98,98,1,0,"VOX",0
50,"50193",651,514,501,2,13,"VOX",0
50,"50140",166,115,115,0,0,"VOX",0
26,"26150",112,101,95,0,6,"VOX",0
39,"39015",839,647,642,4,5,"VOX",2
35,"35027",10344,7310,7216,50,94,"VOX",3
26,"26013",347,249,246,2,3,"VOX",0
42,"42098",10,7,7,1,0,"VOX",0
25,"25119",2248,1449,1442,15,7,"VOX",2
19,"19218",50,33,33,0,0,"VOX",1
46,"46020",3760,2916,2866,22,50,"VOX",3
25,"25049",151,110,108,1,2,"VOX",0
19,"19278",28,26,26,0,0,"VOX",0
21,"21078",2726,1793,1768,17,25,"VOX",0
25,"25245",435,289,280,5,9,"VOX",1
3,"3007",166,139,137,0,2,"VOX",0
40,"40039",210,156,153,3,3,"VOX",2
40,"40030",473,369,363,3,6,"VOX",0
42,"42192",42,27,27,2,0,"VOX",0
26,"26043",365,292,281,1,11,"VOX",0
46,"46260",2581,2087,2068,22,19,"VOX",2
50,"50171",106,79,79,0,0,"VOX",1
3,"3018",12240,8853,8777,47,76,"VOX",20
50,"50253",423,330,328,4,2,"VOX",0
25,"25011",5243,2796,2767,23,29,"VOX",0
4,"4083",1776,1345,1336,6,9,"VOX",0
46,"46004",1922,1565,1547,11,18,"VOX",2
42,"42026",24,20,20,0,0,"VOX",0
40,"40021",27,27,26,0,1,"VOX",0
25,"25912",857,547,539,1,8,"VOX",0
16,"16086",890,740,735,6,5,"VOX",1
15,"15037",4061,2588,2552,19,36,"VOX",1
46,"46084",1576,1263,1242,5,21,"VOX",5
21,"21064",6522,4227,4146,48,81,"VOX",4
19,"19154",68,56,54,0,2,"VOX",0
40,"40110",349,265,263,3,2,"VOX",0
3,"3111",5436,3918,3883,18,35,"VOX",3
9,"9038",119,100,100,0,0,"VOX",0
12,"12136",2635,2201,2171,18,30,"VOX",11
39,"39093",299,229,226,4,3,"VOX",0
24,"24060",602,363,361,3,2,"VOX",1
39,"39012",6687,5021,4957,51,64,"VOX",7
25,"25131",403,248,241,7,7,"VOX",1
25,"25058",4357,2624,2595,20,29,"VOX",3
45,"45176",3706,2554,2521,22,33,"VOX",5
3,"3132",534,436,435,3,1,"VOX",0
3,"3015",12566,9257,9177,39,80,"VOX",28
9,"9412",790,528,523,4,5,"VOX",0
25,"25242",720,456,450,2,6,"VOX",1
46,"46904",792,610,603,8,7,"VOX",0
15,"15005",24516,15761,15537,213,224,"VOX",36
46,"46026",1204,1015,1004,3,11,"VOX",0
18,"18171",2120,1572,1551,9,21,"VOX",1
25,"25174",397,280,280,2,0,"VOX",0
42,"42106",14,10,10,0,0,"VOX",0
16,"16278",70,55,55,0,0,"VOX",0
25,"25016",2107,1268,1259,14,9,"VOX",0
4,"4087",182,135,135,0,0,"VOX",0
10,"10113",2338,1679,1638,9,41,"VOX",1
24,"24141",95,85,84,0,1,"VOX",0
42,"42145",138,108,107,2,1,"VOX",0
48,"48020",273626,184710,183628,1185,1082,"VOX",234
24,"24137",1099,783,778,7,5,"VOX",0
50,"50099",3083,2148,2132,13,16,"VOX",3
19,"19162",68,49,47,0,2,"VOX",0
3,"3051",348,296,294,0,2,"VOX",0
26,"26105",2205,1670,1658,12,12,"VOX",2
25,"25030",135,74,72,1,2,"VOX",0
18,"18105",3782,2450,2420,17,30,"VOX",0
9,"9208",210,136,134,3,2,"VOX",1
40,"40034",84,70,70,0,0,"VOX",1
50,"50019",55,41,41,0,0,"VOX",0
23,"23042",292,217,213,1,4,"VOX",0
45,"45050",457,333,328,1,5,"VOX",0
22,"22063",169,133,129,1,4,"VOX",0
19,"19173",45,38,36,0,2,"VOX",0
9,"9216",387,270,265,1,5,"VOX",1
10,"10135",1302,981,969,3,12,"VOX",1
10,"10039",417,291,291,0,0,"VOX",0
18,"18126",1483,1081,1074,15,7,"VOX",0
24,"24054",430,314,313,1,1,"VOX",0
24,"24139",2183,1548,1525,16,23,"VOX",5
12,"12131",63,52,52,0,0,"VOX",0
28,"28018",3768,2968,2945,26,23,"VOX",9
50,"50131",231,167,165,0,2,"VOX",2
10,"10071",139,96,94,0,2,"VOX",0
29,"29055",1796,1354,1336,11,18,"VOX",3
19,"19272",72,54,53,1,1,"VOX",0
46,"46105",16190,11323,11206,44,117,"VOX",26
11,"11016",14929,9426,9302,123,124,"VOX",23
12,"12044",468,419,412,3,7,"VOX",1
18,"18046",1832,1160,1140,6,20,"VOX",4
42,"42120",145,91,89,2,2,"VOX",0
25,"25136",95,64,64,1,0,"VOX",0
28,"28020",145,94,94,0,0,"VOX",0
47,"47003",227,180,179,3,1,"VOX",1
10,"10202",606,473,463,4,10,"VOX",2
12,"12050",1305,1015,1000,6,15,"VOX",0
19,"19129",28,26,26,0,0,"VOX",0
23,"23093",3226,2302,2273,19,29,"VOX",0
50,"50134",128,91,89,2,2,"VOX",1
10,"10128",5697,3958,3891,32,67,"VOX",1
16,"16118",1375,1106,1086,13,20,"VOX",1
33,"33021",4573,3024,2971,22,53,"VOX",6
16,"16249",1995,1519,1499,6,20,"VOX",1
18,"18079",3441,2442,2411,16,31,"VOX",0
46,"46001",795,601,592,3,9,"VOX",2
40,"40087",92,71,70,1,1,"VOX",0
3,"3029",245,185,183,1,2,"VOX",0
12,"12104",6933,5411,5342,25,69,"VOX",10
46,"46009",3121,2459,2427,8,32,"VOX",10
10,"10209",282,179,177,1,2,"VOX",0
45,"45108",509,412,411,1,1,"VOX",0
16,"16275",11,11,11,1,0,"VOX",0
50,"50150",649,402,397,2,5,"VOX",0
10,"10125",888,635,622,4,13,"VOX",1
18,"18902",816,632,620,4,12,"VOX",0
24,"24055",708,516,512,0,4,"VOX",2
16,"16192",48,31,30,1,1,"VOX",0
25,"25027",976,633,630,7,3,"VOX",0
22,"22040",144,117,115,1,2,"VOX",0
30,"30032",2856,2163,2144,6,19,"VOX",2
47,"47040",64,53,53,0,0,"VOX",0
9,"9306",106,82,82,1,0,"VOX",0
50,"50256",83,53,53,0,0,"VOX",0
29,"29009",1468,1069,1045,8,24,"VOX",0
45,"45006",1406,942,931,4,11,"VOX",1
12,"12084",17615,12766,12644,105,122,"VOX",44
39,"39035",9502,7017,6928,57,89,"VOX",5
50,"50029",626,450,450,3,0,"VOX",0
50,"50901",138,105,105,0,0,"VOX",0
26,"26124",807,649,639,7,10,"VOX",1
33,"33025",9174,5838,5786,57,52,"VOX",5
33,"33020",13307,9011,8914,99,97,"VOX",17
3,"3008",168,130,129,0,1,"VOX",0
16,"16058",103,77,77,0,0,"VOX",0
33,"33053",1141,742,732,6,10,"VOX",3
28,"28073",12549,8788,8701,54,87,"VOX",32
10,"10210",543,356,355,1,1,"VOX",0
40,"40159",142,100,99,1,1,"VOX",0
3,"3023",1398,1184,1167,7,17,"VOX",2
3,"3055",5164,3695,3647,21,48,"VOX",6
18,"18179",538,376,374,6,2,"VOX",0
47,"47146",255,206,204,1,2,"VOX",1
23,"23065",1597,1170,1149,2,21,"VOX",0
46,"46094",20540,15378,15234,102,144,"VOX",37
51,"51001",59125,31093,30737,316,356,"VOX",139
19,"19017",69,57,57,0,0,"VOX",0
16,"16129",95,81,79,0,2,"VOX",0
22,"22015",319,234,228,3,6,"VOX",2
41,"41024",22600,14263,14048,128,215,"VOX",27
10,"10123",578,481,475,1,6,"VOX",0
19,"19324",176,126,125,3,1,"VOX",0
3,"3014",237287,167428,166445,847,983,"VOX",443
22,"22207",125,72,71,2,1,"VOX",0
14,"14036",3740,2747,2696,24,51,"VOX",0
21,"21011",3453,2441,2419,15,22,"VOX",1
16,"16239",135,110,105,0,5,"VOX",0
46,"46024",413,314,313,2,1,"VOX",0
25,"25092",130,98,95,2,3,"VOX",0
18,"18062",10393,7235,7161,63,74,"VOX",18
6,"6010",1105,819,801,5,18,"VOX",1
24,"24160",684,483,474,6,9,"VOX",3
18,"18133",2168,1648,1636,6,12,"VOX",1
47,"47063",103,81,80,1,1,"VOX",0
10,"10073",747,524,516,4,8,"VOX",0
25,"25132",136,88,87,0,1,"VOX",0
47,"47011",565,461,458,5,3,"VOX",0
25,"25250",345,210,204,0,6,"VOX",0
40,"40208",766,596,589,3,7,"VOX",0
35,"35029",4152,2530,2498,32,32,"VOX",2
22,"22248",116,92,90,1,2,"VOX",0
41,"41044",7423,5273,5241,34,32,"VOX",10
12,"12096",777,587,577,6,10,"VOX",1
18,"18141",404,285,282,0,3,"VOX",1
16,"16227",113,93,93,0,0,"VOX",0
50,"50040",89,75,75,0,0,"VOX",0
24,"24188",3822,2850,2817,19,33,"VOX",8
25,"25163",231,135,132,2,3,"VOX",1
22,"22106",22,14,14,0,0,"VOX",0
10,"10144",975,746,735,3,11,"VOX",0
42,"42022",221,173,171,5,2,"VOX",0
28,"28059",4323,3171,3157,11,14,"VOX",12
50,"50107",947,738,733,4,5,"VOX",4
47,"47149",42,34,34,3,0,"VOX",0
33,"33024",226679,158750,157564,1209,1186,"VOX",441
22,"22060",1164,858,850,3,8,"VOX",3
25,"25033",1096,729,723,4,6,"VOX",0
10,"10184",756,613,604,10,9,"VOX",1
15,"15048",4839,3456,3414,36,42,"VOX",5
47,"47118",168,127,127,2,0,"VOX",0
15,"15028",1409,1038,1024,6,14,"VOX",0
24,"24043",134,75,75,1,0,"VOX",0
47,"47232",102,77,74,1,3,"VOX",0
39,"39020",23592,15594,15384,128,210,"VOX",32
18,"18001",251,168,167,5,1,"VOX",0
47,"47169",68,59,59,0,0,"VOX",0
35,"35011",24002,15928,15684,95,244,"VOX",26
41,"41031",1238,825,814,11,11,"VOX",0
40,"40213",86,65,65,3,0,"VOX",0
18,"18103",757,579,575,4,4,"VOX",0
9,"9143",27,19,18,0,1,"VOX",0
15,"15081",1034,791,782,11,9,"VOX",0
40,"40003",139,107,104,0,3,"VOX",0
19,"19257",3403,2430,2402,19,28,"VOX",5
9,"9272",282,210,206,3,4,"VOX",0
42,"42085",189,129,127,3,2,"VOX",0
