"prov_code","muni_code","censo","votantes","validos","blancos","nulos","siglas","votos"
38,"38027",5545,3937,3896,22,41,"AHORA CANAR",5
35,"35020",5933,4140,4088,14,52,"AHORA CANAR",9
38,"38011",21563,15380,15214,69,166,"AHORA CANAR",48
38,"38017",30646,18576,18373,100,203,"AHORA CANAR",96
38,"38036",6831,4947,4829,58,118,"AHORA CANAR",19
38,"38028",22035,15684,15522,86,162,"AHORA CANAR",55
38,"38033",3594,2512,2467,11,45,"AHORA CANAR",1
38,"38007",1625,1124,1104,2,20,"AHORA CANAR",3
38,"38019",13758,8870,8776,46,94,"AHORA CANAR",20
38,"38037",12803,8628,8517,48,111,"AHORA CANAR",14
35,"35030",9949,6611,6462,65,149,"AHORA CANAR",12
35,"35014",11908,7101,6947,63,154,"AHORA CANAR",14
35,"35029",4357,2869,2832,32,37,"AHORA CANAR",6
35,"35032",3348,2585,2542,20,43,"AHORA CANAR",2
38,"38053",3763,2628,2588,21,40,"AHORA CANAR",5
38,"38049",2683,1781,1743,18,38,"AHORA CANAR",5
35,"35005",1017,751,743,1,8,"AHORA CANAR",1
38,"38005",5666,3795,3761,24,34,"AHORA CANAR",28
35,"35003",5582,3441,3391,26,50,"AHORA CANAR",5
38,"38010",3974,2814,2777,20,37,"AHORA CANAR",5
38,"38003",1510,1058,1047,4,11,"AHORA CANAR",0
38,"38022",18629,12903,12759,84,144,"AHORA CANAR",33
38,"38038",164468,112475,111577,728,898,"AHORA CANAR",414
38,"38047",1756,1276,1259,6,17,"AHORA CANAR",1
35,"35024",14243,9496,9394,65,102,"AHORA CANAR",23
35,"35008",6207,4733,4654,42,79,"AHORA CANAR",6
38,"38016",1178,654,648,6,6,"AHORA CANAR",4
35,"35026",82764,55647,54846,499,801,"AHORA CANAR",108
35,"35033",6403,4565,4502,34,63,"AHORA CANAR",10
35,"35034",8396,4599,4546,55,53,"AHORA CANAR",5
38,"38041",6970,5288,5258,38,30,"AHORA CANAR",12
35,"35019",32841,21136,20850,125,286,"AHORA CANAR",32
38,"38029",1493,839,823,5,16,"AHORA CANAR",2
35,"35006",31309,23434,23019,221,415,"AHORA CANAR",61
35,"35012",10765,6327,6270,32,57,"AHORA CANAR",9
35,"35009",20109,15017,14803,78,214,"AHORA CANAR",21
38,"38032",13536,9924,9867,63,57,"AHORA CANAR",29
38,"38021",1599,1079,1057,8,22,"AHORA CANAR",1
35,"35001",4571,3523,3463,8,60,"AHORA CANAR",5
38,"38006",41302,23632,23415,133,217,"AHORA CANAR",133
38,"38004",4490,3242,3202,18,40,"AHORA CANAR",6
38,"38025",7088,5166,5089,39,77,"AHORA CANAR",19
35,"35002",24129,16979,16736,116,243,"AHORA CANAR",48
35,"35022",51302,33009,32566,198,443,"AHORA CANAR",206
38,"38030",1945,1430,1420,6,10,"AHORA CANAR",3
35,"35027",10499,7651,7530,57,121,"AHORA CANAR",12
35,"35016",300503,203470,201240,1598,2230,"AHORA CANAR",427
38,"38031",29154,22871,22598,143,273,"AHORA CANAR",59
38,"38045",3549,2149,2109,6,40,"AHORA CANAR",3
38,"38008",5658,4126,4056,19,70,"AHORA CANAR",3
38,"38015",4067,2951,2926,22,25,"AHORA CANAR",26
35,"35011",24705,17099,16823,129,276,"AHORA CANAR",35
38,"38050",2436,1564,1529,12,35,"AHORA CANAR",7
38,"38048",3957,2889,2842,12,47,"AHORA CANAR",3
38,"38012",2310,1705,1687,6,18,"AHORA CANAR",13
38,"38002",972,678,640,3,38,"AHORA CANAR",1
35,"35031",7412,5593,5519,41,74,"AHORA CANAR",12
35,"35015",10728,6233,6108,54,125,"AHORA CANAR",24
38,"38046",9271,7297,7212,53,85,"AHORA CANAR",31
35,"35021",15014,10909,10792,71,117,"AHORA CANAR",18
35,"35028",10044,6188,6105,52,83,"AHORA CANAR",6
35,"35023",11694,8785,8607,67,178,"AHORA CANAR",11
35,"35010",3797,2601,2572,9,29,"AHORA CANAR",9
38,"38901",1456,1024,1010,9,14,"AHORA CANAR",1
38,"38040",5446,3513,3462,13,51,"AHORA CANAR",5
38,"38018",4455,3242,3198,24,44,"AHORA CANAR",7
38,"38052",1280,893,887,4,6,"AHORA CANAR",1
38,"38039",11112,8233,8161,54,72,"AHORA CANAR",13
38,"38035",10384,6657,6596,50,61,"AHORA CANAR",17
38,"38023",125528,88323,87456,598,867,"AHORA CANAR",381
38,"38009",4299,3105,3069,16,36,"AHORA CANAR",6
35,"35004",41728,23957,23683,219,274,"AHORA CANAR",62
38,"38051",7326,5418,5352,27,66,"AHORA CANAR",14
35,"35018",13056,8699,8618,73,81,"AHORA CANAR",18
35,"35025",1773,1247,1235,9,12,"AHORA CANAR",1
38,"38044",2199,1443,1429,10,14,"AHORA CANAR",1
38,"38042",3781,2799,2774,11,25,"AHORA CANAR",6
38,"38024",15310,10234,10088,82,146,"AHORA CANAR",12
38,"38026",33514,26298,26076,191,222,"AHORA CANAR",65
35,"35013",6584,5067,4974,49,93,"AHORA CANAR",3
38,"38043",19265,14000,13856,115,144,"AHORA CANAR",57
35,"35017",27216,17531,17102,133,429,"AHORA CANAR",36
35,"35007",518,405,401,0,4,"AHORA CANAR",0
38,"38020",15899,11057,10924,90,133,"AHORA CANAR",36
38,"38013",3019,2023,1991,12,32,"AHORA CANAR",3
38,"38034",3998,3033,2993,19,40,"AHORA CANAR",6
38,"38001",20907,12323,12197,70,126,"AHORA CANAR",27
38,"38014",1341,991,981,6,10,"AHORA CANAR",4
33,"33010",1724,1211,1202,15,9,"ANDECHA AST",0
33,"33060",14132,9960,9794,135,166,"ANDECHA AST",17
33,"33077",1118,772,761,4,11,"ANDECHA AST",0
33,"33006",1480,1001,992,9,9,"ANDECHA AST",5
33,"33013",429,320,316,1,4,"ANDECHA AST",0
33,"33008",1705,1285,1273,9,12,"ANDECHA AST",1
33,"33073",8186,5090,5023,65,67,"ANDECHA AST",4
33,"33027",769,505,497,14,8,"ANDECHA AST",1
33,"33062",388,250,245,9,5,"ANDECHA AST",0
33,"33036",11335,8356,8243,92,113,"ANDECHA AST",12
33,"33076",12147,8532,8452,104,80,"ANDECHA AST",10
33,"33002",9474,6779,6662,74,117,"ANDECHA AST",19
33,"33046",483,370,367,6,3,"ANDECHA AST",1
33,"33029",323,172,170,2,2,"ANDECHA AST",0
33,"33007",1398,960,951,9,9,"ANDECHA AST",0
33,"33066",42882,30942,30529,401,413,"ANDECHA AST",64
33,"33020",13000,9476,9338,108,138,"ANDECHA AST",16
33,"33067",747,608,596,9,12,"ANDECHA AST",1
33,"33018",2819,2072,2044,28,28,"ANDECHA AST",3
33,"33072",1455,973,963,14,10,"ANDECHA AST",0
33,"33035",11226,8326,8252,112,74,"ANDECHA AST",5
33,"33050",558,381,375,2,6,"ANDECHA AST",0
33,"33025",8996,6369,6309,81,60,"ANDECHA AST",5
33,"33051",6811,4879,4809,63,70,"ANDECHA AST",1
33,"33001",1504,875,864,15,11,"ANDECHA AST",2
33,"33015",1428,1003,993,7,10,"ANDECHA AST",0
33,"33059",4403,3007,2942,42,65,"ANDECHA AST",2
33,"33034",10043,6765,6671,69,94,"ANDECHA AST",6
33,"33075",253,139,135,1,4,"ANDECHA AST",0
33,"33026",8270,5540,5474,69,66,"ANDECHA AST",2
33,"33068",1047,624,620,8,4,"ANDECHA AST",0
33,"33033",9439,6565,6468,78,97,"ANDECHA AST",12
33,"33044",177352,134444,133352,1391,1092,"ANDECHA AST",178
33,"33078",126,87,85,0,2,"ANDECHA AST",1
33,"33048",136,87,87,1,0,"ANDECHA AST",0
33,"33024",225188,169937,168490,1483,1447,"ANDECHA AST",247
33,"33064",250,175,174,0,1,"ANDECHA AST",0
33,"33014",8771,6425,6368,51,57,"ANDECHA AST",7
33,"33052",704,520,513,5,7,"ANDECHA AST",0
33,"33032",11086,8028,7849,129,179,"ANDECHA AST",11
33,"33058",1664,1205,1176,5,29,"ANDECHA AST",5
33,"33047",1074,841,835,12,6,"ANDECHA AST",0
33,"33011",10659,6448,6332,119,116,"ANDECHA AST",8
33,"33069",3419,2557,2533,32,24,"ANDECHA AST",5
33,"33023",3271,2448,2397,35,51,"ANDECHA AST",2
33,"33004",65515,48686,48245,511,441,"ANDECHA AST",72
33,"33028",1158,635,630,6,5,"ANDECHA AST",2
33,"33030",873,678,671,1,7,"ANDECHA AST",3
33,"33042",4243,3137,3103,36,34,"ANDECHA AST",21
33,"33041",7112,5251,5194,63,57,"ANDECHA AST",7
33,"33021",4361,3098,3043,31,55,"ANDECHA AST",7
33,"33056",4877,3469,3420,30,49,"ANDECHA AST",1
33,"33054",1611,1145,1124,8,21,"ANDECHA AST",2
33,"33019",2882,1981,1939,8,42,"ANDECHA AST",2
33,"33065",1084,761,746,18,15,"ANDECHA AST",3
33,"33017",2997,2096,2058,29,38,"ANDECHA AST",0
33,"33038",2234,1669,1644,16,25,"ANDECHA AST",5
33,"33070",3293,2499,2473,32,26,"ANDECHA AST",2
33,"33061",350,201,200,2,1,"ANDECHA AST",0
33,"33057",1538,1129,1097,14,32,"ANDECHA AST",1
33,"33055",1492,1156,1121,6,35,"ANDECHA AST",1
33,"33005",1376,929,916,14,13,"ANDECHA AST",0
33,"33037",33247,23529,23210,297,319,"ANDECHA AST",32
33,"33053",1079,738,729,6,9,"ANDECHA AST",1
33,"33045",4382,3214,3156,23,58,"ANDECHA AST",6
33,"33071",563,413,407,2,6,"ANDECHA AST",0
33,"33031",33854,23523,23143,307,380,"ANDECHA AST",47
33,"33049",6044,4152,4079,56,73,"ANDECHA AST",11
33,"33009",869,595,591,5,4,"ANDECHA AST",0
33,"33016",18904,14376,14235,168,141,"ANDECHA AST",17
33,"33003",612,373,369,6,4,"ANDECHA AST",0
33,"33040",4566,3205,3150,50,55,"ANDECHA AST",8
33,"33022",813,555,543,6,12,"ANDECHA AST",1
33,"33012",5105,3601,3566,46,35,"ANDECHA AST",1
33,"33043",658,462,455,4,7,"ANDECHA AST",1
33,"33063",374,284,283,3,1,"ANDECHA AST",0
33,"33039",1641,1251,1243,6,8,"ANDECHA AST",1
33,"33074",3376,2345,2311,41,34,"ANDECHA AST",1
7,"7003",12374,7550,7442,51,108,"ARA-MES-ESQ",253
7,"7049",1480,1092,1075,10,17,"ARA-MES-ESQ",151
7,"7053",1164,956,948,4,8,"ARA-MES-ESQ",77
7,"7041",2097,1662,1634,20,28,"ARA-MES-ESQ",276
7,"7045",1300,1038,1030,6,8,"ARA-MES-ESQ",113
7,"7047",2371,1775,1747,13,28,"ARA-MES-ESQ",120
7,"7025",446,363,362,4,1,"ARA-MES-ESQ",14
7,"7005",6975,4824,4775,43,49,"ARA-MES-ESQ",244
7,"7019",164,124,124,0,0,"ARA-MES-ESQ",3
7,"7027",22047,14986,14853,139,133,"ARA-MES-ESQ",639
7,"7008",6047,4570,4513,31,57,"ARA-MES-ESQ",426
7,"7007",414,326,324,2,2,"ARA-MES-ESQ",43
7,"7021",230,183,178,3,5,"ARA-MES-ESQ",11
7,"7044",8791,6335,6196,66,139,"ARA-MES-ESQ",594
7,"7015",21976,14458,14297,205,161,"ARA-MES-ESQ",1182
7,"7026",30991,19827,19602,161,225,"ARA-MES-ESQ",302
7,"7064",5528,3793,3765,23,28,"ARA-MES-ESQ",172
7,"7009",741,554,544,4,10,"ARA-MES-ESQ",74
7,"7040",288348,192799,191053,1586,1746,"ARA-MES-ESQ",6090
7,"7017",882,652,646,6,6,"ARA-MES-ESQ",53
7,"7012",1909,1358,1343,15,15,"ARA-MES-ESQ",171
7,"7052",4816,3276,3258,39,18,"ARA-MES-ESQ",176
7,"7020",3692,2833,2808,42,25,"ARA-MES-ESQ",444
7,"7001",3628,2792,2753,18,39,"ARA-MES-ESQ",234
7,"7018",379,287,286,1,1,"ARA-MES-ESQ",30
7,"7054",22958,14097,13908,123,189,"ARA-MES-ESQ",177
7,"7058",2857,2258,2233,18,25,"ARA-MES-ESQ",198
7,"7011",28642,19567,19396,147,171,"ARA-MES-ESQ",268
7,"7050",3442,2303,2275,28,28,"ARA-MES-ESQ",52
7,"7010",5070,3815,3777,47,38,"ARA-MES-ESQ",300
7,"7028",920,686,676,8,10,"ARA-MES-ESQ",84
7,"7036",27950,20870,20707,154,163,"ARA-MES-ESQ",765
7,"7057",7404,5117,5028,50,89,"ARA-MES-ESQ",267
7,"7055",7897,5264,5176,47,88,"ARA-MES-ESQ",226
7,"7031",24784,16683,16527,160,156,"ARA-MES-ESQ",572
7,"7046",16718,10573,10469,94,104,"ARA-MES-ESQ",122
7,"7030",1590,1234,1202,8,32,"ARA-MES-ESQ",269
7,"7013",7231,5372,5253,43,119,"ARA-MES-ESQ",354
7,"7034",1064,906,900,6,6,"ARA-MES-ESQ",112
7,"7022",11615,8055,7934,91,121,"ARA-MES-ESQ",731
7,"7016",2931,2201,2178,31,23,"ARA-MES-ESQ",157
7,"7056",5245,3883,3841,32,42,"ARA-MES-ESQ",396
7,"7039",4970,3557,3489,36,68,"ARA-MES-ESQ",290
7,"7024",7294,4213,4160,44,53,"ARA-MES-ESQ",227
7,"7014",7778,4724,4669,50,55,"ARA-MES-ESQ",277
7,"7038",2025,1581,1556,14,25,"ARA-MES-ESQ",238
7,"7063",1420,1139,1129,10,10,"ARA-MES-ESQ",67
7,"7902",1091,776,743,10,33,"ARA-MES-ESQ",49
7,"7060",2665,1976,1964,14,12,"ARA-MES-ESQ",259
7,"7061",9564,6678,6583,67,95,"ARA-MES-ESQ",471
7,"7002",6612,4721,4672,43,49,"ARA-MES-ESQ",255
7,"7006",5332,3769,3722,25,47,"ARA-MES-ESQ",583
7,"7062",7902,4889,4828,58,61,"ARA-MES-ESQ",131
7,"7048",18412,11528,11412,112,116,"ARA-MES-ESQ",219
7,"7033",28373,17884,17684,201,200,"ARA-MES-ESQ",1779
7,"7023",3757,2777,2735,43,42,"ARA-MES-ESQ",316
7,"7037",3357,2142,2120,16,22,"ARA-MES-ESQ",194
7,"7029",4366,3270,3229,25,41,"ARA-MES-ESQ",236
7,"7043",3430,2465,2438,24,27,"ARA-MES-ESQ",330
7,"7035",1596,1242,1234,13,8,"ARA-MES-ESQ",181
7,"7004",4033,2898,2860,28,38,"ARA-MES-ESQ",294
7,"7901",594,454,446,6,8,"ARA-MES-ESQ",26
7,"7042",10785,7256,7191,60,65,"ARA-MES-ESQ",468
7,"7051",5414,3610,3575,37,35,"ARA-MES-ESQ",266
7,"7059",3035,2257,2226,13,31,"ARA-MES-ESQ",125
7,"7032",20888,14257,14096,108,161,"ARA-MES-ESQ",694
7,"7065",2302,1633,1603,10,30,"ARA-MES-ESQ",200
12,"12089",4546,3353,3304,12,49,"AVANT ADELA",6
46,"46115",352,261,260,0,1,"AVANT ADELA",0
46,"46001",783,612,607,4,5,"AVANT ADELA",1
46,"46183",6028,4620,4534,29,86,"AVANT ADELA",7
46,"46082",4958,3801,3759,21,42,"AVANT ADELA",15
46,"46008",2624,2036,1996,9,40,"AVANT ADELA",0
46,"46130",857,680,669,6,11,"AVANT ADELA",2
46,"46226",31,27,27,0,0,"AVANT ADELA",0
46,"46257",5428,4237,4190,23,47,"AVANT ADELA",7
46,"46037",1109,927,918,4,9,"AVANT ADELA",0
46,"46050",186,157,154,1,3,"AVANT ADELA",0
46,"46228",2417,1953,1913,13,40,"AVANT ADELA",1
46,"46255",3209,2415,2381,18,34,"AVANT ADELA",3
12,"12078",333,238,235,1,3,"AVANT ADELA",0
12,"12079",419,346,336,2,10,"AVANT ADELA",0
46,"46174",949,789,770,4,19,"AVANT ADELA",0
46,"46191",1949,1541,1505,7,36,"AVANT ADELA",3
46,"46155",993,785,772,2,13,"AVANT ADELA",1
12,"12011",4582,3511,3431,27,80,"AVANT ADELA",7
46,"46206",557,461,455,6,6,"AVANT ADELA",1
46,"46092",263,182,179,1,3,"AVANT ADELA",1
12,"12102",521,442,434,2,8,"AVANT ADELA",0
46,"46062",4572,3571,3510,20,61,"AVANT ADELA",4
12,"12108",438,382,379,4,3,"AVANT ADELA",0
46,"46111",11326,8603,8492,55,111,"AVANT ADELA",23
12,"12092",126,108,106,1,2,"AVANT ADELA",0
46,"46046",884,654,643,3,11,"AVANT ADELA",1
46,"46068",345,308,307,4,1,"AVANT ADELA",0
46,"46231",2401,1780,1770,8,10,"AVANT ADELA",6
12,"12039",792,688,680,3,8,"AVANT ADELA",1
46,"46025",2455,2002,1981,6,21,"AVANT ADELA",2
46,"46208",1070,875,866,2,9,"AVANT ADELA",1
46,"46215",1397,1104,1093,12,11,"AVANT ADELA",1
12,"12135",36194,27266,26961,192,305,"AVANT ADELA",71
46,"46137",242,200,200,3,0,"AVANT ADELA",0
46,"46100",281,210,205,0,5,"AVANT ADELA",0
12,"12107",351,312,306,1,6,"AVANT ADELA",1
46,"46070",17700,13558,13437,115,121,"AVANT ADELA",22
46,"46154",797,645,630,1,15,"AVANT ADELA",1
12,"12001",1033,834,825,8,9,"AVANT ADELA",0
46,"46202",17660,13782,13645,93,137,"AVANT ADELA",29
46,"46190",50023,37273,36976,250,297,"AVANT ADELA",117
46,"46009",3140,2582,2536,14,46,"AVANT ADELA",5
46,"46186",19529,15294,15125,69,169,"AVANT ADELA",40
46,"46024",444,339,335,1,4,"AVANT ADELA",0
46,"46018",567,483,479,3,4,"AVANT ADELA",1
12,"12080",1900,1604,1575,10,29,"AVANT ADELA",0
46,"46160",1907,1508,1485,5,23,"AVANT ADELA",1
46,"46087",109,98,98,1,0,"AVANT ADELA",0
46,"46109",6174,4763,4639,30,124,"AVANT ADELA",20
12,"12124",1840,1477,1460,8,17,"AVANT ADELA",1
46,"46153",435,364,356,1,8,"AVANT ADELA",0
12,"12093",165,128,126,0,2,"AVANT ADELA",1
46,"46021",23977,18032,17879,125,153,"AVANT ADELA",59
46,"46244",59626,44018,43679,342,339,"AVANT ADELA",122
46,"46004",1919,1641,1616,14,25,"AVANT ADELA",3
12,"12098",533,446,440,4,6,"AVANT ADELA",0
12,"12094",875,694,682,2,12,"AVANT ADELA",1
12,"12017",148,120,116,0,4,"AVANT ADELA",0
46,"46205",14233,11274,11145,55,129,"AVANT ADELA",8
12,"12028",12955,10391,10301,68,90,"AVANT ADELA",28
12,"12016",1550,1281,1260,11,21,"AVANT ADELA",4
46,"46086",80,69,69,0,0,"AVANT ADELA",0
46,"46029",20423,15450,15274,100,176,"AVANT ADELA",45
46,"46147",17133,12260,12120,59,140,"AVANT ADELA",38
46,"46127",2740,2174,2147,11,27,"AVANT ADELA",7
12,"12127",67,50,50,1,0,"AVANT ADELA",0
12,"12136",2606,2262,2223,17,39,"AVANT ADELA",1
46,"46128",1581,1324,1287,2,37,"AVANT ADELA",2
46,"46139",4512,3612,3567,25,45,"AVANT ADELA",5
46,"46162",1177,954,938,4,16,"AVANT ADELA",1
46,"46258",2636,2100,2079,9,21,"AVANT ADELA",3
12,"12053",2030,1656,1636,10,20,"AVANT ADELA",2
12,"12091",176,131,130,0,1,"AVANT ADELA",0
46,"46164",12073,8987,8836,63,151,"AVANT ADELA",20
46,"46181",16908,12749,12597,82,152,"AVANT ADELA",34
46,"46253",114,85,85,2,0,"AVANT ADELA",0
46,"46263",239,204,200,3,4,"AVANT ADELA",0
12,"12026",835,656,639,4,17,"AVANT ADELA",0
46,"46085",11075,8106,8011,54,95,"AVANT ADELA",11
46,"46044",4198,3399,3337,13,62,"AVANT ADELA",2
12,"12139",302,219,217,3,2,"AVANT ADELA",0
12,"12100",1281,1118,1102,5,16,"AVANT ADELA",0
46,"46150",1797,1275,1257,9,18,"AVANT ADELA",2
46,"46167",345,255,255,0,0,"AVANT ADELA",0
46,"46088",150,129,127,0,2,"AVANT ADELA",1
46,"46251",2442,2017,1976,9,41,"AVANT ADELA",0
46,"46216",5252,4291,4263,23,28,"AVANT ADELA",10
12,"12015",114,99,98,0,1,"AVANT ADELA",0
46,"46163",1856,1522,1501,4,21,"AVANT ADELA",1
46,"46262",213,170,165,1,5,"AVANT ADELA",0
46,"46129",512,408,400,4,8,"AVANT ADELA",0
46,"46196",140,115,114,0,1,"AVANT ADELA",0
46,"46095",578,467,458,1,9,"AVANT ADELA",0
12,"12057",578,485,473,3,12,"AVANT ADELA",0
12,"12110",219,168,166,1,2,"AVANT ADELA",1
12,"12014",167,131,127,1,4,"AVANT ADELA",0
12,"12064",80,75,73,1,2,"AVANT ADELA",0
12,"12010",237,203,198,1,5,"AVANT ADELA",0
46,"46221",345,294,294,0,0,"AVANT ADELA",0
46,"46079",313,252,248,1,4,"AVANT ADELA",0
12,"12004",4177,3225,3187,13,38,"AVANT ADELA",2
12,"12071",1267,1021,1006,11,15,"AVANT ADELA",1
12,"12090",104,85,83,1,2,"AVANT ADELA",0
46,"46056",175,156,156,3,0,"AVANT ADELA",0
46,"46099",772,620,614,1,6,"AVANT ADELA",0
46,"46176",2045,1450,1434,12,16,"AVANT ADELA",9
12,"12123",43,35,34,1,1,"AVANT ADELA",0
46,"46003",953,828,811,5,17,"AVANT ADELA",0
46,"46078",28394,20928,20748,156,180,"AVANT ADELA",63
46,"46057",474,319,313,1,6,"AVANT ADELA",3
46,"46185",364,315,310,1,5,"AVANT ADELA",0
46,"46060",9287,7184,7110,40,74,"AVANT ADELA",11
46,"46040",995,807,794,7,13,"AVANT ADELA",1
12,"12046",182,161,161,1,0,"AVANT ADELA",2
12,"12141",92,81,81,0,0,"AVANT ADELA",0
46,"46242",330,279,279,0,0,"AVANT ADELA",0
46,"46135",9827,7928,7883,44,45,"AVANT ADELA",17
46,"46013",17712,14181,14075,88,106,"AVANT ADELA",56
46,"46074",2678,2158,2135,13,23,"AVANT ADELA",4
46,"46034",1811,1407,1389,13,18,"AVANT ADELA",4
46,"46148",1509,1208,1195,7,13,"AVANT ADELA",3
12,"12075",107,89,87,0,2,"AVANT ADELA",0
12,"12142",145,123,121,1,2,"AVANT ADELA",0
46,"46101",816,696,687,3,9,"AVANT ADELA",0
46,"46142",761,580,565,4,15,"AVANT ADELA",1
12,"12051",448,324,319,2,5,"AVANT ADELA",0
46,"46230",14084,10694,10599,67,95,"AVANT ADELA",37
46,"46048",3509,2758,2720,11,38,"AVANT ADELA",4
46,"46173",1319,1084,1062,6,22,"AVANT ADELA",1
12,"12031",3942,2976,2931,24,45,"AVANT ADELA",2
46,"46220",48968,35430,34964,306,466,"AVANT ADELA",96
46,"46240",206,175,169,2,6,"AVANT ADELA",0
12,"12043",560,460,450,2,10,"AVANT ADELA",0
46,"46105",16132,11703,11582,64,121,"AVANT ADELA",18
46,"46015",7477,5857,5808,33,49,"AVANT ADELA",6
12,"12006",174,149,149,2,0,"AVANT ADELA",1
12,"12045",328,275,271,2,4,"AVANT ADELA",0
12,"12097",65,54,54,1,0,"AVANT ADELA",1
12,"12109",653,544,533,3,11,"AVANT ADELA",1
46,"46103",1338,1056,1042,5,14,"AVANT ADELA",1
46,"46049",268,231,228,1,3,"AVANT ADELA",0
12,"12059",228,191,188,0,3,"AVANT ADELA",0
46,"46157",2960,2329,2296,12,33,"AVANT ADELA",1
12,"12116",67,57,57,0,0,"AVANT ADELA",0
46,"46033",196,169,168,3,1,"AVANT ADELA",0
46,"46151",757,586,579,0,7,"AVANT ADELA",2
46,"46036",558,391,379,2,12,"AVANT ADELA",0
46,"46124",785,680,675,5,5,"AVANT ADELA",0
46,"46090",1633,1413,1392,5,21,"AVANT ADELA",1
12,"12088",57,54,54,0,0,"AVANT ADELA",0
46,"46063",1783,1368,1345,9,23,"AVANT ADELA",0
46,"46121",111,96,94,2,2,"AVANT ADELA",0
46,"46236",937,764,755,5,9,"AVANT ADELA",1
46,"46054",11390,8717,8604,52,113,"AVANT ADELA",29
46,"46039",2121,1730,1698,19,32,"AVANT ADELA",0
46,"46222",394,325,324,1,1,"AVANT ADELA",2
46,"46149",344,260,256,2,4,"AVANT ADELA",0
12,"12126",24347,19023,18749,152,274,"AVANT ADELA",19
12,"12111",334,283,279,4,4,"AVANT ADELA",0
46,"46118",3670,2930,2894,25,36,"AVANT ADELA",3
46,"46179",2116,1723,1678,18,45,"AVANT ADELA",4
46,"46031",10521,7735,7607,62,128,"AVANT ADELA",18
46,"46122",2730,2103,2071,19,32,"AVANT ADELA",3
12,"12067",523,423,416,1,7,"AVANT ADELA",0
46,"46098",2403,1807,1772,8,35,"AVANT ADELA",2
12,"12034",1400,1108,1080,7,28,"AVANT ADELA",2
12,"12063",44,37,37,1,0,"AVANT ADELA",0
12,"12099",586,449,434,3,15,"AVANT ADELA",0
46,"46241",389,318,313,4,5,"AVANT ADELA",1
46,"46201",62,47,47,0,0,"AVANT ADELA",0
46,"46238",13105,9717,9610,57,107,"AVANT ADELA",12
12,"12013",137,113,113,0,0,"AVANT ADELA",0
46,"46059",1240,1038,1030,3,8,"AVANT ADELA",3
12,"12049",421,339,329,2,10,"AVANT ADELA",0
46,"46177",4778,3767,3711,17,56,"AVANT ADELA",6
12,"12130",420,345,341,0,4,"AVANT ADELA",0
46,"46005",23013,17487,17286,112,201,"AVANT ADELA",56
46,"46012",929,727,707,3,20,"AVANT ADELA",3
12,"12003",943,745,731,6,14,"AVANT ADELA",3
46,"46066",1285,1058,1043,6,15,"AVANT ADELA",0
46,"46248",4886,3672,3613,25,59,"AVANT ADELA",2
46,"46260",2647,2136,2113,8,23,"AVANT ADELA",8
46,"46026",1202,1012,997,1,15,"AVANT ADELA",2
12,"12119",137,107,104,1,3,"AVANT ADELA",0
46,"46188",693,591,585,3,6,"AVANT ADELA",2
46,"46161",1472,1200,1172,7,28,"AVANT ADELA",0
12,"12138",19179,14217,14006,124,211,"AVANT ADELA",24
46,"46117",500,407,399,1,8,"AVANT ADELA",2
46,"46134",2380,1836,1825,5,11,"AVANT ADELA",12
12,"12113",87,65,64,0,1,"AVANT ADELA",0
12,"12122",767,655,646,3,9,"AVANT ADELA",0
12,"12025",121,102,99,0,3,"AVANT ADELA",0
12,"12117",3545,2770,2698,11,72,"AVANT ADELA",6
12,"12069",53,45,44,1,1,"AVANT ADELA",0
12,"12070",499,434,430,3,4,"AVANT ADELA",0
12,"12048",249,181,175,2,6,"AVANT ADELA",0
46,"46125",846,681,675,1,6,"AVANT ADELA",0
46,"46058",1734,1349,1325,9,24,"AVANT ADELA",1
46,"46254",943,751,734,4,17,"AVANT ADELA",0
12,"12018",283,242,235,0,7,"AVANT ADELA",0
12,"12009",17859,13054,12911,98,143,"AVANT ADELA",19
12,"12073",132,110,107,1,3,"AVANT ADELA",0
46,"46067",1744,1451,1432,4,19,"AVANT ADELA",4
12,"12002",115,99,97,0,2,"AVANT ADELA",0
46,"46213",15504,11420,11232,124,188,"AVANT ADELA",25
46,"46203",3544,2851,2810,21,41,"AVANT ADELA",5
46,"46210",344,265,258,2,7,"AVANT ADELA",0
12,"12121",1044,941,915,4,26,"AVANT ADELA",0
46,"46113",2527,1906,1892,12,14,"AVANT ADELA",4
12,"12032",23649,17680,17505,118,175,"AVANT ADELA",30
46,"46259",462,395,394,2,1,"AVANT ADELA",2
46,"46076",591,497,487,0,10,"AVANT ADELA",0
46,"46140",377,312,312,2,0,"AVANT ADELA",0
12,"12041",100,76,75,0,1,"AVANT ADELA",0
12,"12134",135,102,100,0,2,"AVANT ADELA",0
46,"46194",15813,11654,11511,83,143,"AVANT ADELA",25
46,"46042",3348,2825,2774,11,51,"AVANT ADELA",3
46,"46132",2196,1877,1853,10,24,"AVANT ADELA",4
12,"12007",731,649,642,8,7,"AVANT ADELA",2
46,"46120",1183,958,936,3,22,"AVANT ADELA",3
46,"46083",15374,11259,11096,56,163,"AVANT ADELA",28
12,"12074",761,659,645,7,14,"AVANT ADELA",1
46,"46016",1075,887,880,8,7,"AVANT ADELA",4
46,"46212",1590,1209,1192,4,17,"AVANT ADELA",0
12,"12060",430,368,365,1,3,"AVANT ADELA",1
12,"12021",4377,3528,3473,23,55,"AVANT ADELA",3
12,"12033",1951,1528,1506,10,22,"AVANT ADELA",0
46,"46195",1982,1562,1554,2,8,"AVANT ADELA",5
46,"46053",537,459,457,2,2,"AVANT ADELA",0
46,"46225",348,279,273,2,6,"AVANT ADELA",0
12,"12036",546,428,420,9,8,"AVANT ADELA",0
46,"46261",1709,1367,1340,14,27,"AVANT ADELA",0
46,"46169",32294,24909,24676,157,233,"AVANT ADELA",90
12,"12037",17,17,17,1,0,"AVANT ADELA",0
46,"46246",1042,860,838,2,22,"AVANT ADELA",0
12,"12085",5079,3504,3459,13,45,"AVANT ADELA",7
46,"46030",796,653,633,7,20,"AVANT ADELA",0
12,"12058",64,56,56,0,0,"AVANT ADELA",0
12,"12022",328,273,269,1,4,"AVANT ADELA",1
12,"12012",2613,2217,2180,6,37,"AVANT ADELA",3
46,"46010",950,727,718,6,9,"AVANT ADELA",4
46,"46193",8964,7206,7156,27,50,"AVANT ADELA",18
46,"46903",6285,5035,4996,27,39,"AVANT ADELA",7
46,"46038",307,243,241,0,2,"AVANT ADELA",0
12,"12101",356,297,289,2,8,"AVANT ADELA",0
46,"46075",147,136,134,2,2,"AVANT ADELA",0
46,"46007",12284,9370,9265,65,105,"AVANT ADELA",37
46,"46247",961,695,687,3,8,"AVANT ADELA",0
12,"12020",120,107,107,0,0,"AVANT ADELA",0
12,"12112",110,97,96,1,1,"AVANT ADELA",0
46,"46069",157,130,129,0,1,"AVANT ADELA",0
46,"46089",2170,1692,1672,6,20,"AVANT ADELA",2
46,"46072",3542,3008,2961,33,47,"AVANT ADELA",2
12,"12077",4790,3594,3565,39,29,"AVANT ADELA",9
46,"46207",6686,5220,5137,36,83,"AVANT ADELA",12
46,"46055",1284,1031,1021,2,10,"AVANT ADELA",2
12,"12137",37,27,27,0,0,"AVANT ADELA",0
46,"46073",1077,867,862,10,5,"AVANT ADELA",2
12,"12087",25,19,18,2,1,"AVANT ADELA",0
46,"46211",1837,1490,1462,11,28,"AVANT ADELA",2
12,"12902",2248,1678,1653,7,25,"AVANT ADELA",3
46,"46218",1031,907,885,6,22,"AVANT ADELA",1
12,"12095",950,763,756,9,7,"AVANT ADELA",1
46,"46131",49504,37495,37064,259,431,"AVANT ADELA",154
46,"46043",135,119,116,1,3,"AVANT ADELA",1
46,"46094",20691,15841,15672,88,169,"AVANT ADELA",57
12,"12128",1362,1099,1076,9,23,"AVANT ADELA",3
46,"46114",574,457,452,1,5,"AVANT ADELA",0
12,"12125",222,189,187,0,2,"AVANT ADELA",2
46,"46102",19635,15330,15207,95,123,"AVANT ADELA",43
46,"46144",628,511,505,1,6,"AVANT ADELA",0
12,"12096",744,588,580,7,8,"AVANT ADELA",0
46,"46175",428,367,354,3,13,"AVANT ADELA",0
46,"46017",32990,23940,23694,155,246,"AVANT ADELA",41
46,"46064",525,427,424,4,3,"AVANT ADELA",0
46,"46165",7298,5744,5697,38,47,"AVANT ADELA",8
12,"12072",1082,901,889,15,12,"AVANT ADELA",0
46,"46047",532,447,441,4,6,"AVANT ADELA",0
12,"12029",673,566,556,3,10,"AVANT ADELA",0
46,"46249",9159,7113,7012,73,101,"AVANT ADELA",12
46,"46159",23051,17496,17359,104,137,"AVANT ADELA",57
46,"46178",4943,3684,3641,21,43,"AVANT ADELA",10
46,"46204",6657,5262,5204,27,58,"AVANT ADELA",10
46,"46071",470,382,366,0,16,"AVANT ADELA",0
46,"46224",154,124,124,2,0,"AVANT ADELA",0
46,"46081",9993,7972,7882,51,90,"AVANT ADELA",17
46,"46189",473,412,408,2,4,"AVANT ADELA",2
12,"12076",76,64,64,1,0,"AVANT ADELA",0
12,"12106",1163,980,951,7,29,"AVANT ADELA",1
12,"12105",816,639,625,5,14,"AVANT ADELA",0
46,"46096",257,220,217,0,3,"AVANT ADELA",2
46,"46146",1641,1314,1281,11,33,"AVANT ADELA",1
12,"12131",59,50,50,0,0,"AVANT ADELA",0
12,"12901",3357,2693,2675,19,18,"AVANT ADELA",7
12,"12133",60,53,52,1,1,"AVANT ADELA",0
46,"46051",8384,6550,6452,24,98,"AVANT ADELA",6
46,"46235",21270,15754,15592,101,162,"AVANT ADELA",29
12,"12118",76,64,63,0,1,"AVANT ADELA",0
46,"46145",22099,16685,16499,128,186,"AVANT ADELA",27
12,"12024",133,117,117,0,0,"AVANT ADELA",0
12,"12132",484,415,412,4,3,"AVANT ADELA",1
12,"12081",602,488,481,0,7,"AVANT ADELA",1
12,"12061",380,277,274,2,3,"AVANT ADELA",0
46,"46107",1849,1501,1480,5,21,"AVANT ADELA",3
46,"46250",581614,454786,451184,2675,3602,"AVANT ADELA",1131
12,"12084",17723,13501,13281,118,220,"AVANT ADELA",27
12,"12068",41,26,25,1,1,"AVANT ADELA",0
46,"46123",1948,1469,1446,5,23,"AVANT ADELA",2
46,"46233",3781,2901,2847,22,54,"AVANT ADELA",3
46,"46097",958,764,756,6,8,"AVANT ADELA",1
46,"46112",542,460,454,0,6,"AVANT ADELA",0
12,"12040",118683,91285,90499,666,786,"AVANT ADELA",199
46,"46041",327,251,250,2,1,"AVANT ADELA",1
12,"12104",6814,5486,5406,35,80,"AVANT ADELA",6
46,"46243",124,105,104,0,1,"AVANT ADELA",0
46,"46108",426,346,342,1,4,"AVANT ADELA",0
12,"12129",1801,1382,1356,17,26,"AVANT ADELA",0
46,"46158",1040,805,796,4,9,"AVANT ADELA",2
12,"12082",9573,7672,7570,55,102,"AVANT ADELA",16
12,"12083",89,73,71,1,2,"AVANT ADELA",0
46,"46006",4468,3731,3683,22,48,"AVANT ADELA",4
46,"46214",16415,12723,12610,74,113,"AVANT ADELA",34
46,"46256",7211,5263,5209,27,54,"AVANT ADELA",11
46,"46219",122,105,104,0,1,"AVANT ADELA",0
46,"46227",888,708,693,6,15,"AVANT ADELA",1
46,"46170",3408,2769,2720,16,49,"AVANT ADELA",0
46,"46217",893,733,723,6,10,"AVANT ADELA",2
46,"46106",1466,1156,1142,3,14,"AVANT ADELA",1
12,"12052",539,453,439,5,14,"AVANT ADELA",0
46,"46119",752,627,614,8,13,"AVANT ADELA",0
46,"46133",472,374,374,2,0,"AVANT ADELA",1
46,"46116",13608,10792,10731,76,61,"AVANT ADELA",31
46,"46209",1901,1517,1500,5,17,"AVANT ADELA",1
46,"46143",4230,3255,3200,20,55,"AVANT ADELA",5
12,"12065",171,150,147,0,3,"AVANT ADELA",0
46,"46172",5412,3878,3832,18,46,"AVANT ADELA",17
46,"46232",872,714,706,3,8,"AVANT ADELA",0
46,"46192",790,599,586,8,13,"AVANT ADELA",3
46,"46110",21317,15839,15699,89,140,"AVANT ADELA",60
46,"46080",985,799,788,5,11,"AVANT ADELA",0
46,"46229",911,755,752,5,3,"AVANT ADELA",2
46,"46171",16429,12527,12373,61,154,"AVANT ADELA",35
46,"46141",437,367,360,5,7,"AVANT ADELA",0
46,"46904",805,643,628,13,15,"AVANT ADELA",2
12,"12055",106,85,83,2,2,"AVANT ADELA",0
12,"12140",1140,936,922,7,14,"AVANT ADELA",2
46,"46182",1310,988,977,5,11,"AVANT ADELA",2
46,"46237",7148,5537,5472,36,65,"AVANT ADELA",16
46,"46027",932,769,755,1,14,"AVANT ADELA",1
46,"46168",1982,1543,1522,5,21,"AVANT ADELA",0
46,"46180",651,525,519,0,6,"AVANT ADELA",1
46,"46084",1503,1225,1195,1,30,"AVANT ADELA",1
46,"46035",6855,5500,5422,34,78,"AVANT ADELA",5
46,"46065",1576,1246,1228,6,18,"AVANT ADELA",1
46,"46902",356,300,296,8,4,"AVANT ADELA",0
46,"46152",87,69,69,0,0,"AVANT ADELA",0
46,"46156",2024,1642,1628,7,14,"AVANT ADELA",2
46,"46028",388,324,319,1,5,"AVANT ADELA",0
46,"46011",7523,5320,5235,28,85,"AVANT ADELA",10
46,"46052",508,436,426,3,10,"AVANT ADELA",0
46,"46234",327,264,263,5,1,"AVANT ADELA",0
46,"46019",8948,7150,7067,40,83,"AVANT ADELA",2
46,"46198",871,707,693,4,14,"AVANT ADELA",1
46,"46223",7781,6057,5995,42,62,"AVANT ADELA",5
46,"46023",328,277,269,1,8,"AVANT ADELA",0
46,"46093",2134,1700,1687,8,13,"AVANT ADELA",3
46,"46200",1848,1560,1539,6,21,"AVANT ADELA",1
12,"12115",208,170,167,1,3,"AVANT ADELA",0
12,"12050",1230,987,972,10,15,"AVANT ADELA",0
46,"46104",1891,1515,1481,17,34,"AVANT ADELA",0
46,"46245",528,430,426,2,4,"AVANT ADELA",1
46,"46077",7344,5873,5761,49,112,"AVANT ADELA",8
46,"46197",1926,1473,1455,9,18,"AVANT ADELA",1
12,"12044",452,403,400,4,3,"AVANT ADELA",0
46,"46252",128,106,106,2,0,"AVANT ADELA",0
12,"12056",257,218,216,1,2,"AVANT ADELA",0
12,"12027",17473,12829,12683,90,146,"AVANT ADELA",37
46,"46184",26453,21076,20810,172,266,"AVANT ADELA",54
46,"46199",5842,4451,4414,23,37,"AVANT ADELA",7
46,"46239",453,372,366,2,6,"AVANT ADELA",1
46,"46166",8202,6482,6399,39,83,"AVANT ADELA",12
46,"46032",5692,4518,4476,22,42,"AVANT ADELA",9
12,"12114",194,161,160,2,1,"AVANT ADELA",0
46,"46126",5574,4565,4528,25,37,"AVANT ADELA",9
12,"12005",8052,6056,5935,50,121,"AVANT ADELA",8
46,"46022",15325,11197,11072,70,125,"AVANT ADELA",36
12,"12042",574,486,479,8,7,"AVANT ADELA",0
12,"12120",161,138,138,0,0,"AVANT ADELA",0
12,"12103",90,75,70,1,5,"AVANT ADELA",0
46,"46002",1215,963,959,5,4,"AVANT ADELA",0
46,"46061",343,285,280,4,5,"AVANT ADELA",0
46,"46136",2619,2030,2003,24,27,"AVANT ADELA",6
46,"46045",1243,1033,1018,3,15,"AVANT ADELA",0
46,"46187",1304,991,982,8,9,"AVANT ADELA",0
46,"46014",3130,2488,2462,7,26,"AVANT ADELA",2
46,"46091",115,99,99,0,0,"AVANT ADELA",0
46,"46020",3792,3028,2973,11,55,"AVANT ADELA",5
12,"12008",224,197,194,1,3,"AVANT ADELA",0
46,"46138",360,305,303,2,2,"AVANT ADELA",0
12,"12038",156,110,109,1,1,"AVANT ADELA",0
3,"3903",2577,1996,1973,11,23,"AVANT-LOS V",4
3,"3014",238879,176118,174768,1105,1350,"AVANT-LOS V",643
3,"3060",106,84,84,0,0,"AVANT-LOS V",0
3,"3125",336,259,257,1,2,"AVANT-LOS V",0
3,"3124",460,401,390,2,11,"AVANT-LOS V",0
3,"3128",4295,3007,2982,24,25,"AVANT-LOS V",9
3,"3077",1374,1131,1114,9,17,"AVANT-LOS V",0
3,"3071",3988,3125,3088,28,37,"AVANT-LOS V",8
3,"3099",42876,32576,32172,192,404,"AVANT-LOS V",77
3,"3100",496,402,395,2,7,"AVANT-LOS V",1
3,"3024",3948,3210,3164,14,46,"AVANT-LOS V",3
3,"3092",6688,5444,5370,36,74,"AVANT-LOS V",14
3,"3085",269,243,237,0,6,"AVANT-LOS V",0
3,"3074",1750,1433,1427,3,6,"AVANT-LOS V",5
3,"3008",159,127,126,0,1,"AVANT-LOS V",0
3,"3107",2769,2011,1986,10,25,"AVANT-LOS V",7
3,"3118",2426,1741,1718,8,23,"AVANT-LOS V",4
3,"3010",336,295,280,0,15,"AVANT-LOS V",0
3,"3086",166,143,143,1,0,"AVANT-LOS V",0
3,"3055",5247,4042,3991,24,51,"AVANT-LOS V",7
3,"3031",41857,28648,28362,163,286,"AVANT-LOS V",138
3,"3037",341,289,284,1,5,"AVANT-LOS V",1
3,"3093",19713,15195,14988,108,207,"AVANT-LOS V",51
3,"3025",1292,1009,991,7,18,"AVANT-LOS V",1
3,"3129",1218,994,982,5,12,"AVANT-LOS V",4
3,"3104",27091,21366,21119,250,247,"AVANT-LOS V",94
3,"3034",1391,1107,1090,7,17,"AVANT-LOS V",1
3,"3038",335,275,267,1,8,"AVANT-LOS V",0
3,"3003",455,395,388,0,7,"AVANT-LOS V",0
3,"3116",1159,901,884,3,17,"AVANT-LOS V",0
3,"3006",494,413,409,1,4,"AVANT-LOS V",1
3,"3098",518,412,400,1,12,"AVANT-LOS V",3
3,"3007",169,145,141,0,4,"AVANT-LOS V",1
3,"3036",86,77,75,2,2,"AVANT-LOS V",1
3,"3058",4967,4031,3967,24,64,"AVANT-LOS V",7
3,"3103",245,212,211,4,1,"AVANT-LOS V",0
3,"3067",93,87,87,0,0,"AVANT-LOS V",0
3,"3139",23061,16378,16178,128,200,"AVANT-LOS V",82
3,"3096",5779,4433,4352,30,81,"AVANT-LOS V",8
3,"3078",474,372,371,2,1,"AVANT-LOS V",4
3,"3023",1379,1216,1199,6,17,"AVANT-LOS V",1
3,"3065",169399,128218,127256,967,962,"AVANT-LOS V",425
3,"3902",10578,7654,7530,56,124,"AVANT-LOS V",21
3,"3121",21787,15670,15453,81,217,"AVANT-LOS V",55
3,"3042",1462,1025,1008,3,17,"AVANT-LOS V",2
3,"3035",632,529,525,2,4,"AVANT-LOS V",0
3,"3044",4557,3650,3600,17,50,"AVANT-LOS V",9
3,"3033",102,87,85,0,2,"AVANT-LOS V",2
3,"3079",18403,14632,14382,114,250,"AVANT-LOS V",51
3,"3045",213,178,173,4,5,"AVANT-LOS V",0
3,"3048",4971,3808,3739,19,69,"AVANT-LOS V",10
3,"3111",5565,4183,4149,29,34,"AVANT-LOS V",15
3,"3062",221,182,180,1,2,"AVANT-LOS V",1
3,"3028",964,804,795,6,9,"AVANT-LOS V",0
3,"3106",564,485,479,4,6,"AVANT-LOS V",0
3,"3105",5471,4099,4003,14,96,"AVANT-LOS V",9
3,"3053",7469,5950,5865,26,85,"AVANT-LOS V",15
3,"3131",179,147,139,0,8,"AVANT-LOS V",0
3,"3110",312,271,269,1,2,"AVANT-LOS V",2
3,"3097",996,833,816,4,17,"AVANT-LOS V",3
3,"3066",41802,31046,30696,285,350,"AVANT-LOS V",139
3,"3054",336,277,272,2,5,"AVANT-LOS V",0
3,"3084",497,429,429,4,0,"AVANT-LOS V",1
3,"3132",515,417,414,4,3,"AVANT-LOS V",2
3,"3082",12936,9025,8931,57,94,"AVANT-LOS V",27
3,"3004",599,465,458,4,7,"AVANT-LOS V",4
3,"3076",8736,6571,6467,40,104,"AVANT-LOS V",16
3,"3005",7903,6247,6195,37,52,"AVANT-LOS V",16
3,"3015",12807,9782,9634,63,148,"AVANT-LOS V",31
3,"3081",1494,1163,1141,5,22,"AVANT-LOS V",4
3,"3123",7576,5900,5814,36,86,"AVANT-LOS V",13
3,"3041",6093,4444,4398,13,46,"AVANT-LOS V",18
3,"3117",377,320,313,1,7,"AVANT-LOS V",0
3,"3070",2106,1554,1528,9,26,"AVANT-LOS V",3
3,"3094",9626,7206,7138,42,68,"AVANT-LOS V",40
3,"3138",3183,2390,2359,16,31,"AVANT-LOS V",3
3,"3011",8014,5870,5810,38,60,"AVANT-LOS V",17
3,"3090",17881,13593,13437,108,156,"AVANT-LOS V",33
3,"3064",5004,3782,3736,20,46,"AVANT-LOS V",11
3,"3068",42,40,40,3,0,"AVANT-LOS V",0
3,"3130",43,23,23,0,0,"AVANT-LOS V",1
3,"3026",1316,1040,1024,5,16,"AVANT-LOS V",3
3,"3136",410,329,323,3,6,"AVANT-LOS V",1
3,"3115",255,222,221,2,1,"AVANT-LOS V",0
3,"3002",3631,2841,2801,16,40,"AVANT-LOS V",4
3,"3095",4740,3702,3657,23,45,"AVANT-LOS V",14
3,"3051",344,312,307,2,5,"AVANT-LOS V",0
3,"3012",1133,910,897,7,13,"AVANT-LOS V",0
3,"3127",351,290,277,2,13,"AVANT-LOS V",0
3,"3046",1619,1213,1190,17,23,"AVANT-LOS V",3
3,"3017",379,321,311,1,10,"AVANT-LOS V",1
3,"3061",1054,830,816,3,14,"AVANT-LOS V",2
3,"3022",137,122,119,0,3,"AVANT-LOS V",2
3,"3120",2421,1823,1786,9,37,"AVANT-LOS V",6
3,"3043",2899,2466,2434,21,32,"AVANT-LOS V",5
3,"3122",43704,31952,31681,218,271,"AVANT-LOS V",147
3,"3040",258,223,217,1,6,"AVANT-LOS V",2
3,"3091",241,201,196,0,5,"AVANT-LOS V",1
3,"3032",99,87,87,0,0,"AVANT-LOS V",0
3,"3901",1109,827,820,5,7,"AVANT-LOS V",3
3,"3059",20590,15909,15766,96,143,"AVANT-LOS V",31
3,"3027",172,156,153,0,3,"AVANT-LOS V",0
3,"3075",149,125,125,0,0,"AVANT-LOS V",0
3,"3073",222,200,196,3,4,"AVANT-LOS V",2
3,"3047",9711,6910,6791,36,119,"AVANT-LOS V",28
3,"3001",345,285,282,1,3,"AVANT-LOS V",1
3,"3030",563,474,466,2,8,"AVANT-LOS V",0
3,"3009",46121,36093,35720,235,373,"AVANT-LOS V",130
3,"3102",7226,5600,5516,28,84,"AVANT-LOS V",9
3,"3049",12143,9418,9302,47,116,"AVANT-LOS V",12
3,"3057",177,148,147,0,1,"AVANT-LOS V",2
3,"3135",192,157,155,0,2,"AVANT-LOS V",0
3,"3088",5810,4380,4313,31,67,"AVANT-LOS V",19
3,"3109",2976,2375,2345,11,30,"AVANT-LOS V",5
3,"3112",637,526,520,0,6,"AVANT-LOS V",3
3,"3029",244,174,167,1,7,"AVANT-LOS V",0
3,"3050",19334,14377,14253,71,124,"AVANT-LOS V",71
3,"3083",5487,3993,3934,28,59,"AVANT-LOS V",11
3,"3904",1420,1112,1095,5,17,"AVANT-LOS V",2
3,"3013",1070,882,869,3,13,"AVANT-LOS V",0
3,"3072",348,297,295,2,2,"AVANT-LOS V",2
3,"3101",4911,3827,3772,20,55,"AVANT-LOS V",7
3,"3134",141,119,117,0,2,"AVANT-LOS V",0
3,"3021",5578,4720,4626,35,94,"AVANT-LOS V",16
3,"3089",9497,6952,6794,55,158,"AVANT-LOS V",15
3,"3039",89,70,70,0,0,"AVANT-LOS V",0
3,"3137",657,484,480,5,4,"AVANT-LOS V",1
3,"3119",17223,13244,13116,75,128,"AVANT-LOS V",39
3,"3140",26027,19805,19438,230,367,"AVANT-LOS V",79
3,"3113",4342,3194,3154,23,40,"AVANT-LOS V",8
3,"3019",15465,12156,11988,80,168,"AVANT-LOS V",35
3,"3063",27121,19869,19713,131,156,"AVANT-LOS V",64
3,"3016",91,77,77,1,0,"AVANT-LOS V",0
3,"3133",41499,26593,26308,151,285,"AVANT-LOS V",109
3,"3114",1581,1263,1237,9,26,"AVANT-LOS V",2
3,"3056",8629,6838,6737,38,101,"AVANT-LOS V",30
3,"3052",967,805,790,4,15,"AVANT-LOS V",0
3,"3080",1328,1077,1064,4,13,"AVANT-LOS V",0
3,"3020",95,84,84,2,0,"AVANT-LOS V",0
3,"3018",12439,9387,9283,50,104,"AVANT-LOS V",41
3,"3069",3311,2356,2327,12,29,"AVANT-LOS V",6
11,"11027",68637,48919,48441,519,478,"AxSI",349
18,"18062",11041,8531,8355,71,176,"AxSI",13
29,"29020",3280,2531,2485,23,46,"AxSI",1
41,"41097",3135,2355,2308,11,47,"AxSI",3
29,"29100",2378,1711,1686,22,25,"AxSI",2
23,"23073",4389,3400,3363,13,37,"AxSI",2
18,"18916",1778,1249,1236,9,13,"AxSI",5
18,"18107",924,694,680,3,14,"AxSI",0
18,"18100",7981,5900,5769,44,131,"AxSI",6
21,"21008",2613,1803,1777,6,26,"AxSI",2
18,"18907",1774,1426,1415,10,11,"AxSI",1
23,"23015",1332,1066,1048,4,18,"AxSI",0
29,"29004",295,233,226,0,7,"AxSI",0
18,"18135",4434,3169,3105,23,64,"AxSI",4
21,"21018",1719,1167,1139,9,28,"AxSI",1
18,"18095",2002,1566,1537,11,29,"AxSI",0
18,"18149",5401,4290,4212,28,78,"AxSI",3
18,"18011",4376,3286,3248,18,38,"AxSI",0
18,"18137",1002,776,773,0,3,"AxSI",0
21,"21035",9726,6628,6520,78,108,"AxSI",10
18,"18128",342,274,272,1,2,"AxSI",0
29,"29046",2540,1896,1855,13,41,"AxSI",2
41,"41040",11111,8768,8679,76,89,"AxSI",19
21,"21007",6318,4614,4524,50,90,"AxSI",25
21,"21026",253,189,183,1,6,"AxSI",0
29,"29064",437,319,315,2,4,"AxSI",0
11,"11008",17840,12434,12236,181,198,"AxSI",70
21,"21044",17955,11674,11479,136,195,"AxSI",36
18,"18174",434,362,357,0,5,"AxSI",0
23,"23088",6020,4779,4703,56,76,"AxSI",4
18,"18079",3469,2667,2623,16,44,"AxSI",1
23,"23048",820,644,636,1,8,"AxSI",1
29,"29022",171,144,143,0,1,"AxSI",0
41,"41054",713,596,588,4,8,"AxSI",3
29,"29026",1010,747,736,3,11,"AxSI",2
41,"41020",12992,8679,8524,117,155,"AxSI",8
11,"11009",580,429,420,2,9,"AxSI",1
18,"18017",18148,12712,12523,96,189,"AxSI",34
18,"18134",6069,4431,4345,30,86,"AxSI",2
41,"41063",2713,1988,1944,17,44,"AxSI",1
41,"41093",19012,15637,15525,97,112,"AxSI",33
18,"18098",5994,4293,4247,29,46,"AxSI",1
41,"41036",3917,2944,2885,27,59,"AxSI",6
29,"29023",2290,1569,1550,3,19,"AxSI",2
23,"23097",6356,4509,4462,17,47,"AxSI",5
23,"23050",90596,69591,68903,460,688,"AxSI",72
18,"18117",507,402,396,5,6,"AxSI",0
29,"29080",6895,5005,4934,59,71,"AxSI",7
21,"21062",1386,893,885,15,8,"AxSI",2
29,"29051",41793,29275,28764,249,511,"AxSI",85
41,"41056",3694,3044,3009,36,35,"AxSI",9
11,"11901",5698,4167,4080,81,87,"AxSI",35
29,"29011",2871,1955,1926,11,29,"AxSI",1
29,"29031",1559,1139,1113,13,26,"AxSI",2
23,"23082",1875,1402,1389,7,13,"AxSI",0
29,"29003",922,740,727,3,13,"AxSI",1
23,"23096",2571,2099,2063,9,36,"AxSI",1
18,"18005",362,268,265,0,3,"AxSI",0
21,"21075",335,256,249,0,7,"AxSI",0
41,"41903",6769,5018,4919,73,99,"AxSI",7
18,"18007",741,533,527,6,6,"AxSI",2
41,"41019",4895,3518,3462,36,56,"AxSI",2
23,"23009",12808,10348,10233,66,115,"AxSI",3
29,"29077",214,158,156,1,2,"AxSI",0
18,"18074",264,207,205,0,2,"AxSI",0
18,"18168",781,613,604,6,9,"AxSI",0
18,"18171",2111,1679,1638,8,41,"AxSI",0
18,"18153",8796,6686,6594,59,92,"AxSI",8
41,"41901",2703,2242,2201,29,41,"AxSI",2
21,"21056",2922,2307,2228,27,79,"AxSI",4
29,"29045",1681,1263,1242,9,21,"AxSI",3
23,"23070",3808,2598,2565,34,33,"AxSI",2
21,"21016",993,770,744,6,26,"AxSI",1
11,"11023",9372,7032,6950,94,82,"AxSI",5
21,"21040",3181,2303,2227,21,76,"AxSI",5
29,"29075",12890,9033,8949,73,84,"AxSI",14
41,"41032",3843,3018,2944,17,74,"AxSI",9
23,"23084",907,685,670,0,15,"AxSI",1
41,"41087",10496,7661,7477,57,184,"AxSI",13
18,"18152",906,692,686,1,6,"AxSI",0
41,"41055",14804,10863,10720,79,143,"AxSI",27
18,"18047",6074,4437,4353,33,84,"AxSI",6
21,"21034",1159,863,845,4,18,"AxSI",1
23,"23067",2421,1909,1873,13,36,"AxSI",1
29,"29095",3304,2536,2470,22,66,"AxSI",2
41,"41101",6016,4524,4480,42,44,"AxSI",1
41,"41078",2459,1910,1895,24,15,"AxSI",3
29,"29061",1033,840,821,5,19,"AxSI",0
23,"23037",520,431,425,6,6,"AxSI",1
18,"18150",6903,5149,5063,42,86,"AxSI",4
29,"29073",1645,1200,1185,13,15,"AxSI",4
21,"21009",835,575,557,0,18,"AxSI",0
41,"41084",2815,2177,2111,3,66,"AxSI",3
29,"29093",2164,1704,1678,4,26,"AxSI",2
11,"11903",1791,1234,1211,16,23,"AxSI",2
41,"41010",4573,3407,3345,27,62,"AxSI",8
11,"11021",4926,3592,3486,50,106,"AxSI",10
21,"21039",299,226,223,7,3,"AxSI",0
23,"23038",3785,3182,3162,16,20,"AxSI",0
18,"18144",803,650,640,2,10,"AxSI",0
23,"23095",8591,6634,6571,27,63,"AxSI",3
23,"23056",3062,2332,2281,13,51,"AxSI",2
18,"18020",501,365,358,2,7,"AxSI",1
23,"23051",2727,2060,2023,5,37,"AxSI",3
41,"41088",512,383,377,1,6,"AxSI",0
41,"41049",9493,7463,7312,78,151,"AxSI",6
23,"23031",765,659,647,4,12,"AxSI",2
21,"21028",370,300,293,1,7,"AxSI",0
18,"18159",999,828,824,1,4,"AxSI",0
41,"41045",5854,4287,4200,58,87,"AxSI",2
18,"18014",6898,5262,5162,43,100,"AxSI",5
23,"23076",768,653,646,3,7,"AxSI",3
18,"18176",241,182,180,0,2,"AxSI",0
23,"23012",4018,2835,2804,15,31,"AxSI",4
41,"41081",29840,22819,22465,228,354,"AxSI",47
11,"11017",3194,2265,2221,38,44,"AxSI",3
11,"11015",64073,43152,42713,710,439,"AxSI",164
41,"41086",16209,11006,10881,116,125,"AxSI",28
18,"18059",4253,3166,3123,22,43,"AxSI",2
41,"41071",5598,3993,3915,34,78,"AxSI",4
23,"23094",3729,3111,3077,16,34,"AxSI",1
21,"21037",459,363,357,4,6,"AxSI",4
21,"21045",227,181,178,1,3,"AxSI",0
18,"18083",228,189,188,1,1,"AxSI",0
23,"23061",7691,5636,5531,51,105,"AxSI",0
23,"23902",2229,1843,1820,7,23,"AxSI",3
23,"23054",376,296,289,1,7,"AxSI",0
41,"41028",2071,1741,1713,18,28,"AxSI",1
29,"29042",14447,10383,10199,98,184,"AxSI",85
18,"18044",164,113,112,0,1,"AxSI",0
21,"21070",6222,4413,4322,47,91,"AxSI",12
29,"29058",1538,1079,1062,5,17,"AxSI",1
18,"18915",731,539,532,1,7,"AxSI",0
18,"18032",242,180,178,2,2,"AxSI",0
18,"18038",1047,810,787,4,23,"AxSI",1
41,"41060",15100,11304,11105,113,199,"AxSI",34
11,"11029",5423,3161,3105,55,56,"AxSI",6
18,"18188",1648,1295,1276,4,19,"AxSI",3
18,"18065",591,482,468,4,14,"AxSI",0
18,"18178",671,535,532,0,3,"AxSI",0
21,"21059",220,184,180,0,4,"AxSI",0
23,"23075",3220,2559,2524,18,35,"AxSI",5
41,"41051",2311,1770,1734,5,36,"AxSI",2
41,"41066",1310,1027,1010,1,17,"AxSI",5
18,"18033",279,221,220,1,1,"AxSI",0
11,"11034",2331,1708,1670,17,38,"AxSI",16
23,"23046",2331,1953,1926,3,27,"AxSI",0
11,"11002",4200,3287,3257,5,30,"AxSI",13
41,"41039",31500,23692,23345,234,347,"AxSI",177
18,"18185",542,454,453,2,1,"AxSI",0
18,"18108",826,677,669,3,8,"AxSI",0
41,"41904",1792,1171,1162,16,9,"AxSI",0
41,"41005",9250,6925,6809,69,116,"AxSI",20
18,"18145",10869,8532,8405,69,127,"AxSI",11
18,"18154",975,701,699,3,2,"AxSI",0
11,"11039",9945,6824,6726,111,98,"AxSI",23
41,"41003",2371,1801,1760,8,41,"AxSI",2
41,"41015",5401,3984,3889,50,95,"AxSI",9
29,"29009",1441,1097,1073,8,24,"AxSI",0
41,"41050",5180,4217,4149,34,68,"AxSI",38
29,"29098",1235,953,935,12,18,"AxSI",1
41,"41090",3507,2766,2694,15,72,"AxSI",5
18,"18180",627,442,435,4,7,"AxSI",0
18,"18911",7869,5871,5765,49,106,"AxSI",2
29,"29069",86694,58863,58127,561,736,"AxSI",137
11,"11902",3656,2427,2383,29,44,"AxSI",6
41,"41098",5152,4046,3986,24,60,"AxSI",4
21,"21058",2556,1732,1709,21,23,"AxSI",3
18,"18030",567,448,442,4,6,"AxSI",1
18,"18076",790,607,604,1,3,"AxSI",0
11,"11020",166423,117732,116448,1427,1284,"AxSI",452
29,"29014",222,151,150,6,1,"AxSI",0
29,"29036",611,448,444,3,4,"AxSI",1
41,"41082",3359,2760,2718,11,42,"AxSI",1
18,"18122",16001,11761,11556,110,205,"AxSI",7
11,"11005",4520,3212,3128,23,84,"AxSI",7
18,"18167",1850,1330,1317,17,13,"AxSI",2
41,"41042",5849,4730,4692,20,38,"AxSI",5
21,"21060",12235,8053,7929,93,124,"AxSI",24
29,"29037",215,179,179,0,0,"AxSI",1
18,"18036",3970,3197,3149,26,48,"AxSI",2
41,"41094",6447,4998,4912,43,86,"AxSI",1
18,"18141",384,269,264,0,5,"AxSI",1
18,"18105",3822,2688,2650,12,38,"AxSI",0
21,"21032",1801,1401,1378,8,23,"AxSI",1
29,"29034",467,374,373,1,1,"AxSI",0
18,"18120",257,219,217,1,2,"AxSI",1
11,"11010",6351,4472,4385,140,87,"AxSI",17
41,"41083",1128,865,859,6,6,"AxSI",1
21,"21077",1725,1307,1286,10,21,"AxSI",2
41,"41074",2998,2364,2322,17,42,"AxSI",1
11,"11003",1240,898,876,7,22,"AxSI",0
23,"23066",4299,3603,3545,13,58,"AxSI",2
21,"21020",353,242,236,3,6,"AxSI",2
23,"23901",1139,946,934,3,12,"AxSI",1
21,"21053",3287,2375,2322,17,53,"AxSI",2
23,"23032",523,443,439,1,4,"AxSI",0
29,"29024",372,265,250,3,15,"AxSI",0
18,"18157",1148,914,898,8,16,"AxSI",0
29,"29006",665,491,483,5,8,"AxSI",1
41,"41037",3192,2505,2479,15,26,"AxSI",1
41,"41012",3368,2416,2361,23,55,"AxSI",5
23,"23098",838,721,715,2,6,"AxSI",1
18,"18034",486,376,374,4,2,"AxSI",0
23,"23064",1678,1413,1404,10,9,"AxSI",0
21,"21006",3329,2307,2262,20,45,"AxSI",5
29,"29903",493,358,354,6,4,"AxSI",4
18,"18143",949,757,740,5,17,"AxSI",0
18,"18158",8010,5524,5449,23,75,"AxSI",2
21,"21038",1076,786,771,8,15,"AxSI",1
23,"23033",1319,1076,1057,8,19,"AxSI",1
18,"18175",11786,8883,8730,58,153,"AxSI",7
11,"11012",97629,73036,72347,715,689,"AxSI",271
41,"41029",13483,10357,10199,120,158,"AxSI",21
29,"29082",34113,26248,26002,304,246,"AxSI",40
41,"41069",29569,21075,20657,361,418,"AxSI",106
41,"41057",253,189,188,0,1,"AxSI",1
41,"41004",57465,41004,40321,571,683,"AxSI",290
18,"18057",5540,4306,4246,30,60,"AxSI",3
18,"18085",701,465,460,1,5,"AxSI",1
29,"29027",2309,1716,1692,18,24,"AxSI",5
29,"29901",44578,31840,31537,286,303,"AxSI",36
23,"23028",6131,4696,4635,24,61,"AxSI",4
23,"23081",1483,1137,1109,7,28,"AxSI",0
41,"41027",3966,2830,2784,32,46,"AxSI",2
18,"18101",9410,7280,7181,72,99,"AxSI",12
41,"41077",8631,6441,6289,46,152,"AxSI",14
21,"21019",584,441,425,10,16,"AxSI",0
23,"23093",3131,2428,2380,22,48,"AxSI",3
18,"18173",8972,6594,6459,58,135,"AxSI",13
18,"18187",512,388,387,0,1,"AxSI",0
41,"41059",35105,27781,27472,261,309,"AxSI",65
41,"41062",2175,1763,1746,8,17,"AxSI",0
41,"41006",2738,1971,1945,16,26,"AxSI",1
29,"29087",371,266,263,2,3,"AxSI",1
18,"18910",730,491,487,0,4,"AxSI",1
23,"23001",920,769,766,3,3,"AxSI",0
21,"21025",3898,2765,2705,39,60,"AxSI",7
18,"18164",1794,1225,1205,9,20,"AxSI",1
41,"41034",23480,16510,16250,230,260,"AxSI",242
18,"18146",937,690,682,6,8,"AxSI",2
29,"29065",194,150,150,0,0,"AxSI",0
41,"41902",4600,3141,3092,48,49,"AxSI",4
11,"11041",9858,6916,6763,70,153,"AxSI",88
18,"18908",784,599,581,0,18,"AxSI",0
11,"11025",4388,3092,3045,30,47,"AxSI",70
23,"23044",4719,3817,3749,18,68,"AxSI",4
29,"29089",3161,2477,2426,19,51,"AxSI",4
18,"18071",5612,4271,4184,29,87,"AxSI",12
23,"23069",5262,4395,4329,15,66,"AxSI",7
23,"23027",716,524,518,2,6,"AxSI",0
29,"29055",1880,1493,1470,15,23,"AxSI",1
18,"18042",418,344,340,7,4,"AxSI",0
18,"18097",995,708,702,4,6,"AxSI",1
21,"21071",211,155,152,3,3,"AxSI",1
18,"18189",772,619,611,4,8,"AxSI",2
29,"29090",1653,1215,1200,8,15,"AxSI",2
29,"29079",2335,1796,1765,7,31,"AxSI",1
41,"41008",1040,840,822,4,18,"AxSI",3
18,"18194",2045,1394,1370,11,24,"AxSI",1
21,"21015",654,363,359,8,4,"AxSI",2
29,"29086",774,537,532,1,5,"AxSI",0
23,"23024",12224,9586,9329,46,257,"AxSI",11
29,"29001",4199,3380,3341,20,39,"AxSI",3
11,"11030",22973,16087,15853,165,234,"AxSI",58
29,"29094",59350,42199,41749,419,450,"AxSI",265
11,"11001",4342,2928,2870,32,58,"AxSI",11
41,"41100",967,765,727,8,38,"AxSI",2
29,"29902",2592,1841,1817,18,24,"AxSI",1
41,"41021",21397,15585,15334,201,251,"AxSI",39
11,"11011",1736,1285,1249,7,36,"AxSI",15
21,"21024",466,355,341,4,14,"AxSI",0
41,"41043",667,475,453,3,22,"AxSI",0
23,"23002",17399,13575,13341,97,234,"AxSI",20
29,"29002",1150,851,842,4,9,"AxSI",2
21,"21065",255,178,173,2,5,"AxSI",0
29,"29035",1505,1151,1133,6,18,"AxSI",1
18,"18114",591,443,437,2,6,"AxSI",0
18,"18067",681,511,507,3,4,"AxSI",0
29,"29092",579,434,426,5,8,"AxSI",1
23,"23905",1840,1358,1341,9,17,"AxSI",1
18,"18029",1813,1183,1169,9,14,"AxSI",2
18,"18162",929,730,719,4,11,"AxSI",1
23,"23092",27662,21206,20981,170,225,"AxSI",29
18,"18040",226,146,145,0,1,"AxSI",0
41,"41016",7767,5937,5829,56,108,"AxSI",6
41,"41007",12438,9009,8775,135,234,"AxSI",9
23,"23017",1480,1227,1202,6,25,"AxSI",0
23,"23006",4582,3607,3543,32,64,"AxSI",8
41,"41035",1060,803,788,8,15,"AxSI",1
23,"23041",491,383,382,0,1,"AxSI",12
21,"21063",2620,2037,1992,11,45,"AxSI",1
18,"18140",42374,29390,29025,221,365,"AxSI",304
23,"23018",2268,1738,1722,8,16,"AxSI",1
21,"21002",15922,11918,11773,119,145,"AxSI",37
41,"41017",15712,12048,11896,118,152,"AxSI",29
18,"18133",2109,1632,1618,12,14,"AxSI",1
18,"18906",911,722,716,4,6,"AxSI",1
41,"41014",2486,1939,1878,6,61,"AxSI",1
23,"23034",2490,2033,1999,15,34,"AxSI",0
41,"41033",4965,3634,3580,27,54,"AxSI",28
21,"21048",313,243,237,4,6,"AxSI",0
23,"23019",1479,1209,1183,3,26,"AxSI",0
41,"41073",1685,1172,1157,13,15,"AxSI",2
11,"11026",4695,3656,3564,18,92,"AxSI",44
11,"11038",13613,10879,10676,101,203,"AxSI",75
18,"18021",17869,13238,13004,110,234,"AxSI",3
23,"23077",611,483,479,0,4,"AxSI",0
21,"21069",1667,1214,1198,13,16,"AxSI",1
18,"18089",14540,10725,10583,65,142,"AxSI",9
29,"29005",4499,3202,3171,37,31,"AxSI",8
23,"23063",3764,2812,2781,22,31,"AxSI",1
29,"29057",341,236,233,0,3,"AxSI",0
21,"21029",1509,1183,1160,14,23,"AxSI",3
41,"41053",21618,16549,16150,194,399,"AxSI",55
21,"21061",5089,3358,3290,42,68,"AxSI",6
18,"18138",2482,1698,1668,20,30,"AxSI",0
21,"21017",2325,1450,1419,22,31,"AxSI",2
41,"41047",10411,8348,8242,84,106,"AxSI",13
18,"18037",528,435,426,2,9,"AxSI",0
18,"18099",1581,1279,1245,5,34,"AxSI",3
23,"23057",732,613,611,4,2,"AxSI",0
18,"18115",2650,1988,1975,20,13,"AxSI",0
21,"21014",4065,3192,3148,22,44,"AxSI",16
11,"11024",6583,4774,4682,40,92,"AxSI",9
29,"29050",398,274,269,2,5,"AxSI",0
11,"11037",5644,4567,4433,34,134,"AxSI",5
18,"18045",1060,748,737,10,11,"AxSI",0
21,"21067",402,300,299,2,1,"AxSI",0
23,"23014",2552,2056,2020,11,36,"AxSI",0
18,"18909",539,432,426,1,6,"AxSI",0
18,"18035",1190,965,952,4,13,"AxSI",1
41,"41001",1565,1224,1213,8,11,"AxSI",0
18,"18163",315,246,241,1,5,"AxSI",0
41,"41011",15454,11892,11591,160,301,"AxSI",18
11,"11022",48682,28113,27794,294,319,"AxSI",129
29,"29015",32064,23769,23461,213,308,"AxSI",27
23,"23059",5728,4259,4187,18,72,"AxSI",13
18,"18043",130,93,93,0,0,"AxSI",0
29,"29038",18683,12820,12666,168,154,"AxSI",23
18,"18046",1753,1206,1185,1,21,"AxSI",0
18,"18116",2853,2265,2233,15,32,"AxSI",4
11,"11006",24522,16656,16392,220,264,"AxSI",62
29,"29074",781,606,597,2,9,"AxSI",0
21,"21031",1172,807,764,5,43,"AxSI",6
21,"21902",1144,829,824,9,5,"AxSI",1
29,"29068",7716,5347,5230,58,117,"AxSI",14
23,"23079",3639,2859,2818,20,41,"AxSI",6
41,"41068",13936,10692,10530,73,162,"AxSI",19
23,"23904",2604,1727,1701,7,26,"AxSI",0
23,"23091",679,575,571,3,4,"AxSI",1
23,"23025",2727,2125,2090,8,35,"AxSI",0
18,"18086",339,291,289,0,2,"AxSI",0
29,"29016",263,217,217,0,0,"AxSI",0
41,"41009",1167,820,805,4,15,"AxSI",0
23,"23016",384,316,311,0,5,"AxSI",0
23,"23047",1579,1260,1247,13,13,"AxSI",1
21,"21022",186,132,129,0,3,"AxSI",0
41,"41044",7698,5967,5898,59,69,"AxSI",19
23,"23087",11185,8500,8363,65,137,"AxSI",3
23,"23029",806,651,637,0,14,"AxSI",0
18,"18132",3124,2575,2548,17,27,"AxSI",3
21,"21042",15579,8742,8579,138,163,"AxSI",139
23,"23903",3499,2738,2714,7,24,"AxSI",2
18,"18048",2462,1873,1832,16,41,"AxSI",1
29,"29043",2474,1764,1720,25,44,"AxSI",2
23,"23080",1721,1370,1355,8,15,"AxSI",0
21,"21047",1869,1242,1206,8,36,"AxSI",0
23,"23072",1885,1485,1468,5,17,"AxSI",0
18,"18912",1367,990,984,5,6,"AxSI",2
29,"29085",138,100,98,0,2,"AxSI",1
29,"29066",346,266,266,2,0,"AxSI",0
41,"41079",9293,7137,6979,80,158,"AxSI",34
29,"29033",1089,776,761,2,15,"AxSI",0
41,"41070",6397,4987,4921,55,66,"AxSI",15
41,"41096",6134,4926,4845,44,81,"AxSI",10
29,"29049",2926,2197,2165,9,32,"AxSI",3
18,"18002",526,400,400,0,0,"AxSI",0
18,"18003",14413,11095,10883,92,212,"AxSI",10
41,"41052",3027,2357,2288,14,69,"AxSI",5
11,"11042",1155,870,852,7,18,"AxSI",0
23,"23030",1208,1022,1011,6,11,"AxSI",0
23,"23062",1418,1206,1190,5,16,"AxSI",0
11,"11019",1753,1353,1295,7,58,"AxSI",9
11,"11014",17141,11836,11705,214,131,"AxSI",145
29,"29019",864,687,679,7,8,"AxSI",0
18,"18072",664,481,473,0,8,"AxSI",0
21,"21001",610,480,461,3,19,"AxSI",0
29,"29039",2728,2084,2050,14,34,"AxSI",2
23,"23005",29940,19587,19330,191,257,"AxSI",107
21,"21012",286,238,233,4,5,"AxSI",2
21,"21049",3282,2294,2214,21,80,"AxSI",6
23,"23074",2971,2410,2378,8,32,"AxSI",0
41,"41080",1240,940,913,11,27,"AxSI",0
23,"23008",1434,1155,1133,6,22,"AxSI",1
18,"18136",1782,1382,1359,12,23,"AxSI",1
21,"21013",10570,7195,7089,73,106,"AxSI",10
23,"23043",518,398,397,0,1,"AxSI",0
18,"18177",373,253,252,1,1,"AxSI",0
11,"11033",21702,14645,14436,190,209,"AxSI",98
18,"18087",182514,141305,139588,865,1717,"AxSI",128
21,"21050",12522,8425,8312,84,113,"AxSI",14
21,"21074",2698,1979,1945,15,34,"AxSI",0
41,"41072",4037,3256,3221,19,35,"AxSI",2
29,"29904",417,337,335,2,2,"AxSI",0
41,"41026",4300,3561,3521,18,40,"AxSI",4
18,"18126",1450,1115,1087,11,28,"AxSI",0
41,"41048",2198,1561,1512,22,49,"AxSI",4
21,"21054",8157,6002,5869,60,133,"AxSI",12
23,"23055",46343,33603,33225,243,378,"AxSI",69
21,"21052",4429,2951,2891,19,60,"AxSI",4
23,"23052",1108,949,931,8,18,"AxSI",1
21,"21003",677,505,489,3,16,"AxSI",0
21,"21072",10227,7947,7739,98,208,"AxSI",14
18,"18039",3382,2517,2490,20,27,"AxSI",11
23,"23049",1747,1321,1305,11,16,"AxSI",1
18,"18088",1530,1152,1142,0,10,"AxSI",0
21,"21064",6641,4689,4597,66,92,"AxSI",16
23,"23090",1219,1014,1004,5,10,"AxSI",3
29,"29091",9407,6859,6719,63,140,"AxSI",11
18,"18102",8227,6100,5969,32,131,"AxSI",1
18,"18078",710,561,554,4,7,"AxSI",0
29,"29010",1632,1372,1319,4,53,"AxSI",1
23,"23042",317,234,232,1,2,"AxSI",0
21,"21066",495,401,396,4,5,"AxSI",0
29,"29053",1694,1263,1245,18,18,"AxSI",29
29,"29060",671,511,506,1,5,"AxSI",0
18,"18183",624,442,441,1,1,"AxSI",0
41,"41018",9410,6987,6882,52,105,"AxSI",17
18,"18121",130,104,103,3,1,"AxSI",2
18,"18066",2108,1537,1525,9,12,"AxSI",1
21,"21041",112810,77371,76488,900,883,"AxSI",287
18,"18084",4458,3467,3417,17,50,"AxSI",2
29,"29007",28584,21525,21318,202,207,"AxSI",33
23,"23040",1443,1164,1149,3,15,"AxSI",1
18,"18001",230,173,170,1,3,"AxSI",0
23,"23060",19153,14444,14281,87,163,"AxSI",17
18,"18170",324,225,224,1,1,"AxSI",0
18,"18106",415,300,295,0,5,"AxSI",0
11,"11016",15051,10188,10042,131,146,"AxSI",34
21,"21030",1879,1523,1504,14,19,"AxSI",0
18,"18013",4152,3168,3103,16,65,"AxSI",3
41,"41102",14750,10972,10677,110,295,"AxSI",44
29,"29040",1936,1419,1395,7,24,"AxSI",2
41,"41075",10279,7543,7370,96,173,"AxSI",21
23,"23086",11442,8618,8431,80,187,"AxSI",5
18,"18109",599,452,448,3,4,"AxSI",1
11,"11007",18020,11346,11152,176,194,"AxSI",736
21,"21068",962,562,550,14,12,"AxSI",0
18,"18068",1606,1293,1277,11,16,"AxSI",0
18,"18023",15645,11708,11561,91,147,"AxSI",15
23,"23065",1550,1199,1186,4,13,"AxSI",1
18,"18182",1917,1391,1381,7,10,"AxSI",0
18,"18077",471,372,366,5,6,"AxSI",1
29,"29083",2062,1607,1574,9,33,"AxSI",1
18,"18913",781,590,577,5,13,"AxSI",0
29,"29030",774,660,657,3,3,"AxSI",0
23,"23003",8644,6604,6523,36,81,"AxSI",6
18,"18181",202,150,148,0,2,"AxSI",0
21,"21010",14976,9475,9352,145,123,"AxSI",35
18,"18056",3418,2523,2478,22,45,"AxSI",0
18,"18064",366,307,306,0,1,"AxSI",0
21,"21057",995,631,629,3,2,"AxSI",0
21,"21073",1891,1191,1156,17,35,"AxSI",1
29,"29012",9718,7243,7123,47,120,"AxSI",3
41,"41024",22737,15687,15398,167,289,"AxSI",22
18,"18006",4087,3109,3042,28,67,"AxSI",2
23,"23039",2154,1644,1605,6,39,"AxSI",1
18,"18012",2143,1651,1634,8,17,"AxSI",0
21,"21078",2646,1926,1895,14,31,"AxSI",2
29,"29056",1061,783,772,4,11,"AxSI",1
23,"23011",2134,1649,1614,11,35,"AxSI",0
18,"18082",827,587,577,5,10,"AxSI",1
29,"29017",6428,4943,4871,32,72,"AxSI",7
18,"18093",2756,1902,1885,8,17,"AxSI",2
41,"41092",7679,5668,5568,61,100,"AxSI",7
41,"41065",22550,16215,16010,189,205,"AxSI",23
41,"41095",39970,27911,27583,389,328,"AxSI",95
21,"21021",12469,8238,8097,76,141,"AxSI",22
11,"11004",89545,60056,59323,741,733,"AxSI",305
29,"29099",969,757,735,5,22,"AxSI",1
23,"23058",8817,6964,6873,48,91,"AxSI",6
41,"41013",4807,3480,3425,30,55,"AxSI",3
11,"11031",76294,54123,53583,589,540,"AxSI",381
18,"18111",2849,2193,2160,24,33,"AxSI",5
41,"41085",4170,3337,3270,27,67,"AxSI",2
18,"18051",1090,800,795,13,5,"AxSI",0
11,"11036",687,457,447,7,10,"AxSI",0
18,"18184",2170,1688,1656,3,32,"AxSI",1
18,"18903",851,644,636,1,8,"AxSI",0
29,"29081",261,212,210,2,2,"AxSI",0
21,"21023",2051,1356,1332,5,24,"AxSI",8
18,"18028",907,766,756,0,10,"AxSI",0
41,"41002",1427,1057,1024,5,33,"AxSI",4
29,"29008",15183,10716,10555,93,161,"AxSI",10
41,"41061",2144,1763,1712,7,51,"AxSI",2
11,"11040",398,348,342,4,6,"AxSI",1
18,"18123",288,219,219,2,0,"AxSI",0
11,"11018",1446,1126,1100,6,26,"AxSI",8
29,"29063",303,243,239,1,4,"AxSI",0
29,"29047",1103,909,898,2,11,"AxSI",0
18,"18054",838,649,648,8,1,"AxSI",0
18,"18165",4251,3113,3073,20,40,"AxSI",7
18,"18053",1561,1102,1099,3,3,"AxSI",1
23,"23020",1524,1363,1348,12,15,"AxSI",0
29,"29028",1224,875,858,4,17,"AxSI",1
18,"18022",13804,9877,9714,92,163,"AxSI",15
11,"11035",13715,9510,9385,128,125,"AxSI",70
23,"23071",1720,1348,1330,6,18,"AxSI",0
29,"29059",2643,2086,2042,8,44,"AxSI",2
18,"18901",488,335,329,2,6,"AxSI",0
23,"23099",4822,3687,3633,28,54,"AxSI",6
18,"18119",1712,1352,1317,11,35,"AxSI",0
23,"23021",517,446,440,0,6,"AxSI",0
29,"29096",2756,2061,2018,21,43,"AxSI",0
18,"18096",344,265,265,2,0,"AxSI",0
18,"18063",1217,712,702,6,10,"AxSI",0
41,"41031",1215,866,848,3,18,"AxSI",5
21,"21033",561,428,427,4,1,"AxSI",2
29,"29018",1996,1523,1481,11,42,"AxSI",1
11,"11032",54469,33144,32810,461,334,"AxSI",177
41,"41091",539730,412509,408312,3804,4197,"AxSI",946
29,"29025",41515,29572,29311,221,261,"AxSI",28
23,"23045",2057,1519,1507,7,12,"AxSI",1
18,"18147",3644,2492,2441,18,51,"AxSI",2
18,"18010",532,420,416,2,4,"AxSI",1
21,"21005",15697,9910,9778,72,132,"AxSI",18
29,"29071",979,718,712,14,6,"AxSI",0
18,"18127",16822,12735,12537,106,198,"AxSI",7
29,"29052",222,156,153,2,3,"AxSI",0
21,"21027",50,40,39,0,1,"AxSI",0
18,"18112",110,80,76,0,4,"AxSI",0
18,"18148",803,652,648,0,4,"AxSI",0
29,"29044",757,540,533,7,7,"AxSI",0
41,"41038",102179,76348,75425,819,923,"AxSI",195
18,"18151",259,194,193,3,1,"AxSI",0
18,"18018",554,457,451,0,6,"AxSI",0
29,"29021",159,121,120,0,1,"AxSI",1
29,"29097",4168,3086,3009,37,77,"AxSI",10
11,"11013",2332,1747,1713,16,34,"AxSI",4
18,"18193",14802,11165,10973,110,192,"AxSI",5
41,"41025",2019,1492,1439,7,53,"AxSI",3
23,"23035",1103,903,882,6,21,"AxSI",1
29,"29084",27218,19648,19352,173,296,"AxSI",37
41,"41089",6629,4904,4814,48,90,"AxSI",53
29,"29013",1602,1262,1238,12,24,"AxSI",2
18,"18192",1466,1171,1156,1,15,"AxSI",0
23,"23007",3026,2317,2301,13,16,"AxSI",2
21,"21036",203,147,143,0,4,"AxSI",0
41,"41022",4269,3158,3110,16,48,"AxSI",3
29,"29067",430670,312817,309994,2768,2823,"AxSI",502
18,"18905",15550,11394,11230,132,164,"AxSI",14
21,"21046",1714,1097,1071,13,26,"AxSI",8
41,"41041",9760,7835,7646,44,189,"AxSI",49
29,"29072",3277,2628,2592,16,36,"AxSI",3
41,"41076",2143,1419,1403,14,16,"AxSI",1
18,"18103",722,556,555,3,1,"AxSI",1
29,"29054",42393,30327,30108,218,219,"AxSI",58
18,"18070",289,224,222,3,2,"AxSI",0
21,"21004",1593,1114,1085,16,29,"AxSI",7
29,"29032",6657,5314,5190,30,124,"AxSI",3
18,"18049",596,485,481,0,4,"AxSI",0
18,"18161",251,222,220,1,2,"AxSI",0
29,"29070",43090,30294,29928,243,366,"AxSI",74
29,"29076",2335,1661,1614,11,47,"AxSI",1
18,"18069",497,374,366,4,8,"AxSI",0
23,"23101",352,273,271,0,2,"AxSI",0
18,"18025",279,214,212,0,2,"AxSI",0
29,"29088",2694,2019,1951,31,68,"AxSI",1
18,"18914",1657,1315,1278,5,37,"AxSI",0
41,"41067",7227,5367,5271,56,96,"AxSI",10
41,"41099",3968,2666,2642,23,24,"AxSI",6
18,"18061",1000,827,822,1,5,"AxSI",0
41,"41030",500,419,410,6,9,"AxSI",0
41,"41046",3006,2464,2427,13,37,"AxSI",4
18,"18904",743,555,545,1,10,"AxSI",0
21,"21079",687,503,500,5,3,"AxSI",1
21,"21011",3473,2543,2513,14,30,"AxSI",8
23,"23004",421,356,355,2,1,"AxSI",0
18,"18902",755,611,595,1,16,"AxSI",0
23,"23053",9449,6379,6325,25,54,"AxSI",3
18,"18024",831,682,667,6,15,"AxSI",0
18,"18179",503,346,343,3,3,"AxSI",0
18,"18094",2304,1845,1798,16,47,"AxSI",1
21,"21076",2142,1573,1551,24,22,"AxSI",4
29,"29041",3599,2570,2532,22,38,"AxSI",5
11,"11028",32791,24276,24028,279,248,"AxSI",278
18,"18016",308,232,231,5,1,"AxSI",0
18,"18027",2604,1902,1887,6,15,"AxSI",0
18,"18050",1670,1231,1213,9,18,"AxSI",1
29,"29029",380,294,287,2,7,"AxSI",1
21,"21051",221,180,177,1,3,"AxSI",2
18,"18124",359,269,267,0,2,"AxSI",0
18,"18004",687,521,515,4,6,"AxSI",0
23,"23026",3450,2625,2573,17,52,"AxSI",1
41,"41064",5611,3763,3667,47,96,"AxSI",4
21,"21055",7218,5328,5215,41,113,"AxSI",3
41,"41023",7975,5918,5812,51,106,"AxSI",5
41,"41058",17860,12850,12598,152,252,"AxSI",129
21,"21043",1857,1465,1424,7,41,"AxSI",2
18,"18015",425,333,333,0,0,"AxSI",0
23,"23085",2182,1733,1717,7,16,"AxSI",48
29,"29062",651,576,567,4,9,"AxSI",0
23,"23010",14241,10186,10015,68,171,"AxSI",9
29,"29048",1370,1149,1135,10,14,"AxSI",1
15,"15041",9581,7223,7082,96,141,"BNG",464
36,"36014",1872,1373,1345,14,28,"BNG",32
27,"27055",1197,857,851,2,6,"BNG",32
32,"32047",1746,1272,1252,6,20,"BNG",49
15,"15068",4849,3435,3392,55,43,"BNG",259
27,"27024",1451,1122,1102,5,20,"BNG",52
36,"36038",66806,50974,50429,507,545,"BNG",3436
27,"27009",2022,1514,1488,17,26,"BNG",43
27,"27039",4430,3437,3353,53,84,"BNG",200
27,"27053",501,384,373,1,11,"BNG",12
32,"32079",1287,1016,1006,6,10,"BNG",30
15,"15082",15381,11803,11642,133,161,"BNG",990
15,"15029",5403,3682,3622,62,60,"BNG",229
27,"27004",1149,741,722,2,19,"BNG",26
36,"36024",16395,12372,12165,102,207,"BNG",836
15,"15065",7151,5281,5165,63,116,"BNG",338
15,"15072",9436,6962,6860,60,102,"BNG",879
15,"15048",5048,3791,3730,38,61,"BNG",188
15,"15070",8797,6312,6173,108,139,"BNG",618
15,"15045",3629,2263,2237,9,26,"BNG",240
32,"32042",1505,1097,1091,12,6,"BNG",14
32,"32009",10590,7661,7574,68,87,"BNG",156
15,"15067",7953,6004,5925,51,79,"BNG",481
15,"15012",3611,2695,2616,36,79,"BNG",106
27,"27057",11097,7917,7735,88,182,"BNG",462
27,"27058",3322,2551,2512,22,39,"BNG",97
32,"32054",86475,64472,63712,676,760,"BNG",2238
15,"15076",2514,1709,1683,19,26,"BNG",313
32,"32036",1261,954,938,9,16,"BNG",31
15,"15086",2785,2015,1987,14,28,"BNG",101
15,"15093",4048,2761,2720,41,41,"BNG",265
27,"27017",961,667,654,1,13,"BNG",18
15,"15092",6250,4358,4297,28,61,"BNG",188
27,"27062",584,467,466,3,1,"BNG",6
36,"36054",11074,8032,7873,77,159,"BNG",698
15,"15044",1209,889,876,4,13,"BNG",47
36,"36032",3537,2676,2626,16,50,"BNG",212
27,"27014",3162,2181,2139,17,42,"BNG",115
36,"36901",4152,3400,3338,15,62,"BNG",254
27,"27028",78798,58316,57546,629,770,"BNG",2536
32,"32011",918,526,521,6,5,"BNG",6
15,"15073",21760,14900,14630,181,270,"BNG",916
15,"15042",2955,2057,2002,16,55,"BNG",93
32,"32045",2360,1712,1689,18,23,"BNG",37
15,"15066",4008,2931,2886,30,45,"BNG",168
27,"27007",2756,2148,2084,29,64,"BNG",58
27,"27018",3232,2114,2089,24,25,"BNG",105
15,"15077",8155,5554,5433,59,121,"BNG",264
15,"15901",3359,2237,2205,35,32,"BNG",124
32,"32028",1550,1176,1171,10,5,"BNG",21
36,"36060",30432,22488,22196,199,292,"BNG",1204
36,"36030",3946,2847,2810,26,37,"BNG",250
32,"32063",1819,1313,1287,6,26,"BNG",18
27,"27041",2238,1640,1615,10,25,"BNG",83
15,"15043",4978,3631,3572,39,59,"BNG",259
36,"36036",2556,1953,1914,14,39,"BNG",98
36,"36047",2287,1601,1585,14,16,"BNG",76
36,"36018",3073,2184,2144,9,40,"BNG",137
15,"15087",5692,3883,3838,53,45,"BNG",218
27,"27016",6973,5139,5064,66,75,"BNG",222
36,"36037",2554,1839,1793,6,46,"BNG",91
36,"36061",8617,6498,6391,59,107,"BNG",293
15,"15023",6318,4501,4436,40,65,"BNG",389
27,"27045",944,700,698,13,2,"BNG",8
15,"15061",5199,3694,3601,40,93,"BNG",240
27,"27031",15212,10826,10649,125,177,"BNG",374
15,"15016",4569,3171,3146,18,25,"BNG",156
36,"36044",2539,1768,1708,18,60,"BNG",106
36,"36002",3076,2225,2185,19,40,"BNG",303
32,"32090",738,530,525,3,5,"BNG",33
32,"32022",1238,924,916,5,8,"BNG",102
32,"32069",4256,3358,3309,39,49,"BNG",172
15,"15075",12785,9638,9519,121,119,"BNG",513
32,"32082",1178,880,872,12,8,"BNG",42
32,"32033",676,480,468,4,12,"BNG",12
32,"32073",1281,941,932,9,9,"BNG",27
15,"15003",1701,1234,1210,10,24,"BNG",66
15,"15028",1393,1076,1063,8,13,"BNG",151
32,"32010",360,276,273,3,3,"BNG",10
36,"36028",4069,3012,2960,27,52,"BNG",153
15,"15017",19860,14930,14706,204,224,"BNG",761
36,"36010",2828,2217,2184,15,33,"BNG",215
32,"32072",3687,2715,2682,22,33,"BNG",119
15,"15071",7805,5476,5401,62,75,"BNG",444
32,"32037",681,534,523,6,11,"BNG",7
36,"36902",5052,3813,3724,21,89,"BNG",169
32,"32052",1819,1399,1379,15,20,"BNG",39
36,"36056",4961,3719,3635,30,84,"BNG",150
36,"36006",11468,8959,8782,66,177,"BNG",742
32,"32014",1045,775,769,5,6,"BNG",42
27,"27051",8012,5936,5832,70,104,"BNG",336
36,"36040",2517,1895,1853,18,42,"BNG",108
15,"15037",4031,2700,2677,13,23,"BNG",248
36,"36004",10123,7396,7273,93,123,"BNG",516
32,"32034",1074,855,846,1,9,"BNG",61
15,"15057",12051,8814,8660,89,154,"BNG",593
15,"15081",982,755,741,11,14,"BNG",34
32,"32043",2512,1805,1789,16,16,"BNG",52
27,"27027",1806,1392,1354,18,38,"BNG",89
36,"36005",8122,5895,5776,65,119,"BNG",335
15,"15013",6299,4549,4486,45,63,"BNG",340
36,"36001",2401,1739,1715,19,24,"BNG",65
15,"15020",3593,2491,2469,18,22,"BNG",319
32,"32004",1671,907,899,7,8,"BNG",8
32,"32041",759,510,502,2,8,"BNG",9
15,"15030",199972,151737,150397,1576,1340,"BNG",8207
32,"32053",1363,1114,1098,14,16,"BNG",78
15,"15079",1466,1076,1052,11,24,"BNG",98
32,"32078",1108,794,781,15,13,"BNG",19
15,"15039",1224,874,850,11,24,"BNG",40
27,"27022",4683,3131,3059,30,72,"BNG",176
27,"27025",2743,2191,2138,31,53,"BNG",158
32,"32071",1378,963,954,7,9,"BNG",22
32,"32080",286,223,220,1,3,"BNG",5
36,"36003",10038,7747,7632,79,115,"BNG",351
15,"15052",4104,2928,2878,30,50,"BNG",164
32,"32064",480,348,346,2,2,"BNG",5
15,"15010",1819,1194,1181,16,13,"BNG",140
15,"15059",10255,7423,7262,122,161,"BNG",637
32,"32067",1193,827,818,10,9,"BNG",38
27,"27056",1206,896,880,9,16,"BNG",33
27,"27012",1276,776,768,9,8,"BNG",24
36,"36026",19924,14342,14132,171,210,"BNG",657
15,"15050",1748,1038,1027,15,11,"BNG",68
32,"32065",630,478,474,5,4,"BNG",9
15,"15051",4562,3302,3249,36,53,"BNG",221
32,"32092",482,337,334,2,3,"BNG",20
27,"27029",1427,1068,1047,13,21,"BNG",60
15,"15064",2127,1608,1577,29,31,"BNG",83
36,"36039",15610,11844,11592,103,252,"BNG",563
15,"15091",1103,773,758,16,15,"BNG",23
36,"36046",4043,3157,3084,27,73,"BNG",131
27,"27026",2315,1620,1599,17,21,"BNG",81
15,"15025",1000,639,631,6,8,"BNG",41
36,"36016",1064,707,696,7,11,"BNG",49
32,"32031",1014,764,756,5,8,"BNG",15
32,"32075",4382,3546,3489,35,57,"BNG",101
27,"27064",1503,1078,1039,12,39,"BNG",36
27,"27063",1715,1236,1198,10,38,"BNG",69
15,"15088",3415,2349,2323,28,26,"BNG",80
36,"36034",3319,2384,2347,16,37,"BNG",227
15,"15054",31802,22002,21676,368,326,"BNG",1215
32,"32013",2017,1388,1380,5,8,"BNG",37
15,"15047",2269,1531,1497,25,34,"BNG",90
27,"27013",3684,2997,2935,26,62,"BNG",191
15,"15085",3220,2284,2239,23,45,"BNG",148
15,"15006",5169,3527,3436,32,91,"BNG",336
32,"32007",1412,1011,1001,9,10,"BNG",128
27,"27038",923,688,677,12,11,"BNG",14
15,"15034",2724,1832,1811,8,21,"BNG",97
27,"27023",2470,1833,1797,20,36,"BNG",57
15,"15049",1091,805,796,8,9,"BNG",207
32,"32020",2460,1899,1876,6,23,"BNG",98
36,"36059",4663,3196,3115,31,81,"BNG",228
27,"27059",2055,1508,1471,13,37,"BNG",40
15,"15014",3836,2739,2698,38,41,"BNG",169
36,"36025",2137,1387,1381,7,6,"BNG",83
32,"32005",827,628,622,4,6,"BNG",11
15,"15080",1640,1177,1150,9,27,"BNG",31
27,"27052",862,645,640,4,5,"BNG",14
32,"32029",436,340,337,1,3,"BNG",6
32,"32024",4835,3484,3439,23,45,"BNG",161
27,"27054",1145,907,890,5,17,"BNG",54
32,"32018",1179,950,936,3,14,"BNG",18
27,"27035",180,127,123,0,4,"BNG",9
15,"15018",1087,771,761,8,10,"BNG",60
32,"32008",8572,6301,6216,65,85,"BNG",245
32,"32061",1070,862,855,8,7,"BNG",24
15,"15046",6163,4625,4497,49,128,"BNG",363
27,"27050",2842,2100,2072,19,28,"BNG",71
36,"36049",7019,5414,5283,48,131,"BNG",237
36,"36029",16086,12196,12005,126,191,"BNG",1057
32,"32027",1000,762,747,5,15,"BNG",13
27,"27030",3134,2209,2162,27,47,"BNG",132
15,"15005",25263,17634,17347,257,287,"BNG",905
36,"36050",7650,5616,5506,48,110,"BNG",409
32,"32049",689,468,462,3,6,"BNG",11
32,"32068",1419,998,987,4,11,"BNG",47
32,"32087",1675,1313,1288,18,25,"BNG",26
27,"27048",2019,1499,1467,23,32,"BNG",61
32,"32019",11512,8281,8161,96,120,"BNG",298
27,"27061",1016,784,763,9,21,"BNG",20
15,"15089",4324,3258,3200,33,58,"BNG",187
32,"32050",2280,1788,1775,19,13,"BNG",60
32,"32035",1370,881,872,5,9,"BNG",23
36,"36020",2184,1621,1599,13,22,"BNG",66
32,"32032",7932,5956,5831,55,125,"BNG",250
15,"15033",2422,1887,1866,13,21,"BNG",196
32,"32006",1434,1033,1019,8,14,"BNG",23
36,"36043",4682,3345,3303,17,42,"BNG",294
15,"15019",26006,18323,18075,280,248,"BNG",1848
27,"27034",1025,647,636,4,11,"BNG",22
27,"27066",12633,9139,8911,84,228,"BNG",515
32,"32076",1974,1492,1472,17,20,"BNG",60
27,"27015",4020,2809,2730,33,79,"BNG",106
32,"32017",1202,821,815,6,6,"BNG",12
32,"32023",1132,867,862,7,5,"BNG",13
15,"15090",1125,811,800,7,11,"BNG",118
32,"32085",10634,7655,7551,66,104,"BNG",445
27,"27006",2458,1713,1666,27,47,"BNG",48
27,"27047",1525,1026,1008,5,18,"BNG",124
32,"32057",514,367,365,5,2,"BNG",9
27,"27044",2719,1848,1797,29,51,"BNG",172
15,"15060",5843,4360,4281,65,79,"BNG",293
32,"32046",1098,793,782,5,11,"BNG",26
15,"15032",3413,2487,2414,28,73,"BNG",136
15,"15001",4689,3422,3362,52,60,"BNG",191
36,"36055",13551,9908,9682,105,226,"BNG",612
15,"15015",2883,2079,2049,21,30,"BNG",150
27,"27046",1448,1074,1063,7,11,"BNG",64
27,"27040",3035,2285,2234,19,51,"BNG",77
15,"15004",4873,3689,3623,31,66,"BNG",279
32,"32084",902,636,631,2,5,"BNG",33
27,"27049",1342,934,921,11,13,"BNG",36
15,"15084",3059,2236,2217,20,19,"BNG",123
27,"27020",3380,2764,2713,32,51,"BNG",81
36,"36019",1463,1041,1030,14,11,"BNG",48
32,"32012",716,497,487,7,10,"BNG",9
15,"15040",2675,2011,1979,20,32,"BNG",106
32,"32081",2035,1592,1565,14,27,"BNG",33
15,"15027",1555,1227,1204,18,23,"BNG",52
32,"32038",399,274,271,3,3,"BNG",5
36,"36023",8279,6187,6085,46,102,"BNG",630
32,"32025",1013,773,761,7,12,"BNG",24
32,"32016",724,543,535,3,8,"BNG",7
36,"36058",4942,3470,3402,37,68,"BNG",269
15,"15007",3179,2333,2304,22,29,"BNG",106
15,"15022",5574,3846,3798,41,48,"BNG",407
32,"32021",874,616,615,4,1,"BNG",32
32,"32083",821,592,587,7,5,"BNG",21
32,"32044",809,625,617,2,8,"BNG",11
36,"36027",4380,3262,3206,26,56,"BNG",137
27,"27021",1649,1080,1048,14,32,"BNG",53
36,"36052",7234,5292,5151,44,141,"BNG",303
15,"15024",4346,3210,3151,19,59,"BNG",216
32,"32039",1142,895,890,7,5,"BNG",24
36,"36051",14315,10396,10223,70,173,"BNG",455
32,"32030",944,690,685,7,5,"BNG",18
36,"36053",5784,4407,4327,28,80,"BNG",662
36,"36021",12099,9105,8974,85,131,"BNG",347
32,"32070",512,307,304,8,3,"BNG",6
27,"27001",2209,1290,1251,25,39,"BNG",55
36,"36007",1618,1163,1133,7,30,"BNG",50
27,"27032",3194,2268,2223,20,45,"BNG",101
32,"32058",5225,3915,3857,35,58,"BNG",91
32,"32055",1230,908,889,5,19,"BNG",33
32,"32062",766,582,579,1,3,"BNG",8
27,"27019",8189,6148,6039,94,109,"BNG",416
32,"32015",830,543,541,4,2,"BNG",12
32,"32059",1703,1248,1228,12,20,"BNG",17
32,"32089",1220,872,857,15,15,"BNG",67
32,"32060",765,577,567,2,10,"BNG",14
15,"15009",10615,8066,7919,93,147,"BNG",457
36,"36009",4445,3081,2997,26,84,"BNG",52
32,"32088",1610,1040,1019,11,21,"BNG",32
27,"27902",7150,5067,4953,74,114,"BNG",314
27,"27037",1017,759,748,10,11,"BNG",13
36,"36015",4076,2903,2834,37,69,"BNG",154
27,"27043",1219,814,797,6,17,"BNG",40
36,"36033",12244,9553,9358,80,195,"BNG",436
32,"32066",551,399,396,1,3,"BNG",3
15,"15002",24007,18075,17857,216,218,"BNG",1312
15,"15056",5648,4033,3979,39,54,"BNG",210
27,"27033",598,423,415,1,8,"BNG",34
27,"27008",1345,965,946,17,19,"BNG",35
15,"15055",4485,3097,3057,39,40,"BNG",226
36,"36017",17419,12867,12610,120,257,"BNG",845
15,"15058",28606,22203,22022,261,181,"BNG",1047
36,"36048",5244,3859,3786,33,73,"BNG",408
32,"32051",1407,1158,1153,12,5,"BNG",30
27,"27011",2358,1582,1558,12,24,"BNG",98
27,"27010",4402,3015,2940,49,75,"BNG",188
32,"32026",2659,1988,1957,26,31,"BNG",54
15,"15062",5652,3803,3728,25,75,"BNG",325
32,"32091",1703,1312,1306,4,6,"BNG",40
15,"15021",5244,3884,3806,70,78,"BNG",234
32,"32048",864,550,544,1,6,"BNG",46
36,"36057",238171,181891,180030,1636,1861,"BNG",7146
32,"32003",889,667,654,3,13,"BNG",22
15,"15031",23779,17963,17787,213,176,"BNG",922
27,"27002",1546,1136,1103,9,33,"BNG",56
15,"15035",11208,8175,8068,105,107,"BNG",829
27,"27005",2551,1908,1868,26,40,"BNG",221
32,"32074",993,737,734,4,3,"BNG",20
36,"36013",2242,1468,1452,15,16,"BNG",71
32,"32077",1104,820,815,10,5,"BNG",32
36,"36045",24478,18627,18327,157,300,"BNG",991
32,"32040",1418,1083,1075,3,8,"BNG",44
32,"32056",1520,1125,1116,6,9,"BNG",5
36,"36008",21884,16428,16170,165,258,"BNG",1171
36,"36031",562,455,450,2,5,"BNG",61
15,"15053",7548,5364,5309,44,55,"BNG",453
15,"15902",4522,3220,3159,47,61,"BNG",146
36,"36022",9061,6640,6482,47,158,"BNG",470
15,"15074",3919,2865,2808,33,57,"BNG",157
32,"32001",5105,3760,3715,37,45,"BNG",794
15,"15008",5631,4320,4267,64,53,"BNG",199
36,"36035",14571,11096,10917,105,179,"BNG",348
15,"15038",2123,1441,1413,25,28,"BNG",103
15,"15036",56248,40194,39764,508,430,"BNG",1870
32,"32002",2022,1510,1485,8,25,"BNG",38
36,"36041",13621,10098,9939,97,159,"BNG",563
27,"27901",2275,1542,1531,27,11,"BNG",45
15,"15078",78678,60510,59882,621,628,"BNG",5277
27,"27065",12076,8393,8183,128,210,"BNG",346
27,"27042",1648,1247,1233,21,14,"BNG",24
36,"36042",18072,13314,13091,130,223,"BNG",804
15,"15083",1036,784,768,7,16,"BNG",60
15,"15069",6588,4914,4830,58,84,"BNG",422
27,"27060",2463,1695,1669,12,26,"BNG",94
27,"27003",1772,1271,1241,6,30,"BNG",47
32,"32086",2563,1699,1686,19,13,"BNG",136
15,"15011",15481,11249,11037,105,212,"BNG",816
27,"27018",3232,2114,2089,24,25,"C 21",0
27,"27059",2055,1508,1471,13,37,"C 21",0
27,"27027",1806,1392,1354,18,38,"C 21",1
27,"27015",4020,2809,2730,33,79,"C 21",0
27,"27038",923,688,677,12,11,"C 21",0
27,"27044",2719,1848,1797,29,51,"C 21",0
27,"27054",1145,907,890,5,17,"C 21",0
27,"27023",2470,1833,1797,20,36,"C 21",2
27,"27060",2463,1695,1669,12,26,"C 21",1
27,"27035",180,127,123,0,4,"C 21",0
27,"27001",2209,1290,1251,25,39,"C 21",0
27,"27065",12076,8393,8183,128,210,"C 21",2
27,"27048",2019,1499,1467,23,32,"C 21",2
27,"27006",2458,1713,1666,27,47,"C 21",0
27,"27026",2315,1620,1599,17,21,"C 21",0
27,"27002",1546,1136,1103,9,33,"C 21",2
27,"27046",1448,1074,1063,7,11,"C 21",0
27,"27024",1451,1122,1102,5,20,"C 21",0
27,"27007",2756,2148,2084,29,64,"C 21",0
27,"27041",2238,1640,1615,10,25,"C 21",1
27,"27017",961,667,654,1,13,"C 21",0
27,"27052",862,645,640,4,5,"C 21",0
27,"27050",2842,2100,2072,19,28,"C 21",0
27,"27058",3322,2551,2512,22,39,"C 21",1
27,"27012",1276,776,768,9,8,"C 21",0
27,"27003",1772,1271,1241,6,30,"C 21",0
27,"27016",6973,5139,5064,66,75,"C 21",1
27,"27028",78798,58316,57546,629,770,"C 21",25
27,"27055",1197,857,851,2,6,"C 21",0
27,"27063",1715,1236,1198,10,38,"C 21",0
27,"27008",1345,965,946,17,19,"C 21",0
27,"27031",15212,10826,10649,125,177,"C 21",5
27,"27037",1017,759,748,10,11,"C 21",0
27,"27005",2551,1908,1868,26,40,"C 21",0
27,"27062",584,467,466,3,1,"C 21",0
27,"27049",1342,934,921,11,13,"C 21",0
27,"27039",4430,3437,3353,53,84,"C 21",0
27,"27029",1427,1068,1047,13,21,"C 21",0
27,"27061",1016,784,763,9,21,"C 21",0
27,"27009",2022,1514,1488,17,26,"C 21",0
27,"27056",1206,896,880,9,16,"C 21",0
27,"27047",1525,1026,1008,5,18,"C 21",0
27,"27020",3380,2764,2713,32,51,"C 21",0
27,"27011",2358,1582,1558,12,24,"C 21",3
27,"27030",3134,2209,2162,27,47,"C 21",0
27,"27053",501,384,373,1,11,"C 21",1
27,"27045",944,700,698,13,2,"C 21",0
27,"27043",1219,814,797,6,17,"C 21",0
27,"27032",3194,2268,2223,20,45,"C 21",0
27,"27021",1649,1080,1048,14,32,"C 21",0
27,"27025",2743,2191,2138,31,53,"C 21",0
27,"27901",2275,1542,1531,27,11,"C 21",0
27,"27057",11097,7917,7735,88,182,"C 21",1
27,"27033",598,423,415,1,8,"C 21",0
27,"27034",1025,647,636,4,11,"C 21",0
27,"27042",1648,1247,1233,21,14,"C 21",0
27,"27022",4683,3131,3059,30,72,"C 21",4
27,"27010",4402,3015,2940,49,75,"C 21",0
27,"27066",12633,9139,8911,84,228,"C 21",5
27,"27902",7150,5067,4953,74,114,"C 21",2
27,"27051",8012,5936,5832,70,104,"C 21",3
27,"27040",3035,2285,2234,19,51,"C 21",0
27,"27014",3162,2181,2139,17,42,"C 21",1
27,"27013",3684,2997,2935,26,62,"C 21",1
27,"27019",8189,6148,6039,94,109,"C 21",3
27,"27064",1503,1078,1039,12,39,"C 21",2
27,"27004",1149,741,722,2,19,"C 21",0
38,"38009",4299,3105,3069,16,36,"CCa-PNC",548
38,"38007",1625,1124,1104,2,20,"CCa-PNC",149
38,"38025",7088,5166,5089,39,77,"CCa-PNC",961
35,"35001",4571,3523,3463,8,60,"CCa-PNC",148
35,"35020",5933,4140,4088,14,52,"CCa-PNC",452
35,"35031",7412,5593,5519,41,74,"CCa-PNC",441
38,"38039",11112,8233,8161,54,72,"CCa-PNC",2159
38,"38030",1945,1430,1420,6,10,"CCa-PNC",396
35,"35028",10044,6188,6105,52,83,"CCa-PNC",541
38,"38016",1178,654,648,6,6,"CCa-PNC",117
38,"38008",5658,4126,4056,19,70,"CCa-PNC",895
35,"35029",4357,2869,2832,32,37,"CCa-PNC",733
35,"35014",11908,7101,6947,63,154,"CCa-PNC",601
38,"38001",20907,12323,12197,70,126,"CCa-PNC",1602
38,"38051",7326,5418,5352,27,66,"CCa-PNC",1476
38,"38031",29154,22871,22598,143,273,"CCa-PNC",4072
35,"35015",10728,6233,6108,54,125,"CCa-PNC",892
38,"38027",5545,3937,3896,22,41,"CCa-PNC",1228
38,"38041",6970,5288,5258,38,30,"CCa-PNC",1796
38,"38017",30646,18576,18373,100,203,"CCa-PNC",3441
38,"38036",6831,4947,4829,58,118,"CCa-PNC",924
38,"38011",21563,15380,15214,69,166,"CCa-PNC",2349
38,"38037",12803,8628,8517,48,111,"CCa-PNC",1336
38,"38048",3957,2889,2842,12,47,"CCa-PNC",689
38,"38010",3974,2814,2777,20,37,"CCa-PNC",368
38,"38045",3549,2149,2109,6,40,"CCa-PNC",419
35,"35030",9949,6611,6462,65,149,"CCa-PNC",1063
35,"35013",6584,5067,4974,49,93,"CCa-PNC",274
38,"38026",33514,26298,26076,191,222,"CCa-PNC",9003
35,"35032",3348,2585,2542,20,43,"CCa-PNC",104
35,"35005",1017,751,743,1,8,"CCa-PNC",15
38,"38038",164468,112475,111577,728,898,"CCa-PNC",18171
38,"38012",2310,1705,1687,6,18,"CCa-PNC",378
35,"35016",300503,203470,201240,1598,2230,"CCa-PNC",6890
35,"35010",3797,2601,2572,9,29,"CCa-PNC",592
38,"38040",5446,3513,3462,13,51,"CCa-PNC",686
38,"38018",4455,3242,3198,24,44,"CCa-PNC",1052
38,"38021",1599,1079,1057,8,22,"CCa-PNC",248
38,"38042",3781,2799,2774,11,25,"CCa-PNC",424
38,"38028",22035,15684,15522,86,162,"CCa-PNC",2181
35,"35022",51302,33009,32566,198,443,"CCa-PNC",1430
38,"38053",3763,2628,2588,21,40,"CCa-PNC",648
38,"38046",9271,7297,7212,53,85,"CCa-PNC",1518
38,"38003",1510,1058,1047,4,11,"CCa-PNC",135
35,"35018",13056,8699,8618,73,81,"CCa-PNC",936
38,"38002",972,678,640,3,38,"CCa-PNC",135
38,"38033",3594,2512,2467,11,45,"CCa-PNC",421
38,"38029",1493,839,823,5,16,"CCa-PNC",116
35,"35033",6403,4565,4502,34,63,"CCa-PNC",315
38,"38035",10384,6657,6596,50,61,"CCa-PNC",1527
35,"35034",8396,4599,4546,55,53,"CCa-PNC",528
38,"38004",4490,3242,3202,18,40,"CCa-PNC",639
35,"35004",41728,23957,23683,219,274,"CCa-PNC",2753
38,"38034",3998,3033,2993,19,40,"CCa-PNC",875
38,"38006",41302,23632,23415,133,217,"CCa-PNC",3361
38,"38047",1756,1276,1259,6,17,"CCa-PNC",344
38,"38052",1280,893,887,4,6,"CCa-PNC",210
35,"35024",14243,9496,9394,65,102,"CCa-PNC",1606
35,"35006",31309,23434,23019,221,415,"CCa-PNC",1580
35,"35003",5582,3441,3391,26,50,"CCa-PNC",342
35,"35012",10765,6327,6270,32,57,"CCa-PNC",675
38,"38043",19265,14000,13856,115,144,"CCa-PNC",3093
38,"38015",4067,2951,2926,22,25,"CCa-PNC",1111
38,"38044",2199,1443,1429,10,14,"CCa-PNC",405
35,"35007",518,405,401,0,4,"CCa-PNC",102
38,"38022",18629,12903,12759,84,144,"CCa-PNC",3756
38,"38049",2683,1781,1743,18,38,"CCa-PNC",333
35,"35023",11694,8785,8607,67,178,"CCa-PNC",631
38,"38019",13758,8870,8776,46,94,"CCa-PNC",1744
35,"35009",20109,15017,14803,78,214,"CCa-PNC",777
35,"35002",24129,16979,16736,116,243,"CCa-PNC",1042
38,"38020",15899,11057,10924,90,133,"CCa-PNC",2484
35,"35011",24705,17099,16823,129,276,"CCa-PNC",1362
35,"35027",10499,7651,7530,57,121,"CCa-PNC",474
35,"35017",27216,17531,17102,133,429,"CCa-PNC",1588
38,"38013",3019,2023,1991,12,32,"CCa-PNC",421
38,"38024",15310,10234,10088,82,146,"CCa-PNC",1924
35,"35026",82764,55647,54846,499,801,"CCa-PNC",3792
35,"35021",15014,10909,10792,71,117,"CCa-PNC",416
38,"38014",1341,991,981,6,10,"CCa-PNC",322
38,"38901",1456,1024,1010,9,14,"CCa-PNC",255
35,"35019",32841,21136,20850,125,286,"CCa-PNC",1252
38,"38050",2436,1564,1529,12,35,"CCa-PNC",290
38,"38023",125528,88323,87456,598,867,"CCa-PNC",16834
35,"35008",6207,4733,4654,42,79,"CCa-PNC",381
38,"38032",13536,9924,9867,63,57,"CCa-PNC",1574
35,"35025",1773,1247,1235,9,12,"CCa-PNC",47
38,"38005",5666,3795,3761,24,34,"CCa-PNC",897
40,"40186",34,29,29,0,0,"centrados",0
40,"40124",234,175,168,3,7,"centrados",0
40,"40224",19,16,16,0,0,"centrados",0
40,"40127",35,28,28,0,0,"centrados",0
40,"40198",24,20,20,0,0,"centrados",0
40,"40225",1098,902,882,4,20,"centrados",5
40,"40203",958,801,788,6,13,"centrados",8
40,"40194",39191,31175,30785,250,390,"centrados",211
40,"40176",375,325,322,6,3,"centrados",0
40,"40128",122,95,93,2,2,"centrados",0
40,"40122",525,442,434,2,8,"centrados",1
40,"40092",113,86,84,2,2,"centrados",0
40,"40202",55,38,38,0,0,"centrados",0
40,"40061",65,50,48,2,2,"centrados",0
40,"40047",32,25,25,0,0,"centrados",0
40,"40083",72,53,51,3,2,"centrados",3
40,"40191",204,166,165,1,1,"centrados",0
40,"40211",69,58,58,1,0,"centrados",0
40,"40028",105,96,96,1,0,"centrados",0
40,"40010",111,95,94,0,1,"centrados",0
40,"40123",141,108,104,1,4,"centrados",0
40,"40210",98,70,70,0,0,"centrados",0
40,"40082",106,83,81,0,2,"centrados",0
40,"40049",40,30,29,0,1,"centrados",0
40,"40081",119,96,95,2,1,"centrados",0
40,"40030",428,357,350,3,7,"centrados",0
40,"40158",15,13,13,1,0,"centrados",0
40,"40159",132,101,101,0,0,"centrados",2
40,"40157",43,33,33,2,0,"centrados",0
40,"40091",108,93,93,1,0,"centrados",0
40,"40200",38,32,31,0,1,"centrados",0
40,"40155",3835,3165,3121,43,44,"centrados",31
40,"40151",43,32,32,0,0,"centrados",0
40,"40165",74,56,54,1,2,"centrados",0
40,"40099",52,46,44,0,2,"centrados",0
40,"40033",67,57,57,1,0,"centrados",0
40,"40161",35,28,26,0,2,"centrados",0
40,"40060",68,46,46,0,0,"centrados",0
40,"40144",18,16,16,0,0,"centrados",0
40,"40016",54,43,43,1,0,"centrados",0
40,"40003",121,91,89,1,2,"centrados",0
40,"40130",128,102,96,0,6,"centrados",1
40,"40013",56,47,47,0,0,"centrados",0
40,"40181",4166,3405,3337,21,68,"centrados",20
40,"40113",408,339,335,6,4,"centrados",1
40,"40192",133,104,102,2,2,"centrados",0
40,"40036",502,413,406,11,7,"centrados",3
40,"40053",83,62,62,1,0,"centrados",0
40,"40072",224,198,194,3,4,"centrados",5
40,"40162",387,286,278,3,8,"centrados",2
40,"40112",2772,2255,2223,21,32,"centrados",12
40,"40095",464,379,369,2,10,"centrados",1
40,"40017",84,74,71,2,3,"centrados",1
40,"40084",53,40,39,0,1,"centrados",0
40,"40109",72,59,54,1,5,"centrados",0
40,"40037",34,19,19,0,0,"centrados",0
40,"40075",153,128,127,0,1,"centrados",0
40,"40019",29,26,26,0,0,"centrados",0
40,"40120",196,176,169,0,7,"centrados",1
40,"40014",56,44,43,2,1,"centrados",0
40,"40097",125,96,95,1,1,"centrados",0
40,"40149",486,383,376,3,7,"centrados",0
40,"40205",229,185,180,1,5,"centrados",0
40,"40077",932,747,730,9,17,"centrados",5
40,"40089",214,176,170,1,6,"centrados",0
40,"40230",95,70,67,0,3,"centrados",0
40,"40108",110,91,90,0,1,"centrados",0
40,"40135",269,224,221,1,3,"centrados",0
40,"40901",414,331,328,8,3,"centrados",2
40,"40213",95,83,80,1,3,"centrados",1
40,"40005",25,21,21,0,0,"centrados",0
40,"40902",117,96,96,1,0,"centrados",0
40,"40193",221,163,161,5,2,"centrados",0
40,"40118",47,38,37,2,1,"centrados",0
40,"40222",163,143,142,1,1,"centrados",0
40,"40008",45,37,37,0,0,"centrados",0
40,"40044",139,105,103,2,2,"centrados",0
40,"40048",35,29,29,0,0,"centrados",0
40,"40071",43,37,31,0,6,"centrados",0
40,"40177",140,114,113,1,1,"centrados",0
40,"40215",83,69,69,0,0,"centrados",0
40,"40166",253,214,213,1,1,"centrados",0
40,"40134",697,560,548,7,12,"centrados",11
40,"40223",228,181,181,0,0,"centrados",0
40,"40168",28,22,22,0,0,"centrados",0
40,"40201",43,39,37,0,2,"centrados",0
40,"40004",445,348,341,0,7,"centrados",3
40,"40069",74,65,65,0,0,"centrados",0
40,"40212",27,22,20,0,2,"centrados",0
40,"40228",494,397,391,5,6,"centrados",1
40,"40138",2127,1729,1696,18,33,"centrados",9
40,"40006",22,18,18,0,0,"centrados",0
40,"40110",316,254,253,2,1,"centrados",0
40,"40234",376,307,299,2,8,"centrados",0
40,"40034",75,63,62,1,1,"centrados",0
40,"40029",24,21,21,0,0,"centrados",0
40,"40129",164,129,128,2,1,"centrados",0
40,"40062",57,49,49,0,0,"centrados",0
40,"40015",24,24,24,1,0,"centrados",0
40,"40142",52,42,40,0,2,"centrados",0
40,"40906",2131,1830,1814,10,16,"centrados",16
40,"40020",155,125,119,4,6,"centrados",0
40,"40141",833,644,627,5,17,"centrados",4
40,"40170",1307,1066,1054,7,12,"centrados",2
40,"40057",1405,1176,1163,10,13,"centrados",0
40,"40903",77,63,62,0,1,"centrados",0
40,"40195",813,630,623,5,7,"centrados",0
40,"40173",142,122,117,1,5,"centrados",0
40,"40101",923,737,728,8,9,"centrados",4
40,"40055",32,26,25,0,1,"centrados",0
40,"40156",281,223,222,1,1,"centrados",1
40,"40145",1105,906,899,2,7,"centrados",3
40,"40233",396,323,320,2,3,"centrados",2
40,"40188",83,71,71,0,0,"centrados",0
40,"40105",44,39,38,0,1,"centrados",0
40,"40022",193,162,159,2,3,"centrados",0
40,"40219",565,451,432,2,19,"centrados",1
40,"40184",248,205,203,0,2,"centrados",1
40,"40221",48,42,42,0,0,"centrados",0
40,"40100",263,219,215,1,4,"centrados",0
40,"40179",626,540,529,2,11,"centrados",3
40,"40905",128,101,100,4,1,"centrados",0
40,"40140",79,58,58,0,0,"centrados",0
40,"40051",34,33,31,0,2,"centrados",0
40,"40207",800,662,652,6,10,"centrados",4
40,"40052",72,56,56,0,0,"centrados",0
40,"40058",309,277,271,0,6,"centrados",0
40,"40025",128,109,106,1,3,"centrados",0
40,"40229",28,24,24,0,0,"centrados",0
40,"40026",113,106,105,2,1,"centrados",0
40,"40171",39,29,29,1,0,"centrados",0
40,"40107",92,76,74,0,2,"centrados",0
40,"40074",245,219,214,5,5,"centrados",0
40,"40103",146,125,123,0,2,"centrados",0
40,"40111",52,44,44,0,0,"centrados",1
40,"40073",385,339,335,6,4,"centrados",0
40,"40063",6944,5479,5352,39,127,"centrados",21
40,"40056",32,21,21,0,0,"centrados",0
40,"40136",106,82,81,0,1,"centrados",0
40,"40121",249,196,193,4,3,"centrados",0
40,"40132",46,32,31,1,1,"centrados",0
40,"40174",324,254,250,2,4,"centrados",0
40,"40904",341,302,300,4,2,"centrados",1
40,"40218",84,62,62,0,0,"centrados",0
40,"40031",540,429,424,6,5,"centrados",2
40,"40115",156,131,130,4,1,"centrados",0
40,"40154",23,20,20,0,0,"centrados",0
40,"40163",41,38,38,0,0,"centrados",0
40,"40196",32,28,28,1,0,"centrados",0
40,"40216",774,670,665,11,5,"centrados",3
40,"40079",226,179,175,1,4,"centrados",0
40,"40024",827,657,645,4,12,"centrados",0
40,"40041",967,773,764,9,9,"centrados",4
40,"40172",45,37,37,0,0,"centrados",0
40,"40180",277,231,224,3,7,"centrados",1
40,"40204",151,109,104,1,5,"centrados",0
40,"40214",196,167,163,1,4,"centrados",0
40,"40009",40,34,34,0,0,"centrados",0
40,"40190",48,40,39,0,1,"centrados",0
40,"40185",815,624,618,4,6,"centrados",0
40,"40007",68,58,58,0,0,"centrados",0
40,"40199",101,79,78,0,1,"centrados",0
40,"40086",660,570,548,3,22,"centrados",1
40,"40139",258,207,202,0,5,"centrados",1
40,"40080",48,39,39,0,0,"centrados",0
40,"40040",2495,1913,1895,20,18,"centrados",2
40,"40035",135,111,110,0,1,"centrados",2
40,"40021",19,18,18,0,0,"centrados",1
40,"40150",61,53,53,1,0,"centrados",1
40,"40002",34,30,30,0,0,"centrados",0
40,"40046",82,69,69,1,0,"centrados",0
40,"40076",6537,5130,5012,22,118,"centrados",11
40,"40070",148,110,107,1,3,"centrados",0
40,"40043",1791,1472,1447,9,25,"centrados",12
40,"40032",378,287,278,1,9,"centrados",0
40,"40054",107,91,88,0,3,"centrados",0
40,"40220",62,48,48,0,0,"centrados",0
40,"40152",748,637,620,6,17,"centrados",4
40,"40183",116,103,103,0,0,"centrados",0
40,"40078",151,123,122,2,1,"centrados",0
40,"40143",83,73,73,2,0,"centrados",0
40,"40065",469,376,373,1,3,"centrados",0
40,"40148",228,185,180,0,5,"centrados",0
40,"40039",180,147,144,1,3,"centrados",0
40,"40104",284,229,224,2,5,"centrados",0
40,"40001",706,597,590,7,7,"centrados",1
40,"40164",185,136,134,3,2,"centrados",0
40,"40093",76,68,67,0,1,"centrados",0
40,"40126",67,53,51,0,2,"centrados",0
40,"40087",87,70,70,0,0,"centrados",0
40,"40045",120,92,92,1,0,"centrados",0
40,"40018",75,60,60,0,0,"centrados",0
40,"40088",268,200,200,0,0,"centrados",0
40,"40119",166,133,132,1,1,"centrados",1
40,"40059",108,90,89,0,1,"centrados",1
40,"40146",238,205,202,0,3,"centrados",1
40,"40182",173,126,124,1,2,"centrados",2
40,"40125",75,61,61,2,0,"centrados",1
40,"40189",479,392,380,2,12,"centrados",0
40,"40208",720,592,585,4,7,"centrados",0
40,"40106",183,153,151,2,2,"centrados",0
40,"40206",162,132,128,2,4,"centrados",1
40,"40068",22,21,21,0,0,"centrados",0
40,"40160",93,72,72,0,0,"centrados",0
40,"40178",90,63,63,1,0,"centrados",1
40,"40012",238,178,175,4,3,"centrados",0
40,"40131",50,47,47,0,0,"centrados",0
40,"40094",364,284,279,1,5,"centrados",0
40,"40231",98,80,80,2,0,"centrados",0
6,"6075",475,379,369,2,10,"C.Ex-C.R.Ex",0
10,"10063",161,141,141,1,0,"C.Ex-C.R.Ex",0
6,"6102",1019,852,842,2,10,"C.Ex-C.R.Ex",1
10,"10078",370,289,278,4,11,"C.Ex-C.R.Ex",1
6,"6146",1048,837,819,4,18,"C.Ex-C.R.Ex",0
10,"10199",159,123,123,1,0,"C.Ex-C.R.Ex",3
6,"6124",1656,1323,1296,5,27,"C.Ex-C.R.Ex",7
10,"10010",2213,1499,1470,6,29,"C.Ex-C.R.Ex",7
6,"6091",3668,2839,2776,26,63,"C.Ex-C.R.Ex",2
6,"6017",257,211,210,1,1,"C.Ex-C.R.Ex",0
6,"6901",2117,1686,1655,17,31,"C.Ex-C.R.Ex",3
10,"10186",944,781,758,1,23,"C.Ex-C.R.Ex",1
6,"6157",397,296,292,1,4,"C.Ex-C.R.Ex",1
10,"10056",532,434,428,3,6,"C.Ex-C.R.Ex",0
10,"10092",266,216,211,18,5,"C.Ex-C.R.Ex",1
6,"6117",1401,1089,1067,6,22,"C.Ex-C.R.Ex",1
6,"6135",1096,915,902,3,13,"C.Ex-C.R.Ex",0
10,"10091",350,293,291,1,2,"C.Ex-C.R.Ex",1
6,"6119",681,551,547,1,4,"C.Ex-C.R.Ex",3
10,"10084",1294,899,869,5,30,"C.Ex-C.R.Ex",3
10,"10085",319,240,236,1,4,"C.Ex-C.R.Ex",1
10,"10154",177,134,133,1,1,"C.Ex-C.R.Ex",0
10,"10125",862,655,639,4,16,"C.Ex-C.R.Ex",0
6,"6062",576,435,430,0,5,"C.Ex-C.R.Ex",1
6,"6110",137,106,105,0,1,"C.Ex-C.R.Ex",0
6,"6151",1054,791,778,2,13,"C.Ex-C.R.Ex",5
6,"6150",780,637,635,2,2,"C.Ex-C.R.Ex",2
10,"10132",365,276,271,2,5,"C.Ex-C.R.Ex",0
10,"10034",336,269,267,0,2,"C.Ex-C.R.Ex",0
6,"6083",46489,34360,33989,270,371,"C.Ex-C.R.Ex",88
10,"10016",327,260,259,1,1,"C.Ex-C.R.Ex",4
10,"10116",3728,2849,2776,27,73,"C.Ex-C.R.Ex",12
6,"6132",829,598,593,0,5,"C.Ex-C.R.Ex",2
6,"6022",2634,2156,2112,7,44,"C.Ex-C.R.Ex",43
6,"6063",2938,2299,2264,11,35,"C.Ex-C.R.Ex",2
10,"10044",1404,1092,1077,7,15,"C.Ex-C.R.Ex",2
6,"6113",2677,2117,2076,13,41,"C.Ex-C.R.Ex",3
6,"6149",10203,8194,8051,72,143,"C.Ex-C.R.Ex",16
10,"10003",540,388,386,4,2,"C.Ex-C.R.Ex",0
6,"6033",1269,1026,1010,4,16,"C.Ex-C.R.Ex",0
6,"6096",207,168,167,1,1,"C.Ex-C.R.Ex",0
6,"6058",1980,1519,1493,13,26,"C.Ex-C.R.Ex",4
10,"10020",1576,1259,1225,9,34,"C.Ex-C.R.Ex",1
10,"10031",164,136,135,0,1,"C.Ex-C.R.Ex",3
6,"6018",740,543,536,5,7,"C.Ex-C.R.Ex",0
6,"6099",1162,833,813,6,20,"C.Ex-C.R.Ex",1
10,"10219",1212,814,806,8,8,"C.Ex-C.R.Ex",3
10,"10015",627,488,475,0,13,"C.Ex-C.R.Ex",0
10,"10127",4706,3508,3423,23,85,"C.Ex-C.R.Ex",17
6,"6118",157,125,125,1,0,"C.Ex-C.R.Ex",0
6,"6020",1739,1420,1387,5,33,"C.Ex-C.R.Ex",3
10,"10142",840,641,639,5,2,"C.Ex-C.R.Ex",0
10,"10904",722,549,543,7,6,"C.Ex-C.R.Ex",3
10,"10071",124,85,84,0,1,"C.Ex-C.R.Ex",0
6,"6010",1075,859,846,8,13,"C.Ex-C.R.Ex",2
10,"10064",1409,1103,1072,6,31,"C.Ex-C.R.Ex",1
6,"6013",265,227,221,0,6,"C.Ex-C.R.Ex",1
10,"10148",32986,23987,23589,201,398,"C.Ex-C.R.Ex",132
6,"6076",824,631,620,0,11,"C.Ex-C.R.Ex",0
6,"6039",1807,1506,1474,13,32,"C.Ex-C.R.Ex",2
10,"10153",283,204,199,0,5,"C.Ex-C.R.Ex",0
10,"10019",1416,1120,1094,3,26,"C.Ex-C.R.Ex",5
6,"6065",298,258,255,1,3,"C.Ex-C.R.Ex",0
6,"6148",957,762,746,12,16,"C.Ex-C.R.Ex",2
10,"10206",201,146,144,1,2,"C.Ex-C.R.Ex",0
10,"10039",402,302,301,0,1,"C.Ex-C.R.Ex",1
10,"10146",1513,1128,1104,6,24,"C.Ex-C.R.Ex",3
6,"6036",4958,3785,3728,22,57,"C.Ex-C.R.Ex",1
10,"10905",632,491,485,4,6,"C.Ex-C.R.Ex",2
6,"6055",1998,1552,1523,9,29,"C.Ex-C.R.Ex",2
6,"6051",1543,1206,1188,3,18,"C.Ex-C.R.Ex",0
6,"6074",4755,3719,3638,27,81,"C.Ex-C.R.Ex",15
10,"10030",472,323,318,1,5,"C.Ex-C.R.Ex",1
10,"10205",1965,1344,1300,8,44,"C.Ex-C.R.Ex",4
6,"6140",611,515,506,1,9,"C.Ex-C.R.Ex",0
10,"10012",564,469,464,1,5,"C.Ex-C.R.Ex",1
6,"6085",3410,2719,2663,28,56,"C.Ex-C.R.Ex",2
10,"10068",711,576,556,2,20,"C.Ex-C.R.Ex",2
10,"10118",281,242,242,2,0,"C.Ex-C.R.Ex",0
10,"10097",106,88,85,3,3,"C.Ex-C.R.Ex",6
6,"6902",1663,1273,1252,4,21,"C.Ex-C.R.Ex",3
10,"10126",1470,1114,1104,7,10,"C.Ex-C.R.Ex",2
10,"10113",2258,1695,1657,6,38,"C.Ex-C.R.Ex",10
6,"6152",1285,952,935,4,17,"C.Ex-C.R.Ex",2
10,"10193",1412,1158,1145,4,13,"C.Ex-C.R.Ex",4
6,"6030",169,147,146,1,1,"C.Ex-C.R.Ex",0
10,"10185",573,463,460,3,3,"C.Ex-C.R.Ex",0
10,"10083",96,74,73,0,1,"C.Ex-C.R.Ex",0
10,"10178",729,567,559,4,8,"C.Ex-C.R.Ex",10
6,"6042",981,714,705,4,9,"C.Ex-C.R.Ex",0
6,"6129",573,455,451,2,4,"C.Ex-C.R.Ex",2
10,"10051",433,338,332,0,6,"C.Ex-C.R.Ex",6
10,"10901",1177,818,805,1,13,"C.Ex-C.R.Ex",5
10,"10175",1361,1031,997,8,34,"C.Ex-C.R.Ex",1
6,"6025",5096,3981,3904,28,77,"C.Ex-C.R.Ex",9
6,"6090",824,602,578,4,24,"C.Ex-C.R.Ex",2
6,"6131",1063,880,874,5,6,"C.Ex-C.R.Ex",1
10,"10159",317,241,240,0,1,"C.Ex-C.R.Ex",1
10,"10190",521,372,361,2,11,"C.Ex-C.R.Ex",1
10,"10204",419,342,339,4,3,"C.Ex-C.R.Ex",1
10,"10017",772,595,591,3,4,"C.Ex-C.R.Ex",0
10,"10093",393,313,303,4,10,"C.Ex-C.R.Ex",2
6,"6047",837,677,669,6,8,"C.Ex-C.R.Ex",1
6,"6066",1725,1297,1286,9,11,"C.Ex-C.R.Ex",0
10,"10026",656,515,507,8,8,"C.Ex-C.R.Ex",11
10,"10105",2476,1798,1760,21,38,"C.Ex-C.R.Ex",7
6,"6068",431,324,317,4,7,"C.Ex-C.R.Ex",0
10,"10173",558,445,439,0,6,"C.Ex-C.R.Ex",93
10,"10124",858,710,701,3,9,"C.Ex-C.R.Ex",3
10,"10043",754,578,572,3,6,"C.Ex-C.R.Ex",1
10,"10138",540,422,415,3,7,"C.Ex-C.R.Ex",1
10,"10156",100,78,78,0,0,"C.Ex-C.R.Ex",0
10,"10102",503,407,403,3,4,"C.Ex-C.R.Ex",1
10,"10001",283,233,232,3,1,"C.Ex-C.R.Ex",0
10,"10177",1695,1358,1323,9,35,"C.Ex-C.R.Ex",3
10,"10179",277,220,219,0,1,"C.Ex-C.R.Ex",0
6,"6049",974,732,712,7,20,"C.Ex-C.R.Ex",19
6,"6120",3373,2757,2719,10,38,"C.Ex-C.R.Ex",5
10,"10069",785,609,596,2,13,"C.Ex-C.R.Ex",0
6,"6098",534,421,411,8,10,"C.Ex-C.R.Ex",0
10,"10098",381,310,309,1,1,"C.Ex-C.R.Ex",0
10,"10121",7914,5924,5809,36,115,"C.Ex-C.R.Ex",16
10,"10004",690,529,517,8,12,"C.Ex-C.R.Ex",0
10,"10208",121,94,94,2,0,"C.Ex-C.R.Ex",0
6,"6056",454,378,376,1,2,"C.Ex-C.R.Ex",0
10,"10086",303,249,244,3,5,"C.Ex-C.R.Ex",2
10,"10108",203,131,130,1,1,"C.Ex-C.R.Ex",1
6,"6004",1549,1276,1257,6,19,"C.Ex-C.R.Ex",0
10,"10112",1518,1168,1151,4,17,"C.Ex-C.R.Ex",5
6,"6079",644,492,487,3,5,"C.Ex-C.R.Ex",0
10,"10215",413,305,301,2,4,"C.Ex-C.R.Ex",0
6,"6026",815,661,653,5,8,"C.Ex-C.R.Ex",1
10,"10165",253,212,210,1,2,"C.Ex-C.R.Ex",0
6,"6080",1890,1482,1467,18,15,"C.Ex-C.R.Ex",2
10,"10037",76855,60447,59702,451,745,"C.Ex-C.R.Ex",227
6,"6002",4314,3181,3086,44,95,"C.Ex-C.R.Ex",3
10,"10036",306,240,237,2,3,"C.Ex-C.R.Ex",2
10,"10123",575,470,465,2,5,"C.Ex-C.R.Ex",0
6,"6032",78,65,64,0,1,"C.Ex-C.R.Ex",0
10,"10018",1630,1149,1112,12,37,"C.Ex-C.R.Ex",4
10,"10217",521,436,432,0,4,"C.Ex-C.R.Ex",1
10,"10182",124,91,90,0,1,"C.Ex-C.R.Ex",0
6,"6095",9511,7338,7152,116,186,"C.Ex-C.R.Ex",10
6,"6073",700,506,492,11,14,"C.Ex-C.R.Ex",1
10,"10133",1154,971,955,3,16,"C.Ex-C.R.Ex",1
6,"6031",461,316,301,1,15,"C.Ex-C.R.Ex",1
10,"10155",1082,825,819,4,6,"C.Ex-C.R.Ex",0
6,"6040",987,747,739,6,8,"C.Ex-C.R.Ex",25
10,"10191",523,406,398,3,8,"C.Ex-C.R.Ex",0
10,"10038",83,70,69,0,1,"C.Ex-C.R.Ex",0
10,"10060",935,670,658,4,12,"C.Ex-C.R.Ex",2
10,"10218",1083,810,796,3,14,"C.Ex-C.R.Ex",4
6,"6139",502,429,421,5,8,"C.Ex-C.R.Ex",0
10,"10070",669,516,513,1,3,"C.Ex-C.R.Ex",0
10,"10053",279,226,224,5,2,"C.Ex-C.R.Ex",0
6,"6041",457,381,374,5,7,"C.Ex-C.R.Ex",2
10,"10207",464,349,340,3,9,"C.Ex-C.R.Ex",0
10,"10111",1306,1006,994,12,12,"C.Ex-C.R.Ex",39
10,"10196",294,231,231,2,0,"C.Ex-C.R.Ex",0
6,"6125",1679,1348,1324,5,24,"C.Ex-C.R.Ex",2
10,"10065",200,149,149,0,0,"C.Ex-C.R.Ex",0
10,"10183",958,748,735,3,13,"C.Ex-C.R.Ex",1
6,"6137",933,730,723,5,7,"C.Ex-C.R.Ex",2
6,"6053",590,461,444,7,17,"C.Ex-C.R.Ex",1
6,"6071",238,197,193,0,4,"C.Ex-C.R.Ex",0
10,"10162",528,430,424,2,6,"C.Ex-C.R.Ex",1
10,"10045",970,739,735,6,4,"C.Ex-C.R.Ex",0
10,"10099",559,412,401,3,11,"C.Ex-C.R.Ex",9
6,"6100",852,681,677,3,4,"C.Ex-C.R.Ex",0
6,"6057",537,442,433,1,9,"C.Ex-C.R.Ex",0
6,"6005",1691,1246,1225,15,21,"C.Ex-C.R.Ex",2
6,"6019",2012,1539,1495,14,44,"C.Ex-C.R.Ex",1
6,"6105",604,406,400,2,6,"C.Ex-C.R.Ex",0
10,"10059",325,234,232,1,2,"C.Ex-C.R.Ex",0
10,"10213",534,447,441,5,6,"C.Ex-C.R.Ex",1
10,"10023",791,619,614,1,5,"C.Ex-C.R.Ex",6
10,"10164",720,474,461,3,13,"C.Ex-C.R.Ex",1
10,"10101",179,140,138,2,2,"C.Ex-C.R.Ex",1
10,"10050",1015,831,823,2,8,"C.Ex-C.R.Ex",1
6,"6050",4042,3246,3163,27,83,"C.Ex-C.R.Ex",4
6,"6109",3843,3228,3106,26,122,"C.Ex-C.R.Ex",1
10,"10041",1025,840,825,6,15,"C.Ex-C.R.Ex",1
6,"6094",1459,1017,1008,8,9,"C.Ex-C.R.Ex",1
10,"10073",721,553,546,4,7,"C.Ex-C.R.Ex",2
10,"10029",380,320,315,1,5,"C.Ex-C.R.Ex",0
10,"10200",341,262,261,0,1,"C.Ex-C.R.Ex",0
10,"10079",858,694,684,1,10,"C.Ex-C.R.Ex",2
10,"10032",1596,1263,1243,5,20,"C.Ex-C.R.Ex",0
6,"6054",5454,4329,4190,46,139,"C.Ex-C.R.Ex",5
6,"6014",6535,4757,4679,36,78,"C.Ex-C.R.Ex",1
10,"10160",237,189,183,3,6,"C.Ex-C.R.Ex",0
10,"10002",359,284,279,2,5,"C.Ex-C.R.Ex",0
6,"6121",3268,2558,2531,26,27,"C.Ex-C.R.Ex",6
10,"10130",1747,1352,1321,12,31,"C.Ex-C.R.Ex",1
6,"6052",3969,3043,2970,21,73,"C.Ex-C.R.Ex",3
6,"6008",613,540,532,0,8,"C.Ex-C.R.Ex",0
6,"6070",7686,6083,5948,44,135,"C.Ex-C.R.Ex",16
10,"10089",1328,1014,982,20,32,"C.Ex-C.R.Ex",12
6,"6136",1510,1189,1160,7,29,"C.Ex-C.R.Ex",5
10,"10174",171,129,127,0,2,"C.Ex-C.R.Ex",0
10,"10211",447,345,343,2,2,"C.Ex-C.R.Ex",13
10,"10120",156,110,108,0,2,"C.Ex-C.R.Ex",0
6,"6159",2339,1577,1507,25,70,"C.Ex-C.R.Ex",1
6,"6103",4753,3656,3598,35,58,"C.Ex-C.R.Ex",8
10,"10139",95,78,77,1,1,"C.Ex-C.R.Ex",0
6,"6064",850,658,647,2,11,"C.Ex-C.R.Ex",3
10,"10022",412,319,316,1,3,"C.Ex-C.R.Ex",0
10,"10061",1598,1126,1114,5,12,"C.Ex-C.R.Ex",39
10,"10144",920,731,723,4,8,"C.Ex-C.R.Ex",2
6,"6115",1243,898,876,3,22,"C.Ex-C.R.Ex",1
10,"10104",5151,3862,3782,22,80,"C.Ex-C.R.Ex",23
6,"6069",3005,2172,2133,24,39,"C.Ex-C.R.Ex",5
10,"10141",289,224,223,0,1,"C.Ex-C.R.Ex",1
10,"10054",524,435,422,1,13,"C.Ex-C.R.Ex",0
10,"10136",285,223,223,1,0,"C.Ex-C.R.Ex",0
10,"10140",1082,868,855,8,13,"C.Ex-C.R.Ex",3
10,"10903",796,623,614,4,9,"C.Ex-C.R.Ex",12
6,"6112",383,334,334,1,0,"C.Ex-C.R.Ex",0
6,"6006",4494,3395,3325,24,70,"C.Ex-C.R.Ex",5
6,"6108",2249,1726,1684,22,42,"C.Ex-C.R.Ex",4
10,"10067",10245,7850,7701,80,149,"C.Ex-C.R.Ex",24
10,"10072",835,632,625,3,7,"C.Ex-C.R.Ex",1
10,"10100",783,584,566,7,18,"C.Ex-C.R.Ex",1
6,"6161",288,226,222,1,4,"C.Ex-C.R.Ex",1
10,"10088",196,139,138,0,1,"C.Ex-C.R.Ex",2
10,"10055",696,527,512,1,15,"C.Ex-C.R.Ex",1
10,"10087",1606,1239,1223,5,16,"C.Ex-C.R.Ex",2
10,"10033",403,306,302,6,4,"C.Ex-C.R.Ex",1
10,"10024",675,518,505,4,13,"C.Ex-C.R.Ex",0
6,"6087",2030,1592,1571,16,21,"C.Ex-C.R.Ex",1
6,"6162",2895,2289,2254,11,35,"C.Ex-C.R.Ex",1
10,"10119",574,458,455,0,3,"C.Ex-C.R.Ex",0
10,"10151",198,161,157,2,4,"C.Ex-C.R.Ex",0
10,"10110",2224,1618,1559,5,59,"C.Ex-C.R.Ex",9
6,"6029",1183,946,935,12,11,"C.Ex-C.R.Ex",0
10,"10210",492,362,358,3,4,"C.Ex-C.R.Ex",1
10,"10192",767,625,614,1,11,"C.Ex-C.R.Ex",0
10,"10057",126,97,96,2,1,"C.Ex-C.R.Ex",1
10,"10170",239,180,179,1,1,"C.Ex-C.R.Ex",0
10,"10052",166,124,123,0,1,"C.Ex-C.R.Ex",0
6,"6147",338,262,258,2,4,"C.Ex-C.R.Ex",0
10,"10134",553,396,392,2,4,"C.Ex-C.R.Ex",0
6,"6092",555,428,419,3,9,"C.Ex-C.R.Ex",0
6,"6078",506,415,410,1,5,"C.Ex-C.R.Ex",1
6,"6111",493,374,370,2,4,"C.Ex-C.R.Ex",0
10,"10184",740,607,597,5,10,"C.Ex-C.R.Ex",1
10,"10135",1241,995,981,5,14,"C.Ex-C.R.Ex",0
10,"10081",184,142,140,4,2,"C.Ex-C.R.Ex",1
6,"6130",186,159,154,0,5,"C.Ex-C.R.Ex",3
6,"6001",659,539,534,7,5,"C.Ex-C.R.Ex",3
6,"6067",1915,1393,1370,7,23,"C.Ex-C.R.Ex",4
6,"6027",645,572,568,0,4,"C.Ex-C.R.Ex",0
6,"6160",3019,2252,2209,10,43,"C.Ex-C.R.Ex",1
10,"10027",76,66,66,0,0,"C.Ex-C.R.Ex",0
10,"10180",4168,2735,2680,18,55,"C.Ex-C.R.Ex",7
10,"10212",1645,1283,1238,7,45,"C.Ex-C.R.Ex",6
6,"6046",1250,1010,995,7,15,"C.Ex-C.R.Ex",0
10,"10082",1810,1495,1476,9,19,"C.Ex-C.R.Ex",3
6,"6086",1174,869,862,4,7,"C.Ex-C.R.Ex",1
10,"10137",404,346,344,3,2,"C.Ex-C.R.Ex",0
10,"10181",680,548,542,2,6,"C.Ex-C.R.Ex",0
6,"6009",228,190,187,2,3,"C.Ex-C.R.Ex",0
10,"10167",307,238,237,1,1,"C.Ex-C.R.Ex",0
10,"10150",331,277,272,6,5,"C.Ex-C.R.Ex",1
6,"6028",4109,3613,3538,17,75,"C.Ex-C.R.Ex",3
10,"10075",236,186,182,1,4,"C.Ex-C.R.Ex",1
6,"6127",2809,2285,2258,13,27,"C.Ex-C.R.Ex",1
6,"6077",321,260,256,4,4,"C.Ex-C.R.Ex",0
6,"6106",413,267,263,3,4,"C.Ex-C.R.Ex",0
6,"6154",2799,2075,2022,15,53,"C.Ex-C.R.Ex",1
10,"10188",478,387,379,0,8,"C.Ex-C.R.Ex",2
10,"10028",82,60,59,0,1,"C.Ex-C.R.Ex",0
6,"6081",1042,825,811,4,14,"C.Ex-C.R.Ex",2
10,"10042",88,59,59,0,0,"C.Ex-C.R.Ex",0
6,"6088",12505,9311,9140,93,171,"C.Ex-C.R.Ex",26
6,"6107",1570,1117,1106,9,11,"C.Ex-C.R.Ex",2
6,"6007",1433,1078,1071,5,7,"C.Ex-C.R.Ex",2
10,"10007",630,513,507,4,6,"C.Ex-C.R.Ex",1
10,"10161",82,50,50,1,0,"C.Ex-C.R.Ex",1
10,"10094",228,180,180,0,0,"C.Ex-C.R.Ex",0
10,"10169",494,405,395,1,10,"C.Ex-C.R.Ex",0
10,"10201",179,157,156,1,1,"C.Ex-C.R.Ex",0
10,"10202",588,469,459,0,10,"C.Ex-C.R.Ex",2
6,"6061",1084,915,905,8,10,"C.Ex-C.R.Ex",0
6,"6144",512,422,416,1,6,"C.Ex-C.R.Ex",0
6,"6104",656,530,524,6,6,"C.Ex-C.R.Ex",1
6,"6045",476,368,362,3,6,"C.Ex-C.R.Ex",1
10,"10166",313,211,202,0,9,"C.Ex-C.R.Ex",0
10,"10008",1291,1015,997,16,18,"C.Ex-C.R.Ex",2
6,"6023",4170,3088,3045,18,43,"C.Ex-C.R.Ex",6
6,"6034",167,115,115,1,0,"C.Ex-C.R.Ex",0
10,"10117",243,156,154,1,2,"C.Ex-C.R.Ex",0
6,"6141",1688,1308,1291,16,17,"C.Ex-C.R.Ex",0
6,"6134",530,337,331,3,6,"C.Ex-C.R.Ex",1
6,"6138",1013,783,767,3,16,"C.Ex-C.R.Ex",2
10,"10014",1829,1448,1419,12,29,"C.Ex-C.R.Ex",4
6,"6145",899,744,723,1,21,"C.Ex-C.R.Ex",0
10,"10168",320,209,202,1,7,"C.Ex-C.R.Ex",0
6,"6101",442,359,354,2,5,"C.Ex-C.R.Ex",0
10,"10194",524,440,435,4,5,"C.Ex-C.R.Ex",3
10,"10122",220,171,164,0,7,"C.Ex-C.R.Ex",4
6,"6084",1065,904,890,8,14,"C.Ex-C.R.Ex",0
10,"10025",379,328,317,3,11,"C.Ex-C.R.Ex",3
6,"6043",686,553,544,6,9,"C.Ex-C.R.Ex",0
6,"6142",259,214,208,1,6,"C.Ex-C.R.Ex",1
6,"6143",3370,2635,2589,23,46,"C.Ex-C.R.Ex",2
10,"10115",3488,2878,2816,15,62,"C.Ex-C.R.Ex",14
10,"10096",3326,2553,2501,14,52,"C.Ex-C.R.Ex",6
10,"10046",187,154,152,0,2,"C.Ex-C.R.Ex",2
10,"10128",5628,4238,4126,43,112,"C.Ex-C.R.Ex",10
10,"10062",393,339,334,0,5,"C.Ex-C.R.Ex",8
6,"6012",3233,2515,2492,15,23,"C.Ex-C.R.Ex",3
6,"6128",4415,3345,3288,34,57,"C.Ex-C.R.Ex",4
10,"10035",1806,1320,1282,12,38,"C.Ex-C.R.Ex",3
10,"10090",494,364,357,6,7,"C.Ex-C.R.Ex",6
6,"6037",1668,1137,1125,6,12,"C.Ex-C.R.Ex",1
10,"10152",446,354,350,2,4,"C.Ex-C.R.Ex",1
10,"10080",360,256,246,0,10,"C.Ex-C.R.Ex",0
6,"6015",117934,87081,86114,785,967,"C.Ex-C.R.Ex",284
10,"10048",204,156,154,0,2,"C.Ex-C.R.Ex",0
6,"6059",1759,1300,1285,12,15,"C.Ex-C.R.Ex",5
10,"10077",637,501,499,3,2,"C.Ex-C.R.Ex",0
6,"6082",393,314,305,5,9,"C.Ex-C.R.Ex",0
10,"10058",993,739,723,4,16,"C.Ex-C.R.Ex",16
10,"10172",696,517,513,0,4,"C.Ex-C.R.Ex",3
10,"10157",245,185,185,1,0,"C.Ex-C.R.Ex",0
6,"6123",4512,3358,3266,28,92,"C.Ex-C.R.Ex",11
10,"10103",426,330,327,0,3,"C.Ex-C.R.Ex",0
10,"10203",4428,3212,3152,25,60,"C.Ex-C.R.Ex",14
10,"10197",108,84,84,0,0,"C.Ex-C.R.Ex",0
6,"6044",29204,21778,21492,203,286,"C.Ex-C.R.Ex",29
10,"10009",263,196,193,2,3,"C.Ex-C.R.Ex",0
10,"10040",434,321,314,1,7,"C.Ex-C.R.Ex",1
10,"10013",266,203,202,2,1,"C.Ex-C.R.Ex",0
6,"6021",908,708,698,9,10,"C.Ex-C.R.Ex",1
6,"6903",2027,1607,1594,16,13,"C.Ex-C.R.Ex",2
10,"10176",347,266,261,2,5,"C.Ex-C.R.Ex",0
10,"10011",532,439,435,3,4,"C.Ex-C.R.Ex",2
6,"6116",1512,1158,1144,3,14,"C.Ex-C.R.Ex",1
10,"10106",127,108,106,0,2,"C.Ex-C.R.Ex",1
10,"10076",793,597,585,4,12,"C.Ex-C.R.Ex",1
6,"6093",4345,3356,3281,18,75,"C.Ex-C.R.Ex",5
6,"6126",2142,1619,1594,9,25,"C.Ex-C.R.Ex",1
6,"6011",24665,18486,18253,178,233,"C.Ex-C.R.Ex",40
10,"10005",530,407,384,3,23,"C.Ex-C.R.Ex",3
10,"10109",1730,1208,1181,12,27,"C.Ex-C.R.Ex",2
10,"10209",265,184,184,2,0,"C.Ex-C.R.Ex",1
10,"10129",348,263,250,0,13,"C.Ex-C.R.Ex",1
10,"10107",1030,840,828,5,12,"C.Ex-C.R.Ex",0
10,"10047",937,772,760,3,12,"C.Ex-C.R.Ex",39
10,"10158",337,269,267,0,2,"C.Ex-C.R.Ex",0
10,"10902",735,537,521,2,16,"C.Ex-C.R.Ex",0
10,"10143",141,118,113,1,5,"C.Ex-C.R.Ex",0
6,"6035",865,678,670,4,8,"C.Ex-C.R.Ex",0
10,"10131",12808,9377,9254,67,123,"C.Ex-C.R.Ex",104
6,"6089",608,524,519,3,5,"C.Ex-C.R.Ex",0
6,"6133",1799,1476,1453,12,23,"C.Ex-C.R.Ex",1
6,"6114",127,109,108,0,1,"C.Ex-C.R.Ex",0
10,"10187",430,316,311,0,5,"C.Ex-C.R.Ex",7
6,"6048",824,714,702,2,12,"C.Ex-C.R.Ex",0
6,"6072",2225,1777,1752,20,25,"C.Ex-C.R.Ex",0
6,"6016",2943,2283,2247,24,36,"C.Ex-C.R.Ex",5
6,"6156",1171,919,901,10,18,"C.Ex-C.R.Ex",0
6,"6122",6562,4837,4723,43,114,"C.Ex-C.R.Ex",10
10,"10066",161,141,137,0,4,"C.Ex-C.R.Ex",0
6,"6097",2283,1803,1762,10,41,"C.Ex-C.R.Ex",2
10,"10163",339,275,269,0,6,"C.Ex-C.R.Ex",0
10,"10171",355,261,255,0,6,"C.Ex-C.R.Ex",0
10,"10145",125,106,104,1,2,"C.Ex-C.R.Ex",1
10,"10114",962,754,737,2,17,"C.Ex-C.R.Ex",31
10,"10214",217,175,175,1,0,"C.Ex-C.R.Ex",0
6,"6158",13362,10282,10112,73,170,"C.Ex-C.R.Ex",28
6,"6153",20240,15464,15210,134,254,"C.Ex-C.R.Ex",13
10,"10095",314,260,255,2,5,"C.Ex-C.R.Ex",1
10,"10216",1522,1195,1167,9,28,"C.Ex-C.R.Ex",0
10,"10149",434,308,304,2,4,"C.Ex-C.R.Ex",2
6,"6003",766,625,610,3,15,"C.Ex-C.R.Ex",1
10,"10006",1230,1006,995,8,11,"C.Ex-C.R.Ex",2
10,"10147",1283,1038,1007,4,31,"C.Ex-C.R.Ex",1
10,"10021",5045,3932,3840,32,92,"C.Ex-C.R.Ex",6
10,"10189",2527,1958,1907,12,51,"C.Ex-C.R.Ex",4
6,"6060",5723,4401,4323,31,78,"C.Ex-C.R.Ex",3
10,"10198",1071,945,924,3,21,"C.Ex-C.R.Ex",1
6,"6024",1133,963,941,5,22,"C.Ex-C.R.Ex",1
10,"10049",3758,3167,3086,19,81,"C.Ex-C.R.Ex",11
6,"6038",790,583,574,4,9,"C.Ex-C.R.Ex",4
6,"6155",1825,1316,1292,21,24,"C.Ex-C.R.Ex",10
10,"10195",7557,5790,5691,38,99,"C.Ex-C.R.Ex",12
23,"23047",1579,1260,1247,13,13,"CILU-LINARE",1
23,"23074",2971,2410,2378,8,32,"CILU-LINARE",2
23,"23024",12224,9586,9329,46,257,"CILU-LINARE",20
23,"23016",384,316,311,0,5,"CILU-LINARE",0
23,"23002",17399,13575,13341,97,234,"CILU-LINARE",41
23,"23019",1479,1209,1183,3,26,"CILU-LINARE",1
23,"23084",907,685,670,0,15,"CILU-LINARE",1
23,"23090",1219,1014,1004,5,10,"CILU-LINARE",4
23,"23070",3808,2598,2565,34,33,"CILU-LINARE",6
23,"23101",352,273,271,0,2,"CILU-LINARE",1
23,"23039",2154,1644,1605,6,39,"CILU-LINARE",1
23,"23087",11185,8500,8363,65,137,"CILU-LINARE",12
23,"23018",2268,1738,1722,8,16,"CILU-LINARE",1
23,"23004",421,356,355,2,1,"CILU-LINARE",0
23,"23034",2490,2033,1999,15,34,"CILU-LINARE",12
23,"23049",1747,1321,1305,11,16,"CILU-LINARE",3
23,"23005",29940,19587,19330,191,257,"CILU-LINARE",47
23,"23008",1434,1155,1133,6,22,"CILU-LINARE",2
23,"23053",9449,6379,6325,25,54,"CILU-LINARE",2
23,"23040",1443,1164,1149,3,15,"CILU-LINARE",4
23,"23007",3026,2317,2301,13,16,"CILU-LINARE",4
23,"23060",19153,14444,14281,87,163,"CILU-LINARE",36
23,"23061",7691,5636,5531,51,105,"CILU-LINARE",13
23,"23054",376,296,289,1,7,"CILU-LINARE",0
23,"23056",3062,2332,2281,13,51,"CILU-LINARE",5
23,"23095",8591,6634,6571,27,63,"CILU-LINARE",9
23,"23088",6020,4779,4703,56,76,"CILU-LINARE",10
23,"23052",1108,949,931,8,18,"CILU-LINARE",1
23,"23043",518,398,397,0,1,"CILU-LINARE",2
23,"23063",3764,2812,2781,22,31,"CILU-LINARE",1
23,"23062",1418,1206,1190,5,16,"CILU-LINARE",0
23,"23031",765,659,647,4,12,"CILU-LINARE",1
23,"23006",4582,3607,3543,32,64,"CILU-LINARE",4
23,"23025",2727,2125,2090,8,35,"CILU-LINARE",2
23,"23011",2134,1649,1614,11,35,"CILU-LINARE",9
23,"23099",4822,3687,3633,28,54,"CILU-LINARE",4
23,"23051",2727,2060,2023,5,37,"CILU-LINARE",7
23,"23064",1678,1413,1404,10,9,"CILU-LINARE",3
23,"23041",491,383,382,0,1,"CILU-LINARE",2
23,"23059",5728,4259,4187,18,72,"CILU-LINARE",9
23,"23098",838,721,715,2,6,"CILU-LINARE",0
23,"23057",732,613,611,4,2,"CILU-LINARE",1
23,"23055",46343,33603,33225,243,378,"CILU-LINARE",313
23,"23086",11442,8618,8431,80,187,"CILU-LINARE",24
23,"23079",3639,2859,2818,20,41,"CILU-LINARE",2
23,"23071",1720,1348,1330,6,18,"CILU-LINARE",8
23,"23096",2571,2099,2063,9,36,"CILU-LINARE",2
23,"23069",5262,4395,4329,15,66,"CILU-LINARE",16
23,"23029",806,651,637,0,14,"CILU-LINARE",0
23,"23015",1332,1066,1048,4,18,"CILU-LINARE",3
23,"23048",820,644,636,1,8,"CILU-LINARE",4
23,"23097",6356,4509,4462,17,47,"CILU-LINARE",15
23,"23035",1103,903,882,6,21,"CILU-LINARE",3
23,"23042",317,234,232,1,2,"CILU-LINARE",1
23,"23085",2182,1733,1717,7,16,"CILU-LINARE",1
23,"23012",4018,2835,2804,15,31,"CILU-LINARE",7
23,"23094",3729,3111,3077,16,34,"CILU-LINARE",6
23,"23903",3499,2738,2714,7,24,"CILU-LINARE",8
23,"23032",523,443,439,1,4,"CILU-LINARE",1
23,"23082",1875,1402,1389,7,13,"CILU-LINARE",1
23,"23080",1721,1370,1355,8,15,"CILU-LINARE",2
23,"23033",1319,1076,1057,8,19,"CILU-LINARE",6
23,"23027",716,524,518,2,6,"CILU-LINARE",0
23,"23037",520,431,425,6,6,"CILU-LINARE",0
23,"23044",4719,3817,3749,18,68,"CILU-LINARE",10
23,"23066",4299,3603,3545,13,58,"CILU-LINARE",7
23,"23045",2057,1519,1507,7,12,"CILU-LINARE",3
23,"23067",2421,1909,1873,13,36,"CILU-LINARE",1
23,"23021",517,446,440,0,6,"CILU-LINARE",2
23,"23020",1524,1363,1348,12,15,"CILU-LINARE",1
23,"23081",1483,1137,1109,7,28,"CILU-LINARE",1
23,"23010",14241,10186,10015,68,171,"CILU-LINARE",41
23,"23905",1840,1358,1341,9,17,"CILU-LINARE",3
23,"23026",3450,2625,2573,17,52,"CILU-LINARE",6
23,"23092",27662,21206,20981,170,225,"CILU-LINARE",56
23,"23058",8817,6964,6873,48,91,"CILU-LINARE",15
23,"23030",1208,1022,1011,6,11,"CILU-LINARE",1
23,"23075",3220,2559,2524,18,35,"CILU-LINARE",2
23,"23902",2229,1843,1820,7,23,"CILU-LINARE",2
23,"23009",12808,10348,10233,66,115,"CILU-LINARE",11
23,"23073",4389,3400,3363,13,37,"CILU-LINARE",16
23,"23901",1139,946,934,3,12,"CILU-LINARE",3
23,"23072",1885,1485,1468,5,17,"CILU-LINARE",1
23,"23028",6131,4696,4635,24,61,"CILU-LINARE",13
23,"23904",2604,1727,1701,7,26,"CILU-LINARE",2
23,"23017",1480,1227,1202,6,25,"CILU-LINARE",1
23,"23038",3785,3182,3162,16,20,"CILU-LINARE",4
23,"23091",679,575,571,3,4,"CILU-LINARE",0
23,"23076",768,653,646,3,7,"CILU-LINARE",0
23,"23003",8644,6604,6523,36,81,"CILU-LINARE",21
23,"23093",3131,2428,2380,22,48,"CILU-LINARE",3
23,"23046",2331,1953,1926,3,27,"CILU-LINARE",5
23,"23065",1550,1199,1186,4,13,"CILU-LINARE",4
23,"23001",920,769,766,3,3,"CILU-LINARE",2
23,"23050",90596,69591,68903,460,688,"CILU-LINARE",133
23,"23014",2552,2056,2020,11,36,"CILU-LINARE",2
23,"23077",611,483,479,0,4,"CILU-LINARE",0
17,"17064",326,263,261,2,2,"CNV",0
43,"43074",1812,1419,1412,4,7,"CNV",3
17,"17004",533,445,441,3,4,"CNV",1
43,"43020",2276,1831,1819,12,12,"CNV",0
43,"43050",2634,1881,1868,13,13,"CNV",0
17,"17007",1752,1430,1422,2,8,"CNV",0
17,"17214",723,584,580,7,4,"CNV",0
8,"8287",1057,877,871,7,6,"CNV",0
8,"8149",984,770,768,3,2,"CNV",0
17,"17099",78,59,59,0,0,"CNV",0
8,"8229",521,435,433,3,2,"CNV",0
17,"17213",5535,3998,3985,20,13,"CNV",2
17,"17185",2275,1777,1768,7,9,"CNV",2
17,"17020",3671,3021,3006,11,15,"CNV",1
8,"8232",1786,1444,1434,9,10,"CNV",0
17,"17110",1329,1064,1054,5,10,"CNV",0
8,"8169",48284,37528,37326,218,202,"CNV",18
17,"17181",3467,2664,2648,10,16,"CNV",1
8,"8068",6878,5456,5437,25,19,"CNV",2
17,"17085",291,248,246,0,2,"CNV",2
17,"17133",1273,1048,1043,7,5,"CNV",2
17,"17204",596,461,460,2,1,"CNV",0
43,"43146",41,35,35,0,0,"CNV",0
17,"17197",131,113,113,1,0,"CNV",1
17,"17078",336,252,251,3,1,"CNV",0
17,"17902",1306,1076,1074,3,2,"CNV",1
43,"43101",145,122,122,1,0,"CNV",0
43,"43052",934,765,756,2,9,"CNV",1
8,"8209",6896,5269,5244,25,25,"CNV",1
43,"43023",214,186,186,1,0,"CNV",0
8,"8141",4573,3611,3595,26,16,"CNV",1
8,"8275",248,223,222,1,1,"CNV",0
17,"17060",408,311,311,1,0,"CNV",0
17,"17221",4152,3260,3247,11,13,"CNV",2
43,"43044",3949,3060,3032,31,28,"CNV",2
17,"17023",27144,20301,20146,120,155,"CNV",20
43,"43173",99,80,78,0,2,"CNV",0
17,"17092",3467,2660,2633,17,27,"CNV",5
8,"8058",1787,1357,1340,5,17,"CNV",3
17,"17186",3824,3115,3098,15,17,"CNV",1
17,"17034",7205,5337,5291,16,46,"CNV",5
43,"43089",281,209,208,0,1,"CNV",0
17,"17136",195,156,155,0,1,"CNV",1
8,"8030",5209,4318,4305,16,13,"CNV",3
8,"8074",11054,8273,8235,34,38,"CNV",1
8,"8126",8865,7125,7098,33,27,"CNV",2
8,"8056",42727,33215,33054,220,161,"CNV",21
8,"8057",61,50,50,0,0,"CNV",1
43,"43036",865,605,602,1,3,"CNV",0
8,"8155",6960,5427,5390,39,37,"CNV",5
8,"8084",1167,941,936,6,5,"CNV",2
17,"17083",2961,2321,2300,12,21,"CNV",3
17,"17205",211,184,184,1,0,"CNV",0
8,"8016",1812,1454,1448,6,6,"CNV",0
8,"8223",1886,1434,1425,4,9,"CNV",0
17,"17084",231,181,180,1,1,"CNV",0
43,"43092",7235,5200,5174,21,26,"CNV",2
43,"43033",768,609,607,3,2,"CNV",1
8,"8123",19489,16197,16135,58,62,"CNV",3
43,"43039",105,85,85,0,0,"CNV",0
17,"17216",155,127,124,0,3,"CNV",0
8,"8293",228,187,187,1,0,"CNV",0
43,"43124",472,379,373,1,6,"CNV",2
8,"8217",25355,20935,20855,110,80,"CNV",3
43,"43122",111,98,97,0,1,"CNV",0
8,"8001",9079,7383,7341,40,42,"CNV",0
8,"8903",197,177,176,0,1,"CNV",0
8,"8152",116,94,94,0,0,"CNV",0
17,"17035",550,460,460,3,0,"CNV",0
17,"17006",1186,880,878,10,2,"CNV",1
17,"17147",7959,6164,6130,45,34,"CNV",4
17,"17201",143,120,120,0,0,"CNV",0
17,"17082",436,341,339,0,2,"CNV",0
43,"43154",126,111,111,0,0,"CNV",1
8,"8172",20417,16196,16144,88,52,"CNV",11
43,"43002",1875,1367,1348,11,19,"CNV",0
8,"8081",353,299,297,2,2,"CNV",1
17,"17178",1056,804,798,3,6,"CNV",1
17,"17042",408,313,311,0,2,"CNV",0
17,"17065",324,254,253,0,1,"CNV",0
17,"17115",278,226,222,2,4,"CNV",1
8,"8065",1180,967,964,4,3,"CNV",1
17,"17165",634,516,512,3,4,"CNV",1
17,"17124",1599,1258,1254,6,4,"CNV",1
8,"8097",1080,891,880,2,11,"CNV",0
17,"17024",285,228,227,0,1,"CNV",0
8,"8050",136,115,114,0,1,"CNV",0
8,"8028",1088,783,780,2,3,"CNV",0
8,"8051",18437,14951,14887,85,64,"CNV",4
8,"8002",220,184,183,2,1,"CNV",0
17,"17111",958,772,771,3,1,"CNV",0
43,"43125",890,700,698,12,2,"CNV",1
8,"8200",62161,48645,48330,261,315,"CNV",175
8,"8294",2063,1644,1643,10,1,"CNV",0
8,"8153",559,460,458,2,2,"CNV",0
8,"8049",1320,981,977,5,4,"CNV",3
8,"8083",1672,1478,1471,7,7,"CNV",0
8,"8140",4778,3756,3737,19,19,"CNV",1
17,"17116",354,283,282,0,1,"CNV",0
8,"8109",208,184,183,0,1,"CNV",0
8,"8307",49310,38223,38022,162,201,"CNV",17
8,"8148",2334,1803,1794,6,9,"CNV",3
43,"43163",26013,18942,18796,89,146,"CNV",23
43,"43170",878,706,704,7,2,"CNV",0
17,"17061",183,148,148,0,0,"CNV",0
8,"8086",14017,10746,10677,89,69,"CNV",2
43,"43009",1391,1086,1078,3,8,"CNV",0
43,"43135",341,283,280,4,3,"CNV",0
43,"43062",259,223,220,2,3,"CNV",0
17,"17199",6955,5328,5308,23,20,"CNV",38
43,"43141",105,86,86,0,0,"CNV",0
17,"17164",3932,3078,3054,8,24,"CNV",4
43,"43034",468,393,393,0,0,"CNV",0
8,"8242",222,180,180,0,0,"CNV",0
17,"17154",99,84,83,0,1,"CNV",0
17,"17123",345,304,303,4,1,"CNV",0
8,"8162",2124,1659,1651,7,8,"CNV",2
8,"8100",2092,1792,1782,16,10,"CNV",0
17,"17160",14733,10833,10766,43,67,"CNV",8
8,"8301",49135,38575,38398,272,177,"CNV",11
17,"17063",173,157,156,2,1,"CNV",0
8,"8220",2411,2119,2115,13,4,"CNV",3
8,"8255",137,105,105,1,0,"CNV",0
17,"17093",922,716,715,2,1,"CNV",0
8,"8185",197,172,171,2,1,"CNV",0
43,"43063",536,401,397,1,4,"CNV",0
8,"8021",61,47,45,0,2,"CNV",0
8,"8221",12699,10571,10537,53,34,"CNV",11
43,"43132",363,292,291,2,1,"CNV",0
17,"17190",838,681,677,0,4,"CNV",0
8,"8089",34019,26317,26191,170,126,"CNV",7
17,"17114",23269,17558,17474,91,84,"CNV",20
8,"8902",3937,3176,3164,17,12,"CNV",1
8,"8015",156003,117736,117183,704,553,"CNV",133
17,"17157",124,107,107,0,0,"CNV",0
8,"8215",2589,2044,2034,19,10,"CNV",2
43,"43019",1336,1020,1008,4,12,"CNV",0
8,"8096",43555,34070,33871,194,199,"CNV",18
17,"17090",544,469,468,0,1,"CNV",0
43,"43080",227,195,195,0,0,"CNV",0
8,"8147",17282,13644,13560,94,84,"CNV",2
43,"43056",806,616,613,5,3,"CNV",0
43,"43017",116,98,98,1,0,"CNV",0
43,"43055",1988,1631,1622,7,9,"CNV",0
8,"8256",691,571,568,3,3,"CNV",0
17,"17071",1128,978,978,3,0,"CNV",2
8,"8158",3108,2458,2453,13,5,"CNV",0
8,"8004",209,194,191,0,3,"CNV",0
43,"43075",86,71,69,0,2,"CNV",0
8,"8197",7896,6197,6174,28,23,"CNV",0
43,"43128",905,751,747,4,4,"CNV",0
8,"8133",128,98,98,5,0,"CNV",0
8,"8202",12843,10074,10025,57,49,"CNV",2
8,"8181",8061,6442,6402,28,40,"CNV",4
17,"17227",139,106,106,0,0,"CNV",0
43,"43051",9092,6577,6502,26,75,"CNV",2
17,"17188",169,139,138,1,1,"CNV",0
17,"17187",625,530,529,4,1,"CNV",0
17,"17016",719,584,581,1,3,"CNV",0
17,"17098",303,245,245,2,0,"CNV",0
43,"43070",238,194,193,1,1,"CNV",0
17,"17069",364,286,284,2,2,"CNV",0
17,"17005",460,336,331,0,5,"CNV",1
43,"43018",385,335,334,3,1,"CNV",4
8,"8135",6735,5445,5421,36,24,"CNV",0
17,"17145",1432,1113,1103,7,10,"CNV",7
43,"43116",463,381,379,2,2,"CNV",0
43,"43138",2648,1926,1896,8,30,"CNV",2
8,"8085",976,812,811,2,1,"CNV",0
8,"8265",1590,1339,1334,6,5,"CNV",0
43,"43165",572,492,492,1,0,"CNV",0
8,"8059",344,292,290,2,2,"CNV",0
43,"43902",2743,1996,1980,16,16,"CNV",1
43,"43026",765,614,613,3,1,"CNV",0
17,"17208",976,772,768,5,4,"CNV",0
43,"43149",684,533,533,4,0,"CNV",0
43,"43166",1628,1292,1285,3,7,"CNV",0
8,"8285",10321,8169,8120,52,49,"CNV",3
8,"8067",5728,4535,4513,21,22,"CNV",1
43,"43150",1238,1034,1026,6,8,"CNV",0
17,"17075",334,282,281,5,1,"CNV",0
43,"43129",4611,3528,3495,21,33,"CNV",0
43,"43016",3445,2628,2608,11,20,"CNV",0
43,"43046",90,73,73,1,0,"CNV",0
8,"8233",1846,1485,1478,8,7,"CNV",0
17,"17138",845,650,646,0,4,"CNV",4
8,"8276",233,180,180,0,0,"CNV",0
8,"8240",9453,7807,7776,21,31,"CNV",3
17,"17161",1018,859,855,1,4,"CNV",2
8,"8196",19444,15361,15263,90,98,"CNV",10
17,"17903",889,726,721,4,5,"CNV",0
8,"8105",9724,7557,7505,49,52,"CNV",2
8,"8157",8547,6949,6918,39,31,"CNV",4
17,"17070",110,94,94,0,0,"CNV",1
8,"8238",14851,12472,12428,50,44,"CNV",8
17,"17162",156,114,111,1,3,"CNV",0
17,"17142",2673,2250,2241,14,9,"CNV",1
43,"43112",250,204,204,1,0,"CNV",0
8,"8053",2865,2105,2098,17,7,"CNV",0
17,"17223",800,623,616,5,7,"CNV",0
8,"8091",5413,4301,4283,20,18,"CNV",1
8,"8039",402,334,334,2,0,"CNV",1
8,"8101",174954,129953,129198,680,755,"CNV",59
8,"8161",11625,8521,8470,44,51,"CNV",2
43,"43178",1421,1118,1113,7,5,"CNV",0
17,"17192",146,121,120,0,1,"CNV",0
8,"8241",69,56,56,0,0,"CNV",0
8,"8246",1672,1412,1406,7,6,"CNV",1
43,"43105",156,132,132,3,0,"CNV",0
8,"8078",219,176,172,1,4,"CNV",0
8,"8018",2551,1998,1984,6,14,"CNV",4
8,"8211",33731,27698,27561,126,137,"CNV",6
43,"43069",178,146,146,0,0,"CNV",0
8,"8138",4432,3435,3413,10,22,"CNV",1
8,"8273",2353,1944,1934,9,10,"CNV",3
8,"8095",67,53,52,0,1,"CNV",0
8,"8121",87292,67638,67328,362,310,"CNV",25
8,"8170",442,338,338,0,0,"CNV",0
17,"17019",1784,1472,1462,3,10,"CNV",1
17,"17089",5695,4211,4194,13,17,"CNV",2
43,"43027",164,137,137,0,0,"CNV",0
17,"17051",207,174,173,3,1,"CNV",0
43,"43155",22619,16724,16624,101,100,"CNV",5
17,"17010",327,264,263,2,1,"CNV",1
8,"8192",5679,4605,4589,20,16,"CNV",2
17,"17141",6072,4251,4221,14,30,"CNV",4
43,"43079",356,306,305,1,1,"CNV",0
43,"43014",14357,10596,10542,60,54,"CNV",16
17,"17101",562,415,413,2,2,"CNV",1
43,"43120",421,302,297,2,5,"CNV",1
8,"8289",4457,3605,3594,20,11,"CNV",1
8,"8205",61279,51629,51497,360,132,"CNV",47
43,"43041",228,179,177,3,2,"CNV",0
17,"17106",143,124,123,0,1,"CNV",0
8,"8188",115,95,95,0,0,"CNV",0
43,"43001",694,543,543,5,0,"CNV",0
8,"8284",12482,8959,8887,41,72,"CNV",7
17,"17033",5587,4157,4130,13,27,"CNV",3
17,"17132",1333,1088,1080,9,8,"CNV",0
17,"17901",983,790,789,3,1,"CNV",0
17,"17174",162,132,132,4,0,"CNV",0
43,"43110",251,184,184,1,0,"CNV",0
43,"43098",354,291,291,1,0,"CNV",1
17,"17198",433,332,329,0,3,"CNV",0
17,"17103",5084,3575,3543,13,32,"CNV",0
43,"43148",90763,69756,69423,299,333,"CNV",32
43,"43162",4418,3467,3453,20,14,"CNV",0
17,"17152",11026,7610,7564,70,46,"CNV",4
8,"8003",7183,5761,5742,39,19,"CNV",2
17,"17163",2824,2358,2351,13,7,"CNV",2
43,"43021",345,270,269,3,1,"CNV",0
8,"8006",11774,9039,8981,33,58,"CNV",6
8,"8177",39,31,31,0,0,"CNV",0
8,"8098",2409,1916,1912,9,4,"CNV",1
43,"43157",345,303,303,0,0,"CNV",0
17,"17094",1068,772,766,1,6,"CNV",1
8,"8250",7182,5461,5421,38,40,"CNV",1
8,"8069",3280,2691,2680,17,11,"CNV",1
8,"8259",6904,5626,5601,27,25,"CNV",0
8,"8127",2240,1694,1683,13,11,"CNV",0
43,"43160",1322,1051,1045,0,6,"CNV",0
8,"8263",21151,16360,16269,116,91,"CNV",14
43,"43003",350,266,264,3,2,"CNV",0
17,"17222",105,95,95,1,0,"CNV",0
8,"8252",24729,19751,19642,125,109,"CNV",14
43,"43121",591,463,462,0,1,"CNV",1
17,"17074",532,436,426,2,10,"CNV",0
43,"43904",2861,2083,2058,27,25,"CNV",1
8,"8134",842,649,646,3,3,"CNV",0
17,"17012",1171,916,914,10,2,"CNV",1
8,"8041",10692,7805,7732,48,73,"CNV",0
8,"8154",701,587,586,5,1,"CNV",1
43,"43177",284,243,242,0,1,"CNV",1
17,"17177",567,459,457,2,2,"CNV",1
43,"43011",1079,912,909,1,3,"CNV",0
43,"43004",6274,4744,4691,39,53,"CNV",1
8,"8094",1586,1310,1306,10,4,"CNV",2
8,"8128",577,454,451,0,3,"CNV",0
8,"8071",241,200,200,0,0,"CNV",0
17,"17149",364,314,314,0,0,"CNV",0
8,"8047",3737,2903,2876,16,27,"CNV",0
17,"17054",347,271,271,0,0,"CNV",0
17,"17202",3813,2876,2851,8,25,"CNV",5
17,"17121",229,184,184,1,0,"CNV",1
8,"8045",71,52,49,0,3,"CNV",0
43,"43108",1778,1374,1365,6,9,"CNV",0
17,"17146",3127,2404,2381,11,23,"CNV",1
43,"43140",2438,1847,1837,16,10,"CNV",2
8,"8092",3714,2912,2889,8,23,"CNV",1
17,"17088",578,468,468,1,0,"CNV",0
17,"17043",167,135,134,0,1,"CNV",1
17,"17225",207,161,161,0,0,"CNV",0
8,"8251",5127,3972,3940,17,32,"CNV",1
43,"43061",38,28,28,0,0,"CNV",0
43,"43111",2098,1496,1483,8,13,"CNV",1
8,"8288",1676,1196,1182,6,14,"CNV",1
43,"43174",144,128,127,0,1,"CNV",0
8,"8180",27072,21218,21100,126,118,"CNV",3
8,"8113",52518,39750,39592,198,158,"CNV",16
17,"17015",12819,10133,10078,38,55,"CNV",151
17,"17105",247,194,194,1,0,"CNV",0
8,"8193",984,792,790,5,2,"CNV",0
8,"8099",753,565,561,2,4,"CNV",0
43,"43054",2792,2145,2134,21,11,"CNV",0
17,"17200",623,512,510,1,2,"CNV",0
17,"17230",499,397,393,0,4,"CNV",0
43,"43060",2684,2158,2152,8,6,"CNV",2
17,"17029",199,160,157,1,3,"CNV",0
8,"8280",95,78,78,1,0,"CNV",0
43,"43907",4359,3370,3346,22,24,"CNV",0
8,"8228",288,239,239,2,0,"CNV",0
43,"43088",2026,1565,1562,9,3,"CNV",0
8,"8901",240,203,201,1,2,"CNV",0
8,"8176",161,132,131,2,1,"CNV",0
8,"8272",165,133,133,0,0,"CNV",1
8,"8184",54876,41661,41447,248,214,"CNV",12
8,"8027",720,592,588,3,4,"CNV",0
17,"17182",272,220,220,3,0,"CNV",0
43,"43025",590,476,472,0,4,"CNV",0
17,"17001",580,459,454,3,5,"CNV",0
17,"17057",968,826,822,1,4,"CNV",0
8,"8103",640,507,505,4,2,"CNV",0
17,"17175",564,381,381,1,0,"CNV",0
8,"8206",737,625,624,3,1,"CNV",0
43,"43042",2198,1820,1816,8,4,"CNV",0
17,"17002",564,491,488,3,3,"CNV",1
17,"17211",831,694,691,1,3,"CNV",1
8,"8210",4584,3455,3435,23,20,"CNV",2
8,"8247",980,832,828,3,4,"CNV",1
17,"17049",3204,2634,2615,9,19,"CNV",2
8,"8026",193,161,161,1,0,"CNV",0
17,"17130",322,268,268,0,0,"CNV",1
8,"8245",77805,57956,57666,313,290,"CNV",20
8,"8106",7469,5816,5795,34,21,"CNV",1
17,"17172",457,352,349,1,3,"CNV",1
17,"17081",248,192,190,0,2,"CNV",0
8,"8201",447,327,324,5,3,"CNV",2
43,"43144",1236,1025,1021,8,4,"CNV",1
17,"17055",143,126,125,0,1,"CNV",0
8,"8035",12871,9574,9538,31,36,"CNV",3
8,"8130",108,89,86,2,3,"CNV",0
43,"43081",633,532,531,7,1,"CNV",0
8,"8277",171,150,150,0,0,"CNV",0
43,"43030",482,373,372,2,1,"CNV",0
8,"8266",43383,35117,34994,178,123,"CNV",26
17,"17173",182,156,156,0,0,"CNV",0
43,"43906",2103,1595,1587,14,8,"CNV",1
8,"8160",316,252,247,2,5,"CNV",0
43,"43123",71092,53689,53369,241,320,"CNV",38
8,"8038",1525,1228,1220,2,8,"CNV",1
8,"8178",451,389,388,3,1,"CNV",2
8,"8125",25485,19719,19627,101,92,"CNV",12
8,"8905",2308,1943,1938,7,5,"CNV",0
8,"8208",5760,4660,4643,25,17,"CNV",0
17,"17139",1394,1163,1154,3,9,"CNV",2
43,"43099",286,234,234,0,0,"CNV",0
17,"17077",567,434,434,2,0,"CNV",0
8,"8179",611,496,493,2,3,"CNV",0
8,"8295",11184,8566,8529,43,37,"CNV",1
8,"8048",569,442,442,2,0,"CNV",0
43,"43115",128,112,111,1,1,"CNV",0
8,"8257",103,86,86,1,0,"CNV",0
8,"8226",926,811,807,1,4,"CNV",2
8,"8182",2892,2217,2204,18,13,"CNV",0
8,"8230",7666,6202,6168,30,34,"CNV",4
17,"17013",2774,2180,2173,15,7,"CNV",3
8,"8022",12219,9089,9038,42,51,"CNV",12
17,"17050",674,585,582,5,3,"CNV",0
17,"17155",14861,10307,10234,52,73,"CNV",2
8,"8143",2719,2121,2109,10,12,"CNV",3
17,"17028",297,238,237,1,1,"CNV",0
17,"17062",5978,4358,4334,26,24,"CNV",3
17,"17166",547,460,459,2,1,"CNV",0
17,"17126",318,279,279,0,0,"CNV",0
43,"43133",5605,4202,4168,21,34,"CNV",2
43,"43058",96,77,77,0,0,"CNV",0
8,"8189",122,106,106,0,0,"CNV",0
17,"17109",698,558,553,1,5,"CNV",1
8,"8007",6775,5447,5419,21,28,"CNV",3
8,"8118",17542,14101,14059,56,42,"CNV",10
17,"17167",2609,2122,2102,14,20,"CNV",0
43,"43168",84,65,65,1,0,"CNV",0
17,"17144",210,171,170,0,1,"CNV",0
43,"43076",460,378,377,2,1,"CNV",0
17,"17194",78,62,62,0,0,"CNV",0
43,"43134",273,224,223,5,1,"CNV",0
8,"8199",651,542,542,4,0,"CNV",0
8,"8119",6838,5352,5326,31,26,"CNV",5
17,"17076",122,101,100,1,1,"CNV",1
43,"43167",384,334,333,2,1,"CNV",0
8,"8064",1920,1516,1506,6,10,"CNV",0
17,"17080",144,124,124,2,0,"CNV",0
17,"17120",820,604,598,3,6,"CNV",0
8,"8163",19497,14616,14548,67,68,"CNV",5
8,"8175",3368,2496,2486,16,10,"CNV",1
17,"17159",626,487,483,1,4,"CNV",0
8,"8194",25674,17691,17585,115,106,"CNV",31
43,"43097",399,341,341,1,0,"CNV",1
8,"8212",491,406,402,1,4,"CNV",0
43,"43164",306,228,228,0,0,"CNV",0
43,"43151",109,98,98,0,0,"CNV",0
17,"17021",122,98,98,0,0,"CNV",0
8,"8198",4640,3713,3691,23,22,"CNV",0
43,"43175",537,426,419,5,7,"CNV",2
43,"43064",2017,1569,1558,9,11,"CNV",2
17,"17125",131,98,97,1,1,"CNV",0
8,"8296",1843,1520,1514,10,6,"CNV",1
8,"8218",8104,6419,6389,34,30,"CNV",4
17,"17119",73,58,58,2,0,"CNV",0
17,"17096",164,113,113,1,0,"CNV",1
17,"17224",302,233,231,2,2,"CNV",0
17,"17048",6251,4565,4537,20,28,"CNV",5
43,"43176",746,588,586,7,2,"CNV",0
8,"8112",12935,9822,9765,74,57,"CNV",1
17,"17218",570,468,465,5,3,"CNV",2
8,"8156",11155,8956,8923,60,33,"CNV",2
43,"43100",3489,2820,2816,15,4,"CNV",0
8,"8306",527,390,388,2,2,"CNV",0
8,"8174",392,330,330,4,0,"CNV",0
8,"8254",1753,1485,1482,3,3,"CNV",2
17,"17203",165,135,135,0,0,"CNV",0
8,"8213",6547,5270,5245,23,25,"CNV",2
8,"8010",4207,3327,3304,13,23,"CNV",0
43,"43169",450,396,396,3,0,"CNV",0
43,"43038",21861,16504,16406,112,98,"CNV",4
43,"43022",1435,1130,1123,8,7,"CNV",1
17,"17038",380,312,308,3,4,"CNV",0
8,"8087",149,135,133,0,2,"CNV",0
8,"8219",15629,12910,12865,58,45,"CNV",1
43,"43172",337,261,257,2,4,"CNV",0
8,"8093",24,20,20,0,0,"CNV",0
17,"17193",4312,3202,3179,15,23,"CNV",3
8,"8136",11614,9159,9079,84,80,"CNV",3
17,"17171",172,143,141,0,2,"CNV",0
8,"8258",813,661,657,6,4,"CNV",0
8,"8237",1662,1334,1327,7,7,"CNV",0
17,"17234",179,147,146,2,1,"CNV",0
17,"17052",134,104,104,1,0,"CNV",0
43,"43066",155,121,121,1,0,"CNV",0
43,"43031",1446,1180,1178,7,2,"CNV",1
8,"8131",741,585,585,4,0,"CNV",0
8,"8031",2336,1886,1882,11,4,"CNV",1
8,"8033",13218,10480,10435,50,45,"CNV",7
43,"43072",93,74,74,0,0,"CNV",0
43,"43903",2333,1717,1700,11,17,"CNV",0
8,"8012",1721,1340,1331,8,9,"CNV",0
8,"8308",137,118,118,0,0,"CNV",1
8,"8114",18648,14251,14170,69,81,"CNV",11
8,"8299",377,318,317,0,1,"CNV",1
43,"43077",455,342,339,2,3,"CNV",0
43,"43013",4392,3341,3321,14,20,"CNV",1
17,"17233",2328,1924,1912,6,12,"CNV",0
17,"17143",144,115,115,0,0,"CNV",0
17,"17183",255,216,216,0,0,"CNV",3
8,"8282",6711,5696,5677,27,19,"CNV",6
8,"8150",251,211,211,0,0,"CNV",0
8,"8165",1664,1315,1311,9,4,"CNV",1
43,"43093",3884,2956,2933,14,23,"CNV",13
17,"17025",1170,972,967,6,5,"CNV",0
43,"43059",250,214,214,1,0,"CNV",0
17,"17044",6930,5514,5493,26,21,"CNV",0
17,"17079",65381,50872,50631,242,241,"CNV",30
8,"8231",21132,15940,15880,75,60,"CNV",1
43,"43106",793,656,651,2,5,"CNV",0
17,"17184",1264,1068,1060,5,8,"CNV",1
8,"8214",6966,5648,5633,21,15,"CNV",1
17,"17073",1939,1695,1693,7,2,"CNV",1
17,"17102",548,439,435,3,4,"CNV",0
43,"43065",382,308,304,1,4,"CNV",0
8,"8102",28794,22420,22317,92,103,"CNV",16
8,"8116",558,459,459,0,0,"CNV",0
17,"17046",710,574,571,3,3,"CNV",0
17,"17209",615,519,517,2,2,"CNV",0
43,"43118",425,357,356,0,1,"CNV",0
8,"8011",1745,1414,1407,10,7,"CNV",0
43,"43126",1211,1005,999,4,6,"CNV",7
8,"8122",1716,1260,1254,8,6,"CNV",1
17,"17168",379,332,329,0,3,"CNV",0
17,"17151",185,150,150,1,0,"CNV",0
8,"8302",9373,7001,6934,61,67,"CNV",2
43,"43083",144,116,113,1,3,"CNV",1
8,"8261",2378,1821,1815,14,6,"CNV",1
8,"8264",4535,3623,3613,13,10,"CNV",3
8,"8267",6748,5389,5362,28,27,"CNV",0
17,"17107",269,221,219,2,2,"CNV",0
17,"17027",2866,2375,2364,8,11,"CNV",2
8,"8117",2480,2055,2050,16,5,"CNV",4
43,"43094",2120,1659,1646,9,13,"CNV",1
8,"8137",274,232,229,0,3,"CNV",0
8,"8298",26980,20900,20817,91,83,"CNV",5
8,"8104",653,516,516,2,0,"CNV",1
17,"17137",3467,2925,2912,15,13,"CNV",1
8,"8171",2066,1607,1597,7,10,"CNV",0
8,"8303",256,215,213,1,2,"CNV",0
8,"8144",713,565,563,5,2,"CNV",0
8,"8066",1463,1185,1181,9,4,"CNV",0
43,"43156",3956,2993,2965,23,28,"CNV",1
8,"8139",177,156,156,0,0,"CNV",0
43,"43103",905,746,740,8,6,"CNV",0
8,"8271",67,57,57,0,0,"CNV",0
8,"8236",1557,1204,1202,2,2,"CNV",0
17,"17091",398,310,305,2,5,"CNV",0
43,"43095",2564,1995,1984,14,11,"CNV",0
17,"17176",123,110,110,1,0,"CNV",0
8,"8243",156,139,139,0,0,"CNV",1
43,"43091",123,93,93,1,0,"CNV",0
43,"43159",81,63,62,0,1,"CNV",0
43,"43084",521,424,423,2,1,"CNV",1
43,"43109",2704,1937,1922,16,15,"CNV",0
43,"43005",3643,2765,2749,22,16,"CNV",1
8,"8008",179,139,138,0,1,"CNV",0
17,"17041",218,166,165,3,1,"CNV",0
8,"8111",215,200,199,4,1,"CNV",0
43,"43145",4209,3409,3391,9,18,"CNV",0
17,"17128",316,255,252,1,3,"CNV",0
8,"8070",266,232,232,0,0,"CNV",0
8,"8278",4893,4034,4018,17,16,"CNV",1
8,"8190",258,216,215,1,1,"CNV",0
8,"8077",34578,27617,27501,134,116,"CNV",11
43,"43086",5263,4046,4021,17,25,"CNV",1
17,"17129",144,120,120,1,0,"CNV",0
8,"8304",816,686,678,1,8,"CNV",0
8,"8146",1358,1086,1079,2,7,"CNV",0
8,"8019",1117818,875679,872180,4327,3499,"CNV",551
8,"8088",12248,9945,9904,57,41,"CNV",6
8,"8020",5172,4337,4327,26,10,"CNV",3
8,"8054",9155,7468,7428,43,40,"CNV",3
17,"17232",149,117,116,0,1,"CNV",0
8,"8166",962,753,745,7,8,"CNV",0
8,"8305",27533,21656,21539,96,117,"CNV",11
17,"17180",8500,6462,6431,28,31,"CNV",3
17,"17047",4968,3447,3429,22,18,"CNV",1
17,"17039",1740,1385,1380,8,5,"CNV",0
17,"17018",494,405,402,1,3,"CNV",0
43,"43029",314,253,252,0,1,"CNV",0
43,"43136",10463,7789,7749,36,40,"CNV",2
17,"17228",285,229,229,1,0,"CNV",0
17,"17196",242,198,198,1,0,"CNV",1
8,"8040",11004,8468,8431,24,37,"CNV",2
17,"17014",63,51,50,0,1,"CNV",0
8,"8225",94,81,81,1,0,"CNV",0
8,"8283",6113,4832,4813,33,19,"CNV",2
8,"8262",6919,5090,5060,33,30,"CNV",4
8,"8234",3373,2742,2734,25,8,"CNV",1
43,"43040",326,278,276,0,2,"CNV",0
8,"8042",2362,1910,1904,7,6,"CNV",0
43,"43096",98,82,82,0,0,"CNV",0
43,"43104",1762,1410,1401,5,9,"CNV",0
8,"8108",5192,4204,4189,26,15,"CNV",2
8,"8090",137,113,113,2,0,"CNV",0
43,"43035",235,205,203,7,2,"CNV",0
8,"8142",139,126,126,1,0,"CNV",0
8,"8904",10514,7733,7697,38,36,"CNV",1
43,"43137",1905,1515,1499,15,16,"CNV",14
8,"8110",13592,10111,10058,50,53,"CNV",5
43,"43047",4209,2878,2856,23,22,"CNV",1
17,"17217",353,312,311,1,1,"CNV",0
8,"8297",135,111,111,1,0,"CNV",0
8,"8222",1819,1484,1476,11,8,"CNV",1
17,"17195",342,296,295,3,1,"CNV",0
43,"43113",397,325,323,2,2,"CNV",0
17,"17030",650,479,477,4,2,"CNV",0
17,"17210",580,449,445,2,4,"CNV",0
8,"8025",1535,1221,1214,7,7,"CNV",0
8,"8164",934,784,776,1,8,"CNV",1
8,"8244",6041,4994,4970,33,24,"CNV",0
8,"8235",3829,3176,3167,14,9,"CNV",2
43,"43015",119,101,101,0,0,"CNV",0
17,"17097",199,172,170,1,2,"CNV",0
17,"17022",7008,5386,5354,22,32,"CNV",2
8,"8032",2087,1607,1598,9,9,"CNV",0
43,"43045",146,128,127,0,1,"CNV",0
17,"17135",395,309,307,0,2,"CNV",0
8,"8224",878,697,695,1,2,"CNV",0
43,"43010",337,286,284,2,2,"CNV",0
8,"8046",13478,10989,10939,67,50,"CNV",1
43,"43082",351,303,297,1,6,"CNV",0
8,"8052",139,111,110,0,1,"CNV",0
17,"17189",1476,1278,1275,2,3,"CNV",1
8,"8253",128,113,113,0,0,"CNV",0
17,"17170",180,147,147,2,0,"CNV",1
8,"8079",334,284,282,0,2,"CNV",0
17,"17056",1766,1438,1433,9,5,"CNV",1
17,"17008",3594,2763,2741,16,22,"CNV",5
8,"8168",394,287,287,1,0,"CNV",0
17,"17058",170,139,139,0,0,"CNV",0
8,"8292",1062,835,831,3,4,"CNV",0
17,"17003",102,75,75,0,0,"CNV",0
8,"8260",18400,14471,14406,87,65,"CNV",2
8,"8207",2014,1736,1730,9,6,"CNV",0
8,"8187",153380,120687,120090,637,597,"CNV",48
17,"17026",543,450,449,4,1,"CNV",0
8,"8044",4136,3193,3175,11,18,"CNV",0
8,"8269",2712,2258,2250,19,8,"CNV",2
8,"8037",1930,1618,1610,10,8,"CNV",1
43,"43142",1083,850,842,8,8,"CNV",2
8,"8013",1280,1040,1031,5,9,"CNV",0
43,"43158",77,61,61,1,0,"CNV",0
8,"8129",484,406,405,3,1,"CNV",0
17,"17140",639,539,527,4,12,"CNV",0
43,"43085",235,198,194,0,4,"CNV",0
8,"8009",9480,7649,7620,35,29,"CNV",5
17,"17191",166,145,144,2,1,"CNV",0
43,"43071",891,713,706,6,7,"CNV",1
8,"8036",163,134,133,0,1,"CNV",0
43,"43006",676,531,525,4,6,"CNV",0
8,"8183",4563,3628,3613,9,15,"CNV",4
17,"17206",155,118,115,0,3,"CNV",1
43,"43024",1556,1154,1137,3,17,"CNV",1
43,"43131",4772,3432,3401,18,31,"CNV",5
17,"17226",895,673,669,3,4,"CNV",1
43,"43117",143,114,113,0,1,"CNV",1
43,"43067",528,450,445,1,5,"CNV",0
8,"8227",2410,1882,1877,10,5,"CNV",0
43,"43053",188,153,149,0,4,"CNV",0
17,"17037",114,98,98,6,0,"CNV",0
8,"8023",6915,5339,5299,26,40,"CNV",0
8,"8075",4059,3127,3119,14,8,"CNV",2
8,"8191",5270,4176,4162,19,14,"CNV",2
17,"17220",805,673,665,2,8,"CNV",1
43,"43073",84,68,67,0,1,"CNV",0
43,"43901",8750,6057,6004,43,53,"CNV",3
17,"17150",1426,1199,1192,8,7,"CNV",1
43,"43143",51,45,44,0,1,"CNV",0
43,"43905",14941,10510,10446,40,64,"CNV",13
17,"17009",4051,3263,3248,14,15,"CNV",2
43,"43049",727,589,584,2,5,"CNV",0
43,"43068",483,367,365,5,2,"CNV",0
8,"8249",272,248,248,2,0,"CNV",0
8,"8024",357,301,298,1,3,"CNV",0
8,"8281",4840,4009,3998,23,11,"CNV",3
43,"43127",759,630,626,3,4,"CNV",0
8,"8216",25,19,19,0,0,"CNV",0
17,"17117",14471,10565,10504,52,61,"CNV",1
8,"8029",3560,3027,3019,13,8,"CNV",3
43,"43048",763,614,609,7,5,"CNV",0
8,"8204",3115,2548,2534,22,14,"CNV",2
8,"8043",3378,2579,2569,20,10,"CNV",0
8,"8120",7048,5892,5881,49,11,"CNV",6
43,"43161",17113,12944,12881,64,63,"CNV",9
8,"8017",2827,2192,2182,16,10,"CNV",0
17,"17036",2643,2076,2071,12,5,"CNV",3
8,"8279",155280,121081,120515,802,566,"CNV",58
43,"43152",434,357,356,0,1,"CNV",0
17,"17148",1531,1165,1153,4,12,"CNV",0
8,"8014",2000,1578,1567,5,11,"CNV",1
8,"8132",361,281,281,2,0,"CNV",2
17,"17040",551,465,459,4,6,"CNV",0
43,"43028",2766,2007,1988,7,19,"CNV",2
17,"17067",697,581,578,4,3,"CNV",1
43,"43012",3647,3028,3019,15,9,"CNV",1
43,"43153",11092,8327,8291,34,36,"CNV",6
17,"17118",12916,9521,9460,37,61,"CNV",6
8,"8195",76,69,69,0,0,"CNV",0
43,"43171",14705,11002,10956,62,46,"CNV",5
8,"8061",1590,1236,1233,8,3,"CNV",0
43,"43102",463,384,379,2,5,"CNV",0
8,"8203",2472,1884,1873,4,11,"CNV",2
43,"43032",466,379,379,1,0,"CNV",0
43,"43107",383,308,308,1,0,"CNV",0
43,"43147",521,446,442,4,4,"CNV",0
8,"8274",4674,3710,3698,12,12,"CNV",0
43,"43090",1169,749,742,2,7,"CNV",0
43,"43114",375,306,305,0,1,"CNV",1
17,"17169",2497,2047,2042,8,5,"CNV",4
8,"8151",448,378,377,2,1,"CNV",0
43,"43043",3289,2624,2613,14,11,"CNV",0
8,"8082",1143,868,861,4,7,"CNV",0
17,"17215",2227,1936,1925,12,11,"CNV",0
8,"8062",1004,829,826,11,3,"CNV",0
8,"8107",11900,9303,9187,43,116,"CNV",1
8,"8167",6048,4833,4822,48,11,"CNV",0
17,"17068",246,194,193,0,1,"CNV",0
17,"17153",188,162,162,0,0,"CNV",0
17,"17031",182,130,129,0,1,"CNV",0
43,"43007",640,510,509,0,1,"CNV",0
8,"8073",62572,48770,48527,255,243,"CNV",18
8,"8159",14323,11399,11359,57,40,"CNV",5
43,"43119",838,630,628,4,2,"CNV",0
17,"17087",222,177,176,0,1,"CNV",0
8,"8291",4919,3865,3854,28,11,"CNV",0
8,"8080",39,30,30,0,0,"CNV",0
17,"17212",142,117,117,2,0,"CNV",0
8,"8005",6380,5122,5106,18,16,"CNV",0
17,"17095",19938,13998,13918,69,80,"CNV",13
8,"8034",784,648,646,1,2,"CNV",0
8,"8060",135,111,109,0,2,"CNV",1
17,"17032",1742,1235,1224,6,11,"CNV",3
8,"8290",1534,1289,1284,9,5,"CNV",0
17,"17158",468,337,336,1,1,"CNV",0
8,"8270",18837,14541,14497,66,44,"CNV",4
8,"8239",460,380,378,2,2,"CNV",1
17,"17207",2411,2006,1992,8,14,"CNV",23
17,"17086",1745,1223,1210,7,13,"CNV",1
8,"8286",2919,2210,2199,15,11,"CNV",1
17,"17011",651,544,544,4,0,"CNV",0
43,"43008",307,202,200,1,2,"CNV",0
8,"8145",2701,2156,2144,7,12,"CNV",0
43,"43037",17902,12787,12695,63,92,"CNV",6
8,"8076",16497,12734,12667,82,67,"CNV",3
8,"8055",541,443,442,2,1,"CNV",0
8,"8268",971,746,737,3,9,"CNV",1
17,"17100",195,157,154,0,3,"CNV",0
43,"43078",843,653,644,4,9,"CNV",0
43,"43057",38,31,31,1,0,"CNV",0
43,"43139",1999,1552,1539,10,13,"CNV",0
8,"8115",3825,2994,2975,12,19,"CNV",0
8,"8124",37130,29069,28915,146,154,"CNV",10
17,"17066",27323,18373,18269,98,104,"CNV",13
8,"8248",5616,4378,4365,32,13,"CNV",0
17,"17112",194,154,152,2,2,"CNV",0
43,"43130",177,145,145,0,0,"CNV",0
8,"8063",467,406,405,3,1,"CNV",0
8,"8072",10699,8226,8193,45,33,"CNV",2
17,"17134",223,189,189,1,0,"CNV",1
8,"8300",5892,4912,4880,24,32,"CNV",1
3,"3095",4740,3702,3657,23,45,"COMPROMÍS 2",563
12,"12026",835,656,639,4,17,"COMPROMÍS 2",47
3,"3051",344,312,307,2,5,"COMPROMÍS 2",12
12,"12142",145,123,121,1,2,"COMPROMÍS 2",4
46,"46226",31,27,27,0,0,"COMPROMÍS 2",5
46,"46097",958,764,756,6,8,"COMPROMÍS 2",35
12,"12063",44,37,37,1,0,"COMPROMÍS 2",3
3,"3106",564,485,479,4,6,"COMPROMÍS 2",26
46,"46216",5252,4291,4263,23,28,"COMPROMÍS 2",291
46,"46107",1849,1501,1480,5,21,"COMPROMÍS 2",70
3,"3064",5004,3782,3736,20,46,"COMPROMÍS 2",49
46,"46183",6028,4620,4534,29,86,"COMPROMÍS 2",660
3,"3008",159,127,126,0,1,"COMPROMÍS 2",4
46,"46206",557,461,455,6,6,"COMPROMÍS 2",15
46,"46021",23977,18032,17879,125,153,"COMPROMÍS 2",847
46,"46155",993,785,772,2,13,"COMPROMÍS 2",104
46,"46119",752,627,614,8,13,"COMPROMÍS 2",120
46,"46241",389,318,313,4,5,"COMPROMÍS 2",26
12,"12072",1082,901,889,15,12,"COMPROMÍS 2",38
46,"46193",8964,7206,7156,27,50,"COMPROMÍS 2",631
46,"46231",2401,1780,1770,8,10,"COMPROMÍS 2",322
12,"12100",1281,1118,1102,5,16,"COMPROMÍS 2",56
46,"46017",32990,23940,23694,155,246,"COMPROMÍS 2",2906
12,"12129",1801,1382,1356,17,26,"COMPROMÍS 2",162
46,"46100",281,210,205,0,5,"COMPROMÍS 2",36
12,"12124",1840,1477,1460,8,17,"COMPROMÍS 2",59
12,"12103",90,75,70,1,5,"COMPROMÍS 2",2
3,"3023",1379,1216,1199,6,17,"COMPROMÍS 2",98
3,"3117",377,320,313,1,7,"COMPROMÍS 2",39
12,"12022",328,273,269,1,4,"COMPROMÍS 2",13
12,"12105",816,639,625,5,14,"COMPROMÍS 2",14
46,"46049",268,231,228,1,3,"COMPROMÍS 2",20
3,"3010",336,295,280,0,15,"COMPROMÍS 2",44
46,"46229",911,755,752,5,3,"COMPROMÍS 2",37
3,"3132",515,417,414,4,3,"COMPROMÍS 2",56
46,"46232",872,714,706,3,8,"COMPROMÍS 2",23
46,"46258",2636,2100,2079,9,21,"COMPROMÍS 2",74
46,"46013",17712,14181,14075,88,106,"COMPROMÍS 2",1195
46,"46051",8384,6550,6452,24,98,"COMPROMÍS 2",395
46,"46903",6285,5035,4996,27,39,"COMPROMÍS 2",286
46,"46140",377,312,312,2,0,"COMPROMÍS 2",69
3,"3140",26027,19805,19438,230,367,"COMPROMÍS 2",347
46,"46136",2619,2030,2003,24,27,"COMPROMÍS 2",92
12,"12053",2030,1656,1636,10,20,"COMPROMÍS 2",84
46,"46031",10521,7735,7607,62,128,"COMPROMÍS 2",1011
3,"3035",632,529,525,2,4,"COMPROMÍS 2",38
46,"46255",3209,2415,2381,18,34,"COMPROMÍS 2",374
46,"46138",360,305,303,2,2,"COMPROMÍS 2",26
46,"46170",3408,2769,2720,16,49,"COMPROMÍS 2",151
46,"46084",1503,1225,1195,1,30,"COMPROMÍS 2",157
46,"46073",1077,867,862,10,5,"COMPROMÍS 2",40
46,"46132",2196,1877,1853,10,24,"COMPROMÍS 2",219
46,"46172",5412,3878,3832,18,46,"COMPROMÍS 2",276
3,"3119",17223,13244,13116,75,128,"COMPROMÍS 2",403
46,"46233",3781,2901,2847,22,54,"COMPROMÍS 2",262
46,"46162",1177,954,938,4,16,"COMPROMÍS 2",66
12,"12132",484,415,412,4,3,"COMPROMÍS 2",62
12,"12071",1267,1021,1006,11,15,"COMPROMÍS 2",28
46,"46103",1338,1056,1042,5,14,"COMPROMÍS 2",159
3,"3130",43,23,23,0,0,"COMPROMÍS 2",3
3,"3118",2426,1741,1718,8,23,"COMPROMÍS 2",26
46,"46222",394,325,324,1,1,"COMPROMÍS 2",64
46,"46131",49504,37495,37064,259,431,"COMPROMÍS 2",3391
46,"46006",4468,3731,3683,22,48,"COMPROMÍS 2",585
46,"46203",3544,2851,2810,21,41,"COMPROMÍS 2",474
46,"46195",1982,1562,1554,2,8,"COMPROMÍS 2",204
3,"3040",258,223,217,1,6,"COMPROMÍS 2",47
46,"46177",4778,3767,3711,17,56,"COMPROMÍS 2",344
3,"3088",5810,4380,4313,31,67,"COMPROMÍS 2",61
12,"12010",237,203,198,1,5,"COMPROMÍS 2",12
3,"3024",3948,3210,3164,14,46,"COMPROMÍS 2",12
46,"46108",426,346,342,1,4,"COMPROMÍS 2",3
12,"12113",87,65,64,0,1,"COMPROMÍS 2",3
46,"46182",1310,988,977,5,11,"COMPROMÍS 2",74
46,"46239",453,372,366,2,6,"COMPROMÍS 2",14
46,"46111",11326,8603,8492,55,111,"COMPROMÍS 2",561
12,"12037",17,17,17,1,0,"COMPROMÍS 2",4
46,"46186",19529,15294,15125,69,169,"COMPROMÍS 2",1078
12,"12070",499,434,430,3,4,"COMPROMÍS 2",42
12,"12011",4582,3511,3431,27,80,"COMPROMÍS 2",308
3,"3057",177,148,147,0,1,"COMPROMÍS 2",4
46,"46176",2045,1450,1434,12,16,"COMPROMÍS 2",121
3,"3011",8014,5870,5810,38,60,"COMPROMÍS 2",161
46,"46236",937,764,755,5,9,"COMPROMÍS 2",99
3,"3028",964,804,795,6,9,"COMPROMÍS 2",111
3,"3065",169399,128218,127256,967,962,"COMPROMÍS 2",2737
3,"3049",12143,9418,9302,47,116,"COMPROMÍS 2",52
3,"3045",213,178,173,4,5,"COMPROMÍS 2",14
46,"46261",1709,1367,1340,14,27,"COMPROMÍS 2",57
46,"46115",352,261,260,0,1,"COMPROMÍS 2",3
12,"12057",578,485,473,3,12,"COMPROMÍS 2",53
12,"12137",37,27,27,0,0,"COMPROMÍS 2",7
46,"46200",1848,1560,1539,6,21,"COMPROMÍS 2",210
12,"12085",5079,3504,3459,13,45,"COMPROMÍS 2",138
46,"46015",7477,5857,5808,33,49,"COMPROMÍS 2",593
12,"12006",174,149,149,2,0,"COMPROMÍS 2",7
3,"3056",8629,6838,6737,38,101,"COMPROMÍS 2",489
3,"3032",99,87,87,0,0,"COMPROMÍS 2",10
12,"12016",1550,1281,1260,11,21,"COMPROMÍS 2",52
3,"3022",137,122,119,0,3,"COMPROMÍS 2",10
3,"3016",91,77,77,1,0,"COMPROMÍS 2",5
12,"12001",1033,834,825,8,9,"COMPROMÍS 2",73
12,"12064",80,75,73,1,2,"COMPROMÍS 2",3
46,"46105",16132,11703,11582,64,121,"COMPROMÍS 2",1069
46,"46133",472,374,374,2,0,"COMPROMÍS 2",12
3,"3026",1316,1040,1024,5,16,"COMPROMÍS 2",105
12,"12031",3942,2976,2931,24,45,"COMPROMÍS 2",372
46,"46144",628,511,505,1,6,"COMPROMÍS 2",14
12,"12104",6814,5486,5406,35,80,"COMPROMÍS 2",132
46,"46242",330,279,279,0,0,"COMPROMÍS 2",4
46,"46050",186,157,154,1,3,"COMPROMÍS 2",10
12,"12046",182,161,161,1,0,"COMPROMÍS 2",10
3,"3044",4557,3650,3600,17,50,"COMPROMÍS 2",28
46,"46185",364,315,310,1,5,"COMPROMÍS 2",127
12,"12902",2248,1678,1653,7,25,"COMPROMÍS 2",75
3,"3061",1054,830,816,3,14,"COMPROMÍS 2",9
3,"3114",1581,1263,1237,9,26,"COMPROMÍS 2",36
46,"46145",22099,16685,16499,128,186,"COMPROMÍS 2",1419
3,"3070",2106,1554,1528,9,26,"COMPROMÍS 2",23
12,"12135",36194,27266,26961,192,305,"COMPROMÍS 2",1487
46,"46165",7298,5744,5697,38,47,"COMPROMÍS 2",449
3,"3055",5247,4042,3991,24,51,"COMPROMÍS 2",54
3,"3085",269,243,237,0,6,"COMPROMÍS 2",36
46,"46061",343,285,280,4,5,"COMPROMÍS 2",31
12,"12067",523,423,416,1,7,"COMPROMÍS 2",15
3,"3025",1292,1009,991,7,18,"COMPROMÍS 2",5
3,"3090",17881,13593,13437,108,156,"COMPROMÍS 2",387
12,"12083",89,73,71,1,2,"COMPROMÍS 2",1
46,"46199",5842,4451,4414,23,37,"COMPROMÍS 2",305
3,"3020",95,84,84,2,0,"COMPROMÍS 2",5
46,"46175",428,367,354,3,13,"COMPROMÍS 2",61
3,"3082",12936,9025,8931,57,94,"COMPROMÍS 2",579
46,"46197",1926,1473,1455,9,18,"COMPROMÍS 2",215
3,"3076",8736,6571,6467,40,104,"COMPROMÍS 2",116
3,"3109",2976,2375,2345,11,30,"COMPROMÍS 2",20
12,"12049",421,339,329,2,10,"COMPROMÍS 2",23
46,"46252",128,106,106,2,0,"COMPROMÍS 2",3
12,"12112",110,97,96,1,1,"COMPROMÍS 2",6
12,"12020",120,107,107,0,0,"COMPROMÍS 2",0
3,"3113",4342,3194,3154,23,40,"COMPROMÍS 2",54
12,"12084",17723,13501,13281,118,220,"COMPROMÍS 2",515
3,"3036",86,77,75,2,2,"COMPROMÍS 2",5
3,"3093",19713,15195,14988,108,207,"COMPROMÍS 2",450
3,"3073",222,200,196,3,4,"COMPROMÍS 2",16
46,"46086",80,69,69,0,0,"COMPROMÍS 2",19
46,"46104",1891,1515,1481,17,34,"COMPROMÍS 2",327
3,"3110",312,271,269,1,2,"COMPROMÍS 2",71
46,"46091",115,99,99,0,0,"COMPROMÍS 2",13
12,"12126",24347,19023,18749,152,274,"COMPROMÍS 2",1009
46,"46003",953,828,811,5,17,"COMPROMÍS 2",134
3,"3084",497,429,429,4,0,"COMPROMÍS 2",35
3,"3067",93,87,87,0,0,"COMPROMÍS 2",7
12,"12007",731,649,642,8,7,"COMPROMÍS 2",95
3,"3128",4295,3007,2982,24,25,"COMPROMÍS 2",306
46,"46016",1075,887,880,8,7,"COMPROMÍS 2",141
12,"12131",59,50,50,0,0,"COMPROMÍS 2",1
46,"46020",3792,3028,2973,11,55,"COMPROMÍS 2",322
12,"12075",107,89,87,0,2,"COMPROMÍS 2",15
46,"46149",344,260,256,2,4,"COMPROMÍS 2",13
12,"12051",448,324,319,2,5,"COMPROMÍS 2",15
46,"46071",470,382,366,0,16,"COMPROMÍS 2",16
3,"3021",5578,4720,4626,35,94,"COMPROMÍS 2",581
46,"46122",2730,2103,2071,19,32,"COMPROMÍS 2",220
46,"46169",32294,24909,24676,157,233,"COMPROMÍS 2",1289
46,"46048",3509,2758,2720,11,38,"COMPROMÍS 2",532
46,"46011",7523,5320,5235,28,85,"COMPROMÍS 2",709
46,"46230",14084,10694,10599,67,95,"COMPROMÍS 2",823
3,"3107",2769,2011,1986,10,25,"COMPROMÍS 2",144
46,"46125",846,681,675,1,6,"COMPROMÍS 2",94
12,"12040",118683,91285,90499,666,786,"COMPROMÍS 2",4237
46,"46240",206,175,169,2,6,"COMPROMÍS 2",23
46,"46110",21317,15839,15699,89,140,"COMPROMÍS 2",815
46,"46079",313,252,248,1,4,"COMPROMÍS 2",10
12,"12048",249,181,175,2,6,"COMPROMÍS 2",8
46,"46116",13608,10792,10731,76,61,"COMPROMÍS 2",618
46,"46059",1240,1038,1030,3,8,"COMPROMÍS 2",289
3,"3083",5487,3993,3934,28,59,"COMPROMÍS 2",227
12,"12003",943,745,731,6,14,"COMPROMÍS 2",50
3,"3080",1328,1077,1064,4,13,"COMPROMÍS 2",5
46,"46120",1183,958,936,3,22,"COMPROMÍS 2",70
12,"12042",574,486,479,8,7,"COMPROMÍS 2",10
46,"46069",157,130,129,0,1,"COMPROMÍS 2",14
46,"46035",6855,5500,5422,34,78,"COMPROMÍS 2",605
46,"46215",1397,1104,1093,12,11,"COMPROMÍS 2",225
46,"46171",16429,12527,12373,61,154,"COMPROMÍS 2",1067
12,"12069",53,45,44,1,1,"COMPROMÍS 2",3
3,"3050",19334,14377,14253,71,124,"COMPROMÍS 2",509
46,"46121",111,96,94,2,2,"COMPROMÍS 2",11
46,"46047",532,447,441,4,6,"COMPROMÍS 2",61
3,"3099",42876,32576,32172,192,404,"COMPROMÍS 2",377
3,"3034",1391,1107,1090,7,17,"COMPROMÍS 2",14
46,"46151",757,586,579,0,7,"COMPROMÍS 2",61
3,"3047",9711,6910,6791,36,119,"COMPROMÍS 2",284
12,"12107",351,312,306,1,6,"COMPROMÍS 2",5
46,"46074",2678,2158,2135,13,23,"COMPROMÍS 2",233
46,"46124",785,680,675,5,5,"COMPROMÍS 2",177
12,"12058",64,56,56,0,0,"COMPROMÍS 2",1
46,"46246",1042,860,838,2,22,"COMPROMÍS 2",49
12,"12012",2613,2217,2180,6,37,"COMPROMÍS 2",39
12,"12116",67,57,57,0,0,"COMPROMÍS 2",1
12,"12111",334,283,279,4,4,"COMPROMÍS 2",21
46,"46250",581614,454786,451184,2675,3602,"COMPROMÍS 2",35131
46,"46196",140,115,114,0,1,"COMPROMÍS 2",5
46,"46075",147,136,134,2,2,"COMPROMÍS 2",18
12,"12009",17859,13054,12911,98,143,"COMPROMÍS 2",659
46,"46092",263,182,179,1,3,"COMPROMÍS 2",7
3,"3078",474,372,371,2,1,"COMPROMÍS 2",7
46,"46189",473,412,408,2,4,"COMPROMÍS 2",99
12,"12088",57,54,54,0,0,"COMPROMÍS 2",2
46,"46187",1304,991,982,8,9,"COMPROMÍS 2",155
12,"12027",17473,12829,12683,90,146,"COMPROMÍS 2",725
46,"46106",1466,1156,1142,3,14,"COMPROMÍS 2",46
12,"12074",761,659,645,7,14,"COMPROMÍS 2",21
46,"46201",62,47,47,0,0,"COMPROMÍS 2",2
46,"46058",1734,1349,1325,9,24,"COMPROMÍS 2",123
12,"12039",792,688,680,3,8,"COMPROMÍS 2",17
3,"3127",351,290,277,2,13,"COMPROMÍS 2",25
12,"12004",4177,3225,3187,13,38,"COMPROMÍS 2",296
12,"12087",25,19,18,2,1,"COMPROMÍS 2",0
46,"46029",20423,15450,15274,100,176,"COMPROMÍS 2",1755
46,"46009",3140,2582,2536,14,46,"COMPROMÍS 2",331
3,"3077",1374,1131,1114,9,17,"COMPROMÍS 2",24
46,"46019",8948,7150,7067,40,83,"COMPROMÍS 2",762
12,"12098",533,446,440,4,6,"COMPROMÍS 2",22
46,"46202",17660,13782,13645,93,137,"COMPROMÍS 2",1212
46,"46212",1590,1209,1192,4,17,"COMPROMÍS 2",162
46,"46083",15374,11259,11096,56,163,"COMPROMÍS 2",1410
46,"46181",16908,12749,12597,82,152,"COMPROMÍS 2",1795
12,"12125",222,189,187,0,2,"COMPROMÍS 2",4
46,"46254",943,751,734,4,17,"COMPROMÍS 2",7
3,"3054",336,277,272,2,5,"COMPROMÍS 2",22
46,"46198",871,707,693,4,14,"COMPROMÍS 2",162
46,"46148",1509,1208,1195,7,13,"COMPROMÍS 2",50
3,"3074",1750,1433,1427,3,6,"COMPROMÍS 2",16
3,"3014",238879,176118,174768,1105,1350,"COMPROMÍS 2",3207
3,"3071",3988,3125,3088,28,37,"COMPROMÍS 2",546
12,"12018",283,242,235,0,7,"COMPROMÍS 2",8
46,"46081",9993,7972,7882,51,90,"COMPROMÍS 2",937
46,"46213",15504,11420,11232,124,188,"COMPROMÍS 2",239
3,"3097",996,833,816,4,17,"COMPROMÍS 2",221
12,"12073",132,110,107,1,3,"COMPROMÍS 2",3
3,"3005",7903,6247,6195,37,52,"COMPROMÍS 2",64
46,"46098",2403,1807,1772,8,35,"COMPROMÍS 2",460
46,"46139",4512,3612,3567,25,45,"COMPROMÍS 2",648
12,"12055",106,85,83,2,2,"COMPROMÍS 2",12
46,"46076",591,497,487,0,10,"COMPROMÍS 2",27
12,"12134",135,102,100,0,2,"COMPROMÍS 2",9
46,"46156",2024,1642,1628,7,14,"COMPROMÍS 2",153
3,"3116",1159,901,884,3,17,"COMPROMÍS 2",51
12,"12013",137,113,113,0,0,"COMPROMÍS 2",10
3,"3115",255,222,221,2,1,"COMPROMÍS 2",19
46,"46150",1797,1275,1257,9,18,"COMPROMÍS 2",97
3,"3125",336,259,257,1,2,"COMPROMÍS 2",48
46,"46078",28394,20928,20748,156,180,"COMPROMÍS 2",1205
12,"12130",420,345,341,0,4,"COMPROMÍS 2",9
46,"46164",12073,8987,8836,63,151,"COMPROMÍS 2",638
3,"3039",89,70,70,0,0,"COMPROMÍS 2",6
3,"3053",7469,5950,5865,26,85,"COMPROMÍS 2",439
46,"46211",1837,1490,1462,11,28,"COMPROMÍS 2",157
46,"46253",114,85,85,2,0,"COMPROMÍS 2",12
12,"12122",767,655,646,3,9,"COMPROMÍS 2",64
3,"3066",41802,31046,30696,285,350,"COMPROMÍS 2",500
3,"3134",141,119,117,0,2,"COMPROMÍS 2",14
46,"46063",1783,1368,1345,9,23,"COMPROMÍS 2",180
12,"12141",92,81,81,0,0,"COMPROMÍS 2",2
46,"46174",949,789,770,4,19,"COMPROMÍS 2",143
12,"12008",224,197,194,1,3,"COMPROMÍS 2",3
3,"3030",563,474,466,2,8,"COMPROMÍS 2",63
46,"46060",9287,7184,7110,40,74,"COMPROMÍS 2",704
46,"46178",4943,3684,3641,21,43,"COMPROMÍS 2",214
46,"46053",537,459,457,2,2,"COMPROMÍS 2",72
12,"12028",12955,10391,10301,68,90,"COMPROMÍS 2",456
12,"12089",4546,3353,3304,12,49,"COMPROMÍS 2",210
12,"12079",419,346,336,2,10,"COMPROMÍS 2",10
46,"46034",1811,1407,1389,13,18,"COMPROMÍS 2",247
46,"46088",150,129,127,0,2,"COMPROMÍS 2",10
3,"3111",5565,4183,4149,29,34,"COMPROMÍS 2",34
12,"12082",9573,7672,7570,55,102,"COMPROMÍS 2",425
12,"12061",380,277,274,2,3,"COMPROMÍS 2",31
46,"46142",761,580,565,4,15,"COMPROMÍS 2",20
46,"46027",932,769,755,1,14,"COMPROMÍS 2",65
46,"46210",344,265,258,2,7,"COMPROMÍS 2",35
3,"3100",496,402,395,2,7,"COMPROMÍS 2",56
46,"46038",307,243,241,0,2,"COMPROMÍS 2",18
12,"12092",126,108,106,1,2,"COMPROMÍS 2",4
46,"46180",651,525,519,0,6,"COMPROMÍS 2",106
46,"46130",857,680,669,6,11,"COMPROMÍS 2",111
12,"12093",165,128,126,0,2,"COMPROMÍS 2",7
12,"12109",653,544,533,3,11,"COMPROMÍS 2",20
46,"46221",345,294,294,0,0,"COMPROMÍS 2",67
46,"46207",6686,5220,5137,36,83,"COMPROMÍS 2",499
46,"46159",23051,17496,17359,104,137,"COMPROMÍS 2",1091
3,"3031",41857,28648,28362,163,286,"COMPROMÍS 2",573
46,"46012",929,727,707,3,20,"COMPROMÍS 2",27
46,"46244",59626,44018,43679,342,339,"COMPROMÍS 2",2106
12,"12097",65,54,54,1,0,"COMPROMÍS 2",3
3,"3098",518,412,400,1,12,"COMPROMÍS 2",30
12,"12052",539,453,439,5,14,"COMPROMÍS 2",21
3,"3131",179,147,139,0,8,"COMPROMÍS 2",22
46,"46033",196,169,168,3,1,"COMPROMÍS 2",33
12,"12005",8052,6056,5935,50,121,"COMPROMÍS 2",300
46,"46191",1949,1541,1505,7,36,"COMPROMÍS 2",67
3,"3027",172,156,153,0,3,"COMPROMÍS 2",10
46,"46043",135,119,116,1,3,"COMPROMÍS 2",13
3,"3904",1420,1112,1095,5,17,"COMPROMÍS 2",4
46,"46141",437,367,360,5,7,"COMPROMÍS 2",17
12,"12060",430,368,365,1,3,"COMPROMÍS 2",19
3,"3037",341,289,284,1,5,"COMPROMÍS 2",20
12,"12110",219,168,166,1,2,"COMPROMÍS 2",4
46,"46157",2960,2329,2296,12,33,"COMPROMÍS 2",311
46,"46054",11390,8717,8604,52,113,"COMPROMÍS 2",577
46,"46030",796,653,633,7,20,"COMPROMÍS 2",38
46,"46118",3670,2930,2894,25,36,"COMPROMÍS 2",166
3,"3081",1494,1163,1141,5,22,"COMPROMÍS 2",220
3,"3133",41499,26593,26308,151,285,"COMPROMÍS 2",313
3,"3902",10578,7654,7530,56,124,"COMPROMÍS 2",54
3,"3139",23061,16378,16178,128,200,"COMPROMÍS 2",807
12,"12114",194,161,160,2,1,"COMPROMÍS 2",5
46,"46158",1040,805,796,4,9,"COMPROMÍS 2",46
3,"3096",5779,4433,4352,30,81,"COMPROMÍS 2",272
46,"46249",9159,7113,7012,73,101,"COMPROMÍS 2",101
3,"3068",42,40,40,3,0,"COMPROMÍS 2",0
3,"3086",166,143,143,1,0,"COMPROMÍS 2",8
3,"3007",169,145,141,0,4,"COMPROMÍS 2",21
12,"12024",133,117,117,0,0,"COMPROMÍS 2",3
12,"12106",1163,980,951,7,29,"COMPROMÍS 2",18
46,"46068",345,308,307,4,1,"COMPROMÍS 2",47
46,"46143",4230,3255,3200,20,55,"COMPROMÍS 2",513
3,"3046",1619,1213,1190,17,23,"COMPROMÍS 2",54
46,"46173",1319,1084,1062,6,22,"COMPROMÍS 2",138
12,"12140",1140,936,922,7,14,"COMPROMÍS 2",29
3,"3075",149,125,125,0,0,"COMPROMÍS 2",4
12,"12127",67,50,50,1,0,"COMPROMÍS 2",8
3,"3019",15465,12156,11988,80,168,"COMPROMÍS 2",171
46,"46224",154,124,124,2,0,"COMPROMÍS 2",13
12,"12068",41,26,25,1,1,"COMPROMÍS 2",3
3,"3901",1109,827,820,5,7,"COMPROMÍS 2",126
12,"12094",875,694,682,2,12,"COMPROMÍS 2",60
46,"46257",5428,4237,4190,23,47,"COMPROMÍS 2",835
46,"46225",348,279,273,2,6,"COMPROMÍS 2",39
46,"46080",985,799,788,5,11,"COMPROMÍS 2",15
46,"46134",2380,1836,1825,5,11,"COMPROMÍS 2",114
46,"46022",15325,11197,11072,70,125,"COMPROMÍS 2",639
46,"46037",1109,927,918,4,9,"COMPROMÍS 2",149
46,"46128",1581,1324,1287,2,37,"COMPROMÍS 2",264
12,"12101",356,297,289,2,8,"COMPROMÍS 2",6
3,"3006",494,413,409,1,4,"COMPROMÍS 2",95
3,"3013",1070,882,869,3,13,"COMPROMÍS 2",18
46,"46248",4886,3672,3613,25,59,"COMPROMÍS 2",215
3,"3105",5471,4099,4003,14,96,"COMPROMÍS 2",56
46,"46902",356,300,296,8,4,"COMPROMÍS 2",8
46,"46007",12284,9370,9265,65,105,"COMPROMÍS 2",615
46,"46179",2116,1723,1678,18,45,"COMPROMÍS 2",85
12,"12117",3545,2770,2698,11,72,"COMPROMÍS 2",318
3,"3135",192,157,155,0,2,"COMPROMÍS 2",20
3,"3004",599,465,458,4,7,"COMPROMÍS 2",18
46,"46243",124,105,104,0,1,"COMPROMÍS 2",15
12,"12102",521,442,434,2,8,"COMPROMÍS 2",19
3,"3001",345,285,282,1,3,"COMPROMÍS 2",55
46,"46014",3130,2488,2462,7,26,"COMPROMÍS 2",268
46,"46220",48968,35430,34964,306,466,"COMPROMÍS 2",2321
3,"3122",43704,31952,31681,218,271,"COMPROMÍS 2",780
46,"46039",2121,1730,1698,19,32,"COMPROMÍS 2",102
46,"46082",4958,3801,3759,21,42,"COMPROMÍS 2",271
46,"46065",1576,1246,1228,6,18,"COMPROMÍS 2",184
46,"46237",7148,5537,5472,36,65,"COMPROMÍS 2",348
46,"46085",11075,8106,8011,54,95,"COMPROMÍS 2",946
3,"3091",241,201,196,0,5,"COMPROMÍS 2",12
3,"3058",4967,4031,3967,24,64,"COMPROMÍS 2",36
46,"46166",8202,6482,6399,39,83,"COMPROMÍS 2",839
3,"3059",20590,15909,15766,96,143,"COMPROMÍS 2",1391
46,"46194",15813,11654,11511,83,143,"COMPROMÍS 2",938
46,"46163",1856,1522,1501,4,21,"COMPROMÍS 2",215
3,"3063",27121,19869,19713,131,156,"COMPROMÍS 2",1358
46,"46245",528,430,426,2,4,"COMPROMÍS 2",37
12,"12115",208,170,167,1,3,"COMPROMÍS 2",5
46,"46263",239,204,200,3,4,"COMPROMÍS 2",7
46,"46023",328,277,269,1,8,"COMPROMÍS 2",32
3,"3102",7226,5600,5516,28,84,"COMPROMÍS 2",953
46,"46114",574,457,452,1,5,"COMPROMÍS 2",22
46,"46147",17133,12260,12120,59,140,"COMPROMÍS 2",933
46,"46113",2527,1906,1892,12,14,"COMPROMÍS 2",244
46,"46067",1744,1451,1432,4,19,"COMPROMÍS 2",85
12,"12021",4377,3528,3473,23,55,"COMPROMÍS 2",421
12,"12119",137,107,104,1,3,"COMPROMÍS 2",3
3,"3094",9626,7206,7138,42,68,"COMPROMÍS 2",231
3,"3012",1133,910,897,7,13,"COMPROMÍS 2",8
46,"46208",1070,875,866,2,9,"COMPROMÍS 2",140
3,"3015",12807,9782,9634,63,148,"COMPROMÍS 2",90
12,"12014",167,131,127,1,4,"COMPROMÍS 2",11
46,"46064",525,427,424,4,3,"COMPROMÍS 2",57
46,"46219",122,105,104,0,1,"COMPROMÍS 2",7
46,"46188",693,591,585,3,6,"COMPROMÍS 2",141
46,"46251",2442,2017,1976,9,41,"COMPROMÍS 2",242
12,"12043",560,460,450,2,10,"COMPROMÍS 2",17
12,"12120",161,138,138,0,0,"COMPROMÍS 2",2
12,"12139",302,219,217,3,2,"COMPROMÍS 2",42
3,"3129",1218,994,982,5,12,"COMPROMÍS 2",42
46,"46028",388,324,319,1,5,"COMPROMÍS 2",23
12,"12036",546,428,420,9,8,"COMPROMÍS 2",11
46,"46045",1243,1033,1018,3,15,"COMPROMÍS 2",121
46,"46154",797,645,630,1,15,"COMPROMÍS 2",61
46,"46214",16415,12723,12610,74,113,"COMPROMÍS 2",791
46,"46167",345,255,255,0,0,"COMPROMÍS 2",7
46,"46018",567,483,479,3,4,"COMPROMÍS 2",27
46,"46099",772,620,614,1,6,"COMPROMÍS 2",52
12,"12121",1044,941,915,4,26,"COMPROMÍS 2",26
46,"46129",512,408,400,4,8,"COMPROMÍS 2",4
12,"12044",452,403,400,4,3,"COMPROMÍS 2",11
12,"12108",438,382,379,4,3,"COMPROMÍS 2",34
46,"46052",508,436,426,3,10,"COMPROMÍS 2",24
46,"46123",1948,1469,1446,5,23,"COMPROMÍS 2",273
46,"46228",2417,1953,1913,13,40,"COMPROMÍS 2",140
46,"46093",2134,1700,1687,8,13,"COMPROMÍS 2",167
12,"12099",586,449,434,3,15,"COMPROMÍS 2",18
3,"3120",2421,1823,1786,9,37,"COMPROMÍS 2",23
46,"46094",20691,15841,15672,88,169,"COMPROMÍS 2",1360
12,"12050",1230,987,972,10,15,"COMPROMÍS 2",59
12,"12078",333,238,235,1,3,"COMPROMÍS 2",4
3,"3123",7576,5900,5814,36,86,"COMPROMÍS 2",74
46,"46026",1202,1012,997,1,15,"COMPROMÍS 2",191
3,"3002",3631,2841,2801,16,40,"COMPROMÍS 2",159
46,"46066",1285,1058,1043,6,15,"COMPROMÍS 2",126
46,"46168",1982,1543,1522,5,21,"COMPROMÍS 2",194
46,"46153",435,364,356,1,8,"COMPROMÍS 2",82
46,"46260",2647,2136,2113,8,23,"COMPROMÍS 2",237
3,"3018",12439,9387,9283,50,104,"COMPROMÍS 2",951
12,"12041",100,76,75,0,1,"COMPROMÍS 2",2
46,"46070",17700,13558,13437,115,121,"COMPROMÍS 2",1162
46,"46209",1901,1517,1500,5,17,"COMPROMÍS 2",169
3,"3092",6688,5444,5370,36,74,"COMPROMÍS 2",670
3,"3048",4971,3808,3739,19,69,"COMPROMÍS 2",369
3,"3038",335,275,267,1,8,"COMPROMÍS 2",12
46,"46041",327,251,250,2,1,"COMPROMÍS 2",21
46,"46152",87,69,69,0,0,"COMPROMÍS 2",2
3,"3089",9497,6952,6794,55,158,"COMPROMÍS 2",197
12,"12076",76,64,64,1,0,"COMPROMÍS 2",3
12,"12017",148,120,116,0,4,"COMPROMÍS 2",1
46,"46042",3348,2825,2774,11,51,"COMPROMÍS 2",317
3,"3033",102,87,85,0,2,"COMPROMÍS 2",3
46,"46096",257,220,217,0,3,"COMPROMÍS 2",14
12,"12029",673,566,556,3,10,"COMPROMÍS 2",45
46,"46109",6174,4763,4639,30,124,"COMPROMÍS 2",240
46,"46204",6657,5262,5204,27,58,"COMPROMÍS 2",406
46,"46112",542,460,454,0,6,"COMPROMÍS 2",18
12,"12133",60,53,52,1,1,"COMPROMÍS 2",2
12,"12045",328,275,271,2,4,"COMPROMÍS 2",29
46,"46190",50023,37273,36976,250,297,"COMPROMÍS 2",2040
46,"46117",500,407,399,1,8,"COMPROMÍS 2",26
46,"46025",2455,2002,1981,6,21,"COMPROMÍS 2",213
3,"3041",6093,4444,4398,13,46,"COMPROMÍS 2",473
12,"12081",602,488,481,0,7,"COMPROMÍS 2",11
12,"12096",744,588,580,7,8,"COMPROMÍS 2",31
46,"46062",4572,3571,3510,20,61,"COMPROMÍS 2",448
12,"12056",257,218,216,1,2,"COMPROMÍS 2",5
46,"46090",1633,1413,1392,5,21,"COMPROMÍS 2",192
46,"46235",21270,15754,15592,101,162,"COMPROMÍS 2",3519
3,"3003",455,395,388,0,7,"COMPROMÍS 2",60
46,"46046",884,654,643,3,11,"COMPROMÍS 2",120
12,"12128",1362,1099,1076,9,23,"COMPROMÍS 2",105
46,"46238",13105,9717,9610,57,107,"COMPROMÍS 2",1873
12,"12123",43,35,34,1,1,"COMPROMÍS 2",2
3,"3138",3183,2390,2359,16,31,"COMPROMÍS 2",259
46,"46077",7344,5873,5761,49,112,"COMPROMÍS 2",162
46,"46234",327,264,263,5,1,"COMPROMÍS 2",15
12,"12034",1400,1108,1080,7,28,"COMPROMÍS 2",60
46,"46102",19635,15330,15207,95,123,"COMPROMÍS 2",948
46,"46135",9827,7928,7883,44,45,"COMPROMÍS 2",637
3,"3137",657,484,480,5,4,"COMPROMÍS 2",75
46,"46101",816,696,687,3,9,"COMPROMÍS 2",105
46,"46192",790,599,586,8,13,"COMPROMÍS 2",82
3,"3017",379,321,311,1,10,"COMPROMÍS 2",20
46,"46057",474,319,313,1,6,"COMPROMÍS 2",46
12,"12002",115,99,97,0,2,"COMPROMÍS 2",22
46,"46247",961,695,687,3,8,"COMPROMÍS 2",42
3,"3121",21787,15670,15453,81,217,"COMPROMÍS 2",341
12,"12033",1951,1528,1506,10,22,"COMPROMÍS 2",115
12,"12138",19179,14217,14006,124,211,"COMPROMÍS 2",715
46,"46087",109,98,98,1,0,"COMPROMÍS 2",2
46,"46024",444,339,335,1,4,"COMPROMÍS 2",16
3,"3112",637,526,520,0,6,"COMPROMÍS 2",34
3,"3079",18403,14632,14382,114,250,"COMPROMÍS 2",487
12,"12077",4790,3594,3565,39,29,"COMPROMÍS 2",214
12,"12059",228,191,188,0,3,"COMPROMÍS 2",5
46,"46146",1641,1314,1281,11,33,"COMPROMÍS 2",348
46,"46160",1907,1508,1485,5,23,"COMPROMÍS 2",352
3,"3069",3311,2356,2327,12,29,"COMPROMÍS 2",80
12,"12091",176,131,130,0,1,"COMPROMÍS 2",9
3,"3042",1462,1025,1008,3,17,"COMPROMÍS 2",96
46,"46056",175,156,156,3,0,"COMPROMÍS 2",26
3,"3043",2899,2466,2434,21,32,"COMPROMÍS 2",208
12,"12032",23649,17680,17505,118,175,"COMPROMÍS 2",889
46,"46032",5692,4518,4476,22,42,"COMPROMÍS 2",356
3,"3062",221,182,180,1,2,"COMPROMÍS 2",14
3,"3029",244,174,167,1,7,"COMPROMÍS 2",13
3,"3060",106,84,84,0,0,"COMPROMÍS 2",7
3,"3101",4911,3827,3772,20,55,"COMPROMÍS 2",754
46,"46256",7211,5263,5209,27,54,"COMPROMÍS 2",408
12,"12136",2606,2262,2223,17,39,"COMPROMÍS 2",98
12,"12065",171,150,147,0,3,"COMPROMÍS 2",4
12,"12118",76,64,63,0,1,"COMPROMÍS 2",1
46,"46055",1284,1031,1021,2,10,"COMPROMÍS 2",189
12,"12038",156,110,109,1,1,"COMPROMÍS 2",2
46,"46040",995,807,794,7,13,"COMPROMÍS 2",125
46,"46095",578,467,458,1,9,"COMPROMÍS 2",9
46,"46223",7781,6057,5995,42,62,"COMPROMÍS 2",451
12,"12095",950,763,756,9,7,"COMPROMÍS 2",32
46,"46227",888,708,693,6,15,"COMPROMÍS 2",108
46,"46161",1472,1200,1172,7,28,"COMPROMÍS 2",103
46,"46089",2170,1692,1672,6,20,"COMPROMÍS 2",207
3,"3136",410,329,323,3,6,"COMPROMÍS 2",51
46,"46904",805,643,628,13,15,"COMPROMÍS 2",103
46,"46126",5574,4565,4528,25,37,"COMPROMÍS 2",586
12,"12090",104,85,83,1,2,"COMPROMÍS 2",1
3,"3072",348,297,295,2,2,"COMPROMÍS 2",44
46,"46217",893,733,723,6,10,"COMPROMÍS 2",119
46,"46005",23013,17487,17286,112,201,"COMPROMÍS 2",1005
46,"46137",242,200,200,3,0,"COMPROMÍS 2",33
46,"46004",1919,1641,1616,14,25,"COMPROMÍS 2",419
46,"46036",558,391,379,2,12,"COMPROMÍS 2",23
46,"46262",213,170,165,1,5,"COMPROMÍS 2",6
46,"46205",14233,11274,11145,55,129,"COMPROMÍS 2",763
3,"3103",245,212,211,4,1,"COMPROMÍS 2",14
3,"3903",2577,1996,1973,11,23,"COMPROMÍS 2",15
46,"46184",26453,21076,20810,172,266,"COMPROMÍS 2",2630
46,"46002",1215,963,959,5,4,"COMPROMÍS 2",202
46,"46259",462,395,394,2,1,"COMPROMÍS 2",7
46,"46127",2740,2174,2147,11,27,"COMPROMÍS 2",337
46,"46010",950,727,718,6,9,"COMPROMÍS 2",53
46,"46001",783,612,607,4,5,"COMPROMÍS 2",21
12,"12901",3357,2693,2675,19,18,"COMPROMÍS 2",153
12,"12025",121,102,99,0,3,"COMPROMÍS 2",11
12,"12080",1900,1604,1575,10,29,"COMPROMÍS 2",87
46,"46008",2624,2036,1996,9,40,"COMPROMÍS 2",376
12,"12015",114,99,98,0,1,"COMPROMÍS 2",34
46,"46072",3542,3008,2961,33,47,"COMPROMÍS 2",509
46,"46044",4198,3399,3337,13,62,"COMPROMÍS 2",64
3,"3009",46121,36093,35720,235,373,"COMPROMÍS 2",1733
3,"3124",460,401,390,2,11,"COMPROMÍS 2",80
46,"46218",1031,907,885,6,22,"COMPROMÍS 2",206
3,"3052",967,805,790,4,15,"COMPROMÍS 2",43
3,"3104",27091,21366,21119,250,247,"COMPROMÍS 2",382
52,"52001",54124,34068,33749,237,319,"CpM",6857
28,"28109",1622,1205,1192,3,13,"Cs",245
9,"9330",1480,1180,1161,8,19,"Cs",258
50,"50108",52,43,42,0,1,"Cs",6
4,"4059",1025,742,731,3,11,"Cs",79
45,"45022",393,290,288,3,2,"Cs",33
26,"26071",8662,6409,6288,52,121,"Cs",1014
37,"37374",1147,946,923,4,23,"Cs",122
3,"3050",19334,14377,14253,71,124,"Cs",2979
45,"45185",7600,6094,5999,19,95,"Cs",1129
49,"49090",193,153,151,0,2,"Cs",19
9,"9438",561,485,473,6,12,"Cs",113
37,"37170",1370,1009,990,10,19,"Cs",215
7,"7021",230,183,178,3,5,"Cs",24
16,"16024",123,96,95,0,1,"Cs",18
37,"37005",67,48,48,2,0,"Cs",2
4,"4103",1439,1120,1108,16,12,"Cs",144
46,"46086",80,69,69,0,0,"Cs",2
3,"3027",172,156,153,0,3,"Cs",27
10,"10110",2224,1618,1559,5,59,"Cs",267
29,"29028",1224,875,858,4,17,"Cs",134
10,"10020",1576,1259,1225,9,34,"Cs",114
9,"9183",47,41,41,0,0,"Cs",3
15,"15057",12051,8814,8660,89,154,"Cs",1044
47,"47075",4775,3849,3784,38,65,"Cs",886
8,"8292",1062,835,831,3,4,"Cs",66
20,"20008",704,455,449,6,6,"Cs",0
9,"9429",55,41,41,0,0,"Cs",5
29,"29050",398,274,269,2,5,"Cs",47
34,"34098",783,614,605,3,9,"Cs",119
44,"44245",245,176,171,1,5,"Cs",30
19,"19212",674,528,519,2,9,"Cs",83
47,"47142",124,94,92,0,2,"Cs",14
42,"42004",2294,1807,1767,22,40,"Cs",271
9,"9159",61,52,51,0,1,"Cs",10
45,"45171",1326,1032,1013,6,19,"Cs",155
21,"21003",677,505,489,3,16,"Cs",28
9,"9018",24647,18982,18715,184,267,"Cs",4111
16,"16018",381,313,312,2,1,"Cs",36
40,"40121",249,196,193,4,3,"Cs",26
6,"6062",576,435,430,0,5,"Cs",11
13,"13007",1233,1005,967,11,38,"Cs",104
6,"6154",2799,2075,2022,15,53,"Cs",334
14,"14046",4443,3550,3486,38,64,"Cs",306
3,"3093",19713,15195,14988,108,207,"Cs",2993
47,"47019",91,74,73,0,1,"Cs",14
23,"23006",4582,3607,3543,32,64,"Cs",455
34,"34134",40,31,31,1,0,"Cs",0
9,"9024",150,116,114,0,2,"Cs",12
37,"37138",219,180,176,1,4,"Cs",26
5,"5246",52,39,39,0,0,"Cs",0
23,"23050",90596,69591,68903,460,688,"Cs",12871
2,"2074",5891,4435,4375,41,60,"Cs",712
48,"48049",545,448,448,0,0,"Cs",2
12,"12104",6814,5486,5406,35,80,"Cs",860
27,"27028",78798,58316,57546,629,770,"Cs",7286
50,"50192",233,189,183,0,6,"Cs",20
1,"1062",315,236,229,2,7,"Cs",19
39,"39037",2019,1572,1560,2,12,"Cs",185
29,"29070",43090,30294,29928,243,366,"Cs",6532
8,"8150",251,211,211,0,0,"Cs",11
50,"50135",88,74,74,3,0,"Cs",15
41,"41010",4573,3407,3345,27,62,"Cs",490
26,"26176",53,48,48,0,0,"Cs",15
6,"6036",4958,3785,3728,22,57,"Cs",728
6,"6040",987,747,739,6,8,"Cs",85
6,"6106",413,267,263,3,4,"Cs",44
46,"46261",1709,1367,1340,14,27,"Cs",136
34,"34062",150,108,107,1,1,"Cs",11
50,"50196",102,83,81,2,2,"Cs",11
49,"49127",2430,1835,1799,30,36,"Cs",363
49,"49272",77,55,51,0,4,"Cs",12
22,"22252",118,100,99,0,1,"Cs",25
41,"41065",22550,16215,16010,189,205,"Cs",2233
11,"11029",5423,3161,3105,55,56,"Cs",404
13,"13009",1397,1145,1123,4,22,"Cs",191
18,"18096",344,265,265,2,0,"Cs",19
20,"20016",1524,997,997,1,0,"Cs",7
26,"26057",51,47,47,1,0,"Cs",4
9,"9903",3139,2379,2352,27,27,"Cs",425
14,"14028",307,258,257,0,1,"Cs",26
46,"46063",1783,1368,1345,9,23,"Cs",178
37,"37103",414,309,309,4,0,"Cs",40
26,"26069",230,187,186,0,1,"Cs",22
37,"37067",3254,2742,2714,29,28,"Cs",708
50,"50175",924,713,710,9,3,"Cs",130
47,"47092",102,86,85,0,1,"Cs",15
44,"44082",89,72,69,0,3,"Cs",17
42,"42012",29,23,23,0,0,"Cs",2
3,"3115",255,222,221,2,1,"Cs",21
50,"50259",84,58,58,0,0,"Cs",11
40,"40166",253,214,213,1,1,"Cs",26
37,"37004",24,19,19,0,0,"Cs",1
37,"37291",269,212,209,2,3,"Cs",33
8,"8231",21132,15940,15880,75,60,"Cs",2184
37,"37056",40,33,33,0,0,"Cs",11
44,"44208",26,22,22,0,0,"Cs",4
28,"28122",570,457,448,3,9,"Cs",93
18,"18907",1774,1426,1415,10,11,"Cs",155
45,"45149",539,448,440,0,8,"Cs",69
18,"18076",790,607,604,1,3,"Cs",45
46,"46106",1466,1156,1142,3,14,"Cs",175
24,"24073",442,328,324,2,4,"Cs",51
40,"40190",48,40,39,0,1,"Cs",6
5,"5188",41,36,34,0,2,"Cs",5
37,"37115",110,81,81,2,0,"Cs",10
30,"30018",8326,6544,6438,25,106,"Cs",1017
34,"34047",1738,1439,1420,8,19,"Cs",229
19,"19243",36,32,31,0,1,"Cs",6
50,"50240",965,720,702,9,18,"Cs",146
10,"10126",1470,1114,1104,7,10,"Cs",142
22,"22109",266,207,205,3,2,"Cs",48
40,"40077",932,747,730,9,17,"Cs",174
16,"16277",109,82,82,0,0,"Cs",11
50,"50268",42,33,32,1,1,"Cs",7
46,"46108",426,346,342,1,4,"Cs",40
50,"50116",170,132,131,0,1,"Cs",20
38,"38047",1756,1276,1259,6,17,"Cs",147
12,"12074",761,659,645,7,14,"Cs",63
9,"9472",52,45,44,0,1,"Cs",9
12,"12051",448,324,319,2,5,"Cs",29
19,"19254",43,36,36,0,0,"Cs",4
46,"46019",8948,7150,7067,40,83,"Cs",785
28,"28174",1840,1363,1349,10,14,"Cs",273
9,"9200",58,40,40,0,0,"Cs",6
46,"46061",343,285,280,4,5,"Cs",55
9,"9197",137,108,107,0,1,"Cs",21
8,"8057",61,50,50,0,0,"Cs",1
5,"5060",109,88,88,0,0,"Cs",5
47,"47056",83,71,71,0,0,"Cs",12
44,"44227",72,61,61,0,0,"Cs",6
24,"24183",752,549,543,8,6,"Cs",89
13,"13097",2205,1764,1742,6,22,"Cs",249
37,"37282",194,148,146,1,2,"Cs",36
50,"50095",12136,9020,8928,99,92,"Cs",1354
49,"49094",213,138,138,0,0,"Cs",13
36,"36039",15610,11844,11592,103,252,"Cs",1281
37,"37178",99,82,82,0,0,"Cs",15
12,"12109",653,544,533,3,11,"Cs",66
6,"6117",1401,1089,1067,6,22,"Cs",178
3,"3061",1054,830,816,3,14,"Cs",186
19,"19230",548,437,430,1,7,"Cs",97
2,"2023",515,442,435,1,7,"Cs",48
3,"3100",496,402,395,2,7,"Cs",47
37,"37305",218,180,178,3,2,"Cs",27
37,"37074",140,107,106,1,1,"Cs",12
5,"5042",141,117,116,0,1,"Cs",13
37,"37100",77,60,59,1,1,"Cs",24
19,"19325",144,87,87,1,0,"Cs",4
45,"45006",1326,983,972,6,11,"Cs",125
1,"1036",14772,10850,10746,69,104,"Cs",241
9,"9208",179,130,127,1,3,"Cs",25
9,"9125",552,424,421,3,3,"Cs",67
2,"2011",578,461,459,2,2,"Cs",38
7,"7056",5245,3883,3841,32,42,"Cs",634
11,"11025",4388,3092,3045,30,47,"Cs",365
37,"37132",325,232,231,0,1,"Cs",12
12,"12068",41,26,25,1,1,"Cs",1
14,"14033",1265,994,985,9,9,"Cs",134
50,"50150",621,451,450,2,1,"Cs",81
45,"45131",264,226,225,0,1,"Cs",23
32,"32012",716,497,487,7,10,"Cs",37
29,"29008",15183,10716,10555,93,161,"Cs",2029
3,"3135",192,157,155,0,2,"Cs",7
40,"40182",173,126,124,1,2,"Cs",14
20,"20045",46866,33932,33700,191,232,"Cs",1656
37,"37152",402,308,302,1,6,"Cs",57
15,"15024",4346,3210,3151,19,59,"Cs",296
24,"24193",365,286,285,0,1,"Cs",36
27,"27032",3194,2268,2223,20,45,"Cs",201
40,"40174",324,254,250,2,4,"Cs",40
1,"1060",201,174,166,1,8,"Cs",11
37,"37092",1889,1459,1447,16,12,"Cs",427
42,"42115",95,77,77,1,0,"Cs",10
24,"24190",146,109,109,1,0,"Cs",9
49,"49135",588,409,405,0,4,"Cs",69
50,"50125",345,264,261,3,3,"Cs",36
10,"10030",472,323,318,1,5,"Cs",38
24,"24118",104,66,66,0,0,"Cs",6
23,"23904",2604,1727,1701,7,26,"Cs",233
22,"22040",144,124,120,1,4,"Cs",13
37,"37122",203,174,174,1,0,"Cs",37
49,"49255",396,324,323,3,1,"Cs",29
37,"37160",606,431,418,6,13,"Cs",59
4,"4067",520,387,379,1,8,"Cs",36
4,"4014",149,109,108,0,1,"Cs",11
50,"50281",68,55,52,0,3,"Cs",16
2,"2039",952,798,789,9,9,"Cs",96
18,"18077",471,372,366,5,6,"Cs",25
41,"41008",1040,840,822,4,18,"Cs",64
6,"6020",1739,1420,1387,5,33,"Cs",237
5,"5005",171,142,142,2,0,"Cs",39
15,"15079",1466,1076,1052,11,24,"Cs",51
13,"13018",766,644,634,0,10,"Cs",70
18,"18153",8796,6686,6594,59,92,"Cs",1324
23,"23038",3785,3182,3162,16,20,"Cs",578
9,"9071",40,32,32,0,0,"Cs",3
19,"19250",15,13,13,0,0,"Cs",4
6,"6059",1759,1300,1285,12,15,"Cs",214
34,"34009",30,26,26,0,0,"Cs",5
6,"6060",5723,4401,4323,31,78,"Cs",688
37,"37126",30,26,26,0,0,"Cs",3
42,"42205",85,64,62,0,2,"Cs",9
10,"10218",1083,810,796,3,14,"Cs",120
1,"1011",215,179,175,3,4,"Cs",12
16,"16197",66,45,45,0,0,"Cs",7
6,"6076",824,631,620,0,11,"Cs",47
47,"47138",219,182,177,1,5,"Cs",23
24,"24067",606,375,371,2,4,"Cs",73
32,"32046",1098,793,782,5,11,"Cs",57
11,"11007",18020,11346,11152,176,194,"Cs",2104
8,"8303",256,215,213,1,2,"Cs",7
10,"10028",82,60,59,0,1,"Cs",5
24,"24068",443,343,336,1,7,"Cs",32
8,"8216",25,19,19,0,0,"Cs",0
19,"19202",17,13,13,0,0,"Cs",2
37,"37289",218,159,158,0,1,"Cs",26
42,"42207",47,41,41,0,0,"Cs",15
37,"37288",276,225,224,5,1,"Cs",46
6,"6021",908,708,698,9,10,"Cs",82
50,"50104",326,264,259,4,5,"Cs",50
40,"40048",35,29,29,0,0,"Cs",2
18,"18018",554,457,451,0,6,"Cs",55
44,"44183",63,43,43,0,0,"Cs",9
5,"5176",223,173,166,2,7,"Cs",29
41,"41090",3507,2766,2694,15,72,"Cs",320
46,"46119",752,627,614,8,13,"Cs",78
3,"3024",3948,3210,3164,14,46,"Cs",447
9,"9316",108,89,89,0,0,"Cs",14
13,"13045",616,482,479,4,3,"Cs",78
40,"40158",15,13,13,1,0,"Cs",2
22,"22158",11951,8877,8801,69,76,"Cs",1821
8,"8089",34019,26317,26191,170,126,"Cs",3948
9,"9045",274,199,196,1,3,"Cs",38
44,"44226",124,87,83,2,4,"Cs",11
22,"22054",1617,1196,1183,15,13,"Cs",248
2,"2033",1870,1503,1463,11,40,"Cs",211
15,"15054",31802,22002,21676,368,326,"Cs",2869
18,"18171",2111,1679,1638,8,41,"Cs",197
9,"9372",204,176,175,1,1,"Cs",37
5,"5178",345,287,283,1,4,"Cs",38
7,"7013",7231,5372,5253,43,119,"Cs",697
33,"33065",1084,761,746,18,15,"Cs",140
15,"15091",1103,773,758,16,15,"Cs",55
44,"44148",76,64,63,0,1,"Cs",7
36,"36009",4445,3081,2997,26,84,"Cs",331
37,"37367",185,150,148,4,2,"Cs",26
8,"8102",28794,22420,22317,92,103,"Cs",1887
37,"37023",1586,1316,1298,12,18,"Cs",362
28,"28901",868,653,639,6,14,"Cs",101
46,"46003",953,828,811,5,17,"Cs",98
41,"41027",3966,2830,2784,32,46,"Cs",426
24,"24071",967,755,741,7,14,"Cs",102
50,"50261",205,171,167,1,4,"Cs",21
42,"42100",31,27,27,0,0,"Cs",5
18,"18045",1060,748,737,10,11,"Cs",80
48,"48073",6837,4950,4921,33,29,"Cs",27
3,"3136",410,329,323,3,6,"Cs",26
19,"19308",60,57,57,1,0,"Cs",4
34,"34108",502,424,415,6,9,"Cs",43
49,"49178",747,574,564,4,10,"Cs",140
37,"37368",17,15,11,0,4,"Cs",3
22,"22069",418,337,334,5,3,"Cs",91
24,"24042",61,47,47,1,0,"Cs",5
37,"37217",59,48,46,1,2,"Cs",5
12,"12012",2613,2217,2180,6,37,"Cs",247
37,"37071",76,67,67,0,0,"Cs",6
41,"41087",10496,7661,7477,57,184,"Cs",1299
16,"16198",1299,1044,1027,11,17,"Cs",149
50,"50203",1057,849,837,9,12,"Cs",163
19,"19241",35,24,23,2,1,"Cs",0
36,"36005",8122,5895,5776,65,119,"Cs",552
2,"2085",309,264,263,4,1,"Cs",24
29,"29018",1996,1523,1481,11,42,"Cs",239
19,"19218",45,34,34,1,0,"Cs",3
33,"33019",2882,1981,1939,8,42,"Cs",357
19,"19159",87,77,76,0,1,"Cs",6
45,"45039",208,176,176,0,0,"Cs",38
27,"27001",2209,1290,1251,25,39,"Cs",64
36,"36031",562,455,450,2,5,"Cs",46
22,"22083",445,379,372,5,7,"Cs",53
18,"18128",342,274,272,1,2,"Cs",17
37,"37309",37,27,27,0,0,"Cs",7
50,"50106",127,97,96,0,1,"Cs",12
14,"14040",3755,3047,3006,21,41,"Cs",350
23,"23042",317,234,232,1,2,"Cs",27
28,"28015",20440,17084,16953,103,131,"Cs",4737
44,"44066",87,66,65,0,1,"Cs",8
33,"33016",18904,14376,14235,168,141,"Cs",2522
19,"19247",142,118,117,2,1,"Cs",17
26,"26098",99,77,77,1,0,"Cs",6
46,"46104",1891,1515,1481,17,34,"Cs",128
49,"49084",268,226,223,9,3,"Cs",29
37,"37207",325,260,258,1,2,"Cs",65
37,"37307",148,110,107,2,3,"Cs",12
26,"26110",150,128,124,1,4,"Cs",10
37,"37070",528,422,417,2,5,"Cs",66
19,"19132",93,72,72,0,0,"Cs",11
6,"6128",4415,3345,3288,34,57,"Cs",493
44,"44070",55,45,45,0,0,"Cs",4
27,"27054",1145,907,890,5,17,"Cs",26
47,"47199",71,59,59,3,0,"Cs",10
18,"18905",15550,11394,11230,132,164,"Cs",2354
19,"19161",211,165,163,2,2,"Cs",17
28,"28144",6423,5274,5222,35,52,"Cs",1118
39,"39064",1341,1103,1094,5,9,"Cs",137
49,"49207",217,151,148,4,3,"Cs",20
46,"46219",122,105,104,0,1,"Cs",12
12,"12001",1033,834,825,8,9,"Cs",75
26,"26165",337,289,284,0,5,"Cs",41
37,"37086",104,88,88,0,0,"Cs",16
6,"6126",2142,1619,1594,9,25,"Cs",239
22,"22103",676,520,517,6,3,"Cs",127
46,"46177",4778,3767,3711,17,56,"Cs",509
9,"9039",56,44,44,0,0,"Cs",14
44,"44243",27,24,23,0,1,"Cs",6
37,"37198",203,163,162,3,1,"Cs",18
33,"33032",11086,8028,7849,129,179,"Cs",958
22,"22218",40,32,31,1,1,"Cs",7
18,"18906",911,722,716,4,6,"Cs",52
41,"41079",9293,7137,6979,80,158,"Cs",1106
13,"13034",58768,46017,45585,385,432,"Cs",9297
23,"23070",3808,2598,2565,34,33,"Cs",457
21,"21067",402,300,299,2,1,"Cs",33
19,"19219",9,7,7,0,0,"Cs",0
4,"4097",242,184,184,0,0,"Cs",15
50,"50010",66,56,55,2,1,"Cs",14
7,"7058",2857,2258,2233,18,25,"Cs",304
8,"8105",9724,7557,7505,49,52,"Cs",1150
46,"46182",1310,988,977,5,11,"Cs",146
9,"9458",484,408,401,5,7,"Cs",83
27,"27035",180,127,123,0,4,"Cs",6
10,"10168",320,209,202,1,7,"Cs",40
19,"19314",45,38,38,1,0,"Cs",5
18,"18194",2045,1394,1370,11,24,"Cs",216
18,"18161",251,222,220,1,2,"Cs",29
9,"9012",92,76,75,0,1,"Cs",8
50,"50026",421,340,328,4,12,"Cs",44
6,"6102",1019,852,842,2,10,"Cs",75
50,"50143",546,409,401,5,8,"Cs",74
47,"47151",28,22,22,0,0,"Cs",4
49,"49233",85,58,58,0,0,"Cs",8
16,"16901",630,498,492,4,6,"Cs",55
18,"18134",6069,4431,4345,30,86,"Cs",771
22,"22043",93,68,67,1,1,"Cs",8
8,"8065",1180,967,964,4,3,"Cs",34
42,"42097",14,7,7,0,0,"Cs",2
22,"22079",114,89,88,1,1,"Cs",15
9,"9202",22,22,22,2,0,"Cs",1
46,"46045",1243,1033,1018,3,15,"Cs",103
8,"8158",3108,2458,2453,13,5,"Cs",276
40,"40157",43,33,33,2,0,"Cs",3
47,"47111",998,806,795,6,11,"Cs",153
18,"18181",202,150,148,0,2,"Cs",8
50,"50008",5185,3753,3711,35,42,"Cs",738
38,"38017",30646,18576,18373,100,203,"Cs",2683
22,"22067",71,52,52,0,0,"Cs",2
44,"44035",105,86,84,1,2,"Cs",15
19,"19286",742,610,603,4,7,"Cs",86
9,"9169",97,86,85,0,1,"Cs",16
27,"27059",2055,1508,1471,13,37,"Cs",124
26,"26152",27,23,23,1,0,"Cs",4
39,"39013",535,434,431,1,3,"Cs",43
9,"9114",76,63,63,0,0,"Cs",15
48,"48025",860,694,694,3,0,"Cs",4
24,"24019",341,279,272,0,7,"Cs",29
37,"37121",556,448,444,3,4,"Cs",70
2,"2009",19456,15229,15007,152,222,"Cs",2624
3,"3120",2421,1823,1786,9,37,"Cs",317
34,"34230",17,13,13,0,0,"Cs",2
12,"12005",8052,6056,5935,50,121,"Cs",844
19,"19121",264,219,217,0,2,"Cs",13
8,"8271",67,57,57,0,0,"Cs",0
29,"29060",671,511,506,1,5,"Cs",77
18,"18164",1794,1225,1205,9,20,"Cs",209
49,"49035",222,195,195,2,0,"Cs",27
36,"36042",18072,13314,13091,130,223,"Cs",1382
10,"10032",1596,1263,1243,5,20,"Cs",179
4,"4058",342,256,256,0,0,"Cs",38
45,"45205",7342,5347,5275,30,72,"Cs",1084
24,"24029",695,521,520,4,1,"Cs",54
24,"24095",307,237,235,0,2,"Cs",32
19,"19171",5302,4297,4238,24,59,"Cs",763
10,"10060",935,670,658,4,12,"Cs",83
21,"21054",8157,6002,5869,60,133,"Cs",1010
9,"9243",73,57,55,0,2,"Cs",8
18,"18126",1450,1115,1087,11,28,"Cs",111
5,"5193",180,156,156,2,0,"Cs",16
21,"21018",1719,1167,1139,9,28,"Cs",122
19,"19213",70,53,52,0,1,"Cs",4
49,"49021",14258,10333,10206,102,127,"Cs",1868
37,"37381",139,97,95,1,2,"Cs",19
18,"18056",3418,2523,2478,22,45,"Cs",404
9,"9279",167,131,128,2,3,"Cs",33
27,"27030",3134,2209,2162,27,47,"Cs",94
9,"9428",103,86,86,0,0,"Cs",13
14,"14073",2772,2124,2069,18,55,"Cs",238
38,"38050",2436,1564,1529,12,35,"Cs",175
42,"42123",158,118,118,2,0,"Cs",16
20,"20053",4848,3479,3451,27,28,"Cs",68
42,"42034",44,36,36,1,0,"Cs",8
49,"49078",142,113,113,1,0,"Cs",11
12,"12036",546,428,420,9,8,"Cs",25
44,"44008",1565,1158,1138,8,20,"Cs",145
46,"46181",16908,12749,12597,82,152,"Cs",2085
42,"42118",21,13,13,1,0,"Cs",0
19,"19307",26,23,23,0,0,"Cs",3
27,"27011",2358,1582,1558,12,24,"Cs",98
20,"20051",6775,5124,5091,24,33,"Cs",89
10,"10159",317,241,240,0,1,"Cs",22
22,"22114",124,86,82,1,4,"Cs",15
19,"19239",91,64,63,1,1,"Cs",7
9,"9466",112,87,85,2,2,"Cs",11
34,"34042",292,244,243,3,1,"Cs",36
14,"14067",3870,3057,2998,24,59,"Cs",447
39,"39057",2367,1831,1796,14,35,"Cs",183
10,"10036",306,240,237,2,3,"Cs",11
40,"40198",24,20,20,0,0,"Cs",5
42,"42062",20,14,13,0,1,"Cs",1
19,"19262",123,98,97,0,1,"Cs",10
8,"8211",33731,27698,27561,126,137,"Cs",3958
23,"23091",679,575,571,3,4,"Cs",52
23,"23901",1139,946,934,3,12,"Cs",161
3,"3041",6093,4444,4398,13,46,"Cs",634
24,"24060",574,371,369,1,2,"Cs",68
9,"9905",389,308,303,2,5,"Cs",48
26,"26094",69,56,56,0,0,"Cs",7
24,"24164",362,221,220,1,1,"Cs",39
37,"37306",242,184,181,2,3,"Cs",42
9,"9135",40,34,34,0,0,"Cs",2
18,"18107",924,694,680,3,14,"Cs",52
22,"22230",288,229,228,3,1,"Cs",39
18,"18084",4458,3467,3417,17,50,"Cs",667
6,"6081",1042,825,811,4,14,"Cs",105
40,"40188",83,71,71,0,0,"Cs",9
34,"34069",2184,1737,1701,16,36,"Cs",281
19,"19099",289,217,214,0,3,"Cs",22
9,"9056",4812,3585,3533,36,52,"Cs",791
16,"16193",58,51,51,2,0,"Cs",0
8,"8238",14851,12472,12428,50,44,"Cs",1418
37,"37052",278,201,199,2,2,"Cs",30
26,"26020",454,347,337,4,10,"Cs",46
49,"49053",915,726,715,5,11,"Cs",94
47,"47034",72,57,57,1,0,"Cs",7
50,"50060",170,137,135,2,2,"Cs",22
27,"27062",584,467,466,3,1,"Cs",19
46,"46029",20423,15450,15274,100,176,"Cs",2650
20,"20020",113,67,67,0,0,"Cs",0
19,"19293",1905,1513,1499,10,14,"Cs",317
19,"19107",315,273,270,2,3,"Cs",52
34,"34211",175,160,160,0,0,"Cs",19
3,"3057",177,148,147,0,1,"Cs",23
37,"37083",176,160,156,1,4,"Cs",17
29,"29038",18683,12820,12666,168,154,"Cs",2529
19,"19185",27,19,19,0,0,"Cs",1
46,"46040",995,807,794,7,13,"Cs",77
9,"9091",701,545,533,5,12,"Cs",72
5,"5175",149,122,119,1,3,"Cs",22
37,"37200",196,145,145,0,0,"Cs",29
42,"42001",251,186,186,2,0,"Cs",21
42,"42083",26,22,22,0,0,"Cs",0
4,"4083",1740,1342,1326,4,16,"Cs",165
16,"16065",372,306,305,2,1,"Cs",47
47,"47225",74,61,60,0,1,"Cs",8
1,"1032",500,372,362,1,10,"Cs",3
8,"8082",1143,868,861,4,7,"Cs",125
42,"42041",31,23,23,1,0,"Cs",9
39,"39002",3414,2630,2578,23,52,"Cs",368
5,"5014",5291,4096,4044,29,52,"Cs",661
28,"28041",4788,4012,3973,23,39,"Cs",1085
13,"13084",841,683,673,6,10,"Cs",101
8,"8153",559,460,458,2,2,"Cs",17
12,"12052",539,453,439,5,14,"Cs",52
38,"38026",33514,26298,26076,191,222,"Cs",3344
44,"44153",1749,1264,1243,11,21,"Cs",234
24,"24184",183,121,119,0,2,"Cs",18
2,"2045",3617,3020,2969,38,51,"Cs",428
3,"3016",91,77,77,1,0,"Cs",7
24,"24185",452,339,332,3,7,"Cs",67
50,"50212",32,29,29,1,0,"Cs",2
3,"3026",1316,1040,1024,5,16,"Cs",142
16,"16110",91,80,80,0,0,"Cs",9
9,"9440",80,66,66,0,0,"Cs",14
37,"37366",41,30,30,0,0,"Cs",1
3,"3901",1109,827,820,5,7,"Cs",126
50,"50207",93,68,67,2,1,"Cs",15
42,"42171",114,80,79,0,1,"Cs",11
50,"50117",125,100,100,3,0,"Cs",15
9,"9446",12,8,8,0,0,"Cs",1
18,"18082",827,587,577,5,10,"Cs",110
40,"40231",98,80,80,2,0,"Cs",16
20,"20041",234,156,151,2,5,"Cs",2
48,"48080",9946,7574,7499,46,75,"Cs",175
47,"47127",138,92,89,1,3,"Cs",18
45,"45087",8198,6375,6281,36,94,"Cs",1382
46,"46050",186,157,154,1,3,"Cs",10
37,"37331",188,130,130,1,0,"Cs",20
9,"9079",48,42,42,1,0,"Cs",2
26,"26015",180,145,142,1,3,"Cs",18
34,"34034",115,96,95,3,1,"Cs",13
45,"45021",2605,1987,1950,23,37,"Cs",358
50,"50087",29,18,18,0,0,"Cs",5
50,"50177",276,226,223,0,3,"Cs",36
6,"6121",3268,2558,2531,26,27,"Cs",464
42,"42045",276,212,209,2,3,"Cs",55
22,"22908",188,133,131,0,2,"Cs",16
9,"9050",52,36,36,0,0,"Cs",4
6,"6099",1162,833,813,6,20,"Cs",141
6,"6030",169,147,146,1,1,"Cs",17
45,"45115",2586,2158,2114,8,44,"Cs",358
39,"39025",8703,6954,6854,39,100,"Cs",764
50,"50078",231,173,171,0,2,"Cs",12
5,"5129",116,82,76,1,6,"Cs",13
19,"19042",21,19,18,1,1,"Cs",0
50,"50215",20,18,18,0,0,"Cs",2
22,"22036",88,76,75,0,1,"Cs",10
23,"23099",4822,3687,3633,28,54,"Cs",557
3,"3122",43704,31952,31681,218,271,"Cs",6962
16,"16071",20,18,18,0,0,"Cs",0
49,"49091",248,185,183,4,2,"Cs",26
37,"37333",202,138,137,4,1,"Cs",17
28,"28065",130679,106997,105975,762,1022,"Cs",20548
5,"5064",102,83,81,2,2,"Cs",0
47,"47071",398,345,341,2,4,"Cs",85
28,"28035",1394,1057,1043,3,14,"Cs",178
24,"24119",695,515,501,8,14,"Cs",91
49,"49006",142,111,111,1,0,"Cs",21
42,"42156",29,23,23,0,0,"Cs",8
46,"46232",872,714,706,3,8,"Cs",117
45,"45082",1143,976,967,7,9,"Cs",82
50,"50123",436,344,338,1,6,"Cs",57
30,"30025",5001,3951,3898,27,53,"Cs",667
5,"5016",6354,5090,5005,40,85,"Cs",889
47,"47130",99,76,76,2,0,"Cs",16
40,"40165",74,56,54,1,2,"Cs",9
8,"8193",984,792,790,5,2,"Cs",53
13,"13061",5639,4119,4071,56,48,"Cs",780
50,"50110",336,268,266,1,2,"Cs",32
34,"34082",80,68,68,0,0,"Cs",9
9,"9006",59,37,36,1,1,"Cs",6
10,"10146",1513,1128,1104,6,24,"Cs",143
6,"6080",1890,1482,1467,18,15,"Cs",215
18,"18117",507,402,396,5,6,"Cs",35
44,"44241",506,416,407,1,9,"Cs",61
8,"8298",26980,20900,20817,91,83,"Cs",1207
37,"37372",134,104,104,0,0,"Cs",15
50,"50131",210,157,156,0,1,"Cs",25
8,"8255",137,105,105,1,0,"Cs",1
34,"34049",329,251,247,5,4,"Cs",35
49,"49159",269,214,213,1,1,"Cs",22
38,"38043",19265,14000,13856,115,144,"Cs",2171
46,"46227",888,708,693,6,15,"Cs",72
6,"6147",338,262,258,2,4,"Cs",29
46,"46055",1284,1031,1021,2,10,"Cs",124
50,"50033",65,50,50,1,0,"Cs",10
37,"37286",203,147,142,2,5,"Cs",19
18,"18119",1712,1352,1317,11,35,"Cs",224
8,"8299",377,318,317,0,1,"Cs",6
4,"4056",164,135,133,1,2,"Cs",23
8,"8141",4573,3611,3595,26,16,"Cs",224
21,"21047",1869,1242,1206,8,36,"Cs",108
30,"30037",19254,14416,14217,67,199,"Cs",2840
47,"47170",43,34,32,0,2,"Cs",8
2,"2041",321,253,251,3,2,"Cs",10
34,"34041",84,73,72,3,1,"Cs",16
13,"13030",120,97,96,0,1,"Cs",14
9,"9175",119,93,93,0,0,"Cs",11
24,"24081",122,91,88,0,3,"Cs",11
37,"37322",2466,1764,1723,17,41,"Cs",385
19,"19279",51,44,44,0,0,"Cs",5
49,"49076",328,260,258,6,2,"Cs",49
42,"42219",40,33,32,1,1,"Cs",5
15,"15077",8155,5554,5433,59,121,"Cs",469
47,"47068",30,23,23,0,0,"Cs",1
19,"19331",2643,2043,2009,11,34,"Cs",365
40,"40002",34,30,30,0,0,"Cs",8
37,"37339",308,227,226,0,1,"Cs",27
14,"14068",516,405,400,1,5,"Cs",51
12,"12110",219,168,166,1,2,"Cs",26
37,"37376",2164,1606,1581,15,25,"Cs",354
7,"7062",7902,4889,4828,58,61,"Cs",779
18,"18050",1670,1231,1213,9,18,"Cs",195
8,"8064",1920,1516,1506,6,10,"Cs",74
47,"47077",237,187,183,2,4,"Cs",25
41,"41071",5598,3993,3915,34,78,"Cs",519
28,"28178",1134,949,935,1,14,"Cs",170
19,"19196",90,77,70,1,7,"Cs",7
2,"2056",1643,1330,1308,4,22,"Cs",145
5,"5152",655,537,534,3,3,"Cs",66
32,"32031",1014,764,756,5,8,"Cs",61
42,"42130",51,46,45,0,1,"Cs",4
10,"10003",540,388,386,4,2,"Cs",34
3,"3046",1619,1213,1190,17,23,"Cs",170
6,"6041",457,381,374,5,7,"Cs",48
8,"8100",2092,1792,1782,16,10,"Cs",58
19,"19334",44,37,37,0,0,"Cs",2
48,"48065",3303,2541,2524,15,17,"Cs",37
8,"8189",122,106,106,0,0,"Cs",3
33,"33076",12147,8532,8452,104,80,"Cs",1408
18,"18030",567,448,442,4,6,"Cs",66
12,"12064",80,75,73,1,2,"Cs",7
14,"14050",2352,1840,1801,11,39,"Cs",205
26,"26012",33,28,26,0,2,"Cs",5
13,"13040",841,690,666,2,24,"Cs",84
50,"50009",97,72,71,1,1,"Cs",9
44,"44247",287,216,215,6,1,"Cs",33
4,"4090",312,253,249,0,4,"Cs",34
34,"34238",305,261,260,2,1,"Cs",31
3,"3017",379,321,311,1,10,"Cs",43
41,"41086",16209,11006,10881,116,125,"Cs",1806
42,"42134",2652,2028,1989,17,39,"Cs",370
21,"21902",1144,829,824,9,5,"Cs",49
22,"22039",805,667,662,5,5,"Cs",86
10,"10213",534,447,441,5,6,"Cs",56
28,"28180",5317,4266,4222,26,44,"Cs",899
22,"22046",714,592,587,13,5,"Cs",82
47,"47112",2570,2098,2075,13,23,"Cs",397
19,"19271",41,26,26,0,0,"Cs",3
21,"21053",3287,2375,2322,17,53,"Cs",462
8,"8085",976,812,811,2,1,"Cs",39
4,"4075",5427,3989,3961,15,28,"Cs",580
11,"11023",9372,7032,6950,94,82,"Cs",1197
4,"4087",156,117,116,1,1,"Cs",17
37,"37380",56,46,45,1,1,"Cs",9
32,"32062",766,582,579,1,3,"Cs",30
12,"12044",452,403,400,4,3,"Cs",13
10,"10209",265,184,184,2,0,"Cs",19
19,"19200",64,56,56,0,0,"Cs",8
28,"28181",20669,17314,17205,101,109,"Cs",4156
48,"48057",5745,4391,4376,13,15,"Cs",18
3,"3008",159,127,126,0,1,"Cs",18
45,"45054",3831,2980,2944,11,36,"Cs",573
9,"9443",152,115,112,0,3,"Cs",10
9,"9065",138,118,117,1,1,"Cs",21
10,"10103",426,330,327,0,3,"Cs",28
26,"26052",148,113,113,1,0,"Cs",19
12,"12134",135,102,100,0,2,"Cs",7
10,"10048",204,156,154,0,2,"Cs",13
2,"2037",22952,16040,15815,101,225,"Cs",3030
19,"19188",43,34,33,0,1,"Cs",3
49,"49063",310,246,240,2,6,"Cs",36
9,"9082",36,34,34,0,0,"Cs",3
19,"19261",32,24,24,0,0,"Cs",3
44,"44251",242,197,187,0,10,"Cs",23
16,"16219",81,64,63,0,1,"Cs",2
15,"15069",6588,4914,4830,58,84,"Cs",407
47,"47079",54,48,48,0,0,"Cs",10
50,"50013",200,166,166,3,0,"Cs",18
36,"36052",7234,5292,5151,44,141,"Cs",511
46,"46141",437,367,360,5,7,"Cs",47
13,"13076",461,377,369,0,8,"Cs",32
4,"4082",277,198,196,1,2,"Cs",24
6,"6016",2943,2283,2247,24,36,"Cs",311
6,"6006",4494,3395,3325,24,70,"Cs",547
44,"44252",75,56,56,1,0,"Cs",14
15,"15070",8797,6312,6173,108,139,"Cs",455
3,"3010",336,295,280,0,15,"Cs",35
3,"3114",1581,1263,1237,9,26,"Cs",192
42,"42124",58,41,41,0,0,"Cs",5
47,"47104",2836,2339,2267,23,72,"Cs",485
50,"50237",102,81,81,3,0,"Cs",5
4,"4066",13488,9324,9255,73,69,"Cs",1135
3,"3103",245,212,211,4,1,"Cs",20
16,"16007",1159,975,968,10,7,"Cs",103
26,"26132",106,87,87,0,0,"Cs",13
37,"37236",127,90,86,0,4,"Cs",19
10,"10187",430,316,311,0,5,"Cs",37
34,"34006",79,73,70,3,3,"Cs",11
8,"8272",165,133,133,0,0,"Cs",1
42,"42080",150,116,116,1,0,"Cs",15
19,"19249",28,28,28,0,0,"Cs",3
24,"24211",263,219,214,3,5,"Cs",38
27,"27045",944,700,698,13,2,"Cs",45
45,"45028",3628,2916,2863,16,53,"Cs",411
2,"2053",2885,2313,2282,13,31,"Cs",372
29,"29077",214,158,156,1,2,"Cs",7
46,"46035",6855,5500,5422,34,78,"Cs",828
5,"5237",155,131,129,1,2,"Cs",32
3,"3104",27091,21366,21119,250,247,"Cs",4539
40,"40129",164,129,128,2,1,"Cs",24
46,"46259",462,395,394,2,1,"Cs",78
16,"16048",409,331,330,1,1,"Cs",37
28,"28903",35344,30490,30287,201,203,"Cs",7795
27,"27034",1025,647,636,4,11,"Cs",22
32,"32048",864,550,544,1,6,"Cs",32
13,"13065",2813,1993,1971,13,22,"Cs",167
4,"4065",368,287,284,2,3,"Cs",30
16,"16067",119,96,93,2,3,"Cs",5
49,"49275",51218,38135,37628,388,507,"Cs",7374
38,"38021",1599,1079,1057,8,22,"Cs",115
29,"29045",1681,1263,1242,9,21,"Cs",200
37,"37088",199,151,149,1,2,"Cs",13
33,"33077",1118,772,761,4,11,"Cs",79
32,"32005",827,628,622,4,6,"Cs",56
46,"46168",1982,1543,1522,5,21,"Cs",230
18,"18098",5994,4293,4247,29,46,"Cs",756
1,"1001",2005,1438,1419,4,19,"Cs",56
46,"46037",1109,927,918,4,9,"Cs",101
37,"37003",107,82,82,1,0,"Cs",9
44,"44194",104,80,80,1,0,"Cs",22
20,"20018",11218,8145,8109,41,36,"Cs",67
4,"4070",1545,1192,1182,7,10,"Cs",147
34,"34028",134,110,107,3,3,"Cs",11
49,"49271",181,147,144,1,3,"Cs",19
50,"50258",53,33,33,3,0,"Cs",9
19,"19086",1392,1095,1083,7,12,"Cs",138
24,"24024",638,463,452,8,11,"Cs",56
46,"46240",206,175,169,2,6,"Cs",22
34,"34152",125,104,101,0,3,"Cs",11
10,"10097",106,88,85,3,3,"Cs",14
13,"13038",1604,1251,1216,14,35,"Cs",114
18,"18193",14802,11165,10973,110,192,"Cs",2202
46,"46180",651,525,519,0,6,"Cs",59
36,"36016",1064,707,696,7,11,"Cs",37
21,"21002",15922,11918,11773,119,145,"Cs",2895
16,"16026",93,70,68,1,2,"Cs",9
24,"24132",615,405,404,5,1,"Cs",65
19,"19226",41,32,32,0,0,"Cs",5
20,"20049",4159,3024,3004,11,20,"Cs",46
45,"45125",2263,1871,1842,10,29,"Cs",256
28,"28169",1553,1280,1273,15,7,"Cs",339
49,"49005",128,87,85,1,2,"Cs",13
21,"21027",50,40,39,0,1,"Cs",2
16,"16139",324,249,249,2,0,"Cs",31
40,"40097",125,96,95,1,1,"Cs",9
37,"37304",159,105,105,0,0,"Cs",20
8,"8075",4059,3127,3119,14,8,"Cs",349
34,"34022",1019,856,849,8,7,"Cs",95
15,"15038",2123,1441,1413,25,28,"Cs",82
19,"19198",17,17,17,0,0,"Cs",3
37,"37279",726,570,562,6,8,"Cs",111
50,"50170",364,286,279,1,7,"Cs",59
34,"34110",82,66,65,0,1,"Cs",6
18,"18095",2002,1566,1537,11,29,"Cs",260
18,"18910",730,491,487,0,4,"Cs",63
32,"32042",1505,1097,1091,12,6,"Cs",76
29,"29094",59350,42199,41749,419,450,"Cs",8145
2,"2071",1058,912,906,2,6,"Cs",64
46,"46101",816,696,687,3,9,"Cs",77
26,"26168",5515,4130,4077,36,53,"Cs",814
9,"9460",167,149,149,5,0,"Cs",14
50,"50096",36,22,22,0,0,"Cs",11
4,"4062",4460,3466,3425,12,41,"Cs",451
19,"19216",130,100,99,1,1,"Cs",11
5,"5049",410,310,305,3,5,"Cs",61
5,"5089",455,354,340,1,14,"Cs",52
8,"8200",62161,48645,48330,261,315,"Cs",6677
4,"4063",1063,847,835,5,12,"Cs",138
47,"47081",41,36,36,0,0,"Cs",4
19,"19272",65,58,56,1,2,"Cs",8
46,"46183",6028,4620,4534,29,86,"Cs",791
32,"32025",1013,773,761,7,12,"Cs",68
47,"47209",34,25,25,0,0,"Cs",4
23,"23021",517,446,440,0,6,"Cs",26
10,"10905",632,491,485,4,6,"Cs",99
9,"9375",42,38,38,0,0,"Cs",9
6,"6078",506,415,410,1,5,"Cs",88
47,"47125",51,46,45,0,1,"Cs",8
40,"40172",45,37,37,0,0,"Cs",3
24,"24084",152,113,113,0,0,"Cs",16
42,"42139",21,15,15,1,0,"Cs",2
37,"37206",91,66,63,1,3,"Cs",16
16,"16057",64,53,53,0,0,"Cs",2
8,"8052",139,111,110,0,1,"Cs",1
29,"29097",4168,3086,3009,37,77,"Cs",521
18,"18175",11786,8883,8730,58,153,"Cs",1492
46,"46103",1338,1056,1042,5,14,"Cs",97
28,"28159",594,493,491,5,2,"Cs",87
9,"9456",137,104,104,0,0,"Cs",20
5,"5144",66,51,51,0,0,"Cs",7
3,"3020",95,84,84,2,0,"Cs",14
12,"12129",1801,1382,1356,17,26,"Cs",169
8,"8133",128,98,98,5,0,"Cs",4
19,"19224",102,91,90,1,1,"Cs",2
9,"9003",184,143,142,2,1,"Cs",12
19,"19145",41,38,38,0,0,"Cs",7
2,"2002",435,358,352,2,6,"Cs",36
39,"39073",10200,8230,8150,65,80,"Cs",1629
46,"46013",17712,14181,14075,88,106,"Cs",2781
14,"14014",2509,2071,2030,7,41,"Cs",243
34,"34129",170,134,132,2,2,"Cs",15
11,"11003",1240,898,876,7,22,"Cs",155
47,"47001",52,47,46,0,1,"Cs",8
4,"4078",1110,819,814,2,5,"Cs",99
10,"10200",341,262,261,0,1,"Cs",17
16,"16910",78,54,54,1,0,"Cs",4
46,"46105",16132,11703,11582,64,121,"Cs",1869
12,"12037",17,17,17,1,0,"Cs",1
37,"37036",57,42,41,0,1,"Cs",7
15,"15040",2675,2011,1979,20,32,"Cs",146
1,"1028",1068,774,772,7,2,"Cs",23
46,"46075",147,136,134,2,2,"Cs",23
37,"37173",1420,1077,1058,13,19,"Cs",164
45,"45089",1432,1159,1134,5,25,"Cs",158
27,"27033",598,423,415,1,8,"Cs",4
34,"34038",268,198,197,0,1,"Cs",35
40,"40034",75,63,62,1,1,"Cs",16
5,"5251",56,39,39,0,0,"Cs",4
28,"28133",6116,4581,4486,22,95,"Cs",704
4,"4044",1533,1190,1176,8,14,"Cs",189
9,"9906",1200,975,958,8,17,"Cs",177
46,"46015",7477,5857,5808,33,49,"Cs",853
35,"35017",27216,17531,17102,133,429,"Cs",2489
33,"33012",5105,3601,3566,46,35,"Cs",526
42,"42189",53,44,42,0,2,"Cs",15
23,"23004",421,356,355,2,1,"Cs",118
15,"15061",5199,3694,3601,40,93,"Cs",381
40,"40138",2127,1729,1696,18,33,"Cs",284
24,"24110",1154,895,880,5,15,"Cs",70
9,"9170",209,164,159,0,5,"Cs",42
3,"3047",9711,6910,6791,36,119,"Cs",1081
40,"40110",316,254,253,2,1,"Cs",48
4,"4049",5603,4104,4054,27,50,"Cs",692
4,"4098",1455,1097,1087,9,10,"Cs",201
42,"42082",7,7,7,0,0,"Cs",3
8,"8021",61,47,45,0,2,"Cs",1
39,"39048",1765,1429,1420,4,9,"Cs",223
42,"42161",135,104,104,0,0,"Cs",12
47,"47004",1136,950,939,5,11,"Cs",127
16,"16064",651,575,569,4,6,"Cs",54
40,"40143",83,73,73,2,0,"Cs",6
49,"49162",175,134,131,1,3,"Cs",19
45,"45001",1837,1371,1340,12,31,"Cs",212
44,"44076",2110,1725,1691,22,34,"Cs",262
23,"23905",1840,1358,1341,9,17,"Cs",206
12,"12130",420,345,341,0,4,"Cs",13
20,"20028",2258,1579,1574,9,5,"Cs",24
6,"6017",257,211,210,1,1,"Cs",43
47,"47097",307,258,256,4,2,"Cs",34
37,"37085",5002,3994,3951,40,43,"Cs",1176
14,"14007",15042,10970,10758,86,212,"Cs",2093
8,"8301",49135,38575,38398,272,177,"Cs",6415
46,"46058",1734,1349,1325,9,24,"Cs",146
37,"37302",262,182,181,2,1,"Cs",42
49,"49056",288,232,230,2,2,"Cs",24
8,"8275",248,223,222,1,1,"Cs",4
5,"5189",396,325,321,1,4,"Cs",32
44,"44225",103,82,81,0,1,"Cs",13
8,"8083",1672,1478,1471,7,7,"Cs",29
8,"8161",11625,8521,8470,44,51,"Cs",992
46,"46170",3408,2769,2720,16,49,"Cs",446
37,"37241",164,129,127,0,2,"Cs",15
42,"42069",1491,1073,1048,20,25,"Cs",143
37,"37177",265,209,208,0,1,"Cs",71
49,"49164",139,103,102,2,1,"Cs",17
40,"40039",180,147,144,1,3,"Cs",21
24,"24040",412,322,320,2,2,"Cs",52
16,"16153",936,786,768,7,18,"Cs",86
8,"8242",222,180,180,0,0,"Cs",7
49,"49034",417,320,317,0,3,"Cs",43
1,"1055",840,608,602,10,6,"Cs",15
20,"20034",3154,2336,2315,20,21,"Cs",49
26,"26066",259,216,212,3,4,"Cs",33
6,"6046",1250,1010,995,7,15,"Cs",139
15,"15045",3629,2263,2237,9,26,"Cs",155
10,"10127",4706,3508,3423,23,85,"Cs",683
10,"10004",690,529,517,8,12,"Cs",62
26,"26153",10,9,9,0,0,"Cs",0
28,"28002",3281,2481,2455,24,26,"Cs",533
28,"28170",2487,1840,1810,10,30,"Cs",348
6,"6043",686,553,544,6,9,"Cs",92
46,"46902",356,300,296,8,4,"Cs",33
6,"6131",1063,880,874,5,6,"Cs",84
24,"24108",348,268,265,2,3,"Cs",47
9,"9152",248,197,195,0,2,"Cs",21
4,"4010",580,445,434,2,11,"Cs",55
19,"19244",74,54,54,0,0,"Cs",9
19,"19108",102,92,89,0,3,"Cs",11
38,"38009",4299,3105,3069,16,36,"Cs",390
40,"40100",263,219,215,1,4,"Cs",35
46,"46203",3544,2851,2810,21,41,"Cs",354
37,"37180",68,39,39,1,0,"Cs",4
49,"49141",296,220,218,0,2,"Cs",36
50,"50186",37,28,28,0,0,"Cs",4
14,"14042",18727,15069,14837,201,232,"Cs",2520
8,"8209",6896,5269,5244,25,25,"Cs",702
42,"42183",106,83,83,1,0,"Cs",17
41,"41066",1310,1027,1010,1,17,"Cs",104
40,"40149",486,383,376,3,7,"Cs",57
5,"5104",33,24,23,0,1,"Cs",7
46,"46194",15813,11654,11511,83,143,"Cs",1927
24,"24030",4201,3080,3024,25,56,"Cs",428
19,"19201",60,45,45,0,0,"Cs",16
5,"5220",363,312,308,5,4,"Cs",53
21,"21043",1857,1465,1424,7,41,"Cs",155
47,"47040",61,45,44,0,1,"Cs",5
22,"22037",112,96,96,0,0,"Cs",25
37,"37145",244,187,185,3,2,"Cs",29
21,"21007",6318,4614,4524,50,90,"Cs",713
21,"21039",299,226,223,7,3,"Cs",29
37,"37141",152,120,119,2,1,"Cs",16
33,"33074",3376,2345,2311,41,34,"Cs",271
22,"22195",234,193,192,0,1,"Cs",55
44,"44234",70,57,57,1,0,"Cs",9
36,"36021",12099,9105,8974,85,131,"Cs",983
12,"12078",333,238,235,1,3,"Cs",19
24,"24046",899,678,663,7,15,"Cs",93
45,"45102",3585,2724,2676,20,48,"Cs",446
19,"19059",74,53,46,0,7,"Cs",10
24,"24154",955,702,691,3,11,"Cs",104
50,"50032",242,179,176,1,3,"Cs",25
9,"9343",93,73,72,1,1,"Cs",9
9,"9430",22,20,20,0,0,"Cs",3
4,"4091",326,267,266,3,1,"Cs",28
18,"18047",6074,4437,4353,33,84,"Cs",832
8,"8220",2411,2119,2115,13,4,"Cs",34
49,"49214",664,519,510,2,9,"Cs",82
46,"46206",557,461,455,6,6,"Cs",80
5,"5107",55,43,43,2,0,"Cs",5
26,"26160",732,578,574,4,4,"Cs",74
22,"22115",347,262,261,1,1,"Cs",35
19,"19208",41,34,34,0,0,"Cs",3
9,"9022",61,54,54,0,0,"Cs",14
37,"37135",1163,934,924,8,10,"Cs",142
45,"45104",421,340,335,1,5,"Cs",36
50,"50071",127,89,88,0,1,"Cs",15
19,"19114",33,25,25,1,0,"Cs",2
50,"50162",137,112,110,2,2,"Cs",18
4,"4092",2789,2207,2173,6,34,"Cs",444
32,"32084",902,636,631,2,5,"Cs",41
18,"18188",1648,1295,1276,4,19,"Cs",149
16,"16206",196,146,144,3,2,"Cs",10
37,"37026",175,148,148,2,0,"Cs",22
50,"50072",195,164,161,3,3,"Cs",19
36,"36024",16395,12372,12165,102,207,"Cs",1494
37,"37299",229,175,168,0,7,"Cs",31
46,"46076",591,497,487,0,10,"Cs",27
37,"37362",4729,3769,3720,36,49,"Cs",1042
2,"2050",90,75,75,0,0,"Cs",8
9,"9176",59,50,47,2,3,"Cs",5
49,"49206",794,584,570,7,14,"Cs",71
10,"10113",2258,1695,1657,6,38,"Cs",232
34,"34032",37,34,34,1,0,"Cs",11
18,"18085",701,465,460,1,5,"Cs",66
36,"36025",2137,1387,1381,7,6,"Cs",149
23,"23039",2154,1644,1605,6,39,"Cs",203
5,"5226",65,52,52,0,0,"Cs",10
40,"40142",52,42,40,0,2,"Cs",12
18,"18017",18148,12712,12523,96,189,"Cs",2625
34,"34204",52,41,41,1,0,"Cs",3
44,"44215",168,121,120,1,1,"Cs",26
44,"44051",2588,2034,1997,26,37,"Cs",242
47,"47172",135,119,119,0,0,"Cs",17
8,"8249",272,248,248,2,0,"Cs",11
6,"6161",288,226,222,1,4,"Cs",26
19,"19117",1611,1279,1257,7,22,"Cs",232
14,"14048",1189,948,933,5,15,"Cs",109
42,"42096",251,164,160,3,4,"Cs",21
28,"28115",62352,53136,52912,268,224,"Cs",13143
45,"45048",355,277,271,1,6,"Cs",32
22,"22078",438,326,323,3,3,"Cs",43
4,"4095",690,508,502,2,6,"Cs",78
19,"19152",550,413,405,3,8,"Cs",40
10,"10042",88,59,59,0,0,"Cs",0
44,"44065",57,37,36,0,1,"Cs",1
24,"24065",2175,1695,1660,18,35,"Cs",312
18,"18909",539,432,426,1,6,"Cs",23
11,"11020",166423,117732,116448,1427,1284,"Cs",24527
19,"19119",75,68,66,2,2,"Cs",14
37,"37377",218,181,176,2,5,"Cs",42
10,"10016",327,260,259,1,1,"Cs",43
50,"50184",90,79,79,0,0,"Cs",9
4,"4084",341,258,255,0,3,"Cs",45
37,"37230",214,176,176,0,0,"Cs",27
42,"42152",67,47,46,0,1,"Cs",5
28,"28072",6088,5001,4961,23,40,"Cs",1067
5,"5154",34,25,25,1,0,"Cs",3
19,"19214",72,56,55,0,1,"Cs",9
40,"40192",133,104,102,2,2,"Cs",21
32,"32032",7932,5956,5831,55,125,"Cs",738
23,"23045",2057,1519,1507,7,12,"Cs",174
48,"48039",256,218,217,1,1,"Cs",4
20,"20064",12436,8730,8652,59,78,"Cs",205
49,"49043",265,210,208,1,2,"Cs",20
9,"9016",84,55,54,0,1,"Cs",0
19,"19257",3283,2448,2424,21,24,"Cs",389
46,"46212",1590,1209,1192,4,17,"Cs",183
11,"11034",2331,1708,1670,17,38,"Cs",313
2,"2022",344,252,252,1,0,"Cs",29
28,"28012",918,727,711,6,16,"Cs",144
34,"34018",205,181,177,2,4,"Cs",29
19,"19303",40,35,35,0,0,"Cs",2
24,"24151",445,334,328,3,6,"Cs",49
29,"29072",3277,2628,2592,16,36,"Cs",324
9,"9017",90,72,70,2,2,"Cs",10
16,"16086",881,751,747,3,4,"Cs",83
47,"47113",142,117,117,1,0,"Cs",14
40,"40159",132,101,101,0,0,"Cs",15
34,"34189",53,39,39,1,0,"Cs",5
12,"12076",76,64,64,1,0,"Cs",9
49,"49059",88,72,71,0,1,"Cs",14
22,"22213",2923,2261,2221,24,40,"Cs",454
47,"47039",166,134,134,0,0,"Cs",15
44,"44056",457,352,341,4,11,"Cs",33
40,"40125",75,61,61,2,0,"Cs",7
26,"26155",149,119,119,0,0,"Cs",7
16,"16087",226,191,184,3,7,"Cs",12
16,"16044",43,31,30,0,1,"Cs",2
30,"30043",25401,20378,19992,131,386,"Cs",4469
46,"46001",783,612,607,4,5,"Cs",72
8,"8164",934,784,776,1,8,"Cs",39
28,"28172",9751,7994,7928,38,66,"Cs",2134
4,"4024",3225,2558,2534,23,24,"Cs",468
6,"6001",659,539,534,7,5,"Cs",62
3,"3009",46121,36093,35720,235,373,"Cs",5829
34,"34066",57,52,48,1,4,"Cs",6
10,"10022",412,319,316,1,3,"Cs",23
19,"19124",380,271,268,0,3,"Cs",38
50,"50254",174,123,122,0,1,"Cs",29
50,"50022",504,396,386,11,10,"Cs",76
5,"5229",82,67,67,1,0,"Cs",11
24,"24037",337,234,234,1,0,"Cs",28
8,"8291",4919,3865,3854,28,11,"Cs",464
42,"42198",19,15,15,0,0,"Cs",0
10,"10063",161,141,141,1,0,"Cs",10
40,"40127",35,28,28,0,0,"Cs",4
5,"5080",44,31,29,0,2,"Cs",3
14,"14024",1859,1461,1418,10,43,"Cs",194
16,"16046",223,162,161,1,1,"Cs",24
6,"6068",431,324,317,4,7,"Cs",41
47,"47022",59,56,54,1,2,"Cs",10
1,"1056",205,134,134,0,0,"Cs",2
12,"12089",4546,3353,3304,12,49,"Cs",511
5,"5120",32,25,25,1,0,"Cs",4
28,"28046",4776,3944,3912,22,32,"Cs",810
44,"44191",722,567,561,7,6,"Cs",73
24,"24179",299,239,238,3,1,"Cs",22
8,"8148",2334,1803,1794,6,9,"Cs",268
26,"26172",25,23,23,0,0,"Cs",1
46,"46125",846,681,675,1,6,"Cs",52
2,"2027",283,239,238,3,1,"Cs",43
9,"9037",106,97,97,0,0,"Cs",8
24,"24008",9025,6803,6702,79,101,"Cs",1234
19,"19191",13,12,12,0,0,"Cs",0
5,"5082",495,399,394,1,5,"Cs",46
49,"49025",159,126,124,0,2,"Cs",10
18,"18027",2604,1902,1887,6,15,"Cs",256
19,"19264",34,28,28,0,0,"Cs",5
24,"24022",306,227,224,1,3,"Cs",22
20,"20046",1248,918,909,11,9,"Cs",22
36,"36034",3319,2384,2347,16,37,"Cs",185
4,"4901",494,381,378,0,3,"Cs",37
46,"46126",5574,4565,4528,25,37,"Cs",719
37,"37197",87,63,63,0,0,"Cs",13
8,"8177",39,31,31,0,0,"Cs",0
40,"40130",128,102,96,0,6,"Cs",15
10,"10013",266,203,202,2,1,"Cs",27
26,"26045",11,11,11,0,0,"Cs",0
13,"13064",1836,1455,1446,18,9,"Cs",304
50,"50197",96,78,78,1,0,"Cs",12
49,"49058",298,244,242,1,2,"Cs",27
22,"22200",239,181,178,0,3,"Cs",42
19,"19116",12,9,9,1,0,"Cs",0
1,"1059",189037,133121,131768,792,1353,"Cs",5860
36,"36003",10038,7747,7632,79,115,"Cs",1030
6,"6138",1013,783,767,3,16,"Cs",104
19,"19082",99,76,75,0,1,"Cs",8
23,"23028",6131,4696,4635,24,61,"Cs",708
52,"52001",54124,34068,33749,237,319,"Cs",4351
4,"4030",1066,783,776,5,7,"Cs",100
12,"12092",126,108,106,1,2,"Cs",6
4,"4903",4308,3102,3075,17,27,"Cs",480
6,"6072",2225,1777,1752,20,25,"Cs",248
46,"46128",1581,1324,1287,2,37,"Cs",149
8,"8099",753,565,561,2,4,"Cs",30
8,"8178",451,389,388,3,1,"Cs",21
50,"50287",252,200,196,7,4,"Cs",36
22,"22178",103,84,84,2,0,"Cs",18
3,"3139",23061,16378,16178,128,200,"Cs",3177
7,"7063",1420,1139,1129,10,10,"Cs",166
6,"6140",611,515,506,1,9,"Cs",46
18,"18908",784,599,581,0,18,"Cs",114
21,"21050",12522,8425,8312,84,113,"Cs",1302
19,"19300",788,664,652,2,12,"Cs",132
3,"3005",7903,6247,6195,37,52,"Cs",967
8,"8135",6735,5445,5421,36,24,"Cs",667
47,"47006",186,153,149,1,4,"Cs",18
49,"49175",205,150,149,2,1,"Cs",16
19,"19269",94,75,75,0,0,"Cs",1
10,"10152",446,354,350,2,4,"Cs",46
28,"28092",153428,121511,120211,807,1300,"Cs",24483
41,"41082",3359,2760,2718,11,42,"Cs",337
50,"50279",73,61,60,2,1,"Cs",2
14,"14059",687,571,563,7,8,"Cs",89
29,"29037",215,179,179,0,0,"Cs",17
22,"22055",310,258,255,2,3,"Cs",44
18,"18065",591,482,468,4,14,"Cs",50
1,"1019",148,121,121,0,0,"Cs",3
8,"8101",174954,129953,129198,680,755,"Cs",17960
46,"46039",2121,1730,1698,19,32,"Cs",244
22,"22254",1094,857,850,11,7,"Cs",155
6,"6156",1171,919,901,10,18,"Cs",130
46,"46009",3140,2582,2536,14,46,"Cs",430
9,"9047",54,46,45,0,1,"Cs",9
15,"15067",7953,6004,5925,51,79,"Cs",616
19,"19136",12,12,12,0,0,"Cs",0
34,"34171",941,702,688,9,14,"Cs",98
13,"13056",11657,9236,9142,85,94,"Cs",1612
41,"41100",967,765,727,8,38,"Cs",73
29,"29005",4499,3202,3171,37,31,"Cs",516
46,"46131",49504,37495,37064,259,431,"Cs",5946
38,"38038",164468,112475,111577,728,898,"Cs",16840
40,"40193",221,163,161,5,2,"Cs",31
3,"3038",335,275,267,1,8,"Cs",49
44,"44155",1056,830,813,9,17,"Cs",114
9,"9100",58,46,46,0,0,"Cs",5
50,"50262",1163,930,912,15,18,"Cs",157
15,"15046",6163,4625,4497,49,128,"Cs",392
42,"42105",46,37,37,1,0,"Cs",4
19,"19259",28,24,24,0,0,"Cs",2
37,"37168",407,305,300,0,5,"Cs",38
9,"9427",1364,1002,972,13,30,"Cs",154
49,"49179",346,233,232,0,1,"Cs",31
46,"46011",7523,5320,5235,28,85,"Cs",816
40,"40030",428,357,350,3,7,"Cs",52
41,"41092",7679,5668,5568,61,100,"Cs",801
15,"15047",2269,1531,1497,25,34,"Cs",120
37,"37319",93,67,65,1,2,"Cs",7
47,"47060",231,198,195,4,3,"Cs",43
16,"16143",15,10,10,1,0,"Cs",0
4,"4037",1221,975,960,8,15,"Cs",126
37,"37009",196,142,141,1,1,"Cs",15
28,"28162",2771,2264,2243,6,21,"Cs",590
1,"1023",262,210,206,3,4,"Cs",6
8,"8025",1535,1221,1214,7,7,"Cs",85
9,"9051",163,134,133,1,1,"Cs",42
8,"8183",4563,3628,3613,9,15,"Cs",187
37,"37090",66,51,51,1,0,"Cs",3
28,"28130",28508,23566,23305,179,261,"Cs",5065
24,"24070",3941,3007,2947,27,60,"Cs",273
49,"49190",50,45,45,1,0,"Cs",6
34,"34070",135,101,101,1,0,"Cs",2
37,"37194",237,182,181,0,1,"Cs",15
37,"37049",127,89,89,0,0,"Cs",10
29,"29041",3599,2570,2532,22,38,"Cs",491
22,"22060",1172,906,901,13,5,"Cs",174
13,"13015",5226,4010,3959,20,51,"Cs",566
14,"14034",304,246,239,1,7,"Cs",37
29,"29042",14447,10383,10199,98,184,"Cs",2338
9,"9160",80,64,64,1,0,"Cs",7
46,"46043",135,119,116,1,3,"Cs",19
11,"11015",64073,43152,42713,710,439,"Cs",9471
42,"42078",1005,769,756,6,13,"Cs",115
9,"9323",59,41,41,2,0,"Cs",5
40,"40207",800,662,652,6,10,"Cs",175
9,"9054",89,69,68,1,1,"Cs",15
8,"8027",720,592,588,3,4,"Cs",31
37,"37012",145,116,114,0,2,"Cs",19
40,"40140",79,58,58,0,0,"Cs",7
42,"42079",21,18,18,1,0,"Cs",3
46,"46166",8202,6482,6399,39,83,"Cs",1042
18,"18143",949,757,740,5,17,"Cs",90
37,"37051",80,59,58,0,1,"Cs",6
39,"39046",1343,1002,988,8,14,"Cs",64
2,"2003",133957,105024,104115,786,909,"Cs",23486
8,"8080",39,30,30,0,0,"Cs",1
29,"29043",2474,1764,1720,25,44,"Cs",249
45,"45135",4173,3402,3349,18,53,"Cs",403
41,"41004",57465,41004,40321,571,683,"Cs",7282
19,"19235",98,82,81,0,1,"Cs",7
24,"24156",220,146,144,2,2,"Cs",12
41,"41088",512,383,377,1,6,"Cs",40
37,"37249",38,28,28,0,0,"Cs",3
3,"3022",137,122,119,0,3,"Cs",6
32,"32019",11512,8281,8161,96,120,"Cs",950
50,"50122",67,55,54,0,1,"Cs",6
15,"15082",15381,11803,11642,133,161,"Cs",1484
39,"39075",136968,104358,103487,690,871,"Cs",17541
10,"10162",528,430,424,2,6,"Cs",34
22,"22059",1139,867,855,10,12,"Cs",169
47,"47027",2775,2246,2222,14,24,"Cs",438
12,"12040",118683,91285,90499,666,786,"Cs",17065
50,"50142",24,18,18,0,0,"Cs",1
47,"47065",817,658,653,2,5,"Cs",89
50,"50035",75,63,62,0,1,"Cs",3
18,"18145",10869,8532,8405,69,127,"Cs",1793
15,"15083",1036,784,768,7,16,"Cs",40
46,"46138",360,305,303,2,2,"Cs",54
42,"42129",678,540,539,1,1,"Cs",110
10,"10163",339,275,269,0,6,"Cs",39
34,"34086",99,92,90,2,2,"Cs",13
44,"44075",326,275,263,0,12,"Cs",29
37,"37213",83,65,64,0,1,"Cs",8
34,"34133",105,88,86,1,2,"Cs",6
37,"37055",118,96,95,0,1,"Cs",17
9,"9059",136704,109424,108039,1134,1385,"Cs",22628
20,"20058",739,555,551,4,4,"Cs",15
21,"21073",1891,1191,1156,17,35,"Cs",162
40,"40036",502,413,406,11,7,"Cs",85
16,"16108",43,40,39,1,1,"Cs",1
44,"44235",89,67,66,2,1,"Cs",11
29,"29013",1602,1262,1238,12,24,"Cs",140
37,"37365",166,132,131,1,1,"Cs",18
2,"2020",431,359,356,3,3,"Cs",32
41,"41007",12438,9009,8775,135,234,"Cs",1298
29,"29025",41515,29572,29311,221,261,"Cs",6482
47,"47205",355,263,258,3,5,"Cs",56
37,"37165",31,22,21,0,1,"Cs",7
19,"19002",57,45,45,0,0,"Cs",5
16,"16250",65,41,41,0,0,"Cs",9
9,"9061",148,129,129,0,0,"Cs",7
38,"38016",1178,654,648,6,6,"Cs",42
15,"15044",1209,889,876,4,13,"Cs",58
19,"19003",29,28,28,2,0,"Cs",2
40,"40180",277,231,224,3,7,"Cs",52
15,"15085",3220,2284,2239,23,45,"Cs",179
12,"12103",90,75,70,1,5,"Cs",8
26,"26112",223,177,174,0,3,"Cs",23
46,"46049",268,231,228,1,3,"Cs",20
24,"24080",207,162,161,0,1,"Cs",29
3,"3904",1420,1112,1095,5,17,"Cs",195
24,"24161",295,223,219,0,4,"Cs",25
28,"28031",2140,1642,1614,11,28,"Cs",212
29,"29048",1370,1149,1135,10,14,"Cs",69
8,"8259",6904,5626,5601,27,25,"Cs",366
37,"37216",294,248,247,2,1,"Cs",51
10,"10045",970,739,735,6,4,"Cs",81
18,"18112",110,80,76,0,4,"Cs",13
24,"24041",527,371,364,4,7,"Cs",68
5,"5021",1871,1469,1440,15,29,"Cs",262
15,"15087",5692,3883,3838,53,45,"Cs",335
14,"14071",884,641,634,2,7,"Cs",89
16,"16098",520,441,439,6,2,"Cs",46
38,"38039",11112,8233,8161,54,72,"Cs",1355
37,"37060",280,224,224,0,0,"Cs",66
39,"39024",1815,1436,1420,14,16,"Cs",155
26,"26115",23,21,19,0,2,"Cs",3
47,"47059",97,75,75,0,0,"Cs",24
8,"8033",13218,10480,10435,50,45,"Cs",1011
2,"2048",1178,989,967,7,22,"Cs",99
28,"28140",3139,2547,2523,12,24,"Cs",499
28,"28033",4082,3172,3140,13,32,"Cs",698
10,"10047",937,772,760,3,12,"Cs",97
46,"46112",542,460,454,0,6,"Cs",41
37,"37369",125,95,93,0,2,"Cs",7
28,"28064",135,110,104,1,6,"Cs",13
23,"23044",4719,3817,3749,18,68,"Cs",601
5,"5023",175,158,155,2,3,"Cs",17
47,"47166",251,196,189,3,7,"Cs",30
50,"50069",67,44,44,0,0,"Cs",7
18,"18079",3469,2667,2623,16,44,"Cs",220
47,"47102",264,217,211,1,6,"Cs",38
9,"9395",122,95,94,0,1,"Cs",6
13,"13074",944,826,813,1,13,"Cs",98
23,"23076",768,653,646,3,7,"Cs",48
48,"48089",3463,2746,2732,10,14,"Cs",70
48,"48028",691,576,573,1,3,"Cs",3
16,"16203",10167,7720,7591,49,129,"Cs",1122
50,"50213",93,76,75,0,1,"Cs",12
46,"46083",15374,11259,11096,56,163,"Cs",1819
10,"10049",3758,3167,3086,19,81,"Cs",501
12,"12106",1163,980,951,7,29,"Cs",116
24,"24044",152,116,114,0,2,"Cs",18
4,"4013",143321,101501,100814,750,687,"Cs",18874
46,"46053",537,459,457,2,2,"Cs",65
40,"40184",248,205,203,0,2,"Cs",34
30,"30034",1075,852,831,4,21,"Cs",110
12,"12107",351,312,306,1,6,"Cs",37
10,"10050",1015,831,823,2,8,"Cs",69
42,"42187",59,51,49,1,2,"Cs",6
28,"28006",80622,64905,64483,400,422,"Cs",14632
19,"19203",29,25,25,0,0,"Cs",4
19,"19248",76,56,56,0,0,"Cs",9
40,"40186",34,29,29,0,0,"Cs",6
18,"18187",512,388,387,0,1,"Cs",28
19,"19204",149,112,112,1,0,"Cs",9
26,"26120",1460,1130,1109,3,21,"Cs",158
5,"5026",187,163,159,1,4,"Cs",17
19,"19294",25,19,18,0,1,"Cs",1
44,"44049",796,592,578,9,14,"Cs",88
34,"34246",69,53,53,0,0,"Cs",4
13,"13078",8936,6820,6733,46,87,"Cs",947
42,"42093",35,29,29,2,0,"Cs",4
24,"24168",439,365,360,3,5,"Cs",48
49,"49052",179,125,123,1,2,"Cs",16
5,"5147",147,119,117,0,2,"Cs",15
38,"38901",1456,1024,1010,9,14,"Cs",88
39,"39028",3870,3131,3094,19,37,"Cs",561
24,"24049",1415,1146,1134,8,12,"Cs",180
42,"42144",423,338,336,4,2,"Cs",49
19,"19163",60,46,44,0,2,"Cs",5
5,"5027",260,217,211,3,6,"Cs",45
10,"10012",564,469,464,1,5,"Cs",52
27,"27013",3684,2997,2935,26,62,"Cs",164
34,"34901",1071,854,847,4,7,"Cs",118
19,"19297",32,27,27,0,0,"Cs",4
8,"8167",6048,4833,4822,48,11,"Cs",693
50,"50015",81,61,59,1,2,"Cs",9
15,"15028",1393,1076,1063,8,13,"Cs",90
40,"40211",69,58,58,1,0,"Cs",8
2,"2018",796,693,682,5,11,"Cs",90
46,"46137",242,200,200,3,0,"Cs",18
14,"14016",1283,1005,994,4,11,"Cs",83
9,"9128",78,63,61,1,2,"Cs",6
47,"47106",44,35,35,0,0,"Cs",5
24,"24010",8268,5968,5847,66,121,"Cs",1155
37,"37113",409,330,329,3,1,"Cs",51
42,"42015",32,23,23,1,0,"Cs",1
20,"20037",103,77,77,0,0,"Cs",1
4,"4017",1276,907,900,4,7,"Cs",189
34,"34057",462,345,330,3,15,"Cs",42
47,"47141",118,103,102,0,1,"Cs",16
41,"41043",667,475,453,3,22,"Cs",65
3,"3003",455,395,388,0,7,"Cs",39
15,"15901",3359,2237,2205,35,32,"Cs",216
47,"47045",734,601,590,5,11,"Cs",63
5,"5033",170,146,145,0,1,"Cs",18
42,"42149",387,311,308,3,3,"Cs",50
40,"40083",72,53,51,3,2,"Cs",0
8,"8091",5413,4301,4283,20,18,"Cs",382
9,"9407",27,23,23,0,0,"Cs",5
45,"45154",1479,1163,1149,5,14,"Cs",220
5,"5254",181,155,153,0,2,"Cs",21
29,"29081",261,212,210,2,2,"Cs",24
12,"12093",165,128,126,0,2,"Cs",10
44,"44004",379,312,310,5,2,"Cs",43
40,"40213",95,83,80,1,3,"Cs",17
34,"34103",97,84,81,0,3,"Cs",6
9,"9075",103,87,87,1,0,"Cs",18
15,"15065",7151,5281,5165,63,116,"Cs",531
44,"44246",1590,1173,1150,11,23,"Cs",229
45,"45003",550,435,431,4,4,"Cs",73
9,"9131",480,412,402,2,10,"Cs",82
35,"35001",4571,3523,3463,8,60,"Cs",273
9,"9409",110,87,87,0,0,"Cs",9
10,"10180",4168,2735,2680,18,55,"Cs",472
5,"5902",293,246,242,1,4,"Cs",46
19,"19120",108,90,90,1,0,"Cs",5
20,"20040",15753,11440,11364,69,76,"Cs",229
37,"37229",139,110,106,2,4,"Cs",26
47,"47144",75,63,63,1,0,"Cs",8
9,"9030",119,90,89,1,1,"Cs",23
5,"5191",124,105,105,0,0,"Cs",19
49,"49087",483,322,320,2,2,"Cs",47
45,"45204",634,500,497,1,3,"Cs",94
26,"26167",50,38,38,1,0,"Cs",6
39,"39032",1426,1156,1141,8,15,"Cs",165
6,"6097",2283,1803,1762,10,41,"Cs",247
4,"4021",180,146,143,0,3,"Cs",27
45,"45112",1841,1250,1220,7,30,"Cs",163
22,"22212",70,56,56,0,0,"Cs",7
45,"45067",2289,1860,1820,17,40,"Cs",250
10,"10182",124,91,90,0,1,"Cs",5
49,"49044",78,64,64,1,0,"Cs",10
24,"24217",133,106,105,1,1,"Cs",19
5,"5037",219,143,142,2,1,"Cs",30
46,"46152",87,69,69,0,0,"Cs",8
8,"8119",6838,5352,5326,31,26,"Cs",711
34,"34092",260,210,206,0,4,"Cs",17
45,"45159",85,75,74,0,1,"Cs",10
15,"15005",25263,17634,17347,257,287,"Cs",2312
8,"8120",7048,5892,5881,49,11,"Cs",474
47,"47145",586,446,440,2,6,"Cs",75
9,"9191",33,24,24,0,0,"Cs",1
18,"18093",2756,1902,1885,8,17,"Cs",250
5,"5077",158,133,131,1,2,"Cs",17
46,"46092",263,182,179,1,3,"Cs",25
44,"44219",173,142,136,1,6,"Cs",16
24,"24017",538,427,424,2,3,"Cs",57
42,"42059",20,13,13,0,0,"Cs",3
9,"9463",250,203,201,6,2,"Cs",36
24,"24097",204,155,155,7,0,"Cs",8
1,"1009",1265,920,914,6,6,"Cs",7
50,"50298",5427,4373,4323,30,50,"Cs",856
10,"10021",5045,3932,3840,32,92,"Cs",636
18,"18094",2304,1845,1798,16,47,"Cs",154
8,"8253",128,113,113,0,0,"Cs",1
46,"46032",5692,4518,4476,22,42,"Cs",756
42,"42106",14,12,12,0,0,"Cs",1
16,"16045",185,142,141,0,1,"Cs",7
6,"6134",530,337,331,3,6,"Cs",29
24,"24139",2087,1558,1540,20,18,"Cs",222
8,"8043",3378,2579,2569,20,10,"Cs",352
7,"7035",1596,1242,1234,13,8,"Cs",83
45,"45071",1802,1488,1465,0,23,"Cs",185
8,"8254",1753,1485,1482,3,3,"Cs",22
2,"2062",386,287,285,4,2,"Cs",28
18,"18904",743,555,545,1,10,"Cs",87
41,"41021",21397,15585,15334,201,251,"Cs",2289
19,"19078",50,38,37,0,1,"Cs",1
16,"16172",349,278,275,3,3,"Cs",30
6,"6069",3005,2172,2133,24,39,"Cs",338
6,"6135",1096,915,902,3,13,"Cs",114
44,"44097",126,91,90,2,1,"Cs",34
10,"10064",1409,1103,1072,6,31,"Cs",85
47,"47148",423,342,339,2,3,"Cs",69
46,"46155",993,785,772,2,13,"Cs",88
34,"34112",39,30,30,0,0,"Cs",9
44,"44060",37,28,28,0,0,"Cs",1
32,"32037",681,534,523,6,11,"Cs",76
9,"9416",60,44,44,0,0,"Cs",2
19,"19309",21,18,17,0,1,"Cs",4
37,"37348",100,79,79,0,0,"Cs",11
8,"8071",241,200,200,0,0,"Cs",8
34,"34161",22,17,16,0,1,"Cs",4
37,"37001",172,133,133,0,0,"Cs",26
6,"6103",4753,3656,3598,35,58,"Cs",671
47,"47084",1101,880,871,7,9,"Cs",122
6,"6136",1510,1189,1160,7,29,"Cs",161
38,"38034",3998,3033,2993,19,40,"Cs",443
5,"5043",75,62,62,0,0,"Cs",3
22,"22086",209,157,155,1,2,"Cs",27
9,"9086",661,521,518,5,3,"Cs",113
6,"6104",656,530,524,6,6,"Cs",95
44,"44001",65,51,50,0,1,"Cs",8
19,"19310",7,6,6,0,0,"Cs",0
34,"34114",198,152,152,0,0,"Cs",13
32,"32010",360,276,273,3,3,"Cs",9
47,"47086",3823,3090,3046,24,44,"Cs",534
19,"19237",40,33,33,0,0,"Cs",4
27,"27014",3162,2181,2139,17,42,"Cs",192
18,"18005",362,268,265,0,3,"Cs",50
9,"9025",108,73,72,0,1,"Cs",16
50,"50200",475,416,407,4,9,"Cs",68
3,"3137",657,484,480,5,4,"Cs",44
44,"44032",17,13,13,0,0,"Cs",4
44,"44224",21,15,15,0,0,"Cs",2
44,"44129",36,29,29,0,0,"Cs",3
24,"24063",355,261,261,2,0,"Cs",47
14,"14027",7876,6227,6103,81,124,"Cs",875
15,"15073",21760,14900,14630,181,270,"Cs",2121
16,"16010",137,104,101,0,3,"Cs",21
9,"9090",50,45,45,2,0,"Cs",12
42,"42162",2325,1721,1699,16,22,"Cs",335
5,"5045",80,65,65,0,0,"Cs",5
42,"42027",73,63,63,0,0,"Cs",8
8,"8283",6113,4832,4813,33,19,"Cs",294
8,"8205",61279,51629,51497,360,132,"Cs",6220
24,"24104",245,173,172,1,1,"Cs",22
19,"19317",127,98,97,0,1,"Cs",8
5,"5200",40,27,26,0,1,"Cs",2
21,"21061",5089,3358,3290,42,68,"Cs",537
24,"24064",1515,1159,1141,11,18,"Cs",174
28,"28071",64,56,54,0,2,"Cs",10
8,"8109",208,184,183,0,1,"Cs",3
42,"42003",66,55,55,0,0,"Cs",6
21,"21074",2698,1979,1945,15,34,"Cs",152
15,"15002",24007,18075,17857,216,218,"Cs",2697
44,"44260",138,91,90,1,1,"Cs",16
4,"4032",5698,4168,4138,20,30,"Cs",792
18,"18136",1782,1382,1359,12,23,"Cs",120
3,"3140",26027,19805,19438,230,367,"Cs",4084
47,"47121",521,429,422,5,7,"Cs",52
49,"49071",715,500,499,3,1,"Cs",65
26,"26024",210,171,169,1,2,"Cs",14
12,"12121",1044,941,915,4,26,"Cs",61
37,"37316",716,576,565,4,11,"Cs",119
8,"8127",2240,1694,1683,13,11,"Cs",133
47,"47153",104,76,75,0,1,"Cs",5
45,"45034",1291,1066,1039,7,27,"Cs",173
6,"6008",613,540,532,0,8,"Cs",65
26,"26101",34,27,27,0,0,"Cs",5
47,"47122",2016,1655,1617,15,38,"Cs",262
10,"10031",164,136,135,0,1,"Cs",36
46,"46161",1472,1200,1172,7,28,"Cs",163
23,"23097",6356,4509,4462,17,47,"Cs",743
37,"37355",162,137,135,0,2,"Cs",21
50,"50204",2394,1876,1855,21,21,"Cs",311
13,"13010",881,680,666,4,14,"Cs",79
24,"24028",365,297,290,2,7,"Cs",36
2,"2034",1324,1088,1083,10,5,"Cs",115
16,"16904",451,386,383,3,3,"Cs",49
8,"8050",136,115,114,0,1,"Cs",2
6,"6010",1075,859,846,8,13,"Cs",89
16,"16003",133,111,110,1,1,"Cs",15
47,"47028",30,17,17,0,0,"Cs",4
3,"3018",12439,9387,9283,50,104,"Cs",1604
16,"16099",184,126,121,0,5,"Cs",24
45,"45036",634,490,482,0,8,"Cs",57
8,"8278",4893,4034,4018,17,16,"Cs",121
1,"1901",2474,1655,1631,13,24,"Cs",78
19,"19186",78,67,67,0,0,"Cs",10
6,"6077",321,260,256,4,4,"Cs",19
21,"21030",1879,1523,1504,14,19,"Cs",120
44,"44037",449,334,331,1,3,"Cs",34
32,"32015",830,543,541,4,2,"Cs",33
8,"8077",34578,27617,27501,134,116,"Cs",4130
27,"27061",1016,784,763,9,21,"Cs",57
45,"45037",1535,1121,1105,7,16,"Cs",131
49,"49077",159,104,103,0,1,"Cs",16
15,"15078",78678,60510,59882,621,628,"Cs",7661
46,"46133",472,374,374,2,0,"Cs",28
18,"18140",42374,29390,29025,221,365,"Cs",4687
10,"10034",336,269,267,0,2,"Cs",28
47,"47187",75,54,53,0,1,"Cs",5
6,"6111",493,374,370,2,4,"Cs",61
40,"40103",146,125,123,0,2,"Cs",21
18,"18035",1190,965,952,4,13,"Cs",105
34,"34126",254,220,219,3,1,"Cs",21
44,"44199",39,39,38,5,1,"Cs",4
12,"12125",222,189,187,0,2,"Cs",11
42,"42168",108,85,85,1,0,"Cs",11
46,"46164",12073,8987,8836,63,151,"Cs",1568
22,"22099",465,365,362,3,3,"Cs",50
15,"15048",5048,3791,3730,38,61,"Cs",410
19,"19278",24,24,24,0,0,"Cs",0
42,"42213",25,16,16,0,0,"Cs",2
45,"45133",2808,2233,2187,14,46,"Cs",359
41,"41002",1427,1057,1024,5,33,"Cs",186
47,"47221",100,84,83,1,1,"Cs",8
16,"16190",4957,4006,3945,36,61,"Cs",648
34,"34081",60,48,48,0,0,"Cs",3
20,"20054",459,313,312,1,1,"Cs",2
5,"5012",121,100,97,0,3,"Cs",12
28,"28026",6703,5422,5367,21,55,"Cs",1203
8,"8053",2865,2105,2098,17,7,"Cs",223
14,"14004",1981,1522,1509,8,13,"Cs",216
46,"46196",140,115,114,0,1,"Cs",11
24,"24033",205,146,146,3,0,"Cs",26
5,"5054",1203,946,927,5,19,"Cs",99
49,"49036",508,361,355,6,6,"Cs",26
50,"50151",603,490,489,3,1,"Cs",79
38,"38012",2310,1705,1687,6,18,"Cs",167
40,"40208",720,592,585,4,7,"Cs",107
26,"26146",86,69,69,1,0,"Cs",9
5,"5133",67,48,48,0,0,"Cs",10
50,"50121",277,220,218,2,2,"Cs",29
19,"19329",59,49,49,0,0,"Cs",7
6,"6114",127,109,108,0,1,"Cs",3
47,"47128",56,49,46,0,3,"Cs",6
34,"34083",1664,1244,1229,10,15,"Cs",212
2,"2040",563,516,513,3,3,"Cs",51
37,"37097",44,29,29,0,0,"Cs",5
16,"16062",25,21,21,0,0,"Cs",2
12,"12038",156,110,109,1,1,"Cs",13
40,"40210",98,70,70,0,0,"Cs",12
29,"29011",2871,1955,1926,11,29,"Cs",256
18,"18071",5612,4271,4184,29,87,"Cs",751
23,"23903",3499,2738,2714,7,24,"Cs",309
10,"10081",184,142,140,4,2,"Cs",10
46,"46127",2740,2174,2147,11,27,"Cs",229
34,"34202",28,20,20,1,0,"Cs",5
50,"50286",75,58,55,0,3,"Cs",7
15,"15021",5244,3884,3806,70,78,"Cs",415
46,"46046",884,654,643,3,11,"Cs",84
28,"28166",347,287,286,1,1,"Cs",58
12,"12072",1082,901,889,15,12,"Cs",84
9,"9434",1280,1089,1077,12,12,"Cs",297
24,"24115",53267,39733,39172,433,561,"Cs",6527
45,"45184",201,133,132,0,1,"Cs",11
46,"46077",7344,5873,5761,49,112,"Cs",645
20,"20907",117,88,87,0,1,"Cs",0
8,"8055",541,443,442,2,1,"Cs",22
42,"42175",21,15,15,0,0,"Cs",3
19,"19283",32,26,26,0,0,"Cs",2
34,"34087",122,105,105,0,0,"Cs",24
19,"19001",41,33,33,0,0,"Cs",3
10,"10083",96,74,73,0,1,"Cs",9
22,"22028",362,284,282,5,2,"Cs",36
5,"5058",72,52,52,0,0,"Cs",8
2,"2080",499,409,400,0,9,"Cs",49
44,"44013",11250,8525,8420,95,105,"Cs",1835
16,"16151",64,52,52,0,0,"Cs",2
18,"18040",226,146,145,0,1,"Cs",14
46,"46149",344,260,256,2,4,"Cs",37
29,"29057",341,236,233,0,3,"Cs",13
13,"13083",2392,1772,1714,13,58,"Cs",245
44,"44034",126,97,97,2,0,"Cs",19
9,"9332",140,103,102,0,1,"Cs",23
8,"8215",2589,2044,2034,19,10,"Cs",112
45,"45187",3976,3365,3308,24,57,"Cs",469
6,"6085",3410,2719,2663,28,56,"Cs",498
22,"22151",88,66,65,0,1,"Cs",13
9,"9274",1045,875,867,8,8,"Cs",171
24,"24001",168,105,104,0,1,"Cs",26
12,"12042",574,486,479,8,7,"Cs",51
10,"10207",464,349,340,3,9,"Cs",40
49,"49247",417,301,294,0,7,"Cs",52
44,"44014",2499,2015,1963,25,52,"Cs",290
28,"28001",80,64,64,0,0,"Cs",11
2,"2082",95,83,83,0,0,"Cs",12
22,"22155",65,54,54,0,0,"Cs",14
9,"9441",92,81,81,1,0,"Cs",10
1,"1034",150,111,111,2,0,"Cs",1
24,"24002",233,183,183,1,0,"Cs",29
46,"46080",985,799,788,5,11,"Cs",89
8,"8294",2063,1644,1643,10,1,"Cs",116
21,"21004",1593,1114,1085,16,29,"Cs",90
5,"5179",199,181,175,0,6,"Cs",34
50,"50126",2262,1736,1708,20,28,"Cs",396
19,"19288",22,21,21,1,0,"Cs",3
37,"37130",178,150,150,2,0,"Cs",26
8,"8137",274,232,229,0,3,"Cs",5
24,"24120",311,209,209,0,0,"Cs",41
44,"44146",170,148,146,3,2,"Cs",17
9,"9276",389,283,268,5,15,"Cs",35
19,"19053",1929,1472,1458,9,14,"Cs",197
44,"44114",238,188,184,1,4,"Cs",38
40,"40006",22,18,18,0,0,"Cs",2
18,"18044",164,113,112,0,1,"Cs",14
47,"47069",118,96,92,1,4,"Cs",12
3,"3058",4967,4031,3967,24,64,"Cs",624
15,"15025",1000,639,631,6,8,"Cs",30
10,"10088",196,139,138,0,1,"Cs",21
49,"49046",242,178,175,0,3,"Cs",23
49,"49250",1194,954,939,8,15,"Cs",217
37,"37106",249,173,173,1,0,"Cs",38
34,"34001",39,32,32,3,0,"Cs",1
29,"29073",1645,1200,1185,13,15,"Cs",110
50,"50098",162,121,120,3,1,"Cs",15
16,"16030",22,19,19,1,0,"Cs",3
50,"50040",86,71,71,0,0,"Cs",13
6,"6122",6562,4837,4723,43,114,"Cs",1002
8,"8060",135,111,109,0,2,"Cs",6
3,"3091",241,201,196,0,5,"Cs",9
6,"6023",4170,3088,3045,18,43,"Cs",389
22,"22074",275,223,221,10,2,"Cs",47
2,"2013",135,113,110,0,3,"Cs",13
9,"9020",237,184,180,5,4,"Cs",43
28,"28004",6564,4798,4767,26,31,"Cs",913
12,"12135",36194,27266,26961,192,305,"Cs",4797
18,"18116",2853,2265,2233,15,32,"Cs",253
2,"2086",2426,1738,1728,8,10,"Cs",136
18,"18046",1753,1206,1185,1,21,"Cs",179
49,"49010",348,301,295,6,6,"Cs",53
42,"42049",109,73,72,1,1,"Cs",7
4,"4053",12500,9437,9298,56,139,"Cs",1942
5,"5183",123,104,96,0,8,"Cs",21
19,"19112",53,41,40,1,1,"Cs",5
5,"5106",28,22,22,0,0,"Cs",6
37,"37063",60,45,45,1,0,"Cs",7
3,"3124",460,401,390,2,11,"Cs",26
37,"37297",401,319,315,2,4,"Cs",50
29,"29075",12890,9033,8949,73,84,"Cs",1482
15,"15060",5843,4360,4281,65,79,"Cs",564
20,"20004",227,156,154,4,2,"Cs",1
5,"5066",439,373,367,2,6,"Cs",51
9,"9124",1432,1078,1054,7,24,"Cs",146
26,"26006",1825,1496,1470,8,26,"Cs",198
6,"6025",5096,3981,3904,28,77,"Cs",601
12,"12048",249,181,175,2,6,"Cs",22
15,"15030",199972,151737,150397,1576,1340,"Cs",21105
6,"6058",1980,1519,1493,13,26,"Cs",299
1,"1043",2337,1669,1656,18,13,"Cs",135
22,"22163",419,363,361,1,2,"Cs",88
42,"42142",45,35,35,0,0,"Cs",3
22,"22116",1369,1025,1003,8,22,"Cs",179
10,"10052",166,124,123,0,1,"Cs",24
26,"26161",8,7,7,0,0,"Cs",0
6,"6125",1679,1348,1324,5,24,"Cs",193
34,"34147",160,125,124,1,1,"Cs",16
6,"6026",815,661,653,5,8,"Cs",64
44,"44212",41,32,32,0,0,"Cs",4
24,"24009",278,154,151,2,3,"Cs",14
19,"19209",41,35,34,0,1,"Cs",4
9,"9449",92,75,74,1,1,"Cs",25
3,"3002",3631,2841,2801,16,40,"Cs",479
33,"33043",658,462,455,4,7,"Cs",44
49,"49121",368,269,266,1,3,"Cs",49
44,"44011",48,32,32,1,0,"Cs",7
49,"49258",110,93,92,0,1,"Cs",16
11,"11030",22973,16087,15853,165,234,"Cs",3735
38,"38024",15310,10234,10088,82,146,"Cs",1675
16,"16036",122,98,97,1,1,"Cs",13
50,"50191",445,341,337,2,4,"Cs",57
34,"34010",553,454,449,3,5,"Cs",82
19,"19210",18,18,17,0,1,"Cs",0
46,"46239",453,372,366,2,6,"Cs",55
39,"39029",636,512,512,5,0,"Cs",70
39,"39001",2065,1669,1643,16,26,"Cs",223
42,"42191",180,129,129,1,0,"Cs",24
10,"10096",3326,2553,2501,14,52,"Cs",329
48,"48093",888,720,715,2,5,"Cs",3
32,"32002",2022,1510,1485,8,25,"Cs",157
9,"9292",75,62,62,2,0,"Cs",8
5,"5072",94,86,85,1,1,"Cs",21
37,"37263",338,251,246,0,5,"Cs",33
49,"49016",229,189,187,2,2,"Cs",42
29,"29080",6895,5005,4934,59,71,"Cs",768
6,"6029",1183,946,935,12,11,"Cs",89
28,"28082",6063,4939,4889,46,50,"Cs",933
8,"8293",228,187,187,1,0,"Cs",6
5,"5138",289,224,223,2,1,"Cs",28
49,"49112",118,78,78,2,0,"Cs",1
24,"24199",405,302,297,3,5,"Cs",42
18,"18158",8010,5524,5449,23,75,"Cs",768
32,"32003",889,667,654,3,13,"Cs",36
40,"40122",525,442,434,2,8,"Cs",80
5,"5074",665,571,565,2,6,"Cs",132
9,"9295",54,38,38,0,0,"Cs",6
5,"5114",1264,1061,1030,3,31,"Cs",125
6,"6901",2117,1686,1655,17,31,"Cs",280
10,"10017",772,595,591,3,4,"Cs",46
12,"12083",89,73,71,1,2,"Cs",12
20,"20009",11343,8168,8106,46,62,"Cs",245
36,"36058",4942,3470,3402,37,68,"Cs",279
19,"19256",44,32,32,0,0,"Cs",5
37,"37116",69,51,51,0,0,"Cs",8
50,"50076",75,64,63,0,1,"Cs",4
29,"29082",34113,26248,26002,304,246,"Cs",6010
47,"47174",270,215,208,2,7,"Cs",35
47,"47017",198,162,160,1,2,"Cs",14
24,"24134",3294,2540,2479,25,61,"Cs",401
5,"5036",116,100,100,0,0,"Cs",19
27,"27050",2842,2100,2072,19,28,"Cs",106
37,"37343",66,50,48,1,2,"Cs",11
37,"37267",182,153,150,1,3,"Cs",25
9,"9133",38,33,33,0,0,"Cs",2
6,"6031",461,316,301,1,15,"Cs",36
35,"35030",9949,6611,6462,65,149,"Cs",714
40,"40228",494,397,391,5,6,"Cs",63
50,"50167",215,181,179,1,2,"Cs",31
18,"18124",359,269,267,0,2,"Cs",20
12,"12055",106,85,83,2,2,"Cs",9
47,"47175",6704,5296,5222,52,74,"Cs",1042
44,"44026",95,76,75,2,1,"Cs",8
44,"44218",31,25,25,2,0,"Cs",1
46,"46091",115,99,99,0,0,"Cs",13
49,"49020",261,215,210,2,5,"Cs",28
8,"8146",1358,1086,1079,2,7,"Cs",156
42,"42058",102,84,84,0,0,"Cs",12
40,"40229",28,24,24,0,0,"Cs",0
34,"34019",110,92,91,2,1,"Cs",19
46,"46122",2730,2103,2071,19,32,"Cs",262
46,"46031",10521,7735,7607,62,128,"Cs",1195
8,"8094",1586,1310,1306,10,4,"Cs",70
6,"6066",1725,1297,1286,9,11,"Cs",131
12,"12087",25,19,18,2,1,"Cs",1
4,"4023",120,95,95,2,0,"Cs",16
6,"6133",1799,1476,1453,12,23,"Cs",172
34,"34020",51,38,38,0,0,"Cs",7
37,"37157",78,64,64,0,0,"Cs",13
28,"28152",16839,14205,14151,87,54,"Cs",3771
10,"10062",393,339,334,0,5,"Cs",35
42,"42021",68,44,44,2,0,"Cs",8
9,"9464",33,27,27,0,0,"Cs",3
9,"9083",27,24,23,0,1,"Cs",2
50,"50225",1532,1072,1064,10,8,"Cs",164
5,"5118",68,44,43,0,1,"Cs",9
47,"47210",402,300,289,2,11,"Cs",32
30,"30014",1585,1226,1202,3,24,"Cs",142
26,"26171",156,131,127,0,4,"Cs",22
22,"22173",218,162,160,1,2,"Cs",13
45,"45024",1043,832,821,5,11,"Cs",72
16,"16006",110,99,98,1,1,"Cs",14
22,"22128",192,155,154,2,1,"Cs",37
50,"50901",140,108,108,0,0,"Cs",22
41,"41077",8631,6441,6289,46,152,"Cs",859
47,"47115",276,231,223,1,8,"Cs",38
42,"42108",10,7,7,0,0,"Cs",1
19,"19263",22,13,12,0,1,"Cs",2
20,"20044",364,263,262,0,1,"Cs",4
24,"24141",101,78,78,0,0,"Cs",6
39,"39036",971,794,787,5,7,"Cs",119
37,"37159",79,68,68,0,0,"Cs",11
8,"8306",527,390,388,2,2,"Cs",37
19,"19220",2536,1833,1813,9,20,"Cs",374
49,"49229",113,88,87,0,1,"Cs",8
26,"26131",34,34,34,1,0,"Cs",1
9,"9307",112,87,86,0,1,"Cs",11
8,"8149",984,770,768,3,2,"Cs",35
24,"24142",24730,18823,18504,201,319,"Cs",3747
24,"24021",1602,1211,1194,7,17,"Cs",137
10,"10147",1283,1038,1007,4,31,"Cs",86
46,"46156",2024,1642,1628,7,14,"Cs",175
23,"23092",27662,21206,20981,170,225,"Cs",3851
6,"6070",7686,6083,5948,44,135,"Cs",1160
12,"12118",76,64,63,0,1,"Cs",7
42,"42159",40,36,35,0,1,"Cs",11
13,"13003",449,346,343,0,3,"Cs",33
42,"42160",247,195,194,4,1,"Cs",18
14,"14026",2014,1502,1474,10,28,"Cs",223
9,"9140",115,88,88,2,0,"Cs",14
6,"6137",933,730,723,5,7,"Cs",87
50,"50257",163,136,134,1,2,"Cs",19
46,"46187",1304,991,982,8,9,"Cs",92
32,"32066",551,399,396,1,3,"Cs",7
9,"9309",292,224,223,3,1,"Cs",40
5,"5109",441,363,356,5,7,"Cs",53
44,"44257",154,110,109,1,1,"Cs",17
9,"9289",1379,1002,994,9,8,"Cs",160
26,"26096",260,221,212,2,9,"Cs",31
45,"45029",188,160,159,0,1,"Cs",18
22,"22016",566,423,420,4,3,"Cs",54
36,"36035",14571,11096,10917,105,179,"Cs",1542
16,"16231",50,40,40,0,0,"Cs",3
24,"24023",262,208,206,3,2,"Cs",30
46,"46097",958,764,756,6,8,"Cs",193
44,"44258",53,44,44,0,0,"Cs",6
1,"1016",421,236,229,3,7,"Cs",3
6,"6039",1807,1506,1474,13,32,"Cs",141
9,"9143",27,18,18,0,0,"Cs",2
24,"24145",618,443,435,3,8,"Cs",73
8,"8073",62572,48770,48527,255,243,"Cs",6792
5,"5084",69,46,46,0,0,"Cs",3
46,"46188",693,591,585,3,6,"Cs",97
49,"49027",126,88,88,0,0,"Cs",20
37,"37276",126,101,101,0,0,"Cs",33
46,"46098",2403,1807,1772,8,35,"Cs",237
24,"24146",251,206,204,1,2,"Cs",16
6,"6139",502,429,421,5,8,"Cs",39
3,"3014",238879,176118,174768,1105,1350,"Cs",37609
3,"3096",5779,4433,4352,30,81,"Cs",817
45,"45063",380,294,289,0,5,"Cs",19
37,"37016",574,464,455,3,9,"Cs",118
37,"37151",143,112,111,1,1,"Cs",18
9,"9422",32,27,26,2,1,"Cs",4
15,"15012",3611,2695,2616,36,79,"Cs",270
40,"40026",113,106,105,2,1,"Cs",21
5,"5086",76,64,61,0,3,"Cs",8
47,"47183",139,118,118,1,0,"Cs",33
24,"24026",1099,812,799,5,13,"Cs",153
37,"37042",41,32,31,1,1,"Cs",5
9,"9148",79,63,63,5,0,"Cs",6
40,"40904",341,302,300,4,2,"Cs",67
28,"28021",576,387,386,3,1,"Cs",60
13,"13008",427,304,302,0,2,"Cs",52
12,"12063",44,37,37,1,0,"Cs",4
9,"9314",92,75,74,1,1,"Cs",9
45,"45080",3,3,3,0,0,"Cs",0
46,"46160",1907,1508,1485,5,23,"Cs",132
24,"24106",218,164,162,0,2,"Cs",25
5,"5205",79,66,66,0,0,"Cs",12
40,"40905",128,101,100,4,1,"Cs",13
6,"6141",1688,1308,1291,16,17,"Cs",166
37,"37166",199,146,144,0,2,"Cs",26
39,"39041",1767,1437,1417,18,20,"Cs",183
48,"48076",284,226,224,1,2,"Cs",2
7,"7010",5070,3815,3777,47,38,"Cs",636
5,"5048",106,98,94,1,4,"Cs",11
24,"24150",224,176,174,2,2,"Cs",27
18,"18173",8972,6594,6459,58,135,"Cs",907
6,"6142",259,214,208,1,6,"Cs",33
49,"49031",145,107,103,0,4,"Cs",6
50,"50233",104,82,82,0,0,"Cs",19
47,"47155",3410,2694,2660,21,34,"Cs",619
19,"19322",26,21,21,1,0,"Cs",2
1,"1063",1830,1363,1353,4,10,"Cs",35
49,"49032",287,224,222,0,2,"Cs",47
50,"50118",2110,1622,1605,19,17,"Cs",254
42,"42073",73,58,57,0,1,"Cs",13
47,"47156",150,128,128,2,0,"Cs",21
41,"41101",6016,4524,4480,42,44,"Cs",570
3,"3111",5565,4183,4149,29,34,"Cs",653
26,"26064",2337,1764,1724,14,40,"Cs",236
3,"3049",12143,9418,9302,47,116,"Cs",1551
16,"16056",453,323,321,1,2,"Cs",38
8,"8155",6960,5427,5390,39,37,"Cs",645
9,"9261",449,343,342,5,1,"Cs",54
19,"19187",42,36,36,0,0,"Cs",7
5,"5008",208,168,163,1,5,"Cs",12
41,"41057",253,189,188,0,1,"Cs",14
39,"39015",824,646,644,2,2,"Cs",80
46,"46904",805,643,628,13,15,"Cs",109
6,"6045",476,368,362,3,6,"Cs",43
21,"21031",1172,807,764,5,43,"Cs",77
2,"2001",695,567,559,3,8,"Cs",52
46,"46012",929,727,707,3,20,"Cs",98
42,"42212",62,48,47,1,1,"Cs",7
19,"19095",11,10,10,1,0,"Cs",0
49,"49155",80,66,65,1,1,"Cs",17
6,"6144",512,422,416,1,6,"Cs",49
32,"32017",1202,821,815,6,6,"Cs",57
46,"46134",2380,1836,1825,5,11,"Cs",334
38,"38011",21563,15380,15214,69,166,"Cs",2511
18,"18105",3822,2688,2650,12,38,"Cs",311
8,"8236",1557,1204,1202,2,2,"Cs",57
44,"44265",181,153,148,1,5,"Cs",20
18,"18036",3970,3197,3149,26,48,"Cs",602
23,"23066",4299,3603,3545,13,58,"Cs",553
37,"37171",397,297,292,1,5,"Cs",71
10,"10078",370,289,278,4,11,"Cs",42
22,"22023",389,313,305,6,8,"Cs",48
19,"19326",2343,1789,1768,9,21,"Cs",426
49,"49157",192,153,149,0,4,"Cs",22
13,"13016",661,508,495,2,13,"Cs",67
24,"24112",299,226,223,1,3,"Cs",22
3,"3082",12936,9025,8931,57,94,"Cs",1670
50,"50180",106,84,84,1,0,"Cs",7
33,"33071",563,413,407,2,6,"Cs",31
32,"32047",1746,1272,1252,6,20,"Cs",119
44,"44266",102,89,86,1,3,"Cs",7
42,"42173",29702,22141,21776,301,365,"Cs",3650
50,"50090",134,108,108,0,0,"Cs",22
37,"37361",81,63,61,0,2,"Cs",12
27,"27064",1503,1078,1039,12,39,"Cs",63
29,"29010",1632,1372,1319,4,53,"Cs",146
8,"8012",1721,1340,1331,8,9,"Cs",56
15,"15050",1748,1038,1027,15,11,"Cs",66
20,"20025",1116,835,830,2,5,"Cs",2
10,"10202",588,469,459,0,10,"Cs",110
18,"18038",1047,810,787,4,23,"Cs",84
49,"49037",177,146,143,1,3,"Cs",31
15,"15051",4562,3302,3249,36,53,"Cs",320
12,"12070",499,434,430,3,4,"Cs",32
47,"47160",392,317,314,2,3,"Cs",42
48,"48051",216,157,157,0,0,"Cs",4
18,"18178",671,535,532,0,3,"Cs",53
22,"22063",159,133,132,2,1,"Cs",12
44,"44110",37,33,33,0,0,"Cs",2
11,"11042",1155,870,852,7,18,"Cs",119
19,"19238",44,30,30,1,0,"Cs",1
44,"44232",368,284,273,2,11,"Cs",45
49,"49003",869,627,624,3,3,"Cs",88
32,"32020",2460,1899,1876,6,23,"Cs",67
42,"42128",46,41,41,0,0,"Cs",4
9,"9908",427,294,290,6,4,"Cs",33
49,"49039",327,255,246,6,9,"Cs",44
2,"2005",545,443,436,5,7,"Cs",47
3,"3023",1379,1216,1199,6,17,"Cs",159
29,"29012",9718,7243,7123,47,120,"Cs",953
45,"45092",223,204,204,1,0,"Cs",25
22,"22064",162,121,121,0,0,"Cs",14
24,"24158",296,226,220,2,6,"Cs",32
19,"19194",94,76,76,0,0,"Cs",14
50,"50182",3675,2846,2810,36,36,"Cs",620
13,"13022",332,264,256,1,8,"Cs",31
19,"19104",18,16,16,0,0,"Cs",1
14,"14038",32692,24015,23679,213,336,"Cs",5131
45,"45093",154,124,123,0,1,"Cs",22
24,"24159",1746,1393,1368,6,25,"Cs",270
39,"39049",306,209,208,4,1,"Cs",19
15,"15022",5574,3846,3798,41,48,"Cs",364
46,"46078",28394,20928,20748,156,180,"Cs",3545
9,"9454",42,37,36,0,1,"Cs",9
46,"46007",12284,9370,9265,65,105,"Cs",1850
24,"24160",645,481,475,1,6,"Cs",60
45,"45002",2608,1840,1821,7,19,"Cs",311
16,"16066",2298,1932,1885,17,47,"Cs",248
20,"20029",4272,3257,3239,18,18,"Cs",36
22,"22197",439,356,353,10,3,"Cs",69
21,"21038",1076,786,771,8,15,"Cs",87
5,"5100",267,217,212,1,5,"Cs",37
44,"44044",83,65,64,2,1,"Cs",15
8,"8015",156003,117736,117183,704,553,"Cs",15636
39,"39050",255,188,184,2,4,"Cs",23
45,"45095",660,528,519,3,9,"Cs",69
3,"3119",17223,13244,13116,75,128,"Cs",2774
46,"46201",62,47,47,0,0,"Cs",5
11,"11022",48682,28113,27794,294,319,"Cs",5906
49,"49042",230,179,174,1,5,"Cs",18
42,"42085",178,133,133,3,0,"Cs",21
5,"5216",213,166,165,0,1,"Cs",31
28,"28106",78429,59182,58471,417,711,"Cs",11391
40,"40145",1105,906,899,2,7,"Cs",131
18,"18182",1917,1391,1381,7,10,"Cs",184
6,"6053",590,461,444,7,17,"Cs",60
27,"27008",1345,965,946,17,19,"Cs",45
47,"47195",430,335,320,2,15,"Cs",52
30,"30001",4539,3615,3567,16,48,"Cs",457
8,"8084",1167,941,936,6,5,"Cs",54
6,"6120",3373,2757,2719,10,38,"Cs",382
10,"10087",1606,1239,1223,5,16,"Cs",152
46,"46172",5412,3878,3832,18,46,"Cs",595
8,"8016",1812,1454,1448,6,6,"Cs",96
5,"5103",66,48,48,0,0,"Cs",5
37,"37332",70,53,53,0,0,"Cs",7
22,"22068",65,46,44,1,2,"Cs",9
39,"39052",18957,15123,14985,106,138,"Cs",2860
47,"47100",119,104,102,2,2,"Cs",9
28,"28108",3642,2878,2841,16,37,"Cs",654
45,"45098",2110,1675,1652,6,23,"Cs",217
16,"16199",28,23,23,1,0,"Cs",3
38,"38019",13758,8870,8776,46,94,"Cs",1018
6,"6055",1998,1552,1523,9,29,"Cs",203
21,"21042",15579,8742,8579,138,163,"Cs",1771
26,"26003",389,329,328,1,1,"Cs",29
30,"30003",25046,17860,17668,99,192,"Cs",3237
42,"42046",46,35,33,2,2,"Cs",5
22,"22072",194,141,140,0,1,"Cs",25
8,"8163",19497,14616,14548,67,68,"Cs",1817
45,"45191",521,449,446,0,3,"Cs",47
34,"34190",49,36,36,3,0,"Cs",3
24,"24005",345,255,250,2,5,"Cs",24
8,"8086",14017,10746,10677,89,69,"Cs",1447
6,"6056",454,378,376,1,2,"Cs",29
19,"19246",42,30,30,0,0,"Cs",2
9,"9339",126,105,105,1,0,"Cs",11
9,"9120",38,32,31,2,1,"Cs",3
38,"38020",15899,11057,10924,90,133,"Cs",1308
9,"9445",43,36,34,1,2,"Cs",3
50,"50130",362,252,249,1,3,"Cs",61
22,"22203",76,61,61,0,0,"Cs",9
18,"18185",542,454,453,2,1,"Cs",45
30,"30004",1126,884,876,5,8,"Cs",52
5,"5105",336,272,266,2,6,"Cs",52
47,"47198",66,47,47,0,0,"Cs",3
16,"16073",188,159,155,0,4,"Cs",11
21,"21044",17955,11674,11479,136,195,"Cs",1721
29,"29019",864,687,679,7,8,"Cs",66
15,"15059",10255,7423,7262,122,161,"Cs",729
49,"49048",114,85,85,0,0,"Cs",14
8,"8087",149,135,133,0,2,"Cs",5
45,"45194",65,49,48,0,1,"Cs",5
24,"24124",346,231,226,2,5,"Cs",49
37,"37183",386,296,294,4,2,"Cs",43
27,"27012",1276,776,768,9,8,"Cs",40
44,"44020",22,18,18,0,0,"Cs",5
38,"38022",18629,12903,12759,84,144,"Cs",1973
11,"11027",68637,48919,48441,519,478,"Cs",9686
9,"9177",1127,883,877,6,6,"Cs",208
9,"9447",43,40,40,0,0,"Cs",7
28,"28036",2675,2135,2093,17,42,"Cs",448
19,"19113",446,352,342,3,10,"Cs",38
29,"29021",159,121,120,0,1,"Cs",10
20,"20005",1267,884,882,2,2,"Cs",10
23,"23047",1579,1260,1247,13,13,"Cs",127
13,"13033",1560,1278,1262,9,16,"Cs",102
5,"5108",40,28,28,0,0,"Cs",3
10,"10215",413,305,301,2,4,"Cs",28
37,"37025",244,209,206,0,3,"Cs",38
9,"9023",1178,982,966,14,16,"Cs",246
26,"26080",453,385,383,2,2,"Cs",52
46,"46116",13608,10792,10731,76,61,"Cs",2157
40,"40152",748,637,620,6,17,"Cs",130
37,"37185",537,416,405,1,11,"Cs",107
28,"28113",36716,29939,29607,224,332,"Cs",6555
38,"38023",125528,88323,87456,598,867,"Cs",11562
26,"26081",15,14,14,1,0,"Cs",0
16,"16035",238,190,188,0,2,"Cs",26
34,"34232",735,595,584,8,11,"Cs",96
18,"18189",772,619,611,4,8,"Cs",92
22,"22206",182,145,145,0,0,"Cs",25
45,"45198",1790,1488,1464,5,24,"Cs",132
34,"34101",45,39,38,0,1,"Cs",8
42,"42095",1857,1498,1473,21,25,"Cs",294
41,"41042",5849,4730,4692,20,38,"Cs",481
37,"37300",547,392,391,5,1,"Cs",86
37,"37068",340,256,256,3,0,"Cs",40
14,"14047",1629,1300,1285,18,15,"Cs",208
37,"37187",555,437,433,0,4,"Cs",87
3,"3034",1391,1107,1090,7,17,"Cs",183
32,"32030",944,690,685,7,5,"Cs",27
15,"15062",5652,3803,3728,25,75,"Cs",330
12,"12139",302,219,217,3,2,"Cs",22
5,"5112",95,66,64,2,2,"Cs",16
34,"34058",185,161,161,1,0,"Cs",21
24,"24171",349,201,198,4,3,"Cs",12
47,"47109",171,130,130,1,0,"Cs",13
22,"22207",121,78,78,1,0,"Cs",16
2,"2019",2368,2009,1975,5,34,"Cs",235
15,"15064",2127,1608,1577,29,31,"Cs",133
45,"45109",2786,2273,2206,9,67,"Cs",287
28,"28040",16648,11709,11551,66,158,"Cs",2274
12,"12041",100,76,75,0,1,"Cs",13
6,"6151",1054,791,778,2,13,"Cs",144
30,"30009",12689,10036,9909,50,127,"Cs",1500
5,"5113",62,49,49,0,0,"Cs",13
11,"11032",54469,33144,32810,461,334,"Cs",7063
3,"3129",1218,994,982,5,12,"Cs",161
48,"48064",613,494,492,1,2,"Cs",2
23,"23051",2727,2060,2023,5,37,"Cs",286
49,"49136",312,227,220,3,7,"Cs",42
8,"8224",878,697,695,1,2,"Cs",48
45,"45065",261,207,205,2,2,"Cs",19
27,"27048",2019,1499,1467,23,32,"Cs",82
49,"49176",610,426,426,4,0,"Cs",39
18,"18088",1530,1152,1142,0,10,"Cs",77
40,"40084",53,40,39,0,1,"Cs",6
46,"46090",1633,1413,1392,5,21,"Cs",168
9,"9352",107,86,86,2,0,"Cs",18
22,"22080",264,208,202,2,6,"Cs",41
46,"46120",1183,958,936,3,22,"Cs",130
34,"34017",889,743,738,6,5,"Cs",95
40,"40123",141,108,104,1,4,"Cs",29
10,"10100",783,584,566,7,18,"Cs",81
22,"22125",39429,29988,29612,337,376,"Cs",5948
23,"23019",1479,1209,1183,3,26,"Cs",152
9,"9032",103,72,72,0,0,"Cs",10
30,"30011",4695,3665,3610,16,55,"Cs",550
10,"10141",289,224,223,0,1,"Cs",23
22,"22081",243,187,186,0,1,"Cs",45
16,"16085",135,109,109,1,0,"Cs",14
13,"13087",23207,17321,17032,202,289,"Cs",3807
15,"15036",56248,40194,39764,508,430,"Cs",4768
50,"50280",301,246,240,1,6,"Cs",40
3,"3132",515,417,414,4,3,"Cs",58
16,"16217",94,77,77,0,0,"Cs",5
9,"9190",86,68,67,0,1,"Cs",4
48,"48067",1134,877,872,5,5,"Cs",5
27,"27019",8189,6148,6039,94,109,"Cs",648
42,"42103",554,448,442,2,6,"Cs",68
46,"46213",15504,11420,11232,124,188,"Cs",2255
36,"36029",16086,12196,12005,126,191,"Cs",1216
9,"9355",87,69,67,1,2,"Cs",7
8,"8252",24729,19751,19642,125,109,"Cs",3020
5,"5232",106,87,84,1,3,"Cs",18
19,"19074",65,60,60,0,0,"Cs",9
26,"26051",210,178,176,1,2,"Cs",19
28,"28013",41563,32024,31693,194,331,"Cs",6244
10,"10102",503,407,403,3,4,"Cs",28
49,"49061",145,111,108,0,3,"Cs",20
5,"5078",100,87,86,0,1,"Cs",16
34,"34214",178,141,141,1,0,"Cs",31
32,"32007",1412,1011,1001,9,10,"Cs",92
12,"12901",3357,2693,2675,19,18,"Cs",511
4,"4064",2879,2196,2179,12,17,"Cs",338
4,"4101",4375,3161,3112,34,49,"Cs",403
24,"24058",195,127,125,1,2,"Cs",12
6,"6067",1915,1393,1370,7,23,"Cs",254
8,"8305",27533,21656,21539,96,117,"Cs",1755
5,"5079",68,56,56,0,0,"Cs",7
22,"22049",74,63,63,0,0,"Cs",7
40,"40054",107,91,88,0,3,"Cs",14
28,"28045",35264,27864,27597,180,267,"Cs",6278
8,"8227",2410,1882,1877,10,5,"Cs",128
23,"23024",12224,9586,9329,46,257,"Cs",1383
12,"12902",2248,1678,1653,7,25,"Cs",253
9,"9306",98,82,81,1,1,"Cs",15
9,"9036",37,33,32,3,1,"Cs",10
44,"44028",171,140,138,1,2,"Cs",20
24,"24020",434,302,299,1,3,"Cs",78
12,"12088",57,54,54,0,0,"Cs",3
21,"21057",995,631,629,3,2,"Cs",78
49,"49064",483,319,317,1,2,"Cs",59
24,"24178",72,65,65,1,0,"Cs",20
37,"37079",80,69,68,2,1,"Cs",12
19,"19126",1687,1306,1285,9,21,"Cs",291
8,"8175",3368,2496,2486,16,10,"Cs",123
40,"40162",387,286,278,3,8,"Cs",48
46,"46258",2636,2100,2079,9,21,"Cs",285
37,"37080",212,173,169,0,4,"Cs",35
5,"5236",106,77,77,0,0,"Cs",11
14,"14054",13796,11042,10799,102,243,"Cs",1735
13,"13047",5780,4553,4461,32,92,"Cs",692
5,"5081",37,29,29,0,0,"Cs",4
36,"36001",2401,1739,1715,19,24,"Cs",112
8,"8307",49310,38223,38022,162,201,"Cs",4326
32,"32065",630,478,474,5,4,"Cs",38
44,"44031",82,52,52,1,0,"Cs",5
22,"22051",91,78,78,1,0,"Cs",10
24,"24180",1101,844,833,8,11,"Cs",143
11,"11041",9858,6916,6763,70,153,"Cs",1460
45,"45120",121,96,96,0,0,"Cs",12
16,"16092",154,113,112,0,1,"Cs",8
12,"12090",104,85,83,1,2,"Cs",9
37,"37237",304,238,234,0,4,"Cs",58
32,"32038",399,274,271,3,3,"Cs",19
37,"37161",121,88,88,0,0,"Cs",10
46,"46005",23013,17487,17286,112,201,"Cs",2993
14,"14057",6139,5054,4964,51,90,"Cs",751
41,"41097",3135,2355,2308,11,47,"Cs",294
50,"50285",650,466,462,7,4,"Cs",82
8,"8256",691,571,568,3,3,"Cs",41
29,"29033",1089,776,761,2,15,"Cs",70
44,"44160",440,311,306,2,5,"Cs",65
40,"40058",309,277,271,0,6,"Cs",43
34,"34027",1046,791,783,13,8,"Cs",122
32,"32039",1142,895,890,7,5,"Cs",58
38,"38035",10384,6657,6596,50,61,"Cs",1121
5,"5083",141,104,103,2,1,"Cs",24
26,"26175",47,40,40,2,0,"Cs",4
2,"2030",2978,2357,2315,13,42,"Cs",295
50,"50113",584,505,495,3,10,"Cs",61
13,"13051",336,272,271,1,1,"Cs",39
20,"20047",462,337,335,2,2,"Cs",2
11,"11901",5698,4167,4080,81,87,"Cs",652
7,"7007",414,326,324,2,2,"Cs",37
34,"34071",161,138,138,0,0,"Cs",12
9,"9043",186,128,128,1,0,"Cs",21
6,"6073",700,506,492,11,14,"Cs",65
27,"27026",2315,1620,1599,17,21,"Cs",136
44,"44063",65,55,55,1,0,"Cs",13
5,"5124",92,71,70,1,1,"Cs",11
4,"4904",1879,1328,1322,4,6,"Cs",166
34,"34206",814,668,660,13,8,"Cs",70
27,"27016",6973,5139,5064,66,75,"Cs",396
8,"8074",11054,8273,8235,34,38,"Cs",1239
8,"8902",3937,3176,3164,17,12,"Cs",364
21,"21026",253,189,183,1,6,"Cs",39
13,"13053",14075,10930,10798,98,132,"Cs",2196
16,"16236",865,669,665,2,4,"Cs",108
27,"27027",1806,1392,1354,18,38,"Cs",84
2,"2032",265,208,203,3,5,"Cs",17
16,"16096",280,239,234,3,5,"Cs",19
34,"34223",205,160,157,1,3,"Cs",12
50,"50115",3275,2399,2355,32,44,"Cs",450
22,"22090",85,66,66,1,0,"Cs",11
5,"5001",179,153,152,2,1,"Cs",20
19,"19135",93,76,72,0,4,"Cs",10
46,"46130",857,680,669,6,11,"Cs",75
8,"8023",6915,5339,5299,26,40,"Cs",618
42,"42117",133,109,106,0,3,"Cs",11
41,"41083",1128,865,859,6,6,"Cs",90
39,"39069",1928,1650,1627,9,23,"Cs",149
16,"16097",139,121,120,1,1,"Cs",6
24,"24187",845,641,630,6,11,"Cs",136
13,"13055",615,475,465,5,10,"Cs",38
47,"47217",1973,1569,1541,19,28,"Cs",339
24,"24027",1219,913,886,8,27,"Cs",130
23,"23031",765,659,647,4,12,"Cs",57
47,"47090",2435,1956,1921,12,35,"Cs",335
21,"21064",6641,4689,4597,66,92,"Cs",688
22,"22225",2610,1867,1843,15,24,"Cs",343
37,"37318",199,152,152,1,0,"Cs",32
36,"36038",66806,50974,50429,507,545,"Cs",6348
26,"26180",223,182,177,3,5,"Cs",30
5,"5243",81,63,62,1,1,"Cs",18
9,"9485",56,50,50,2,0,"Cs",8
24,"24188",3820,3107,3056,33,51,"Cs",501
50,"50176",222,161,156,3,5,"Cs",25
8,"8286",2919,2210,2199,15,11,"Cs",318
34,"34077",381,301,293,2,8,"Cs",52
8,"8076",16497,12734,12667,82,67,"Cs",1395
19,"19323",34,29,29,0,0,"Cs",4
5,"5007",110,81,80,2,1,"Cs",10
23,"23064",1678,1413,1404,10,9,"Cs",100
20,"20022",854,621,621,7,0,"Cs",0
14,"14062",963,753,745,4,8,"Cs",68
47,"47219",40,38,34,0,4,"Cs",5
24,"24069",39,27,27,0,0,"Cs",1
50,"50205",74,58,57,0,1,"Cs",5
45,"45130",302,241,235,2,6,"Cs",21
15,"15016",4569,3171,3146,18,25,"Cs",269
24,"24153",233,187,183,1,4,"Cs",11
44,"44067",108,82,78,0,4,"Cs",7
19,"19142",249,178,177,1,1,"Cs",30
50,"50206",453,371,370,5,1,"Cs",70
49,"49193",435,303,287,1,16,"Cs",57
37,"37091",164,108,108,3,0,"Cs",21
5,"5130",94,86,86,0,0,"Cs",15
8,"8103",640,507,505,4,2,"Cs",43
34,"34228",76,62,62,0,0,"Cs",5
44,"44068",643,518,511,9,7,"Cs",59
30,"30024",60183,45738,45317,290,421,"Cs",8216
50,"50120",55,43,43,2,0,"Cs",10
14,"14064",300,231,227,6,4,"Cs",31
2,"2038",266,217,216,1,1,"Cs",24
5,"5092",146,118,116,0,2,"Cs",27
21,"21068",962,562,550,14,12,"Cs",52
44,"44038",98,83,80,0,3,"Cs",13
19,"19096",101,81,79,1,2,"Cs",7
28,"28097",125,100,100,0,0,"Cs",12
24,"24191",108,89,89,0,0,"Cs",19
50,"50179",264,231,228,0,3,"Cs",20
46,"46195",1982,1562,1554,2,8,"Cs",239
47,"47188",99,77,77,0,0,"Cs",11
23,"23001",920,769,766,3,3,"Cs",123
46,"46074",2678,2158,2135,13,23,"Cs",406
45,"45041",3897,2959,2904,28,55,"Cs",508
8,"8237",1662,1334,1327,7,7,"Cs",42
22,"22102",181,153,151,1,2,"Cs",35
6,"6146",1048,837,819,4,18,"Cs",85
18,"18070",289,224,222,3,2,"Cs",39
47,"47189",151,126,123,0,3,"Cs",13
5,"5210",79,57,57,0,0,"Cs",13
9,"9216",374,283,281,2,2,"Cs",28
26,"26067",20,19,19,0,0,"Cs",2
34,"34179",26,20,19,0,1,"Cs",5
50,"50208",1748,1360,1344,11,16,"Cs",262
3,"3052",967,805,790,4,15,"Cs",137
8,"8106",7469,5816,5795,34,21,"Cs",621
28,"28057",1549,1246,1239,5,7,"Cs",297
9,"9163",578,490,481,5,9,"Cs",97
22,"22062",154,115,115,1,0,"Cs",20
8,"8185",197,172,171,2,1,"Cs",14
48,"48915",347,259,259,4,0,"Cs",1
3,"3053",7469,5950,5865,26,85,"Cs",1210
3,"3116",1159,901,884,3,17,"Cs",168
6,"6082",393,314,305,5,9,"Cs",48
8,"8107",11900,9303,9187,43,116,"Cs",1373
38,"38044",2199,1443,1429,10,14,"Cs",217
19,"19148",42,35,33,0,2,"Cs",6
42,"42218",75,52,51,0,1,"Cs",9
49,"49082",343,288,286,8,2,"Cs",31
16,"16247",63,53,53,1,0,"Cs",0
22,"22232",87,66,65,2,1,"Cs",7
22,"22105",101,82,82,4,0,"Cs",3
37,"37363",107,81,80,0,1,"Cs",3
5,"5135",398,324,320,2,4,"Cs",52
20,"20057",194,143,143,0,0,"Cs",1
38,"38045",3549,2149,2109,6,40,"Cs",202
18,"18916",1778,1249,1236,9,13,"Cs",203
24,"24197",736,556,552,7,4,"Cs",78
37,"37099",61,46,46,1,0,"Cs",2
37,"37327",179,154,150,0,4,"Cs",37
26,"26109",73,66,66,0,0,"Cs",4
30,"30028",6400,4364,4289,30,75,"Cs",656
10,"10041",1025,840,825,6,15,"Cs",83
22,"22106",20,15,15,0,0,"Cs",2
29,"29046",2540,1896,1855,13,41,"Cs",322
34,"34234",68,59,57,0,2,"Cs",5
3,"3055",5247,4042,3991,24,51,"Cs",809
38,"38046",9271,7297,7212,53,85,"Cs",1058
50,"50124",399,316,316,3,0,"Cs",78
47,"47193",1609,1347,1332,9,15,"Cs",270
18,"18074",264,207,205,0,2,"Cs",19
46,"46159",23051,17496,17359,104,137,"Cs",3030
48,"48084",21858,15943,15796,116,147,"Cs",367
37,"37101",142,119,117,0,2,"Cs",17
40,"40144",18,16,16,0,0,"Cs",2
9,"9220",70,59,58,0,1,"Cs",8
19,"19285",20,18,18,0,0,"Cs",3
32,"32050",2280,1788,1775,19,13,"Cs",116
18,"18111",2849,2193,2160,24,33,"Cs",394
47,"47131",165,127,127,3,0,"Cs",18
10,"10043",754,578,572,3,6,"Cs",73
24,"24079",872,671,665,4,6,"Cs",110
12,"12009",17859,13054,12911,98,143,"Cs",2303
46,"46231",2401,1780,1770,8,10,"Cs",166
47,"47226",149,124,123,0,1,"Cs",16
22,"22235",88,72,72,1,0,"Cs",4
18,"18010",532,420,416,2,4,"Cs",71
40,"40181",4166,3405,3337,21,68,"Cs",723
38,"38048",3957,2889,2842,12,47,"Cs",270
14,"14070",1284,988,969,5,19,"Cs",132
29,"29049",2926,2197,2165,9,32,"Cs",216
9,"9062",40,39,39,0,0,"Cs",6
19,"19287",136,107,105,3,2,"Cs",18
5,"5257",135,104,104,0,0,"Cs",21
22,"22236",236,207,203,2,4,"Cs",28
13,"13070",766,620,604,6,16,"Cs",78
23,"23074",2971,2410,2378,8,32,"Cs",332
28,"28062",288,243,236,0,7,"Cs",44
13,"13071",38130,27060,26802,237,258,"Cs",4943
8,"8190",258,216,215,1,1,"Cs",11
12,"12075",107,89,87,0,2,"Cs",6
5,"5258",107,96,96,2,0,"Cs",19
47,"47134",148,127,126,6,1,"Cs",14
44,"44238",2294,1763,1743,10,20,"Cs",621
34,"34240",87,65,63,3,2,"Cs",11
39,"39079",8861,6827,6745,47,82,"Cs",992
46,"46142",761,580,565,4,15,"Cs",76
9,"9392",49,41,41,0,0,"Cs",7
37,"37104",25,18,18,0,0,"Cs",5
5,"5142",90,83,81,0,2,"Cs",13
27,"27040",3035,2285,2234,19,51,"Cs",95
23,"23075",3220,2559,2524,18,35,"Cs",282
46,"46051",8384,6550,6452,24,98,"Cs",1014
10,"10129",348,263,250,0,13,"Cs",31
36,"36019",1463,1041,1030,14,11,"Cs",77
46,"46021",23977,18032,17879,125,153,"Cs",3469
22,"22242",63,47,45,1,2,"Cs",6
50,"50214",18,10,10,0,0,"Cs",0
34,"34093",81,70,70,0,0,"Cs",9
2,"2049",796,582,574,1,8,"Cs",61
44,"44239",22,19,19,0,0,"Cs",3
45,"45008",142,121,121,0,0,"Cs",9
19,"19290",851,581,577,5,4,"Cs",93
46,"46052",508,436,426,3,10,"Cs",69
37,"37218",48,29,29,0,0,"Cs",5
34,"34094",61,44,44,0,0,"Cs",12
12,"12013",137,113,113,0,0,"Cs",8
42,"42089",57,48,48,1,0,"Cs",4
46,"46174",949,789,770,4,19,"Cs",64
9,"9067",407,285,278,2,7,"Cs",55
45,"45009",464,303,301,2,2,"Cs",22
34,"34096",50,44,44,0,0,"Cs",7
16,"16115",47,35,35,0,0,"Cs",5
37,"37221",394,299,299,2,0,"Cs",32
22,"22244",46,37,37,2,0,"Cs",6
3,"3060",106,84,84,0,0,"Cs",7
6,"6090",824,602,578,4,24,"Cs",90
26,"26005",2480,1687,1661,5,26,"Cs",286
28,"28143",77,62,62,0,0,"Cs",15
44,"44085",49,31,31,0,0,"Cs",1
46,"46023",328,277,269,1,8,"Cs",24
44,"44048",53,47,47,0,0,"Cs",4
16,"16033",1644,1345,1320,11,25,"Cs",190
13,"13031",2471,2044,2020,15,24,"Cs",302
22,"22245",306,266,263,0,3,"Cs",62
28,"28067",4361,3548,3509,14,39,"Cs",634
14,"14075",557,429,411,5,18,"Cs",50
5,"5145",47,27,27,1,0,"Cs",5
37,"37109",177,149,149,3,0,"Cs",30
47,"47042",50,41,39,0,2,"Cs",5
16,"16263",966,763,755,2,8,"Cs",94
50,"50189",678,544,534,5,10,"Cs",76
20,"20065",2943,2145,2124,11,21,"Cs",45
3,"3062",221,182,180,1,2,"Cs",65
14,"14901",915,795,782,8,13,"Cs",34
47,"47232",100,76,76,1,0,"Cs",13
8,"8194",25674,17691,17585,115,106,"Cs",2658
45,"45150",414,326,320,2,6,"Cs",31
34,"34100",131,100,97,1,3,"Cs",14
50,"50132",771,589,576,2,13,"Cs",133
16,"16264",390,338,328,2,10,"Cs",32
49,"49095",279,221,217,0,4,"Cs",47
28,"28068",11554,9122,9022,44,100,"Cs",1839
9,"9403",103,90,89,0,1,"Cs",18
5,"5148",23,17,17,0,0,"Cs",2
36,"36054",11074,8032,7873,77,159,"Cs",761
41,"41014",2486,1939,1878,6,61,"Cs",131
4,"4093",1919,1346,1326,10,20,"Cs",157
50,"50219",4283,3274,3213,53,61,"Cs",768
46,"46147",17133,12260,12120,59,140,"Cs",1935
28,"28114",143,104,104,0,0,"Cs",16
18,"18049",596,485,481,0,4,"Cs",50
28,"28146",1792,1308,1293,8,15,"Cs",204
32,"32029",436,340,337,1,3,"Cs",14
10,"10054",524,435,422,1,13,"Cs",43
19,"19015",84,74,73,0,1,"Cs",15
20,"20067",30618,21972,21854,138,118,"Cs",630
23,"23081",1483,1137,1109,7,28,"Cs",153
39,"39085",6964,5489,5445,28,44,"Cs",1007
44,"44088",23,21,21,0,0,"Cs",3
49,"49097",74,43,43,0,0,"Cs",7
6,"6094",1459,1017,1008,8,9,"Cs",156
5,"5151",80,64,64,1,0,"Cs",5
9,"9406",246,203,200,4,3,"Cs",44
1,"1002",8035,6227,6159,17,68,"Cs",103
8,"8038",1525,1228,1220,2,8,"Cs",76
19,"19299",102,78,78,1,0,"Cs",13
47,"47046",125,107,104,1,3,"Cs",17
22,"22119",1256,963,954,5,9,"Cs",159
42,"42016",20,13,13,0,0,"Cs",3
13,"13023",8950,6359,6271,76,88,"Cs",1027
7,"7030",1590,1234,1202,8,32,"Cs",148
5,"5267",107,71,70,3,1,"Cs",0
27,"27047",1525,1026,1008,5,18,"Cs",54
9,"9074",834,697,694,8,3,"Cs",186
22,"22249",118,93,93,2,0,"Cs",19
5,"5153",87,65,65,1,0,"Cs",12
42,"42151",38,31,30,0,1,"Cs",7
16,"16083",45,29,28,0,1,"Cs",8
38,"38027",5545,3937,3896,22,41,"Cs",426
47,"47016",70,62,61,0,1,"Cs",14
4,"4060",407,308,304,1,4,"Cs",40
46,"46150",1797,1275,1257,9,18,"Cs",169
42,"42017",131,104,104,2,0,"Cs",4
39,"39003",258,205,202,3,3,"Cs",9
7,"7031",24784,16683,16527,160,156,"Cs",3244
16,"16124",1826,1482,1455,6,27,"Cs",135
9,"9239",47,39,39,0,0,"Cs",13
9,"9076",24,17,17,1,0,"Cs",3
24,"24174",469,360,354,5,6,"Cs",50
6,"6064",850,658,647,2,11,"Cs",52
10,"10018",1630,1149,1112,12,37,"Cs",172
5,"5115",516,397,395,3,2,"Cs",52
24,"24055",676,513,508,6,5,"Cs",78
46,"46151",757,586,579,0,7,"Cs",83
9,"9077",30,22,22,0,0,"Cs",6
45,"45020",1239,987,973,4,14,"Cs",152
49,"49101",147,99,96,0,3,"Cs",18
36,"36059",4663,3196,3115,31,81,"Cs",293
8,"8067",5728,4535,4513,21,22,"Cs",243
23,"23086",11442,8618,8431,80,187,"Cs",1585
37,"37231",239,204,203,6,1,"Cs",47
16,"16002",195,166,164,1,2,"Cs",22
37,"37118",120,93,90,2,3,"Cs",21
39,"39005",1406,1127,1110,12,17,"Cs",200
41,"41046",3006,2464,2427,13,37,"Cs",284
7,"7033",28373,17884,17684,201,200,"Cs",2603
42,"42020",4186,3027,2988,28,39,"Cs",412
50,"50137",964,790,781,9,9,"Cs",110
30,"30042",2180,1727,1703,6,24,"Cs",222
48,"48006",309,265,265,0,0,"Cs",0
19,"19305",135,104,103,3,1,"Cs",16
40,"40194",39191,31175,30785,250,390,"Cs",6349
3,"3133",41499,26593,26308,151,285,"Cs",4496
20,"20042",3172,2247,2231,9,16,"Cs",35
7,"7001",3628,2792,2753,18,39,"Cs",375
45,"45114",560,441,436,0,5,"Cs",76
49,"49103",394,343,339,3,4,"Cs",63
46,"46244",59626,44018,43679,342,339,"Cs",8257
28,"28074",140580,113723,112489,776,1234,"Cs",21108
6,"6100",852,681,677,3,4,"Cs",64
22,"22214",118,98,97,1,1,"Cs",11
30,"30013",7467,5621,5553,26,68,"Cs",838
16,"16004",227,193,191,0,2,"Cs",16
36,"36061",8617,6498,6391,59,107,"Cs",601
29,"29062",651,576,567,4,9,"Cs",46
20,"20043",1734,1254,1248,5,6,"Cs",9
49,"49062",105,69,69,1,0,"Cs",4
23,"23055",46343,33603,33225,243,378,"Cs",5942
15,"15007",3179,2333,2304,22,29,"Cs",145
16,"16005",232,175,172,0,3,"Cs",28
44,"44190",65,45,43,0,2,"Cs",13
45,"45162",632,481,471,2,10,"Cs",61
9,"9035",284,213,210,1,3,"Cs",56
19,"19175",30,19,19,1,0,"Cs",0
5,"5040",64,51,51,1,0,"Cs",8
46,"46033",196,169,168,3,1,"Cs",23
48,"48070",528,392,390,2,2,"Cs",2
49,"49143",194,141,135,2,6,"Cs",15
45,"45072",661,525,517,3,8,"Cs",69
9,"9248",78,64,64,0,0,"Cs",24
8,"8122",1716,1260,1254,8,6,"Cs",88
3,"3071",3988,3125,3088,28,37,"Cs",420
12,"12117",3545,2770,2698,11,72,"Cs",421
47,"47052",6752,5665,5589,57,76,"Cs",1450
41,"41050",5180,4217,4149,34,68,"Cs",610
10,"10024",675,518,505,4,13,"Cs",80
3,"3011",8014,5870,5810,38,60,"Cs",1230
22,"22901",714,521,508,3,13,"Cs",78
19,"19027",131,98,96,0,2,"Cs",11
20,"20075",4346,3158,3134,19,24,"Cs",71
21,"21058",2556,1732,1709,21,23,"Cs",161
19,"19127",90,63,63,0,0,"Cs",7
50,"50199",325,238,232,3,6,"Cs",31
8,"8097",1080,891,880,2,11,"Cs",44
24,"24061",1736,1350,1328,10,22,"Cs",288
9,"9249",50,39,39,0,0,"Cs",11
49,"49107",116,82,81,1,1,"Cs",7
44,"44099",649,457,450,2,7,"Cs",74
27,"27055",1197,857,851,2,6,"Cs",47
7,"7037",3357,2142,2120,16,22,"Cs",304
22,"22130",10128,7355,7294,61,61,"Cs",1359
33,"33002",9474,6779,6662,74,117,"Cs",765
2,"2065",443,373,370,0,3,"Cs",35
9,"9250",259,215,214,1,1,"Cs",22
5,"5161",550,444,434,2,10,"Cs",42
42,"42204",54,45,43,2,2,"Cs",2
40,"40901",414,331,328,8,3,"Cs",62
22,"22087",58,47,47,0,0,"Cs",8
38,"38004",4490,3242,3202,18,40,"Cs",429
40,"40199",101,79,78,0,1,"Cs",25
33,"33064",250,175,174,0,1,"Cs",20
47,"47054",613,501,498,0,3,"Cs",83
28,"28124",59,52,52,0,0,"Cs",15
19,"19179",76,66,64,1,2,"Cs",4
9,"9253",106,88,85,2,3,"Cs",16
10,"10027",76,66,66,0,0,"Cs",3
29,"29034",467,374,373,1,1,"Cs",63
47,"47055",192,157,154,1,3,"Cs",20
19,"19034",23,23,22,0,1,"Cs",6
3,"3074",1750,1433,1427,3,6,"Cs",296
48,"48012",2071,1685,1674,7,11,"Cs",9
8,"8125",25485,19719,19627,101,92,"Cs",2494
10,"10068",711,576,556,2,20,"Cs",59
44,"44003",17,14,14,0,0,"Cs",4
26,"26138",4545,3433,3374,27,59,"Cs",568
41,"41053",21618,16549,16150,194,399,"Cs",3044
24,"24103",264,162,161,1,1,"Cs",14
9,"9255",84,70,70,1,0,"Cs",13
35,"35009",20109,15017,14803,78,214,"Cs",1618
16,"16095",81,69,68,1,1,"Cs",5
34,"34904",300,220,220,0,0,"Cs",29
39,"39012",6737,5391,5314,52,77,"Cs",893
48,"48908",249,214,213,0,1,"Cs",3
8,"8126",8865,7125,7098,33,27,"Cs",895
37,"37127",200,145,145,1,0,"Cs",22
19,"19318",23,18,18,0,0,"Cs",0
22,"22135",174,132,132,5,0,"Cs",22
2,"2069",11414,9019,8883,54,136,"Cs",1776
34,"34122",86,68,66,0,2,"Cs",7
44,"44196",125,96,95,2,1,"Cs",10
23,"23096",2571,2099,2063,9,36,"Cs",261
26,"26139",55,43,43,0,0,"Cs",10
7,"7042",10785,7256,7191,60,65,"Cs",1014
19,"19038",22,19,19,0,0,"Cs",0
20,"20080",7709,5629,5588,28,41,"Cs",123
10,"10193",1412,1158,1145,4,13,"Cs",304
35,"35011",24705,17099,16823,129,276,"Cs",2518
37,"37354",5467,3960,3910,31,50,"Cs",996
18,"18100",7981,5900,5769,44,131,"Cs",901
42,"42164",1589,1201,1172,10,29,"Cs",216
12,"12122",767,655,646,3,9,"Cs",49
13,"13902",449,362,360,2,2,"Cs",64
47,"47058",202,154,153,3,1,"Cs",17
40,"40203",958,801,788,6,13,"Cs",168
23,"23062",1418,1206,1190,5,16,"Cs",91
6,"6075",475,379,369,2,10,"Cs",28
12,"12094",875,694,682,2,12,"Cs",82
9,"9258",171,142,141,2,1,"Cs",17
18,"18033",279,221,220,1,1,"Cs",28
9,"9098",477,372,360,4,12,"Cs",86
37,"37129",252,206,202,2,4,"Cs",29
3,"3110",312,271,269,1,2,"Cs",23
37,"37243",90,71,70,0,1,"Cs",13
37,"37007",399,311,306,3,5,"Cs",74
46,"46070",17700,13558,13437,115,121,"Cs",3042
50,"50234",242,194,187,3,7,"Cs",36
29,"29095",3304,2536,2470,22,66,"Cs",329
46,"46162",1177,954,938,4,16,"Cs",75
8,"8128",577,454,451,0,3,"Cs",14
18,"18911",7869,5871,5765,49,106,"Cs",1222
37,"37008",4222,3431,3393,19,38,"Cs",697
18,"18138",2482,1698,1668,20,30,"Cs",181
6,"6110",137,106,105,0,1,"Cs",16
10,"10075",236,186,182,1,4,"Cs",23
22,"22139",78,60,60,0,0,"Cs",5
7,"7045",1300,1038,1030,6,8,"Cs",131
16,"16016",216,175,174,3,1,"Cs",11
37,"37205",217,177,174,0,3,"Cs",23
8,"8261",2378,1821,1815,14,6,"Cs",260
22,"22021",1884,1465,1450,13,15,"Cs",267
32,"32072",3687,2715,2682,22,33,"Cs",265
42,"42033",50,45,44,1,1,"Cs",2
50,"50149",33,25,25,1,0,"Cs",8
12,"12034",1400,1108,1080,7,28,"Cs",123
22,"22022",543,441,433,4,8,"Cs",99
49,"49117",437,340,335,1,5,"Cs",73
49,"49239",617,437,420,7,17,"Cs",42
37,"37010",923,739,735,2,4,"Cs",177
22,"22141",114,86,85,0,1,"Cs",11
33,"33070",3293,2499,2473,32,26,"Cs",310
34,"34127",80,64,64,1,0,"Cs",8
10,"10198",1071,945,924,3,21,"Cs",98
46,"46225",348,279,273,2,6,"Cs",27
40,"40032",378,287,278,1,9,"Cs",79
32,"32045",2360,1712,1689,18,23,"Cs",126
49,"49197",162,129,123,2,6,"Cs",26
34,"34229",58,42,40,1,2,"Cs",1
8,"8026",193,161,161,1,0,"Cs",3
38,"38042",3781,2799,2774,11,25,"Cs",323
45,"45132",2376,1915,1908,13,7,"Cs",440
8,"8010",4207,3327,3304,13,23,"Cs",263
19,"19097",14,13,13,0,0,"Cs",1
21,"21033",561,428,427,4,1,"Cs",46
9,"9267",113,102,101,2,1,"Cs",23
37,"37134",212,156,148,0,8,"Cs",14
16,"16146",87,68,68,0,0,"Cs",5
24,"24155",442,374,371,6,3,"Cs",56
1,"1027",430,295,293,2,2,"Cs",5
16,"16245",400,329,318,0,11,"Cs",36
12,"12127",67,50,50,1,0,"Cs",3
20,"20055",17378,12565,12482,55,83,"Cs",209
14,"14005",6318,4464,4380,59,84,"Cs",546
37,"37248",152,125,121,1,4,"Cs",27
39,"39018",4272,3533,3476,17,57,"Cs",527
10,"10080",360,256,246,0,10,"Cs",39
44,"44071",585,449,447,6,2,"Cs",80
46,"46136",2619,2030,2003,24,27,"Cs",324
47,"47190",95,81,81,1,0,"Cs",16
45,"45043",783,670,664,6,6,"Cs",63
19,"19046",22148,17383,17137,125,246,"Cs",3444
8,"8290",1534,1289,1284,9,5,"Cs",81
19,"19193",23,20,20,0,0,"Cs",3
37,"37250",332,232,231,1,1,"Cs",37
9,"9269",29,25,23,1,2,"Cs",5
34,"34084",155,127,126,1,1,"Cs",15
24,"24114",2893,2017,1989,17,28,"Cs",204
6,"6115",1243,898,876,3,22,"Cs",151
16,"16023",507,401,398,2,3,"Cs",69
5,"5057",2401,1949,1917,19,32,"Cs",283
9,"9109",1066,686,650,11,36,"Cs",66
22,"22027",306,230,225,3,5,"Cs",41
50,"50063",61,54,54,0,0,"Cs",4
49,"49122",778,586,573,6,13,"Cs",111
45,"45046",2369,1860,1832,5,28,"Cs",209
27,"27066",12633,9139,8911,84,228,"Cs",852
9,"9270",159,119,117,4,2,"Cs",29
49,"49244",49,32,32,1,0,"Cs",6
50,"50064",438,368,362,1,6,"Cs",32
19,"19049",9,8,8,0,0,"Cs",1
42,"42176",27,22,22,2,0,"Cs",5
26,"26150",100,83,83,0,0,"Cs",4
50,"50154",116,98,98,0,0,"Cs",22
44,"44112",408,303,293,2,10,"Cs",50
48,"48023",580,493,489,0,4,"Cs",2
37,"37252",101,80,79,1,1,"Cs",14
50,"50065",55,43,43,1,0,"Cs",7
19,"19333",105,74,73,1,1,"Cs",6
46,"46048",3509,2758,2720,11,38,"Cs",332
24,"24117",412,336,335,0,1,"Cs",51
9,"9112",104,76,76,1,0,"Cs",14
40,"40073",385,339,335,6,4,"Cs",69
2,"2081",18331,14219,13987,108,232,"Cs",2381
48,"48024",999,813,811,2,2,"Cs",5
26,"26151",411,353,351,3,2,"Cs",54
16,"16152",32,28,28,1,0,"Cs",2
3,"3086",166,143,143,1,0,"Cs",30
9,"9439",1054,867,851,8,16,"Cs",231
37,"37253",133,107,103,0,4,"Cs",23
22,"22029",119,103,103,0,0,"Cs",15
39,"39022",969,740,732,2,8,"Cs",90
27,"27902",7150,5067,4953,74,114,"Cs",560
19,"19197",27,22,22,0,0,"Cs",2
15,"15023",6318,4501,4436,40,65,"Cs",440
3,"3088",5810,4380,4313,31,67,"Cs",881
10,"10085",319,240,236,1,4,"Cs",33
37,"37290",134,113,112,0,1,"Cs",24
9,"9275",166,130,130,2,0,"Cs",17
12,"12131",59,50,50,0,0,"Cs",3
18,"18148",803,652,648,0,4,"Cs",61
10,"10086",303,249,244,3,5,"Cs",44
5,"5061",261,214,208,0,6,"Cs",43
6,"6119",681,551,547,1,4,"Cs",97
9,"9115",91,71,66,2,5,"Cs",6
22,"22032",107,74,74,2,0,"Cs",11
39,"39023",6523,5205,5144,22,61,"Cs",698
37,"37255",42,31,31,2,0,"Cs",5
19,"19005",91,63,63,0,0,"Cs",5
34,"34137",24,23,22,2,1,"Cs",1
22,"22156",296,246,242,3,4,"Cs",51
40,"40111",52,44,44,0,0,"Cs",1
12,"12132",484,415,412,4,3,"Cs",50
5,"5180",82,61,60,0,1,"Cs",6
1,"1037",585,426,425,1,1,"Cs",6
16,"16154",4752,3798,3732,37,66,"Cs",413
22,"22035",226,174,174,0,0,"Cs",24
37,"37256",195,152,150,0,2,"Cs",37
33,"33078",126,87,85,0,2,"Cs",6
49,"49008",431,293,289,2,4,"Cs",33
44,"44017",272,221,219,0,2,"Cs",56
40,"40112",2772,2255,2223,21,32,"Cs",588
47,"47229",231,174,168,0,6,"Cs",21
9,"9226",56,47,47,0,0,"Cs",10
21,"21006",3329,2307,2262,20,45,"Cs",219
37,"37144",338,275,273,1,2,"Cs",40
5,"5181",46,39,39,0,0,"Cs",5
15,"15027",1555,1227,1204,18,23,"Cs",124
48,"48027",22668,17326,17224,95,102,"Cs",434
37,"37021",69,52,51,1,1,"Cs",2
4,"4052",12767,9352,9269,90,83,"Cs",1875
46,"46082",4958,3801,3759,21,42,"Cs",765
26,"26040",63,51,50,0,1,"Cs",3
45,"45192",2412,2103,2068,7,35,"Cs",301
19,"19057",72,59,58,0,1,"Cs",4
44,"44209",815,606,592,2,14,"Cs",120
49,"49047",100,72,72,0,0,"Cs",7
26,"26041",114,84,84,0,0,"Cs",7
40,"40008",45,37,37,0,0,"Cs",8
47,"47167",242,212,210,0,2,"Cs",34
18,"18151",259,194,193,3,1,"Cs",16
42,"42048",60,50,50,0,0,"Cs",6
10,"10091",350,293,291,1,2,"Cs",56
6,"6024",1133,963,941,5,22,"Cs",160
28,"28173",519,417,412,4,5,"Cs",61
24,"24123",716,514,507,2,7,"Cs",59
37,"37259",36,29,29,0,0,"Cs",5
26,"26042",799,605,596,5,9,"Cs",69
32,"32083",821,592,587,7,5,"Cs",23
27,"27043",1219,814,797,6,17,"Cs",35
42,"42092",62,42,41,1,1,"Cs",5
24,"24007",753,569,563,4,6,"Cs",68
13,"13077",3399,2447,2380,30,67,"Cs",440
37,"37146",102,86,86,1,0,"Cs",14
18,"18152",906,692,686,1,6,"Cs",59
7,"7059",3035,2257,2226,13,31,"Cs",345
42,"42050",27,21,21,1,0,"Cs",4
50,"50246",38,28,28,0,0,"Cs",6
46,"46176",2045,1450,1434,12,16,"Cs",233
40,"40220",62,48,48,0,0,"Cs",8
40,"40118",47,38,37,2,1,"Cs",10
14,"14015",2067,1575,1551,16,24,"Cs",260
45,"45058",352,270,269,5,1,"Cs",32
9,"9287",199,169,168,1,1,"Cs",30
10,"10174",171,129,127,0,2,"Cs",9
29,"29076",2335,1661,1614,11,47,"Cs",298
12,"12136",2606,2262,2223,17,39,"Cs",294
8,"8221",12699,10571,10537,53,34,"Cs",1235
50,"50247",842,621,616,7,5,"Cs",130
12,"12137",37,27,27,0,0,"Cs",2
3,"3032",99,87,87,0,0,"Cs",10
23,"23048",820,644,636,1,8,"Cs",78
45,"45060",158,118,118,0,0,"Cs",15
18,"18048",2462,1873,1832,16,41,"Cs",356
24,"24127",268,204,201,3,3,"Cs",35
40,"40221",48,42,42,0,0,"Cs",18
5,"5186",1558,1255,1247,9,8,"Cs",265
49,"49257",310,205,202,2,3,"Cs",32
47,"47171",384,315,311,5,4,"Cs",69
22,"22042",117,96,95,1,1,"Cs",21
46,"46117",500,407,399,1,8,"Cs",62
42,"42190",92,74,73,1,1,"Cs",13
35,"35027",10499,7651,7530,57,121,"Cs",1195
15,"15031",23779,17963,17787,213,176,"Cs",2733
9,"9450",25,17,17,0,0,"Cs",3
46,"46087",109,98,98,1,0,"Cs",4
14,"14017",10945,8514,8386,90,128,"Cs",1292
10,"10217",521,436,432,0,4,"Cs",50
37,"37149",61,56,54,1,2,"Cs",6
45,"45062",1074,888,867,4,21,"Cs",91
12,"12050",1230,987,972,10,15,"Cs",64
37,"37027",235,188,184,2,4,"Cs",37
9,"9451",238,211,207,2,4,"Cs",32
18,"18157",1148,914,898,8,16,"Cs",151
50,"50249",284,229,227,1,2,"Cs",80
26,"26164",51,37,37,1,0,"Cs",5
9,"9129",89,75,75,0,0,"Cs",8
19,"19066",50,43,43,0,0,"Cs",1
21,"21013",10570,7195,7089,73,106,"Cs",1015
50,"50074",6166,4547,4444,33,103,"Cs",1006
5,"5073",289,239,238,0,1,"Cs",45
40,"40014",56,44,43,2,1,"Cs",9
9,"9130",66,55,52,0,3,"Cs",11
6,"6129",573,455,451,2,4,"Cs",61
10,"10098",381,310,309,1,1,"Cs",43
15,"15033",2422,1887,1866,13,21,"Cs",128
50,"50165",1783,1359,1330,20,29,"Cs",312
46,"46252",128,106,106,2,0,"Cs",5
18,"18051",1090,800,795,13,5,"Cs",102
49,"49260",700,558,548,8,10,"Cs",105
44,"44122",1284,995,984,15,11,"Cs",158
8,"8170",442,338,338,0,0,"Cs",16
34,"34154",76,59,58,0,1,"Cs",7
14,"14019",6408,5163,5086,58,77,"Cs",704
5,"5901",253,173,171,1,2,"Cs",30
22,"22045",73,57,56,0,1,"Cs",5
9,"9455",43,37,36,0,1,"Cs",9
26,"26166",147,136,136,2,0,"Cs",42
40,"40016",54,43,43,1,0,"Cs",7
50,"50075",72,59,59,1,0,"Cs",3
24,"24014",7180,5189,5097,46,92,"Cs",861
24,"24094",1326,982,966,4,16,"Cs",128
28,"28084",16103,12519,12378,82,141,"Cs",2673
47,"47048",175,148,148,0,0,"Cs",34
29,"29083",2062,1607,1574,9,33,"Cs",157
34,"34156",50,43,43,0,0,"Cs",9
44,"44123",99,69,69,1,0,"Cs",9
5,"5076",473,417,413,7,4,"Cs",92
42,"42057",147,95,93,3,2,"Cs",13
16,"16167",292,235,229,1,6,"Cs",24
20,"20010",1528,1156,1151,5,5,"Cs",17
22,"22170",668,529,520,4,9,"Cs",76
49,"49139",153,111,110,1,1,"Cs",12
50,"50252",5057,3661,3613,36,48,"Cs",607
26,"26050",130,97,97,0,0,"Cs",10
19,"19073",16,13,13,0,0,"Cs",1
49,"49263",45,37,37,0,0,"Cs",4
42,"42195",92,53,53,1,0,"Cs",3
21,"21017",2325,1450,1419,22,31,"Cs",162
23,"23020",1524,1363,1348,12,15,"Cs",159
37,"37268",108,72,70,0,2,"Cs",26
22,"22172",520,412,407,3,5,"Cs",89
6,"6033",1269,1026,1010,4,16,"Cs",100
41,"41047",10411,8348,8242,84,106,"Cs",1687
8,"8226",926,811,807,1,4,"Cs",26
8,"8068",6878,5456,5437,25,19,"Cs",682
49,"49264",540,372,369,1,3,"Cs",55
14,"14022",3886,3080,3043,18,37,"Cs",281
9,"9302",98,75,73,0,2,"Cs",19
45,"45069",1817,1460,1438,4,22,"Cs",193
32,"32006",1434,1033,1019,8,14,"Cs",48
22,"22127",529,434,432,4,2,"Cs",109
24,"24219",492,374,371,5,3,"Cs",45
47,"47177",100,80,79,0,1,"Cs",12
20,"20012",148,113,112,0,1,"Cs",0
19,"19076",19,18,18,0,0,"Cs",0
50,"50051",800,615,608,3,7,"Cs",60
9,"9136",173,130,128,0,2,"Cs",20
48,"48038",1158,891,891,2,0,"Cs",11
40,"40019",29,26,26,0,0,"Cs",3
34,"34159",370,247,244,5,3,"Cs",23
49,"49022",280,243,241,1,2,"Cs",28
42,"42060",29,20,19,0,1,"Cs",2
36,"36901",4152,3400,3338,15,62,"Cs",307
26,"26053",195,161,160,3,1,"Cs",17
29,"29086",774,537,532,1,5,"Cs",66
37,"37271",351,286,280,0,6,"Cs",60
3,"3102",7226,5600,5516,28,84,"Cs",775
13,"13046",693,558,547,0,11,"Cs",65
7,"7003",12374,7550,7442,51,108,"Cs",1242
50,"50255",197,162,160,2,2,"Cs",14
37,"37035",165,134,134,0,0,"Cs",20
46,"46094",20691,15841,15672,88,169,"Cs",3048
37,"37272",133,106,106,1,0,"Cs",23
28,"28088",286,193,193,2,0,"Cs",29
48,"48040",1309,979,973,5,6,"Cs",7
50,"50227",110,74,73,2,1,"Cs",9
23,"23057",732,613,611,4,2,"Cs",51
42,"42200",76,54,53,0,1,"Cs",7
23,"23025",2727,2125,2090,8,35,"Cs",279
40,"40233",396,323,320,2,3,"Cs",54
19,"19221",35,26,26,0,0,"Cs",2
38,"38002",972,678,640,3,38,"Cs",51
18,"18061",1000,827,822,1,5,"Cs",83
24,"24100",754,602,598,7,4,"Cs",104
8,"8045",71,52,49,0,3,"Cs",0
28,"28089",3842,3087,3048,12,39,"Cs",674
47,"47180",57,46,46,1,0,"Cs",13
21,"21022",186,132,129,0,3,"Cs",15
44,"44222",122,102,102,1,0,"Cs",15
29,"29089",3161,2477,2426,19,51,"Cs",159
8,"8229",521,435,433,3,2,"Cs",10
13,"13048",506,388,384,3,4,"Cs",30
10,"10107",1030,840,828,5,12,"Cs",63
11,"11005",4520,3212,3128,23,84,"Cs",450
50,"50081",491,390,384,5,6,"Cs",42
1,"1058",1403,958,951,4,7,"Cs",15
26,"26174",132,116,116,5,0,"Cs",9
44,"44223",73,58,58,0,0,"Cs",14
37,"37082",745,546,536,2,10,"Cs",73
50,"50082",84,63,63,0,0,"Cs",11
37,"37039",282,222,222,1,0,"Cs",44
23,"23027",716,524,518,2,6,"Cs",65
49,"49109",562,445,444,5,1,"Cs",45
46,"46006",4468,3731,3683,22,48,"Cs",546
34,"34167",110,88,88,0,0,"Cs",9
20,"20017",8484,6294,6263,25,31,"Cs",93
28,"28090",9128,7590,7516,54,74,"Cs",1742
33,"33003",612,373,369,6,4,"Cs",35
49,"49270",137,111,111,0,0,"Cs",15
8,"8151",448,378,377,2,1,"Cs",12
16,"16050",220,182,179,1,3,"Cs",15
50,"50173",149,107,105,0,2,"Cs",14
9,"9476",60,50,50,0,0,"Cs",16
3,"3106",564,485,479,4,6,"Cs",46
47,"47182",1335,1034,1022,6,12,"Cs",255
5,"5199",37,31,31,0,0,"Cs",2
44,"44130",27,24,24,0,0,"Cs",5
37,"37040",382,319,316,1,3,"Cs",55
9,"9311",59,47,46,0,1,"Cs",7
48,"48043",4539,3566,3556,22,10,"Cs",65
28,"28050",4367,3411,3384,14,27,"Cs",826
5,"5125",56,47,43,0,4,"Cs",13
29,"29092",579,434,426,5,8,"Cs",90
34,"34169",381,314,309,6,5,"Cs",57
1,"1061",152,129,129,2,0,"Cs",1
19,"19087",17,14,14,0,0,"Cs",0
50,"50084",66,47,47,0,0,"Cs",18
48,"48044",62054,49055,48840,373,215,"Cs",2484
37,"37277",77,56,56,0,0,"Cs",13
46,"46008",2624,2036,1996,9,40,"Cs",230
46,"46190",50023,37273,36976,250,297,"Cs",7863
50,"50260",32,28,28,0,0,"Cs",3
26,"26178",71,57,56,1,1,"Cs",5
11,"11009",580,429,420,2,9,"Cs",73
19,"19088",95,82,82,2,0,"Cs",9
29,"29093",2164,1704,1678,4,26,"Cs",149
50,"50085",183,136,136,1,0,"Cs",23
46,"46263",239,204,200,3,4,"Cs",10
8,"8207",2014,1736,1730,9,6,"Cs",49
40,"40134",697,560,548,7,12,"Cs",97
26,"26061",1552,1228,1194,14,34,"Cs",180
14,"14030",7797,6116,6036,54,80,"Cs",817
9,"9149",34,27,27,0,0,"Cs",10
34,"34170",51,35,35,0,0,"Cs",7
16,"16186",412,358,354,1,4,"Cs",17
42,"42208",20,16,16,0,0,"Cs",3
12,"12123",43,35,34,1,1,"Cs",3
11,"11010",6351,4472,4385,140,87,"Cs",782
21,"21028",370,300,293,1,7,"Cs",88
33,"33007",1398,960,951,9,9,"Cs",96
36,"36006",11468,8959,8782,66,177,"Cs",836
22,"22094",98,72,71,2,1,"Cs",16
50,"50086",178,121,119,2,2,"Cs",14
47,"47185",87,77,77,0,0,"Cs",19
45,"45083",551,470,465,5,5,"Cs",92
42,"42209",135,107,100,5,7,"Cs",10
16,"16187",55,43,43,0,0,"Cs",9
50,"50001",88,71,70,0,1,"Cs",9
8,"8154",701,587,586,5,1,"Cs",47
37,"37244",128,99,97,1,2,"Cs",25
37,"37046",10749,8133,7989,84,144,"Cs",1648
10,"10115",3488,2878,2816,15,62,"Cs",467
6,"6044",29204,21778,21492,203,286,"Cs",4385
37,"37280",71,41,40,0,1,"Cs",4
22,"22058",191,157,157,3,0,"Cs",22
39,"39043",1523,1246,1220,10,26,"Cs",208
50,"50002",125,96,91,1,5,"Cs",18
26,"26181",14,14,14,0,0,"Cs",0
16,"16906",71,52,52,1,0,"Cs",3
40,"40205",229,185,180,1,5,"Cs",31
38,"38010",3974,2814,2777,20,37,"Cs",278
45,"45085",1511,1141,1128,9,13,"Cs",203
42,"42075",78,60,60,1,0,"Cs",16
8,"8009",9480,7649,7620,35,29,"Cs",796
34,"34035",100,84,82,1,2,"Cs",3
40,"40031",540,429,424,6,5,"Cs",80
29,"29007",28584,21525,21318,202,207,"Cs",4905
41,"41085",4170,3337,3270,27,67,"Cs",536
18,"18068",1606,1293,1277,11,16,"Cs",203
26,"26065",58,49,47,0,2,"Cs",11
50,"50178",276,193,193,4,0,"Cs",39
20,"20023",446,299,299,1,0,"Cs",3
28,"28025",404,314,305,3,9,"Cs",29
19,"19233",82,72,72,1,0,"Cs",14
38,"38041",6970,5288,5258,38,30,"Cs",654
8,"8078",219,176,172,1,4,"Cs",3
12,"12126",24347,19023,18749,152,274,"Cs",2606
10,"10077",637,501,499,3,2,"Cs",125
45,"45086",493,373,368,0,5,"Cs",56
5,"5209",75,58,57,0,1,"Cs",6
37,"37133",101,84,80,0,4,"Cs",18
46,"46165",7298,5744,5697,38,47,"Cs",985
9,"9431",120,98,98,3,0,"Cs",14
47,"47158",858,672,663,8,9,"Cs",86
37,"37284",314,241,237,2,4,"Cs",32
8,"8011",1745,1414,1407,10,7,"Cs",27
42,"42215",735,540,529,5,11,"Cs",76
16,"16019",185,147,147,0,0,"Cs",20
9,"9325",177,117,117,2,0,"Cs",22
23,"23035",1103,903,882,6,21,"Cs",125
15,"15049",1091,805,796,8,9,"Cs",35
12,"12069",53,45,44,1,1,"Cs",9
8,"8131",741,585,585,4,0,"Cs",13
5,"5094",132,109,108,1,1,"Cs",18
37,"37172",853,601,590,4,11,"Cs",111
4,"4080",199,158,157,0,1,"Cs",27
29,"29099",969,757,735,5,22,"Cs",102
50,"50005",239,204,201,2,3,"Cs",35
49,"49158",203,163,155,0,8,"Cs",15
18,"18004",687,521,515,4,6,"Cs",45
29,"29100",2378,1711,1686,22,25,"Cs",238
28,"28027",1200,920,906,4,14,"Cs",159
34,"34039",62,49,49,0,0,"Cs",7
46,"46197",1926,1473,1455,9,18,"Cs",172
5,"5212",197,138,136,0,2,"Cs",21
37,"37174",983,788,768,0,20,"Cs",112
1,"1030",143,118,117,1,1,"Cs",1
44,"44141",127,100,100,0,0,"Cs",19
24,"24036",272,181,179,4,2,"Cs",16
14,"14036",3676,2850,2766,40,84,"Cs",414
19,"19102",92,80,80,0,0,"Cs",13
11,"11017",3194,2265,2221,38,44,"Cs",350
46,"46198",871,707,693,4,14,"Cs",63
5,"5096",79,62,62,1,0,"Cs",4
9,"9328",74,51,50,0,1,"Cs",7
8,"8239",460,380,378,2,2,"Cs",45
50,"50267",573,440,434,7,6,"Cs",74
9,"9166",98,77,77,1,0,"Cs",11
41,"41089",6629,4904,4814,48,90,"Cs",776
20,"20027",2758,1980,1958,19,22,"Cs",9
38,"38015",4067,2951,2926,22,25,"Cs",342
18,"18072",664,481,473,0,8,"Cs",88
3,"3117",377,320,313,1,7,"Cs",35
9,"9011",73,50,49,0,1,"Cs",9
13,"13021",417,343,343,0,0,"Cs",24
50,"50092",300,234,230,1,4,"Cs",36
33,"33014",8771,6425,6368,51,57,"Cs",903
11,"11019",1753,1353,1295,7,58,"Cs",198
41,"41006",2738,1971,1945,16,26,"Cs",215
46,"46017",32990,23940,23694,155,246,"Cs",4250
32,"32077",1104,820,815,10,5,"Cs",64
12,"12073",132,110,107,1,3,"Cs",10
6,"6051",1543,1206,1188,3,18,"Cs",106
37,"37176",130,103,103,1,0,"Cs",16
3,"3025",1292,1009,991,7,18,"Cs",135
50,"50269",279,189,186,1,3,"Cs",16
10,"10002",359,284,279,2,5,"Cs",43
33,"33015",1428,1003,993,7,10,"Cs",117
46,"46109",6174,4763,4639,30,124,"Cs",786
24,"24039",1954,1563,1552,28,11,"Cs",298
50,"50093",83,66,66,1,0,"Cs",11
44,"44236",59,44,44,0,0,"Cs",6
29,"29014",222,151,150,6,1,"Cs",22
26,"26073",94,72,68,0,4,"Cs",4
37,"37329",39,36,36,0,0,"Cs",8
29,"29904",417,337,335,2,2,"Cs",21
9,"9014",192,143,142,0,1,"Cs",26
37,"37058",56,41,41,0,0,"Cs",10
34,"34237",573,479,472,4,7,"Cs",55
44,"44144",325,249,247,1,2,"Cs",40
4,"4085",371,305,303,2,2,"Cs",27
37,"37057",209,165,162,2,3,"Cs",13
34,"34185",68,53,51,1,2,"Cs",4
32,"32023",1132,867,862,7,5,"Cs",51
29,"29015",32064,23769,23461,213,308,"Cs",4459
47,"47194",292,245,243,1,2,"Cs",26
21,"21040",3181,2303,2227,21,76,"Cs",307
29,"29016",263,217,217,0,0,"Cs",24
3,"3089",9497,6952,6794,55,158,"Cs",1167
8,"8162",2124,1659,1651,7,8,"Cs",129
36,"36018",3073,2184,2144,9,40,"Cs",178
21,"21041",112810,77371,76488,900,883,"Cs",16089
44,"44237",368,299,293,2,6,"Cs",37
22,"22201",266,192,192,2,0,"Cs",26
26,"26075",321,266,265,0,1,"Cs",38
20,"20031",183,125,125,2,0,"Cs",0
27,"27009",2022,1514,1488,17,26,"Cs",79
16,"16070",28,26,26,1,0,"Cs",1
47,"47008",22,15,15,0,0,"Cs",1
30,"30002",9735,7319,7227,33,92,"Cs",995
13,"13027",3223,2343,2309,22,34,"Cs",282
32,"32024",4835,3484,3439,23,45,"Cs",353
9,"9338",231,193,189,2,4,"Cs",59
40,"40041",967,773,764,9,9,"Cs",176
37,"37181",264,185,184,1,1,"Cs",17
5,"5219",37,30,30,0,0,"Cs",2
8,"8017",2827,2192,2182,16,10,"Cs",153
33,"33018",2819,2072,2044,28,28,"Cs",255
18,"18184",2170,1688,1656,3,32,"Cs",154
50,"50012",96,79,79,1,0,"Cs",8
19,"19110",56,47,47,0,0,"Cs",6
45,"45100",179,150,148,1,2,"Cs",15
39,"39053",213,146,145,2,1,"Cs",13
4,"4089",694,516,510,1,6,"Cs",55
28,"28034",370,284,280,0,4,"Cs",45
42,"42184",56,42,41,1,1,"Cs",4
14,"14043",7408,5721,5619,76,102,"Cs",817
49,"49169",34,28,26,0,2,"Cs",4
10,"10008",1291,1015,997,16,18,"Cs",145
37,"37062",77,65,63,0,2,"Cs",13
47,"47011",557,478,476,5,2,"Cs",49
5,"5221",323,249,244,1,5,"Cs",31
19,"19111",162,142,142,0,0,"Cs",11
40,"40150",61,53,53,1,0,"Cs",10
42,"42090",88,69,68,2,1,"Cs",8
3,"3030",563,474,466,2,8,"Cs",55
8,"8165",1664,1315,1311,9,4,"Cs",84
28,"28111",622,492,487,1,5,"Cs",95
16,"16158",511,428,417,4,11,"Cs",61
15,"15029",5403,3682,3622,62,60,"Cs",271
6,"6157",397,296,292,1,4,"Cs",23
22,"22162",129,99,99,0,0,"Cs",22
50,"50100",306,238,235,3,3,"Cs",48
45,"45103",362,306,299,0,7,"Cs",18
37,"37184",290,199,195,0,4,"Cs",32
8,"8166",962,753,745,7,8,"Cs",37
41,"41012",3368,2416,2361,23,55,"Cs",278
5,"5222",152,111,109,0,2,"Cs",19
24,"24167",716,516,505,4,11,"Cs",89
9,"9345",117,96,95,1,1,"Cs",14
8,"8088",12248,9945,9904,57,41,"Cs",811
37,"37298",172,126,125,0,1,"Cs",17
28,"28112",154,137,137,1,0,"Cs",28
47,"47200",71,62,62,0,0,"Cs",6
28,"28037",1578,1196,1180,5,16,"Cs",144
10,"10011",532,439,435,3,4,"Cs",70
14,"14045",3013,2508,2468,13,40,"Cs",324
8,"8246",1672,1412,1406,7,6,"Cs",49
49,"49216",147,122,114,0,8,"Cs",17
6,"6092",555,428,419,3,9,"Cs",77
2,"2016",538,405,401,4,4,"Cs",54
49,"49172",481,316,310,2,6,"Cs",28
8,"8247",980,832,828,3,4,"Cs",27
30,"30007",6484,4774,4727,25,47,"Cs",789
3,"3127",351,290,277,2,13,"Cs",39
28,"28038",5155,4142,4090,20,52,"Cs",786
42,"42094",603,484,475,10,9,"Cs",79
19,"19251",39,31,31,0,0,"Cs",2
24,"24129",111,91,91,1,0,"Cs",13
44,"44151",182,139,138,1,1,"Cs",19
8,"8248",5616,4378,4365,32,13,"Cs",481
46,"46026",1202,1012,997,1,15,"Cs",109
45,"45107",3423,2806,2770,18,36,"Cs",557
46,"46208",1070,875,866,2,9,"Cs",80
37,"37186",96,79,79,0,0,"Cs",15
16,"16211",322,233,229,0,4,"Cs",30
4,"4094",209,156,154,0,2,"Cs",9
24,"24051",394,290,283,3,7,"Cs",30
5,"5110",706,550,546,4,4,"Cs",105
12,"12081",602,488,481,0,7,"Cs",67
9,"9181",277,220,219,2,1,"Cs",46
41,"41015",5401,3984,3889,50,95,"Cs",695
48,"48063",356,277,274,2,3,"Cs",1
16,"16212",230,198,196,2,2,"Cs",27
9,"9350",430,340,339,9,1,"Cs",80
37,"37301",79,69,67,0,2,"Cs",11
49,"49055",95,83,83,1,0,"Cs",11
50,"50017",1779,1386,1373,14,13,"Cs",310
5,"5228",167,124,124,0,0,"Cs",22
39,"39058",800,574,573,1,1,"Cs",48
47,"47110",438,352,347,4,5,"Cs",58
50,"50278",177,137,137,2,0,"Cs",24
18,"18087",182514,141305,139588,865,1717,"Cs",25686
16,"16213",34,29,28,0,1,"Cs",4
6,"6162",2895,2289,2254,11,35,"Cs",466
34,"34059",402,326,320,3,6,"Cs",36
9,"9027",48,41,39,0,2,"Cs",3
8,"8250",7182,5461,5421,38,40,"Cs",865
21,"21014",4065,3192,3148,22,44,"Cs",538
50,"50018",893,705,696,3,9,"Cs",115
10,"10139",95,78,77,1,1,"Cs",8
49,"49057",105,85,81,2,4,"Cs",7
37,"37072",145,136,134,3,2,"Cs",16
37,"37190",193,144,144,1,0,"Cs",24
46,"46211",1837,1490,1462,11,28,"Cs",222
16,"16084",50,36,32,0,4,"Cs",2
27,"27017",961,667,654,1,13,"Cs",38
21,"21015",654,363,359,8,4,"Cs",43
3,"3131",179,147,139,0,8,"Cs",11
45,"45066",7770,6064,5962,21,102,"Cs",977
38,"38028",22035,15684,15522,86,162,"Cs",1925
9,"9189",126,102,96,0,6,"Cs",10
50,"50019",64,48,47,0,1,"Cs",2
16,"16216",278,243,240,0,3,"Cs",27
34,"34210",103,90,90,1,0,"Cs",6
8,"8171",2066,1607,1597,7,10,"Cs",70
10,"10140",1082,868,855,8,13,"Cs",152
6,"6902",1663,1273,1252,4,21,"Cs",256
18,"18089",14540,10725,10583,65,142,"Cs",1642
32,"32033",676,480,468,4,12,"Cs",16
38,"38029",1493,839,823,5,16,"Cs",125
46,"46030",796,653,633,7,20,"Cs",81
41,"41018",9410,6987,6882,52,105,"Cs",871
37,"37192",355,234,227,5,7,"Cs",45
39,"39061",3488,2833,2798,18,35,"Cs",476
4,"4099",4931,3781,3719,24,62,"Cs",742
9,"9033",81,69,68,1,1,"Cs",8
5,"5116",96,77,75,0,2,"Cs",9
41,"41019",4895,3518,3462,36,56,"Cs",536
10,"10143",141,118,113,1,5,"Cs",12
36,"36030",3946,2847,2810,26,37,"Cs",263
40,"40053",83,62,62,1,0,"Cs",9
34,"34213",52,42,42,0,0,"Cs",2
28,"28044",6193,5040,4991,31,49,"Cs",1101
15,"15068",4849,3435,3392,55,43,"Cs",309
28,"28014",34047,26858,26575,178,283,"Cs",5775
40,"40018",75,60,60,0,0,"Cs",15
27,"27020",3380,2764,2713,32,51,"Cs",108
2,"2024",3374,2657,2613,23,44,"Cs",462
46,"46123",1948,1469,1446,5,23,"Cs",170
50,"50282",57,47,45,0,2,"Cs",2
47,"47020",272,228,225,5,3,"Cs",29
10,"10144",920,731,723,4,8,"Cs",80
18,"18903",851,644,636,1,8,"Cs",82
8,"8174",392,330,330,4,0,"Cs",16
22,"22215",128,91,91,1,0,"Cs",26
9,"9194",1969,1526,1511,14,15,"Cs",273
37,"37270",183,143,140,1,3,"Cs",29
34,"34215",162,143,142,3,1,"Cs",19
44,"44157",64,38,38,1,0,"Cs",2
41,"41094",6447,4998,4912,43,86,"Cs",796
8,"8096",43555,34070,33871,194,199,"Cs",4070
32,"32008",8572,6301,6216,65,85,"Cs",961
32,"32092",482,337,334,2,3,"Cs",16
50,"50109",98,69,67,3,2,"Cs",16
40,"40055",32,26,25,0,1,"Cs",3
44,"44158",1166,921,904,7,17,"Cs",230
49,"49183",93,73,71,2,2,"Cs",13
50,"50198",49,43,43,1,0,"Cs",6
30,"30015",19372,14430,14283,91,147,"Cs",3059
10,"10023",791,619,614,1,5,"Cs",60
46,"46064",525,427,424,4,3,"Cs",55
22,"22217",372,296,290,5,6,"Cs",53
38,"38032",13536,9924,9867,63,57,"Cs",1664
34,"34068",29,24,23,0,1,"Cs",0
48,"48071",6038,4711,4674,27,37,"Cs",62
49,"49065",1073,789,777,3,12,"Cs",122
8,"8176",161,132,131,2,1,"Cs",4
49,"49146",274,213,209,1,4,"Cs",20
1,"1057",243,202,199,0,3,"Cs",6
39,"39065",232,190,189,5,1,"Cs",22
2,"2028",118,99,98,4,1,"Cs",10
9,"9362",205,177,177,3,0,"Cs",37
34,"34217",1251,1053,1042,7,11,"Cs",221
21,"21059",220,184,180,0,4,"Cs",12
40,"40057",1405,1176,1163,10,13,"Cs",126
33,"33063",374,284,283,3,1,"Cs",16
15,"15009",10615,8066,7919,93,147,"Cs",956
24,"24224",574,435,427,3,8,"Cs",79
3,"3042",1462,1025,1008,3,17,"Cs",127
18,"18062",11041,8531,8355,71,176,"Cs",1719
8,"8004",209,194,191,0,3,"Cs",3
34,"34165",59,51,50,1,1,"Cs",3
45,"45076",564,389,388,2,1,"Cs",48
19,"19130",61365,49363,48747,383,616,"Cs",9372
46,"46218",1031,907,885,6,22,"Cs",104
6,"6071",238,197,193,0,4,"Cs",32
40,"40164",185,136,134,3,2,"Cs",22
12,"12091",176,131,130,0,1,"Cs",27
26,"26095",95,78,78,1,0,"Cs",7
46,"46036",558,391,379,2,12,"Cs",63
8,"8020",5172,4337,4327,26,10,"Cs",458
7,"7006",5332,3769,3722,25,47,"Cs",364
45,"45122",5516,4611,4561,28,50,"Cs",947
10,"10150",331,277,272,6,5,"Cs",32
33,"33034",10043,6765,6671,69,94,"Cs",1225
47,"47025",114,98,98,0,0,"Cs",9
24,"24182",411,302,295,4,7,"Cs",60
9,"9366",75,60,60,2,0,"Cs",10
41,"41024",22737,15687,15398,167,289,"Cs",2671
22,"22221",90,58,56,0,2,"Cs",15
22,"22222",517,407,398,5,9,"Cs",92
14,"14058",7859,5854,5745,51,109,"Cs",1089
9,"9044",53,49,47,1,2,"Cs",14
16,"16234",23,16,16,0,0,"Cs",1
5,"5085",30,27,27,0,0,"Cs",2
34,"34168",45,39,39,0,0,"Cs",4
20,"20048",184,120,120,2,0,"Cs",1
30,"30019",25846,18755,18517,172,238,"Cs",3206
41,"41025",2019,1492,1439,7,53,"Cs",157
48,"48074",3273,2480,2460,14,20,"Cs",40
47,"47026",49,40,39,0,1,"Cs",4
10,"10029",380,320,315,1,5,"Cs",36
38,"38037",12803,8628,8517,48,111,"Cs",941
13,"13054",4914,3946,3890,31,56,"Cs",687
34,"34073",180,149,145,2,4,"Cs",30
9,"9369",422,328,325,8,3,"Cs",57
32,"32041",759,510,502,2,8,"Cs",16
28,"28051",1640,1301,1292,9,9,"Cs",253
8,"8180",27072,21218,21100,126,118,"Cs",3134
5,"5241",3041,2242,2204,24,38,"Cs",375
26,"26100",56,46,46,0,0,"Cs",2
37,"37087",910,755,747,3,8,"Cs",211
21,"21063",2620,2037,1992,11,45,"Cs",227
10,"10153",283,204,199,0,5,"Cs",18
47,"47216",114,102,98,0,4,"Cs",19
40,"40170",1307,1066,1054,7,12,"Cs",193
28,"28127",66441,56199,55932,327,267,"Cs",15338
37,"37317",288,240,238,2,2,"Cs",33
49,"49075",134,118,114,1,4,"Cs",8
10,"10154",177,134,133,1,1,"Cs",17
47,"47089",132,116,115,1,1,"Cs",24
5,"5127",608,499,496,0,3,"Cs",74
34,"34076",545,475,473,2,2,"Cs",80
40,"40062",57,49,49,0,0,"Cs",8
5,"5242",686,588,585,11,3,"Cs",26
19,"19040",57,40,40,0,0,"Cs",6
45,"45173",9729,7664,7558,46,106,"Cs",1480
8,"8181",8061,6442,6402,28,40,"Cs",712
26,"26102",6057,4672,4579,37,93,"Cs",838
3,"3902",10578,7654,7530,56,124,"Cs",1478
34,"34225",5001,4070,4021,48,49,"Cs",743
29,"29039",2728,2084,2050,14,34,"Cs",230
40,"40063",6944,5479,5352,39,127,"Cs",1055
13,"13012",382,279,277,2,2,"Cs",21
40,"40171",39,29,29,1,0,"Cs",6
34,"34227",72,63,61,4,2,"Cs",15
23,"23063",3764,2812,2781,22,31,"Cs",281
45,"45129",109,84,83,0,1,"Cs",16
18,"18102",8227,6100,5969,32,131,"Cs",820
24,"24189",5816,4434,4382,49,52,"Cs",934
22,"22227",199,155,154,1,1,"Cs",27
47,"47029",50,43,43,1,0,"Cs",6
18,"18001",230,173,170,1,3,"Cs",16
26,"26183",66,50,50,0,0,"Cs",7
12,"12096",744,588,580,7,8,"Cs",62
40,"40065",469,376,373,1,3,"Cs",84
29,"29040",1936,1419,1395,7,24,"Cs",185
46,"46042",3348,2825,2774,11,51,"Cs",343
50,"50031",139,97,90,0,7,"Cs",10
9,"9211",1362,1065,1050,16,15,"Cs",126
37,"37320",88,67,67,1,0,"Cs",5
13,"13059",196,169,168,0,1,"Cs",9
14,"14063",1000,767,757,4,10,"Cs",90
12,"12097",65,54,54,1,0,"Cs",7
16,"16242",308,266,263,2,3,"Cs",26
5,"5131",95,72,71,0,1,"Cs",19
6,"6079",644,492,487,3,5,"Cs",58
47,"47220",154,119,119,1,0,"Cs",33
4,"4077",302,275,275,1,0,"Cs",11
40,"40068",22,21,21,0,0,"Cs",4
33,"33009",869,595,591,5,4,"Cs",77
8,"8156",11155,8956,8923,60,33,"Cs",1161
44,"44169",310,250,245,4,5,"Cs",43
37,"37321",149,121,121,0,0,"Cs",20
3,"3113",4342,3194,3154,23,40,"Cs",566
50,"50004",478,380,376,2,4,"Cs",51
34,"34177",176,154,152,2,2,"Cs",21
49,"49156",230,189,182,0,7,"Cs",21
18,"18069",497,374,366,4,8,"Cs",41
19,"19190",2302,1788,1767,13,21,"Cs",270
46,"46135",9827,7928,7883,44,45,"Cs",1560
26,"26106",76,66,65,0,1,"Cs",14
33,"33011",10659,6448,6332,119,116,"Cs",850
7,"7015",21976,14458,14297,205,161,"Cs",2667
23,"23067",2421,1909,1873,13,36,"Cs",203
9,"9055",48,34,34,1,0,"Cs",3
21,"21070",6222,4413,4322,47,91,"Cs",664
19,"19234",45,32,32,0,0,"Cs",5
12,"12006",174,149,149,2,0,"Cs",19
8,"8264",4535,3623,3613,13,10,"Cs",485
37,"37323",476,380,377,7,3,"Cs",78
4,"4003",17540,12174,12051,75,123,"Cs",1654
40,"40070",148,110,107,1,3,"Cs",14
41,"41003",2371,1801,1760,8,41,"Cs",172
47,"47222",86,71,71,0,0,"Cs",14
3,"3083",5487,3993,3934,28,59,"Cs",683
6,"6015",117934,87081,86114,785,967,"Cs",19508
14,"14066",5756,4396,4310,36,86,"Cs",697
9,"9057",148,120,116,0,4,"Cs",17
16,"16106",2708,2200,2163,17,37,"Cs",184
42,"42127",38,27,27,1,0,"Cs",3
7,"7016",2931,2201,2178,31,23,"Cs",311
10,"10039",402,302,301,0,1,"Cs",36
45,"45136",5825,4314,4260,22,54,"Cs",714
50,"50034",787,568,556,3,12,"Cs",95
24,"24076",1286,998,981,8,17,"Cs",158
49,"49201",285,243,243,7,0,"Cs",33
50,"50210",36,29,29,0,0,"Cs",5
37,"37325",90,70,70,0,0,"Cs",3
8,"8029",3560,3027,3019,13,8,"Cs",288
4,"4004",400,320,315,2,5,"Cs",88
24,"24077",215,178,178,0,0,"Cs",37
28,"28059",4515,3573,3542,12,31,"Cs",839
8,"8265",1590,1339,1334,6,5,"Cs",38
8,"8187",153380,120687,120090,637,597,"Cs",14491
12,"12101",356,297,289,2,8,"Cs",39
40,"40072",224,198,194,3,4,"Cs",43
7,"7017",882,652,646,6,6,"Cs",79
47,"47035",902,715,707,5,8,"Cs",97
2,"2043",1173,975,962,1,13,"Cs",118
8,"8188",115,95,95,0,0,"Cs",3
28,"28135",985,762,756,1,6,"Cs",115
44,"44174",409,306,300,3,6,"Cs",56
39,"39077",236,175,173,0,2,"Cs",18
24,"24078",336,259,255,0,4,"Cs",52
16,"16109",41,33,33,3,0,"Cs",2
9,"9168",272,222,216,3,6,"Cs",26
47,"47036",205,162,157,1,5,"Cs",19
13,"13068",1037,802,783,2,19,"Cs",78
30,"30029",12055,9003,8882,58,121,"Cs",1561
49,"49203",287,229,223,2,6,"Cs",27
6,"6084",1065,904,890,8,14,"Cs",116
46,"46230",14084,10694,10599,67,95,"Cs",1861
7,"7019",164,124,124,0,0,"Cs",12
50,"50036",100,80,80,0,0,"Cs",10
23,"23072",1885,1485,1468,5,17,"Cs",182
44,"44175",113,84,82,1,2,"Cs",7
13,"13069",618,488,469,3,19,"Cs",36
3,"3056",8629,6838,6737,38,101,"Cs",1019
14,"14069",7376,5511,5398,47,113,"Cs",595
1,"1033",656,533,525,1,8,"Cs",19
10,"10044",1404,1092,1077,7,15,"Cs",149
42,"42131",52,37,37,0,0,"Cs",4
5,"5139",66,59,59,0,0,"Cs",12
23,"23007",3026,2317,2301,13,16,"Cs",459
45,"45141",849,677,665,4,12,"Cs",77
4,"4008",464,386,383,4,3,"Cs",49
37,"37330",318,255,248,2,7,"Cs",34
10,"10167",307,238,237,1,1,"Cs",10
26,"26113",31,30,30,0,0,"Cs",0
24,"24202",7559,5449,5363,63,86,"Cs",693
33,"33047",1074,841,835,12,6,"Cs",83
6,"6086",1174,869,862,4,7,"Cs",132
48,"48086",2015,1504,1486,6,18,"Cs",31
42,"42007",109,89,89,1,0,"Cs",11
4,"4009",151,126,124,3,2,"Cs",17
21,"21077",1725,1307,1286,10,21,"Cs",142
22,"22110",707,531,528,2,3,"Cs",82
32,"32052",1819,1399,1379,15,20,"Cs",107
24,"24082",860,690,678,12,12,"Cs",103
38,"38049",2683,1781,1743,18,38,"Cs",237
50,"50039",467,366,364,3,2,"Cs",33
8,"8032",2087,1607,1598,9,9,"Cs",128
12,"12105",816,639,625,5,14,"Cs",76
40,"40076",6537,5130,5012,22,118,"Cs",968
18,"18114",591,443,437,2,6,"Cs",72
10,"10169",494,405,395,1,10,"Cs",45
28,"28138",63,49,49,0,0,"Cs",12
8,"8269",2712,2258,2250,19,8,"Cs",102
19,"19156",933,756,745,1,11,"Cs",132
3,"3059",20590,15909,15766,96,143,"Cs",2319
40,"40183",116,103,103,0,0,"Cs",9
18,"18012",2143,1651,1634,8,17,"Cs",182
36,"36050",7650,5616,5506,48,110,"Cs",506
32,"32053",1363,1114,1098,14,16,"Cs",60
22,"22112",9516,7043,6956,84,87,"Cs",1541
29,"29051",41793,29275,28764,249,511,"Cs",6050
26,"26117",2097,1680,1647,17,33,"Cs",227
24,"24206",1611,1286,1268,7,18,"Cs",154
8,"8034",784,648,646,1,2,"Cs",28
34,"34242",93,66,64,1,2,"Cs",10
44,"44178",53,39,39,0,0,"Cs",7
45,"45101",3709,3052,3002,14,50,"Cs",412
19,"19008",37,32,32,1,0,"Cs",1
39,"39081",437,356,347,2,9,"Cs",15
46,"46144",628,511,505,1,6,"Cs",77
49,"49092",116,87,86,0,1,"Cs",8
26,"26118",72,63,60,1,3,"Cs",8
37,"37334",73,49,49,0,0,"Cs",8
16,"16258",172,128,128,2,0,"Cs",11
19,"19160",905,618,613,3,5,"Cs",106
42,"42010",21,18,16,0,2,"Cs",4
27,"27042",1648,1247,1233,21,14,"Cs",35
5,"5025",82,70,70,0,0,"Cs",15
29,"29052",222,156,153,2,3,"Cs",24
34,"34196",88,74,74,4,0,"Cs",10
29,"29020",3280,2531,2485,23,46,"Cs",340
2,"2051",1665,1253,1222,6,31,"Cs",234
34,"34052",167,144,143,2,1,"Cs",20
24,"24209",2609,1880,1857,13,23,"Cs",242
47,"47231",4458,3677,3651,47,26,"Cs",951
9,"9398",74,59,58,1,1,"Cs",1
6,"6091",3668,2839,2776,26,63,"Cs",332
50,"50042",16,16,16,0,0,"Cs",2
22,"22001",214,162,162,0,0,"Cs",26
24,"24087",586,469,460,4,9,"Cs",79
19,"19010",9,10,10,0,0,"Cs",0
36,"36053",5784,4407,4327,28,80,"Cs",406
47,"47043",309,276,273,1,3,"Cs",33
5,"5263",163,121,120,0,1,"Cs",14
26,"26007",481,391,383,0,8,"Cs",42
44,"44181",66,58,57,0,1,"Cs",14
48,"48091",1090,862,857,9,5,"Cs",15
27,"27044",2719,1848,1797,29,51,"Cs",64
19,"19296",27,24,24,0,0,"Cs",2
22,"22002",106,95,94,0,1,"Cs",16
44,"44119",119,83,82,0,1,"Cs",12
12,"12080",1900,1604,1575,10,29,"Cs",165
3,"3063",27121,19869,19713,131,156,"Cs",3617
37,"37337",139,114,114,0,0,"Cs",40
12,"12016",1550,1281,1260,11,21,"Cs",128
26,"26121",30,21,21,1,0,"Cs",1
45,"45014",4020,2910,2854,22,56,"Cs",394
37,"37112",152,104,103,0,1,"Cs",8
46,"46238",13105,9717,9610,57,107,"Cs",1435
45,"45106",7395,5971,5861,40,110,"Cs",825
19,"19165",41,36,36,0,0,"Cs",5
5,"5149",100,82,79,0,3,"Cs",10
8,"8116",558,459,459,0,0,"Cs",11
16,"16265",20,20,19,0,1,"Cs",0
49,"49096",157,129,123,2,6,"Cs",10
36,"36055",13551,9908,9682,105,226,"Cs",1192
3,"3064",5004,3782,3736,20,46,"Cs",869
49,"49220",139,110,104,2,6,"Cs",15
26,"26123",124,112,110,0,2,"Cs",14
14,"14902",1121,928,900,7,28,"Cs",92
46,"46148",1509,1208,1195,7,13,"Cs",227
16,"16122",249,197,196,3,1,"Cs",23
36,"36056",4961,3719,3635,30,84,"Cs",343
42,"42148",9,9,9,0,0,"Cs",1
48,"48094",3125,2407,2388,12,19,"Cs",26
12,"12111",334,283,279,4,4,"Cs",17
34,"34102",202,173,171,2,2,"Cs",21
50,"50134",118,91,89,0,2,"Cs",17
10,"10178",729,567,559,4,8,"Cs",89
6,"6095",9511,7338,7152,116,186,"Cs",962
23,"23082",1875,1402,1389,7,13,"Cs",144
37,"37340",142,101,101,0,0,"Cs",15
15,"15902",4522,3220,3159,47,61,"Cs",274
26,"26124",776,635,624,5,11,"Cs",39
44,"44090",66,49,49,0,0,"Cs",6
36,"36057",238171,181891,180030,1636,1861,"Cs",21474
48,"48095",2326,1691,1680,11,11,"Cs",47
26,"26125",2663,2042,2011,32,31,"Cs",351
40,"40191",204,166,165,1,1,"Cs",33
19,"19301",37,31,31,0,0,"Cs",7
50,"50105",279,216,213,4,3,"Cs",24
24,"24093",338,239,232,3,7,"Cs",23
37,"37341",48,36,36,0,0,"Cs",5
2,"2057",1960,1522,1489,15,33,"Cs",162
49,"49099",98,75,74,0,1,"Cs",8
8,"8040",11004,8468,8431,24,37,"Cs",713
46,"46059",1240,1038,1030,3,8,"Cs",55
33,"33056",4877,3469,3420,30,49,"Cs",645
48,"48005",113,80,80,0,0,"Cs",0
8,"8118",17542,14101,14059,56,42,"Cs",1350
1,"1004",1356,1007,998,3,9,"Cs",19
21,"21052",4429,2951,2891,19,60,"Cs",278
26,"26013",323,258,256,1,2,"Cs",30
42,"42018",131,102,102,1,0,"Cs",19
19,"19170",189,116,116,0,0,"Cs",12
10,"10058",993,739,723,4,16,"Cs",111
37,"37342",255,200,199,1,1,"Cs",53
15,"15004",4873,3689,3623,31,66,"Cs",368
26,"26127",186,162,159,1,3,"Cs",17
8,"8199",651,542,542,4,0,"Cs",26
33,"33057",1538,1129,1097,14,32,"Cs",146
45,"45158",2546,2026,2001,9,25,"Cs",255
42,"42153",12,10,10,1,0,"Cs",0
50,"50223",916,751,745,13,6,"Cs",89
40,"40087",87,70,70,0,0,"Cs",8
48,"48097",1316,979,976,4,3,"Cs",21
28,"28073",12751,9940,9838,63,102,"Cs",2127
5,"5156",234,153,151,0,2,"Cs",17
4,"4022",357,261,261,0,0,"Cs",34
18,"18022",13804,9877,9714,92,163,"Cs",1859
24,"24096",108,69,69,0,0,"Cs",9
29,"29061",1033,840,821,5,19,"Cs",86
26,"26128",96,74,74,1,0,"Cs",3
37,"37345",150,134,133,0,1,"Cs",19
48,"48901",5151,4042,4012,22,30,"Cs",125
50,"50224",65,54,54,1,0,"Cs",7
48,"48007",385,281,279,1,2,"Cs",0
44,"44189",48,36,36,0,0,"Cs",5
5,"5038",113,89,88,0,1,"Cs",5
46,"46062",4572,3571,3510,20,61,"Cs",508
29,"29029",380,294,287,2,7,"Cs",23
5,"5905",222,165,164,1,1,"Cs",40
10,"10184",740,607,597,5,10,"Cs",67
45,"45023",2248,1799,1784,16,15,"Cs",382
19,"19023",127,98,96,0,2,"Cs",17
3,"3070",2106,1554,1528,9,26,"Cs",259
45,"45161",15266,11185,11023,69,162,"Cs",2431
27,"27052",862,645,640,4,5,"Cs",47
42,"42022",206,161,161,1,0,"Cs",26
49,"49227",313,255,254,1,1,"Cs",53
37,"37120",97,83,81,1,2,"Cs",20
39,"39007",393,300,298,1,2,"Cs",17
12,"12025",121,102,99,0,3,"Cs",4
16,"16275",12,12,12,0,0,"Cs",2
22,"22012",102,81,80,1,1,"Cs",17
37,"37347",464,368,359,2,9,"Cs",77
4,"4102",14110,9871,9765,90,106,"Cs",1444
50,"50283",69,53,52,3,1,"Cs",6
46,"46246",1042,860,838,2,22,"Cs",92
30,"30902",8225,5797,5715,22,82,"Cs",1063
45,"45163",8340,6486,6363,38,123,"Cs",1275
28,"28153",795,566,564,5,2,"Cs",86
9,"9085",472,371,365,3,6,"Cs",81
42,"42157",10,10,10,0,0,"Cs",2
12,"12026",835,656,639,4,17,"Cs",60
49,"49023",909,682,674,5,8,"Cs",134
15,"15039",1224,874,850,11,24,"Cs",67
21,"21021",12469,8238,8097,76,141,"Cs",1516
26,"26018",10441,8400,8311,64,89,"Cs",1602
5,"5160",296,236,232,1,4,"Cs",27
22,"22014",233,185,182,3,3,"Cs",32
8,"8203",2472,1884,1873,4,11,"Cs",151
8,"8019",1117818,875679,872180,4327,3499,"Cs",101928
5,"5121",262,201,199,0,2,"Cs",33
37,"37123",162,122,117,3,5,"Cs",23
50,"50902",79,69,69,0,0,"Cs",15
28,"28154",5525,4283,4222,24,61,"Cs",823
12,"12027",17473,12829,12683,90,146,"Cs",2014
19,"19177",61,49,48,0,1,"Cs",6
20,"20076",7025,5263,5237,31,26,"Cs",83
42,"42063",47,31,28,0,3,"Cs",2
34,"34025",53,37,37,2,0,"Cs",4
11,"11004",89545,60056,59323,741,733,"Cs",11926
6,"6004",1549,1276,1257,6,19,"Cs",180
26,"26134",83,70,67,0,3,"Cs",6
10,"10189",2527,1958,1907,12,51,"Cs",257
9,"9363",922,733,725,3,8,"Cs",152
2,"2029",3327,2586,2556,15,30,"Cs",510
10,"10067",10245,7850,7701,80,149,"Cs",1301
8,"8282",6711,5696,5677,27,19,"Cs",503
8,"8046",13478,10989,10939,67,50,"Cs",970
13,"13096",7533,5766,5696,43,70,"Cs",986
37,"37238",106,88,87,1,1,"Cs",18
41,"41052",3027,2357,2288,14,69,"Cs",384
12,"12028",12955,10391,10301,68,90,"Cs",2256
34,"34116",55,45,45,0,0,"Cs",0
8,"8047",3737,2903,2876,16,27,"Cs",247
9,"9419",67,53,52,0,1,"Cs",8
46,"46067",1744,1451,1432,4,19,"Cs",195
26,"26136",92,80,80,3,0,"Cs",10
40,"40094",364,284,279,1,5,"Cs",58
48,"48906",753,611,608,1,3,"Cs",8
48,"48907",340,283,281,1,2,"Cs",0
22,"22017",822,664,660,5,4,"Cs",89
37,"37239",206,184,181,3,3,"Cs",21
12,"12029",673,566,556,3,10,"Cs",51
42,"42028",76,65,65,1,0,"Cs",5
4,"4031",2249,1778,1773,2,5,"Cs",229
9,"9368",28,21,21,1,0,"Cs",6
26,"26099",1216,993,973,14,20,"Cs",160
10,"10192",767,625,614,1,11,"Cs",65
50,"50056",405,332,330,4,2,"Cs",67
16,"16012",77,65,65,0,0,"Cs",1
16,"16137",37,27,25,0,2,"Cs",0
42,"42163",46,37,37,0,0,"Cs",6
7,"7041",2097,1662,1634,20,28,"Cs",143
37,"37353",122,95,95,1,0,"Cs",8
9,"9423",28,26,26,0,0,"Cs",4
4,"4033",125,98,95,0,3,"Cs",12
16,"16902",127,101,101,0,0,"Cs",12
24,"24105",1498,1188,1177,18,11,"Cs",250
27,"27058",3322,2551,2512,22,39,"Cs",127
28,"28158",678,547,540,1,7,"Cs",107
19,"19184",62,45,45,0,0,"Cs",4
47,"47057",273,204,200,0,4,"Cs",41
50,"50057",1332,1001,986,10,15,"Cs",217
19,"19319",4583,3640,3585,24,55,"Cs",857
48,"48909",202,172,172,2,0,"Cs",0
33,"33066",42882,30942,30529,401,413,"Cs",5720
15,"15013",6299,4549,4486,45,63,"Cs",523
16,"16903",996,816,806,9,10,"Cs",108
34,"34123",1637,1376,1354,8,22,"Cs",196
8,"8285",10321,8169,8120,52,49,"Cs",497
9,"9424",34,24,24,0,0,"Cs",2
46,"46222",394,325,324,1,1,"Cs",41
34,"34124",63,58,58,0,0,"Cs",4
33,"33067",747,608,596,9,12,"Cs",56
12,"12032",23649,17680,17505,118,175,"Cs",3095
26,"26141",100,73,73,0,0,"Cs",12
19,"19228",29,22,22,0,0,"Cs",1
4,"4074",2887,2062,2038,16,24,"Cs",287
15,"15014",3836,2739,2698,38,41,"Cs",245
16,"16015",351,251,250,4,1,"Cs",40
42,"42165",419,288,285,8,3,"Cs",55
33,"33068",1047,624,620,8,4,"Cs",70
49,"49114",40,33,32,1,1,"Cs",1
46,"46071",470,382,366,0,16,"Cs",47
19,"19041",167,133,129,1,4,"Cs",22
28,"28161",51559,41390,40922,255,468,"Cs",9892
49,"49115",169,137,136,0,1,"Cs",20
50,"50059",754,599,589,6,10,"Cs",129
12,"12124",1840,1477,1460,8,17,"Cs",197
50,"50148",290,229,227,2,2,"Cs",29
18,"18034",486,376,374,4,2,"Cs",21
37,"37356",87,66,66,0,0,"Cs",9
16,"16142",120,95,95,0,0,"Cs",4
8,"8051",18437,14951,14887,85,64,"Cs",1591
26,"26103",827,655,645,3,10,"Cs",64
16,"16017",340,281,271,2,10,"Cs",20
1,"1022",761,577,569,5,8,"Cs",26
44,"44007",152,120,117,0,3,"Cs",22
50,"50235",2412,1826,1807,22,19,"Cs",420
46,"46072",3542,3008,2961,33,47,"Cs",399
9,"9102",33,26,25,0,1,"Cs",4
37,"37246",5155,4153,4107,33,46,"Cs",920
26,"26143",242,190,189,0,1,"Cs",29
39,"39016",23868,19029,18839,108,190,"Cs",3296
48,"48018",867,605,603,3,2,"Cs",3
5,"5169",219,176,173,1,3,"Cs",26
47,"47061",243,203,197,3,6,"Cs",28
41,"41030",500,419,410,6,9,"Cs",46
47,"47031",196,155,155,3,0,"Cs",23
5,"5053",80,57,57,2,0,"Cs",14
10,"10118",281,242,242,2,0,"Cs",24
8,"8262",6919,5090,5060,33,30,"Cs",470
23,"23101",352,273,271,0,2,"Cs",32
4,"4038",3110,2235,2203,23,32,"Cs",387
22,"22228",529,421,417,3,4,"Cs",123
18,"18913",781,590,577,5,13,"Cs",88
48,"48019",3461,2647,2633,12,14,"Cs",55
15,"15018",1087,771,761,8,10,"Cs",26
44,"44108",300,228,224,5,4,"Cs",39
40,"40139",258,207,202,0,5,"Cs",41
42,"42035",741,537,523,7,14,"Cs",66
45,"45180",2834,2269,2239,11,30,"Cs",397
47,"47062",157,134,134,0,0,"Cs",18
6,"6013",265,227,221,0,6,"Cs",11
9,"9104",47,39,39,0,0,"Cs",1
5,"5055",540,448,445,1,3,"Cs",58
26,"26031",98,89,87,0,2,"Cs",11
42,"42036",40,34,33,2,1,"Cs",8
28,"28164",3202,2553,2530,19,23,"Cs",574
37,"37360",215,158,153,3,5,"Cs",33
19,"19045",127,107,107,1,0,"Cs",12
6,"6014",6535,4757,4679,36,78,"Cs",1011
34,"34130",198,165,161,2,4,"Cs",20
20,"20056",4075,2983,2942,12,41,"Cs",22
15,"15019",26006,18323,18075,280,248,"Cs",2084
28,"28100",4409,3425,3382,20,43,"Cs",689
6,"6048",824,714,702,2,12,"Cs",70
18,"18037",528,435,426,2,9,"Cs",71
27,"27065",12076,8393,8183,128,210,"Cs",547
49,"49120",53,39,39,0,0,"Cs",1
8,"8132",361,281,281,2,0,"Cs",7
19,"19330",67,60,60,0,0,"Cs",1
15,"15020",3593,2491,2469,18,22,"Cs",196
39,"39019",2229,1785,1751,15,34,"Cs",269
26,"26032",45,37,37,1,0,"Cs",3
16,"16148",546,481,479,1,2,"Cs",44
50,"50152",1368,1061,1043,6,18,"Cs",134
19,"19047",55,47,47,0,0,"Cs",4
50,"50153",922,705,704,6,1,"Cs",97
44,"44204",27,22,22,0,0,"Cs",2
37,"37014",1153,414,411,4,3,"Cs",60
48,"48022",2316,1645,1631,11,14,"Cs",22
16,"16149",154,130,130,2,0,"Cs",24
41,"41061",2144,1763,1712,7,51,"Cs",75
29,"29067",430670,312817,309994,2768,2823,"Cs",62563
1,"1031",1163,948,928,6,20,"Cs",35
19,"19048",19,13,13,0,0,"Cs",1
16,"16150",94,75,75,1,0,"Cs",14
33,"33075",253,139,135,1,4,"Cs",12
47,"47162",68,55,55,0,0,"Cs",14
41,"41062",2175,1763,1746,8,17,"Cs",111
40,"40108",110,91,90,0,1,"Cs",18
4,"4046",848,653,649,5,4,"Cs",100
8,"8056",42727,33215,33054,220,161,"Cs",5679
18,"18146",937,690,682,6,8,"Cs",137
29,"29068",7716,5347,5230,58,117,"Cs",1233
8,"8134",842,649,646,3,3,"Cs",46
39,"39021",467,392,385,2,7,"Cs",31
7,"7051",5414,3610,3575,37,35,"Cs",505
49,"49123",532,406,402,2,4,"Cs",41
14,"14008",2785,1942,1910,15,32,"Cs",245
4,"4047",2230,1806,1785,8,21,"Cs",199
9,"9113",460,369,364,3,5,"Cs",118
40,"40109",72,59,54,1,5,"Cs",7
6,"6118",157,125,125,1,0,"Cs",11
26,"26036",17013,12543,12354,95,189,"Cs",2489
4,"4048",1496,1109,1102,4,7,"Cs",258
50,"50155",90,70,69,0,1,"Cs",20
6,"6018",740,543,536,5,7,"Cs",39
22,"22066",748,576,567,6,9,"Cs",77
18,"18042",418,344,340,7,4,"Cs",38
49,"49125",1401,1031,1010,7,21,"Cs",203
47,"47067",153,119,119,3,0,"Cs",12
13,"13024",891,636,628,2,8,"Cs",79
27,"27007",2756,2148,2084,29,64,"Cs",99
19,"19106",76,57,57,0,0,"Cs",6
7,"7053",1164,956,948,4,8,"Cs",129
46,"46171",16429,12527,12373,61,154,"Cs",2101
37,"37018",110,86,85,1,1,"Cs",14
42,"42043",3838,2897,2855,18,42,"Cs",520
49,"49248",174,142,139,2,3,"Cs",9
46,"46079",313,252,248,1,4,"Cs",27
2,"2083",209,183,183,0,0,"Cs",12
50,"50242",93,72,70,0,2,"Cs",14
16,"16027",701,540,531,2,9,"Cs",61
45,"45189",616,506,498,2,8,"Cs",77
14,"14010",4001,3106,3068,15,38,"Cs",358
18,"18149",5401,4290,4212,28,78,"Cs",912
40,"40215",83,69,69,0,0,"Cs",14
4,"4050",751,522,519,1,3,"Cs",71
46,"46081",9993,7972,7882,51,90,"Cs",1348
23,"23008",1434,1155,1133,6,22,"Cs",121
14,"14011",572,498,495,5,3,"Cs",41
50,"50243",311,252,247,1,5,"Cs",47
8,"8295",11184,8566,8529,43,37,"Cs",1195
44,"44115",102,96,95,0,1,"Cs",7
28,"28171",4382,3202,3134,11,68,"Cs",518
37,"37143",375,308,306,2,2,"Cs",49
46,"46173",1319,1084,1062,6,22,"Cs",151
45,"45053",7834,6440,6333,46,107,"Cs",1126
16,"16156",82,65,65,0,0,"Cs",2
47,"47070",30,26,25,0,1,"Cs",1
23,"23009",12808,10348,10233,66,115,"Cs",1674
8,"8059",344,292,290,2,2,"Cs",12
49,"49128",533,428,424,7,4,"Cs",52
9,"9119",45,26,26,0,0,"Cs",4
10,"10210",492,362,358,3,4,"Cs",23
50,"50244",191,153,150,1,3,"Cs",42
50,"50159",641,527,526,8,1,"Cs",68
35,"35023",11694,8785,8607,67,178,"Cs",1181
44,"44018",16,16,16,0,0,"Cs",0
37,"37022",245,200,196,2,4,"Cs",28
10,"10090",494,364,357,6,7,"Cs",30
37,"37257",49,40,40,1,0,"Cs",4
37,"37370",308,256,254,2,2,"Cs",53
8,"8296",1843,1520,1514,10,6,"Cs",143
49,"49251",161,125,124,0,1,"Cs",16
40,"40219",565,451,432,2,19,"Cs",95
42,"42185",25,20,20,0,0,"Cs",1
9,"9281",135,104,102,1,2,"Cs",28
3,"3092",6688,5444,5370,36,74,"Cs",844
32,"32082",1178,880,872,12,8,"Cs",71
8,"8297",135,111,111,1,0,"Cs",6
24,"24006",487,393,387,3,6,"Cs",50
41,"41068",13936,10692,10530,73,162,"Cs",1375
42,"42011",17,11,11,0,0,"Cs",3
9,"9123",43,39,38,0,1,"Cs",2
50,"50070",49,28,28,0,0,"Cs",2
37,"37371",258,176,175,0,1,"Cs",23
12,"12046",182,161,161,1,0,"Cs",18
16,"16159",209,147,144,0,3,"Cs",18
4,"4054",352,280,278,2,2,"Cs",26
45,"45057",224,188,184,0,4,"Cs",20
34,"34005",792,659,645,5,14,"Cs",138
37,"37024",88,69,69,0,0,"Cs",12
3,"3001",345,285,282,1,3,"Cs",39
50,"50161",103,80,80,0,0,"Cs",19
49,"49131",238,182,178,0,4,"Cs",28
47,"47074",141,122,122,2,0,"Cs",13
46,"46085",11075,8106,8011,54,95,"Cs",1123
37,"37373",700,522,514,0,8,"Cs",95
49,"49012",73,45,45,0,0,"Cs",8
23,"23014",2552,2056,2020,11,36,"Cs",265
49,"49013",229,176,175,4,1,"Cs",21
22,"22041",152,121,119,2,2,"Cs",26
50,"50275",110,55,55,0,0,"Cs",6
4,"4015",118,97,97,2,0,"Cs",9
34,"34055",263,214,213,3,1,"Cs",27
9,"9448",201,161,161,1,0,"Cs",33
40,"40119",166,133,132,1,1,"Cs",32
50,"50248",502,390,377,6,13,"Cs",56
35,"35026",82764,55647,54846,499,801,"Cs",8810
9,"9127",52,45,45,1,0,"Cs",3
28,"28079",2374366,1872679,1859094,11998,13585,"Cs",370141
19,"19064",64,56,56,0,0,"Cs",9
18,"18154",975,701,699,3,2,"Cs",58
21,"21011",3473,2543,2513,14,30,"Cs",330
7,"7061",9564,6678,6583,67,95,"Cs",1053
12,"12049",421,339,329,2,10,"Cs",48
40,"40222",163,143,142,1,1,"Cs",29
6,"6028",4109,3613,3538,17,75,"Cs",533
3,"3095",4740,3702,3657,23,45,"Cs",497
26,"26163",124,106,104,1,2,"Cs",13
16,"16162",39,31,30,0,1,"Cs",0
19,"19065",114,92,91,0,1,"Cs",10
50,"50073",2117,1735,1706,13,29,"Cs",319
1,"1047",967,686,673,8,13,"Cs",55
50,"50164",388,279,272,2,7,"Cs",26
16,"16038",28,21,21,0,0,"Cs",2
46,"46251",2442,2017,1976,9,41,"Cs",246
15,"15032",3413,2487,2414,28,73,"Cs",238
45,"45200",4478,3666,3565,35,101,"Cs",625
34,"34011",386,326,321,2,5,"Cs",50
22,"22165",452,360,356,1,4,"Cs",69
28,"28177",10722,9093,9029,64,64,"Cs",2487
37,"37150",36,31,31,0,0,"Cs",4
14,"14018",3611,2802,2741,25,61,"Cs",398
44,"44023",18,14,14,0,0,"Cs",0
39,"39030",1895,1374,1358,6,16,"Cs",157
24,"24131",677,468,463,1,5,"Cs",95
22,"22044",234,184,183,3,1,"Cs",20
22,"22167",473,392,384,4,8,"Cs",63
50,"50250",56,45,45,0,0,"Cs",11
34,"34012",340,271,265,2,6,"Cs",38
26,"26048",22,22,22,0,0,"Cs",7
46,"46088",150,129,127,0,2,"Cs",19
3,"3097",996,833,816,4,17,"Cs",99
15,"15034",2724,1832,1811,8,21,"Cs",103
28,"28179",1450,1115,1100,3,15,"Cs",244
37,"37378",99,69,67,2,2,"Cs",7
40,"40225",1098,902,882,4,20,"Cs",143
7,"7064",5528,3793,3765,23,28,"Cs",615
34,"34015",39,32,31,0,1,"Cs",1
32,"32004",1671,907,899,7,8,"Cs",57
24,"24133",356,267,267,4,0,"Cs",32
42,"42193",16,7,7,0,0,"Cs",2
50,"50166",236,200,198,1,2,"Cs",32
44,"44025",5825,4337,4197,50,140,"Cs",771
10,"10902",735,537,521,2,16,"Cs",63
37,"37154",129,106,102,3,4,"Cs",11
12,"12053",2030,1656,1636,10,20,"Cs",193
19,"19215",144,121,119,0,2,"Cs",15
12,"12141",92,81,81,0,0,"Cs",18
49,"49018",288,225,222,1,3,"Cs",27
19,"19071",8155,6327,6242,35,85,"Cs",1498
24,"24015",2209,1714,1672,19,42,"Cs",367
1,"1052",268,188,187,1,1,"Cs",0
37,"37155",68,52,52,0,0,"Cs",11
14,"14021",260397,195951,193914,2025,2037,"Cs",36522
24,"24016",507,314,311,2,3,"Cs",29
6,"6032",78,65,64,0,1,"Cs",22
47,"47080",35,23,21,0,2,"Cs",8
48,"48036",24038,18180,18050,94,130,"Cs",472
24,"24136",496,375,371,2,4,"Cs",73
3,"3007",169,145,141,0,4,"Cs",22
20,"20011",1633,1297,1287,2,10,"Cs",9
45,"45068",171,142,142,0,0,"Cs",22
34,"34157",2364,1881,1846,13,35,"Cs",252
50,"50077",206,158,157,1,1,"Cs",17
44,"44027",149,120,119,0,1,"Cs",16
8,"8304",816,686,678,1,8,"Cs",30
37,"37156",4276,2621,2572,27,49,"Cs",593
18,"18054",838,649,648,8,1,"Cs",96
37,"37033",92,69,69,2,0,"Cs",10
26,"26169",68,61,61,2,0,"Cs",8
34,"34158",286,194,194,0,0,"Cs",20
6,"6132",829,598,593,0,5,"Cs",70
49,"49226",239,207,200,3,7,"Cs",22
19,"19217",42,38,38,0,0,"Cs",5
5,"5194",132,111,111,0,0,"Cs",20
22,"22048",12593,9614,9528,82,86,"Cs",2205
20,"20013",5430,4144,4119,19,25,"Cs",72
35,"35033",6403,4565,4502,34,63,"Cs",717
41,"41076",2143,1419,1403,14,16,"Cs",116
6,"6034",167,115,115,1,0,"Cs",22
24,"24018",174,141,139,0,2,"Cs",16
50,"50079",227,182,178,1,4,"Cs",28
14,"14023",2007,1734,1711,9,23,"Cs",161
32,"32091",1703,1312,1306,4,6,"Cs",87
46,"46093",2134,1700,1687,8,13,"Cs",201
16,"16171",1749,1449,1422,6,27,"Cs",126
38,"38001",20907,12323,12197,70,126,"Cs",1911
47,"47083",83,66,65,1,1,"Cs",4
9,"9137",180,149,147,1,2,"Cs",30
49,"49267",97,73,68,1,5,"Cs",16
6,"6035",865,678,670,4,8,"Cs",48
47,"47178",166,144,143,4,1,"Cs",22
39,"39035",9169,7135,7045,40,90,"Cs",931
46,"46185",364,315,310,1,5,"Cs",17
8,"8070",266,232,232,0,0,"Cs",7
22,"22050",93,79,79,2,0,"Cs",8
9,"9467",60,46,46,0,0,"Cs",5
40,"40056",32,21,21,0,0,"Cs",0
16,"16091",64,46,46,1,0,"Cs",0
34,"34216",60,46,46,0,0,"Cs",6
9,"9138",87,74,72,2,2,"Cs",13
19,"19079",8,7,7,1,0,"Cs",0
18,"18165",4251,3113,3073,20,40,"Cs",545
16,"16047",214,175,174,4,1,"Cs",24
26,"26055",39,35,35,1,0,"Cs",0
8,"8123",19489,16197,16135,58,62,"Cs",1576
46,"46095",578,467,458,1,9,"Cs",107
49,"49024",637,465,461,2,4,"Cs",94
9,"9471",142,113,112,3,1,"Cs",19
37,"37037",107,86,86,0,0,"Cs",28
13,"13002",1419,1021,995,5,26,"Cs",102
47,"47085",16381,12697,12540,129,157,"Cs",2692
10,"10025",379,328,317,3,11,"Cs",40
9,"9417",42,32,32,0,0,"Cs",0
10,"10066",161,141,137,0,4,"Cs",17
38,"38003",1510,1058,1047,4,11,"Cs",148
49,"49147",249,197,196,1,1,"Cs",40
37,"37038",751,607,592,4,15,"Cs",110
46,"46096",257,220,217,0,3,"Cs",27
42,"42026",22,20,20,0,0,"Cs",6
19,"19223",101,66,66,1,0,"Cs",5
16,"16049",144,111,108,1,3,"Cs",13
8,"8308",137,118,118,0,0,"Cs",0
15,"15041",9581,7223,7082,96,141,"Cs",563
9,"9473",87,76,73,0,3,"Cs",10
4,"4069",4757,3633,3588,25,45,"Cs",605
22,"22052",885,708,702,6,6,"Cs",97
11,"11006",24522,16656,16392,220,264,"Cs",3325
37,"37162",209,156,153,1,3,"Cs",16
3,"3105",5471,4099,4003,14,96,"Cs",839
49,"49187",1202,930,921,8,9,"Cs",162
13,"13005",23187,18379,18119,174,260,"Cs",3353
37,"37275",101,69,67,0,2,"Cs",5
29,"29001",4199,3380,3341,20,39,"Cs",352
15,"15042",2955,2057,2002,16,55,"Cs",152
22,"22053",786,573,567,3,6,"Cs",90
28,"28091",5474,4027,3977,26,50,"Cs",635
45,"45123",3160,2434,2392,16,42,"Cs",507
37,"37314",82,72,68,0,4,"Cs",7
27,"27025",2743,2191,2138,31,53,"Cs",140
13,"13006",572,437,430,5,7,"Cs",39
4,"4071",363,303,301,2,2,"Cs",35
26,"26059",1122,861,841,7,20,"Cs",134
22,"22181",88,60,59,1,1,"Cs",10
3,"3015",12807,9782,9634,63,148,"Cs",1732
9,"9144",44,37,37,2,0,"Cs",10
37,"37164",238,194,193,4,1,"Cs",28
18,"18064",366,307,306,0,1,"Cs",25
5,"5201",499,414,407,2,7,"Cs",71
34,"34029",659,557,551,5,6,"Cs",67
9,"9480",109,87,85,1,2,"Cs",11
37,"37041",73,55,55,0,0,"Cs",7
14,"14029",4029,3089,3039,15,50,"Cs",372
16,"16052",537,429,429,2,0,"Cs",62
32,"32013",2017,1388,1380,5,8,"Cs",98
34,"34031",26,24,24,0,0,"Cs",2
29,"29003",922,740,727,3,13,"Cs",98
46,"46099",772,620,614,1,6,"Cs",76
4,"4072",314,245,240,0,5,"Cs",28
48,"48075",2067,1591,1565,11,26,"Cs",15
48,"48045",5194,4138,4098,25,40,"Cs",61
3,"3109",2976,2375,2345,11,30,"Cs",337
19,"19227",73,55,53,0,2,"Cs",9
38,"38007",1625,1124,1104,2,20,"Cs",109
8,"8007",6775,5447,5419,21,28,"Cs",355
49,"49030",80,66,62,0,4,"Cs",9
4,"4073",336,243,243,0,0,"Cs",32
29,"29004",295,233,226,0,7,"Cs",20
8,"8903",197,177,176,0,1,"Cs",4
8,"8233",1846,1485,1478,8,7,"Cs",68
6,"6042",981,714,705,4,9,"Cs",42
26,"26179",41,33,32,0,1,"Cs",3
13,"13903",493,412,406,1,6,"Cs",44
16,"16238",464,387,383,2,4,"Cs",44
13,"13011",4506,3111,3044,29,67,"Cs",441
10,"10114",962,754,737,2,17,"Cs",72
40,"40906",2131,1830,1814,10,16,"Cs",471
19,"19229",57,52,52,0,0,"Cs",4
8,"8904",10514,7733,7697,38,36,"Cs",1146
46,"46192",790,599,586,8,13,"Cs",92
48,"48046",12644,9809,9744,46,65,"Cs",116
46,"46010",950,727,718,6,9,"Cs",122
28,"28023",5090,4252,4212,31,40,"Cs",924
46,"46903",6285,5035,4996,27,39,"Cs",1342
44,"44135",102,85,85,0,0,"Cs",10
28,"28095",1677,1310,1293,4,17,"Cs",219
34,"34174",178,150,149,2,1,"Cs",19
29,"29006",665,491,483,5,8,"Cs",46
47,"47186",244448,197042,195276,1561,1766,"Cs",38615
36,"36008",21884,16428,16170,165,258,"Cs",1682
6,"6011",24665,18486,18253,178,233,"Cs",4215
14,"14032",393,328,321,2,7,"Cs",42
19,"19231",10,7,7,0,0,"Cs",0
8,"8905",2308,1943,1938,7,5,"Cs",172
32,"32016",724,543,535,3,8,"Cs",18
24,"24152",447,301,296,1,5,"Cs",32
3,"3112",637,526,520,0,6,"Cs",53
37,"37047",228,93,92,1,1,"Cs",10
48,"48048",543,421,419,1,2,"Cs",0
1,"1902",730,551,545,6,6,"Cs",32
9,"9155",25,20,20,0,0,"Cs",5
50,"50263",176,119,116,0,3,"Cs",15
16,"16189",262,220,220,1,0,"Cs",55
50,"50003",119,95,95,1,0,"Cs",24
7,"7046",16718,10573,10469,94,104,"Cs",1579
16,"16058",97,73,73,0,0,"Cs",9
50,"50264",147,122,120,0,2,"Cs",23
47,"47126",44,42,42,1,0,"Cs",4
48,"48913",1224,977,967,6,10,"Cs",18
21,"21032",1801,1401,1378,8,23,"Cs",101
23,"23034",2490,2033,1999,15,34,"Cs",238
8,"8130",108,89,86,2,3,"Cs",1
9,"9266",103,85,85,0,0,"Cs",11
33,"33040",4566,3205,3150,50,55,"Cs",456
37,"37359",163,122,117,0,5,"Cs",24
39,"39045",351,280,277,1,3,"Cs",19
50,"50236",101,82,80,1,2,"Cs",10
8,"8079",334,284,282,0,2,"Cs",9
9,"9904",468,371,369,3,2,"Cs",61
47,"47002",18,18,18,0,0,"Cs",5
50,"50089",8584,6951,6912,34,39,"Cs",1953
37,"37050",67,54,54,0,0,"Cs",4
22,"22189",178,143,143,0,0,"Cs",18
13,"13017",247,189,188,2,1,"Cs",17
9,"9007",55,37,37,0,0,"Cs",8
22,"22190",122,89,89,0,0,"Cs",19
50,"50265",74,56,56,0,0,"Cs",6
34,"34178",119,105,104,0,1,"Cs",9
42,"42216",26,20,20,1,0,"Cs",1
46,"46014",3130,2488,2462,7,26,"Cs",404
39,"39074",7041,5612,5551,31,61,"Cs",798
26,"26107",91,78,77,0,1,"Cs",12
40,"40105",44,39,38,0,1,"Cs",6
10,"10038",83,70,69,0,1,"Cs",4
5,"5211",430,364,357,6,7,"Cs",53
40,"40141",833,644,627,5,17,"Cs",115
45,"45090",368,287,286,1,1,"Cs",35
50,"50006",908,705,689,3,16,"Cs",121
21,"21035",9726,6628,6520,78,108,"Cs",836
21,"21034",1159,863,845,4,18,"Cs",162
13,"13019",5095,3758,3717,25,41,"Cs",610
50,"50091",40,35,35,0,0,"Cs",9
12,"12071",1267,1021,1006,11,15,"Cs",119
37,"37054",238,200,196,3,4,"Cs",21
46,"46107",1849,1501,1480,5,21,"Cs",167
9,"9010",32,27,27,1,0,"Cs",3
41,"41005",9250,6925,6809,69,116,"Cs",1109
37,"37287",309,215,214,3,1,"Cs",40
38,"38014",1341,991,981,6,10,"Cs",123
6,"6149",10203,8194,8051,72,143,"Cs",1627
4,"4081",346,272,271,2,1,"Cs",33
15,"15052",4104,2928,2878,30,50,"Cs",173
47,"47096",126,106,105,0,1,"Cs",20
28,"28102",891,681,666,4,15,"Cs",104
36,"36015",4076,2903,2834,37,69,"Cs",252
29,"29902",2592,1841,1817,18,24,"Cs",256
27,"27005",2551,1908,1868,26,40,"Cs",121
9,"9167",53,39,36,0,3,"Cs",8
15,"15053",7548,5364,5309,44,55,"Cs",452
10,"10123",575,470,465,2,5,"Cs",43
10,"10001",283,233,232,3,1,"Cs",18
37,"37175",404,321,319,8,2,"Cs",56
19,"19103",251,218,216,1,2,"Cs",19
27,"27006",2458,1713,1666,27,47,"Cs",134
3,"3118",2426,1741,1718,8,23,"Cs",349
42,"42084",20,16,16,0,0,"Cs",2
5,"5099",457,392,389,2,3,"Cs",54
47,"47005",502,420,414,2,6,"Cs",76
18,"18180",627,442,435,4,7,"Cs",76
19,"19105",2540,2013,1988,13,25,"Cs",376
34,"34184",49,39,38,0,1,"Cs",0
2,"2008",1123,857,842,9,15,"Cs",112
34,"34046",44,31,31,0,0,"Cs",2
29,"29903",493,358,354,6,4,"Cs",58
49,"49163",215,151,148,1,3,"Cs",17
32,"32022",1238,924,916,5,8,"Cs",67
20,"20059",8867,6792,6759,21,33,"Cs",38
4,"4007",731,570,569,0,1,"Cs",97
24,"24201",1039,775,765,5,10,"Cs",125
11,"11021",4926,3592,3486,50,106,"Cs",697
50,"50094",1518,1172,1155,20,17,"Cs",196
9,"9389",64,50,50,0,0,"Cs",2
42,"42132",135,114,113,1,1,"Cs",12
49,"49086",111,94,93,1,1,"Cs",16
5,"5101",277,224,222,0,2,"Cs",31
34,"34091",122,103,102,4,1,"Cs",14
46,"46110",21317,15839,15699,89,140,"Cs",2779
6,"6152",1285,952,935,4,17,"Cs",246
45,"45096",987,829,813,3,16,"Cs",81
47,"47099",155,135,133,0,2,"Cs",30
19,"19242",77,67,67,0,0,"Cs",10
2,"2010",1798,1494,1469,6,25,"Cs",207
15,"15055",4485,3097,3057,39,40,"Cs",252
6,"6054",5454,4329,4190,46,139,"Cs",727
14,"14041",3115,2449,2376,45,73,"Cs",329
46,"46202",17660,13782,13645,93,137,"Cs",2827
15,"15056",5648,4033,3979,39,54,"Cs",397
10,"10128",5628,4238,4126,43,112,"Cs",698
39,"39051",73,65,64,0,1,"Cs",12
42,"42087",51,45,44,1,1,"Cs",7
37,"37059",117,106,100,0,6,"Cs",13
8,"8111",215,200,199,4,1,"Cs",4
40,"40040",2495,1913,1895,20,18,"Cs",420
24,"24163",4073,3269,3231,36,38,"Cs",765
3,"3028",964,804,795,6,9,"Cs",92
10,"10006",1230,1006,995,8,11,"Cs",91
19,"19109",33,30,30,1,0,"Cs",1
20,"20032",8681,6491,6429,22,62,"Cs",143
9,"9064",305,251,249,3,2,"Cs",62
18,"18078",710,561,554,4,7,"Cs",45
50,"50011",116,100,99,0,1,"Cs",14
29,"29017",6428,4943,4871,32,72,"Cs",759
34,"34050",185,156,156,2,0,"Cs",15
22,"22202",145,127,126,0,1,"Cs",20
19,"19245",1145,904,880,8,24,"Cs",120
42,"42088",60,53,53,0,0,"Cs",6
10,"10007",630,513,507,4,6,"Cs",90
47,"47197",867,721,717,2,4,"Cs",104
13,"13028",10273,8434,8273,42,161,"Cs",1208
44,"44147",398,293,286,3,7,"Cs",35
37,"37061",207,160,160,0,0,"Cs",29
46,"46113",2527,1906,1892,12,14,"Cs",335
24,"24165",327,236,233,1,3,"Cs",70
37,"37294",11787,9201,9083,76,118,"Cs",2141
41,"41011",15454,11892,11591,160,301,"Cs",1545
8,"8245",77805,57956,57666,313,290,"Cs",8774
37,"37182",78,57,57,0,0,"Cs",10
10,"10131",12808,9377,9254,67,123,"Cs",1795
34,"34192",82,68,68,0,0,"Cs",11
26,"26078",86,71,70,1,1,"Cs",8
50,"50099",3042,2299,2265,20,34,"Cs",397
10,"10009",263,196,193,2,3,"Cs",13
50,"50273",32,24,24,0,0,"Cs",2
47,"47103",255,215,214,3,1,"Cs",30
46,"46084",1503,1225,1195,1,30,"Cs",133
10,"10132",365,276,271,2,5,"Cs",18
2,"2014",350,285,280,1,5,"Cs",34
24,"24166",1359,1038,1011,11,27,"Cs",182
3,"3031",41857,28648,28362,163,286,"Cs",5332
22,"22075",119,87,87,1,0,"Cs",7
9,"9021",51,36,35,1,1,"Cs",6
23,"23046",2331,1953,1926,3,27,"Cs",216
20,"20035",484,384,384,2,0,"Cs",2
32,"32027",1000,762,747,5,15,"Cs",47
34,"34053",200,176,171,5,5,"Cs",21
46,"46024",444,339,335,1,4,"Cs",43
24,"24047",720,531,523,2,8,"Cs",86
26,"26079",620,526,521,0,5,"Cs",68
12,"12079",419,346,336,2,10,"Cs",39
2,"2015",1433,1234,1214,7,20,"Cs",172
3,"3125",336,259,257,1,2,"Cs",25
50,"50101",832,625,614,1,11,"Cs",97
39,"39055",1075,836,829,8,7,"Cs",115
37,"37065",271,187,184,0,3,"Cs",31
37,"37223",112,78,76,0,2,"Cs",7
45,"45197",1894,1525,1499,6,26,"Cs",166
20,"20066",439,327,326,0,1,"Cs",0
45,"45105",380,284,275,2,9,"Cs",36
33,"33022",813,555,543,6,12,"Cs",64
6,"6159",2339,1577,1507,25,70,"Cs",187
5,"5225",353,300,297,2,3,"Cs",49
10,"10134",553,396,392,2,4,"Cs",48
9,"9347",135,108,108,0,0,"Cs",32
20,"20036",13192,9864,9806,67,58,"Cs",264
16,"16079",26,17,17,0,0,"Cs",2
47,"47203",58,48,48,0,0,"Cs",7
24,"24050",105,88,87,3,1,"Cs",9
29,"29022",171,144,143,0,1,"Cs",13
2,"2017",777,588,584,0,4,"Cs",56
50,"50016",44,31,31,0,0,"Cs",8
16,"16121",233,183,179,0,4,"Cs",19
2,"2054",383,314,309,1,5,"Cs",27
45,"45152",547,448,442,1,6,"Cs",57
28,"28039",125,103,103,2,0,"Cs",15
24,"24170",1839,1417,1391,7,26,"Cs",206
44,"44244",68,48,48,4,0,"Cs",5
10,"10136",285,223,223,1,0,"Cs",31
46,"46027",932,769,755,1,14,"Cs",79
11,"11031",76294,54123,53583,589,540,"Cs",11238
29,"29024",372,265,250,3,15,"Cs",41
46,"46118",3670,2930,2894,25,36,"Cs",441
6,"6061",1084,915,905,8,10,"Cs",71
10,"10015",627,488,475,0,13,"Cs",107
46,"46209",1901,1517,1500,5,17,"Cs",197
40,"40155",3835,3165,3121,43,44,"Cs",808
8,"8169",48284,37528,37326,218,202,"Cs",4924
19,"19118",10,10,10,1,0,"Cs",1
9,"9182",76,65,64,0,1,"Cs",10
24,"24052",139,99,99,0,0,"Cs",5
24,"24053",406,279,276,6,3,"Cs",44
46,"46210",344,265,258,2,7,"Cs",25
40,"40156",281,223,222,1,1,"Cs",46
50,"50221",32,22,22,0,0,"Cs",6
26,"26084",7187,5620,5558,36,62,"Cs",1212
14,"14049",16282,12515,12301,121,214,"Cs",1920
4,"4096",281,239,237,1,2,"Cs",20
11,"11033",21702,14645,14436,190,209,"Cs",2907
42,"42098",9,8,8,0,0,"Cs",0
3,"3036",86,77,75,2,2,"Cs",16
50,"50193",663,536,516,1,20,"Cs",86
39,"39060",6693,5459,5394,29,65,"Cs",757
9,"9184",7,5,5,0,0,"Cs",2
36,"36027",4380,3262,3206,26,56,"Cs",334
16,"16215",237,157,153,1,4,"Cs",20
40,"40051",34,33,31,0,2,"Cs",2
6,"6063",2938,2299,2264,11,35,"Cs",262
22,"22124",182,148,148,1,0,"Cs",23
24,"24054",417,318,311,0,7,"Cs",54
49,"49177",260,165,162,2,3,"Cs",12
29,"29026",1010,747,736,3,11,"Cs",65
12,"12084",17723,13501,13281,118,220,"Cs",2135
3,"3037",341,289,284,1,5,"Cs",46
23,"23052",1108,949,931,8,18,"Cs",83
44,"44154",248,200,195,2,5,"Cs",61
10,"10181",680,548,542,2,6,"Cs",82
3,"3067",93,87,87,0,0,"Cs",8
13,"13041",249,179,171,2,8,"Cs",19
28,"28118",61,52,51,0,1,"Cs",3
47,"47018",36,31,29,0,2,"Cs",1
27,"27018",3232,2114,2089,24,25,"Cs",95
24,"24056",2762,2062,2013,24,49,"Cs",371
50,"50020",802,606,600,7,6,"Cs",111
10,"10019",1416,1120,1094,3,26,"Cs",217
44,"44249",46,37,37,1,0,"Cs",9
8,"8172",20417,16196,16144,88,52,"Cs",1906
30,"30012",9069,7397,7266,53,131,"Cs",1112
49,"49102",183,136,135,2,1,"Cs",15
22,"22126",87,66,66,0,0,"Cs",18
14,"14051",1348,1064,1048,7,16,"Cs",83
18,"18902",755,611,595,1,16,"Cs",69
22,"22082",285,230,226,2,4,"Cs",52
32,"32034",1074,855,846,1,9,"Cs",36
44,"44250",19,15,15,0,0,"Cs",6
6,"6903",2027,1607,1594,16,13,"Cs",282
24,"24176",299,243,238,3,5,"Cs",36
47,"47176",202,138,138,1,0,"Cs",22
37,"37193",365,277,276,3,1,"Cs",42
40,"40160",93,72,72,0,0,"Cs",7
26,"26091",147,132,131,1,1,"Cs",13
3,"3039",89,70,70,0,0,"Cs",4
46,"46214",16415,12723,12610,74,113,"Cs",2547
24,"24177",472,330,326,3,4,"Cs",51
5,"5233",226,198,197,0,1,"Cs",19
16,"16088",101,85,85,1,0,"Cs",10
45,"45116",680,547,537,4,10,"Cs",75
48,"48902",18971,14015,13895,101,120,"Cs",346
14,"14053",5925,4442,4348,75,94,"Cs",585
3,"3134",141,119,117,0,2,"Cs",7
47,"47021",72,63,63,0,0,"Cs",15
41,"41020",12992,8679,8524,117,155,"Cs",1290
11,"11038",13613,10879,10676,101,203,"Cs",2445
44,"44059",550,446,437,7,9,"Cs",64
32,"32036",1261,954,938,9,16,"Cs",61
2,"2026",832,682,673,6,9,"Cs",75
39,"39063",954,726,722,4,4,"Cs",48
37,"37195",37,29,29,1,0,"Cs",2
47,"47116",403,321,320,3,1,"Cs",50
27,"27022",4683,3131,3059,30,72,"Cs",195
37,"37310",172,125,124,3,1,"Cs",14
9,"9360",25,22,22,0,0,"Cs",4
5,"5041",995,776,767,3,9,"Cs",145
49,"49105",136,105,103,1,2,"Cs",16
22,"22175",184,139,137,1,2,"Cs",25
46,"46216",5252,4291,4263,23,28,"Cs",852
28,"28121",205,166,165,1,1,"Cs",20
15,"15071",7805,5476,5401,62,75,"Cs",506
16,"16225",59,40,40,0,0,"Cs",4
22,"22085",96,82,81,0,1,"Cs",10
14,"14025",2857,2482,2436,14,46,"Cs",180
50,"50024",556,427,426,6,1,"Cs",54
49,"49184",170,122,121,0,1,"Cs",22
40,"40163",41,38,38,0,0,"Cs",9
44,"44256",34,32,32,1,0,"Cs",13
50,"50111",183,144,142,2,2,"Cs",31
44,"44061",75,66,65,2,1,"Cs",16
4,"4068",174,134,134,0,0,"Cs",9
45,"45074",401,335,326,3,9,"Cs",48
22,"22176",170,136,135,0,1,"Cs",18
50,"50053",650,505,497,4,8,"Cs",75
19,"19032",146,102,101,2,1,"Cs",10
42,"42111",279,209,208,3,1,"Cs",17
10,"10149",434,308,304,2,4,"Cs",33
21,"21023",2051,1356,1332,5,24,"Cs",149
34,"34218",445,352,345,2,7,"Cs",39
10,"10026",656,515,507,8,8,"Cs",73
49,"49066",449,319,314,4,5,"Cs",43
5,"5122",119,90,88,1,2,"Cs",14
37,"37313",534,413,411,1,2,"Cs",71
28,"28123",61103,52177,51832,338,345,"Cs",11467
22,"22220",150,120,117,0,3,"Cs",25
27,"27024",1451,1122,1102,5,20,"Cs",35
19,"19266",229,194,192,1,2,"Cs",27
40,"40059",108,90,89,0,1,"Cs",11
37,"37199",129,97,97,0,0,"Cs",21
50,"50201",444,357,354,1,3,"Cs",81
5,"5123",103,85,85,1,0,"Cs",16
49,"49068",435,287,286,1,1,"Cs",26
16,"16094",120,89,88,0,1,"Cs",13
15,"15011",15481,11249,11037,105,212,"Cs",1398
16,"16135",118,86,85,0,1,"Cs",8
45,"45031",2824,2104,2068,20,36,"Cs",328
50,"50202",131,90,88,1,2,"Cs",7
47,"47119",87,66,65,1,1,"Cs",11
50,"50114",132,111,111,1,0,"Cs",29
15,"15074",3919,2865,2808,33,57,"Cs",208
8,"8179",611,496,493,2,3,"Cs",28
45,"45124",2069,1757,1718,14,39,"Cs",245
39,"39068",649,515,509,7,6,"Cs",81
29,"29036",611,448,444,3,4,"Cs",43
6,"6074",4755,3719,3638,27,81,"Cs",627
40,"40060",68,46,46,0,0,"Cs",2
37,"37201",237,188,187,1,1,"Cs",38
46,"46129",512,408,400,4,8,"Cs",40
22,"22223",74,63,63,1,0,"Cs",7
49,"49189",192,132,128,1,4,"Cs",17
21,"21062",1386,893,885,15,8,"Cs",208
23,"23061",7691,5636,5531,51,105,"Cs",804
50,"50027",224,170,165,1,5,"Cs",19
16,"16237",98,83,83,0,0,"Cs",11
40,"40061",65,50,48,2,2,"Cs",5
44,"44103",123,101,100,1,1,"Cs",19
9,"9046",24,19,19,0,0,"Cs",1
44,"44261",722,584,578,8,6,"Cs",77
5,"5002",1890,1497,1468,8,29,"Cs",247
45,"45127",764,582,577,3,5,"Cs",70
7,"7009",741,554,544,4,10,"Cs",75
24,"24066",449,329,324,3,5,"Cs",52
9,"9095",112,70,68,1,2,"Cs",18
47,"47123",461,391,390,3,1,"Cs",87
50,"50028",77,59,58,1,1,"Cs",12
27,"27060",2463,1695,1669,12,26,"Cs",106
6,"6109",3843,3228,3106,26,122,"Cs",408
18,"18101",9410,7280,7181,72,99,"Cs",1425
49,"49152",483,327,322,2,5,"Cs",74
2,"2070",384,318,318,2,0,"Cs",28
26,"26026",1265,1061,1049,2,12,"Cs",179
14,"14061",688,567,556,2,11,"Cs",40
50,"50029",604,475,467,7,8,"Cs",74
41,"41028",2071,1741,1713,18,28,"Cs",386
10,"10155",1082,825,819,4,6,"Cs",102
45,"45128",2552,1874,1839,9,35,"Cs",319
2,"2035",1946,1592,1576,15,16,"Cs",237
47,"47124",388,322,319,2,3,"Cs",46
50,"50030",201,138,136,1,2,"Cs",13
50,"50290",358,272,266,6,6,"Cs",37
3,"3048",4971,3808,3739,19,69,"Cs",604
21,"21065",255,178,173,2,5,"Cs",28
16,"16100",640,570,565,1,5,"Cs",46
28,"28129",8578,6925,6853,45,72,"Cs",1848
21,"21066",495,401,396,4,5,"Cs",33
19,"19274",950,753,741,7,12,"Cs",112
32,"32043",2512,1805,1789,16,16,"Cs",209
44,"44263",377,296,285,3,11,"Cs",52
2,"2036",95,75,75,0,0,"Cs",3
48,"48078",37991,28582,28382,202,200,"Cs",864
32,"32044",809,625,617,2,8,"Cs",55
28,"28054",11891,9476,9395,64,81,"Cs",1897
18,"18912",1367,990,984,5,6,"Cs",157
41,"41102",14750,10972,10677,110,295,"Cs",1920
44,"44264",248,175,171,0,4,"Cs",29
18,"18103",722,556,555,3,1,"Cs",74
10,"10157",245,185,185,1,0,"Cs",23
39,"39072",324,206,204,4,2,"Cs",17
50,"50119",872,684,680,4,4,"Cs",156
18,"18002",526,400,400,0,0,"Cs",29
3,"3019",15465,12156,11988,80,168,"Cs",2359
41,"41901",2703,2242,2201,29,41,"Cs",200
9,"9052",29,17,17,1,0,"Cs",4
32,"32073",1281,941,932,9,9,"Cs",47
19,"19232",58,49,49,0,0,"Cs",7
9,"9214",641,454,445,5,9,"Cs",53
16,"16102",1163,951,943,16,8,"Cs",156
39,"39044",3868,3019,2985,8,34,"Cs",487
6,"6145",899,744,723,1,21,"Cs",83
27,"27063",1715,1236,1198,10,38,"Cs",58
16,"16909",661,540,535,1,5,"Cs",42
39,"39017",553,416,409,0,7,"Cs",40
8,"8157",8547,6949,6918,39,31,"Cs",931
40,"40104",284,229,224,2,5,"Cs",44
21,"21069",1667,1214,1198,13,16,"Cs",180
28,"28131",13432,10500,10387,81,113,"Cs",2120
18,"18003",14413,11095,10883,92,212,"Cs",2154
14,"14065",1813,1439,1421,11,18,"Cs",230
16,"16103",239,203,203,0,0,"Cs",26
42,"42125",75,62,62,2,0,"Cs",13
5,"5013",847,708,701,0,7,"Cs",68
41,"41031",1215,866,848,3,18,"Cs",84
49,"49199",241,174,171,4,3,"Cs",13
37,"37209",410,288,283,3,5,"Cs",44
24,"24074",96,73,73,0,0,"Cs",9
30,"30026",16252,11142,10977,65,165,"Cs",2139
16,"16020",9,5,5,0,0,"Cs",1
44,"44010",184,137,137,1,0,"Cs",24
48,"48081",1883,1532,1518,3,14,"Cs",16
4,"4043",511,423,421,3,2,"Cs",25
50,"50238",86,66,66,2,0,"Cs",9
23,"23069",5262,4395,4329,15,66,"Cs",1005
37,"37211",212,164,163,1,1,"Cs",37
9,"9217",349,268,266,5,2,"Cs",39
41,"41032",3843,3018,2944,17,74,"Cs",504
16,"16246",452,348,340,1,8,"Cs",32
28,"28058",141251,112674,111423,778,1251,"Cs",23072
37,"37324",335,276,274,1,2,"Cs",46
37,"37098",304,214,210,0,4,"Cs",22
34,"34131",58,51,51,0,0,"Cs",2
37,"37137",99,65,65,0,0,"Cs",9
37,"37212",101,85,83,0,2,"Cs",17
5,"5252",58,38,38,0,0,"Cs",9
19,"19282",143,114,114,1,0,"Cs",11
10,"10040",434,321,314,1,7,"Cs",31
18,"18108",826,677,669,3,8,"Cs",81
19,"19150",126,102,100,0,2,"Cs",8
49,"49202",172,125,124,2,1,"Cs",23
39,"39076",3483,2770,2734,21,36,"Cs",430
41,"41033",4965,3634,3580,27,54,"Cs",627
21,"21072",10227,7947,7739,98,208,"Cs",1090
10,"10204",419,342,339,4,3,"Cs",57
6,"6083",46489,34360,33989,270,371,"Cs",7646
40,"40178",90,63,63,1,0,"Cs",9
5,"5017",86,74,73,0,1,"Cs",5
50,"50211",237,177,173,0,4,"Cs",16
10,"10164",720,474,461,3,13,"Cs",55
22,"22107",100,68,67,0,1,"Cs",13
13,"13067",342,298,295,0,3,"Cs",13
40,"40179",626,540,529,2,11,"Cs",107
19,"19284",10,9,9,1,0,"Cs",0
46,"46139",4512,3612,3567,25,45,"Cs",480
9,"9388",33,28,28,0,0,"Cs",9
33,"33045",4382,3214,3156,23,58,"Cs",495
49,"49085",918,673,660,5,13,"Cs",117
18,"18007",741,533,527,6,6,"Cs",64
34,"34088",264,211,207,1,4,"Cs",28
10,"10206",201,146,144,1,2,"Cs",21
27,"27038",923,688,677,12,11,"Cs",36
2,"2044",1049,746,737,5,9,"Cs",113
9,"9221",492,413,409,0,4,"Cs",95
44,"44206",103,83,82,0,1,"Cs",13
8,"8267",6748,5389,5362,28,27,"Cs",522
19,"19051",61,54,54,0,0,"Cs",4
7,"7020",3692,2833,2808,42,25,"Cs",398
10,"10166",313,211,202,0,9,"Cs",30
49,"49124",237,169,166,1,3,"Cs",25
6,"6019",2012,1539,1495,14,44,"Cs",213
47,"47007",4036,3261,3217,25,44,"Cs",723
34,"34089",140,119,114,2,5,"Cs",16
40,"40214",196,167,163,1,4,"Cs",37
21,"21076",2142,1573,1551,24,22,"Cs",155
27,"27039",4430,3437,3353,53,84,"Cs",272
16,"16251",1809,1469,1443,11,26,"Cs",174
5,"5140",106,91,89,0,2,"Cs",19
30,"30031",500,435,433,3,2,"Cs",66
19,"19155",66,56,56,0,0,"Cs",8
18,"18011",4376,3286,3248,18,38,"Cs",555
2,"2046",1132,975,953,10,22,"Cs",121
49,"49088",82,59,59,0,0,"Cs",7
50,"50038",1405,1112,1099,13,13,"Cs",163
47,"47038",101,79,79,0,0,"Cs",10
40,"40075",153,128,127,0,1,"Cs",22
45,"45005",227,180,174,5,6,"Cs",15
22,"22111",146,115,115,1,0,"Cs",26
10,"10046",187,154,152,0,2,"Cs",14
42,"42044",53,41,39,0,2,"Cs",6
5,"5022",1571,1295,1282,5,13,"Cs",221
24,"24203",95,72,72,0,0,"Cs",9
50,"50128",27,24,24,0,0,"Cs",3
9,"9225",81,62,62,0,0,"Cs",12
28,"28063",254,203,202,2,1,"Cs",32
5,"5259",106,87,87,0,0,"Cs",6
24,"24004",494,408,403,7,5,"Cs",26
8,"8191",5270,4176,4162,19,14,"Cs",260
24,"24083",1005,800,791,7,9,"Cs",107
19,"19289",23,19,19,0,0,"Cs",4
50,"50129",213,151,149,5,2,"Cs",46
27,"27041",2238,1640,1615,10,25,"Cs",116
6,"6089",608,524,519,3,5,"Cs",84
46,"46143",4230,3255,3200,20,55,"Cs",392
21,"21079",687,503,500,5,3,"Cs",54
48,"48088",133,99,98,2,1,"Cs",0
14,"14012",6076,4579,4489,38,90,"Cs",499
8,"8270",18837,14541,14497,66,44,"Cs",2044
9,"9227",113,93,91,0,2,"Cs",15
16,"16255",136,108,108,0,0,"Cs",11
42,"42009",77,69,69,2,0,"Cs",14
15,"15089",4324,3258,3200,33,58,"Cs",263
46,"46235",21270,15754,15592,101,162,"Cs",2205
26,"26004",66,54,54,0,0,"Cs",3
8,"8113",52518,39750,39592,198,158,"Cs",3180
9,"9066",54,41,40,1,1,"Cs",4
41,"41039",31500,23692,23345,234,347,"Cs",4812
7,"7024",7294,4213,4160,44,53,"Cs",608
16,"16116",77,59,59,0,0,"Cs",9
19,"19009",247,190,187,0,3,"Cs",23
45,"45147",590,506,496,2,10,"Cs",59
26,"26119",177,150,147,2,3,"Cs",15
37,"37296",298,241,239,2,2,"Cs",19
38,"38052",1280,893,887,4,6,"Cs",132
49,"49093",280,239,238,2,1,"Cs",27
24,"24086",266,211,210,0,1,"Cs",25
9,"9068",24,18,18,0,0,"Cs",3
40,"40185",815,624,618,4,6,"Cs",82
39,"39082",1622,1261,1252,16,9,"Cs",131
46,"46236",937,764,755,5,9,"Cs",62
10,"10051",433,338,332,0,6,"Cs",14
29,"29053",1694,1263,1245,18,18,"Cs",248
8,"8036",163,134,133,0,1,"Cs",5
33,"33051",6811,4879,4809,63,70,"Cs",793
16,"16117",1022,822,809,6,13,"Cs",112
37,"37336",52,46,45,3,1,"Cs",10
24,"24088",995,813,802,12,11,"Cs",158
19,"19162",67,50,48,0,2,"Cs",7
46,"46146",1641,1314,1281,11,33,"Cs",144
30,"30036",15256,10884,10703,56,181,"Cs",2026
16,"16118",1350,1126,1093,6,33,"Cs",130
15,"15092",6250,4358,4297,28,61,"Cs",310
44,"44021",104,86,85,2,1,"Cs",13
33,"33021",4361,3098,3043,31,55,"Cs",449
5,"5224",100,91,90,1,1,"Cs",16
50,"50218",110,92,92,0,0,"Cs",17
22,"22003",132,114,114,0,0,"Cs",22
26,"26008",1822,1436,1420,14,16,"Cs",236
40,"40081",119,96,95,2,1,"Cs",16
24,"24089",101353,78253,77375,776,878,"Cs",15096
48,"48092",869,676,674,9,2,"Cs",5
24,"24212",1002,772,764,7,8,"Cs",117
42,"42013",37,29,29,0,0,"Cs",3
8,"8115",3825,2994,2975,12,19,"Cs",360
30,"30038",15674,11755,11675,59,80,"Cs",2498
29,"29056",1061,783,772,4,11,"Cs",107
46,"46056",175,156,156,3,0,"Cs",13
24,"24090",326,213,213,2,0,"Cs",36
48,"48032",5773,4504,4476,5,28,"Cs",95
40,"40120",196,176,169,0,7,"Cs",29
28,"28176",13836,11415,11326,64,89,"Cs",2837
42,"42014",60,44,44,1,0,"Cs",9
5,"5030",43,36,36,0,0,"Cs",4
8,"8196",19444,15361,15263,90,98,"Cs",2297
18,"18121",130,104,103,3,1,"Cs",6
10,"10055",696,527,512,1,15,"Cs",93
24,"24091",585,433,423,1,10,"Cs",69
5,"5266",102,79,78,0,1,"Cs",12
19,"19167",129,104,102,0,2,"Cs",9
26,"26010",85,68,68,1,0,"Cs",4
45,"45016",4442,3621,3583,21,38,"Cs",783
37,"37114",78,64,59,0,5,"Cs",11
48,"48003",14444,11233,11162,43,71,"Cs",197
24,"24214",634,473,471,3,2,"Cs",55
49,"49098",204,157,153,2,4,"Cs",13
37,"37228",325,278,273,0,5,"Cs",37
50,"50045",1198,957,951,3,6,"Cs",156
12,"12018",283,242,235,0,7,"Cs",36
41,"41044",7698,5967,5898,59,69,"Cs",1141
1,"1049",132,100,100,1,0,"Cs",0
19,"19168",266,211,206,4,5,"Cs",26
12,"12020",120,107,107,0,0,"Cs",15
28,"28148",88647,70218,69546,570,672,"Cs",15701
34,"34104",233,190,189,1,1,"Cs",23
24,"24215",152,125,124,1,1,"Cs",10
39,"39087",41381,32335,31995,194,340,"Cs",4049
6,"6096",207,168,167,1,1,"Cs",9
4,"4020",286,218,217,1,1,"Cs",18
13,"13085",2287,1911,1885,13,26,"Cs",252
49,"49137",170,138,134,0,4,"Cs",16
49,"49017",259,196,195,0,1,"Cs",17
18,"18123",288,219,219,2,0,"Cs",30
50,"50136",534,416,405,2,11,"Cs",75
5,"5035",96,78,78,0,0,"Cs",7
46,"46253",114,85,85,2,0,"Cs",14
12,"12113",87,65,64,0,1,"Cs",10
27,"27049",1342,934,921,11,13,"Cs",65
46,"46242",330,279,279,0,0,"Cs",40
19,"19302",52,43,41,1,2,"Cs",8
39,"39088",59,51,51,0,0,"Cs",1
45,"45019",7545,5831,5740,52,91,"Cs",1123
16,"16272",199,162,161,1,1,"Cs",23
44,"44217",31,25,25,0,0,"Cs",2
18,"18159",999,828,824,1,4,"Cs",41
2,"2059",313,252,250,3,2,"Cs",18
18,"18021",17869,13238,13004,110,234,"Cs",2758
9,"9242",66,53,53,1,0,"Cs",7
19,"19304",220,177,175,1,2,"Cs",31
12,"12114",194,161,160,2,1,"Cs",19
34,"34107",73,54,54,2,0,"Cs",7
44,"44187",193,155,151,1,4,"Cs",34
3,"3068",42,40,40,3,0,"Cs",3
35,"35003",5582,3441,3391,26,50,"Cs",547
23,"23087",11185,8500,8363,65,137,"Cs",1491
7,"7901",594,454,446,6,8,"Cs",36
39,"39033",540,430,423,1,7,"Cs",43
42,"42154",99,81,81,1,0,"Cs",16
37,"37232",378,322,321,1,1,"Cs",62
2,"2060",1280,1039,1020,5,19,"Cs",143
36,"36060",30432,22488,22196,199,292,"Cs",2734
50,"50297",502835,394653,391387,3269,3266,"Cs",84272
12,"12115",208,170,167,1,3,"Cs",22
50,"50050",86,65,65,1,0,"Cs",7
41,"41048",2198,1561,1512,22,49,"Cs",204
15,"15006",5169,3527,3436,32,91,"Cs",320
47,"47146",278,232,230,3,2,"Cs",42
8,"8042",2362,1910,1904,7,6,"Cs",256
40,"40088",268,200,200,0,0,"Cs",40
16,"16274",103,86,85,0,1,"Cs",6
5,"5157",235,175,174,2,1,"Cs",21
24,"24221",750,563,553,6,10,"Cs",97
30,"30901",10529,8488,8375,37,113,"Cs",1589
24,"24098",1149,882,863,7,19,"Cs",134
18,"18163",315,246,241,1,5,"Cs",36
2,"2061",618,504,500,7,4,"Cs",43
28,"28075",5952,4797,4758,25,39,"Cs",1101
50,"50139",322,257,256,0,1,"Cs",30
47,"47147",102,85,85,0,0,"Cs",13
6,"6101",442,359,354,2,5,"Cs",36
29,"29063",303,243,239,1,4,"Cs",22
49,"49104",335,245,240,1,5,"Cs",28
2,"2063",1375,1067,1047,1,20,"Cs",153
50,"50140",157,108,108,0,0,"Cs",22
45,"45025",1219,926,913,5,13,"Cs",167
40,"40091",108,93,93,1,0,"Cs",11
39,"39008",13900,10895,10767,81,128,"Cs",2006
15,"15008",5631,4320,4267,64,53,"Cs",549
9,"9084",167,132,127,4,5,"Cs",21
10,"10105",2476,1798,1760,21,38,"Cs",328
35,"35034",8396,4599,4546,55,53,"Cs",643
41,"41095",39970,27911,27583,389,328,"Cs",5652
44,"44221",384,320,315,2,5,"Cs",55
45,"45164",172,143,143,1,0,"Cs",11
6,"6003",766,625,610,3,15,"Cs",123
44,"44192",349,288,284,1,4,"Cs",53
30,"30016",152709,110165,109114,717,1051,"Cs",23376
24,"24223",2540,1971,1929,37,42,"Cs",312
28,"28078",40,37,37,0,0,"Cs",3
29,"29065",194,150,150,0,0,"Cs",15
18,"18132",3124,2575,2548,17,27,"Cs",303
47,"47149",45,39,39,1,0,"Cs",5
45,"45165",62598,47784,47120,345,664,"Cs",9153
9,"9038",111,95,95,0,0,"Cs",28
14,"14055",18446,13919,13711,148,208,"Cs",2852
10,"10188",478,387,379,0,8,"Cs",50
24,"24143",495,388,380,2,8,"Cs",42
34,"34163",46,40,40,1,0,"Cs",4
47,"47150",259,206,202,0,4,"Cs",46
49,"49108",454,325,322,2,3,"Cs",46
8,"8098",2409,1916,1912,9,4,"Cs",208
35,"35008",6207,4733,4654,42,79,"Cs",714
37,"37350",404,310,307,0,3,"Cs",75
46,"46066",1285,1058,1043,6,15,"Cs",159
24,"24225",992,762,751,5,11,"Cs",111
9,"9418",73,58,55,2,3,"Cs",11
49,"49231",293,212,209,0,3,"Cs",36
24,"24144",639,469,462,2,7,"Cs",76
51,"51001",59934,38342,37884,322,458,"Cs",4530
45,"45030",478,368,364,3,4,"Cs",41
6,"6105",604,406,400,2,6,"Cs",77
49,"49148",264,146,136,1,10,"Cs",19
5,"5162",75,58,58,0,0,"Cs",9
37,"37125",227,171,169,0,2,"Cs",39
24,"24102",608,457,448,3,9,"Cs",59
2,"2067",1129,866,852,4,14,"Cs",124
34,"34120",63965,50687,50117,471,570,"Cs",8206
26,"26022",187,153,148,0,5,"Cs",12
46,"46260",2647,2136,2113,8,23,"Cs",310
22,"22088",143,111,111,1,0,"Cs",11
5,"5239",231,177,174,1,3,"Cs",37
5,"5163",1705,1360,1345,4,15,"Cs",202
34,"34121",183,155,151,1,4,"Cs",32
19,"19182",39,32,32,0,0,"Cs",3
1,"1018",1408,998,993,6,5,"Cs",20
12,"12120",161,138,138,0,0,"Cs",13
13,"13098",1983,1537,1485,22,52,"Cs",234
44,"44195",84,66,65,1,1,"Cs",12
22,"22905",287,226,224,2,2,"Cs",49
18,"18135",4434,3169,3105,23,64,"Cs",470
49,"49111",121,100,100,3,0,"Cs",10
9,"9094",51,46,45,0,1,"Cs",3
42,"42029",131,98,97,2,1,"Cs",11
40,"40202",55,38,38,0,0,"Cs",7
13,"13901",864,687,673,1,14,"Cs",88
5,"5165",370,293,285,4,8,"Cs",51
5,"5047",4118,3334,3248,25,86,"Cs",530
50,"50146",190,152,149,0,3,"Cs",15
16,"16013",26,21,20,0,1,"Cs",5
10,"10112",1518,1168,1151,4,17,"Cs",122
47,"47154",146,122,118,2,4,"Cs",17
22,"22136",749,579,576,5,3,"Cs",108
44,"44005",46,31,31,1,0,"Cs",8
9,"9151",445,358,354,3,4,"Cs",61
40,"40099",52,46,44,0,2,"Cs",3
37,"37006",117,81,81,2,0,"Cs",8
14,"14060",3694,2878,2798,26,80,"Cs",495
42,"42071",163,111,108,2,3,"Cs",10
16,"16014",563,444,443,4,1,"Cs",45
9,"9373",406,284,268,3,16,"Cs",46
26,"26062",86,74,72,1,2,"Cs",7
33,"33006",1480,1001,992,9,9,"Cs",70
24,"24230",410,312,309,5,3,"Cs",46
3,"3078",474,372,371,2,1,"Cs",85
22,"22137",1015,741,733,9,8,"Cs",128
44,"44006",223,171,169,2,2,"Cs",39
10,"10073",721,553,546,4,7,"Cs",48
5,"5167",225,181,175,1,6,"Cs",15
50,"50058",63,54,53,2,1,"Cs",13
39,"39098",1379,1154,1144,7,10,"Cs",97
8,"8208",5760,4660,4643,25,17,"Cs",589
40,"40204",151,109,104,1,5,"Cs",13
37,"37131",171,138,137,0,1,"Cs",32
37,"37357",258,0,0,0,0,"Cs",0
41,"41056",3694,3044,3009,36,35,"Cs",490
44,"44106",153,115,111,2,4,"Cs",12
34,"34125",79,59,58,0,1,"Cs",7
35,"35013",6584,5067,4974,49,93,"Cs",709
3,"3079",18403,14632,14382,114,250,"Cs",3198
33,"33069",3419,2557,2533,32,24,"Cs",354
48,"48911",388,323,322,3,1,"Cs",2
49,"49116",360,255,248,5,7,"Cs",27
10,"10197",108,84,84,0,0,"Cs",4
8,"8129",484,406,405,3,1,"Cs",19
40,"40206",162,132,128,2,4,"Cs",23
24,"24109",876,635,619,3,16,"Cs",103
40,"40101",923,737,728,8,9,"Cs",174
9,"9101",74,57,57,0,0,"Cs",5
35,"35014",11908,7101,6947,63,154,"Cs",1041
14,"14002",10859,8215,8078,93,137,"Cs",1104
13,"13014",481,400,395,1,5,"Cs",35
7,"7012",1909,1358,1343,15,15,"Cs",146
46,"46224",154,124,124,2,0,"Cs",9
47,"47157",495,428,426,3,2,"Cs",55
34,"34176",127,106,104,2,2,"Cs",23
34,"34036",238,199,198,1,1,"Cs",27
9,"9103",200,179,179,1,0,"Cs",17
45,"45040",1276,842,828,4,14,"Cs",77
9,"9378",29,21,20,0,1,"Cs",4
12,"12004",4177,3225,3187,13,38,"Cs",436
10,"10158",337,269,267,0,2,"Cs",26
16,"16243",379,323,318,5,5,"Cs",26
49,"49118",194,151,151,1,0,"Cs",26
44,"44039",202,166,165,3,1,"Cs",18
44,"44009",799,621,611,7,10,"Cs",103
37,"37247",173,144,143,1,1,"Cs",30
19,"19327",397,333,332,0,1,"Cs",28
10,"10079",858,694,684,1,10,"Cs",112
5,"5171",67,57,51,1,6,"Cs",12
24,"24113",351,277,272,2,5,"Cs",53
22,"22143",197,134,132,1,2,"Cs",19
49,"49119",222,181,180,0,1,"Cs",20
9,"9105",97,81,76,1,5,"Cs",13
45,"45042",183,141,137,0,4,"Cs",11
50,"50062",1863,1441,1416,9,25,"Cs",277
16,"16147",56,32,32,0,0,"Cs",10
44,"44171",182,130,128,0,2,"Cs",11
47,"47033",204,167,167,2,0,"Cs",45
47,"47159",831,703,693,0,10,"Cs",102
36,"36013",2242,1468,1452,15,16,"Cs",111
5,"5095",236,193,191,0,2,"Cs",17
37,"37013",107,73,72,0,1,"Cs",3
45,"45182",987,815,800,7,15,"Cs",65
9,"9268",88,71,71,0,0,"Cs",4
2,"2077",54,45,44,0,1,"Cs",1
18,"18144",803,650,640,2,10,"Cs",130
46,"46167",345,255,255,0,0,"Cs",21
48,"48021",1336,990,983,4,7,"Cs",7
37,"37136",633,448,434,8,14,"Cs",88
28,"28028",1820,1493,1483,8,10,"Cs",198
8,"8081",353,299,297,2,2,"Cs",8
26,"26148",150,128,124,1,4,"Cs",12
22,"22149",308,247,246,3,1,"Cs",47
45,"45183",2337,1743,1704,7,39,"Cs",354
49,"49002",58,49,43,0,6,"Cs",10
42,"42038",34,27,27,1,0,"Cs",2
10,"10082",1810,1495,1476,9,19,"Cs",262
26,"26033",163,143,142,3,1,"Cs",13
7,"7050",3442,2303,2275,28,28,"Cs",279
50,"50295",49,46,46,0,0,"Cs",8
4,"4005",533,448,442,0,6,"Cs",34
9,"9110",77,57,57,0,0,"Cs",7
26,"26149",45,36,36,0,0,"Cs",6
39,"39020",23931,17782,17566,126,216,"Cs",2123
37,"37364",757,549,536,7,13,"Cs",88
40,"40212",27,22,20,0,2,"Cs",3
27,"27901",2275,1542,1531,27,11,"Cs",110
19,"19195",37,29,28,2,1,"Cs",1
47,"47066",1407,1131,1122,11,9,"Cs",204
24,"24038",3048,2360,2315,23,45,"Cs",303
19,"19332",85,70,70,1,0,"Cs",12
5,"5215",159,126,124,0,2,"Cs",16
10,"10084",1294,899,869,5,30,"Cs",139
46,"46169",32294,24909,24676,157,233,"Cs",4459
42,"42177",64,55,54,6,1,"Cs",5
46,"46018",567,483,479,3,4,"Cs",51
29,"29069",86694,58863,58127,561,736,"Cs",11549
5,"5177",139,117,117,0,0,"Cs",15
42,"42042",49,42,42,1,0,"Cs",9
18,"18147",3644,2492,2441,18,51,"Cs",321
28,"28030",1815,1438,1395,10,43,"Cs",237
49,"49004",111,77,77,4,0,"Cs",15
48,"48085",10637,8270,8223,54,47,"Cs",196
32,"32078",1108,794,781,15,13,"Cs",54
41,"41064",5611,3763,3667,47,96,"Cs",605
14,"14039",2575,2037,1990,14,47,"Cs",299
6,"6052",3969,3043,2970,21,73,"Cs",563
34,"34135",399,320,315,4,5,"Cs",37
28,"28061",22564,18245,18064,117,181,"Cs",3924
36,"36017",17419,12867,12610,120,257,"Cs",1084
45,"45050",489,381,363,3,18,"Cs",56
42,"42178",101,75,75,0,0,"Cs",9
45,"45051",1634,1336,1290,9,46,"Cs",189
18,"18043",130,93,93,0,0,"Cs",10
32,"32079",1287,1016,1006,6,10,"Cs",136
35,"35021",15014,10909,10792,71,117,"Cs",2089
37,"37019",140,118,117,1,1,"Cs",13
40,"40005",25,21,21,0,0,"Cs",2
29,"29071",979,718,712,14,6,"Cs",74
26,"26038",81,61,61,0,0,"Cs",7
10,"10208",121,94,94,2,0,"Cs",3
9,"9117",71,55,53,0,2,"Cs",7
16,"16029",102,81,81,1,0,"Cs",12
44,"44016",436,334,331,1,3,"Cs",86
37,"37020",425,341,339,4,2,"Cs",60
8,"8243",156,139,139,0,0,"Cs",1
32,"32080",286,223,220,1,3,"Cs",7
9,"9442",370,305,301,5,4,"Cs",47
20,"20001",257,174,172,1,2,"Cs",0
28,"28003",170,148,148,1,0,"Cs",26
50,"50068",1947,1402,1389,11,13,"Cs",195
41,"41009",1167,820,805,4,15,"Cs",177
2,"2084",305,221,215,1,6,"Cs",40
19,"19055",44,34,34,1,0,"Cs",3
1,"1039",195,157,153,0,4,"Cs",5
34,"34140",96,69,69,1,0,"Cs",13
40,"40007",68,58,58,0,0,"Cs",13
5,"5063",31,27,27,0,0,"Cs",3
50,"50187",56,43,43,0,0,"Cs",6
49,"49009",389,305,304,2,1,"Cs",43
8,"8218",8104,6419,6389,34,30,"Cs",748
50,"50272",13174,10143,10042,103,101,"Cs",2350
24,"24122",1319,983,969,3,14,"Cs",153
18,"18150",6903,5149,5063,42,86,"Cs",884
23,"23010",14241,10186,10015,68,171,"Cs",1772
6,"6155",1825,1316,1292,21,24,"Cs",225
16,"16031",36,25,25,0,0,"Cs",2
20,"20003",551,401,399,2,2,"Cs",0
49,"49129",821,628,616,5,12,"Cs",65
34,"34141",176,154,152,0,2,"Cs",17
22,"22160",212,171,170,3,1,"Cs",35
28,"28005",136050,108267,107316,772,951,"Cs",23526
5,"5065",459,393,382,1,11,"Cs",88
19,"19058",7375,6122,6061,34,61,"Cs",1332
7,"7057",7404,5117,5028,50,89,"Cs",676
45,"45056",2300,1526,1501,8,25,"Cs",271
21,"21008",2613,1803,1777,6,26,"Cs",204
49,"49011",212,166,165,7,1,"Cs",26
50,"50160",2150,1652,1619,14,33,"Cs",243
26,"26158",246,207,206,2,1,"Cs",19
46,"46175",428,367,354,3,13,"Cs",33
44,"44210",743,600,594,8,6,"Cs",117
2,"2901",2185,1633,1613,9,20,"Cs",245
1,"1042",907,723,721,4,2,"Cs",9
8,"8139",177,156,156,0,0,"Cs",2
32,"32055",1230,908,889,5,19,"Cs",66
47,"47168",30,29,29,0,0,"Cs",3
36,"36022",9061,6640,6482,47,158,"Cs",521
45,"45195",2072,1615,1583,4,32,"Cs",192
6,"6124",1656,1323,1296,5,27,"Cs",185
19,"19060",157,128,125,0,3,"Cs",18
21,"21009",835,575,557,0,18,"Cs",70
8,"8140",4778,3756,3737,19,19,"Cs",251
49,"49132",313,252,249,0,3,"Cs",33
42,"42051",15,10,10,0,0,"Cs",0
45,"45059",1696,1442,1415,4,27,"Cs",301
41,"41013",4807,3480,3425,30,55,"Cs",210
34,"34099",52,45,41,0,4,"Cs",10
45,"45012",631,516,509,2,7,"Cs",43
39,"39056",2268,1847,1830,7,17,"Cs",231
7,"7060",2665,1976,1964,14,12,"Cs",206
37,"37148",404,321,315,2,6,"Cs",63
41,"41070",6397,4987,4921,55,66,"Cs",1032
10,"10094",228,180,180,0,0,"Cs",16
37,"37261",217,166,163,0,3,"Cs",23
5,"5185",90,71,70,0,1,"Cs",10
5,"5069",74,63,62,0,1,"Cs",9
40,"40154",23,20,20,0,0,"Cs",5
20,"20006",254,169,169,0,0,"Cs",1
32,"32001",5105,3760,3715,37,45,"Cs",308
12,"12138",19179,14217,14006,124,211,"Cs",1934
10,"10095",314,260,255,2,5,"Cs",65
50,"50102",820,653,642,9,11,"Cs",111
47,"47140",110,91,90,0,1,"Cs",11
46,"46178",4943,3684,3641,21,43,"Cs",713
32,"32085",10634,7655,7551,66,104,"Cs",913
50,"50163",3787,3041,3022,31,19,"Cs",756
44,"44022",463,342,326,6,16,"Cs",81
1,"1046",631,464,461,0,3,"Cs",10
19,"19211",356,301,300,0,1,"Cs",27
26,"26046",1571,1185,1157,18,28,"Cs",161
37,"37375",673,583,573,4,10,"Cs",116
49,"49259",79,62,61,0,1,"Cs",9
21,"21012",286,238,233,4,5,"Cs",17
32,"32086",2563,1699,1686,19,13,"Cs",126
23,"23016",384,316,311,0,5,"Cs",40
46,"46179",2116,1723,1678,18,45,"Cs",222
34,"34205",55,44,44,0,0,"Cs",3
40,"40223",228,181,181,0,0,"Cs",41
3,"3004",599,465,458,4,7,"Cs",74
44,"44121",53,38,38,2,0,"Cs",3
37,"37264",55,42,42,0,0,"Cs",5
10,"10219",1212,814,806,8,8,"Cs",132
47,"47078",159,135,131,0,4,"Cs",30
20,"20038",380,296,295,0,1,"Cs",0
28,"28010",10538,8708,8635,54,73,"Cs",2066
37,"37029",193,139,133,1,6,"Cs",21
35,"35028",10044,6188,6105,52,83,"Cs",947
42,"42054",19,15,15,0,0,"Cs",1
35,"35029",4357,2869,2832,32,37,"Cs",335
45,"45064",3998,3166,3117,17,49,"Cs",587
40,"40224",19,16,16,0,0,"Cs",1
10,"10099",559,412,401,3,11,"Cs",63
42,"42056",28,25,24,0,1,"Cs",0
9,"9353",76,64,63,2,1,"Cs",19
13,"13039",14212,10929,10761,107,168,"Cs",2038
37,"37030",81,68,65,0,3,"Cs",16
10,"10901",1177,818,805,1,13,"Cs",116
45,"45203",2713,2092,2053,16,39,"Cs",359
30,"30041",13970,9796,9682,80,114,"Cs",1817
23,"23018",2268,1738,1722,8,16,"Cs",194
50,"50251",8207,6352,6242,46,110,"Cs",1121
34,"34155",120,104,103,0,1,"Cs",11
4,"4061",622,501,494,4,7,"Cs",140
3,"3099",42876,32576,32172,192,404,"Cs",6335
14,"14020",338,240,233,2,7,"Cs",21
37,"37031",336,261,258,3,3,"Cs",37
45,"45157",2261,1627,1603,8,24,"Cs",261
26,"26014",447,313,309,2,4,"Cs",41
46,"46254",943,751,734,4,17,"Cs",74
18,"18053",1561,1102,1099,3,3,"Cs",168
10,"10101",179,140,138,2,2,"Cs",21
9,"9301",648,545,536,7,9,"Cs",115
10,"10903",796,623,614,4,9,"Cs",106
7,"7065",2302,1633,1603,10,30,"Cs",177
16,"16169",51,36,32,0,4,"Cs",2
40,"40017",84,74,71,2,3,"Cs",17
18,"18901",488,335,329,2,6,"Cs",33
8,"8145",2701,2156,2144,7,12,"Cs",205
45,"45113",1797,1300,1281,6,19,"Cs",151
39,"39089",134,99,98,0,1,"Cs",4
37,"37032",549,431,430,3,1,"Cs",111
50,"50168",27,20,20,0,0,"Cs",1
7,"7902",1091,776,743,10,33,"Cs",88
45,"45901",780,593,587,3,6,"Cs",74
16,"16043",88,71,71,1,0,"Cs",13
42,"42196",8,6,6,0,0,"Cs",0
28,"28085",4141,3337,3296,13,41,"Cs",563
11,"11037",5644,4567,4433,34,134,"Cs",262
9,"9134",220,155,151,1,4,"Cs",24
24,"24137",1052,815,803,14,12,"Cs",86
1,"1054",1013,729,726,2,3,"Cs",9
45,"45070",1406,1201,1188,4,13,"Cs",168
47,"47082",810,679,668,8,11,"Cs",99
37,"37269",430,331,325,2,6,"Cs",46
28,"28183",1124,857,842,4,15,"Cs",105
40,"40230",95,70,67,0,3,"Cs",7
49,"49142",249,175,173,0,2,"Cs",16
13,"13090",1023,814,796,5,18,"Cs",86
18,"18057",5540,4306,4246,30,60,"Cs",931
44,"44220",113,92,89,0,3,"Cs",12
3,"3040",258,223,217,1,6,"Cs",24
9,"9304",192,164,161,2,3,"Cs",39
22,"22174",462,381,377,0,4,"Cs",49
37,"37158",233,168,166,0,2,"Cs",31
26,"26054",292,235,231,2,4,"Cs",17
20,"20014",1156,772,765,4,7,"Cs",2
46,"46257",5428,4237,4190,23,47,"Cs",497
8,"8228",288,239,239,2,0,"Cs",11
40,"40020",155,125,119,4,6,"Cs",29
47,"47211",48,43,43,1,0,"Cs",4
34,"34160",134,114,112,0,2,"Cs",14
13,"13001",1195,947,943,5,4,"Cs",94
26,"26093",48,38,38,0,0,"Cs",3
9,"9195",55,45,45,1,0,"Cs",7
9,"9415",275,206,204,0,2,"Cs",58
11,"11039",9945,6824,6726,111,98,"Cs",1017
44,"44029",579,466,457,3,9,"Cs",92
5,"5235",139,106,101,0,5,"Cs",14
47,"47179",373,275,273,1,2,"Cs",64
41,"41078",2459,1910,1895,24,15,"Cs",186
5,"5197",100,84,83,0,1,"Cs",11
40,"40128",122,95,93,2,2,"Cs",11
40,"40021",19,18,18,0,0,"Cs",2
49,"49268",368,282,279,2,3,"Cs",30
20,"20015",1237,975,967,8,8,"Cs",2
3,"3012",1133,910,897,7,13,"Cs",156
26,"26056",403,334,328,2,6,"Cs",19
26,"26019",350,270,256,3,14,"Cs",47
34,"34024",25,17,16,1,1,"Cs",1
16,"16174",168,143,141,1,2,"Cs",9
50,"50903",2238,1750,1732,11,18,"Cs",346
7,"7038",2025,1581,1556,14,25,"Cs",133
6,"6037",1668,1137,1125,6,12,"Cs",158
28,"28902",523,418,415,2,3,"Cs",79
18,"18167",1850,1330,1317,17,13,"Cs",187
50,"50171",96,78,78,1,0,"Cs",17
50,"50172",178,134,131,3,3,"Cs",37
47,"47181",165,143,143,0,0,"Cs",27
40,"40022",193,162,159,2,3,"Cs",25
5,"5198",71,51,51,0,0,"Cs",9
6,"6038",790,583,574,4,9,"Cs",101
3,"3043",2899,2466,2434,21,32,"Cs",375
22,"22177",97,81,81,1,0,"Cs",22
12,"12060",430,368,365,1,3,"Cs",37
36,"36002",3076,2225,2185,19,40,"Cs",179
47,"47214",1364,1112,1074,7,38,"Cs",149
3,"3138",3183,2390,2359,16,31,"Cs",348
40,"40024",827,657,645,4,12,"Cs",144
8,"8901",240,203,201,1,2,"Cs",6
29,"29090",1653,1215,1200,8,15,"Cs",217
38,"38005",5666,3795,3761,24,34,"Cs",381
26,"26058",143,116,115,2,1,"Cs",9
24,"24226",193,136,134,2,2,"Cs",27
16,"16176",31,22,22,0,0,"Cs",4
19,"19181",55,47,46,1,1,"Cs",7
44,"44101",51,43,42,1,1,"Cs",17
44,"44161",430,320,316,1,4,"Cs",42
29,"29091",9407,6859,6719,63,140,"Cs",1163
50,"50174",83,58,58,0,0,"Cs",6
8,"8005",6380,5122,5106,18,16,"Cs",501
21,"21025",3898,2765,2705,39,60,"Cs",293
10,"10111",1306,1006,994,12,12,"Cs",153
26,"26177",301,250,246,2,4,"Cs",20
12,"12061",380,277,274,2,3,"Cs",30
47,"47088",105,90,90,0,0,"Cs",16
39,"39040",4267,3428,3385,24,43,"Cs",494
42,"42206",8,4,4,0,0,"Cs",0
24,"24148",1616,1252,1237,11,15,"Cs",202
49,"49029",614,497,488,9,9,"Cs",93
11,"11008",17840,12434,12236,181,198,"Cs",2617
49,"49273",166,111,110,0,1,"Cs",14
20,"20019",9912,7226,7195,51,31,"Cs",135
33,"33005",1376,929,916,14,13,"Cs",86
50,"50288",3444,2689,2668,24,21,"Cs",657
44,"44164",20,18,18,0,0,"Cs",1
15,"15076",2514,1709,1683,19,26,"Cs",116
45,"45126",239,173,168,0,5,"Cs",27
9,"9482",35,28,28,0,0,"Cs",4
23,"23030",1208,1022,1011,6,11,"Cs",51
5,"5204",583,486,482,4,4,"Cs",75
42,"42070",32,24,24,0,0,"Cs",2
34,"34224",42,30,29,0,1,"Cs",7
47,"47184",541,447,441,0,6,"Cs",79
24,"24149",146,123,123,0,0,"Cs",17
18,"18137",1002,776,773,0,3,"Cs",87
19,"19321",34,29,29,0,0,"Cs",2
46,"46100",281,210,205,0,5,"Cs",12
10,"10194",524,440,435,4,5,"Cs",88
6,"6009",228,190,187,2,3,"Cs",26
4,"4034",165,107,106,1,1,"Cs",27
28,"28094",959,736,729,6,7,"Cs",128
34,"34033",17,15,15,0,0,"Cs",3
5,"5088",29,23,23,0,0,"Cs",4
37,"37167",177,159,158,3,1,"Cs",26
49,"49153",151,110,108,0,2,"Cs",12
21,"21029",1509,1183,1160,14,23,"Cs",207
39,"39070",123,101,99,0,2,"Cs",18
46,"46132",2196,1877,1853,10,24,"Cs",239
12,"12095",950,763,756,9,7,"Cs",94
48,"48047",149,115,115,1,0,"Cs",1
18,"18174",434,362,357,0,5,"Cs",45
14,"14031",566,453,446,2,7,"Cs",47
36,"36007",1618,1163,1133,7,30,"Cs",70
9,"9154",124,101,101,3,0,"Cs",22
22,"22186",191,165,164,2,1,"Cs",28
46,"46193",8964,7206,7156,27,50,"Cs",1284
46,"46102",19635,15330,15207,95,123,"Cs",2403
12,"12067",523,423,416,1,7,"Cs",44
22,"22187",294,244,243,2,1,"Cs",49
10,"10116",3728,2849,2776,27,73,"Cs",460
37,"37281",39,34,33,0,1,"Cs",3
9,"9318",58,37,37,0,0,"Cs",2
5,"5090",77,70,69,0,1,"Cs",10
9,"9321",1597,1293,1280,4,13,"Cs",254
9,"9902",446,345,341,0,4,"Cs",71
4,"4076",1221,951,933,8,18,"Cs",113
5,"5208",38,31,31,0,0,"Cs",2
9,"9001",30,27,27,0,0,"Cs",3
49,"49194",340,236,233,3,3,"Cs",48
11,"11013",2332,1747,1713,16,34,"Cs",328
32,"32026",2659,1988,1957,26,31,"Cs",185
24,"24031",210,180,176,0,4,"Cs",31
16,"16101",139,123,122,0,1,"Cs",10
48,"48079",395,313,312,2,1,"Cs",2
11,"11014",17141,11836,11705,214,131,"Cs",2728
22,"22188",76,60,59,1,1,"Cs",8
39,"39101",236,173,171,1,2,"Cs",6
5,"5170",50,38,38,0,0,"Cs",9
18,"18141",384,269,264,0,5,"Cs",27
9,"9265",47,38,36,2,2,"Cs",4
22,"22142",94,80,80,2,0,"Cs",6
7,"7047",2371,1775,1747,13,28,"Cs",198
10,"10199",159,123,123,1,0,"Cs",28
16,"16060",722,571,560,3,11,"Cs",82
10,"10119",574,458,455,0,3,"Cs",61
27,"27002",1546,1136,1103,9,33,"Cs",67
16,"16061",941,790,763,8,27,"Cs",108
9,"9162",132,102,102,1,0,"Cs",14
3,"3021",5578,4720,4626,35,94,"Cs",787
32,"32018",1179,950,936,3,14,"Cs",38
29,"29098",1235,953,935,12,18,"Cs",145
47,"47094",123,110,109,1,1,"Cs",12
4,"4079",54086,38415,38134,239,281,"Cs",7417
18,"18177",373,253,252,1,1,"Cs",27
45,"45088",2332,1724,1695,16,29,"Cs",294
39,"39102",2255,1711,1698,11,13,"Cs",208
45,"45181",2337,1846,1818,7,28,"Cs",280
16,"16104",55,46,46,0,0,"Cs",6
49,"49242",444,364,359,3,5,"Cs",42
22,"22024",222,179,177,1,2,"Cs",30
44,"44231",36,33,32,0,1,"Cs",1
10,"10121",7914,5924,5809,36,115,"Cs",945
37,"37285",366,273,272,1,1,"Cs",32
42,"42081",136,95,93,0,2,"Cs",20
38,"38013",3019,2023,1991,12,32,"Cs",245
47,"47129",855,715,696,3,19,"Cs",147
24,"24034",3457,2627,2588,31,39,"Cs",380
16,"16063",113,86,83,0,3,"Cs",17
5,"5015",68,48,48,1,0,"Cs",9
7,"7049",1480,1092,1075,10,17,"Cs",99
11,"11018",1446,1126,1100,6,26,"Cs",145
47,"47095",41,36,34,2,2,"Cs",4
44,"44041",58,48,44,1,4,"Cs",6
27,"27004",1149,741,722,2,19,"Cs",39
45,"45091",374,275,274,1,1,"Cs",52
14,"14037",3182,2388,2319,22,69,"Cs",335
47,"47191",115,85,84,0,1,"Cs",10
18,"18179",503,346,343,3,3,"Cs",38
29,"29901",44578,31840,31537,286,303,"Cs",6514
33,"33013",429,320,316,1,4,"Cs",43
3,"3054",336,277,272,2,5,"Cs",33
44,"44142",28,21,21,0,0,"Cs",2
44,"44042",114,84,84,0,0,"Cs",8
50,"50007",49,34,34,0,0,"Cs",7
2,"2006",561,482,480,2,2,"Cs",55
8,"8014",2000,1578,1567,5,11,"Cs",103
28,"28029",562,459,456,2,3,"Cs",77
5,"5214",27,22,22,0,0,"Cs",8
6,"6150",780,637,635,2,2,"Cs",145
50,"50183",319,242,241,4,1,"Cs",51
12,"12102",521,442,434,2,8,"Cs",46
34,"34182",753,609,604,6,5,"Cs",57
5,"5018",24,18,17,0,1,"Cs",1
32,"32021",874,616,615,4,1,"Cs",31
8,"8240",9453,7807,7776,21,31,"Cs",477
19,"19240",51,42,41,1,1,"Cs",3
37,"37139",187,162,157,2,5,"Cs",47
10,"10125",862,655,639,4,16,"Cs",80
44,"44043",88,67,65,1,2,"Cs",18
9,"9013",44,37,37,0,0,"Cs",7
9,"9060",128,111,111,1,0,"Cs",13
50,"50037",127,93,93,0,0,"Cs",12
46,"46200",1848,1560,1539,6,21,"Cs",194
40,"40074",245,219,214,5,5,"Cs",50
5,"5256",112,94,92,1,2,"Cs",20
33,"33046",483,370,367,6,3,"Cs",18
12,"12010",237,203,198,1,5,"Cs",32
21,"21075",335,256,249,0,7,"Cs",28
8,"8241",69,56,56,0,0,"Cs",5
48,"48055",2596,2023,2005,12,18,"Cs",24
37,"37215",134,97,96,3,1,"Cs",14
32,"32051",1407,1158,1153,12,5,"Cs",40
15,"15086",2785,2015,1987,14,28,"Cs",150
20,"20060",88,75,75,0,0,"Cs",0
19,"19004",59,52,52,0,0,"Cs",5
22,"22199",6926,5113,5051,44,62,"Cs",990
23,"23073",4389,3400,3363,13,37,"Cs",475
5,"5217",54,44,43,0,1,"Cs",4
13,"13026",415,342,340,1,2,"Cs",35
44,"44045",368,302,298,8,4,"Cs",39
42,"42086",33,21,19,0,2,"Cs",4
28,"28107",442,336,325,3,11,"Cs",61
6,"6153",20240,15464,15210,134,254,"Cs",3050
48,"48056",989,791,785,4,6,"Cs",8
26,"26074",107,97,96,2,1,"Cs",6
5,"5102",1681,1358,1329,4,29,"Cs",163
9,"9063",214,185,184,0,1,"Cs",44
22,"22239",88,71,71,0,0,"Cs",6
46,"46233",3781,2901,2847,22,54,"Cs",441
9,"9337",114,93,93,0,0,"Cs",15
18,"18183",624,442,441,1,1,"Cs",81
23,"23043",518,398,397,0,1,"Cs",39
50,"50157",286,226,220,0,6,"Cs",19
39,"39080",3505,2735,2701,8,34,"Cs",370
26,"26076",116,93,91,0,2,"Cs",18
16,"16113",3067,2416,2383,15,33,"Cs",379
44,"44046",43,32,32,0,0,"Cs",7
47,"47196",28,24,24,0,0,"Cs",3
8,"8244",6041,4994,4970,33,24,"Cs",611
9,"9394",662,495,490,10,5,"Cs",76
11,"11024",6583,4774,4682,40,92,"Cs",875
9,"9174",781,625,608,3,17,"Cs",119
20,"20062",945,727,726,3,1,"Cs",10
4,"4011",2757,2171,2136,11,35,"Cs",251
3,"3029",244,174,167,1,7,"Cs",22
44,"44047",229,125,124,2,1,"Cs",17
10,"10171",355,261,255,0,6,"Cs",13
47,"47010",14572,12316,12186,102,130,"Cs",3389
26,"26077",17,17,17,0,0,"Cs",5
40,"40043",1791,1472,1447,9,25,"Cs",270
18,"18127",16822,12735,12537,106,198,"Cs",2407
48,"48059",400,329,325,0,4,"Cs",3
16,"16204",241,198,196,1,2,"Cs",40
8,"8018",2551,1998,1984,6,14,"Cs",175
3,"3123",7576,5900,5814,36,86,"Cs",1174
18,"18014",6898,5262,5162,43,100,"Cs",1140
34,"34051",91,81,79,0,2,"Cs",12
6,"6057",537,442,433,1,9,"Cs",35
46,"46205",14233,11274,11145,55,129,"Cs",1990
46,"46114",574,457,452,1,5,"Cs",67
33,"33020",13000,9476,9338,108,138,"Cs",1328
50,"50188",27,24,24,0,0,"Cs",3
37,"37108",99,80,78,2,2,"Cs",10
44,"44240",149,121,121,0,0,"Cs",28
34,"34245",310,244,240,3,4,"Cs",34
23,"23079",3639,2859,2818,20,41,"Cs",290
40,"40009",40,34,34,0,0,"Cs",4
49,"49170",98,75,75,1,0,"Cs",15
28,"28066",7515,6105,6039,40,66,"Cs",1428
50,"50274",66,48,47,0,1,"Cs",8
49,"49050",504,351,351,3,0,"Cs",70
10,"10133",1154,971,955,3,16,"Cs",80
30,"30005",30193,22648,22419,136,229,"Cs",4562
16,"16205",107,80,79,0,1,"Cs",12
13,"13032",1084,842,831,9,11,"Cs",83
16,"16078",41517,31810,31486,340,324,"Cs",5471
22,"22205",459,347,345,1,2,"Cs",46
47,"47105",175,152,149,1,3,"Cs",17
46,"46237",7148,5537,5472,36,65,"Cs",974
4,"4055",366,315,314,3,1,"Cs",20
28,"28175",935,775,767,3,8,"Cs",151
40,"40046",82,69,69,1,0,"Cs",10
46,"46025",2455,2002,1981,6,21,"Cs",332
9,"9179",38,32,32,0,0,"Cs",4
48,"48062",293,247,245,0,2,"Cs",1
24,"24169",2809,2165,2146,18,19,"Cs",215
49,"49219",7221,5301,5186,62,115,"Cs",922
10,"10135",1241,995,981,5,14,"Cs",63
3,"3033",102,87,85,0,2,"Cs",12
9,"9072",320,259,258,1,1,"Cs",52
7,"7027",22047,14986,14853,139,133,"Cs",2474
49,"49173",344,220,216,1,4,"Cs",22
47,"47014",47,43,43,1,0,"Cs",4
22,"22077",362,301,293,3,8,"Cs",46
37,"37225",99,90,86,1,4,"Cs",18
45,"45061",2485,1850,1822,7,28,"Cs",241
34,"34149",21,18,18,0,0,"Cs",2
27,"27046",1448,1074,1063,7,11,"Cs",49
13,"13036",766,626,617,0,9,"Cs",58
6,"6160",3019,2252,2209,10,43,"Cs",309
8,"8090",137,113,113,2,0,"Cs",2
27,"27015",4020,2809,2730,33,79,"Cs",152
37,"37069",971,721,704,2,17,"Cs",155
30,"30008",14450,10832,10675,60,157,"Cs",1930
47,"47204",235,182,178,0,4,"Cs",13
18,"18192",1466,1171,1156,1,15,"Cs",133
8,"8168",394,287,287,1,0,"Cs",15
33,"33024",225188,169937,168490,1483,1447,"Cs",29965
44,"44089",52,44,44,0,0,"Cs",8
16,"16269",393,322,317,3,5,"Cs",16
16,"16082",271,207,206,3,1,"Cs",4
47,"47015",176,136,135,0,1,"Cs",9
3,"3035",632,529,525,2,4,"Cs",61
24,"24172",415,240,237,1,3,"Cs",35
40,"40049",40,30,29,0,1,"Cs",0
8,"8039",402,334,334,2,0,"Cs",14
16,"16270",156,124,124,1,0,"Cs",10
13,"13037",790,633,620,3,13,"Cs",62
45,"45018",551,399,397,3,2,"Cs",48
24,"24092",745,606,601,6,5,"Cs",62
33,"33025",8996,6369,6309,81,60,"Cs",1149
37,"37189",114,88,88,2,0,"Cs",12
3,"3130",43,23,23,0,0,"Cs",6
41,"41016",7767,5937,5829,56,108,"Cs",1028
44,"44053",105,81,81,0,0,"Cs",21
50,"50046",167,134,130,3,4,"Cs",23
12,"12140",1140,936,922,7,14,"Cs",133
15,"15066",4008,2931,2886,30,45,"Cs",294
34,"34060",135,111,110,0,1,"Cs",15
9,"9029",144,120,118,3,2,"Cs",19
19,"19070",67,53,51,0,2,"Cs",6
19,"19019",14,10,10,0,0,"Cs",2
50,"50047",43,32,31,1,1,"Cs",7
47,"47207",260,213,211,2,2,"Cs",33
41,"41091",539730,412509,408312,3804,4197,"Cs",68824
36,"36028",4069,3012,2960,27,52,"Cs",229
26,"26087",170,136,135,3,1,"Cs",25
34,"34106",113,101,101,0,0,"Cs",17
5,"5075",99,79,79,1,0,"Cs",6
37,"37379",173,152,152,0,0,"Cs",22
20,"20071",15036,11090,11025,59,65,"Cs",155
29,"29027",2309,1716,1692,18,24,"Cs",247
6,"6065",298,258,255,1,3,"Cs",13
9,"9354",33,29,29,2,0,"Cs",6
23,"23053",9449,6379,6325,25,54,"Cs",574
24,"24175",1831,1433,1412,17,21,"Cs",291
50,"50195",53,42,41,0,1,"Cs",5
47,"47208",56,37,37,0,0,"Cs",4
28,"28150",3187,2640,2604,20,36,"Cs",534
19,"19122",81,64,64,1,0,"Cs",5
28,"28151",3251,2483,2450,11,33,"Cs",537
12,"12142",145,123,121,1,2,"Cs",25
10,"10183",958,748,735,3,13,"Cs",85
44,"44093",79,73,73,4,0,"Cs",8
19,"19123",36,33,32,2,1,"Cs",3
5,"5117",193,169,167,0,2,"Cs",30
13,"13042",888,699,686,2,13,"Cs",108
50,"50021",25,23,23,1,0,"Cs",2
11,"11036",687,457,447,7,10,"Cs",42
18,"18023",15645,11708,11561,91,147,"Cs",2530
13,"13044",2569,1984,1951,12,33,"Cs",292
13,"13043",209,167,167,1,0,"Cs",29
9,"9192",55,48,47,2,1,"Cs",4
24,"24057",1306,1018,997,7,21,"Cs",142
37,"37077",252,216,213,2,3,"Cs",38
48,"48068",1528,1218,1211,5,7,"Cs",3
28,"28119",2245,1839,1821,10,18,"Cs",428
49,"49180",138,95,95,0,0,"Cs",9
39,"39006",1721,1332,1315,3,17,"Cs",175
21,"21019",584,441,425,10,16,"Cs",26
37,"37245",335,240,240,5,0,"Cs",24
32,"32063",1819,1313,1287,6,26,"Cs",91
1,"1010",2315,1789,1770,14,19,"Cs",23
32,"32035",1370,881,872,5,9,"Cs",75
21,"21056",2922,2307,2228,27,79,"Cs",184
38,"38031",29154,22871,22598,143,273,"Cs",2847
46,"46124",785,680,675,5,5,"Cs",93
27,"27021",1649,1080,1048,14,32,"Cs",57
10,"10145",125,106,104,1,2,"Cs",14
23,"23056",3062,2332,2281,13,51,"Cs",349
24,"24059",821,575,572,3,3,"Cs",68
24,"24099",155,121,121,1,0,"Cs",3
37,"37235",219,170,166,4,4,"Cs",45
29,"29031",1559,1139,1113,13,26,"Cs",116
48,"48009",772,628,622,2,6,"Cs",7
35,"35006",31309,23434,23019,221,415,"Cs",3474
34,"34023",5098,4016,3973,48,43,"Cs",667
49,"49145",210,133,131,1,2,"Cs",19
45,"45118",2088,1562,1540,11,22,"Cs",239
9,"9361",112,94,94,1,0,"Cs",15
50,"50023",208,165,164,2,1,"Cs",31
33,"33001",1504,875,864,15,11,"Cs",74
42,"42024",86,66,66,3,0,"Cs",6
37,"37311",207,164,162,4,2,"Cs",31
9,"9196",135,108,107,0,1,"Cs",11
50,"50284",132,105,104,1,1,"Cs",11
47,"47212",358,312,311,3,1,"Cs",35
47,"47023",3057,2577,2557,21,20,"Cs",591
47,"47117",286,240,235,0,5,"Cs",58
40,"40234",376,307,299,2,8,"Cs",74
41,"41096",6134,4926,4845,44,81,"Cs",867
29,"29088",2694,2019,1951,31,68,"Cs",274
44,"44128",59,46,45,0,1,"Cs",11
23,"23026",3450,2625,2573,17,52,"Cs",318
22,"22902",208,160,156,0,4,"Cs",32
7,"7005",6975,4824,4775,43,49,"Cs",822
4,"4902",45395,31127,30881,251,246,"Cs",5109
49,"49185",156,126,120,1,6,"Cs",15
49,"49186",235,181,178,4,3,"Cs",19
9,"9198",100,80,79,0,1,"Cs",13
39,"39066",877,711,705,5,6,"Cs",68
33,"33033",9439,6565,6468,78,97,"Cs",723
24,"24062",130,90,90,2,0,"Cs",7
26,"26135",153,123,123,1,0,"Cs",17
26,"26021",2752,2132,2105,10,27,"Cs",305
45,"45167",1385,1143,1130,2,13,"Cs",187
9,"9199",94,72,70,0,2,"Cs",15
27,"27056",1206,896,880,9,16,"Cs",77
22,"22903",622,538,533,3,5,"Cs",103
3,"3044",4557,3650,3600,17,50,"Cs",663
8,"8257",103,86,86,1,0,"Cs",2
28,"28049",57902,47976,47561,329,415,"Cs",10047
9,"9365",27,19,19,1,0,"Cs",4
23,"23059",5728,4259,4187,18,72,"Cs",714
18,"18063",1217,712,702,6,10,"Cs",83
40,"40025",128,109,106,1,3,"Cs",10
10,"10190",521,372,361,2,11,"Cs",60
48,"48013",79423,59100,58630,458,470,"Cs",2021
1,"1017",816,579,574,2,5,"Cs",14
32,"32040",1418,1083,1075,3,8,"Cs",84
38,"38036",6831,4947,4829,58,118,"Cs",538
2,"2031",541,432,425,0,7,"Cs",52
29,"29035",1505,1151,1133,6,18,"Cs",49
49,"49069",327,211,207,0,4,"Cs",22
10,"10151",198,161,157,2,4,"Cs",8
10,"10069",785,609,596,2,13,"Cs",83
46,"46038",307,243,241,0,2,"Cs",16
18,"18099",1581,1279,1245,5,34,"Cs",211
22,"22089",276,216,216,2,0,"Cs",37
30,"30020",6431,4991,4940,19,51,"Cs",585
41,"41099",3968,2666,2642,23,24,"Cs",341
46,"46220",48968,35430,34964,306,466,"Cs",5815
47,"47215",48,44,44,0,0,"Cs",6
15,"15075",12785,9638,9519,121,119,"Cs",1492
32,"32069",4256,3358,3309,39,49,"Cs",300
48,"48014",1242,915,910,4,5,"Cs",29
19,"19183",71,61,59,0,2,"Cs",6
18,"18032",242,180,178,2,2,"Cs",24
22,"22018",308,234,232,2,2,"Cs",46
37,"37202",989,838,828,7,10,"Cs",217
9,"9257",86,74,71,0,3,"Cs",15
9,"9206",55,47,47,1,0,"Cs",3
28,"28052",3949,2890,2818,8,72,"Cs",547
24,"24229",388,312,307,2,5,"Cs",57
50,"50232",160,116,114,2,2,"Cs",17
19,"19270",25,21,21,0,0,"Cs",4
8,"8049",1320,981,977,5,4,"Cs",31
34,"34074",683,545,540,4,5,"Cs",79
16,"16140",19,16,16,0,0,"Cs",0
44,"44133",15,12,12,0,0,"Cs",2
37,"37044",450,342,335,6,7,"Cs",72
40,"40135",269,224,221,1,3,"Cs",26
7,"7043",3430,2465,2438,24,27,"Cs",261
49,"49191",266,216,214,1,2,"Cs",8
12,"12002",115,99,97,0,2,"Cs",6
50,"50289",51,40,38,1,2,"Cs",5
9,"9209",4419,3407,3338,37,69,"Cs",659
23,"23098",838,721,715,2,6,"Cs",48
39,"39014",901,709,704,5,5,"Cs",81
15,"15015",2883,2079,2049,21,30,"Cs",207
9,"9048",1380,1070,1039,8,31,"Cs",222
10,"10033",403,306,302,6,4,"Cs",30
5,"5128",342,274,267,1,7,"Cs",29
19,"19139",26,20,20,1,0,"Cs",0
22,"22096",320,274,272,2,2,"Cs",66
38,"38040",5446,3513,3462,13,51,"Cs",445
49,"49238",268,222,216,2,6,"Cs",34
36,"36040",2517,1895,1853,18,42,"Cs",143
30,"30023",3875,3107,3068,20,39,"Cs",486
20,"20052",1070,833,827,2,6,"Cs",6
13,"13058",4050,3188,3128,24,60,"Cs",477
26,"26104",11,9,9,0,0,"Cs",0
3,"3903",2577,1996,1973,11,23,"Cs",416
50,"50291",93,78,77,1,1,"Cs",15
41,"41029",13483,10357,10199,120,158,"Cs",1824
47,"47030",941,759,740,3,19,"Cs",109
44,"44168",184,137,136,4,1,"Cs",30
5,"5245",348,295,290,3,5,"Cs",75
23,"23065",1550,1199,1186,4,13,"Cs",166
41,"41001",1565,1224,1213,8,11,"Cs",124
37,"37219",165,101,97,2,4,"Cs",21
4,"4012",187,163,162,1,1,"Cs",29
8,"8104",653,516,516,2,0,"Cs",17
10,"10117",243,156,154,1,2,"Cs",10
8,"8210",4584,3455,3435,23,20,"Cs",218
19,"19189",115,93,92,0,1,"Cs",4
26,"26105",2211,1744,1723,19,21,"Cs",334
50,"50088",282,233,227,2,6,"Cs",30
46,"46073",1077,867,862,10,5,"Cs",83
44,"44200",39,25,25,0,0,"Cs",0
28,"28163",429,361,345,4,16,"Cs",46
8,"8288",1676,1196,1182,6,14,"Cs",114
20,"20903",4803,3514,3481,24,33,"Cs",73
18,"18176",241,182,180,0,2,"Cs",13
19,"19044",284,226,223,1,3,"Cs",24
26,"26030",17,17,17,0,0,"Cs",5
15,"15080",1640,1177,1150,9,27,"Cs",77
28,"28132",12068,9067,8954,63,113,"Cs",1663
19,"19280",3611,2805,2767,25,38,"Cs",602
15,"15081",982,755,741,11,14,"Cs",38
8,"8184",54876,41661,41447,248,214,"Cs",5988
46,"46044",4198,3399,3337,13,62,"Cs",561
4,"4002",1039,798,792,7,6,"Cs",91
5,"5249",96,69,69,0,0,"Cs",5
24,"24194",266,199,199,1,0,"Cs",21
50,"50293",392,295,293,6,2,"Cs",33
13,"13063",3652,2692,2649,32,43,"Cs",478
49,"49081",1322,1051,1030,11,21,"Cs",173
44,"44109",102,71,70,1,1,"Cs",10
26,"26147",34,30,29,0,1,"Cs",2
41,"41059",35105,27781,27472,261,309,"Cs",5485
42,"42037",29,19,18,0,1,"Cs",2
20,"20905",153,124,124,1,0,"Cs",0
10,"10161",82,50,50,1,0,"Cs",1
18,"18915",731,539,532,1,7,"Cs",66
19,"19281",18,17,17,3,0,"Cs",2
48,"48082",37396,27913,27694,172,219,"Cs",781
29,"29044",757,540,533,7,7,"Cs",48
23,"23003",8644,6604,6523,36,81,"Cs",884
2,"2004",606,504,499,5,5,"Cs",63
34,"34132",107,84,83,0,1,"Cs",9
44,"44268",32,30,30,0,0,"Cs",9
46,"46228",2417,1953,1913,13,40,"Cs",304
28,"28134",63352,51185,50776,336,409,"Cs",12399
40,"40071",43,37,31,0,6,"Cs",4
49,"49083",50,41,41,1,0,"Cs",1
45,"45137",1567,1155,1139,11,16,"Cs",179
9,"9386",55,49,49,0,0,"Cs",10
9,"9218",347,277,271,0,6,"Cs",55
12,"12007",731,649,642,8,7,"Cs",51
18,"18006",4087,3109,3042,28,67,"Cs",345
5,"5136",84,64,64,2,0,"Cs",13
9,"9219",27153,20116,19831,215,285,"Cs",3211
22,"22233",80,50,50,0,0,"Cs",6
16,"16248",862,730,720,10,10,"Cs",71
50,"50296",382,288,272,1,16,"Cs",52
45,"45138",1055,889,874,5,15,"Cs",90
4,"4006",7218,5002,4940,33,62,"Cs",1044
19,"19151",1083,785,770,5,15,"Cs",112
45,"45047",2668,1922,1882,11,40,"Cs",382
18,"18109",599,452,448,3,4,"Cs",62
16,"16196",602,522,510,3,12,"Cs",34
8,"8108",5192,4204,4189,26,15,"Cs",622
8,"8266",43383,35117,34994,178,123,"Cs",4774
48,"48054",24938,19329,19197,124,132,"Cs",753
45,"45094",367,290,288,4,2,"Cs",30
16,"16025",25,21,21,0,0,"Cs",4
10,"10165",253,212,210,1,2,"Cs",23
49,"49204",57,42,42,0,0,"Cs",3
19,"19050",15,13,13,0,0,"Cs",0
28,"28168",1329,976,969,3,7,"Cs",162
41,"41035",1060,803,788,8,15,"Cs",90
18,"18020",501,365,358,2,7,"Cs",65
45,"45049",423,340,335,1,5,"Cs",50
19,"19153",22,22,22,0,0,"Cs",2
41,"41063",2713,1988,1944,17,44,"Cs",248
50,"50241",595,434,423,3,11,"Cs",80
5,"5019",44838,36021,35637,287,384,"Cs",8651
44,"44113",72,51,50,0,1,"Cs",2
46,"46140",377,312,312,2,0,"Cs",61
26,"26037",131,99,98,1,1,"Cs",13
9,"9390",569,464,459,5,5,"Cs",89
19,"19052",21,16,16,0,0,"Cs",3
37,"37254",175,141,140,1,1,"Cs",25
41,"41036",3917,2944,2885,27,59,"Cs",298
47,"47164",350,290,286,2,4,"Cs",32
28,"28137",1744,1385,1366,8,19,"Cs",257
19,"19154",59,48,47,0,1,"Cs",2
9,"9224",159,135,132,0,3,"Cs",39
16,"16111",163,125,122,1,3,"Cs",18
36,"36048",5244,3859,3786,33,73,"Cs",385
26,"26001",198,171,165,1,6,"Cs",20
8,"8110",13592,10111,10058,50,53,"Cs",1082
13,"13072",729,542,531,3,11,"Cs",52
26,"26002",827,643,639,5,4,"Cs",101
8,"8058",1787,1357,1340,5,17,"Cs",132
50,"50156",209,174,171,1,3,"Cs",21
45,"45190",458,378,365,2,13,"Cs",41
9,"9391",361,286,283,3,3,"Cs",54
8,"8217",25355,20935,20855,110,80,"Cs",2899
41,"41037",3192,2505,2479,15,26,"Cs",225
3,"3121",21787,15670,15453,81,217,"Cs",2919
34,"34139",160,119,118,0,1,"Cs",9
19,"19006",757,556,548,7,8,"Cs",84
3,"3090",17881,13593,13437,108,156,"Cs",2931
13,"13073",497,394,390,1,4,"Cs",34
19,"19157",56,40,37,0,3,"Cs",3
34,"34241",18,17,14,4,3,"Cs",1
24,"24121",616,491,484,4,7,"Cs",51
7,"7023",3757,2777,2735,43,42,"Cs",424
18,"18115",2650,1988,1975,20,13,"Cs",226
24,"24043",122,71,69,0,2,"Cs",9
47,"47009",99,84,84,0,0,"Cs",10
32,"32081",2035,1592,1565,14,27,"Cs",141
20,"20002",355,258,257,8,1,"Cs",1
19,"19291",1131,875,864,1,11,"Cs",132
45,"45146",101,86,85,0,1,"Cs",3
37,"37233",56,46,46,2,0,"Cs",6
8,"8069",3280,2691,2680,17,11,"Cs",301
50,"50216",240,189,181,3,8,"Cs",42
20,"20063",8061,6042,5999,36,43,"Cs",54
32,"32054",86475,64472,63712,676,760,"Cs",8786
23,"23077",611,483,479,0,4,"Cs",55
41,"41067",7227,5367,5271,56,96,"Cs",661
50,"50041",17,14,14,0,0,"Cs",2
24,"24207",278,242,235,0,7,"Cs",31
40,"40115",156,131,130,4,1,"Cs",12
44,"44179",325,233,231,7,2,"Cs",40
50,"50217",431,346,344,0,2,"Cs",47
16,"16259",27,22,21,0,1,"Cs",0
8,"8061",1590,1236,1233,8,3,"Cs",129
45,"45010",389,280,280,3,0,"Cs",18
22,"22204",1119,836,832,9,4,"Cs",197
10,"10092",266,216,211,18,5,"Cs",27
45,"45148",275,209,209,1,0,"Cs",35
5,"5262",323,254,254,0,0,"Cs",28
16,"16074",28,23,23,0,0,"Cs",2
8,"8114",18648,14251,14170,69,81,"Cs",1707
45,"45011",275,241,238,2,3,"Cs",31
12,"12015",114,99,98,0,1,"Cs",6
38,"38053",3763,2628,2588,21,40,"Cs",317
9,"9400",310,250,247,4,3,"Cs",37
44,"44086",421,332,327,3,5,"Cs",55
44,"44180",72,61,61,0,0,"Cs",8
40,"40080",48,39,39,0,0,"Cs",5
33,"33052",704,520,513,5,7,"Cs",50
3,"3094",9626,7206,7138,42,68,"Cs",1425
47,"47013",90,80,78,4,2,"Cs",8
9,"9231",59,43,43,1,0,"Cs",6
42,"42188",43,35,34,1,1,"Cs",5
46,"46207",6686,5220,5137,36,83,"Cs",834
13,"13079",12265,9441,9218,123,223,"Cs",1498
8,"8273",2353,1944,1934,9,10,"Cs",71
41,"41041",9760,7835,7646,44,189,"Cs",1222
10,"10216",1522,1195,1167,9,28,"Cs",132
42,"42145",134,108,108,0,0,"Cs",18
39,"39084",874,718,712,4,6,"Cs",84
48,"48031",308,236,236,0,0,"Cs",1
9,"9180",133,104,99,1,5,"Cs",13
19,"19298",55,47,47,0,0,"Cs",9
48,"48001",5885,4359,4334,35,25,"Cs",132
22,"22117",2414,1798,1784,18,14,"Cs",351
23,"23015",1332,1066,1048,4,18,"Cs",161
16,"16209",111,97,97,0,0,"Cs",4
18,"18120",257,219,217,1,2,"Cs",13
8,"8222",1819,1484,1476,11,8,"Cs",105
9,"9235",140,105,102,0,3,"Cs",10
28,"28069",56,47,45,2,2,"Cs",9
22,"22004",124,90,88,1,2,"Cs",9
33,"33054",1611,1145,1124,8,21,"Cs",167
13,"13081",590,449,440,0,9,"Cs",31
46,"46057",474,319,313,1,6,"Cs",39
8,"8274",4674,3710,3698,12,12,"Cs",347
40,"40189",479,392,380,2,12,"Cs",50
15,"15001",4689,3422,3362,52,60,"Cs",423
19,"19166",152,125,122,0,3,"Cs",5
49,"49221",234,138,130,1,8,"Cs",33
10,"10014",1829,1448,1419,12,29,"Cs",139
12,"12082",9573,7672,7570,55,102,"Cs",1154
4,"4018",252,215,213,1,2,"Cs",20
8,"8197",7896,6197,6174,28,23,"Cs",791
28,"28147",990,779,769,2,10,"Cs",109
26,"26011",7229,5355,5277,64,78,"Cs",855
3,"3065",169399,128218,127256,967,962,"Cs",25569
8,"8143",2719,2121,2109,10,12,"Cs",227
42,"42055",165,124,122,2,2,"Cs",18
30,"30040",705,600,596,1,4,"Cs",49
16,"16039",367,263,262,2,1,"Cs",30
10,"10056",532,434,428,3,6,"Cs",39
47,"47143",110,78,78,1,0,"Cs",13
15,"15003",1701,1234,1210,10,24,"Cs",62
46,"46241",389,318,313,4,5,"Cs",43
12,"12112",110,97,96,1,1,"Cs",12
16,"16040",85,72,72,1,0,"Cs",9
28,"28116",759,621,618,7,3,"Cs",138
16,"16166",239,176,174,3,2,"Cs",17
8,"8144",713,565,563,5,2,"Cs",20
22,"22250",344,271,264,6,7,"Cs",53
2,"2021",1014,836,827,5,9,"Cs",88
3,"3006",494,413,409,1,4,"Cs",45
9,"9297",313,268,267,6,1,"Cs",72
5,"5903",138,94,92,0,2,"Cs",10
16,"16271",595,513,511,2,2,"Cs",35
28,"28149",6172,5089,5038,31,51,"Cs",1239
6,"6130",186,159,154,0,5,"Cs",5
9,"9241",247,192,188,2,4,"Cs",46
37,"37266",70,58,56,0,2,"Cs",8
49,"49019",228,170,164,0,6,"Cs",41
49,"49224",169,117,115,0,2,"Cs",16
9,"9410",2999,2175,2135,27,40,"Cs",176
10,"10059",325,234,232,1,2,"Cs",25
46,"46243",124,105,104,0,1,"Cs",11
44,"44124",73,58,57,0,1,"Cs",10
9,"9078",37,31,31,0,0,"Cs",7
16,"16126",729,622,616,5,6,"Cs",62
16,"16042",1108,948,938,3,10,"Cs",110
22,"22009",585,439,435,4,4,"Cs",53
32,"32061",1070,862,855,8,7,"Cs",57
26,"26088",41,38,38,0,0,"Cs",1
29,"29084",27218,19648,19352,173,296,"Cs",4082
1,"1053",592,376,373,2,3,"Cs",5
16,"16273",303,236,231,2,5,"Cs",32
27,"27051",8012,5936,5832,70,104,"Cs",566
37,"37119",95,78,77,0,1,"Cs",8
42,"42155",142,92,92,0,0,"Cs",7
13,"13088",589,439,429,1,10,"Cs",67
5,"5192",93,81,78,0,3,"Cs",9
46,"46153",435,364,356,1,8,"Cs",36
34,"34109",63,42,41,0,1,"Cs",7
7,"7034",1064,906,900,6,6,"Cs",95
50,"50138",47,42,42,1,0,"Cs",11
29,"29085",138,100,98,0,2,"Cs",8
13,"13089",1609,1336,1299,10,37,"Cs",136
35,"35004",41728,23957,23683,219,274,"Cs",2908
26,"26016",28,24,23,0,1,"Cs",3
19,"19075",61,44,43,0,1,"Cs",4
44,"44229",143,110,108,4,2,"Cs",18
48,"48017",13150,9546,9504,38,42,"Cs",66
10,"10104",5151,3862,3782,22,80,"Cs",717
19,"19173",51,47,47,0,0,"Cs",8
19,"19024",8525,6587,6485,33,102,"Cs",1543
10,"10185",573,463,460,3,3,"Cs",60
35,"35005",1017,751,743,1,8,"Cs",79
26,"26130",201,164,163,0,1,"Cs",28
8,"8280",95,78,78,1,0,"Cs",5
6,"6002",4314,3181,3086,44,95,"Cs",668
27,"27053",501,384,373,1,11,"Cs",13
13,"13092",1715,1434,1425,1,9,"Cs",139
12,"12057",578,485,473,3,12,"Cs",53
16,"16089",377,308,308,1,0,"Cs",37
16,"16131",127,90,90,1,0,"Cs",12
5,"5195",206,157,157,0,0,"Cs",18
12,"12058",64,56,56,0,0,"Cs",14
19,"19176",230,184,183,0,1,"Cs",23
36,"36032",3537,2676,2626,16,50,"Cs",190
44,"44127",57,45,45,0,0,"Cs",9
8,"8289",4457,3605,3594,20,11,"Cs",296
2,"2075",1718,1470,1448,4,22,"Cs",172
32,"32009",10590,7661,7574,68,87,"Cs",988
49,"49230",82,67,66,0,1,"Cs",4
48,"48904",3542,2832,2811,27,21,"Cs",79
37,"37349",103,69,68,0,1,"Cs",14
13,"13093",3930,2960,2906,34,54,"Cs",547
35,"35007",518,405,401,0,4,"Cs",22
47,"47053",126,100,97,0,3,"Cs",17
29,"29032",6657,5314,5190,30,124,"Cs",667
48,"48010",474,368,368,0,0,"Cs",4
42,"42110",55,43,43,0,0,"Cs",7
12,"12059",228,191,188,0,3,"Cs",24
4,"4028",202,183,181,0,2,"Cs",9
48,"48041",686,581,579,2,2,"Cs",5
48,"48011",9652,7293,7251,37,42,"Cs",176
16,"16133",4387,3607,3544,38,63,"Cs",412
15,"15010",1819,1194,1181,16,13,"Cs",76
18,"18028",907,766,756,0,10,"Cs",67
12,"12119",137,107,104,1,3,"Cs",17
2,"2066",223,172,169,1,3,"Cs",12
19,"19178",30,15,15,0,0,"Cs",3
19,"19311",87,71,71,2,0,"Cs",18
8,"8072",10699,8226,8193,45,33,"Cs",987
37,"37274",118473,91137,90221,811,916,"Cs",18823
41,"41080",1240,940,913,11,27,"Cs",136
16,"16134",4383,3544,3491,34,53,"Cs",595
9,"9141",602,501,493,4,8,"Cs",100
39,"39010",610,518,512,1,6,"Cs",28
39,"39094",841,676,670,3,6,"Cs",83
32,"32067",1193,827,818,10,9,"Cs",67
28,"28156",1084,885,880,6,5,"Cs",174
49,"49232",84,71,70,0,1,"Cs",12
45,"45168",62790,50868,50335,359,533,"Cs",9909
39,"39067",759,582,575,3,7,"Cs",52
37,"37163",32,27,27,0,0,"Cs",5
10,"10109",1730,1208,1181,12,27,"Cs",180
40,"40003",121,91,89,1,2,"Cs",12
16,"16280",165,130,128,3,2,"Cs",13
34,"34072",143,130,128,1,2,"Cs",10
50,"50231",257,210,207,3,3,"Cs",32
44,"44102",27,22,22,0,0,"Cs",8
39,"39011",1575,1249,1242,3,7,"Cs",150
32,"32068",1419,998,987,4,11,"Cs",50
40,"40095",464,379,369,2,10,"Cs",75
8,"8152",116,94,94,0,0,"Cs",0
8,"8206",737,625,624,3,1,"Cs",29
37,"37240",939,694,686,3,8,"Cs",185
49,"49234",399,339,333,2,6,"Cs",37
6,"6007",1433,1078,1071,5,7,"Cs",123
6,"6107",1570,1117,1106,9,11,"Cs",172
3,"3076",8736,6571,6467,40,104,"Cs",1194
37,"37017",222,177,177,1,0,"Cs",47
41,"41026",4300,3561,3521,18,40,"Cs",327
22,"22182",233,178,174,1,4,"Cs",25
5,"5164",17,12,12,0,0,"Cs",0
44,"44132",58,47,47,0,0,"Cs",5
5,"5126",62,53,52,0,1,"Cs",5
48,"48015",33109,24697,24475,161,222,"Cs",716
26,"26140",239,199,194,1,5,"Cs",21
41,"41054",713,596,588,4,8,"Cs",80
22,"22019",175,151,151,0,0,"Cs",39
19,"19089",25,19,19,1,0,"Cs",0
16,"16185",35,29,29,0,0,"Cs",4
10,"10071",124,85,84,0,1,"Cs",9
45,"45081",19138,15010,14829,110,181,"Cs",3417
10,"10072",835,632,625,3,7,"Cs",67
19,"19039",59,56,55,1,1,"Cs",2
6,"6108",2249,1726,1684,22,42,"Cs",274
45,"45035",293,228,223,1,5,"Cs",12
26,"26025",89,77,77,0,0,"Cs",6
22,"22057",364,286,284,3,2,"Cs",40
28,"28160",8629,6922,6856,34,66,"Cs",1556
13,"13904",504,394,376,6,18,"Cs",43
32,"32070",512,307,304,8,3,"Cs",17
49,"49237",143,95,93,0,2,"Cs",8
41,"41084",2815,2177,2111,3,66,"Cs",242
19,"19138",223,176,172,4,4,"Cs",20
22,"22095",65,57,56,1,1,"Cs",6
44,"44197",50,35,35,0,0,"Cs",1
42,"42032",142,120,120,0,0,"Cs",22
44,"44198",181,151,145,1,6,"Cs",32
2,"2072",1525,1146,1112,4,34,"Cs",132
1,"1021",469,333,330,1,3,"Cs",7
8,"8287",1057,877,871,7,6,"Cs",26
7,"7011",28642,19567,19396,147,171,"Cs",3856
24,"24901",860,642,630,7,12,"Cs",87
45,"45175",614,512,504,3,8,"Cs",43
4,"4036",223,188,186,1,2,"Cs",22
46,"46163",1856,1522,1501,4,21,"Cs",229
24,"24902",335,266,263,1,3,"Cs",27
48,"48912",2331,1843,1833,7,10,"Cs",34
45,"45038",3505,2749,2705,16,44,"Cs",600
39,"39100",849,650,644,9,6,"Cs",70
5,"5052",87,77,77,0,0,"Cs",10
19,"19324",160,128,123,1,5,"Cs",18
20,"20902",14229,10567,10495,53,72,"Cs",462
42,"42076",201,157,151,0,6,"Cs",27
26,"26157",282,233,232,1,1,"Cs",37
34,"34003",150,122,120,2,2,"Cs",15
9,"9444",63,43,43,2,0,"Cs",2
27,"27031",15212,10826,10649,125,177,"Cs",1162
9,"9213",270,196,196,1,0,"Cs",30
19,"19143",1754,1422,1402,11,20,"Cs",252
10,"10035",1806,1320,1282,12,38,"Cs",143
3,"3081",1494,1163,1141,5,22,"Cs",138
37,"37358",164,142,135,2,7,"Cs",33
44,"44136",51,43,43,1,0,"Cs",1
15,"15017",19860,14930,14706,204,224,"Cs",2193
26,"26029",36,29,28,0,1,"Cs",3
16,"16032",277,224,223,1,1,"Cs",10
26,"26144",188,161,160,1,1,"Cs",12
45,"45179",495,383,382,3,1,"Cs",36
26,"26145",237,207,204,0,3,"Cs",31
37,"37283",119,96,96,0,0,"Cs",6
48,"48050",187,153,149,0,4,"Cs",1
4,"4041",330,248,247,1,1,"Cs",26
50,"50061",193,173,169,1,4,"Cs",15
10,"10173",558,445,439,0,6,"Cs",47
39,"39054",4528,3614,3575,23,39,"Cs",536
48,"48060",3620,2615,2606,13,9,"Cs",6
10,"10201",179,157,156,1,1,"Cs",33
49,"49241",240,199,199,1,0,"Cs",44
32,"32074",993,737,734,4,3,"Cs",53
8,"8212",491,406,402,1,4,"Cs",13
45,"45134",1609,1305,1291,6,14,"Cs",166
33,"33072",1455,973,963,14,10,"Cs",104
47,"47169",61,53,53,0,0,"Cs",12
19,"19147",45,36,36,0,0,"Cs",6
48,"48020",272959,203643,202331,1472,1312,"Cs",7794
47,"47003",204,171,168,4,3,"Cs",12
44,"44040",191,164,158,2,6,"Cs",22
22,"22025",1035,764,755,24,9,"Cs",134
5,"5173",59,52,52,0,0,"Cs",15
22,"22144",257,207,204,1,3,"Cs",25
24,"24196",1918,1446,1422,9,24,"Cs",163
40,"40001",706,597,590,7,7,"Cs",138
33,"33073",8186,5090,5023,65,67,"Cs",634
9,"9907",1507,1198,1174,16,24,"Cs",270
12,"12039",792,688,680,3,8,"Cs",105
34,"34180",64,55,55,2,0,"Cs",11
49,"49038",94,68,68,1,0,"Cs",16
14,"14006",1321,1155,1127,4,28,"Cs",128
32,"32076",1974,1492,1472,17,20,"Cs",85
47,"47064",37,32,29,0,3,"Cs",5
28,"28101",229,183,182,2,1,"Cs",46
6,"6049",974,732,712,7,20,"Cs",131
8,"8213",6547,5270,5245,23,25,"Cs",455
46,"46016",1075,887,880,8,7,"Cs",82
5,"5097",476,332,327,0,5,"Cs",47
8,"8013",1280,1040,1031,5,9,"Cs",78
29,"29079",2335,1796,1765,7,31,"Cs",224
23,"23005",29940,19587,19330,191,257,"Cs",3309
3,"3084",497,429,429,4,0,"Cs",44
37,"37251",107,79,79,1,0,"Cs",19
24,"24116",390,283,279,1,4,"Cs",49
26,"26083",354,295,291,1,4,"Cs",26
3,"3085",269,243,237,0,6,"Cs",29
9,"9272",259,197,195,2,2,"Cs",34
44,"44205",634,444,426,9,18,"Cs",78
16,"16195",458,368,364,3,4,"Cs",38
41,"41034",23480,16510,16250,230,260,"Cs",2470
32,"32049",689,468,462,3,6,"Cs",35
10,"10124",858,710,701,3,9,"Cs",61
45,"45139",145,118,117,1,1,"Cs",3
8,"8030",5209,4318,4305,16,13,"Cs",431
15,"15084",3059,2236,2217,20,19,"Cs",159
8,"8160",316,252,247,2,5,"Cs",7
26,"26035",16,14,13,0,1,"Cs",1
49,"49246",217,180,177,2,3,"Cs",20
49,"49041",414,309,307,4,2,"Cs",45
30,"30030",320172,249965,247884,1497,2081,"Cs",50180
16,"16165",55,49,48,1,1,"Cs",2
19,"19067",69,53,50,1,3,"Cs",2
45,"45140",1089,887,870,5,17,"Cs",93
41,"41072",4037,3256,3221,19,35,"Cs",234
36,"36047",2287,1601,1585,14,16,"Cs",117
28,"28136",680,569,563,0,6,"Cs",91
14,"14009",2669,1863,1844,19,19,"Cs",292
47,"47037",163,134,128,2,6,"Cs",18
9,"9334",48,37,35,0,2,"Cs",6
23,"23041",491,383,382,0,1,"Cs",39
19,"19169",33,26,25,0,1,"Cs",3
49,"49205",367,286,282,5,4,"Cs",30
45,"45004",552,434,434,4,0,"Cs",47
19,"19335",56,45,43,0,2,"Cs",2
45,"45188",2762,2144,2098,14,46,"Cs",348
45,"45142",7800,6245,6143,67,102,"Cs",1001
34,"34136",149,105,102,0,3,"Cs",21
19,"19901",36,32,32,0,0,"Cs",2
7,"7054",22958,14097,13908,123,189,"Cs",2269
49,"49166",1192,916,899,10,17,"Cs",142
48,"48026",1139,920,913,4,7,"Cs",2
37,"37142",566,446,444,6,2,"Cs",93
49,"49007",365,271,265,7,6,"Cs",28
24,"24003",608,430,418,0,12,"Cs",68
46,"46020",3792,3028,2973,11,55,"Cs",414
37,"37292",94,76,73,1,3,"Cs",17
48,"48087",432,357,356,0,1,"Cs",5
6,"6087",2030,1592,1571,16,21,"Cs",171
49,"49249",63,52,52,1,0,"Cs",1
50,"50107",988,837,828,11,9,"Cs",176
5,"5155",46,36,36,0,0,"Cs",7
5,"5218",105,82,81,0,1,"Cs",9
22,"22157",183,136,134,1,2,"Cs",18
44,"44177",101,75,75,1,0,"Cs",6
45,"45144",740,605,598,7,7,"Cs",58
16,"16155",488,411,408,3,3,"Cs",44
4,"4051",406,343,339,1,4,"Cs",69
2,"2012",1825,1541,1509,8,32,"Cs",236
37,"37293",106,75,74,0,1,"Cs",13
27,"27010",4402,3015,2940,49,75,"Cs",149
48,"48058",946,724,715,3,9,"Cs",12
33,"33049",6044,4152,4079,56,73,"Cs",607
5,"5260",97,81,80,1,1,"Cs",10
9,"9019",144,113,109,1,4,"Cs",21
4,"4088",2435,1708,1693,6,15,"Cs",198
15,"15058",28606,22203,22022,261,181,"Cs",3738
3,"3101",4911,3827,3772,20,55,"Cs",491
40,"40126",67,53,51,0,2,"Cs",7
19,"19174",91,69,69,0,0,"Cs",8
49,"49252",304,244,241,6,3,"Cs",47
1,"1041",152,107,103,2,4,"Cs",4
12,"12045",328,275,271,2,4,"Cs",25
14,"14013",16604,12618,12388,155,230,"Cs",2007
5,"5143",62,51,51,0,0,"Cs",3
47,"47073",116,91,89,0,2,"Cs",6
44,"44117",319,263,256,5,7,"Cs",36
12,"12077",4790,3594,3565,39,29,"Cs",460
49,"49130",158,131,131,5,0,"Cs",26
44,"44126",317,226,222,1,4,"Cs",32
44,"44019",68,42,42,0,0,"Cs",13
12,"12014",167,131,127,1,4,"Cs",7
6,"6123",4512,3358,3266,28,92,"Cs",519
41,"41040",11111,8768,8679,76,89,"Cs",1742
49,"49210",448,372,370,3,2,"Cs",33
39,"39026",1720,1322,1312,5,10,"Cs",139
9,"9229",183,136,136,2,0,"Cs",13
18,"18025",279,214,212,0,2,"Cs",39
16,"16191",858,707,701,8,6,"Cs",111
47,"47093",797,628,615,6,13,"Cs",87
16,"16034",155,124,122,1,2,"Cs",14
24,"24125",421,298,289,2,9,"Cs",54
10,"10093",393,313,303,4,10,"Cs",30
49,"49256",242,204,202,4,2,"Cs",17
41,"41069",29569,21075,20657,361,418,"Cs",4090
8,"8062",1004,829,826,11,3,"Cs",70
8,"8003",7183,5761,5742,39,19,"Cs",680
30,"30006",829,731,727,4,4,"Cs",107
47,"47139",1004,790,776,2,14,"Cs",149
28,"28007",126831,103108,102202,710,906,"Cs",20569
24,"24210",527,387,386,0,1,"Cs",61
34,"34201",171,139,139,0,0,"Cs",18
19,"19061",53,45,45,0,0,"Cs",2
5,"5264",57,40,38,1,2,"Cs",11
21,"21010",14976,9475,9352,145,123,"Cs",1531
23,"23080",1721,1370,1355,8,15,"Cs",157
50,"50190",675,565,553,5,12,"Cs",77
34,"34902",123,98,98,4,0,"Cs",9
6,"6093",4345,3356,3281,18,75,"Cs",570
26,"26162",112,95,94,0,1,"Cs",21
16,"16161",52,47,47,0,0,"Cs",7
19,"19115",32,23,23,0,0,"Cs",4
4,"4016",2128,1643,1621,4,22,"Cs",309
33,"33023",3271,2448,2397,35,51,"Cs",310
4,"4057",1260,970,953,10,17,"Cs",186
49,"49014",116,89,88,2,1,"Cs",9
37,"37262",69,60,60,0,0,"Cs",6
22,"22164",43,33,31,0,2,"Cs",6
6,"6005",1691,1246,1225,15,21,"Cs",139
20,"20007",327,235,230,2,5,"Cs",1
24,"24011",189,122,121,1,1,"Cs",7
34,"34151",147,99,97,1,2,"Cs",16
8,"8142",139,126,126,1,0,"Cs",4
46,"46199",5842,4451,4414,23,37,"Cs",862
40,"40013",56,47,47,0,0,"Cs",5
45,"45108",482,385,382,0,3,"Cs",49
7,"7029",4366,3270,3229,25,41,"Cs",477
30,"30039",20191,14552,14380,96,172,"Cs",2648
50,"50220",43,37,37,0,0,"Cs",1
45,"45153",1560,1243,1230,4,13,"Cs",189
21,"21049",3282,2294,2214,21,80,"Cs",252
16,"16163",60,50,50,0,0,"Cs",4
10,"10138",540,422,415,3,7,"Cs",47
8,"8223",1886,1434,1425,4,9,"Cs",85
45,"45201",3620,2465,2419,10,46,"Cs",458
1,"1003",1179,908,903,6,5,"Cs",0
48,"48034",12639,9519,9443,77,76,"Cs",529
23,"23084",907,685,670,0,15,"Cs",48
33,"33035",11226,8326,8252,112,74,"Cs",1587
44,"44064",63,49,48,0,1,"Cs",8
37,"37265",208,184,181,1,3,"Cs",21
24,"24228",626,432,426,3,6,"Cs",70
20,"20039",2144,1704,1692,11,12,"Cs",7
8,"8302",9373,7001,6934,61,67,"Cs",1160
21,"21051",221,180,177,1,3,"Cs",20
41,"41017",15712,12048,11896,118,152,"Cs",2531
16,"16041",339,271,267,2,4,"Cs",30
26,"26126",29,29,29,1,0,"Cs",0
37,"37278",789,618,613,8,5,"Cs",185
22,"22008",155,127,125,0,2,"Cs",25
5,"5190",53,47,47,1,0,"Cs",8
48,"48035",404,334,331,2,3,"Cs",5
9,"9132",171,136,130,1,6,"Cs",24
15,"15035",11208,8175,8068,105,107,"Cs",779
37,"37191",104,65,65,1,0,"Cs",5
28,"28117",98,89,87,2,2,"Cs",15
20,"20070",1083,831,823,2,8,"Cs",3
13,"13086",162,139,136,1,3,"Cs",10
40,"40124",234,175,168,3,7,"Cs",23
32,"32089",1220,872,857,15,15,"Cs",111
8,"8225",94,81,81,1,0,"Cs",0
46,"46121",111,96,94,2,2,"Cs",10
12,"12085",5079,3504,3459,13,45,"Cs",635
19,"19258",84,69,66,1,3,"Cs",9
21,"21016",993,770,744,6,26,"Cs",74
37,"37073",620,481,471,6,10,"Cs",83
5,"5231",151,126,126,0,0,"Cs",15
9,"9374",90,79,78,1,1,"Cs",26
46,"46223",7781,6057,5995,42,62,"Cs",1148
12,"12022",328,273,269,1,4,"Cs",33
47,"47049",91,66,64,0,2,"Cs",8
50,"50253",382,318,315,2,3,"Cs",49
32,"32090",738,530,525,3,5,"Cs",48
22,"22047",241,213,212,2,1,"Cs",50
44,"44125",65,50,50,0,0,"Cs",8
48,"48037",684,537,531,4,6,"Cs",4
9,"9356",43,36,36,0,0,"Cs",12
24,"24218",444,343,341,6,2,"Cs",52
26,"26089",111800,87863,86778,700,1085,"Cs",16728
16,"16170",653,514,500,3,14,"Cs",44
35,"35032",3348,2585,2542,20,43,"Cs",371
21,"21055",7218,5328,5215,41,113,"Cs",894
42,"42197",68,56,56,0,0,"Cs",5
46,"46184",26453,21076,20810,172,266,"Cs",3397
50,"50169",336,261,259,2,2,"Cs",38
5,"5010",145,119,118,1,1,"Cs",19
9,"9262",158,137,136,1,1,"Cs",18
22,"22113",470,369,369,2,0,"Cs",77
8,"8279",155280,121081,120515,802,566,"Cs",15662
37,"37382",164,135,134,0,1,"Cs",20
22,"22084",555,438,433,5,5,"Cs",64
19,"19125",40,28,28,0,0,"Cs",6
46,"46002",1215,963,959,5,4,"Cs",111
8,"8001",9079,7383,7341,40,42,"Cs",1066
21,"21020",353,242,236,3,6,"Cs",21
28,"28087",3259,2643,2623,16,20,"Cs",497
8,"8147",17282,13644,13560,94,84,"Cs",1668
40,"40044",139,105,103,2,2,"Cs",21
45,"45117",715,571,556,1,15,"Cs",72
10,"10186",944,781,758,1,23,"Cs",93
4,"4026",55,46,45,1,1,"Cs",8
48,"48903",1807,1471,1462,6,9,"Cs",54
50,"50052",85,64,64,0,0,"Cs",8
23,"23090",1219,1014,1004,5,10,"Cs",68
45,"45026",218,177,172,0,5,"Cs",16
28,"28099",1923,1490,1475,7,15,"Cs",294
9,"9396",153,125,124,0,1,"Cs",12
48,"48090",6016,4700,4639,24,61,"Cs",96
8,"8263",21151,16360,16269,116,91,"Cs",2439
12,"12098",533,446,440,4,6,"Cs",32
45,"45073",287,226,225,1,1,"Cs",13
50,"50256",74,46,45,0,1,"Cs",3
9,"9139",98,82,82,2,0,"Cs",9
26,"26173",6,6,6,0,0,"Cs",0
3,"3051",344,312,307,2,5,"Cs",41
19,"19080",65,51,51,0,0,"Cs",8
16,"16008",83,65,65,0,0,"Cs",1
37,"37273",88,67,67,0,0,"Cs",5
45,"45027",327,276,273,0,3,"Cs",12
46,"46217",893,733,723,6,10,"Cs",99
28,"28017",1280,1017,1012,9,5,"Cs",193
50,"50228",250,217,214,3,3,"Cs",39
3,"3073",222,200,196,3,4,"Cs",8
18,"18097",995,708,702,4,6,"Cs",111
37,"37081",871,725,717,4,8,"Cs",113
10,"10108",203,131,130,1,1,"Cs",13
47,"47024",232,189,188,0,1,"Cs",24
45,"45075",124,93,90,0,3,"Cs",13
48,"48042",1365,1136,1130,7,6,"Cs",25
30,"30017",11477,8952,8844,62,108,"Cs",1823
16,"16093",57,47,47,0,0,"Cs",6
46,"46248",4886,3672,3613,25,59,"Cs",523
13,"13004",996,769,763,3,6,"Cs",61
34,"34220",149,133,132,0,1,"Cs",32
16,"16175",5079,4279,4207,40,72,"Cs",574
49,"49067",336,236,232,0,4,"Cs",43
5,"5238",739,589,586,1,3,"Cs",84
50,"50276",119,91,91,1,0,"Cs",13
9,"9310",15,14,13,1,1,"Cs",3
28,"28019",1269,990,981,4,9,"Cs",141
50,"50230",1134,853,846,6,7,"Cs",142
9,"9251",365,278,277,0,1,"Cs",55
9,"9026",371,305,303,2,2,"Cs",49
6,"6050",4042,3246,3163,27,83,"Cs",522
48,"48053",904,738,728,5,10,"Cs",28
20,"20078",1145,882,879,4,3,"Cs",7
16,"16177",82,64,63,0,1,"Cs",4
49,"49149",365,285,282,2,3,"Cs",41
23,"23029",806,651,637,0,14,"Cs",42
49,"49028",105,94,93,1,1,"Cs",5
9,"9312",89,75,74,2,1,"Cs",6
37,"37315",86,68,67,0,1,"Cs",14
18,"18170",324,225,224,1,1,"Cs",24
40,"40903",77,63,62,0,1,"Cs",11
46,"46262",213,170,165,1,5,"Cs",34
41,"41081",29840,22819,22465,228,354,"Cs",3310
26,"26060",75,60,60,1,0,"Cs",6
45,"45079",349,272,272,1,0,"Cs",28
23,"23040",1443,1164,1149,3,15,"Cs",106
8,"8117",2480,2055,2050,16,5,"Cs",118
19,"19037",132,114,112,0,2,"Cs",9
24,"24173",908,679,667,3,12,"Cs",125
39,"39096",670,523,518,2,5,"Cs",66
46,"46221",345,294,294,0,0,"Cs",42
10,"10070",669,516,513,1,3,"Cs",67
40,"40168",28,22,22,0,0,"Cs",0
20,"20050",270,186,183,3,3,"Cs",1
49,"49151",593,453,444,5,9,"Cs",65
39,"39078",1406,1101,1090,7,11,"Cs",143
39,"39097",679,437,435,2,2,"Cs",27
3,"3077",1374,1131,1114,9,17,"Cs",156
5,"5087",149,112,111,1,1,"Cs",5
49,"49235",422,312,301,0,11,"Cs",46
49,"49236",70,55,55,0,0,"Cs",15
37,"37242",80,65,64,1,1,"Cs",18
37,"37117",1553,1245,1230,14,15,"Cs",353
20,"20081",7655,5629,5601,22,28,"Cs",66
18,"18066",2108,1537,1525,9,12,"Cs",175
26,"26114",74,62,60,0,2,"Cs",10
40,"40028",105,96,96,1,0,"Cs",22
9,"9483",189,153,150,1,3,"Cs",29
19,"19090",90,73,72,1,1,"Cs",8
8,"8008",179,139,138,0,1,"Cs",4
9,"9317",19,19,19,1,0,"Cs",0
28,"28128",445,352,352,2,0,"Cs",61
42,"42166",57,49,49,0,0,"Cs",8
4,"4035",8433,6246,6196,33,50,"Cs",940
44,"44080",284,214,212,1,2,"Cs",28
35,"35031",7412,5593,5519,41,74,"Cs",857
20,"20021",186,112,112,0,0,"Cs",1
19,"19091",23,19,19,0,0,"Cs",1
39,"39042",5930,4722,4676,26,46,"Cs",858
23,"23032",523,443,439,1,4,"Cs",33
48,"48016",5437,4282,4248,21,34,"Cs",184
10,"10196",294,231,231,2,0,"Cs",12
5,"5207",645,543,540,3,3,"Cs",81
28,"28096",19809,15584,15392,118,192,"Cs",3552
40,"40136",106,82,81,0,1,"Cs",15
33,"33008",1705,1285,1273,9,12,"Cs",122
13,"13013",7050,5475,5371,39,104,"Cs",1027
34,"34175",87,67,66,0,1,"Cs",10
33,"33039",1641,1251,1243,6,8,"Cs",200
49,"49033",666,515,508,1,7,"Cs",80
23,"23033",1319,1076,1057,8,19,"Cs",162
19,"19092",395,317,309,1,8,"Cs",45
33,"33029",323,172,170,2,2,"Cs",15
20,"20033",854,675,671,5,4,"Cs",5
3,"3080",1328,1077,1064,4,13,"Cs",190
13,"13029",90,77,77,0,0,"Cs",9
47,"47230",288,236,233,1,3,"Cs",40
49,"49168",93,74,74,0,0,"Cs",13
50,"50292",129,113,113,1,0,"Cs",15
41,"41058",17860,12850,12598,152,252,"Cs",2124
6,"6112",383,334,334,1,0,"Cs",43
45,"45177",2023,1693,1651,11,42,"Cs",279
16,"16145",425,362,357,8,5,"Cs",33
19,"19043",99,87,84,2,3,"Cs",9
40,"40161",35,28,26,0,2,"Cs",2
14,"14044",1620,1279,1264,12,15,"Cs",205
6,"6012",3233,2515,2492,15,23,"Cs",284
16,"16908",163,135,133,0,2,"Cs",12
35,"35015",10728,6233,6108,54,125,"Cs",573
49,"49240",185,141,136,0,5,"Cs",16
44,"44230",152,112,111,1,1,"Cs",13
36,"36010",2828,2217,2184,15,33,"Cs",238
44,"44211",35,24,24,0,0,"Cs",5
39,"39091",1885,1512,1503,6,9,"Cs",181
40,"40069",74,65,65,0,0,"Cs",9
46,"46145",22099,16685,16499,128,186,"Cs",2879
34,"34199",1159,910,880,7,30,"Cs",164
19,"19098",18,18,17,0,1,"Cs",4
18,"18914",1657,1315,1278,5,37,"Cs",150
33,"33041",7112,5251,5194,63,57,"Cs",728
2,"2076",318,256,250,1,6,"Cs",29
9,"9346",89,69,68,1,1,"Cs",14
21,"21046",1714,1097,1071,13,26,"Cs",140
7,"7048",18412,11528,11412,112,116,"Cs",1897
44,"44201",478,417,412,3,5,"Cs",93
32,"32075",4382,3546,3489,35,57,"Cs",420
23,"23902",2229,1843,1820,7,23,"Cs",146
14,"14035",5817,4373,4314,44,59,"Cs",576
27,"27003",1772,1271,1241,6,30,"Cs",83
9,"9327",29,22,22,0,0,"Cs",5
49,"49200",936,744,726,10,18,"Cs",120
47,"47223",152,123,120,2,3,"Cs",17
22,"22193",269,220,217,2,3,"Cs",37
41,"41903",6769,5018,4919,73,99,"Cs",981
24,"24157",2545,2028,1972,25,56,"Cs",442
19,"19192",1759,1367,1360,3,7,"Cs",190
41,"41060",15100,11304,11105,113,199,"Cs",2092
39,"39047",1976,1564,1538,8,26,"Cs",222
6,"6148",957,762,746,12,16,"Cs",83
8,"8159",14323,11399,11359,57,40,"Cs",1418
34,"34233",128,118,117,2,1,"Cs",11
9,"9058",395,325,317,1,8,"Cs",91
5,"5213",95,77,75,0,2,"Cs",11
41,"41904",1792,1171,1162,16,9,"Cs",90
5,"5070",30,28,28,0,0,"Cs",1
5,"5044",250,189,189,1,0,"Cs",19
21,"21048",313,243,237,4,6,"Cs",29
9,"9073",963,799,787,7,12,"Cs",217
21,"21036",203,147,143,0,4,"Cs",12
34,"34181",422,324,321,3,3,"Cs",34
9,"9387",111,91,89,0,2,"Cs",15
40,"40082",106,83,81,0,2,"Cs",22
19,"19252",60,49,47,0,2,"Cs",12
48,"48083",6946,5238,5201,35,37,"Cs",76
9,"9329",117,90,89,8,1,"Cs",9
44,"44173",102,85,80,0,5,"Cs",15
28,"28167",8608,7086,7015,48,71,"Cs",1678
26,"26111",250,209,205,2,4,"Cs",22
7,"7018",379,287,286,1,1,"Cs",31
49,"49040",112,97,97,0,0,"Cs",6
16,"16249",1938,1544,1529,13,15,"Cs",192
19,"19255",72,51,51,0,0,"Cs",1
5,"5059",92,63,63,0,0,"Cs",6
47,"47098",556,480,475,4,5,"Cs",84
34,"34045",73,67,65,0,2,"Cs",5
29,"29047",1103,909,898,2,11,"Cs",72
16,"16123",66,43,43,0,0,"Cs",7
19,"19018",141,112,110,0,2,"Cs",11
35,"35010",3797,2601,2572,9,29,"Cs",238
46,"46028",388,324,319,1,5,"Cs",53
48,"48004",326,261,260,3,1,"Cs",0
35,"35020",5933,4140,4088,14,52,"Cs",293
8,"8031",2336,1886,1882,11,4,"Cs",115
40,"40004",445,348,341,0,7,"Cs",63
7,"7052",4816,3276,3258,39,18,"Cs",529
41,"41073",1685,1172,1157,13,15,"Cs",164
44,"44024",28,25,24,0,1,"Cs",2
37,"37102",379,297,291,3,6,"Cs",54
37,"37140",642,422,418,2,4,"Cs",69
47,"47132",39,33,33,0,0,"Cs",4
44,"44054",94,79,79,0,0,"Cs",12
45,"45172",641,504,496,4,8,"Cs",61
16,"16125",1599,1314,1295,9,19,"Cs",204
34,"34048",63,54,53,2,1,"Cs",2
12,"12011",4582,3511,3431,27,80,"Cs",438
10,"10005",530,407,384,3,23,"Cs",73
9,"9335",87,71,71,0,0,"Cs",13
46,"46111",11326,8603,8492,55,111,"Cs",1537
28,"28032",5042,4039,3992,23,47,"Cs",991
44,"44176",153,124,124,0,0,"Cs",27
30,"30032",2851,2256,2218,14,38,"Cs",251
47,"47228",439,353,352,1,1,"Cs",61
45,"45052",3134,2670,2652,23,18,"Cs",579
49,"49225",127,81,81,0,0,"Cs",16
14,"14001",3443,2724,2675,24,49,"Cs",342
33,"33058",1664,1205,1176,5,29,"Cs",121
37,"37204",255,197,195,0,2,"Cs",32
7,"7055",7897,5264,5176,47,88,"Cs",816
36,"36049",7019,5414,5283,48,131,"Cs",596
16,"16254",203,168,166,1,2,"Cs",24
40,"40148",228,185,180,0,5,"Cs",32
45,"45007",665,549,533,0,16,"Cs",46
10,"10089",1328,1014,982,20,32,"Cs",148
30,"30033",10363,8115,7979,54,136,"Cs",1446
8,"8112",12935,9822,9765,74,57,"Cs",742
46,"46234",327,264,263,5,1,"Cs",34
47,"47101",1644,1354,1337,9,17,"Cs",172
12,"12024",133,117,117,0,0,"Cs",21
44,"44156",46,36,33,1,3,"Cs",5
8,"8138",4432,3435,3413,10,22,"Cs",181
42,"42121",55,42,42,0,0,"Cs",8
10,"10076",793,597,585,4,12,"Cs",95
49,"49209",474,338,334,4,4,"Cs",37
15,"15037",4031,2700,2677,13,23,"Cs",254
39,"39034",257,167,162,2,5,"Cs",9
19,"19306",22,19,19,0,0,"Cs",1
16,"16072",133,96,95,1,1,"Cs",5
28,"28110",2003,1596,1571,7,25,"Cs",247
10,"10130",1747,1352,1321,12,31,"Cs",105
9,"9228",157,136,136,0,0,"Cs",29
10,"10172",696,517,513,0,4,"Cs",51
28,"28141",6246,4943,4890,44,53,"Cs",1191
40,"40113",408,339,335,6,4,"Cs",46
34,"34067",129,87,87,0,0,"Cs",5
40,"40079",226,179,175,1,4,"Cs",18
24,"24222",14431,11296,11135,117,161,"Cs",2399
30,"30035",19268,14248,14103,92,145,"Cs",2705
34,"34004",5533,4345,4286,41,59,"Cs",743
37,"37222",86,64,62,0,2,"Cs",14
37,"37335",389,308,301,3,7,"Cs",48
18,"18059",4253,3166,3123,22,43,"Cs",442
47,"47032",153,121,121,1,0,"Cs",13
9,"9247",22,18,18,0,0,"Cs",1
16,"16244",708,627,617,1,10,"Cs",65
10,"10037",76855,60447,59702,451,745,"Cs",13609
11,"11028",32791,24276,24028,279,248,"Cs",3247
47,"47012",101,80,80,0,0,"Cs",11
46,"46115",352,261,260,0,1,"Cs",29
36,"36023",8279,6187,6085,46,102,"Cs",727
38,"38033",3594,2512,2467,11,45,"Cs",239
36,"36033",12244,9553,9358,80,195,"Cs",941
7,"7026",30991,19827,19602,161,225,"Cs",3645
49,"49171",610,477,473,8,4,"Cs",73
32,"32028",1550,1176,1171,10,5,"Cs",95
29,"29054",42393,30327,30108,218,219,"Cs",6075
44,"44150",26,21,21,0,0,"Cs",6
44,"44087",68,56,54,0,2,"Cs",4
44,"44050",3115,2333,2299,27,34,"Cs",512
18,"18016",308,232,231,5,1,"Cs",27
47,"47044",323,282,279,1,3,"Cs",47
16,"16119",179,128,128,0,0,"Cs",7
50,"50043",246,172,170,2,2,"Cs",20
40,"40012",238,178,175,4,3,"Cs",23
26,"26122",116,98,97,0,1,"Cs",15
50,"50044",222,161,161,3,0,"Cs",20
33,"33053",1079,738,729,6,9,"Cs",49
32,"32057",514,367,365,5,2,"Cs",24
8,"8063",467,406,405,3,1,"Cs",9
10,"10176",347,266,261,2,5,"Cs",30
8,"8037",1930,1618,1610,10,8,"Cs",54
22,"22247",30,21,21,0,0,"Cs",3
37,"37351",269,234,233,6,1,"Cs",39
42,"42064",85,71,71,0,0,"Cs",7
46,"46249",9159,7113,7012,73,101,"Cs",1364
21,"21060",12235,8053,7929,93,124,"Cs",1618
49,"49054",849,641,629,5,12,"Cs",120
16,"16081",49,42,42,0,0,"Cs",8
45,"45015",662,506,500,2,6,"Cs",92
46,"46047",532,447,441,4,6,"Cs",55
2,"2079",2823,2303,2253,22,50,"Cs",276
19,"19016",57,40,40,0,0,"Cs",5
18,"18086",339,291,289,0,2,"Cs",16
37,"37188",160,115,112,3,3,"Cs",19
34,"34903",183,128,128,1,0,"Cs",13
9,"9236",35,29,29,1,0,"Cs",3
22,"22248",104,83,82,0,1,"Cs",15
39,"39086",362,273,268,1,5,"Cs",21
36,"36026",19924,14342,14132,171,210,"Cs",1684
26,"26023",435,351,347,5,4,"Cs",53
9,"9351",62,51,50,1,1,"Cs",9
33,"33055",1492,1156,1121,6,35,"Cs",200
37,"37028",137,111,107,1,4,"Cs",14
23,"23017",1480,1227,1202,6,25,"Cs",104
49,"49188",110,87,86,0,1,"Cs",17
37,"37214",116,87,87,4,0,"Cs",20
23,"23095",8591,6634,6571,27,63,"Cs",933
5,"5034",14,12,12,0,0,"Cs",2
8,"8048",569,442,442,2,0,"Cs",21
9,"9408",42,33,33,0,0,"Cs",8
39,"39059",7577,5978,5916,47,62,"Cs",724
28,"28083",9665,7794,7737,56,57,"Cs",1985
1,"1051",3558,2448,2433,14,15,"Cs",45
50,"50194",81,59,59,1,0,"Cs",13
42,"42030",89,72,72,0,0,"Cs",6
37,"37128",242,187,184,1,3,"Cs",30
49,"49100",286,210,208,2,2,"Cs",32
39,"39004",1483,1181,1163,4,18,"Cs",96
50,"50222",1570,1126,1105,17,21,"Cs",194
50,"50066",2835,2199,2177,19,22,"Cs",454
5,"5230",65,58,58,4,0,"Cs",10
49,"49223",716,552,548,0,4,"Cs",46
49,"49138",208,159,154,2,5,"Cs",19
32,"32060",765,577,567,2,10,"Cs",44
8,"8277",171,150,150,0,0,"Cs",6
44,"44092",70,56,55,1,1,"Cs",6
8,"8041",10692,7805,7732,48,73,"Cs",1157
8,"8251",5127,3972,3940,17,32,"Cs",496
1,"1006",176,127,127,2,0,"Cs",11
6,"6098",534,421,411,8,10,"Cs",28
11,"11035",13715,9510,9385,128,125,"Cs",1703
8,"8093",24,20,20,0,0,"Cs",0
44,"44055",77,58,56,0,2,"Cs",7
28,"28053",6840,5797,5739,32,58,"Cs",1504
41,"41074",2998,2364,2322,17,42,"Cs",197
7,"7044",8791,6335,6196,66,139,"Cs",756
42,"42120",132,89,87,0,2,"Cs",15
27,"27029",1427,1068,1047,13,21,"Cs",63
42,"42019",511,384,378,7,6,"Cs",57
3,"3069",3311,2356,2327,12,29,"Cs",350
33,"33028",1158,635,630,6,5,"Cs",42
16,"16218",187,149,148,2,1,"Cs",11
28,"28043",6166,4404,4320,30,84,"Cs",750
26,"26129",936,770,759,1,11,"Cs",114
10,"10061",1598,1126,1114,5,12,"Cs",218
9,"9412",765,564,558,7,6,"Cs",84
14,"14052",9080,5999,5909,63,90,"Cs",949
19,"19260",38,33,31,1,2,"Cs",2
39,"39099",3149,2562,2540,22,22,"Cs",292
9,"9377",629,494,488,4,6,"Cs",124
9,"9358",248,186,179,1,7,"Cs",27
45,"45099",3635,2741,2684,23,57,"Cs",457
28,"28182",198,169,169,1,0,"Cs",25
12,"12003",943,745,731,6,14,"Cs",116
10,"10211",447,345,343,2,2,"Cs",59
13,"13075",199,157,157,0,0,"Cs",18
5,"5039",48,47,47,0,0,"Cs",8
18,"18024",831,682,667,6,15,"Cs",46
29,"29030",774,660,657,3,3,"Cs",41
46,"46215",1397,1104,1093,12,11,"Cs",77
49,"49181",335,227,224,2,3,"Cs",15
5,"5119",24,16,16,1,0,"Cs",5
26,"26017",354,293,290,4,3,"Cs",34
45,"45193",589,512,507,6,5,"Cs",50
33,"33061",350,201,200,2,1,"Cs",9
16,"16157",190,163,161,1,2,"Cs",13
12,"12116",67,57,57,0,0,"Cs",8
29,"29064",437,319,315,2,4,"Cs",48
50,"50080",34,29,29,0,0,"Cs",4
5,"5159",228,160,159,2,1,"Cs",29
22,"22061",6583,5027,4973,51,54,"Cs",1040
7,"7025",446,363,362,4,1,"Cs",47
20,"20904",89,50,49,0,1,"Cs",0
6,"6113",2677,2117,2076,13,41,"Cs",352
48,"48914",325,286,285,0,1,"Cs",0
49,"49080",630,499,493,4,6,"Cs",67
40,"40092",113,86,84,2,2,"Cs",11
45,"45119",3485,2478,2430,21,48,"Cs",449
33,"33031",33854,23523,23143,307,380,"Cs",2858
19,"19146",46,41,41,1,0,"Cs",2
46,"46226",31,27,27,0,0,"Cs",0
39,"39009",3307,2545,2526,11,19,"Cs",376
42,"42201",23,20,20,0,0,"Cs",0
44,"44159",37,32,32,1,0,"Cs",3
42,"42158",94,78,78,0,0,"Cs",13
11,"11016",15051,10188,10042,131,146,"Cs",2207
49,"49269",220,163,162,1,1,"Cs",27
16,"16278",63,51,51,0,0,"Cs",3
19,"19222",96,73,72,2,1,"Cs",3
9,"9308",62,48,48,0,0,"Cs",8
41,"41051",2311,1770,1734,5,36,"Cs",151
20,"20077",5254,4083,4059,22,24,"Cs",94
19,"19129",27,25,25,0,0,"Cs",4
8,"8204",3115,2548,2534,22,14,"Cs",260
14,"14056",23513,17065,16684,147,381,"Cs",2935
47,"47118",149,111,108,1,3,"Cs",9
16,"16279",174,125,125,0,0,"Cs",22
18,"18133",2109,1632,1618,12,14,"Cs",169
39,"39038",1506,1093,1076,2,17,"Cs",137
19,"19033",48,42,41,0,1,"Cs",2
44,"44100",175,142,141,2,1,"Cs",12
42,"42065",23,18,18,2,0,"Cs",0
2,"2042",818,631,620,1,11,"Cs",76
20,"20026",204,182,159,3,23,"Cs",0
7,"7028",920,686,676,8,10,"Cs",77
12,"12017",148,120,116,0,4,"Cs",21
40,"40200",38,32,31,0,1,"Cs",7
21,"21024",466,355,341,4,14,"Cs",22
46,"46158",1040,805,796,4,9,"Cs",96
32,"32058",5225,3915,3857,35,58,"Cs",462
5,"5187",1728,1394,1364,7,30,"Cs",230
28,"28060",1565,1262,1247,5,15,"Cs",142
35,"35018",13056,8699,8618,73,81,"Cs",1223
19,"19267",21,17,17,1,0,"Cs",3
34,"34221",170,138,136,2,2,"Cs",15
2,"2068",324,274,273,0,1,"Cs",57
7,"7040",288348,192799,191053,1586,1746,"Cs",37027
3,"3045",213,178,173,4,5,"Cs",23
16,"16011",23,18,18,0,0,"Cs",5
23,"23071",1720,1348,1330,6,18,"Cs",136
8,"8258",813,661,657,6,4,"Cs",7
8,"8022",12219,9089,9038,42,51,"Cs",413
28,"28125",3216,2459,2444,11,15,"Cs",435
5,"5240",3323,2389,2346,16,43,"Cs",379
47,"47163",280,238,232,2,6,"Cs",38
24,"24012",285,204,202,2,2,"Cs",40
18,"18122",16001,11761,11556,110,205,"Cs",2167
34,"34222",109,81,79,1,2,"Cs",6
10,"10179",277,220,219,0,1,"Cs",15
20,"20079",18142,14055,13971,75,84,"Cs",264
11,"11903",1791,1234,1211,16,23,"Cs",208
45,"45033",298,224,221,1,3,"Cs",13
36,"36037",2554,1839,1793,6,46,"Cs",174
8,"8066",1463,1185,1181,9,4,"Cs",144
26,"26086",15,15,15,0,0,"Cs",1
9,"9315",393,291,286,4,5,"Cs",69
28,"28093",2142,1751,1728,9,23,"Cs",318
46,"46069",157,130,129,0,1,"Cs",15
42,"42194",146,111,111,0,0,"Cs",22
16,"16053",391,334,327,4,7,"Cs",58
5,"5166",160,128,123,1,5,"Cs",30
49,"49262",370,287,286,1,1,"Cs",33
9,"9298",75,62,62,1,0,"Cs",23
7,"7032",20888,14257,14096,108,161,"Cs",2493
34,"34186",47,41,41,0,0,"Cs",6
50,"50271",248,197,189,2,8,"Cs",53
42,"42006",152,115,112,2,3,"Cs",19
44,"44165",173,136,135,2,1,"Cs",26
30,"30021",9441,6664,6591,32,73,"Cs",1210
37,"37203",146,113,112,0,1,"Cs",17
1,"1020",320,239,238,1,1,"Cs",0
22,"22226",771,598,591,6,7,"Cs",116
47,"47227",55,46,46,0,0,"Cs",5
8,"8024",357,301,298,1,3,"Cs",15
30,"30022",17056,12158,11954,126,204,"Cs",2346
45,"45174",296,253,250,3,3,"Cs",21
50,"50147",751,564,559,3,5,"Cs",77
13,"13057",1105,934,919,3,15,"Cs",97
49,"49192",124,102,102,2,0,"Cs",11
5,"5244",41,32,32,0,0,"Cs",4
16,"16240",100,77,76,0,1,"Cs",6
34,"34079",1715,1421,1402,10,19,"Cs",274
44,"44167",39,30,30,0,0,"Cs",4
39,"39071",422,318,316,0,2,"Cs",10
8,"8182",2892,2217,2204,18,13,"Cs",308
5,"5051",162,135,131,0,4,"Cs",18
26,"26028",139,120,117,1,3,"Cs",8
22,"22011",97,78,75,2,3,"Cs",14
39,"39062",1841,1511,1500,9,11,"Cs",222
38,"38030",1945,1430,1420,6,10,"Cs",153
44,"44107",205,159,158,0,1,"Cs",20
41,"41093",19012,15637,15525,97,112,"Cs",3425
46,"46204",6657,5262,5204,27,58,"Cs",895
8,"8201",447,327,324,5,3,"Cs",7
39,"39090",772,619,609,1,10,"Cs",103
47,"47041",153,119,116,2,3,"Cs",13
5,"5261",33,26,26,0,0,"Cs",4
19,"19277",16,13,13,0,0,"Cs",1
13,"13060",272,219,214,4,5,"Cs",25
34,"34080",5291,3802,3728,35,74,"Cs",707
14,"14003",1258,989,968,12,21,"Cs",138
40,"40173",142,122,117,1,5,"Cs",32
8,"8121",87292,67638,67328,362,310,"Cs",9054
48,"48029",8613,6697,6642,52,55,"Cs",307
28,"28076",425,354,349,3,5,"Cs",54
22,"22013",275,218,217,6,1,"Cs",33
34,"34143",157,125,120,1,5,"Cs",9
42,"42141",114,89,89,0,0,"Cs",14
8,"8202",12843,10074,10025,57,49,"Cs",775
40,"40196",32,28,28,1,0,"Cs",2
15,"15090",1125,811,800,7,11,"Cs",40
20,"20074",11503,8767,8720,26,47,"Cs",108
6,"6047",837,677,669,6,8,"Cs",85
20,"20024",391,274,274,1,0,"Cs",4
40,"40176",375,325,322,6,3,"Cs",40
42,"42172",28,25,25,1,0,"Cs",1
9,"9432",174,145,137,0,8,"Cs",26
37,"37110",103,84,82,0,2,"Cs",12
2,"2052",466,394,394,3,0,"Cs",30
44,"44118",158,126,122,1,4,"Cs",31
40,"40010",111,95,94,0,1,"Cs",12
23,"23002",17399,13575,13341,97,234,"Cs",2505
33,"33062",388,250,245,9,5,"Cs",28
47,"47063",89,71,71,0,0,"Cs",8
9,"9382",30,24,23,0,1,"Cs",4
21,"21071",211,155,152,3,3,"Cs",26
22,"22246",71,50,50,0,0,"Cs",8
40,"40106",183,153,151,2,2,"Cs",19
44,"44267",71,53,52,0,1,"Cs",18
5,"5056",94,83,83,0,0,"Cs",9
12,"12100",1281,1118,1102,5,16,"Cs",120
42,"42217",34,26,26,0,0,"Cs",2
16,"16160",60,44,43,1,1,"Cs",1
50,"50239",63,47,47,0,0,"Cs",5
44,"44074",444,353,346,3,7,"Cs",50
9,"9384",295,222,216,1,6,"Cs",45
10,"10203",4428,3212,3152,25,60,"Cs",554
49,"49160",43,29,26,0,3,"Cs",2
36,"36045",24478,18627,18327,157,300,"Cs",1602
47,"47076",17721,14605,14438,134,167,"Cs",3336
22,"22015",300,232,226,5,6,"Cs",46
44,"44062",31,24,23,1,1,"Cs",2
8,"8300",5892,4912,4880,24,32,"Cs",639
6,"6127",2809,2285,2258,13,27,"Cs",275
24,"24198",547,402,399,4,3,"Cs",44
18,"18039",3382,2517,2490,20,27,"Cs",466
37,"37015",205,131,130,2,1,"Cs",6
6,"6116",1512,1158,1144,3,14,"Cs",129
13,"13082",25882,17928,17721,101,207,"Cs",3492
23,"23049",1747,1321,1305,11,16,"Cs",161
33,"33044",177352,134444,133352,1391,1092,"Cs",26798
49,"49245",253,183,182,2,1,"Cs",16
47,"47152",68,59,59,0,0,"Cs",3
19,"19036",248,213,210,1,3,"Cs",23
2,"2007",1013,820,813,6,7,"Cs",46
22,"22234",745,587,578,11,9,"Cs",168
22,"22208",194,159,156,1,3,"Cs",27
44,"44152",67,48,48,2,0,"Cs",17
28,"28104",15318,12897,12797,87,100,"Cs",3786
35,"35019",32841,21136,20850,125,286,"Cs",3146
9,"9273",51,46,46,3,0,"Cs",7
32,"32087",1675,1313,1288,18,25,"Cs",93
9,"9093",162,138,137,1,1,"Cs",23
7,"7008",6047,4570,4513,31,57,"Cs",729
44,"44184",38,28,26,0,2,"Cs",12
3,"3066",41802,31046,30696,285,350,"Cs",6640
40,"40015",24,24,24,1,0,"Cs",0
46,"46089",2170,1692,1672,6,20,"Cs",235
8,"8276",233,180,180,0,0,"Cs",6
22,"22209",159,139,136,5,3,"Cs",15
8,"8092",3714,2912,2889,8,23,"Cs",131
47,"47206",78,64,64,0,0,"Cs",7
12,"12031",3942,2976,2931,24,45,"Cs",492
16,"16001",64,51,51,0,0,"Cs",5
34,"34208",47,38,38,0,0,"Cs",11
44,"44077",74,55,54,0,1,"Cs",8
46,"46191",1949,1541,1505,7,36,"Cs",150
2,"2058",313,218,214,1,4,"Cs",22
28,"28011",420,315,311,1,4,"Cs",50
44,"44185",93,73,72,1,1,"Cs",8
28,"28042",1266,1020,1010,2,10,"Cs",177
12,"12021",4377,3528,3473,23,55,"Cs",425
8,"8198",4640,3713,3691,23,22,"Cs",318
8,"8268",971,746,737,3,9,"Cs",52
47,"47133",2776,2317,2292,28,25,"Cs",550
20,"20061",4392,3278,3264,11,14,"Cs",34
16,"16112",1468,1108,1096,6,12,"Cs",91
42,"42181",391,319,317,0,2,"Cs",33
19,"19199",19,17,16,0,1,"Cs",0
50,"50067",13788,10562,10413,107,149,"Cs",2094
24,"24107",214,170,170,2,0,"Cs",14
44,"44207",130,101,101,1,0,"Cs",15
41,"41055",14804,10863,10720,79,143,"Cs",1615
29,"29009",1441,1097,1073,8,24,"Cs",98
9,"9425",476,366,362,1,4,"Cs",34
22,"22020",119,91,87,1,4,"Cs",21
19,"19021",976,744,724,5,20,"Cs",141
41,"41075",10279,7543,7370,96,173,"Cs",966
19,"19054",167,144,141,2,3,"Cs",12
21,"21078",2646,1926,1895,14,31,"Cs",236
6,"6022",2634,2156,2112,7,44,"Cs",290
33,"33048",136,87,87,1,0,"Cs",6
12,"12133",60,53,52,1,1,"Cs",10
9,"9173",129,102,102,0,0,"Cs",16
49,"49167",179,140,136,2,4,"Cs",17
8,"8235",3829,3176,3167,14,9,"Cs",199
37,"37169",176,138,137,1,1,"Cs",20
47,"47114",3911,2864,2807,28,57,"Cs",541
11,"11012",97629,73036,72347,715,689,"Cs",12383
22,"22909",301,233,231,4,2,"Cs",26
16,"16188",77,56,56,0,0,"Cs",6
42,"42167",236,183,182,3,1,"Cs",46
45,"45084",2121,1708,1676,16,32,"Cs",202
34,"34243",320,260,258,1,2,"Cs",27
28,"28086",5390,3992,3936,26,56,"Cs",862
9,"9246",609,449,441,2,8,"Cs",74
36,"36051",14315,10396,10223,70,173,"Cs",1195
37,"37107",10483,7732,7633,78,99,"Cs",1561
40,"40078",151,123,122,2,1,"Cs",15
23,"23011",2134,1649,1614,11,35,"Cs",218
14,"14074",2237,1859,1839,8,20,"Cs",214
8,"8035",12871,9574,9538,31,36,"Cs",931
8,"8044",4136,3193,3175,11,18,"Cs",333
9,"9340",76,56,56,1,0,"Cs",11
35,"35024",14243,9496,9394,65,102,"Cs",1487
44,"44096",153,120,112,1,8,"Cs",4
7,"7036",27950,20870,20707,154,163,"Cs",4807
32,"32064",480,348,346,2,2,"Cs",44
42,"42023",60,49,48,0,1,"Cs",1
40,"40089",214,176,170,1,6,"Cs",29
16,"16276",21,18,18,1,0,"Cs",0
34,"34037",276,224,223,2,1,"Cs",42
33,"33010",1724,1211,1202,15,9,"Cs",176
8,"8214",6966,5648,5633,21,15,"Cs",468
39,"39083",1074,786,777,4,9,"Cs",55
18,"18015",425,333,333,0,0,"Cs",22
9,"9230",33,28,28,0,0,"Cs",2
50,"50141",109,90,90,1,0,"Cs",8
34,"34113",40,37,37,0,0,"Cs",5
36,"36902",5052,3813,3724,21,89,"Cs",236
11,"11040",398,348,342,4,6,"Cs",49
2,"2064",374,318,315,3,3,"Cs",47
12,"12108",438,382,379,4,3,"Cs",45
48,"48061",799,636,636,2,0,"Cs",17
10,"10214",217,175,175,1,0,"Cs",17
37,"37147",172,130,127,3,3,"Cs",22
9,"9178",40,27,27,0,0,"Cs",5
44,"44203",9,9,9,0,0,"Cs",1
9,"9288",88,73,71,1,2,"Cs",12
26,"26044",51,44,42,0,2,"Cs",4
13,"13094",290,227,227,1,0,"Cs",40
19,"19011",236,181,181,0,0,"Cs",24
13,"13080",321,246,246,1,0,"Cs",13
23,"23093",3131,2428,2380,22,48,"Cs",239
8,"8195",76,69,69,0,0,"Cs",1
45,"45013",1671,1320,1298,4,22,"Cs",138
6,"6027",645,572,568,0,4,"Cs",66
34,"34056",1949,1537,1511,7,26,"Cs",223
1,"1044",231,171,166,0,5,"Cs",1
10,"10053",279,226,224,5,2,"Cs",9
19,"19081",27,19,19,0,0,"Cs",2
44,"44172",295,220,218,4,2,"Cs",21
3,"3013",1070,882,869,3,13,"Cs",125
49,"49110",345,222,220,2,2,"Cs",25
44,"44002",46,42,42,0,0,"Cs",3
50,"50133",100,82,82,2,0,"Cs",7
48,"48033",204,160,159,1,1,"Cs",0
49,"49134",166,111,111,2,0,"Cs",22
28,"28080",49801,41938,41705,248,233,"Cs",10755
16,"16194",220,181,173,1,8,"Cs",12
9,"9437",270,227,224,2,3,"Cs",35
48,"48002",7777,6034,5981,48,53,"Cs",91
26,"26034",612,509,497,5,12,"Cs",65
22,"22184",168,142,139,2,3,"Cs",19
13,"13052",6313,4844,4762,38,82,"Cs",590
28,"28070",113,94,94,2,0,"Cs",16
10,"10137",404,346,344,3,2,"Cs",55
38,"38006",41302,23632,23415,133,217,"Cs",3287
40,"40132",46,32,31,1,1,"Cs",3
44,"44052",74,50,49,0,1,"Cs",7
47,"47173",885,708,704,7,4,"Cs",114
9,"9294",102,86,85,0,1,"Cs",17
9,"9256",333,260,256,2,4,"Cs",33
26,"26072",285,252,247,1,5,"Cs",19
45,"45186",2945,2319,2280,11,39,"Cs",270
45,"45032",444,319,313,2,6,"Cs",46
19,"19268",43,42,42,0,0,"Cs",7
11,"11902",3656,2427,2383,29,44,"Cs",374
49,"49261",1505,1168,1149,8,19,"Cs",184
20,"20069",147441,111102,110598,762,504,"Cs",5085
47,"47047",202,164,161,3,3,"Cs",25
28,"28126",47,35,35,0,0,"Cs",2
33,"33036",11335,8356,8243,92,113,"Cs",1198
37,"37303",181,137,137,1,0,"Cs",34
49,"49113",166,139,139,1,0,"Cs",24
33,"33026",8270,5540,5474,69,66,"Cs",867
10,"10057",126,97,96,2,1,"Cs",8
41,"41045",5854,4287,4200,58,87,"Cs",640
9,"9223",43,39,39,1,0,"Cs",12
24,"24216",671,504,502,3,2,"Cs",71
29,"29059",2643,2086,2042,8,44,"Cs",202
45,"45111",53,43,41,0,2,"Cs",3
45,"45156",3338,2805,2750,9,55,"Cs",462
23,"23085",2182,1733,1717,7,16,"Cs",191
26,"26049",153,115,115,1,0,"Cs",13
33,"33060",14132,9960,9794,135,166,"Cs",938
19,"19020",46,35,34,1,1,"Cs",5
34,"34061",96,77,77,2,0,"Cs",5
40,"40052",72,56,56,0,0,"Cs",10
33,"33027",769,505,497,14,8,"Cs",37
48,"48066",347,291,291,0,0,"Cs",3
5,"5141",95,82,82,0,0,"Cs",15
8,"8234",3373,2742,2734,25,8,"Cs",253
41,"41049",9493,7463,7312,78,151,"Cs",996
5,"5253",78,62,60,0,2,"Cs",12
8,"8260",18400,14471,14406,87,65,"Cs",2191
37,"37089",62,51,50,0,1,"Cs",9
26,"26142",784,651,641,5,10,"Cs",77
5,"5168",3500,2774,2730,25,44,"Cs",435
33,"33059",4403,3007,2942,42,65,"Cs",316
1,"1008",802,576,570,3,6,"Cs",24
47,"47050",3898,3084,3047,36,37,"Cs",714
10,"10904",722,549,543,7,6,"Cs",101
5,"5904",112,81,81,3,0,"Cs",11
19,"19022",571,443,434,7,9,"Cs",79
37,"37344",235,171,168,1,3,"Cs",38
14,"14072",999,763,754,4,9,"Cs",116
9,"9034",292,239,238,2,1,"Cs",53
2,"2073",4844,3828,3772,28,56,"Cs",559
4,"4100",9266,6046,5988,49,58,"Cs",1188
29,"29096",2756,2061,2018,21,43,"Cs",251
9,"9433",58,51,50,1,1,"Cs",7
34,"34063",87,77,77,1,0,"Cs",16
19,"19265",135,107,107,1,0,"Cs",10
18,"18162",929,730,719,4,11,"Cs",60
22,"22243",39,28,28,0,0,"Cs",11
44,"44116",76,62,62,0,0,"Cs",28
40,"40195",813,630,623,5,7,"Cs",98
9,"9414",181,148,146,0,2,"Cs",36
46,"46154",797,645,630,1,15,"Cs",122
46,"46245",528,430,426,2,4,"Cs",63
5,"5234",46,43,43,0,0,"Cs",5
8,"8219",15629,12910,12865,58,45,"Cs",1225
16,"16224",77,61,60,1,1,"Cs",6
46,"46250",581614,454786,451184,2675,3602,"Cs",84956
16,"16130",536,445,444,0,1,"Cs",43
5,"5158",345,279,274,2,5,"Cs",31
37,"37346",252,214,213,3,1,"Cs",25
40,"40035",135,111,110,0,1,"Cs",26
49,"49174",130,93,91,0,2,"Cs",15
49,"49228",55,47,47,0,0,"Cs",6
13,"13091",544,485,476,4,9,"Cs",32
44,"44182",198,172,171,2,1,"Cs",38
4,"4086",1643,1226,1209,6,17,"Cs",148
22,"22229",108,80,80,2,0,"Cs",17
8,"8002",220,184,183,2,1,"Cs",4
8,"8281",4840,4009,3998,23,11,"Cs",375
5,"5132",881,634,626,2,8,"Cs",93
28,"28056",914,715,703,4,12,"Cs",101
13,"13062",559,478,471,1,7,"Cs",58
34,"34146",53,47,46,0,1,"Cs",7
22,"22076",288,228,226,1,2,"Cs",32
46,"46247",961,695,687,3,8,"Cs",112
3,"3072",348,297,295,2,2,"Cs",40
37,"37196",72,56,53,0,3,"Cs",6
27,"27023",2470,1833,1797,20,36,"Cs",98
8,"8054",9155,7468,7428,43,40,"Cs",972
23,"23037",520,431,425,6,6,"Cs",35
16,"16192",43,30,29,0,1,"Cs",1
12,"12099",586,449,434,3,15,"Cs",50
45,"45202",3982,3094,3055,8,39,"Cs",524
50,"50229",65,57,56,0,1,"Cs",5
4,"4019",232,181,179,0,2,"Cs",15
26,"26108",290,241,237,0,4,"Cs",41
24,"24101",384,285,283,4,2,"Cs",32
42,"42202",20,12,11,0,1,"Cs",0
28,"28018",4068,3367,3344,15,23,"Cs",614
41,"41023",7975,5918,5812,51,106,"Cs",842
49,"49026",201,163,162,0,1,"Cs",21
8,"8230",7666,6202,6168,30,34,"Cs",855
10,"10122",220,171,164,0,7,"Cs",19
28,"28155",485,414,409,0,5,"Cs",59
9,"9164",150,116,114,0,2,"Cs",29
4,"4029",8819,6149,6073,45,76,"Cs",762
22,"22168",23,21,20,0,1,"Cs",5
45,"45077",562,442,437,0,5,"Cs",73
7,"7039",4970,3557,3489,36,68,"Cs",551
16,"16266",358,281,279,3,2,"Cs",31
16,"16141",130,105,105,0,0,"Cs",23
10,"10195",7557,5790,5691,38,99,"Cs",995
38,"38025",7088,5166,5089,39,77,"Cs",734
22,"22150",461,368,362,1,6,"Cs",62
8,"8136",11614,9159,9079,84,80,"Cs",1397
21,"21037",459,363,357,4,6,"Cs",47
47,"47161",3945,3370,3344,20,26,"Cs",723
40,"40131",50,47,47,0,0,"Cs",17
18,"18029",1813,1183,1169,9,14,"Cs",211
37,"37328",164,127,127,4,0,"Cs",9
36,"36046",4043,3157,3084,27,73,"Cs",357
45,"45169",186,135,134,0,1,"Cs",17
3,"3107",2769,2011,1986,10,25,"Cs",348
16,"16181",57,46,46,1,0,"Cs",2
40,"40037",34,19,19,0,0,"Cs",3
49,"49150",123,90,90,3,0,"Cs",13
44,"44216",26922,20603,20279,204,324,"Cs",4889
9,"9201",28,20,19,0,1,"Cs",3
42,"42192",38,26,26,1,0,"Cs",4
45,"45170",199,154,150,1,4,"Cs",34
45,"45017",260,218,213,1,5,"Cs",23
49,"49222",370,284,282,2,2,"Cs",32
8,"8028",1088,783,780,2,3,"Cs",96
39,"39031",1245,990,983,5,7,"Cs",171
45,"45176",3841,2992,2952,16,40,"Cs",730
45,"45155",319,261,253,1,8,"Cs",26
45,"45110",1697,1339,1326,11,13,"Cs",108
19,"19134",30,24,24,0,0,"Cs",5
23,"23088",6020,4779,4703,56,76,"Cs",489
40,"40218",84,62,62,0,0,"Cs",14
48,"48096",6510,5247,5185,36,62,"Cs",96
28,"28055",907,671,666,5,5,"Cs",108
36,"36041",13621,10098,9939,97,159,"Cs",1320
3,"3098",518,412,400,1,12,"Cs",47
38,"38051",7326,5418,5352,27,66,"Cs",701
32,"32088",1610,1040,1019,11,21,"Cs",87
33,"33050",558,381,375,2,6,"Cs",41
50,"50245",76,58,58,0,0,"Cs",15
12,"12043",560,460,450,2,10,"Cs",51
22,"22907",1444,1149,1137,12,12,"Cs",216
49,"49126",273,161,160,1,1,"Cs",15
9,"9348",133,105,104,0,1,"Cs",11
32,"32014",1045,775,769,5,6,"Cs",43
28,"28022",36550,31559,31436,207,123,"Cs",8824
2,"2055",1057,770,755,6,15,"Cs",74
5,"5062",166,136,133,0,3,"Cs",28
3,"3128",4295,3007,2982,24,25,"Cs",558
4,"4001",1014,768,763,9,5,"Cs",131
16,"16239",118,89,88,0,1,"Cs",10
11,"11011",1736,1285,1249,7,36,"Cs",223
47,"47218",979,757,745,5,12,"Cs",115
40,"40029",24,21,21,0,0,"Cs",3
12,"12033",1951,1528,1506,10,22,"Cs",235
32,"32071",1378,963,954,7,9,"Cs",39
48,"48077",3376,2656,2647,11,9,"Cs",54
9,"9901",340,256,255,1,1,"Cs",63
26,"26027",143,101,98,1,3,"Cs",11
18,"18067",681,511,507,3,4,"Cs",63
47,"47091",74,64,63,1,1,"Cs",8
28,"28024",168,146,145,1,1,"Cs",22
44,"44228",99,83,83,0,0,"Cs",11
49,"49154",109,64,63,0,1,"Cs",7
29,"29058",1538,1079,1062,5,17,"Cs",230
32,"32056",1520,1125,1116,6,9,"Cs",79
36,"36044",2539,1768,1708,18,60,"Cs",198
49,"49243",109,86,83,0,3,"Cs",23
29,"29066",346,266,266,2,0,"Cs",38
12,"12056",257,218,216,1,2,"Cs",26
48,"48052",1567,1309,1300,4,9,"Cs",8
45,"45045",1331,1001,990,2,11,"Cs",133
49,"49079",103,91,79,1,12,"Cs",13
13,"13020",4729,3461,3416,34,45,"Cs",557
50,"50181",1000,770,754,7,16,"Cs",120
7,"7002",6612,4721,4672,43,49,"Cs",674
42,"42174",179,132,128,1,4,"Cs",22
42,"42061",272,207,204,2,3,"Cs",42
40,"40086",660,570,548,3,22,"Cs",99
45,"45199",3107,2221,2184,8,37,"Cs",426
5,"5182",731,494,490,6,4,"Cs",69
33,"33030",873,678,671,1,7,"Cs",95
29,"29087",371,266,263,2,3,"Cs",22
47,"47165",6822,5456,5296,62,160,"Cs",1122
26,"26070",155,133,132,0,1,"Cs",10
46,"46229",911,755,752,5,3,"Cs",67
26,"26154",10,10,10,1,0,"Cs",2
47,"47192",94,82,81,2,1,"Cs",5
44,"44145",972,741,732,11,9,"Cs",122
44,"44012",310,240,238,5,2,"Cs",39
5,"5172",116,95,93,0,2,"Cs",21
34,"34231",217,184,178,0,6,"Cs",26
35,"35025",1773,1247,1235,9,12,"Cs",192
5,"5184",240,207,204,1,3,"Cs",19
46,"46004",1919,1641,1616,14,25,"Cs",274
10,"10065",200,149,149,0,0,"Cs",11
28,"28047",42847,33561,33215,216,346,"Cs",7193
46,"46065",1576,1246,1228,6,18,"Cs",220
40,"40045",120,92,92,1,0,"Cs",17
10,"10120",156,110,108,0,2,"Cs",13
44,"44138",118,90,89,2,1,"Cs",14
44,"44131",27,22,22,0,0,"Cs",1
26,"26068",79,62,62,1,0,"Cs",12
36,"36036",2556,1953,1914,14,39,"Cs",130
26,"26047",1879,1569,1549,10,20,"Cs",148
9,"9238",941,573,567,8,6,"Cs",72
19,"19017",57,50,49,0,1,"Cs",7
23,"23058",8817,6964,6873,48,91,"Cs",1039
42,"42113",521,382,380,3,2,"Cs",63
28,"28165",1910,1443,1430,11,13,"Cs",265
10,"10170",239,180,179,1,1,"Cs",25
16,"16022",78,70,70,0,0,"Cs",11
22,"22906",174,137,134,5,3,"Cs",19
45,"45055",998,844,828,4,16,"Cs",84
32,"32011",918,526,521,6,5,"Cs",20
19,"19007",435,328,319,1,9,"Cs",43
10,"10148",32986,23987,23589,201,398,"Cs",4564
37,"37258",137,99,98,1,1,"Cs",23
22,"22007",756,576,571,5,5,"Cs",120
29,"29023",2290,1569,1550,3,19,"Cs",354
13,"13025",296,260,256,1,4,"Cs",19
42,"42052",17,15,15,0,0,"Cs",0
35,"35002",24129,16979,16736,116,243,"Cs",2694
49,"49165",55,53,50,0,3,"Cs",5
2,"2047",107,89,88,1,1,"Cs",4
44,"44213",65,46,46,0,0,"Cs",12
33,"33037",33247,23529,23210,297,319,"Cs",2744
26,"26082",100,85,85,0,0,"Cs",6
47,"47224",97,74,74,0,0,"Cs",13
44,"44111",78,64,64,1,0,"Cs",8
27,"27037",1017,759,748,10,11,"Cs",22
10,"10177",1695,1358,1323,9,35,"Cs",317
37,"37226",150,119,119,2,0,"Cs",15
23,"23060",19153,14444,14281,87,163,"Cs",2520
34,"34236",147,111,111,0,0,"Cs",16
19,"19133",81,70,70,0,0,"Cs",11
21,"21001",610,480,461,3,19,"Cs",43
16,"16051",126,102,100,0,2,"Cs",2
36,"36004",10123,7396,7273,93,123,"Cs",714
42,"42116",42,30,30,1,0,"Cs",2
36,"36020",2184,1621,1599,13,22,"Cs",126
8,"8232",1786,1444,1434,9,10,"Cs",56
50,"50055",3627,2627,2571,41,56,"Cs",545
47,"47087",368,292,288,3,4,"Cs",46
36,"36043",4682,3345,3303,17,42,"Cs",324
40,"40177",140,114,113,1,1,"Cs",11
32,"32059",1703,1248,1228,12,20,"Cs",61
44,"44163",114,92,92,0,0,"Cs",13
30,"30010",6857,5533,5457,38,76,"Cs",876
10,"10175",1361,1031,997,8,34,"Cs",123
26,"26170",427,343,338,2,5,"Cs",53
9,"9122",88,64,64,0,0,"Cs",8
5,"5029",99,69,69,0,0,"Cs",7
49,"49266",70,51,49,2,2,"Cs",10
30,"30027",49767,39111,38724,245,387,"Cs",8506
48,"48008",615,454,448,4,6,"Cs",4
28,"28048",504,399,392,6,7,"Cs",49
26,"26092",109,84,82,1,2,"Cs",13
47,"47051",321,274,272,1,2,"Cs",53
11,"11002",4200,3287,3257,5,30,"Cs",131
48,"48069",13094,10021,9954,49,67,"Cs",264
37,"37002",126,81,81,0,0,"Cs",19
13,"13035",955,739,720,6,19,"Cs",71
5,"5227",340,237,234,0,3,"Cs",33
12,"12065",171,150,147,0,3,"Cs",12
13,"13066",2604,2182,2146,6,36,"Cs",212
38,"38008",5658,4126,4056,19,70,"Cs",528
16,"16068",127,104,104,4,0,"Cs",10
10,"10160",237,189,183,3,6,"Cs",19
37,"37260",139,109,109,0,0,"Cs",14
42,"42031",26,19,19,1,0,"Cs",4
44,"44105",69,54,54,1,0,"Cs",5
9,"9411",154,118,118,0,0,"Cs",12
42,"42119",145,90,89,6,1,"Cs",13
26,"26039",38,34,34,0,0,"Cs",1
16,"16202",741,573,568,4,5,"Cs",90
40,"40216",774,670,665,11,5,"Cs",169
24,"24205",981,744,732,8,12,"Cs",148
47,"47135",82,69,67,1,2,"Cs",16
9,"9277",107,92,89,0,3,"Cs",12
50,"50144",31,26,25,0,1,"Cs",2
45,"45160",1095,913,905,2,8,"Cs",158
44,"44033",244,174,172,0,2,"Cs",24
39,"39095",2240,1809,1778,12,31,"Cs",216
22,"22006",272,206,201,2,5,"Cs",29
22,"22122",65,58,58,3,0,"Cs",11
22,"22131",83,65,65,0,0,"Cs",21
37,"37124",196,153,153,2,0,"Cs",26
50,"50294",64,49,47,0,2,"Cs",10
33,"33042",4243,3137,3103,36,34,"Cs",620
5,"5265",79,59,59,0,0,"Cs",13
15,"15093",4048,2761,2720,41,41,"Cs",209
9,"9413",408,313,310,2,3,"Cs",53
37,"37338",78,66,64,0,2,"Cs",5
41,"41038",102179,76348,75425,819,923,"Cs",13944
48,"48905",2490,1911,1891,16,20,"Cs",23
37,"37234",317,224,222,1,2,"Cs",41
37,"37078",788,670,658,6,12,"Cs",117
8,"8095",67,53,52,0,1,"Cs",2
46,"46186",19529,15294,15125,69,169,"Cs",2920
8,"8192",5679,4605,4589,20,16,"Cs",301
9,"9009",158,139,137,4,2,"Cs",37
22,"22251",334,269,263,4,6,"Cs",70
46,"46060",9287,7184,7110,40,74,"Cs",1176
26,"26009",391,317,314,2,3,"Cs",30
42,"42182",51,42,42,1,0,"Cs",4
24,"24130",418,331,326,0,5,"Cs",57
42,"42039",210,147,141,2,6,"Cs",14
42,"42053",21,15,15,0,0,"Cs",0
49,"49015",201,157,155,0,2,"Cs",14
45,"45196",1387,1099,1084,6,15,"Cs",179
28,"28016",78,62,61,1,1,"Cs",9
9,"9326",154,129,127,4,2,"Cs",32
5,"5196",57,45,42,0,3,"Cs",6
44,"44149",100,74,73,0,1,"Cs",14
6,"6158",13362,10282,10112,73,170,"Cs",2092
9,"9070",33,28,25,0,3,"Cs",5
26,"26043",349,272,268,2,4,"Cs",44
1,"1013",703,491,487,2,4,"Cs",5
22,"22129",163,117,116,0,1,"Cs",16
50,"50048",33,25,25,0,0,"Cs",1
15,"15043",4978,3631,3572,39,59,"Cs",326
42,"42008",56,41,41,0,0,"Cs",1
45,"45151",546,434,431,0,3,"Cs",46
42,"42025",1134,824,813,6,11,"Cs",143
46,"46256",7211,5263,5209,27,54,"Cs",869
9,"9280",27,22,22,0,0,"Cs",2
12,"12128",1362,1099,1076,9,23,"Cs",170
9,"9108",432,332,326,1,6,"Cs",67
5,"5134",49,41,40,0,1,"Cs",3
22,"22253",57,48,47,0,1,"Cs",11
18,"18013",4152,3168,3103,16,65,"Cs",520
48,"48072",970,735,730,1,5,"Cs",1
42,"42107",67,48,48,0,0,"Cs",3
40,"40093",76,68,67,0,1,"Cs",17
10,"10212",1645,1283,1238,7,45,"Cs",136
4,"4045",1704,1355,1326,12,29,"Cs",147
20,"20068",188,142,142,1,0,"Cs",0
40,"40902",117,96,96,1,0,"Cs",8
5,"5046",39,37,37,0,0,"Cs",2
5,"5174",65,53,52,1,1,"Cs",6
24,"24025",289,234,226,4,8,"Cs",35
50,"50185",136,103,102,0,1,"Cs",13
16,"16055",679,478,477,4,1,"Cs",83
44,"44036",23,20,20,0,0,"Cs",1
9,"9172",168,132,132,1,0,"Cs",16
24,"24162",1772,1382,1369,22,13,"Cs",253
45,"45097",1044,901,890,4,11,"Cs",146
28,"28009",14500,11656,11564,62,92,"Cs",2905
45,"45145",2613,1950,1921,13,29,"Cs",414
47,"47137",31,23,23,0,0,"Cs",0
44,"44084",55,45,45,0,0,"Cs",9
50,"50025",4516,3417,3364,35,53,"Cs",799
33,"33004",65515,48686,48245,511,441,"Cs",7961
37,"37312",244,198,197,1,1,"Cs",24
28,"28157",682,530,516,1,14,"Cs",85
10,"10205",1965,1344,1300,8,44,"Cs",148
19,"19225",851,664,650,3,14,"Cs",147
44,"44143",394,327,327,2,0,"Cs",48
9,"9421",242,197,196,2,1,"Cs",39
40,"40201",43,39,37,0,2,"Cs",7
42,"42135",70,46,45,0,1,"Cs",6
28,"28145",2640,2014,1987,11,27,"Cs",413
46,"46189",473,412,408,2,4,"Cs",62
40,"40033",67,57,57,1,0,"Cs",10
9,"9215",365,267,264,1,3,"Cs",46
28,"28120",1209,991,974,3,17,"Cs",196
5,"5206",29,21,20,1,1,"Cs",3
44,"44193",69,57,56,1,1,"Cs",8
15,"15072",9436,6962,6860,60,102,"Cs",572
13,"13050",479,399,394,2,5,"Cs",55
9,"9303",75,67,67,0,0,"Cs",11
13,"13095",72,60,60,1,0,"Cs",3
11,"11026",4695,3656,3564,18,92,"Cs",705
50,"50277",49,37,37,3,0,"Cs",0
20,"20073",4698,3530,3515,29,15,"Cs",55
16,"16228",176,150,150,1,0,"Cs",22
9,"9041",26,26,26,1,0,"Cs",5
44,"44262",143,115,112,0,3,"Cs",35
2,"2025",7355,5864,5693,30,171,"Cs",1159
35,"35016",300503,203470,201240,1598,2230,"Cs",34051
46,"46255",3209,2415,2381,18,34,"Cs",323
1,"1014",366,283,277,7,6,"Cs",14
20,"20030",21198,15734,15654,100,80,"Cs",317
38,"38018",4455,3242,3198,24,44,"Cs",363
24,"24213",170,140,139,0,1,"Cs",13
40,"40107",92,76,74,0,2,"Cs",11
42,"42068",78,62,61,2,1,"Cs",6
40,"40146",238,205,202,0,3,"Cs",38
50,"50209",2747,1993,1975,29,18,"Cs",407
9,"9405",129,99,97,1,2,"Cs",11
37,"37224",189,168,165,0,3,"Cs",7
18,"18106",415,300,295,0,5,"Cs",38
8,"8124",37130,29069,28915,146,154,"Cs",3736
21,"21045",227,181,178,1,3,"Cs",19
19,"19172",50,35,35,1,0,"Cs",6
44,"44094",123,112,112,0,0,"Cs",21
33,"33038",2234,1669,1644,16,25,"Cs",220
16,"16128",51,44,44,0,0,"Cs",12
6,"6143",3370,2635,2589,23,46,"Cs",363
50,"50266",121,85,80,0,5,"Cs",8
42,"42211",81,74,73,2,1,"Cs",14
40,"40047",32,25,25,0,0,"Cs",4
5,"5024",198,142,139,2,3,"Cs",16
10,"10191",523,406,398,3,8,"Cs",56
29,"29074",781,606,597,2,9,"Cs",112
40,"40151",43,32,32,0,0,"Cs",3
22,"22133",108,85,83,1,2,"Cs",14
7,"7004",4033,2898,2860,28,38,"Cs",345
41,"41022",4269,3158,3110,16,48,"Cs",362
50,"50054",56,48,47,0,1,"Cs",13
9,"9088",64,42,42,4,0,"Cs",7
46,"46022",15325,11197,11072,70,125,"Cs",1863
33,"33017",2997,2096,2058,29,38,"Cs",206
16,"16129",90,78,77,0,1,"Cs",11
37,"37352",201,159,158,0,1,"Cs",36
37,"37034",75,66,66,0,0,"Cs",6
20,"20906",130,99,98,1,1,"Cs",1
44,"44137",188,148,146,0,2,"Cs",31
16,"16107",98,76,75,1,1,"Cs",8
29,"29055",1880,1493,1470,15,23,"Cs",196
39,"39039",546,431,428,0,3,"Cs",36
22,"22904",761,581,566,2,15,"Cs",105
10,"10106",127,108,106,0,2,"Cs",18
46,"46034",1811,1407,1389,13,18,"Cs",232
37,"37045",28,19,18,0,1,"Cs",6
8,"8006",11774,9039,8981,33,58,"Cs",732
28,"28008",1961,1477,1456,6,21,"Cs",269
9,"9232",140,110,107,0,3,"Cs",14
37,"37179",196,172,169,0,3,"Cs",17
44,"44120",219,158,152,1,6,"Cs",30
9,"9244",45,35,35,0,0,"Cs",3
47,"47213",108,84,84,0,0,"Cs",11
37,"37011",99,75,73,0,2,"Cs",14
18,"18083",228,189,188,1,1,"Cs",20
35,"35012",10765,6327,6270,32,57,"Cs",971
46,"46068",345,308,307,4,1,"Cs",52
45,"45078",1328,1152,1133,6,19,"Cs",97
41,"41098",5152,4046,3986,24,60,"Cs",518
36,"36014",1872,1373,1345,14,28,"Cs",68
35,"35022",51302,33009,32566,198,443,"Cs",4713
45,"45143",1190,940,925,3,15,"Cs",92
21,"21005",15697,9910,9778,72,132,"Cs",1430
49,"49133",291,213,211,0,2,"Cs",35
42,"42140",14,13,12,0,1,"Cs",0
46,"46157",2960,2329,2296,12,33,"Cs",340
13,"13049",747,566,553,4,13,"Cs",53
16,"16009",54,49,49,0,0,"Cs",6
9,"9380",73,53,53,0,0,"Cs",9
19,"19031",10,8,8,0,0,"Cs",2
46,"46041",327,251,250,2,1,"Cs",32
12,"12008",224,197,194,1,3,"Cs",13
50,"50270",38,32,30,1,2,"Cs",3
11,"11001",4342,2928,2870,32,58,"Cs",415
16,"16227",108,85,85,1,0,"Cs",9
16,"16253",308,250,249,2,1,"Cs",18
19,"19013",114,99,99,0,0,"Cs",6
49,"49208",364,260,255,5,5,"Cs",47
45,"45166",1564,1298,1279,6,19,"Cs",190
2,"2078",899,705,691,3,14,"Cs",62
39,"39093",302,256,256,2,0,"Cs",31
20,"20901",1412,1034,1030,2,4,"Cs",9
10,"10010",2213,1499,1470,6,29,"Cs",204
9,"9259",227,198,197,2,1,"Cs",23
16,"16905",1278,1028,1012,11,16,"Cs",178
7,"7022",11615,8055,7934,91,121,"Cs",1077
50,"50014",119,85,85,0,0,"Cs",22
45,"45121",7273,5362,5291,27,71,"Cs",1001
23,"23094",3729,3111,3077,16,34,"Cs",287
50,"50083",84,70,68,0,2,"Cs",7
4,"4027",226,147,147,1,0,"Cs",29
9,"9478",45,40,40,0,0,"Cs",2
49,"49265",120,93,92,1,1,"Cs",11
24,"24181",1414,1067,1055,14,12,"Cs",137
6,"6088",12505,9311,9140,93,171,"Cs",1752
48,"48030",601,490,489,0,1,"Cs",0
7,"7014",7778,4724,4669,50,55,"Cs",681
5,"5067",74,61,60,0,1,"Cs",15
10,"10156",100,78,78,0,0,"Cs",5
9,"9283",44,33,33,0,0,"Cs",4
27,"27057",11097,7917,7735,88,182,"Cs",785
23,"23054",376,296,289,1,7,"Cs",20
16,"16173",190,141,141,0,0,"Cs",7
23,"23012",4018,2835,2804,15,31,"Cs",381
26,"26063",118,96,95,2,1,"Cs",12
20,"20072",4752,3445,3412,24,33,"Cs",99
9,"9381",33,25,25,0,0,"Cs",3
16,"16132",34,26,26,0,0,"Cs",2
29,"29002",1150,851,842,4,9,"Cs",104
28,"28020",169,110,109,0,1,"Cs",16
15,"15088",3415,2349,2323,28,26,"Cs",220
5,"5093",353,275,269,0,6,"Cs",37
24,"24227",1548,1148,1128,5,20,"Cs",235
10,"10142",840,641,639,5,2,"Cs",79
37,"37096",203,162,160,1,2,"Cs",29
37,"37208",69,52,51,0,1,"Cs",2
8,"8284",12482,8959,8887,41,72,"Cs",993
41,"41902",4600,3141,3092,48,49,"Cs",413
48,"48910",2802,2082,2073,3,9,"Cs",54
46,"46054",11390,8717,8604,52,113,"Cs",1471
39,"39092",871,635,629,2,6,"Cs",41
18,"18168",781,613,604,6,9,"Cs",190
24,"24032",102,84,83,0,1,"Cs",10
5,"5247",227,182,177,1,5,"Cs",33
3,"3075",149,125,125,0,0,"Cs",39
39,"39027",3066,2511,2467,15,44,"Cs",328
25,"25234",4201,3087,3072,13,15,"Cs",212
43,"43165",572,492,492,1,0,"Cs",17
43,"43116",463,381,379,2,2,"Cs",14
25,"25040",10614,7791,7734,58,57,"Cs",646
17,"17211",831,694,691,1,3,"Cs",31
43,"43094",2120,1659,1646,9,13,"Cs",91
25,"25176",307,262,259,1,3,"Cs",14
17,"17006",1186,880,878,10,2,"Cs",64
25,"25210",1079,867,853,4,14,"Cs",38
43,"43012",3647,3028,3019,15,9,"Cs",360
25,"25204",1191,936,930,5,6,"Cs",58
17,"17044",6930,5514,5493,26,21,"Cs",288
25,"25143",84,72,71,0,1,"Cs",4
43,"43903",2333,1717,1700,11,17,"Cs",117
17,"17058",170,139,139,0,0,"Cs",5
17,"17225",207,161,161,0,0,"Cs",11
43,"43072",93,74,74,0,0,"Cs",8
43,"43051",9092,6577,6502,26,75,"Cs",1158
43,"43004",6274,4744,4691,39,53,"Cs",308
25,"25085",141,118,117,2,1,"Cs",14
25,"25037",366,286,284,3,2,"Cs",10
25,"25156",784,608,605,4,3,"Cs",38
17,"17173",182,156,156,0,0,"Cs",5
43,"43134",273,224,223,5,1,"Cs",19
17,"17157",124,107,107,0,0,"Cs",4
25,"25167",226,185,185,2,0,"Cs",7
17,"17172",457,352,349,1,3,"Cs",9
17,"17054",347,271,271,0,0,"Cs",25
25,"25182",1043,842,839,9,3,"Cs",58
17,"17134",223,189,189,1,0,"Cs",3
25,"25910",91,70,67,2,3,"Cs",1
43,"43099",286,234,234,0,0,"Cs",7
25,"25102",661,517,511,8,6,"Cs",47
43,"43163",26013,18942,18796,89,146,"Cs",2748
43,"43081",633,532,531,7,1,"Cs",21
25,"25044",178,145,144,6,1,"Cs",9
43,"43037",17902,12787,12695,63,92,"Cs",1830
25,"25130",183,142,140,0,2,"Cs",1
25,"25137",8686,6327,6296,46,31,"Cs",506
17,"17101",562,415,413,2,2,"Cs",34
17,"17034",7205,5337,5291,16,46,"Cs",515
25,"25064",98,88,88,0,0,"Cs",2
43,"43130",177,145,145,0,0,"Cs",6
17,"17076",122,101,100,1,1,"Cs",1
17,"17138",845,650,646,0,4,"Cs",53
25,"25218",86,79,79,0,0,"Cs",2
17,"17184",1264,1068,1060,5,8,"Cs",34
17,"17149",364,314,314,0,0,"Cs",3
17,"17207",2411,2006,1992,8,14,"Cs",55
25,"25240",1385,1116,1110,10,6,"Cs",70
43,"43102",463,384,379,2,5,"Cs",7
43,"43125",890,700,698,12,2,"Cs",36
43,"43139",1999,1552,1539,10,13,"Cs",83
25,"25904",162,147,147,3,0,"Cs",8
17,"17088",578,468,468,1,0,"Cs",20
25,"25005",274,202,202,2,0,"Cs",9
43,"43095",2564,1995,1984,14,11,"Cs",304
25,"25038",1482,1111,1094,11,17,"Cs",71
25,"25057",214,162,161,0,1,"Cs",26
17,"17057",968,826,822,1,4,"Cs",30
43,"43007",640,510,509,0,1,"Cs",52
17,"17233",2328,1924,1912,6,12,"Cs",120
25,"25070",811,677,675,4,2,"Cs",36
17,"17062",5978,4358,4334,26,24,"Cs",418
25,"25009",605,505,491,5,14,"Cs",25
43,"43174",144,128,127,0,1,"Cs",7
17,"17069",364,286,284,2,2,"Cs",14
17,"17202",3813,2876,2851,8,25,"Cs",315
17,"17192",146,121,120,0,1,"Cs",7
25,"25216",241,199,199,2,0,"Cs",17
17,"17196",242,198,198,1,0,"Cs",16
25,"25225",541,427,420,4,7,"Cs",12
43,"43056",806,616,613,5,3,"Cs",28
17,"17065",324,254,253,0,1,"Cs",3
43,"43110",251,184,184,1,0,"Cs",10
17,"17158",468,337,336,1,1,"Cs",37
17,"17133",1273,1048,1043,7,5,"Cs",31
25,"25905",369,308,307,1,1,"Cs",17
25,"25093",629,489,487,4,2,"Cs",34
43,"43080",227,195,195,0,0,"Cs",20
25,"25003",3721,2828,2815,19,13,"Cs",197
17,"17035",550,460,460,3,0,"Cs",19
25,"25244",362,296,294,2,2,"Cs",20
25,"25105",103,89,88,1,1,"Cs",7
25,"25138",547,440,436,1,4,"Cs",24
43,"43121",591,463,462,0,1,"Cs",13
43,"43124",472,379,373,1,6,"Cs",25
25,"25035",366,306,302,2,4,"Cs",23
25,"25056",213,163,163,3,0,"Cs",4
43,"43005",3643,2765,2749,22,16,"Cs",286
25,"25165",276,221,219,1,2,"Cs",13
17,"17180",8500,6462,6431,28,31,"Cs",404
17,"17228",285,229,229,1,0,"Cs",16
17,"17146",3127,2404,2381,11,23,"Cs",192
25,"25122",1925,1505,1497,23,8,"Cs",88
17,"17115",278,226,222,2,4,"Cs",14
17,"17214",723,584,580,7,4,"Cs",45
43,"43021",345,270,269,3,1,"Cs",12
25,"25163",236,181,179,3,2,"Cs",9
17,"17014",63,51,50,0,1,"Cs",4
17,"17204",596,461,460,2,1,"Cs",40
17,"17163",2824,2358,2351,13,7,"Cs",91
25,"25243",3730,2637,2606,20,31,"Cs",449
43,"43063",536,401,397,1,4,"Cs",23
17,"17048",6251,4565,4537,20,28,"Cs",620
17,"17100",195,157,154,0,3,"Cs",6
25,"25101",543,454,449,1,5,"Cs",11
17,"17071",1128,978,978,3,0,"Cs",34
17,"17132",1333,1088,1080,9,8,"Cs",78
43,"43062",259,223,220,2,3,"Cs",14
25,"25173",1649,1278,1262,5,16,"Cs",119
25,"25140",773,573,571,5,2,"Cs",27
25,"25170",261,230,228,4,2,"Cs",7
25,"25088",95,85,83,0,2,"Cs",5
17,"17191",166,145,144,2,1,"Cs",3
25,"25086",521,414,411,2,3,"Cs",13
17,"17137",3467,2925,2912,15,13,"Cs",87
17,"17120",820,604,598,3,6,"Cs",59
17,"17082",436,341,339,0,2,"Cs",25
43,"43148",90763,69756,69423,299,333,"Cs",11131
25,"25205",562,451,447,7,4,"Cs",21
17,"17197",131,113,113,1,0,"Cs",12
25,"25174",390,324,324,0,0,"Cs",25
17,"17110",1329,1064,1054,5,10,"Cs",111
43,"43085",235,198,194,0,4,"Cs",12
43,"43020",2276,1831,1819,12,12,"Cs",260
17,"17178",1056,804,798,3,6,"Cs",39
25,"25050",3269,2457,2446,23,11,"Cs",134
17,"17169",2497,2047,2042,8,5,"Cs",195
43,"43047",4209,2878,2856,23,22,"Cs",459
25,"25052",1562,1273,1264,3,9,"Cs",45
17,"17060",408,311,311,1,0,"Cs",26
25,"25193",767,614,606,6,8,"Cs",18
25,"25228",3115,2468,2459,19,9,"Cs",230
43,"43108",1778,1374,1365,6,9,"Cs",125
17,"17002",564,491,488,3,3,"Cs",35
43,"43045",146,128,127,0,1,"Cs",2
17,"17201",143,120,120,0,0,"Cs",4
43,"43097",399,341,341,1,0,"Cs",11
25,"25133",686,528,527,2,1,"Cs",29
25,"25048",1632,1274,1264,7,10,"Cs",81
25,"25007",1392,1089,1083,4,6,"Cs",89
25,"25171",2127,1639,1630,8,9,"Cs",58
17,"17027",2866,2375,2364,8,11,"Cs",107
25,"25128",127,87,87,0,0,"Cs",4
25,"25043",801,613,606,1,7,"Cs",17
17,"17028",297,238,237,1,1,"Cs",8
25,"25254",711,576,571,5,5,"Cs",27
43,"43114",375,306,305,0,1,"Cs",4
25,"25134",603,492,490,1,2,"Cs",16
25,"25902",542,449,439,3,10,"Cs",16
17,"17135",395,309,307,0,2,"Cs",44
43,"43098",354,291,291,1,0,"Cs",14
17,"17181",3467,2664,2648,10,16,"Cs",299
25,"25073",546,420,418,2,2,"Cs",15
17,"17182",272,220,220,3,0,"Cs",45
43,"43129",4611,3528,3495,21,33,"Cs",345
43,"43153",11092,8327,8291,34,36,"Cs",1157
43,"43111",2098,1496,1483,8,13,"Cs",224
43,"43128",905,751,747,4,4,"Cs",40
43,"43068",483,367,365,5,2,"Cs",28
25,"25909",140,108,107,2,1,"Cs",4
25,"25227",664,517,517,1,0,"Cs",15
43,"43169",450,396,396,3,0,"Cs",14
25,"25074",180,157,155,2,2,"Cs",9
43,"43006",676,531,525,4,6,"Cs",23
17,"17001",580,459,454,3,5,"Cs",29
17,"17013",2774,2180,2173,15,7,"Cs",221
25,"25203",8798,6279,6231,26,48,"Cs",565
17,"17901",983,790,789,3,1,"Cs",49
17,"17029",199,160,157,1,3,"Cs",12
17,"17056",1766,1438,1433,9,5,"Cs",57
25,"25029",1607,1270,1265,6,5,"Cs",30
43,"43064",2017,1569,1558,9,11,"Cs",107
43,"43015",119,101,101,0,0,"Cs",0
17,"17004",533,445,441,3,4,"Cs",24
17,"17183",255,216,216,0,0,"Cs",7
17,"17176",123,110,110,1,0,"Cs",14
43,"43018",385,335,334,3,1,"Cs",16
17,"17186",3824,3115,3098,15,17,"Cs",341
25,"25142",365,300,299,2,1,"Cs",12
17,"17153",188,162,162,0,0,"Cs",4
43,"43016",3445,2628,2608,11,20,"Cs",327
17,"17033",5587,4157,4130,13,27,"Cs",382
17,"17024",285,228,227,0,1,"Cs",16
43,"43117",143,114,113,0,1,"Cs",8
43,"43065",382,308,304,1,4,"Cs",7
43,"43032",466,379,379,1,0,"Cs",15
25,"25104",122,91,91,0,0,"Cs",5
43,"43904",2861,2083,2058,27,25,"Cs",155
43,"43059",250,214,214,1,0,"Cs",3
43,"43092",7235,5200,5174,21,26,"Cs",904
25,"25180",228,176,174,1,2,"Cs",5
43,"43035",235,205,203,7,2,"Cs",8
43,"43003",350,266,264,3,2,"Cs",26
43,"43078",843,653,644,4,9,"Cs",47
25,"25209",1550,1192,1172,4,20,"Cs",69
43,"43036",865,605,602,1,3,"Cs",68
43,"43112",250,204,204,1,0,"Cs",8
25,"25149",1378,1108,1102,3,6,"Cs",58
43,"43055",1988,1631,1622,7,9,"Cs",64
25,"25185",679,493,491,6,2,"Cs",30
43,"43038",21861,16504,16406,112,98,"Cs",2853
17,"17067",697,581,578,4,3,"Cs",23
25,"25217",10819,8163,8120,64,43,"Cs",581
17,"17093",922,716,715,2,1,"Cs",59
25,"25252",557,424,422,4,2,"Cs",29
17,"17077",567,434,434,2,0,"Cs",41
17,"17139",1394,1163,1154,3,9,"Cs",45
17,"17096",164,113,113,1,0,"Cs",1
25,"25099",1291,981,978,2,3,"Cs",53
43,"43042",2198,1820,1816,8,4,"Cs",216
25,"25078",1001,807,805,5,2,"Cs",31
25,"25092",127,101,99,1,2,"Cs",2
43,"43034",468,393,393,0,0,"Cs",22
25,"25109",214,179,176,3,3,"Cs",6
25,"25913",86,77,77,0,0,"Cs",2
43,"43127",759,630,626,3,4,"Cs",39
43,"43168",84,65,65,1,0,"Cs",1
43,"43143",51,45,44,0,1,"Cs",1
17,"17166",547,460,459,2,1,"Cs",8
17,"17103",5084,3575,3543,13,32,"Cs",400
17,"17221",4152,3260,3247,11,13,"Cs",479
25,"25154",118,94,94,0,0,"Cs",1
17,"17025",1170,972,967,6,5,"Cs",42
43,"43149",684,533,533,4,0,"Cs",42
43,"43067",528,450,445,1,5,"Cs",16
17,"17148",1531,1165,1153,4,12,"Cs",130
25,"25219",149,118,118,1,0,"Cs",11
43,"43013",4392,3341,3321,14,20,"Cs",272
17,"17190",838,681,677,0,4,"Cs",17
17,"17097",199,172,170,1,2,"Cs",4
17,"17141",6072,4251,4221,14,30,"Cs",535
43,"43907",4359,3370,3346,22,24,"Cs",610
17,"17038",380,312,308,3,4,"Cs",16
17,"17215",2227,1936,1925,12,11,"Cs",144
25,"25012",2342,1748,1739,10,9,"Cs",195
17,"17220",805,673,665,2,8,"Cs",24
43,"43147",521,446,442,4,4,"Cs",5
17,"17089",5695,4211,4194,13,17,"Cs",325
17,"17171",172,143,141,0,2,"Cs",8
43,"43011",1079,912,909,1,3,"Cs",54
17,"17046",710,574,571,3,3,"Cs",21
25,"25022",107,88,88,0,0,"Cs",3
43,"43161",17113,12944,12881,64,63,"Cs",1247
17,"17118",12916,9521,9460,37,61,"Cs",1018
17,"17162",156,114,111,1,3,"Cs",3
43,"43079",356,306,305,1,1,"Cs",17
17,"17061",183,148,148,0,0,"Cs",13
43,"43071",891,713,706,6,7,"Cs",44
25,"25224",126,98,98,0,0,"Cs",2
17,"17007",1752,1430,1422,2,8,"Cs",61
17,"17213",5535,3998,3985,20,13,"Cs",387
25,"25096",888,663,661,2,2,"Cs",30
43,"43151",109,98,98,0,0,"Cs",10
17,"17210",580,449,445,2,4,"Cs",35
25,"25221",117,92,92,0,0,"Cs",3
43,"43162",4418,3467,3453,20,14,"Cs",515
17,"17152",11026,7610,7564,70,46,"Cs",1333
43,"43178",1421,1118,1113,7,5,"Cs",123
17,"17111",958,772,771,3,1,"Cs",54
25,"25023",4527,3621,3601,23,20,"Cs",379
25,"25249",176,139,138,1,1,"Cs",9
17,"17902",1306,1076,1074,3,2,"Cs",69
43,"43155",22619,16724,16624,101,100,"Cs",1344
25,"25233",285,231,229,2,2,"Cs",16
43,"43093",3884,2956,2933,14,23,"Cs",204
43,"43046",90,73,73,1,0,"Cs",2
17,"17123",345,304,303,4,1,"Cs",12
43,"43040",326,278,276,0,2,"Cs",7
43,"43008",307,202,200,1,2,"Cs",19
25,"25911",424,332,331,1,1,"Cs",9
25,"25079",285,228,227,0,1,"Cs",5
17,"17222",105,95,95,1,0,"Cs",1
25,"25247",147,100,100,2,0,"Cs",21
17,"17098",303,245,245,2,0,"Cs",17
25,"25042",208,160,160,1,0,"Cs",11
25,"25036",184,144,143,0,1,"Cs",19
43,"43152",434,357,356,0,1,"Cs",5
43,"43905",14941,10510,10446,40,64,"Cs",2033
17,"17209",615,519,517,2,2,"Cs",67
17,"17010",327,264,263,2,1,"Cs",3
17,"17151",185,150,150,1,0,"Cs",7
25,"25006",317,246,245,3,1,"Cs",13
17,"17042",408,313,311,0,2,"Cs",20
43,"43033",768,609,607,3,2,"Cs",44
25,"25068",531,402,399,6,3,"Cs",14
43,"43050",2634,1881,1868,13,13,"Cs",258
25,"25027",977,765,763,4,2,"Cs",48
25,"25191",321,248,244,3,4,"Cs",12
43,"43137",1905,1515,1499,15,16,"Cs",177
25,"25223",911,732,723,6,9,"Cs",18
25,"25072",5874,4468,4450,24,18,"Cs",343
43,"43156",3956,2993,2965,23,28,"Cs",264
43,"43138",2648,1926,1896,8,30,"Cs",170
43,"43140",2438,1847,1837,16,10,"Cs",357
17,"17005",460,336,331,0,5,"Cs",21
25,"25016",2083,1590,1587,8,3,"Cs",91
17,"17064",326,263,261,2,2,"Cs",17
25,"25169",167,118,117,0,1,"Cs",7
25,"25127",214,172,172,0,0,"Cs",0
17,"17126",318,279,279,0,0,"Cs",3
25,"25222",66,57,57,0,0,"Cs",6
43,"43113",397,325,323,2,2,"Cs",30
43,"43010",337,286,284,2,2,"Cs",13
43,"43122",111,98,97,0,1,"Cs",4
25,"25112",268,214,212,2,2,"Cs",16
25,"25202",108,75,75,0,0,"Cs",0
17,"17095",19938,13998,13918,69,80,"Cs",2176
25,"25192",724,564,558,4,6,"Cs",34
17,"17116",354,283,282,0,1,"Cs",8
25,"25058",4358,3269,3254,7,15,"Cs",170
25,"25121",635,436,429,1,7,"Cs",55
43,"43176",746,588,586,7,2,"Cs",18
43,"43086",5263,4046,4021,17,25,"Cs",240
43,"43158",77,61,61,1,0,"Cs",0
25,"25208",333,252,249,0,3,"Cs",4
17,"17099",78,59,59,0,0,"Cs",2
17,"17003",102,75,75,0,0,"Cs",0
25,"25197",141,109,108,0,1,"Cs",6
25,"25226",242,184,183,4,1,"Cs",10
43,"43107",383,308,308,1,0,"Cs",24
25,"25059",813,621,612,3,9,"Cs",102
25,"25906",210,157,155,0,2,"Cs",5
17,"17226",895,673,669,3,4,"Cs",138
43,"43902",2743,1996,1980,16,16,"Cs",123
17,"17159",626,487,483,1,4,"Cs",20
43,"43118",425,357,356,0,1,"Cs",27
43,"43142",1083,850,842,8,8,"Cs",44
25,"25094",139,116,116,0,0,"Cs",9
25,"25089",97,72,71,1,1,"Cs",1
43,"43014",14357,10596,10542,60,54,"Cs",802
17,"17084",231,181,180,1,1,"Cs",5
17,"17129",144,120,120,1,0,"Cs",10
43,"43066",155,121,121,1,0,"Cs",8
17,"17216",155,127,124,0,3,"Cs",4
43,"43069",178,146,146,0,0,"Cs",7
17,"17217",353,312,311,1,1,"Cs",15
43,"43077",455,342,339,2,3,"Cs",33
43,"43061",38,28,28,0,0,"Cs",1
17,"17087",222,177,176,0,1,"Cs",4
25,"25061",80,59,58,0,1,"Cs",2
25,"25215",505,299,299,4,0,"Cs",35
17,"17043",167,135,134,0,1,"Cs",5
17,"17021",122,98,98,0,0,"Cs",0
17,"17051",207,174,173,3,1,"Cs",7
43,"43024",1556,1154,1137,3,17,"Cs",187
43,"43166",1628,1292,1285,3,7,"Cs",135
17,"17109",698,558,553,1,5,"Cs",7
25,"25907",497,389,386,2,3,"Cs",16
17,"17218",570,468,465,5,3,"Cs",15
25,"25051",1510,1176,1172,6,4,"Cs",57
17,"17075",334,282,281,5,1,"Cs",8
25,"25118",327,241,239,2,2,"Cs",19
17,"17147",7959,6164,6130,45,34,"Cs",423
17,"17161",1018,859,855,1,4,"Cs",23
17,"17085",291,248,246,0,2,"Cs",6
43,"43030",482,373,372,2,1,"Cs",31
43,"43136",10463,7789,7749,36,40,"Cs",473
17,"17174",162,132,132,4,0,"Cs",4
43,"43088",2026,1565,1562,9,3,"Cs",128
25,"25049",155,113,111,0,2,"Cs",14
17,"17200",623,512,510,1,2,"Cs",11
17,"17230",499,397,393,0,4,"Cs",46
25,"25248",880,714,713,4,1,"Cs",10
43,"43150",1238,1034,1026,6,8,"Cs",49
25,"25115",801,638,637,4,1,"Cs",33
25,"25046",407,349,347,1,2,"Cs",21
17,"17080",144,124,124,2,0,"Cs",8
25,"25132",143,118,118,0,0,"Cs",3
25,"25903",229,189,188,0,1,"Cs",4
25,"25912",843,685,684,4,1,"Cs",76
43,"43175",537,426,419,5,7,"Cs",30
43,"43023",214,186,186,1,0,"Cs",12
17,"17189",1476,1278,1275,2,3,"Cs",30
17,"17030",650,479,477,4,2,"Cs",50
25,"25255",395,321,318,2,3,"Cs",26
25,"25004",575,470,467,2,3,"Cs",20
17,"17090",544,469,468,0,1,"Cs",27
25,"25175",176,135,135,1,0,"Cs",11
17,"17195",342,296,295,3,1,"Cs",3
25,"25075",131,102,102,0,0,"Cs",5
25,"25179",171,134,134,1,0,"Cs",4
25,"25166",172,137,136,1,1,"Cs",7
43,"43029",314,253,252,0,1,"Cs",7
17,"17119",73,58,58,2,0,"Cs",2
25,"25151",736,592,584,1,8,"Cs",40
17,"17050",674,585,582,5,3,"Cs",23
25,"25211",672,513,512,6,1,"Cs",23
43,"43048",763,614,609,7,5,"Cs",45
17,"17091",398,310,305,2,5,"Cs",15
17,"17144",210,171,170,0,1,"Cs",8
25,"25010",196,156,155,2,1,"Cs",4
17,"17167",2609,2122,2102,14,20,"Cs",69
25,"25157",162,137,137,4,0,"Cs",21
17,"17205",211,184,184,1,0,"Cs",3
43,"43101",145,122,122,1,0,"Cs",4
43,"43104",1762,1410,1401,5,9,"Cs",40
43,"43123",71092,53689,53369,241,320,"Cs",7657
25,"25098",232,172,170,2,2,"Cs",4
43,"43043",3289,2624,2613,14,11,"Cs",350
25,"25033",1121,899,890,5,9,"Cs",47
17,"17223",800,623,616,5,7,"Cs",44
17,"17165",634,516,512,3,4,"Cs",12
17,"17168",379,332,329,0,3,"Cs",20
43,"43057",38,31,31,1,0,"Cs",1
17,"17164",3932,3078,3054,8,24,"Cs",138
25,"25177",358,270,268,1,2,"Cs",15
17,"17114",23269,17558,17474,91,84,"Cs",1032
25,"25168",488,408,407,6,1,"Cs",27
17,"17023",27144,20301,20146,120,155,"Cs",2718
25,"25135",1000,773,769,2,4,"Cs",34
17,"17203",165,135,135,0,0,"Cs",3
43,"43172",337,261,257,2,4,"Cs",17
25,"25146",221,172,170,3,2,"Cs",14
43,"43132",363,292,291,2,1,"Cs",18
43,"43058",96,77,77,0,0,"Cs",3
17,"17175",564,381,381,1,0,"Cs",51
25,"25238",205,163,163,2,0,"Cs",8
17,"17155",14861,10307,10234,52,73,"Cs",1057
43,"43159",81,63,62,0,1,"Cs",2
25,"25136",96,79,79,2,0,"Cs",6
25,"25120",92704,68713,68361,445,352,"Cs",8435
25,"25103",136,103,102,2,1,"Cs",6
43,"43009",1391,1086,1078,3,8,"Cs",81
17,"17107",269,221,219,2,2,"Cs",7
17,"17143",144,115,115,0,0,"Cs",2
17,"17094",1068,772,766,1,6,"Cs",55
43,"43141",105,86,86,0,0,"Cs",6
17,"17187",625,530,529,4,1,"Cs",27
43,"43002",1875,1367,1348,11,19,"Cs",225
43,"43133",5605,4202,4168,21,34,"Cs",326
43,"43090",1169,749,742,2,7,"Cs",113
17,"17170",180,147,147,2,0,"Cs",2
25,"25124",157,114,114,0,0,"Cs",6
25,"25194",415,325,325,3,0,"Cs",3
17,"17125",131,98,97,1,1,"Cs",1
17,"17112",194,154,152,2,2,"Cs",2
25,"25055",163,130,129,0,1,"Cs",11
43,"43073",84,68,67,0,1,"Cs",2
43,"43022",1435,1130,1123,8,7,"Cs",107
17,"17063",173,157,156,2,1,"Cs",2
17,"17177",567,459,457,2,2,"Cs",17
25,"25181",175,136,135,0,1,"Cs",6
25,"25164",357,264,261,4,3,"Cs",8
17,"17016",719,584,581,1,3,"Cs",21
17,"17052",134,104,104,1,0,"Cs",4
43,"43017",116,98,98,1,0,"Cs",1
25,"25041",528,399,396,4,3,"Cs",26
17,"17198",433,332,329,0,3,"Cs",30
17,"17234",179,147,146,2,1,"Cs",20
25,"25015",335,262,260,8,2,"Cs",18
17,"17020",3671,3021,3006,11,15,"Cs",122
25,"25034",2288,1733,1719,9,14,"Cs",88
43,"43145",4209,3409,3391,9,18,"Cs",290
25,"25129",159,115,115,2,0,"Cs",4
43,"43028",2766,2007,1988,7,19,"Cs",229
43,"43052",934,765,756,2,9,"Cs",52
17,"17068",246,194,193,0,1,"Cs",10
17,"17018",494,405,402,1,3,"Cs",14
17,"17040",551,465,459,4,6,"Cs",16
17,"17105",247,194,194,1,0,"Cs",7
25,"25126",284,233,232,1,1,"Cs",9
25,"25161",343,243,243,0,0,"Cs",7
43,"43041",228,179,177,3,2,"Cs",21
43,"43901",8750,6057,6004,43,53,"Cs",264
17,"17037",114,98,98,6,0,"Cs",4
25,"25032",67,53,53,0,0,"Cs",2
25,"25001",139,104,103,1,1,"Cs",3
25,"25908",221,159,158,1,1,"Cs",7
43,"43103",905,746,740,8,6,"Cs",128
25,"25021",2541,1891,1882,14,9,"Cs",101
43,"43075",86,71,69,0,2,"Cs",1
17,"17031",182,130,129,0,1,"Cs",7
25,"25077",440,331,330,1,1,"Cs",20
43,"43074",1812,1419,1412,4,7,"Cs",108
25,"25114",95,79,79,0,0,"Cs",0
25,"25031",57,39,39,0,0,"Cs",18
25,"25196",112,94,93,0,1,"Cs",1
43,"43177",284,243,242,0,1,"Cs",17
17,"17212",142,117,117,2,0,"Cs",0
43,"43044",3949,3060,3032,31,28,"Cs",332
25,"25220",994,822,816,3,6,"Cs",24
43,"43120",421,302,297,2,5,"Cs",34
25,"25045",54,31,31,5,0,"Cs",3
25,"25152",144,106,106,1,0,"Cs",8
25,"25251",713,562,558,4,4,"Cs",37
17,"17188",169,139,138,1,1,"Cs",4
25,"25047",972,784,781,8,3,"Cs",33
17,"17227",139,106,106,0,0,"Cs",7
17,"17136",195,156,155,0,1,"Cs",8
43,"43091",123,93,93,1,0,"Cs",2
25,"25025",1378,996,983,8,13,"Cs",164
43,"43025",590,476,472,0,4,"Cs",30
17,"17070",110,94,94,0,0,"Cs",4
25,"25153",192,152,150,1,2,"Cs",17
25,"25186",207,174,173,7,1,"Cs",6
25,"25232",1356,1066,1061,2,5,"Cs",54
25,"25201",110,89,89,0,0,"Cs",4
25,"25245",430,346,342,1,4,"Cs",18
25,"25250",330,261,258,1,3,"Cs",4
43,"43019",1336,1020,1008,4,12,"Cs",84
43,"43049",727,589,584,2,5,"Cs",14
43,"43135",341,283,280,4,3,"Cs",18
43,"43039",105,85,85,0,0,"Cs",8
17,"17142",2673,2250,2241,14,9,"Cs",200
17,"17008",3594,2763,2741,16,22,"Cs",133
25,"25253",145,122,121,0,1,"Cs",6
25,"25189",2164,1591,1583,11,8,"Cs",119
25,"25100",184,145,144,1,1,"Cs",3
25,"25113",1116,912,908,8,4,"Cs",46
25,"25024",352,273,272,0,1,"Cs",3
25,"25183",535,419,416,4,3,"Cs",13
25,"25076",134,94,93,0,1,"Cs",4
25,"25231",494,410,408,2,2,"Cs",13
43,"43167",384,334,333,2,1,"Cs",9
17,"17073",1939,1695,1693,7,2,"Cs",118
17,"17206",155,118,115,0,3,"Cs",7
43,"43084",521,424,423,2,1,"Cs",15
43,"43164",306,228,228,0,0,"Cs",24
25,"25011",5260,3908,3871,30,37,"Cs",328
25,"25002",467,357,356,2,1,"Cs",10
17,"17154",99,84,83,0,1,"Cs",3
25,"25145",76,66,66,1,0,"Cs",2
25,"25158",1606,1291,1277,5,14,"Cs",69
43,"43106",793,656,651,2,5,"Cs",31
43,"43001",694,543,543,5,0,"Cs",39
25,"25097",84,72,72,1,0,"Cs",5
17,"17079",65381,50872,50631,242,241,"Cs",4712
43,"43154",126,111,111,0,0,"Cs",4
17,"17047",4968,3447,3429,22,18,"Cs",491
43,"43146",41,35,35,0,0,"Cs",0
17,"17145",1432,1113,1103,7,10,"Cs",57
17,"17185",2275,1777,1768,7,9,"Cs",74
25,"25150",165,136,133,0,3,"Cs",5
43,"43105",156,132,132,3,0,"Cs",2
17,"17102",548,439,435,3,4,"Cs",15
43,"43082",351,303,297,1,6,"Cs",4
17,"17074",532,436,426,2,10,"Cs",43
43,"43171",14705,11002,10956,62,46,"Cs",2427
17,"17106",143,124,123,0,1,"Cs",5
17,"17903",889,726,721,4,5,"Cs",61
25,"25148",219,168,168,1,0,"Cs",13
17,"17086",1745,1223,1210,7,13,"Cs",183
43,"43100",3489,2820,2816,15,4,"Cs",445
17,"17232",149,117,116,0,1,"Cs",1
25,"25067",706,537,532,4,5,"Cs",45
25,"25190",257,215,215,0,0,"Cs",5
17,"17224",302,233,231,2,2,"Cs",5
25,"25008",1088,867,857,7,10,"Cs",50
25,"25017",232,184,181,0,3,"Cs",2
25,"25239",595,367,366,3,1,"Cs",32
43,"43109",2704,1937,1922,16,15,"Cs",362
25,"25060",69,49,49,1,0,"Cs",4
43,"43031",1446,1180,1178,7,2,"Cs",72
43,"43027",164,137,137,0,0,"Cs",0
17,"17049",3204,2634,2615,9,19,"Cs",163
43,"43119",838,630,628,4,2,"Cs",77
25,"25207",6430,4899,4867,41,32,"Cs",295
17,"17083",2961,2321,2300,12,21,"Cs",172
25,"25125",389,303,300,1,3,"Cs",12
17,"17194",78,62,62,0,0,"Cs",3
17,"17066",27323,18373,18269,98,104,"Cs",2399
43,"43076",460,378,377,2,1,"Cs",15
43,"43096",98,82,82,0,0,"Cs",4
25,"25071",42,32,31,0,1,"Cs",0
17,"17015",12819,10133,10078,38,55,"Cs",409
17,"17055",143,126,125,0,1,"Cs",1
25,"25087",56,49,49,0,0,"Cs",0
25,"25053",1092,879,873,8,6,"Cs",48
43,"43157",345,303,303,0,0,"Cs",3
17,"17199",6955,5328,5308,23,20,"Cs",526
43,"43089",281,209,208,0,1,"Cs",20
17,"17036",2643,2076,2071,12,5,"Cs",136
17,"17009",4051,3263,3248,14,15,"Cs",124
25,"25242",689,539,531,0,8,"Cs",26
43,"43053",188,153,149,0,4,"Cs",3
17,"17130",322,268,268,0,0,"Cs",6
43,"43144",1236,1025,1021,8,4,"Cs",109
43,"43131",4772,3432,3401,18,31,"Cs",600
17,"17026",543,450,449,4,1,"Cs",18
25,"25082",295,229,229,2,0,"Cs",8
25,"25111",113,90,89,0,1,"Cs",4
17,"17193",4312,3202,3179,15,23,"Cs",405
17,"17128",316,255,252,1,3,"Cs",26
43,"43906",2103,1595,1587,14,8,"Cs",153
17,"17150",1426,1199,1192,8,7,"Cs",59
17,"17041",218,166,165,3,1,"Cs",10
43,"43070",238,194,193,1,1,"Cs",3
25,"25200",323,253,252,0,1,"Cs",6
25,"25081",287,221,220,2,1,"Cs",3
43,"43173",99,80,78,0,2,"Cs",0
25,"25123",189,151,151,0,0,"Cs",5
25,"25155",618,493,489,2,4,"Cs",19
17,"17160",14733,10833,10766,43,67,"Cs",1048
25,"25062",695,578,573,3,5,"Cs",41
17,"17121",229,184,184,1,0,"Cs",6
17,"17022",7008,5386,5354,22,32,"Cs",277
25,"25131",402,321,320,1,1,"Cs",17
25,"25063",95,61,61,0,0,"Cs",2
17,"17039",1740,1385,1380,8,5,"Cs",77
17,"17011",651,544,544,4,0,"Cs",28
17,"17208",976,772,768,5,4,"Cs",30
25,"25172",1779,1407,1405,3,2,"Cs",71
43,"43170",878,706,704,7,2,"Cs",32
25,"25901",287,209,207,1,2,"Cs",13
25,"25030",123,90,90,1,0,"Cs",2
25,"25039",261,216,216,1,0,"Cs",8
25,"25013",2108,1570,1557,12,13,"Cs",151
43,"43083",144,116,113,1,3,"Cs",11
17,"17092",3467,2660,2633,17,27,"Cs",212
25,"25141",152,118,118,1,0,"Cs",5
17,"17012",1171,916,914,10,2,"Cs",117
17,"17081",248,192,190,0,2,"Cs",14
17,"17117",14471,10565,10504,52,61,"Cs",1150
43,"43160",1322,1051,1045,0,6,"Cs",124
43,"43126",1211,1005,999,4,6,"Cs",84
43,"43026",765,614,613,3,1,"Cs",28
43,"43115",128,112,111,1,1,"Cs",2
25,"25020",274,221,221,2,0,"Cs",17
25,"25069",425,329,327,1,2,"Cs",7
25,"25019",4646,3224,3199,22,25,"Cs",346
17,"17140",639,539,527,4,12,"Cs",34
25,"25119",2245,1798,1792,10,6,"Cs",82
25,"25206",250,189,188,2,1,"Cs",2
17,"17124",1599,1258,1254,6,4,"Cs",69
25,"25230",1555,1221,1208,8,13,"Cs",103
25,"25212",224,195,195,2,0,"Cs",13
43,"43060",2684,2158,2152,8,6,"Cs",98
17,"17032",1742,1235,1224,6,11,"Cs",64
17,"17078",336,252,251,3,1,"Cs",13
17,"17019",1784,1472,1462,3,10,"Cs",50
25,"25139",491,390,388,3,2,"Cs",18
25,"25014",249,203,200,2,3,"Cs",0
43,"43054",2792,2145,2134,21,11,"Cs",104
25,"25110",2731,2121,2106,14,15,"Cs",147
32,"32066",551,399,396,1,3,"CxG",0
27,"27045",944,700,698,13,2,"CxG",2
15,"15057",12051,8814,8660,89,154,"CxG",12
15,"15068",4849,3435,3392,55,43,"CxG",5
36,"36028",4069,3012,2960,27,52,"CxG",2
15,"15079",1466,1076,1052,11,24,"CxG",3
15,"15080",1640,1177,1150,9,27,"CxG",0
27,"27022",4683,3131,3059,30,72,"CxG",0
27,"27014",3162,2181,2139,17,42,"CxG",3
32,"32038",399,274,271,3,3,"CxG",0
15,"15038",2123,1441,1413,25,28,"CxG",1
36,"36024",16395,12372,12165,102,207,"CxG",71
36,"36014",1872,1373,1345,14,28,"CxG",1
32,"32058",5225,3915,3857,35,58,"CxG",3
15,"15075",12785,9638,9519,121,119,"CxG",13
15,"15031",23779,17963,17787,213,176,"CxG",22
32,"32069",4256,3358,3309,39,49,"CxG",2
27,"27035",180,127,123,0,4,"CxG",0
15,"15020",3593,2491,2469,18,22,"CxG",2
32,"32022",1238,924,916,5,8,"CxG",1
32,"32020",2460,1899,1876,6,23,"CxG",0
32,"32014",1045,775,769,5,6,"CxG",2
15,"15061",5199,3694,3601,40,93,"CxG",5
27,"27034",1025,647,636,4,11,"CxG",0
32,"32048",864,550,544,1,6,"CxG",0
36,"36019",1463,1041,1030,14,11,"CxG",2
27,"27048",2019,1499,1467,23,32,"CxG",1
32,"32036",1261,954,938,9,16,"CxG",0
15,"15010",1819,1194,1181,16,13,"CxG",0
32,"32041",759,510,502,2,8,"CxG",0
15,"15058",28606,22203,22022,261,181,"CxG",24
27,"27031",15212,10826,10649,125,177,"CxG",9
32,"32067",1193,827,818,10,9,"CxG",1
36,"36054",11074,8032,7873,77,159,"CxG",6
32,"32023",1132,867,862,7,5,"CxG",0
15,"15073",21760,14900,14630,181,270,"CxG",46
15,"15093",4048,2761,2720,41,41,"CxG",6
27,"27024",1451,1122,1102,5,20,"CxG",0
32,"32035",1370,881,872,5,9,"CxG",0
32,"32070",512,307,304,8,3,"CxG",0
32,"32028",1550,1176,1171,10,5,"CxG",1
32,"32013",2017,1388,1380,5,8,"CxG",1
32,"32008",8572,6301,6216,65,85,"CxG",19
36,"36004",10123,7396,7273,93,123,"CxG",7
15,"15022",5574,3846,3798,41,48,"CxG",6
32,"32043",2512,1805,1789,16,16,"CxG",18
27,"27061",1016,784,763,9,21,"CxG",0
32,"32001",5105,3760,3715,37,45,"CxG",3
32,"32050",2280,1788,1775,19,13,"CxG",2
15,"15077",8155,5554,5433,59,121,"CxG",30
27,"27053",501,384,373,1,11,"CxG",0
15,"15027",1555,1227,1204,18,23,"CxG",0
15,"15076",2514,1709,1683,19,26,"CxG",4
32,"32084",902,636,631,2,5,"CxG",2
15,"15039",1224,874,850,11,24,"CxG",1
32,"32029",436,340,337,1,3,"CxG",0
36,"36044",2539,1768,1708,18,60,"CxG",2
36,"36050",7650,5616,5506,48,110,"CxG",9
15,"15017",19860,14930,14706,204,224,"CxG",27
32,"32042",1505,1097,1091,12,6,"CxG",0
32,"32052",1819,1399,1379,15,20,"CxG",0
36,"36901",4152,3400,3338,15,62,"CxG",7
15,"15040",2675,2011,1979,20,32,"CxG",5
32,"32027",1000,762,747,5,15,"CxG",0
27,"27025",2743,2191,2138,31,53,"CxG",3
27,"27059",2055,1508,1471,13,37,"CxG",1
32,"32082",1178,880,872,12,8,"CxG",2
32,"32092",482,337,334,2,3,"CxG",0
15,"15048",5048,3791,3730,38,61,"CxG",3
27,"27032",3194,2268,2223,20,45,"CxG",3
15,"15083",1036,784,768,7,16,"CxG",2
36,"36038",66806,50974,50429,507,545,"CxG",54
32,"32078",1108,794,781,15,13,"CxG",0
27,"27054",1145,907,890,5,17,"CxG",2
36,"36007",1618,1163,1133,7,30,"CxG",2
27,"27013",3684,2997,2935,26,62,"CxG",11
27,"27028",78798,58316,57546,629,770,"CxG",80
15,"15056",5648,4033,3979,39,54,"CxG",14
32,"32056",1520,1125,1116,6,9,"CxG",1
27,"27037",1017,759,748,10,11,"CxG",0
27,"27902",7150,5067,4953,74,114,"CxG",34
15,"15005",25263,17634,17347,257,287,"CxG",23
32,"32021",874,616,615,4,1,"CxG",0
36,"36040",2517,1895,1853,18,42,"CxG",0
32,"32068",1419,998,987,4,11,"CxG",1
36,"36023",8279,6187,6085,46,102,"CxG",4
32,"32086",2563,1699,1686,19,13,"CxG",3
36,"36042",18072,13314,13091,130,223,"CxG",29
36,"36035",14571,11096,10917,105,179,"CxG",12
27,"27011",2358,1582,1558,12,24,"CxG",1
36,"36033",12244,9553,9358,80,195,"CxG",12
15,"15082",15381,11803,11642,133,161,"CxG",29
15,"15006",5169,3527,3436,32,91,"CxG",22
32,"32006",1434,1033,1019,8,14,"CxG",1
15,"15030",199972,151737,150397,1576,1340,"CxG",217
32,"32044",809,625,617,2,8,"CxG",0
36,"36041",13621,10098,9939,97,159,"CxG",13
27,"27017",961,667,654,1,13,"CxG",0
27,"27002",1546,1136,1103,9,33,"CxG",5
32,"32018",1179,950,936,3,14,"CxG",0
32,"32015",830,543,541,4,2,"CxG",0
36,"36046",4043,3157,3084,27,73,"CxG",6
15,"15046",6163,4625,4497,49,128,"CxG",6
27,"27066",12633,9139,8911,84,228,"CxG",25
32,"32089",1220,872,857,15,15,"CxG",1
36,"36025",2137,1387,1381,7,6,"CxG",1
32,"32088",1610,1040,1019,11,21,"CxG",0
15,"15049",1091,805,796,8,9,"CxG",0
27,"27049",1342,934,921,11,13,"CxG",1
32,"32057",514,367,365,5,2,"CxG",1
32,"32083",821,592,587,7,5,"CxG",0
36,"36048",5244,3859,3786,33,73,"CxG",5
27,"27010",4402,3015,2940,49,75,"CxG",4
36,"36032",3537,2676,2626,16,50,"CxG",2
32,"32011",918,526,521,6,5,"CxG",0
32,"32045",2360,1712,1689,18,23,"CxG",4
27,"27015",4020,2809,2730,33,79,"CxG",3
27,"27901",2275,1542,1531,27,11,"CxG",1
36,"36039",15610,11844,11592,103,252,"CxG",13
15,"15085",3220,2284,2239,23,45,"CxG",5
15,"15091",1103,773,758,16,15,"CxG",3
27,"27026",2315,1620,1599,17,21,"CxG",3
27,"27020",3380,2764,2713,32,51,"CxG",5
32,"32087",1675,1313,1288,18,25,"CxG",2
27,"27057",11097,7917,7735,88,182,"CxG",38
15,"15074",3919,2865,2808,33,57,"CxG",4
15,"15008",5631,4320,4267,64,53,"CxG",3
27,"27047",1525,1026,1008,5,18,"CxG",1
15,"15078",78678,60510,59882,621,628,"CxG",130
15,"15044",1209,889,876,4,13,"CxG",1
27,"27058",3322,2551,2512,22,39,"CxG",1
15,"15013",6299,4549,4486,45,63,"CxG",4
15,"15092",6250,4358,4297,28,61,"CxG",10
27,"27027",1806,1392,1354,18,38,"CxG",9
36,"36030",3946,2847,2810,26,37,"CxG",4
15,"15047",2269,1531,1497,25,34,"CxG",6
15,"15037",4031,2700,2677,13,23,"CxG",3
15,"15041",9581,7223,7082,96,141,"CxG",12
32,"32051",1407,1158,1153,12,5,"CxG",0
36,"36043",4682,3345,3303,17,42,"CxG",3
27,"27029",1427,1068,1047,13,21,"CxG",0
36,"36005",8122,5895,5776,65,119,"CxG",7
36,"36003",10038,7747,7632,79,115,"CxG",4
36,"36018",3073,2184,2144,9,40,"CxG",2
27,"27042",1648,1247,1233,21,14,"CxG",0
36,"36017",17419,12867,12610,120,257,"CxG",20
32,"32039",1142,895,890,7,5,"CxG",2
27,"27039",4430,3437,3353,53,84,"CxG",2
32,"32032",7932,5956,5831,55,125,"CxG",8
15,"15007",3179,2333,2304,22,29,"CxG",13
36,"36045",24478,18627,18327,157,300,"CxG",33
36,"36022",9061,6640,6482,47,158,"CxG",10
15,"15072",9436,6962,6860,60,102,"CxG",16
15,"15064",2127,1608,1577,29,31,"CxG",2
27,"27021",1649,1080,1048,14,32,"CxG",0
15,"15018",1087,771,761,8,10,"CxG",1
27,"27050",2842,2100,2072,19,28,"CxG",2
27,"27040",3035,2285,2234,19,51,"CxG",1
15,"15062",5652,3803,3728,25,75,"CxG",33
32,"32002",2022,1510,1485,8,25,"CxG",7
15,"15054",31802,22002,21676,368,326,"CxG",36
36,"36016",1064,707,696,7,11,"CxG",0
36,"36026",19924,14342,14132,171,210,"CxG",12
36,"36020",2184,1621,1599,13,22,"CxG",10
15,"15025",1000,639,631,6,8,"CxG",3
15,"15015",2883,2079,2049,21,30,"CxG",3
32,"32012",716,497,487,7,10,"CxG",2
32,"32046",1098,793,782,5,11,"CxG",2
32,"32010",360,276,273,3,3,"CxG",0
32,"32059",1703,1248,1228,12,20,"CxG",0
36,"36008",21884,16428,16170,165,258,"CxG",13
32,"32019",11512,8281,8161,96,120,"CxG",9
15,"15023",6318,4501,4436,40,65,"CxG",13
27,"27041",2238,1640,1615,10,25,"CxG",4
27,"27063",1715,1236,1198,10,38,"CxG",0
32,"32016",724,543,535,3,8,"CxG",0
32,"32091",1703,1312,1306,4,6,"CxG",1
27,"27030",3134,2209,2162,27,47,"CxG",4
36,"36058",4942,3470,3402,37,68,"CxG",6
27,"27018",3232,2114,2089,24,25,"CxG",2
32,"32037",681,534,523,6,11,"CxG",0
15,"15042",2955,2057,2002,16,55,"CxG",6
32,"32073",1281,941,932,9,9,"CxG",0
15,"15070",8797,6312,6173,108,139,"CxG",13
27,"27004",1149,741,722,2,19,"CxG",0
15,"15069",6588,4914,4830,58,84,"CxG",8
32,"32060",765,577,567,2,10,"CxG",0
32,"32005",827,628,622,4,6,"CxG",0
32,"32025",1013,773,761,7,12,"CxG",0
32,"32024",4835,3484,3439,23,45,"CxG",5
36,"36055",13551,9908,9682,105,226,"CxG",8
36,"36053",5784,4407,4327,28,80,"CxG",7
36,"36010",2828,2217,2184,15,33,"CxG",0
15,"15050",1748,1038,1027,15,11,"CxG",0
27,"27016",6973,5139,5064,66,75,"CxG",7
32,"32030",944,690,685,7,5,"CxG",0
32,"32055",1230,908,889,5,19,"CxG",2
15,"15014",3836,2739,2698,38,41,"CxG",3
32,"32061",1070,862,855,8,7,"CxG",1
36,"36049",7019,5414,5283,48,131,"CxG",15
36,"36057",238171,181891,180030,1636,1861,"CxG",236
15,"15087",5692,3883,3838,53,45,"CxG",5
15,"15033",2422,1887,1866,13,21,"CxG",5
27,"27006",2458,1713,1666,27,47,"CxG",1
15,"15043",4978,3631,3572,39,59,"CxG",4
32,"32049",689,468,462,3,6,"CxG",1
32,"32047",1746,1272,1252,6,20,"CxG",4
36,"36902",5052,3813,3724,21,89,"CxG",5
36,"36027",4380,3262,3206,26,56,"CxG",6
32,"32075",4382,3546,3489,35,57,"CxG",10
36,"36001",2401,1739,1715,19,24,"CxG",1
36,"36037",2554,1839,1793,6,46,"CxG",3
32,"32090",738,530,525,3,5,"CxG",3
36,"36021",12099,9105,8974,85,131,"CxG",13
27,"27044",2719,1848,1797,29,51,"CxG",6
32,"32063",1819,1313,1287,6,26,"CxG",0
27,"27051",8012,5936,5832,70,104,"CxG",15
32,"32034",1074,855,846,1,9,"CxG",0
15,"15032",3413,2487,2414,28,73,"CxG",7
27,"27062",584,467,466,3,1,"CxG",1
15,"15052",4104,2928,2878,30,50,"CxG",1
32,"32077",1104,820,815,10,5,"CxG",0
32,"32076",1974,1492,1472,17,20,"CxG",1
27,"27056",1206,896,880,9,16,"CxG",3
15,"15045",3629,2263,2237,9,26,"CxG",4
27,"27008",1345,965,946,17,19,"CxG",3
15,"15036",56248,40194,39764,508,430,"CxG",55
15,"15055",4485,3097,3057,39,40,"CxG",5
32,"32054",86475,64472,63712,676,760,"CxG",93
32,"32031",1014,764,756,5,8,"CxG",0
32,"32080",286,223,220,1,3,"CxG",0
36,"36060",30432,22488,22196,199,292,"CxG",32
27,"27064",1503,1078,1039,12,39,"CxG",6
15,"15060",5843,4360,4281,65,79,"CxG",3
15,"15029",5403,3682,3622,62,60,"CxG",7
36,"36052",7234,5292,5151,44,141,"CxG",11
15,"15011",15481,11249,11037,105,212,"CxG",16
15,"15067",7953,6004,5925,51,79,"CxG",8
32,"32071",1378,963,954,7,9,"CxG",0
27,"27007",2756,2148,2084,29,64,"CxG",2
15,"15004",4873,3689,3623,31,66,"CxG",5
27,"27023",2470,1833,1797,20,36,"CxG",2
15,"15086",2785,2015,1987,14,28,"CxG",5
32,"32003",889,667,654,3,13,"CxG",1
32,"32040",1418,1083,1075,3,8,"CxG",0
15,"15016",4569,3171,3146,18,25,"CxG",2
27,"27009",2022,1514,1488,17,26,"CxG",0
27,"27033",598,423,415,1,8,"CxG",0
15,"15902",4522,3220,3159,47,61,"CxG",13
15,"15034",2724,1832,1811,8,21,"CxG",2
15,"15065",7151,5281,5165,63,116,"CxG",6
32,"32081",2035,1592,1565,14,27,"CxG",0
15,"15059",10255,7423,7262,122,161,"CxG",15
27,"27065",12076,8393,8183,128,210,"CxG",7
32,"32007",1412,1011,1001,9,10,"CxG",0
15,"15002",24007,18075,17857,216,218,"CxG",45
15,"15028",1393,1076,1063,8,13,"CxG",0
36,"36034",3319,2384,2347,16,37,"CxG",1
15,"15012",3611,2695,2616,36,79,"CxG",16
15,"15090",1125,811,800,7,11,"CxG",2
15,"15003",1701,1234,1210,10,24,"CxG",1
36,"36029",16086,12196,12005,126,191,"CxG",10
15,"15021",5244,3884,3806,70,78,"CxG",4
27,"27060",2463,1695,1669,12,26,"CxG",3
32,"32017",1202,821,815,6,6,"CxG",0
36,"36013",2242,1468,1452,15,16,"CxG",4
32,"32004",1671,907,899,7,8,"CxG",4
15,"15051",4562,3302,3249,36,53,"CxG",6
27,"27001",2209,1290,1251,25,39,"CxG",3
27,"27012",1276,776,768,9,8,"CxG",1
15,"15081",982,755,741,11,14,"CxG",0
15,"15084",3059,2236,2217,20,19,"CxG",4
32,"32062",766,582,579,1,3,"CxG",1
15,"15001",4689,3422,3362,52,60,"CxG",9
15,"15009",10615,8066,7919,93,147,"CxG",17
27,"27005",2551,1908,1868,26,40,"CxG",5
32,"32079",1287,1016,1006,6,10,"CxG",2
36,"36031",562,455,450,2,5,"CxG",0
15,"15089",4324,3258,3200,33,58,"CxG",6
15,"15088",3415,2349,2323,28,26,"CxG",3
15,"15019",26006,18323,18075,280,248,"CxG",31
27,"27003",1772,1271,1241,6,30,"CxG",2
36,"36036",2556,1953,1914,14,39,"CxG",2
15,"15071",7805,5476,5401,62,75,"CxG",9
36,"36009",4445,3081,2997,26,84,"CxG",3
32,"32074",993,737,734,4,3,"CxG",6
32,"32072",3687,2715,2682,22,33,"CxG",2
15,"15024",4346,3210,3151,19,59,"CxG",8
27,"27055",1197,857,851,2,6,"CxG",31
36,"36051",14315,10396,10223,70,173,"CxG",15
27,"27038",923,688,677,12,11,"CxG",1
27,"27046",1448,1074,1063,7,11,"CxG",0
15,"15053",7548,5364,5309,44,55,"CxG",20
36,"36047",2287,1601,1585,14,16,"CxG",4
15,"15066",4008,2931,2886,30,45,"CxG",4
32,"32085",10634,7655,7551,66,104,"CxG",6
32,"32065",630,478,474,5,4,"CxG",5
36,"36006",11468,8959,8782,66,177,"CxG",10
32,"32064",480,348,346,2,2,"CxG",0
27,"27043",1219,814,797,6,17,"CxG",14
32,"32053",1363,1114,1098,14,16,"CxG",0
32,"32009",10590,7661,7574,68,87,"CxG",4
36,"36002",3076,2225,2185,19,40,"CxG",0
36,"36059",4663,3196,3115,31,81,"CxG",6
15,"15035",11208,8175,8068,105,107,"CxG",16
32,"32026",2659,1988,1957,26,31,"CxG",1
32,"32033",676,480,468,4,12,"CxG",0
15,"15901",3359,2237,2205,35,32,"CxG",3
36,"36056",4961,3719,3635,30,84,"CxG",8
27,"27052",862,645,640,4,5,"CxG",0
36,"36061",8617,6498,6391,59,107,"CxG",9
27,"27019",8189,6148,6039,94,109,"CxG",8
36,"36015",4076,2903,2834,37,69,"CxG",6
6,"6131",1063,880,874,5,6,"DP",0
6,"6014",6535,4757,4679,36,78,"DP",2
6,"6060",5723,4401,4323,31,78,"DP",1
6,"6157",397,296,292,1,4,"DP",0
6,"6148",957,762,746,12,16,"DP",1
6,"6086",1174,869,862,4,7,"DP",0
6,"6116",1512,1158,1144,3,14,"DP",0
6,"6154",2799,2075,2022,15,53,"DP",1
6,"6118",157,125,125,1,0,"DP",0
6,"6050",4042,3246,3163,27,83,"DP",2
6,"6096",207,168,167,1,1,"DP",0
6,"6149",10203,8194,8051,72,143,"DP",53
6,"6124",1656,1323,1296,5,27,"DP",1
6,"6017",257,211,210,1,1,"DP",0
6,"6117",1401,1089,1067,6,22,"DP",0
6,"6066",1725,1297,1286,9,11,"DP",0
6,"6071",238,197,193,0,4,"DP",0
6,"6132",829,598,593,0,5,"DP",0
6,"6040",987,747,739,6,8,"DP",0
6,"6155",1825,1316,1292,21,24,"DP",2
6,"6103",4753,3656,3598,35,58,"DP",0
6,"6058",1980,1519,1493,13,26,"DP",1
6,"6097",2283,1803,1762,10,41,"DP",0
6,"6016",2943,2283,2247,24,36,"DP",1
6,"6062",576,435,430,0,5,"DP",0
6,"6009",228,190,187,2,3,"DP",0
6,"6099",1162,833,813,6,20,"DP",0
6,"6158",13362,10282,10112,73,170,"DP",6
6,"6049",974,732,712,7,20,"DP",0
6,"6027",645,572,568,0,4,"DP",0
6,"6135",1096,915,902,3,13,"DP",0
6,"6079",644,492,487,3,5,"DP",1
6,"6020",1739,1420,1387,5,33,"DP",0
6,"6082",393,314,305,5,9,"DP",0
6,"6152",1285,952,935,4,17,"DP",0
6,"6003",766,625,610,3,15,"DP",0
6,"6032",78,65,64,0,1,"DP",0
6,"6085",3410,2719,2663,28,56,"DP",0
6,"6125",1679,1348,1324,5,24,"DP",2
6,"6026",815,661,653,5,8,"DP",0
6,"6106",413,267,263,3,4,"DP",0
6,"6033",1269,1026,1010,4,16,"DP",0
6,"6151",1054,791,778,2,13,"DP",0
6,"6051",1543,1206,1188,3,18,"DP",1
6,"6147",338,262,258,2,4,"DP",0
6,"6083",46489,34360,33989,270,371,"DP",43
6,"6101",442,359,354,2,5,"DP",0
6,"6018",740,543,536,5,7,"DP",1
6,"6030",169,147,146,1,1,"DP",0
6,"6107",1570,1117,1106,9,11,"DP",0
6,"6041",457,381,374,5,7,"DP",0
6,"6052",3969,3043,2970,21,73,"DP",0
6,"6903",2027,1607,1594,16,13,"DP",1
6,"6100",852,681,677,3,4,"DP",1
6,"6025",5096,3981,3904,28,77,"DP",3
6,"6102",1019,852,842,2,10,"DP",0
6,"6145",899,744,723,1,21,"DP",2
6,"6075",475,379,369,2,10,"DP",0
6,"6121",3268,2558,2531,26,27,"DP",2
6,"6091",3668,2839,2776,26,63,"DP",0
6,"6081",1042,825,811,4,14,"DP",0
6,"6902",1663,1273,1252,4,21,"DP",0
6,"6056",454,378,376,1,2,"DP",0
6,"6090",824,602,578,4,24,"DP",0
6,"6122",6562,4837,4723,43,114,"DP",3
6,"6130",186,159,154,0,5,"DP",1
6,"6022",2634,2156,2112,7,44,"DP",1
6,"6139",502,429,421,5,8,"DP",0
6,"6092",555,428,419,3,9,"DP",0
6,"6162",2895,2289,2254,11,35,"DP",0
6,"6069",3005,2172,2133,24,39,"DP",0
6,"6042",981,714,705,4,9,"DP",1
6,"6002",4314,3181,3086,44,95,"DP",2
6,"6153",20240,15464,15210,134,254,"DP",9
6,"6036",4958,3785,3728,22,57,"DP",2
6,"6078",506,415,410,1,5,"DP",0
6,"6133",1799,1476,1453,12,23,"DP",1
6,"6109",3843,3228,3106,26,122,"DP",1
6,"6029",1183,946,935,12,11,"DP",0
6,"6047",837,677,669,6,8,"DP",0
6,"6113",2677,2117,2076,13,41,"DP",1
6,"6120",3373,2757,2719,10,38,"DP",3
6,"6043",686,553,544,6,9,"DP",1
6,"6119",681,551,547,1,4,"DP",0
6,"6901",2117,1686,1655,17,31,"DP",1
6,"6038",790,583,574,4,9,"DP",0
6,"6065",298,258,255,1,3,"DP",0
6,"6137",933,730,723,5,7,"DP",0
6,"6127",2809,2285,2258,13,27,"DP",0
6,"6129",573,455,451,2,4,"DP",0
6,"6074",4755,3719,3638,27,81,"DP",3
6,"6140",611,515,506,1,9,"DP",0
6,"6008",613,540,532,0,8,"DP",1
6,"6054",5454,4329,4190,46,139,"DP",3
6,"6126",2142,1619,1594,9,25,"DP",2
6,"6037",1668,1137,1125,6,12,"DP",2
6,"6053",590,461,444,7,17,"DP",0
6,"6094",1459,1017,1008,8,9,"DP",0
6,"6064",850,658,647,2,11,"DP",0
6,"6084",1065,904,890,8,14,"DP",1
6,"6063",2938,2299,2264,11,35,"DP",2
6,"6104",656,530,524,6,6,"DP",1
6,"6045",476,368,362,3,6,"DP",0
6,"6144",512,422,416,1,6,"DP",0
6,"6108",2249,1726,1684,22,42,"DP",1
6,"6141",1688,1308,1291,16,17,"DP",2
6,"6089",608,524,519,3,5,"DP",0
6,"6110",137,106,105,0,1,"DP",0
6,"6028",4109,3613,3538,17,75,"DP",1
6,"6021",908,708,698,9,10,"DP",0
6,"6087",2030,1592,1571,16,21,"DP",0
6,"6059",1759,1300,1285,12,15,"DP",1
6,"6057",537,442,433,1,9,"DP",1
6,"6093",4345,3356,3281,18,75,"DP",0
6,"6019",2012,1539,1495,14,44,"DP",0
6,"6123",4512,3358,3266,28,92,"DP",1
6,"6001",659,539,534,7,5,"DP",0
6,"6055",1998,1552,1523,9,29,"DP",1
6,"6095",9511,7338,7152,116,186,"DP",2
6,"6161",288,226,222,1,4,"DP",0
6,"6080",1890,1482,1467,18,15,"DP",1
6,"6044",29204,21778,21492,203,286,"DP",6
6,"6024",1133,963,941,5,22,"DP",1
6,"6159",2339,1577,1507,25,70,"DP",0
6,"6146",1048,837,819,4,18,"DP",0
6,"6111",493,374,370,2,4,"DP",0
6,"6046",1250,1010,995,7,15,"DP",0
6,"6115",1243,898,876,3,22,"DP",7
6,"6034",167,115,115,1,0,"DP",0
6,"6048",824,714,702,2,12,"DP",0
6,"6011",24665,18486,18253,178,233,"DP",17
6,"6136",1510,1189,1160,7,29,"DP",0
6,"6015",117934,87081,86114,785,967,"DP",82
6,"6134",530,337,331,3,6,"DP",0
6,"6061",1084,915,905,8,10,"DP",0
6,"6143",3370,2635,2589,23,46,"DP",0
6,"6072",2225,1777,1752,20,25,"DP",0
6,"6150",780,637,635,2,2,"DP",0
6,"6006",4494,3395,3325,24,70,"DP",2
6,"6105",604,406,400,2,6,"DP",0
6,"6023",4170,3088,3045,18,43,"DP",2
6,"6098",534,421,411,8,10,"DP",0
6,"6013",265,227,221,0,6,"DP",0
6,"6005",1691,1246,1225,15,21,"DP",0
6,"6114",127,109,108,0,1,"DP",0
6,"6138",1013,783,767,3,16,"DP",0
6,"6076",824,631,620,0,11,"DP",0
6,"6128",4415,3345,3288,34,57,"DP",0
6,"6088",12505,9311,9140,93,171,"DP",4
6,"6067",1915,1393,1370,7,23,"DP",0
6,"6010",1075,859,846,8,13,"DP",0
6,"6112",383,334,334,1,0,"DP",0
6,"6156",1171,919,901,10,18,"DP",0
6,"6160",3019,2252,2209,10,43,"DP",3
6,"6004",1549,1276,1257,6,19,"DP",0
6,"6007",1433,1078,1071,5,7,"DP",0
6,"6077",321,260,256,4,4,"DP",0
6,"6012",3233,2515,2492,15,23,"DP",0
6,"6070",7686,6083,5948,44,135,"DP",3
6,"6031",461,316,301,1,15,"DP",0
6,"6035",865,678,670,4,8,"DP",0
6,"6073",700,506,492,11,14,"DP",0
6,"6039",1807,1506,1474,13,32,"DP",0
6,"6142",259,214,208,1,6,"DP",0
6,"6068",431,324,317,4,7,"DP",0
30,"30007",6484,4774,4727,25,47,"DPL",1
30,"30042",2180,1727,1703,6,24,"DPL",1
30,"30010",6857,5533,5457,38,76,"DPL",5
30,"30016",152709,110165,109114,717,1051,"DPL",106
30,"30035",19268,14248,14103,92,145,"DPL",4
30,"30020",6431,4991,4940,19,51,"DPL",0
30,"30009",12689,10036,9909,50,127,"DPL",7
30,"30006",829,731,727,4,4,"DPL",0
30,"30026",16252,11142,10977,65,165,"DPL",3
30,"30005",30193,22648,22419,136,229,"DPL",6
30,"30030",320172,249965,247884,1497,2081,"DPL",192
30,"30902",8225,5797,5715,22,82,"DPL",3
30,"30032",2851,2256,2218,14,38,"DPL",0
30,"30028",6400,4364,4289,30,75,"DPL",0
30,"30033",10363,8115,7979,54,136,"DPL",7
30,"30013",7467,5621,5553,26,68,"DPL",1
30,"30018",8326,6544,6438,25,106,"DPL",3
30,"30040",705,600,596,1,4,"DPL",1
30,"30038",15674,11755,11675,59,80,"DPL",5
30,"30024",60183,45738,45317,290,421,"DPL",19
30,"30001",4539,3615,3567,16,48,"DPL",0
30,"30041",13970,9796,9682,80,114,"DPL",9
30,"30022",17056,12158,11954,126,204,"DPL",5
30,"30004",1126,884,876,5,8,"DPL",2
30,"30029",12055,9003,8882,58,121,"DPL",7
30,"30039",20191,14552,14380,96,172,"DPL",8
30,"30008",14450,10832,10675,60,157,"DPL",1
30,"30002",9735,7319,7227,33,92,"DPL",3
30,"30025",5001,3951,3898,27,53,"DPL",1
30,"30031",500,435,433,3,2,"DPL",1
30,"30036",15256,10884,10703,56,181,"DPL",8
30,"30021",9441,6664,6591,32,73,"DPL",25
30,"30014",1585,1226,1202,3,24,"DPL",0
30,"30901",10529,8488,8375,37,113,"DPL",6
30,"30011",4695,3665,3610,16,55,"DPL",1
30,"30017",11477,8952,8844,62,108,"DPL",3
30,"30003",25046,17860,17668,99,192,"DPL",6
30,"30027",49767,39111,38724,245,387,"DPL",24
30,"30015",19372,14430,14283,91,147,"DPL",2
30,"30043",25401,20378,19992,131,386,"DPL",4
30,"30023",3875,3107,3068,20,39,"DPL",4
30,"30037",19254,14416,14217,67,199,"DPL",7
30,"30034",1075,852,831,4,21,"DPL",0
30,"30012",9069,7397,7266,53,131,"DPL",4
30,"30019",25846,18755,18517,172,238,"DPL",5
20,"20069",147441,111102,110598,762,504,"EAJ-PNV",30921
1,"1034",150,111,111,2,0,"EAJ-PNV",50
48,"48090",6016,4700,4639,24,61,"EAJ-PNV",1887
1,"1002",8035,6227,6159,17,68,"EAJ-PNV",2148
48,"48905",2490,1911,1891,16,20,"EAJ-PNV",856
48,"48018",867,605,603,3,2,"EAJ-PNV",279
20,"20071",15036,11090,11025,59,65,"EAJ-PNV",4074
1,"1032",500,372,362,1,10,"EAJ-PNV",116
48,"48094",3125,2407,2388,12,19,"EAJ-PNV",1097
20,"20029",4272,3257,3239,18,18,"EAJ-PNV",1293
48,"48064",613,494,492,1,2,"EAJ-PNV",241
20,"20008",704,455,449,6,6,"EAJ-PNV",153
20,"20061",4392,3278,3264,11,14,"EAJ-PNV",1353
1,"1011",215,179,175,3,4,"EAJ-PNV",64
48,"48077",3376,2656,2647,11,9,"EAJ-PNV",1250
1,"1057",243,202,199,0,3,"EAJ-PNV",84
20,"20906",130,99,98,1,1,"EAJ-PNV",29
20,"20060",88,75,75,0,0,"EAJ-PNV",2
1,"1054",1013,729,726,2,3,"EAJ-PNV",205
48,"48057",5745,4391,4376,13,15,"EAJ-PNV",1933
20,"20001",257,174,172,1,2,"EAJ-PNV",76
20,"20031",183,125,125,2,0,"EAJ-PNV",50
48,"48036",24038,18180,18050,94,130,"EAJ-PNV",6435
48,"48021",1336,990,983,4,7,"EAJ-PNV",475
48,"48067",1134,877,872,5,5,"EAJ-PNV",388
20,"20021",186,112,112,0,0,"EAJ-PNV",45
1,"1053",592,376,373,2,3,"EAJ-PNV",122
1,"1044",231,171,166,0,5,"EAJ-PNV",46
48,"48069",13094,10021,9954,49,67,"EAJ-PNV",4791
48,"48907",340,283,281,1,2,"EAJ-PNV",170
20,"20058",739,555,551,4,4,"EAJ-PNV",164
48,"48033",204,160,159,1,1,"EAJ-PNV",78
48,"48063",356,277,274,2,3,"EAJ-PNV",123
20,"20011",1633,1297,1287,2,10,"EAJ-PNV",398
48,"48070",528,392,390,2,2,"EAJ-PNV",124
1,"1058",1403,958,951,4,7,"EAJ-PNV",263
48,"48904",3542,2832,2811,27,21,"EAJ-PNV",1324
1,"1017",816,579,574,2,5,"EAJ-PNV",202
1,"1018",1408,998,993,6,5,"EAJ-PNV",262
48,"48014",1242,915,910,4,5,"EAJ-PNV",367
20,"20051",6775,5124,5091,24,33,"EAJ-PNV",1558
48,"48079",395,313,312,2,1,"EAJ-PNV",142
48,"48011",9652,7293,7251,37,42,"EAJ-PNV",2380
20,"20023",446,299,299,1,0,"EAJ-PNV",95
48,"48053",904,738,728,5,10,"EAJ-PNV",400
20,"20043",1734,1254,1248,5,6,"EAJ-PNV",564
48,"48056",989,791,785,4,6,"EAJ-PNV",387
48,"48035",404,334,331,2,3,"EAJ-PNV",176
20,"20081",7655,5629,5601,22,28,"EAJ-PNV",1858
1,"1062",315,236,229,2,7,"EAJ-PNV",50
48,"48087",432,357,356,0,1,"EAJ-PNV",214
48,"48903",1807,1471,1462,6,9,"EAJ-PNV",844
20,"20034",3154,2336,2315,20,21,"EAJ-PNV",708
20,"20053",4848,3479,3451,27,28,"EAJ-PNV",781
20,"20048",184,120,120,2,0,"EAJ-PNV",29
1,"1020",320,239,238,1,1,"EAJ-PNV",82
48,"48023",580,493,489,0,4,"EAJ-PNV",225
48,"48038",1158,891,891,2,0,"EAJ-PNV",461
48,"48084",21858,15943,15796,116,147,"EAJ-PNV",4081
20,"20075",4346,3158,3134,19,24,"EAJ-PNV",945
20,"20007",327,235,230,2,5,"EAJ-PNV",63
20,"20074",11503,8767,8720,26,47,"EAJ-PNV",2925
20,"20004",227,156,154,4,2,"EAJ-PNV",82
1,"1061",152,129,129,2,0,"EAJ-PNV",38
48,"48041",686,581,579,2,2,"EAJ-PNV",321
48,"48051",216,157,157,0,0,"EAJ-PNV",71
48,"48046",12644,9809,9744,46,65,"EAJ-PNV",4431
48,"48013",79423,59100,58630,458,470,"EAJ-PNV",14657
48,"48912",2331,1843,1833,7,10,"EAJ-PNV",756
48,"48025",860,694,694,3,0,"EAJ-PNV",339
48,"48032",5773,4504,4476,5,28,"EAJ-PNV",1468
20,"20073",4698,3530,3515,29,15,"EAJ-PNV",819
1,"1009",1265,920,914,6,6,"EAJ-PNV",244
48,"48059",400,329,325,0,4,"EAJ-PNV",148
20,"20013",5430,4144,4119,19,25,"EAJ-PNV",1394
1,"1056",205,134,134,0,0,"EAJ-PNV",72
1,"1036",14772,10850,10746,69,104,"EAJ-PNV",3226
20,"20035",484,384,384,2,0,"EAJ-PNV",145
48,"48006",309,265,265,0,0,"EAJ-PNV",101
48,"48010",474,368,368,0,0,"EAJ-PNV",193
48,"48060",3620,2615,2606,13,9,"EAJ-PNV",1258
48,"48910",2802,2082,2073,3,9,"EAJ-PNV",656
20,"20068",188,142,142,1,0,"EAJ-PNV",42
20,"20022",854,621,621,7,0,"EAJ-PNV",252
1,"1016",421,236,229,3,7,"EAJ-PNV",77
20,"20028",2258,1579,1574,9,5,"EAJ-PNV",407
1,"1004",1356,1007,998,3,9,"EAJ-PNV",359
1,"1047",967,686,673,8,13,"EAJ-PNV",128
20,"20080",7709,5629,5588,28,41,"EAJ-PNV",1417
20,"20020",113,67,67,0,0,"EAJ-PNV",28
48,"48074",3273,2480,2460,14,20,"EAJ-PNV",1001
48,"48044",62054,49055,48840,373,215,"EAJ-PNV",17981
48,"48016",5437,4282,4248,21,34,"EAJ-PNV",1587
48,"48089",3463,2746,2732,10,14,"EAJ-PNV",1154
20,"20902",14229,10567,10495,53,72,"EAJ-PNV",1972
48,"48073",6837,4950,4921,33,29,"EAJ-PNV",1756
48,"48002",7777,6034,5981,48,53,"EAJ-PNV",1920
20,"20014",1156,772,765,4,7,"EAJ-PNV",217
1,"1030",143,118,117,1,1,"EAJ-PNV",39
48,"48092",869,676,674,9,2,"EAJ-PNV",355
20,"20063",8061,6042,5999,36,43,"EAJ-PNV",1485
48,"48012",2071,1685,1674,7,11,"EAJ-PNV",823
20,"20045",46866,33932,33700,191,232,"EAJ-PNV",7423
1,"1027",430,295,293,2,2,"EAJ-PNV",111
48,"48097",1316,979,976,4,3,"EAJ-PNV",343
1,"1014",366,283,277,7,6,"EAJ-PNV",85
1,"1042",907,723,721,4,2,"EAJ-PNV",320
48,"48915",347,259,259,4,0,"EAJ-PNV",98
48,"48088",133,99,98,2,1,"EAJ-PNV",23
1,"1022",761,577,569,5,8,"EAJ-PNV",117
48,"48058",946,724,715,3,9,"EAJ-PNV",263
20,"20904",89,50,49,0,1,"EAJ-PNV",8
20,"20038",380,296,295,0,1,"EAJ-PNV",126
1,"1059",189037,133121,131768,792,1353,"EAJ-PNV",26498
48,"48008",615,454,448,4,6,"EAJ-PNV",233
1,"1051",3558,2448,2433,14,15,"EAJ-PNV",729
20,"20079",18142,14055,13971,75,84,"EAJ-PNV",5463
20,"20036",13192,9864,9806,67,58,"EAJ-PNV",4022
48,"48009",772,628,622,2,6,"EAJ-PNV",246
20,"20065",2943,2145,2124,11,21,"EAJ-PNV",610
1,"1006",176,127,127,2,0,"EAJ-PNV",21
20,"20010",1528,1156,1151,5,5,"EAJ-PNV",284
48,"48017",13150,9546,9504,38,42,"EAJ-PNV",4908
1,"1046",631,464,461,0,3,"EAJ-PNV",159
20,"20018",11218,8145,8109,41,36,"EAJ-PNV",3377
48,"48061",799,636,636,2,0,"EAJ-PNV",326
48,"48909",202,172,172,2,0,"EAJ-PNV",65
48,"48019",3461,2647,2633,12,14,"EAJ-PNV",882
20,"20026",204,182,159,3,23,"EAJ-PNV",72
48,"48076",284,226,224,1,2,"EAJ-PNV",141
20,"20072",4752,3445,3412,24,33,"EAJ-PNV",1001
20,"20076",7025,5263,5237,31,26,"EAJ-PNV",1591
20,"20041",234,156,151,2,5,"EAJ-PNV",66
48,"48078",37991,28582,28382,202,200,"EAJ-PNV",7507
20,"20046",1248,918,909,11,9,"EAJ-PNV",299
1,"1013",703,491,487,2,4,"EAJ-PNV",152
1,"1021",469,333,330,1,3,"EAJ-PNV",111
20,"20024",391,274,274,1,0,"EAJ-PNV",87
1,"1902",730,551,545,6,6,"EAJ-PNV",139
48,"48093",888,720,715,2,5,"EAJ-PNV",296
48,"48085",10637,8270,8223,54,47,"EAJ-PNV",3248
1,"1019",148,121,121,0,0,"EAJ-PNV",75
20,"20067",30618,21972,21854,138,118,"EAJ-PNV",3819
1,"1033",656,533,525,1,8,"EAJ-PNV",218
20,"20003",551,401,399,2,2,"EAJ-PNV",111
20,"20059",8867,6792,6759,21,33,"EAJ-PNV",2483
48,"48052",1567,1309,1300,4,9,"EAJ-PNV",478
48,"48031",308,236,236,0,0,"EAJ-PNV",126
48,"48001",5885,4359,4334,35,25,"EAJ-PNV",1192
20,"20062",945,727,726,3,1,"EAJ-PNV",290
48,"48040",1309,979,973,5,6,"EAJ-PNV",505
20,"20047",462,337,335,2,2,"EAJ-PNV",91
48,"48007",385,281,279,1,2,"EAJ-PNV",123
48,"48026",1139,920,913,4,7,"EAJ-PNV",363
48,"48906",753,611,608,1,3,"EAJ-PNV",312
48,"48055",2596,2023,2005,12,18,"EAJ-PNV",805
20,"20050",270,186,183,3,3,"EAJ-PNV",69
48,"48908",249,214,213,0,1,"EAJ-PNV",113
48,"48071",6038,4711,4674,27,37,"EAJ-PNV",1677
48,"48911",388,323,322,3,1,"EAJ-PNV",119
20,"20037",103,77,77,0,0,"EAJ-PNV",36
48,"48037",684,537,531,4,6,"EAJ-PNV",250
20,"20064",12436,8730,8652,59,78,"EAJ-PNV",1951
48,"48039",256,218,217,1,1,"EAJ-PNV",106
48,"48015",33109,24697,24475,161,222,"EAJ-PNV",7528
1,"1063",1830,1363,1353,4,10,"EAJ-PNV",420
48,"48048",543,421,419,1,2,"EAJ-PNV",209
48,"48042",1365,1136,1130,7,6,"EAJ-PNV",614
20,"20057",194,143,143,0,0,"EAJ-PNV",39
48,"48072",970,735,730,1,5,"EAJ-PNV",278
20,"20006",254,169,169,0,0,"EAJ-PNV",63
1,"1037",585,426,425,1,1,"EAJ-PNV",163
48,"48083",6946,5238,5201,35,37,"EAJ-PNV",1423
20,"20066",439,327,326,0,1,"EAJ-PNV",97
48,"48045",5194,4138,4098,25,40,"EAJ-PNV",1726
48,"48075",2067,1591,1565,11,26,"EAJ-PNV",769
20,"20015",1237,975,967,8,8,"EAJ-PNV",322
48,"48080",9946,7574,7499,46,75,"EAJ-PNV",2215
48,"48913",1224,977,967,6,10,"EAJ-PNV",452
1,"1001",2005,1438,1419,4,19,"EAJ-PNV",394
48,"48086",2015,1504,1486,6,18,"EAJ-PNV",590
48,"48096",6510,5247,5185,36,62,"EAJ-PNV",2439
48,"48004",326,261,260,3,1,"EAJ-PNV",131
48,"48054",24938,19329,19197,124,132,"EAJ-PNV",6687
20,"20030",21198,15734,15654,100,80,"EAJ-PNV",4173
48,"48024",999,813,811,2,2,"EAJ-PNV",418
1,"1031",1163,948,928,6,20,"EAJ-PNV",212
48,"48091",1090,862,857,9,5,"EAJ-PNV",338
48,"48095",2326,1691,1680,11,11,"EAJ-PNV",473
1,"1901",2474,1655,1631,13,24,"EAJ-PNV",314
48,"48047",149,115,115,1,0,"EAJ-PNV",38
1,"1023",262,210,206,3,4,"EAJ-PNV",67
20,"20044",364,263,262,0,1,"EAJ-PNV",69
20,"20077",5254,4083,4059,22,24,"EAJ-PNV",1436
48,"48066",347,291,291,0,0,"EAJ-PNV",173
48,"48062",293,247,245,0,2,"EAJ-PNV",133
1,"1055",840,608,602,10,6,"EAJ-PNV",194
20,"20049",4159,3024,3004,11,20,"EAJ-PNV",951
20,"20033",854,675,671,5,4,"EAJ-PNV",238
20,"20005",1267,884,882,2,2,"EAJ-PNV",282
20,"20032",8681,6491,6429,22,62,"EAJ-PNV",2367
48,"48020",272959,203643,202331,1472,1312,"EAJ-PNV",67625
1,"1049",132,100,100,1,0,"EAJ-PNV",46
48,"48082",37396,27913,27694,172,219,"EAJ-PNV",7727
48,"48028",691,576,573,1,3,"EAJ-PNV",253
20,"20017",8484,6294,6263,25,31,"EAJ-PNV",2524
20,"20903",4803,3514,3481,24,33,"EAJ-PNV",970
48,"48043",4539,3566,3556,22,10,"EAJ-PNV",1699
20,"20012",148,113,112,0,1,"EAJ-PNV",47
20,"20070",1083,831,823,2,8,"EAJ-PNV",360
20,"20040",15753,11440,11364,69,76,"EAJ-PNV",2398
20,"20002",355,258,257,8,1,"EAJ-PNV",76
20,"20019",9912,7226,7195,51,31,"EAJ-PNV",2641
20,"20039",2144,1704,1692,11,12,"EAJ-PNV",697
1,"1003",1179,908,903,6,5,"EAJ-PNV",285
20,"20042",3172,2247,2231,9,16,"EAJ-PNV",649
48,"48034",12639,9519,9443,77,76,"EAJ-PNV",1679
20,"20055",17378,12565,12482,55,83,"EAJ-PNV",3582
1,"1010",2315,1789,1770,14,19,"EAJ-PNV",741
20,"20054",459,313,312,1,1,"EAJ-PNV",58
20,"20907",117,88,87,0,1,"EAJ-PNV",32
48,"48022",2316,1645,1631,11,14,"EAJ-PNV",914
20,"20027",2758,1980,1958,19,22,"EAJ-PNV",724
1,"1008",802,576,570,3,6,"EAJ-PNV",164
48,"48005",113,80,80,0,0,"EAJ-PNV",34
48,"48065",3303,2541,2524,15,17,"EAJ-PNV",967
20,"20025",1116,835,830,2,5,"EAJ-PNV",346
48,"48068",1528,1218,1211,5,7,"EAJ-PNV",697
20,"20078",1145,882,879,4,3,"EAJ-PNV",187
48,"48030",601,490,489,0,1,"EAJ-PNV",255
1,"1043",2337,1669,1656,18,13,"EAJ-PNV",233
48,"48029",8613,6697,6642,52,55,"EAJ-PNV",1940
48,"48050",187,153,149,0,4,"EAJ-PNV",59
1,"1060",201,174,166,1,8,"EAJ-PNV",52
48,"48049",545,448,448,0,0,"EAJ-PNV",227
20,"20016",1524,997,997,1,0,"EAJ-PNV",472
20,"20056",4075,2983,2942,12,41,"EAJ-PNV",1175
20,"20052",1070,833,827,2,6,"EAJ-PNV",277
1,"1039",195,157,153,0,4,"EAJ-PNV",44
48,"48901",5151,4042,4012,22,30,"EAJ-PNV",1413
48,"48914",325,286,285,0,1,"EAJ-PNV",160
20,"20901",1412,1034,1030,2,4,"EAJ-PNV",406
48,"48027",22668,17326,17224,95,102,"EAJ-PNV",6328
20,"20009",11343,8168,8106,46,62,"EAJ-PNV",1833
48,"48003",14444,11233,11162,43,71,"EAJ-PNV",4440
1,"1052",268,188,187,1,1,"EAJ-PNV",66
48,"48902",18971,14015,13895,101,120,"EAJ-PNV",4601
20,"20905",153,124,124,1,0,"EAJ-PNV",40
48,"48081",1883,1532,1518,3,14,"EAJ-PNV",820
1,"1028",1068,774,772,7,2,"EAJ-PNV",167
1,"1041",152,107,103,2,4,"EAJ-PNV",29
22,"22040",144,124,120,1,4,"EB",0
4,"4054",352,280,278,2,2,"EB",2
39,"39008",13900,10895,10767,81,128,"EB",10
39,"39062",1841,1511,1500,9,11,"EB",1
22,"22901",714,521,508,3,13,"EB",0
44,"44041",58,48,44,1,4,"EB",0
26,"26054",292,235,231,2,4,"EB",1
44,"44044",83,65,64,2,1,"EB",0
14,"14068",516,405,400,1,5,"EB",1
50,"50007",49,34,34,0,0,"EB",0
22,"22107",100,68,67,0,1,"EB",0
50,"50131",210,157,156,0,1,"EB",0
50,"50156",209,174,171,1,3,"EB",0
22,"22213",2923,2261,2221,24,40,"EB",5
50,"50193",663,536,516,1,20,"EB",3
44,"44219",173,142,136,1,6,"EB",0
50,"50064",438,368,362,1,6,"EB",1
39,"39075",136968,104358,103487,690,871,"EB",124
50,"50091",40,35,35,0,0,"EB",0
22,"22032",107,74,74,2,0,"EB",1
14,"14037",3182,2388,2319,22,69,"EB",4
14,"14008",2785,1942,1910,15,32,"EB",2
26,"26067",20,19,19,0,0,"EB",0
50,"50078",231,173,171,0,2,"EB",0
22,"22129",163,117,116,0,1,"EB",0
22,"22195",234,193,192,0,1,"EB",0
50,"50068",1947,1402,1389,11,13,"EB",4
4,"4067",520,387,379,1,8,"EB",1
26,"26047",1879,1569,1549,10,20,"EB",1
50,"50262",1163,930,912,15,18,"EB",1
22,"22197",439,356,353,10,3,"EB",0
44,"44234",70,57,57,1,0,"EB",1
26,"26088",41,38,38,0,0,"EB",0
26,"26046",1571,1185,1157,18,28,"EB",1
44,"44158",1166,921,904,7,17,"EB",1
26,"26093",48,38,38,0,0,"EB",0
50,"50177",276,226,223,0,3,"EB",0
50,"50147",751,564,559,3,5,"EB",1
44,"44146",170,148,146,3,2,"EB",1
39,"39078",1406,1101,1090,7,11,"EB",0
44,"44113",72,51,50,0,1,"EB",0
22,"22025",1035,764,755,24,9,"EB",4
44,"44267",71,53,52,0,1,"EB",0
50,"50015",81,61,59,1,2,"EB",0
44,"44017",272,221,219,0,2,"EB",0
50,"50253",382,318,315,2,3,"EB",1
26,"26051",210,178,176,1,2,"EB",0
26,"26132",106,87,87,0,0,"EB",0
26,"26035",16,14,13,0,1,"EB",0
44,"44127",57,45,45,0,0,"EB",0
22,"22182",233,178,174,1,4,"EB",0
50,"50110",336,268,266,1,2,"EB",0
44,"44046",43,32,32,0,0,"EB",0
39,"39092",871,635,629,2,6,"EB",0
22,"22006",272,206,201,2,5,"EB",1
50,"50118",2110,1622,1605,19,17,"EB",2
4,"4083",1740,1342,1326,4,16,"EB",0
14,"14009",2669,1863,1844,19,19,"EB",1
39,"39097",679,437,435,2,2,"EB",0
39,"39047",1976,1564,1538,8,26,"EB",3
50,"50154",116,98,98,0,0,"EB",0
4,"4088",2435,1708,1693,6,15,"EB",1
4,"4046",848,653,649,5,4,"EB",1
26,"26039",38,34,34,0,0,"EB",0
22,"22193",269,220,217,2,3,"EB",0
44,"44097",126,91,90,2,1,"EB",0
50,"50238",86,66,66,2,0,"EB",0
39,"39050",255,188,184,2,4,"EB",0
22,"22055",310,258,255,2,3,"EB",1
22,"22226",771,598,591,6,7,"EB",0
44,"44025",5825,4337,4197,50,140,"EB",21
50,"50268",42,33,32,1,1,"EB",0
50,"50264",147,122,120,0,2,"EB",0
22,"22200",239,181,178,0,3,"EB",1
50,"50153",922,705,704,6,1,"EB",1
4,"4014",149,109,108,0,1,"EB",1
26,"26120",1460,1130,1109,3,21,"EB",2
26,"26146",86,69,69,1,0,"EB",0
50,"50283",69,53,52,3,1,"EB",0
44,"44006",223,171,169,2,2,"EB",1
14,"14034",304,246,239,1,7,"EB",0
22,"22186",191,165,164,2,1,"EB",1
50,"50057",1332,1001,986,10,15,"EB",2
22,"22143",197,134,132,1,2,"EB",0
14,"14011",572,498,495,5,3,"EB",0
50,"50192",233,189,183,0,6,"EB",0
44,"44013",11250,8525,8420,95,105,"EB",24
4,"4023",120,95,95,2,0,"EB",0
50,"50065",55,43,43,1,0,"EB",0
50,"50902",79,69,69,0,0,"EB",0
44,"44070",55,45,45,0,0,"EB",0
26,"26119",177,150,147,2,3,"EB",1
26,"26100",56,46,46,0,0,"EB",0
44,"44118",158,126,122,1,4,"EB",0
50,"50151",603,490,489,3,1,"EB",3
26,"26031",98,89,87,0,2,"EB",0
14,"14046",4443,3550,3486,38,64,"EB",1
22,"22902",208,160,156,0,4,"EB",0
14,"14026",2014,1502,1474,10,28,"EB",4
44,"44014",2499,2015,1963,25,52,"EB",13
50,"50279",73,61,60,2,1,"EB",0
26,"26152",27,23,23,1,0,"EB",0
39,"39017",553,416,409,0,7,"EB",0
39,"39083",1074,786,777,4,9,"EB",2
22,"22068",65,46,44,1,2,"EB",0
44,"44228",99,83,83,0,0,"EB",0
22,"22067",71,52,52,0,0,"EB",2
26,"26065",58,49,47,0,2,"EB",0
22,"22041",152,121,119,2,2,"EB",0
14,"14007",15042,10970,10758,86,212,"EB",16
4,"4078",1110,819,814,2,5,"EB",1
44,"44249",46,37,37,1,0,"EB",0
50,"50044",222,161,161,3,0,"EB",1
50,"50061",193,173,169,1,4,"EB",0
4,"4005",533,448,442,0,6,"EB",0
26,"26149",45,36,36,0,0,"EB",0
22,"22028",362,284,282,5,2,"EB",0
26,"26079",620,526,521,0,5,"EB",0
4,"4086",1643,1226,1209,6,17,"EB",0
50,"50140",157,108,108,0,0,"EB",0
39,"39082",1622,1261,1252,16,9,"EB",1
4,"4079",54086,38415,38134,239,281,"EB",63
50,"50220",43,37,37,0,0,"EB",0
4,"4904",1879,1328,1322,4,6,"EB",5
26,"26055",39,35,35,1,0,"EB",0
44,"44125",65,50,50,0,0,"EB",0
26,"26151",411,353,351,3,2,"EB",2
44,"44189",48,36,36,0,0,"EB",0
50,"50267",573,440,434,7,6,"EB",3
50,"50297",502835,394653,391387,3269,3266,"EB",2046
50,"50189",678,544,534,5,10,"EB",0
14,"14016",1283,1005,994,4,11,"EB",1
39,"39009",3307,2545,2526,11,19,"EB",1
44,"44261",722,584,578,8,6,"EB",1
50,"50028",77,59,58,1,1,"EB",0
50,"50009",97,72,71,1,1,"EB",0
50,"50085",183,136,136,1,0,"EB",0
44,"44122",1284,995,984,15,11,"EB",2
22,"22052",885,708,702,6,6,"EB",1
22,"22081",243,187,186,0,1,"EB",0
22,"22905",287,226,224,2,2,"EB",0
50,"50050",86,65,65,1,0,"EB",0
44,"44237",368,299,293,2,6,"EB",1
14,"14060",3694,2878,2798,26,80,"EB",4
22,"22174",462,381,377,0,4,"EB",0
22,"22049",74,63,63,0,0,"EB",1
4,"4102",14110,9871,9765,90,106,"EB",13
44,"44265",181,153,148,1,5,"EB",0
50,"50197",96,78,78,1,0,"EB",0
26,"26168",5515,4130,4077,36,53,"EB",7
22,"22088",143,111,111,1,0,"EB",0
22,"22110",707,531,528,2,3,"EB",1
44,"44258",53,44,44,0,0,"EB",0
26,"26096",260,221,212,2,9,"EB",2
50,"50026",421,340,328,4,12,"EB",0
14,"14051",1348,1064,1048,7,16,"EB",0
44,"44042",114,84,84,0,0,"EB",0
22,"22064",162,121,121,0,0,"EB",0
44,"44221",384,320,315,2,5,"EB",1
44,"44037",449,334,331,1,3,"EB",1
4,"4095",690,508,502,2,6,"EB",2
50,"50002",125,96,91,1,5,"EB",0
4,"4050",751,522,519,1,3,"EB",1
39,"39024",1815,1436,1420,14,16,"EB",5
39,"39014",901,709,704,5,5,"EB",1
50,"50074",6166,4547,4444,33,103,"EB",18
50,"50196",102,83,81,2,2,"EB",1
4,"4018",252,215,213,1,2,"EB",2
44,"44089",52,44,44,0,0,"EB",0
26,"26103",827,655,645,3,10,"EB",0
26,"26036",17013,12543,12354,95,189,"EB",32
44,"44144",325,249,247,1,2,"EB",0
50,"50184",90,79,79,0,0,"EB",0
14,"14066",5756,4396,4310,36,86,"EB",1
22,"22077",362,301,293,3,8,"EB",0
50,"50256",74,46,45,0,1,"EB",0
50,"50162",137,112,110,2,2,"EB",0
39,"39046",1343,1002,988,8,14,"EB",0
50,"50084",66,47,47,0,0,"EB",0
50,"50294",64,49,47,0,2,"EB",0
22,"22105",101,82,82,4,0,"EB",1
50,"50270",38,32,30,1,2,"EB",0
50,"50047",43,32,31,1,1,"EB",0
50,"50066",2835,2199,2177,19,22,"EB",6
4,"4073",336,243,243,0,0,"EB",0
50,"50120",55,43,43,2,0,"EB",0
44,"44207",130,101,101,1,0,"EB",0
50,"50273",32,24,24,0,0,"EB",0
14,"14040",3755,3047,3006,21,41,"EB",4
22,"22099",465,365,362,3,3,"EB",0
39,"39045",351,280,277,1,3,"EB",2
44,"44218",31,25,25,2,0,"EB",0
26,"26167",50,38,38,1,0,"EB",1
44,"44200",39,25,25,0,0,"EB",0
22,"22142",94,80,80,2,0,"EB",0
14,"14075",557,429,411,5,18,"EB",1
44,"44085",49,31,31,0,0,"EB",0
44,"44205",634,444,426,9,18,"EB",1
14,"14035",5817,4373,4314,44,59,"EB",7
50,"50096",36,22,22,0,0,"EB",0
50,"50246",38,28,28,0,0,"EB",0
22,"22244",46,37,37,2,0,"EB",0
50,"50179",264,231,228,0,3,"EB",0
44,"44020",22,18,18,0,0,"EB",0
50,"50021",25,23,23,1,0,"EB",0
26,"26084",7187,5620,5558,36,62,"EB",13
14,"14022",3886,3080,3043,18,37,"EB",2
4,"4064",2879,2196,2179,12,17,"EB",1
50,"50008",5185,3753,3711,35,42,"EB",18
22,"22202",145,127,126,0,1,"EB",0
44,"44077",74,55,54,0,1,"EB",0
50,"50257",163,136,134,1,2,"EB",0
44,"44196",125,96,95,2,1,"EB",0
44,"44175",113,84,82,1,2,"EB",0
26,"26112",223,177,174,0,3,"EB",0
50,"50260",32,28,28,0,0,"EB",0
22,"22151",88,66,65,0,1,"EB",0
50,"50152",1368,1061,1043,6,18,"EB",2
44,"44034",126,97,97,2,0,"EB",0
4,"4098",1455,1097,1087,9,10,"EB",1
22,"22212",70,56,56,0,0,"EB",0
22,"22232",87,66,65,2,1,"EB",1
50,"50063",61,54,54,0,0,"EB",0
26,"26037",131,99,98,1,1,"EB",0
26,"26074",107,97,96,2,1,"EB",0
50,"50004",478,380,376,2,4,"EB",0
44,"44145",972,741,732,11,9,"EB",6
14,"14023",2007,1734,1711,9,23,"EB",1
14,"14010",4001,3106,3068,15,38,"EB",6
44,"44068",643,518,511,9,7,"EB",1
44,"44173",102,85,80,0,5,"EB",0
22,"22217",372,296,290,5,6,"EB",1
39,"39101",236,173,171,1,2,"EB",0
44,"44012",310,240,238,5,2,"EB",1
44,"44235",89,67,66,2,1,"EB",0
50,"50092",300,234,230,1,4,"EB",1
39,"39057",2367,1831,1796,14,35,"EB",0
26,"26172",25,23,23,0,0,"EB",0
26,"26010",85,68,68,1,0,"EB",0
39,"39026",1720,1322,1312,5,10,"EB",1
50,"50083",84,70,68,0,2,"EB",1
39,"39030",1895,1374,1358,6,16,"EB",3
22,"22208",194,159,156,1,3,"EB",1
22,"22043",93,68,67,1,1,"EB",1
44,"44143",394,327,327,2,0,"EB",0
14,"14042",18727,15069,14837,201,232,"EB",33
14,"14038",32692,24015,23679,213,336,"EB",24
50,"50224",65,54,54,1,0,"EB",0
50,"50098",162,121,120,3,1,"EB",0
22,"22181",88,60,59,1,1,"EB",0
50,"50115",3275,2399,2355,32,44,"EB",25
44,"44116",76,62,62,0,0,"EB",1
22,"22176",170,136,135,0,1,"EB",0
44,"44061",75,66,65,2,1,"EB",0
22,"22190",122,89,89,0,0,"EB",0
44,"44031",82,52,52,1,0,"EB",0
4,"4072",314,245,240,0,5,"EB",0
4,"4044",1533,1190,1176,8,14,"EB",2
44,"44008",1565,1158,1138,8,20,"EB",1
22,"22045",73,57,56,0,1,"EB",0
50,"50241",595,434,423,3,11,"EB",0
14,"14050",2352,1840,1801,11,39,"EB",2
39,"39060",6693,5459,5394,29,65,"EB",6
26,"26066",259,216,212,3,4,"EB",0
50,"50203",1057,849,837,9,12,"EB",18
50,"50032",242,179,176,1,3,"EB",0
22,"22094",98,72,71,2,1,"EB",1
50,"50207",93,68,67,2,1,"EB",0
22,"22111",146,115,115,1,0,"EB",0
44,"44114",238,188,184,1,4,"EB",1
44,"44193",69,57,56,1,1,"EB",0
26,"26021",2752,2132,2105,10,27,"EB",3
39,"39079",8861,6827,6745,47,82,"EB",11
50,"50167",215,181,179,1,2,"EB",0
22,"22239",88,71,71,0,0,"EB",0
50,"50107",988,837,828,11,9,"EB",2
50,"50182",3675,2846,2810,36,36,"EB",18
44,"44049",796,592,578,9,14,"EB",0
26,"26059",1122,861,841,7,20,"EB",2
39,"39051",73,65,64,0,1,"EB",0
44,"44208",26,22,22,0,0,"EB",0
22,"22082",285,230,226,2,4,"EB",2
4,"4099",4931,3781,3719,24,62,"EB",8
50,"50058",63,54,53,2,1,"EB",0
50,"50211",237,177,173,0,4,"EB",1
50,"50281",68,55,52,0,3,"EB",0
4,"4063",1063,847,835,5,12,"EB",2
50,"50240",965,720,702,9,18,"EB",2
26,"26064",2337,1764,1724,14,40,"EB",3
44,"44156",46,36,33,1,3,"EB",0
44,"44236",59,44,44,0,0,"EB",0
44,"44047",229,125,124,2,1,"EB",0
22,"22223",74,63,63,1,0,"EB",0
50,"50288",3444,2689,2668,24,21,"EB",7
50,"50269",279,189,186,1,3,"EB",0
44,"44222",122,102,102,1,0,"EB",0
26,"26073",94,72,68,0,4,"EB",0
26,"26121",30,21,21,1,0,"EB",0
26,"26045",11,11,11,0,0,"EB",0
50,"50181",1000,770,754,7,16,"EB",7
39,"39016",23868,19029,18839,108,190,"EB",23
39,"39091",1885,1512,1503,6,9,"EB",1
44,"44065",57,37,36,0,1,"EB",0
22,"22203",76,61,61,0,0,"EB",0
4,"4049",5603,4104,4054,27,50,"EB",3
50,"50070",49,28,28,0,0,"EB",0
50,"50185",136,103,102,0,1,"EB",1
44,"44019",68,42,42,0,0,"EB",0
26,"26017",354,293,290,4,3,"EB",1
26,"26062",86,74,72,1,2,"EB",1
4,"4074",2887,2062,2038,16,24,"EB",5
4,"4066",13488,9324,9255,73,69,"EB",15
50,"50150",621,451,450,2,1,"EB",2
44,"44009",799,621,611,7,10,"EB",2
44,"44252",75,56,56,1,0,"EB",0
44,"44191",722,567,561,7,6,"EB",1
39,"39048",1765,1429,1420,4,9,"EB",3
50,"50087",29,18,18,0,0,"EB",0
50,"50080",34,29,29,0,0,"EB",0
50,"50170",364,286,279,1,7,"EB",0
50,"50237",102,81,81,3,0,"EB",0
44,"44108",300,228,224,5,4,"EB",0
26,"26018",10441,8400,8311,64,89,"EB",11
39,"39005",1406,1127,1110,12,17,"EB",1
22,"22230",288,229,228,3,1,"EB",0
26,"26108",290,241,237,0,4,"EB",1
26,"26052",148,113,113,1,0,"EB",0
26,"26177",301,250,246,2,4,"EB",0
50,"50272",13174,10143,10042,103,101,"EB",66
22,"22072",194,141,140,0,1,"EB",0
4,"4096",281,239,237,1,2,"EB",0
26,"26157",282,233,232,1,1,"EB",1
44,"44010",184,137,137,1,0,"EB",0
14,"14901",915,795,782,8,13,"EB",1
26,"26044",51,44,42,0,2,"EB",0
50,"50056",405,332,330,4,2,"EB",0
4,"4056",164,135,133,1,2,"EB",0
44,"44246",1590,1173,1150,11,23,"EB",8
50,"50155",90,70,69,0,1,"EB",0
4,"4033",125,98,95,0,3,"EB",0
44,"44232",368,284,273,2,11,"EB",4
50,"50043",246,172,170,2,2,"EB",1
44,"44217",31,25,25,0,0,"EB",0
50,"50194",81,59,59,1,0,"EB",0
14,"14044",1620,1279,1264,12,15,"EB",3
26,"26179",41,33,32,0,1,"EB",0
14,"14064",300,231,227,6,4,"EB",0
22,"22225",2610,1867,1843,15,24,"EB",4
44,"44194",104,80,80,1,0,"EB",0
50,"50119",872,684,680,4,4,"EB",2
22,"22085",96,82,81,0,1,"EB",0
26,"26034",612,509,497,5,12,"EB",0
26,"26123",124,112,110,0,2,"EB",0
4,"4017",1276,907,900,4,7,"EB",1
44,"44002",46,42,42,0,0,"EB",0
50,"50217",431,346,344,0,2,"EB",0
4,"4103",1439,1120,1108,16,12,"EB",0
4,"4071",363,303,301,2,2,"EB",0
26,"26083",354,295,291,1,4,"EB",1
22,"22178",103,84,84,2,0,"EB",2
22,"22078",438,326,323,3,3,"EB",0
50,"50250",56,45,45,0,0,"EB",0
4,"4059",1025,742,731,3,11,"EB",0
26,"26165",337,289,284,0,5,"EB",2
50,"50093",83,66,66,1,0,"EB",0
4,"4047",2230,1806,1785,8,21,"EB",1
22,"22172",520,412,407,3,5,"EB",0
22,"22036",88,76,75,0,1,"EB",0
14,"14039",2575,2037,1990,14,47,"EB",2
44,"44067",108,82,78,0,4,"EB",0
44,"44164",20,18,18,0,0,"EB",0
4,"4048",1496,1109,1102,4,7,"EB",2
26,"26139",55,43,43,0,0,"EB",0
39,"39068",649,515,509,7,6,"EB",1
39,"39102",2255,1711,1698,11,13,"EB",2
22,"22029",119,103,103,0,0,"EB",0
39,"39037",2019,1572,1560,2,12,"EB",2
50,"50291",93,78,77,1,1,"EB",1
26,"26029",36,29,28,0,1,"EB",0
50,"50076",75,64,63,0,1,"EB",0
14,"14049",16282,12515,12301,121,214,"EB",20
26,"26049",153,115,115,1,0,"EB",0
26,"26053",195,161,160,3,1,"EB",0
22,"22184",168,142,139,2,3,"EB",0
50,"50254",174,123,122,0,1,"EB",1
26,"26140",239,199,194,1,5,"EB",0
4,"4053",12500,9437,9298,56,139,"EB",9
4,"4008",464,386,383,4,3,"EB",1
39,"39038",1506,1093,1076,2,17,"EB",0
50,"50200",475,416,407,4,9,"EB",0
50,"50019",64,48,47,0,1,"EB",0
4,"4062",4460,3466,3425,12,41,"EB",2
50,"50038",1405,1112,1099,13,13,"EB",4
22,"22046",714,592,587,13,5,"EB",3
14,"14020",338,240,233,2,7,"EB",0
22,"22221",90,58,56,0,2,"EB",0
4,"4082",277,198,196,1,2,"EB",0
26,"26075",321,266,265,0,1,"EB",2
50,"50176",222,161,156,3,5,"EB",0
26,"26154",10,10,10,1,0,"EB",0
44,"44263",377,296,285,3,11,"EB",0
26,"26142",784,651,641,5,10,"EB",0
39,"39023",6523,5205,5144,22,61,"EB",4
44,"44197",50,35,35,0,0,"EB",1
44,"44055",77,58,56,0,2,"EB",0
4,"4010",580,445,434,2,11,"EB",0
44,"44076",2110,1725,1691,22,34,"EB",3
14,"14059",687,571,563,7,8,"EB",1
39,"39033",540,430,423,1,7,"EB",0
44,"44260",138,91,90,1,1,"EB",0
26,"26117",2097,1680,1647,17,33,"EB",4
26,"26129",936,770,759,1,11,"EB",4
22,"22037",112,96,96,0,0,"EB",0
22,"22018",308,234,232,2,2,"EB",1
26,"26162",112,95,94,0,1,"EB",0
50,"50116",170,132,131,0,1,"EB",0
26,"26020",454,347,337,4,10,"EB",0
26,"26057",51,47,47,1,0,"EB",0
44,"44107",205,159,158,0,1,"EB",1
26,"26183",66,50,50,0,0,"EB",0
22,"22909",301,233,231,4,2,"EB",3
26,"26101",34,27,27,0,0,"EB",0
39,"39090",772,619,609,1,10,"EB",0
22,"22019",175,151,151,0,0,"EB",2
39,"39044",3868,3019,2985,8,34,"EB",1
22,"22057",364,286,284,3,2,"EB",0
4,"4065",368,287,284,2,3,"EB",0
50,"50261",205,171,167,1,4,"EB",0
26,"26087",170,136,135,3,1,"EB",0
26,"26105",2211,1744,1723,19,21,"EB",5
44,"44240",149,121,121,0,0,"EB",0
14,"14054",13796,11042,10799,102,243,"EB",14
50,"50236",101,82,80,1,2,"EB",0
22,"22023",389,313,305,6,8,"EB",0
4,"4038",3110,2235,2203,23,32,"EB",3
44,"44135",102,85,85,0,0,"EB",2
22,"22229",108,80,80,2,0,"EB",0
14,"14014",2509,2071,2030,7,41,"EB",3
50,"50062",1863,1441,1416,9,25,"EB",4
44,"44211",35,24,24,0,0,"EB",0
22,"22114",124,86,82,1,4,"EB",0
22,"22024",222,179,177,1,2,"EB",2
39,"39036",971,794,787,5,7,"EB",1
44,"44256",34,32,32,1,0,"EB",0
50,"50121",277,220,218,2,2,"EB",1
50,"50030",201,138,136,1,2,"EB",0
22,"22126",87,66,66,0,0,"EB",0
22,"22044",234,184,183,3,1,"EB",0
50,"50148",290,229,227,2,2,"EB",1
44,"44226",124,87,83,2,4,"EB",0
50,"50027",224,170,165,1,5,"EB",0
50,"50266",121,85,80,0,5,"EB",0
22,"22246",71,50,50,0,0,"EB",0
22,"22051",91,78,78,1,0,"EB",1
4,"4007",731,570,569,0,1,"EB",1
26,"26019",350,270,256,3,14,"EB",0
22,"22235",88,72,72,1,0,"EB",0
50,"50105",279,216,213,4,3,"EB",0
50,"50034",787,568,556,3,12,"EB",1
22,"22206",182,145,145,0,0,"EB",1
44,"44087",68,56,54,0,2,"EB",0
26,"26148",150,128,124,1,4,"EB",0
26,"26061",1552,1228,1194,14,34,"EB",3
50,"50149",33,25,25,1,0,"EB",2
50,"50191",445,341,337,2,4,"EB",3
44,"44028",171,140,138,1,2,"EB",0
50,"50232",160,116,114,2,2,"EB",1
50,"50178",276,193,193,4,0,"EB",0
50,"50295",49,46,46,0,0,"EB",0
22,"22131",83,65,65,0,0,"EB",0
50,"50054",56,48,47,0,1,"EB",0
39,"39095",2240,1809,1778,12,31,"EB",0
44,"44268",32,30,30,0,0,"EB",0
22,"22903",622,538,533,3,5,"EB",0
26,"26145",237,207,204,0,3,"EB",0
39,"39085",6964,5489,5445,28,44,"EB",7
50,"50230",1134,853,846,6,7,"EB",4
44,"44224",21,15,15,0,0,"EB",0
44,"44152",67,48,48,2,0,"EB",0
44,"44121",53,38,38,2,0,"EB",0
50,"50055",3627,2627,2571,41,56,"EB",15
50,"50134",118,91,89,0,2,"EB",0
44,"44033",244,174,172,0,2,"EB",0
22,"22167",473,392,384,4,8,"EB",1
44,"44052",74,50,49,0,1,"EB",0
22,"22090",85,66,66,1,0,"EB",1
44,"44027",149,120,119,0,1,"EB",0
50,"50296",382,288,272,1,16,"EB",3
44,"44147",398,293,286,3,7,"EB",0
26,"26155",149,119,119,0,0,"EB",1
26,"26072",285,252,247,1,5,"EB",0
50,"50094",1518,1172,1155,20,17,"EB",8
44,"44004",379,312,310,5,2,"EB",1
50,"50218",110,92,92,0,0,"EB",0
44,"44064",63,49,48,0,1,"EB",0
22,"22130",10128,7355,7294,61,61,"EB",20
39,"39100",849,650,644,9,6,"EB",1
22,"22109",266,207,205,3,2,"EB",0
44,"44216",26922,20603,20279,204,324,"EB",79
50,"50075",72,59,59,1,0,"EB",0
44,"44024",28,25,24,0,1,"EB",0
44,"44038",98,83,80,0,3,"EB",0
14,"14067",3870,3057,2998,24,59,"EB",3
50,"50010",66,56,55,2,1,"EB",0
39,"39041",1767,1437,1417,18,20,"EB",3
50,"50198",49,43,43,1,0,"EB",0
50,"50212",32,29,29,1,0,"EB",0
44,"44182",198,172,171,2,1,"EB",1
22,"22136",749,579,576,5,3,"EB",3
44,"44054",94,79,79,0,0,"EB",0
50,"50106",127,97,96,0,1,"EB",1
22,"22170",668,529,520,4,9,"EB",3
14,"14071",884,641,634,2,7,"EB",0
22,"22035",226,174,174,0,0,"EB",1
26,"26009",391,317,314,2,3,"EB",1
44,"44155",1056,830,813,9,17,"EB",4
50,"50048",33,25,25,0,0,"EB",0
26,"26002",827,643,639,5,4,"EB",0
44,"44250",19,15,15,0,0,"EB",0
50,"50011",116,100,99,0,1,"EB",0
39,"39080",3505,2735,2701,8,34,"EB",2
50,"50020",802,606,600,7,6,"EB",2
50,"50126",2262,1736,1708,20,28,"EB",3
50,"50243",311,252,247,1,5,"EB",1
26,"26089",111800,87863,86778,700,1085,"EB",221
4,"4022",357,261,261,0,0,"EB",3
14,"14069",7376,5511,5398,47,113,"EB",7
22,"22021",1884,1465,1450,13,15,"EB",4
50,"50045",1198,957,951,3,6,"EB",2
50,"50018",893,705,696,3,9,"EB",2
50,"50290",358,272,266,6,6,"EB",0
50,"50187",56,43,43,0,0,"EB",0
4,"4011",2757,2171,2136,11,35,"EB",0
22,"22199",6926,5113,5051,44,62,"EB",13
26,"26077",17,17,17,0,0,"EB",0
39,"39077",236,175,173,0,2,"EB",0
26,"26043",349,272,268,2,4,"EB",0
14,"14063",1000,767,757,4,10,"EB",1
14,"14033",1265,994,985,9,9,"EB",3
4,"4076",1221,951,933,8,18,"EB",1
4,"4089",694,516,510,1,6,"EB",0
50,"50242",93,72,70,0,2,"EB",0
22,"22155",65,54,54,0,0,"EB",0
22,"22074",275,223,221,10,2,"EB",0
44,"44148",76,64,63,0,1,"EB",0
4,"4085",371,305,303,2,2,"EB",0
39,"39073",10200,8230,8150,65,80,"EB",13
50,"50251",8207,6352,6242,46,110,"EB",9
26,"26092",109,84,82,1,2,"EB",0
39,"39007",393,300,298,1,2,"EB",0
44,"44126",317,226,222,1,4,"EB",0
26,"26144",188,161,160,1,1,"EB",1
22,"22075",119,87,87,1,0,"EB",0
4,"4091",326,267,266,3,1,"EB",2
50,"50100",306,238,235,3,3,"EB",0
44,"44241",506,416,407,1,9,"EB",1
44,"44060",37,28,28,0,0,"EB",0
50,"50901",140,108,108,0,0,"EB",0
4,"4013",143321,101501,100814,750,687,"EB",193
4,"4041",330,248,247,1,1,"EB",3
26,"26131",34,34,34,1,0,"EB",0
50,"50089",8584,6951,6912,34,39,"EB",30
22,"22061",6583,5027,4973,51,54,"EB",19
50,"50005",239,204,201,2,3,"EB",1
44,"44266",102,89,86,1,3,"EB",0
39,"39074",7041,5612,5551,31,61,"EB",5
22,"22252",118,100,99,0,1,"EB",1
39,"39065",232,190,189,5,1,"EB",0
22,"22908",188,133,131,0,2,"EB",1
22,"22058",191,157,157,3,0,"EB",1
44,"44203",9,9,9,0,0,"EB",0
26,"26068",79,62,62,1,0,"EB",0
50,"50025",4516,3417,3364,35,53,"EB",7
22,"22163",419,363,361,1,2,"EB",1
26,"26134",83,70,67,0,3,"EB",0
50,"50208",1748,1360,1344,11,16,"EB",5
39,"39031",1245,990,983,5,7,"EB",1
50,"50071",127,89,88,0,1,"EB",0
50,"50072",195,164,161,3,3,"EB",0
44,"44192",349,288,284,1,4,"EB",1
50,"50172",178,134,131,3,3,"EB",0
22,"22063",159,133,132,2,1,"EB",0
4,"4024",3225,2558,2534,23,24,"EB",4
44,"44110",37,33,33,0,0,"EB",0
44,"44172",295,220,218,4,2,"EB",0
4,"4090",312,253,249,0,4,"EB",0
44,"44022",463,342,326,6,16,"EB",0
44,"44179",325,233,231,7,2,"EB",0
4,"4070",1545,1192,1182,7,10,"EB",4
22,"22164",43,33,31,0,2,"EB",0
14,"14902",1121,928,900,7,28,"EB",1
50,"50035",75,63,62,0,1,"EB",0
39,"39020",23931,17782,17566,126,216,"EB",32
39,"39094",841,676,670,3,6,"EB",1
44,"44111",78,64,64,1,0,"EB",0
50,"50286",75,58,55,0,3,"EB",0
50,"50258",53,33,33,3,0,"EB",0
50,"50001",88,71,70,0,1,"EB",0
44,"44101",51,43,42,1,1,"EB",0
50,"50114",132,111,111,1,0,"EB",0
44,"44161",430,320,316,1,4,"EB",2
26,"26164",51,37,37,1,0,"EB",0
44,"44003",17,14,14,0,0,"EB",0
22,"22165",452,360,356,1,4,"EB",3
50,"50164",388,279,272,2,7,"EB",15
44,"44130",27,24,24,0,0,"EB",0
44,"44174",409,306,300,3,6,"EB",3
44,"44023",18,14,14,0,0,"EB",0
50,"50202",131,90,88,1,2,"EB",1
26,"26173",6,6,6,0,0,"EB",0
26,"26138",4545,3433,3374,27,59,"EB",7
4,"4060",407,308,304,1,4,"EB",0
22,"22080",264,208,202,2,6,"EB",1
22,"22066",748,576,567,6,9,"EB",0
44,"44163",114,92,92,0,0,"EB",0
4,"4084",341,258,255,0,3,"EB",0
50,"50161",103,80,80,0,0,"EB",1
50,"50037",127,93,93,0,0,"EB",0
26,"26086",15,15,15,0,0,"EB",0
39,"39086",362,273,268,1,5,"EB",0
39,"39059",7577,5978,5916,47,62,"EB",4
22,"22209",159,139,136,5,3,"EB",0
44,"44153",1749,1264,1243,11,21,"EB",6
4,"4097",242,184,184,0,0,"EB",0
26,"26178",71,57,56,1,1,"EB",0
44,"44132",58,47,47,0,0,"EB",0
14,"14070",1284,988,969,5,19,"EB",1
50,"50213",93,76,75,0,1,"EB",0
26,"26126",29,29,29,1,0,"EB",0
44,"44247",287,216,215,6,1,"EB",0
14,"14030",7797,6116,6036,54,80,"EB",5
44,"44123",99,69,69,1,0,"EB",0
26,"26013",323,258,256,1,2,"EB",2
44,"44066",87,66,65,0,1,"EB",0
39,"39088",59,51,51,0,0,"EB",0
4,"4021",180,146,143,0,3,"EB",0
26,"26158",246,207,206,2,1,"EB",0
50,"50086",178,121,119,2,2,"EB",1
50,"50117",125,100,100,3,0,"EB",0
50,"50077",206,158,157,1,1,"EB",0
44,"44124",73,58,57,0,1,"EB",1
4,"4035",8433,6246,6196,33,50,"EB",9
26,"26050",130,97,97,0,0,"EB",1
50,"50067",13788,10562,10413,107,149,"EB",30
26,"26128",96,74,74,1,0,"EB",1
14,"14052",9080,5999,5909,63,90,"EB",7
50,"50186",37,28,28,0,0,"EB",0
14,"14028",307,258,257,0,1,"EB",0
22,"22112",9516,7043,6956,84,87,"EB",30
22,"22157",183,136,134,1,2,"EB",0
26,"26027",143,101,98,1,3,"EB",0
44,"44209",815,606,592,2,14,"EB",3
4,"4052",12767,9352,9269,90,83,"EB",17
50,"50244",191,153,150,1,3,"EB",0
44,"44184",38,28,26,0,2,"EB",0
44,"44229",143,110,108,4,2,"EB",1
22,"22215",128,91,91,1,0,"EB",0
26,"26028",139,120,117,1,3,"EB",0
50,"50206",453,371,370,5,1,"EB",2
50,"50060",170,137,135,2,2,"EB",0
50,"50079",227,182,178,1,4,"EB",3
22,"22243",39,28,28,0,0,"EB",0
26,"26170",427,343,338,2,5,"EB",0
39,"39006",1721,1332,1315,3,17,"EB",1
22,"22253",57,48,47,0,1,"EB",0
26,"26078",86,71,70,1,1,"EB",0
44,"44251",242,197,187,0,10,"EB",1
44,"44168",184,137,136,4,1,"EB",1
22,"22228",529,421,417,3,4,"EB",0
22,"22160",212,171,170,3,1,"EB",0
50,"50109",98,69,67,3,2,"EB",1
14,"14024",1859,1461,1418,10,43,"EB",2
22,"22175",184,139,137,1,2,"EB",0
44,"44029",579,466,457,3,9,"EB",2
22,"22128",192,155,154,2,1,"EB",0
50,"50163",3787,3041,3022,31,19,"EB",10
22,"22102",181,153,151,1,2,"EB",0
22,"22050",93,79,79,2,0,"EB",0
50,"50227",110,74,73,2,1,"EB",0
50,"50104",326,264,259,4,5,"EB",0
14,"14004",1981,1522,1509,8,13,"EB",3
26,"26030",17,17,17,0,0,"EB",0
44,"44137",188,148,146,0,2,"EB",0
44,"44039",202,166,165,3,1,"EB",0
22,"22103",676,520,517,6,3,"EB",3
44,"44109",102,71,70,1,1,"EB",0
4,"4051",406,343,339,1,4,"EB",0
44,"44171",182,130,128,0,2,"EB",0
4,"4028",202,183,181,0,2,"EB",0
50,"50190",675,565,553,5,12,"EB",1
39,"39056",2268,1847,1830,7,17,"EB",0
50,"50081",491,390,384,5,6,"EB",0
26,"26069",230,187,186,0,1,"EB",0
44,"44212",41,32,32,0,0,"EB",0
22,"22144",257,207,204,1,3,"EB",0
50,"50247",842,621,616,7,5,"EB",3
39,"39055",1075,836,829,8,7,"EB",1
22,"22248",104,83,82,0,1,"EB",0
44,"44181",66,58,57,0,1,"EB",0
26,"26008",1822,1436,1420,14,16,"EB",2
22,"22087",58,47,47,0,0,"EB",1
39,"39066",877,711,705,5,6,"EB",0
4,"4903",4308,3102,3075,17,27,"EB",6
44,"44213",65,46,46,0,0,"EB",0
44,"44244",68,48,48,4,0,"EB",1
22,"22003",132,114,114,0,0,"EB",1
26,"26110",150,128,124,1,4,"EB",0
44,"44032",17,13,13,0,0,"EB",0
4,"4030",1066,783,776,5,7,"EB",1
22,"22233",80,50,50,0,0,"EB",0
26,"26082",100,85,85,0,0,"EB",0
4,"4004",400,320,315,2,5,"EB",0
50,"50133",100,82,82,2,0,"EB",0
26,"26127",186,162,159,1,3,"EB",0
44,"44262",143,115,112,0,3,"EB",0
44,"44045",368,302,298,8,4,"EB",2
22,"22201",266,192,192,2,0,"EB",0
14,"14048",1189,948,933,5,15,"EB",0
50,"50204",2394,1876,1855,21,21,"EB",2
50,"50277",49,37,37,3,0,"EB",0
44,"44088",23,21,21,0,0,"EB",0
50,"50173",149,107,105,0,2,"EB",0
26,"26022",187,153,148,0,5,"EB",0
26,"26150",100,83,83,0,0,"EB",0
50,"50249",284,229,227,1,2,"EB",0
44,"44112",408,303,293,2,10,"EB",1
14,"14017",10945,8514,8386,90,128,"EB",16
26,"26060",75,60,60,1,0,"EB",1
39,"39040",4267,3428,3385,24,43,"EB",3
44,"44225",103,82,81,0,1,"EB",0
44,"44131",27,22,22,0,0,"EB",0
50,"50231",257,210,207,3,3,"EB",1
50,"50278",177,137,137,2,0,"EB",0
44,"44102",27,22,22,0,0,"EB",1
50,"50125",345,264,261,3,3,"EB",0
44,"44090",66,49,49,0,0,"EB",0
26,"26125",2663,2042,2011,32,31,"EB",1
22,"22084",555,438,433,5,5,"EB",4
4,"4019",232,181,179,0,2,"EB",0
50,"50221",32,22,22,0,0,"EB",0
22,"22168",23,21,20,0,1,"EB",0
44,"44035",105,86,84,1,2,"EB",0
39,"39069",1928,1650,1627,9,23,"EB",1
26,"26012",33,28,26,0,2,"EB",0
44,"44005",46,31,31,1,0,"EB",1
50,"50175",924,713,710,9,3,"EB",2
22,"22135",174,132,132,5,0,"EB",0
22,"22039",805,667,662,5,5,"EB",1
50,"50166",236,200,198,1,2,"EB",1
22,"22250",344,271,264,6,7,"EB",4
44,"44154",248,200,195,2,5,"EB",2
22,"22095",65,57,56,1,1,"EB",0
39,"39032",1426,1156,1141,8,15,"EB",2
14,"14003",1258,989,968,12,21,"EB",0
44,"44048",53,47,47,0,0,"EB",0
50,"50274",66,48,47,0,1,"EB",0
4,"4026",55,46,45,1,1,"EB",0
4,"4087",156,117,116,1,1,"EB",0
4,"4001",1014,768,763,9,5,"EB",2
39,"39070",123,101,99,0,2,"EB",0
44,"44016",436,334,331,1,3,"EB",0
14,"14041",3115,2449,2376,45,73,"EB",2
39,"39004",1483,1181,1163,4,18,"EB",0
22,"22009",585,439,435,4,4,"EB",0
44,"44187",193,155,151,1,4,"EB",0
44,"44026",95,76,75,2,1,"EB",0
26,"26014",447,313,309,2,4,"EB",0
50,"50168",27,20,20,0,0,"EB",0
44,"44198",181,151,145,1,6,"EB",2
4,"4036",223,188,186,1,2,"EB",0
26,"26076",116,93,91,0,2,"EB",0
50,"50138",47,42,42,1,0,"EB",0
50,"50040",86,71,71,0,0,"EB",0
39,"39025",8703,6954,6854,39,100,"EB",8
39,"39072",324,206,204,4,2,"EB",0
26,"26104",11,9,9,0,0,"EB",0
44,"44199",39,39,38,5,1,"EB",1
26,"26111",250,209,205,2,4,"EB",2
50,"50159",641,527,526,8,1,"EB",2
39,"39081",437,356,347,2,9,"EB",0
22,"22141",114,86,85,0,1,"EB",2
26,"26091",147,132,131,1,1,"EB",0
50,"50012",96,79,79,1,0,"EB",0
44,"44239",22,19,19,0,0,"EB",0
26,"26041",114,84,84,0,0,"EB",0
44,"44190",65,45,43,0,2,"EB",1
44,"44230",152,112,111,1,1,"EB",2
39,"39029",636,512,512,5,0,"EB",0
22,"22254",1094,857,850,11,7,"EB",2
50,"50088",282,233,227,2,6,"EB",0
50,"50160",2150,1652,1619,14,33,"EB",9
39,"39054",4528,3614,3575,23,39,"EB",3
50,"50188",27,24,24,0,0,"EB",0
14,"14061",688,567,556,2,11,"EB",0
44,"44080",284,214,212,1,2,"EB",2
22,"22156",296,246,242,3,4,"EB",4
26,"26180",223,182,177,3,5,"EB",0
50,"50130",362,252,249,1,3,"EB",0
22,"22089",276,216,216,2,0,"EB",0
14,"14027",7876,6227,6103,81,124,"EB",7
39,"39039",546,431,428,0,3,"EB",0
22,"22189",178,143,143,0,0,"EB",1
50,"50180",106,84,84,1,0,"EB",0
39,"39049",306,209,208,4,1,"EB",0
50,"50090",134,108,108,0,0,"EB",0
26,"26106",76,66,65,0,1,"EB",0
26,"26056",403,334,328,2,6,"EB",0
14,"14055",18446,13919,13711,148,208,"EB",20
4,"4068",174,134,134,0,0,"EB",0
14,"14005",6318,4464,4380,59,84,"EB",10
22,"22086",209,157,155,1,2,"EB",1
4,"4901",494,381,378,0,3,"EB",0
50,"50006",908,705,689,3,16,"EB",2
50,"50132",771,589,576,2,13,"EB",3
50,"50053",650,505,497,4,8,"EB",0
14,"14015",2067,1575,1551,16,24,"EB",3
44,"44243",27,24,23,0,1,"EB",0
50,"50022",504,396,386,11,10,"EB",1
50,"50031",139,97,90,0,7,"EB",0
22,"22083",445,379,372,5,7,"EB",0
50,"50141",109,90,90,1,0,"EB",1
26,"26048",22,22,22,0,0,"EB",2
50,"50102",820,653,642,9,11,"EB",2
26,"26032",45,37,37,1,0,"EB",0
44,"44142",28,21,21,0,0,"EB",0
4,"4045",1704,1355,1326,12,29,"EB",0
22,"22106",20,15,15,0,0,"EB",0
50,"50099",3042,2299,2265,20,34,"EB",2
50,"50210",36,29,29,0,0,"EB",1
44,"44075",326,275,263,0,12,"EB",3
39,"39001",2065,1669,1643,16,26,"EB",2
50,"50142",24,18,18,0,0,"EB",0
50,"50248",502,390,377,6,13,"EB",1
44,"44157",64,38,38,1,0,"EB",0
22,"22204",1119,836,832,9,4,"EB",5
39,"39063",954,726,722,4,4,"EB",0
50,"50051",800,615,608,3,7,"EB",2
22,"22251",334,269,263,4,6,"EB",1
4,"4075",5427,3989,3961,15,28,"EB",3
44,"44238",2294,1763,1743,10,20,"EB",4
22,"22236",236,207,203,2,4,"EB",3
26,"26098",99,77,77,1,0,"EB",0
26,"26071",8662,6409,6288,52,121,"EB",13
44,"44183",63,43,43,0,0,"EB",0
44,"44215",168,121,120,1,1,"EB",0
39,"39011",1575,1249,1242,3,7,"EB",3
26,"26136",92,80,80,3,0,"EB",0
4,"4002",1039,798,792,7,6,"EB",3
22,"22222",517,407,398,5,9,"EB",0
50,"50174",83,58,58,0,0,"EB",0
39,"39096",670,523,518,2,5,"EB",0
50,"50036",100,80,80,0,0,"EB",0
44,"44043",88,67,65,1,2,"EB",0
26,"26023",435,351,347,5,4,"EB",0
44,"44206",103,83,82,0,1,"EB",1
26,"26011",7229,5355,5277,64,78,"EB",2
50,"50069",67,44,44,0,0,"EB",0
50,"50275",110,55,55,0,0,"EB",0
22,"22249",118,93,93,2,0,"EB",0
4,"4101",4375,3161,3112,34,49,"EB",4
26,"26169",68,61,61,2,0,"EB",0
26,"26004",66,54,54,0,0,"EB",0
26,"26166",147,136,136,2,0,"EB",0
39,"39022",969,740,732,2,8,"EB",1
39,"39013",535,434,431,1,3,"EB",0
44,"44094",123,112,112,0,0,"EB",0
39,"39053",213,146,145,2,1,"EB",0
50,"50073",2117,1735,1706,13,29,"EB",4
50,"50169",336,261,259,2,2,"EB",3
44,"44169",310,250,245,4,5,"EB",0
50,"50280",301,246,240,1,6,"EB",1
50,"50146",190,152,149,0,3,"EB",1
44,"44227",72,61,61,0,0,"EB",0
50,"50123",436,344,338,1,6,"EB",2
44,"44036",23,20,20,0,0,"EB",0
50,"50029",604,475,467,7,8,"EB",2
22,"22020",119,91,87,1,4,"EB",2
26,"26042",799,605,596,5,9,"EB",0
50,"50052",85,64,64,0,0,"EB",0
22,"22013",275,218,217,6,1,"EB",0
50,"50017",1779,1386,1373,14,13,"EB",3
50,"50137",964,790,781,9,9,"EB",0
50,"50252",5057,3661,3613,36,48,"EB",9
22,"22125",39429,29988,29612,337,376,"EB",152
50,"50201",444,357,354,1,3,"EB",3
50,"50293",392,295,293,6,2,"EB",1
14,"14065",1813,1439,1421,11,18,"EB",1
39,"39027",3066,2511,2467,15,44,"EB",5
50,"50205",74,58,57,0,1,"EB",1
50,"50157",286,226,220,0,6,"EB",0
50,"50059",754,599,589,6,10,"EB",2
22,"22096",320,274,272,2,2,"EB",1
50,"50129",213,151,149,5,2,"EB",0
44,"44082",89,72,69,0,3,"EB",1
26,"26115",23,21,19,0,2,"EB",0
44,"44178",53,39,39,0,0,"EB",0
44,"44040",191,164,158,2,6,"EB",0
26,"26040",63,51,50,0,1,"EB",1
50,"50003",119,95,95,1,0,"EB",0
50,"50282",57,47,45,0,2,"EB",0
50,"50235",2412,1826,1807,22,19,"EB",3
39,"39028",3870,3131,3094,19,37,"EB",4
22,"22012",102,81,80,1,1,"EB",0
50,"50139",322,257,256,0,1,"EB",0
50,"50298",5427,4373,4323,30,50,"EB",12
22,"22149",308,247,246,3,1,"EB",2
44,"44051",2588,2034,1997,26,37,"EB",9
44,"44084",55,45,45,0,0,"EB",0
26,"26033",163,143,142,3,1,"EB",0
26,"26122",116,98,97,0,1,"EB",2
44,"44160",440,311,306,2,5,"EB",5
26,"26130",201,164,163,0,1,"EB",0
44,"44096",153,120,112,1,8,"EB",0
22,"22007",756,576,571,5,5,"EB",0
26,"26118",72,63,60,1,3,"EB",0
50,"50023",208,165,164,2,1,"EB",0
44,"44149",100,74,73,0,1,"EB",1
26,"26113",31,30,30,0,0,"EB",0
26,"26063",118,96,95,2,1,"EB",0
50,"50271",248,197,189,2,8,"EB",2
39,"39061",3488,2833,2798,18,35,"EB",3
44,"44245",245,176,171,1,5,"EB",0
22,"22004",124,90,88,1,2,"EB",0
44,"44063",65,55,55,1,0,"EB",0
4,"4031",2249,1778,1773,2,5,"EB",1
50,"50124",399,316,316,3,0,"EB",1
4,"4006",7218,5002,4940,33,62,"EB",12
22,"22017",822,664,660,5,4,"EB",1
50,"50042",16,16,16,0,0,"EB",0
50,"50199",325,238,232,3,6,"EB",0
44,"44159",37,32,32,1,0,"EB",0
44,"44201",478,417,412,3,5,"EB",0
26,"26147",34,30,29,0,1,"EB",0
26,"26081",15,14,14,1,0,"EB",0
44,"44001",65,51,50,0,1,"EB",0
50,"50033",65,50,50,1,0,"EB",0
50,"50135",88,74,74,3,0,"EB",0
26,"26007",481,391,383,0,8,"EB",1
50,"50128",27,24,24,0,0,"EB",0
22,"22011",97,78,75,2,3,"EB",0
22,"22022",543,441,433,4,8,"EB",2
39,"39071",422,318,316,0,2,"EB",0
44,"44053",105,81,81,0,0,"EB",1
44,"44257",154,110,109,1,1,"EB",1
39,"39084",874,718,712,4,6,"EB",0
14,"14073",2772,2124,2069,18,55,"EB",0
22,"22127",529,434,432,4,2,"EB",0
50,"50122",67,55,54,0,1,"EB",0
4,"4077",302,275,275,1,0,"EB",0
44,"44136",51,43,43,1,0,"EB",0
50,"50216",240,189,181,3,8,"EB",1
22,"22016",566,423,420,4,3,"EB",0
22,"22150",461,368,362,1,6,"EB",3
14,"14013",16604,12618,12388,155,230,"EB",11
22,"22207",121,78,78,1,0,"EB",1
44,"44185",93,73,72,1,1,"EB",0
4,"4034",165,107,106,1,1,"EB",1
44,"44117",319,263,256,5,7,"EB",1
26,"26005",2480,1687,1661,5,26,"EB",0
26,"26114",74,62,60,0,2,"EB",1
50,"50233",104,82,82,0,0,"EB",0
14,"14021",260397,195951,193914,2025,2037,"EB",428
26,"26102",6057,4672,4579,37,93,"EB",3
26,"26038",81,61,61,0,0,"EB",0
4,"4009",151,126,124,3,2,"EB",0
50,"50183",319,242,241,4,1,"EB",4
50,"50143",546,409,401,5,8,"EB",0
22,"22234",745,587,578,11,9,"EB",1
22,"22115",347,262,261,1,1,"EB",1
44,"44180",72,61,61,0,0,"EB",1
39,"39089",134,99,98,0,1,"EB",0
26,"26099",1216,993,973,14,20,"EB",3
22,"22119",1256,963,954,5,9,"EB",0
39,"39002",3414,2630,2578,23,52,"EB",3
22,"22133",108,85,83,1,2,"EB",0
14,"14018",3611,2802,2741,25,61,"EB",4
44,"44177",101,75,75,1,0,"EB",0
44,"44195",84,66,65,1,1,"EB",0
4,"4015",118,97,97,2,0,"EB",4
26,"26080",453,385,383,2,2,"EB",1
14,"14032",393,328,321,2,7,"EB",0
22,"22214",118,98,97,1,1,"EB",0
44,"44056",457,352,341,4,11,"EB",0
50,"50165",1783,1359,1330,20,29,"EB",6
39,"39003",258,205,202,3,3,"EB",0
50,"50113",584,505,495,3,10,"EB",1
14,"14057",6139,5054,4964,51,90,"EB",11
4,"4902",45395,31127,30881,251,246,"EB",60
26,"26109",73,66,66,0,0,"EB",0
22,"22117",2414,1798,1784,18,14,"EB",9
26,"26135",153,123,123,1,0,"EB",0
50,"50136",534,416,405,2,11,"EB",0
22,"22124",182,148,148,1,0,"EB",0
39,"39076",3483,2770,2734,21,36,"EB",2
50,"50222",1570,1126,1105,17,21,"EB",3
50,"50225",1532,1072,1064,10,8,"EB",2
44,"44210",743,600,594,8,6,"EB",2
22,"22906",174,137,134,5,3,"EB",1
44,"44103",123,101,100,1,1,"EB",0
26,"26025",89,77,77,0,0,"EB",1
22,"22907",1444,1149,1137,12,12,"EB",5
26,"26176",53,48,48,0,0,"EB",0
22,"22053",786,573,567,3,6,"EB",3
50,"50219",4283,3274,3213,53,61,"EB",18
26,"26124",776,635,624,5,11,"EB",0
14,"14058",7859,5854,5745,51,109,"EB",2
50,"50259",84,58,58,0,0,"EB",0
4,"4058",342,256,256,0,0,"EB",0
22,"22014",233,185,182,3,3,"EB",0
26,"26107",91,78,77,0,1,"EB",0
4,"4055",366,315,314,3,1,"EB",0
50,"50223",916,751,745,13,6,"EB",1
44,"44115",102,96,95,0,1,"EB",0
39,"39052",18957,15123,14985,106,138,"EB",23
14,"14072",999,763,754,4,9,"EB",0
14,"14062",963,753,745,4,8,"EB",0
44,"44119",119,83,82,0,1,"EB",0
26,"26003",389,329,328,1,1,"EB",0
26,"26143",242,190,189,0,1,"EB",0
22,"22139",78,60,60,0,0,"EB",0
26,"26160",732,578,574,4,4,"EB",0
14,"14053",5925,4442,4348,75,94,"EB",5
50,"50108",52,43,42,0,1,"EB",0
50,"50245",76,58,58,0,0,"EB",0
44,"44018",16,16,16,0,0,"EB",0
26,"26024",210,171,169,1,2,"EB",0
44,"44220",113,92,89,0,3,"EB",2
22,"22113",470,369,369,2,0,"EB",1
39,"39034",257,167,162,2,5,"EB",0
22,"22173",218,162,160,1,2,"EB",5
4,"4012",187,163,162,1,1,"EB",0
50,"50239",63,47,47,0,0,"EB",1
14,"14074",2237,1859,1839,8,20,"EB",3
4,"4061",622,501,494,4,7,"EB",0
22,"22060",1172,906,901,13,5,"EB",3
4,"4081",346,272,271,2,1,"EB",0
50,"50903",2238,1750,1732,11,18,"EB",2
50,"50255",197,162,160,2,2,"EB",1
44,"44059",550,446,437,7,9,"EB",0
50,"50041",17,14,14,0,0,"EB",0
26,"26161",8,7,7,0,0,"EB",0
44,"44105",69,54,54,1,0,"EB",0
44,"44165",173,136,135,2,1,"EB",0
44,"44176",153,124,124,0,0,"EB",0
50,"50195",53,42,41,0,1,"EB",0
26,"26163",124,106,104,1,2,"EB",0
39,"39058",800,574,573,1,1,"EB",0
26,"26058",143,116,115,2,1,"EB",0
39,"39067",759,582,575,3,7,"EB",0
22,"22227",199,155,154,1,1,"EB",0
50,"50024",556,427,426,6,1,"EB",2
4,"4003",17540,12174,12051,75,123,"EB",17
44,"44150",26,21,21,0,0,"EB",0
44,"44223",73,58,58,0,0,"EB",0
39,"39093",302,256,256,2,0,"EB",2
44,"44071",585,449,447,6,2,"EB",1
50,"50144",31,26,25,0,1,"EB",0
44,"44138",118,90,89,2,1,"EB",0
44,"44021",104,86,85,2,1,"EB",1
39,"39064",1341,1103,1094,5,9,"EB",1
50,"50265",74,56,56,0,0,"EB",0
50,"50046",167,134,130,3,4,"EB",1
39,"39043",1523,1246,1220,10,26,"EB",0
14,"14056",23513,17065,16684,147,381,"EB",16
39,"39035",9169,7135,7045,40,90,"EB",7
50,"50287",252,200,196,7,4,"EB",0
14,"14002",10859,8215,8078,93,137,"EB",2
50,"50276",119,91,91,1,0,"EB",1
4,"4057",1260,970,953,10,17,"EB",1
22,"22177",97,81,81,1,0,"EB",1
22,"22188",76,60,59,1,1,"EB",1
39,"39019",2229,1785,1751,15,34,"EB",2
50,"50292",129,113,113,1,0,"EB",0
44,"44100",175,142,141,2,1,"EB",0
22,"22079",114,89,88,1,1,"EB",0
44,"44204",27,22,22,0,0,"EB",0
39,"39087",41381,32335,31995,194,340,"EB",39
50,"50013",200,166,166,3,0,"EB",0
22,"22059",1139,867,855,10,12,"EB",3
4,"4032",5698,4168,4138,20,30,"EB",2
44,"44133",15,12,12,0,0,"EB",0
22,"22069",418,337,334,5,3,"EB",1
14,"14031",566,453,446,2,7,"EB",0
44,"44093",79,73,73,4,0,"EB",0
39,"39098",1379,1154,1144,7,10,"EB",0
26,"26001",198,171,165,1,6,"EB",0
50,"50095",12136,9020,8928,99,92,"EB",25
44,"44099",649,457,450,2,7,"EB",1
26,"26015",180,145,142,1,3,"EB",0
44,"44167",39,30,30,0,0,"EB",1
4,"4027",226,147,147,1,0,"EB",0
22,"22162",129,99,99,0,0,"EB",0
14,"14043",7408,5721,5619,76,102,"EB",14
14,"14029",4029,3089,3039,15,50,"EB",2
39,"39021",467,392,385,2,7,"EB",0
50,"50215",20,18,18,0,0,"EB",0
22,"22122",65,58,58,3,0,"EB",0
39,"39012",6737,5391,5314,52,77,"EB",10
22,"22076",288,228,226,1,2,"EB",0
22,"22002",106,95,94,0,1,"EB",0
44,"44092",70,56,55,1,1,"EB",0
26,"26070",155,133,132,0,1,"EB",2
44,"44120",219,158,152,1,6,"EB",0
14,"14019",6408,5163,5086,58,77,"EB",18
22,"22187",294,244,243,2,1,"EB",1
14,"14045",3013,2508,2468,13,40,"EB",4
44,"44007",152,120,117,0,3,"EB",0
26,"26095",95,78,78,1,0,"EB",0
26,"26171",156,131,127,0,4,"EB",0
44,"44141",127,100,100,0,0,"EB",0
22,"22027",306,230,225,3,5,"EB",1
22,"22008",155,127,125,0,2,"EB",0
39,"39010",610,518,512,1,6,"EB",0
26,"26026",1265,1061,1049,2,12,"EB",1
22,"22137",1015,741,733,9,8,"EB",0
50,"50014",119,85,85,0,0,"EB",1
22,"22247",30,21,21,0,0,"EB",1
4,"4037",1221,975,960,8,15,"EB",0
50,"50263",176,119,116,0,3,"EB",1
26,"26006",1825,1496,1470,8,26,"EB",2
50,"50234",242,194,187,3,7,"EB",2
26,"26153",10,9,9,0,0,"EB",0
26,"26141",100,73,73,0,0,"EB",0
50,"50039",467,366,364,3,2,"EB",1
50,"50289",51,40,38,1,2,"EB",0
50,"50214",18,10,10,0,0,"EB",1
22,"22205",459,347,345,1,2,"EB",0
44,"44011",48,32,32,1,0,"EB",0
4,"4020",286,218,217,1,1,"EB",0
22,"22048",12593,9614,9528,82,86,"EB",30
44,"44062",31,24,23,1,1,"EB",0
44,"44106",153,115,111,2,4,"EB",0
39,"39015",824,646,644,2,2,"EB",2
50,"50171",96,78,78,1,0,"EB",0
14,"14012",6076,4579,4489,38,90,"EB",2
22,"22116",1369,1025,1003,8,22,"EB",2
26,"26181",14,14,14,0,0,"EB",0
39,"39018",4272,3533,3476,17,57,"EB",4
50,"50228",250,217,214,3,3,"EB",0
4,"4069",4757,3633,3588,25,45,"EB",2
26,"26175",47,40,40,2,0,"EB",0
50,"50016",44,31,31,0,0,"EB",0
50,"50082",84,63,63,0,0,"EB",0
44,"44151",182,139,138,1,1,"EB",1
4,"4100",9266,6046,5988,49,58,"EB",9
44,"44264",248,175,171,0,4,"EB",0
26,"26016",28,24,23,0,1,"EB",0
14,"14006",1321,1155,1127,4,28,"EB",0
26,"26174",132,116,116,5,0,"EB",0
14,"14036",3676,2850,2766,40,84,"EB",4
22,"22042",117,96,95,1,1,"EB",0
22,"22158",11951,8877,8801,69,76,"EB",40
4,"4016",2128,1643,1621,4,22,"EB",2
50,"50209",2747,1993,1975,29,18,"EB",10
44,"44129",36,29,29,0,0,"EB",0
50,"50285",650,466,462,7,4,"EB",1
50,"50229",65,57,56,0,1,"EB",0
4,"4029",8819,6149,6073,45,76,"EB",6
39,"39099",3149,2562,2540,22,22,"EB",6
26,"26094",69,56,56,0,0,"EB",0
4,"4080",199,158,157,0,1,"EB",0
22,"22054",1617,1196,1183,15,13,"EB",7
22,"22218",40,32,31,1,1,"EB",0
39,"39042",5930,4722,4676,26,46,"EB",8
44,"44128",59,46,45,0,1,"EB",1
44,"44086",421,332,327,3,5,"EB",1
4,"4094",209,156,154,0,2,"EB",0
44,"44074",444,353,346,3,7,"EB",1
14,"14025",2857,2482,2436,14,46,"EB",3
22,"22047",241,213,212,2,1,"EB",1
22,"22904",761,581,566,2,15,"EB",0
44,"44050",3115,2333,2299,27,34,"EB",6
4,"4092",2789,2207,2173,6,34,"EB",2
22,"22220",150,120,117,0,3,"EB",0
22,"22001",214,162,162,0,0,"EB",2
44,"44231",36,33,32,0,1,"EB",0
22,"22015",300,232,226,5,6,"EB",2
14,"14047",1629,1300,1285,18,15,"EB",2
50,"50284",132,105,104,1,1,"EB",1
50,"50101",832,625,614,1,11,"EB",2
22,"22242",63,47,45,1,2,"EB",0
4,"4093",1919,1346,1326,10,20,"EB",2
4,"4043",511,423,421,3,2,"EB",0
14,"14001",3443,2724,2675,24,49,"EB",2
50,"50111",183,144,142,2,2,"EB",0
22,"22245",306,266,263,0,3,"EB",2
22,"22062",154,115,115,1,0,"EB",0
20,"20019",9912,7226,7195,51,31,"EB",8
20,"20034",3154,2336,2315,20,21,"EB",1
20,"20903",4803,3514,3481,24,33,"EB",4
20,"20073",4698,3530,3515,29,15,"EB",11
20,"20906",130,99,98,1,1,"EB",0
20,"20026",204,182,159,3,23,"EB",0
20,"20040",15753,11440,11364,69,76,"EB",15
20,"20042",3172,2247,2231,9,16,"EB",5
20,"20036",13192,9864,9806,67,58,"EB",16
20,"20902",14229,10567,10495,53,72,"EB",26
20,"20066",439,327,326,0,1,"EB",1
20,"20905",153,124,124,1,0,"EB",0
20,"20038",380,296,295,0,1,"EB",0
20,"20010",1528,1156,1151,5,5,"EB",2
20,"20060",88,75,75,0,0,"EB",0
20,"20050",270,186,183,3,3,"EB",0
20,"20063",8061,6042,5999,36,43,"EB",5
20,"20002",355,258,257,8,1,"EB",0
20,"20012",148,113,112,0,1,"EB",0
20,"20079",18142,14055,13971,75,84,"EB",17
20,"20067",30618,21972,21854,138,118,"EB",38
20,"20013",5430,4144,4119,19,25,"EB",16
20,"20020",113,67,67,0,0,"EB",0
20,"20039",2144,1704,1692,11,12,"EB",2
20,"20043",1734,1254,1248,5,6,"EB",0
20,"20015",1237,975,967,8,8,"EB",1
20,"20076",7025,5263,5237,31,26,"EB",3
20,"20016",1524,997,997,1,0,"EB",3
20,"20075",4346,3158,3134,19,24,"EB",4
20,"20035",484,384,384,2,0,"EB",0
20,"20044",364,263,262,0,1,"EB",1
20,"20078",1145,882,879,4,3,"EB",4
20,"20030",21198,15734,15654,100,80,"EB",15
20,"20029",4272,3257,3239,18,18,"EB",2
20,"20033",854,675,671,5,4,"EB",1
20,"20006",254,169,169,0,0,"EB",0
20,"20059",8867,6792,6759,21,33,"EB",3
20,"20072",4752,3445,3412,24,33,"EB",5
20,"20056",4075,2983,2942,12,41,"EB",2
20,"20069",147441,111102,110598,762,504,"EB",248
20,"20007",327,235,230,2,5,"EB",1
20,"20008",704,455,449,6,6,"EB",0
20,"20037",103,77,77,0,0,"EB",0
20,"20071",15036,11090,11025,59,65,"EB",13
20,"20024",391,274,274,1,0,"EB",0
20,"20018",11218,8145,8109,41,36,"EB",4
20,"20070",1083,831,823,2,8,"EB",2
20,"20054",459,313,312,1,1,"EB",0
20,"20074",11503,8767,8720,26,47,"EB",8
20,"20027",2758,1980,1958,19,22,"EB",2
20,"20046",1248,918,909,11,9,"EB",1
20,"20068",188,142,142,1,0,"EB",2
20,"20032",8681,6491,6429,22,62,"EB",11
20,"20021",186,112,112,0,0,"EB",1
20,"20003",551,401,399,2,2,"EB",0
20,"20004",227,156,154,4,2,"EB",0
20,"20005",1267,884,882,2,2,"EB",2
20,"20077",5254,4083,4059,22,24,"EB",4
20,"20052",1070,833,827,2,6,"EB",0
20,"20023",446,299,299,1,0,"EB",1
20,"20011",1633,1297,1287,2,10,"EB",2
20,"20061",4392,3278,3264,11,14,"EB",3
20,"20048",184,120,120,2,0,"EB",1
20,"20051",6775,5124,5091,24,33,"EB",9
20,"20057",194,143,143,0,0,"EB",0
20,"20058",739,555,551,4,4,"EB",1
20,"20904",89,50,49,0,1,"EB",0
20,"20028",2258,1579,1574,9,5,"EB",2
20,"20045",46866,33932,33700,191,232,"EB",47
20,"20064",12436,8730,8652,59,78,"EB",14
20,"20031",183,125,125,2,0,"EB",0
20,"20041",234,156,151,2,5,"EB",0
20,"20081",7655,5629,5601,22,28,"EB",8
20,"20017",8484,6294,6263,25,31,"EB",10
20,"20047",462,337,335,2,2,"EB",1
20,"20022",854,621,621,7,0,"EB",4
20,"20065",2943,2145,2124,11,21,"EB",5
20,"20014",1156,772,765,4,7,"EB",0
20,"20025",1116,835,830,2,5,"EB",0
20,"20055",17378,12565,12482,55,83,"EB",16
20,"20080",7709,5629,5588,28,41,"EB",6
20,"20009",11343,8168,8106,46,62,"EB",15
20,"20062",945,727,726,3,1,"EB",4
20,"20901",1412,1034,1030,2,4,"EB",1
20,"20907",117,88,87,0,1,"EB",2
20,"20001",257,174,172,1,2,"EB",1
20,"20053",4848,3479,3451,27,28,"EB",5
20,"20049",4159,3024,3004,11,20,"EB",2
36,"36009",4445,3081,2997,26,84,"EB",2
36,"36059",4663,3196,3115,31,81,"EB",6
36,"36017",17419,12867,12610,120,257,"EB",21
36,"36038",66806,50974,50429,507,545,"EB",91
36,"36046",4043,3157,3084,27,73,"EB",3
36,"36023",8279,6187,6085,46,102,"EB",8
36,"36010",2828,2217,2184,15,33,"EB",2
36,"36040",2517,1895,1853,18,42,"EB",2
36,"36036",2556,1953,1914,14,39,"EB",2
36,"36055",13551,9908,9682,105,226,"EB",19
36,"36045",24478,18627,18327,157,300,"EB",28
36,"36032",3537,2676,2626,16,50,"EB",3
36,"36049",7019,5414,5283,48,131,"EB",11
36,"36003",10038,7747,7632,79,115,"EB",19
36,"36004",10123,7396,7273,93,123,"EB",5
36,"36901",4152,3400,3338,15,62,"EB",4
36,"36027",4380,3262,3206,26,56,"EB",4
36,"36005",8122,5895,5776,65,119,"EB",6
36,"36037",2554,1839,1793,6,46,"EB",6
36,"36024",16395,12372,12165,102,207,"EB",10
36,"36042",18072,13314,13091,130,223,"EB",22
36,"36018",3073,2184,2144,9,40,"EB",1
36,"36052",7234,5292,5151,44,141,"EB",14
36,"36902",5052,3813,3724,21,89,"EB",1
36,"36047",2287,1601,1585,14,16,"EB",1
36,"36008",21884,16428,16170,165,258,"EB",36
36,"36033",12244,9553,9358,80,195,"EB",14
36,"36058",4942,3470,3402,37,68,"EB",6
36,"36021",12099,9105,8974,85,131,"EB",9
36,"36020",2184,1621,1599,13,22,"EB",2
36,"36035",14571,11096,10917,105,179,"EB",15
36,"36051",14315,10396,10223,70,173,"EB",5
36,"36026",19924,14342,14132,171,210,"EB",23
36,"36050",7650,5616,5506,48,110,"EB",10
36,"36044",2539,1768,1708,18,60,"EB",2
36,"36030",3946,2847,2810,26,37,"EB",3
36,"36048",5244,3859,3786,33,73,"EB",4
36,"36007",1618,1163,1133,7,30,"EB",1
36,"36006",11468,8959,8782,66,177,"EB",14
36,"36015",4076,2903,2834,37,69,"EB",7
36,"36041",13621,10098,9939,97,159,"EB",23
36,"36056",4961,3719,3635,30,84,"EB",1
36,"36028",4069,3012,2960,27,52,"EB",2
36,"36022",9061,6640,6482,47,158,"EB",6
36,"36060",30432,22488,22196,199,292,"EB",42
36,"36019",1463,1041,1030,14,11,"EB",2
36,"36014",1872,1373,1345,14,28,"EB",3
36,"36053",5784,4407,4327,28,80,"EB",3
36,"36039",15610,11844,11592,103,252,"EB",15
36,"36002",3076,2225,2185,19,40,"EB",1
36,"36016",1064,707,696,7,11,"EB",2
36,"36031",562,455,450,2,5,"EB",2
36,"36029",16086,12196,12005,126,191,"EB",14
36,"36057",238171,181891,180030,1636,1861,"EB",297
36,"36001",2401,1739,1715,19,24,"EB",1
36,"36043",4682,3345,3303,17,42,"EB",2
36,"36034",3319,2384,2347,16,37,"EB",1
36,"36054",11074,8032,7873,77,159,"EB",5
36,"36061",8617,6498,6391,59,107,"EB",3
36,"36013",2242,1468,1452,15,16,"EB",2
36,"36025",2137,1387,1381,7,6,"EB",3
8,"8290",1534,1289,1284,9,5,"ECP-GUANYEM",149
17,"17026",543,450,449,4,1,"ECP-GUANYEM",29
17,"17121",229,184,184,1,0,"ECP-GUANYEM",7
8,"8098",2409,1916,1912,9,4,"ECP-GUANYEM",239
25,"25194",415,325,325,3,0,"ECP-GUANYEM",14
43,"43137",1905,1515,1499,15,16,"ECP-GUANYEM",159
8,"8129",484,406,405,3,1,"ECP-GUANYEM",37
8,"8284",12482,8959,8887,41,72,"ECP-GUANYEM",1447
17,"17207",2411,2006,1992,8,14,"ECP-GUANYEM",119
17,"17011",651,544,544,4,0,"ECP-GUANYEM",30
8,"8176",161,132,131,2,1,"ECP-GUANYEM",5
17,"17013",2774,2180,2173,15,7,"ECP-GUANYEM",215
17,"17015",12819,10133,10078,38,55,"ECP-GUANYEM",725
8,"8241",69,56,56,0,0,"ECP-GUANYEM",4
8,"8080",39,30,30,0,0,"ECP-GUANYEM",0
8,"8019",1117818,875679,872180,4327,3499,"ECP-GUANYEM",142143
25,"25173",1649,1278,1262,5,16,"ECP-GUANYEM",185
17,"17223",800,623,616,5,7,"ECP-GUANYEM",71
8,"8143",2719,2121,2109,10,12,"ECP-GUANYEM",250
8,"8273",2353,1944,1934,9,10,"ECP-GUANYEM",206
25,"25245",430,346,342,1,4,"ECP-GUANYEM",50
43,"43145",4209,3409,3391,9,18,"ECP-GUANYEM",300
8,"8002",220,184,183,2,1,"ECP-GUANYEM",18
25,"25142",365,300,299,2,1,"ECP-GUANYEM",23
8,"8162",2124,1659,1651,7,8,"ECP-GUANYEM",258
43,"43030",482,373,372,2,1,"ECP-GUANYEM",49
43,"43006",676,531,525,4,6,"ECP-GUANYEM",55
8,"8136",11614,9159,9079,84,80,"ECP-GUANYEM",1980
43,"43082",351,303,297,1,6,"ECP-GUANYEM",27
8,"8082",1143,868,861,4,7,"ECP-GUANYEM",149
8,"8275",248,223,222,1,1,"ECP-GUANYEM",9
25,"25181",175,136,135,0,1,"ECP-GUANYEM",8
8,"8064",1920,1516,1506,6,10,"ECP-GUANYEM",129
8,"8053",2865,2105,2098,17,7,"ECP-GUANYEM",271
8,"8072",10699,8226,8193,45,33,"ECP-GUANYEM",1281
8,"8037",1930,1618,1610,10,8,"ECP-GUANYEM",62
8,"8149",984,770,768,3,2,"ECP-GUANYEM",32
8,"8229",521,435,433,3,2,"ECP-GUANYEM",24
25,"25023",4527,3621,3601,23,20,"ECP-GUANYEM",296
17,"17048",6251,4565,4537,20,28,"ECP-GUANYEM",450
8,"8261",2378,1821,1815,14,6,"ECP-GUANYEM",229
8,"8215",2589,2044,2034,19,10,"ECP-GUANYEM",131
43,"43009",1391,1086,1078,3,8,"ECP-GUANYEM",71
8,"8289",4457,3605,3594,20,11,"ECP-GUANYEM",540
17,"17089",5695,4211,4194,13,17,"ECP-GUANYEM",376
17,"17086",1745,1223,1210,7,13,"ECP-GUANYEM",117
25,"25201",110,89,89,0,0,"ECP-GUANYEM",11
8,"8209",6896,5269,5244,25,25,"ECP-GUANYEM",907
8,"8117",2480,2055,2050,16,5,"ECP-GUANYEM",141
17,"17061",183,148,148,0,0,"ECP-GUANYEM",5
8,"8089",34019,26317,26191,170,126,"ECP-GUANYEM",4524
17,"17029",199,160,157,1,3,"ECP-GUANYEM",9
17,"17155",14861,10307,10234,52,73,"ECP-GUANYEM",1079
25,"25222",66,57,57,0,0,"ECP-GUANYEM",0
17,"17143",144,115,115,0,0,"ECP-GUANYEM",13
25,"25101",543,454,449,1,5,"ECP-GUANYEM",14
43,"43003",350,266,264,3,2,"ECP-GUANYEM",52
43,"43004",6274,4744,4691,39,53,"ECP-GUANYEM",533
8,"8159",14323,11399,11359,57,40,"ECP-GUANYEM",2233
25,"25099",1291,981,978,2,3,"ECP-GUANYEM",52
25,"25225",541,427,420,4,7,"ECP-GUANYEM",10
8,"8264",4535,3623,3613,13,10,"ECP-GUANYEM",325
17,"17125",131,98,97,1,1,"ECP-GUANYEM",5
25,"25193",767,614,606,6,8,"ECP-GUANYEM",16
43,"43076",460,378,377,2,1,"ECP-GUANYEM",20
17,"17163",2824,2358,2351,13,7,"ECP-GUANYEM",138
43,"43150",1238,1034,1026,6,8,"ECP-GUANYEM",108
17,"17128",316,255,252,1,3,"ECP-GUANYEM",18
8,"8131",741,585,585,4,0,"ECP-GUANYEM",34
25,"25049",155,113,111,0,2,"ECP-GUANYEM",2
17,"17010",327,264,263,2,1,"ECP-GUANYEM",27
25,"25192",724,564,558,4,6,"ECP-GUANYEM",50
25,"25015",335,262,260,8,2,"ECP-GUANYEM",18
8,"8184",54876,41661,41447,248,214,"ECP-GUANYEM",8328
43,"43170",878,706,704,7,2,"ECP-GUANYEM",61
25,"25071",42,32,31,0,1,"ECP-GUANYEM",1
8,"8075",4059,3127,3119,14,8,"ECP-GUANYEM",440
8,"8217",25355,20935,20855,110,80,"ECP-GUANYEM",3947
8,"8246",1672,1412,1406,7,6,"ECP-GUANYEM",76
17,"17110",1329,1064,1054,5,10,"ECP-GUANYEM",99
17,"17001",580,459,454,3,5,"ECP-GUANYEM",41
25,"25063",95,61,61,0,0,"ECP-GUANYEM",3
43,"43127",759,630,626,3,4,"ECP-GUANYEM",54
25,"25074",180,157,155,2,2,"ECP-GUANYEM",8
17,"17042",408,313,311,0,2,"ECP-GUANYEM",29
25,"25004",575,470,467,2,3,"ECP-GUANYEM",39
8,"8029",3560,3027,3019,13,8,"ECP-GUANYEM",281
43,"43110",251,184,184,1,0,"ECP-GUANYEM",16
8,"8006",11774,9039,8981,33,58,"ECP-GUANYEM",989
25,"25254",711,576,571,5,5,"ECP-GUANYEM",55
8,"8263",21151,16360,16269,116,91,"ECP-GUANYEM",2872
8,"8107",11900,9303,9187,43,116,"ECP-GUANYEM",1775
8,"8221",12699,10571,10537,53,34,"ECP-GUANYEM",1422
17,"17232",149,117,116,0,1,"ECP-GUANYEM",13
25,"25053",1092,879,873,8,6,"ECP-GUANYEM",58
43,"43031",1446,1180,1178,7,2,"ECP-GUANYEM",86
25,"25191",321,248,244,3,4,"ECP-GUANYEM",8
25,"25072",5874,4468,4450,24,18,"ECP-GUANYEM",333
43,"43902",2743,1996,1980,16,16,"ECP-GUANYEM",229
17,"17139",1394,1163,1154,3,9,"ECP-GUANYEM",78
17,"17115",278,226,222,2,4,"ECP-GUANYEM",14
8,"8011",1745,1414,1407,10,7,"ECP-GUANYEM",73
17,"17099",78,59,59,0,0,"ECP-GUANYEM",2
25,"25200",323,253,252,0,1,"ECP-GUANYEM",9
43,"43014",14357,10596,10542,60,54,"ECP-GUANYEM",1269
43,"43160",1322,1051,1045,0,6,"ECP-GUANYEM",115
17,"17181",3467,2664,2648,10,16,"ECP-GUANYEM",302
8,"8904",10514,7733,7697,38,36,"ECP-GUANYEM",1772
8,"8122",1716,1260,1254,8,6,"ECP-GUANYEM",176
17,"17022",7008,5386,5354,22,32,"ECP-GUANYEM",600
17,"17092",3467,2660,2633,17,27,"ECP-GUANYEM",262
17,"17188",169,139,138,1,1,"ECP-GUANYEM",13
43,"43116",463,381,379,2,2,"ECP-GUANYEM",28
25,"25203",8798,6279,6231,26,48,"ECP-GUANYEM",627
8,"8265",1590,1339,1334,6,5,"ECP-GUANYEM",70
8,"8097",1080,891,880,2,11,"ECP-GUANYEM",93
25,"25220",994,822,816,3,6,"ECP-GUANYEM",31
8,"8039",402,334,334,2,0,"ECP-GUANYEM",49
43,"43050",2634,1881,1868,13,13,"ECP-GUANYEM",248
8,"8014",2000,1578,1567,5,11,"ECP-GUANYEM",158
8,"8056",42727,33215,33054,220,161,"ECP-GUANYEM",5726
25,"25103",136,103,102,2,1,"ECP-GUANYEM",8
17,"17185",2275,1777,1768,7,9,"ECP-GUANYEM",136
8,"8126",8865,7125,7098,33,27,"ECP-GUANYEM",1401
43,"43112",250,204,204,1,0,"ECP-GUANYEM",6
25,"25062",695,578,573,3,5,"ECP-GUANYEM",40
8,"8049",1320,981,977,5,4,"ECP-GUANYEM",65
8,"8236",1557,1204,1202,2,2,"ECP-GUANYEM",104
43,"43035",235,205,203,7,2,"ECP-GUANYEM",12
25,"25212",224,195,195,2,0,"ECP-GUANYEM",11
25,"25027",977,765,763,4,2,"ECP-GUANYEM",41
8,"8161",11625,8521,8470,44,51,"ECP-GUANYEM",1490
25,"25901",287,209,207,1,2,"ECP-GUANYEM",15
43,"43138",2648,1926,1896,8,30,"ECP-GUANYEM",227
43,"43105",156,132,132,3,0,"ECP-GUANYEM",8
25,"25013",2108,1570,1557,12,13,"ECP-GUANYEM",124
43,"43163",26013,18942,18796,89,146,"ECP-GUANYEM",2837
25,"25146",221,172,170,3,2,"ECP-GUANYEM",8
25,"25224",126,98,98,0,0,"ECP-GUANYEM",4
8,"8096",43555,34070,33871,194,199,"ECP-GUANYEM",4694
25,"25122",1925,1505,1497,23,8,"ECP-GUANYEM",79
25,"25177",358,270,268,1,2,"ECP-GUANYEM",16
17,"17084",231,181,180,1,1,"ECP-GUANYEM",11
8,"8303",256,215,213,1,2,"ECP-GUANYEM",18
25,"25121",635,436,429,1,7,"ECP-GUANYEM",51
43,"43904",2861,2083,2058,27,25,"ECP-GUANYEM",255
43,"43133",5605,4202,4168,21,34,"ECP-GUANYEM",528
8,"8175",3368,2496,2486,16,10,"ECP-GUANYEM",141
17,"17066",27323,18373,18269,98,104,"ECP-GUANYEM",1800
17,"17095",19938,13998,13918,69,80,"ECP-GUANYEM",1949
17,"17044",6930,5514,5493,26,21,"ECP-GUANYEM",445
25,"25131",402,321,320,1,1,"ECP-GUANYEM",17
8,"8034",784,648,646,1,2,"ECP-GUANYEM",42
17,"17055",143,126,125,0,1,"ECP-GUANYEM",10
25,"25038",1482,1111,1094,11,17,"ECP-GUANYEM",55
8,"8061",1590,1236,1233,8,3,"ECP-GUANYEM",194
17,"17148",1531,1165,1153,4,12,"ECP-GUANYEM",121
8,"8041",10692,7805,7732,48,73,"ECP-GUANYEM",1364
8,"8145",2701,2156,2144,7,12,"ECP-GUANYEM",252
43,"43167",384,334,333,2,1,"ECP-GUANYEM",32
43,"43142",1083,850,842,8,8,"ECP-GUANYEM",90
43,"43094",2120,1659,1646,9,13,"ECP-GUANYEM",116
25,"25234",4201,3087,3072,13,15,"ECP-GUANYEM",267
8,"8074",11054,8273,8235,34,38,"ECP-GUANYEM",1494
8,"8091",5413,4301,4283,20,18,"ECP-GUANYEM",744
17,"17136",195,156,155,0,1,"ECP-GUANYEM",27
8,"8292",1062,835,831,3,4,"ECP-GUANYEM",88
43,"43075",86,71,69,0,2,"ECP-GUANYEM",5
17,"17168",379,332,329,0,3,"ECP-GUANYEM",17
8,"8115",3825,2994,2975,12,19,"ECP-GUANYEM",586
25,"25255",395,321,318,2,3,"ECP-GUANYEM",28
43,"43130",177,145,145,0,0,"ECP-GUANYEM",2
17,"17147",7959,6164,6130,45,34,"ECP-GUANYEM",457
8,"8078",219,176,172,1,4,"ECP-GUANYEM",14
17,"17176",123,110,110,1,0,"ECP-GUANYEM",9
17,"17180",8500,6462,6431,28,31,"ECP-GUANYEM",556
25,"25154",118,94,94,0,0,"ECP-GUANYEM",2
8,"8133",128,98,98,5,0,"ECP-GUANYEM",4
8,"8077",34578,27617,27501,134,116,"ECP-GUANYEM",4724
43,"43124",472,379,373,1,6,"ECP-GUANYEM",26
43,"43123",71092,53689,53369,241,320,"ECP-GUANYEM",6191
8,"8004",209,194,191,0,3,"ECP-GUANYEM",8
17,"17116",354,283,282,0,1,"ECP-GUANYEM",17
43,"43095",2564,1995,1984,14,11,"ECP-GUANYEM",260
25,"25119",2245,1798,1792,10,6,"ECP-GUANYEM",106
8,"8130",108,89,86,2,3,"ECP-GUANYEM",2
17,"17141",6072,4251,4221,14,30,"ECP-GUANYEM",411
25,"25180",228,176,174,1,2,"ECP-GUANYEM",7
8,"8104",653,516,516,2,0,"ECP-GUANYEM",30
43,"43169",450,396,396,3,0,"ECP-GUANYEM",38
17,"17132",1333,1088,1080,9,8,"ECP-GUANYEM",74
43,"43036",865,605,602,1,3,"ECP-GUANYEM",82
25,"25009",605,505,491,5,14,"ECP-GUANYEM",26
17,"17109",698,558,553,1,5,"ECP-GUANYEM",37
25,"25098",232,172,170,2,2,"ECP-GUANYEM",10
8,"8272",165,133,133,0,0,"ECP-GUANYEM",4
8,"8027",720,592,588,3,4,"ECP-GUANYEM",57
8,"8114",18648,14251,14170,69,81,"ECP-GUANYEM",2533
17,"17171",172,143,141,0,2,"ECP-GUANYEM",9
43,"43177",284,243,242,0,1,"ECP-GUANYEM",7
8,"8220",2411,2119,2115,13,4,"ECP-GUANYEM",77
25,"25165",276,221,219,1,2,"ECP-GUANYEM",9
17,"17090",544,469,468,0,1,"ECP-GUANYEM",19
17,"17107",269,221,219,2,2,"ECP-GUANYEM",11
8,"8048",569,442,442,2,0,"ECP-GUANYEM",22
43,"43907",4359,3370,3346,22,24,"ECP-GUANYEM",507
8,"8008",179,139,138,0,1,"ECP-GUANYEM",7
8,"8259",6904,5626,5601,27,25,"ECP-GUANYEM",668
25,"25057",214,162,161,0,1,"ECP-GUANYEM",22
25,"25169",167,118,117,0,1,"ECP-GUANYEM",7
17,"17214",723,584,580,7,4,"ECP-GUANYEM",40
17,"17192",146,121,120,0,1,"ECP-GUANYEM",6
25,"25044",178,145,144,6,1,"ECP-GUANYEM",6
25,"25196",112,94,93,0,1,"ECP-GUANYEM",12
8,"8127",2240,1694,1683,13,11,"ECP-GUANYEM",200
25,"25157",162,137,137,4,0,"ECP-GUANYEM",6
43,"43040",326,278,276,0,2,"ECP-GUANYEM",26
8,"8222",1819,1484,1476,11,8,"ECP-GUANYEM",218
25,"25136",96,79,79,2,0,"ECP-GUANYEM",1
8,"8124",37130,29069,28915,146,154,"ECP-GUANYEM",5696
8,"8063",467,406,405,3,1,"ECP-GUANYEM",36
17,"17035",550,460,460,3,0,"ECP-GUANYEM",20
8,"8026",193,161,161,1,0,"ECP-GUANYEM",3
8,"8047",3737,2903,2876,16,27,"ECP-GUANYEM",235
8,"8099",753,565,561,2,4,"ECP-GUANYEM",42
43,"43161",17113,12944,12881,64,63,"ECP-GUANYEM",1341
8,"8021",61,47,45,0,2,"ECP-GUANYEM",3
17,"17203",165,135,135,0,0,"ECP-GUANYEM",11
25,"25036",184,144,143,0,1,"ECP-GUANYEM",11
8,"8055",541,443,442,2,1,"ECP-GUANYEM",33
8,"8193",984,792,790,5,2,"ECP-GUANYEM",99
43,"43049",727,589,584,2,5,"ECP-GUANYEM",38
43,"43046",90,73,73,1,0,"ECP-GUANYEM",4
25,"25076",134,94,93,0,1,"ECP-GUANYEM",9
8,"8005",6380,5122,5106,18,16,"ECP-GUANYEM",574
8,"8196",19444,15361,15263,90,98,"ECP-GUANYEM",2940
43,"43033",768,609,607,3,2,"ECP-GUANYEM",65
17,"17004",533,445,441,3,4,"ECP-GUANYEM",33
17,"17213",5535,3998,3985,20,13,"ECP-GUANYEM",463
25,"25135",1000,773,769,2,4,"ECP-GUANYEM",41
8,"8160",316,252,247,2,5,"ECP-GUANYEM",22
43,"43066",155,121,121,1,0,"ECP-GUANYEM",13
8,"8134",842,649,646,3,3,"ECP-GUANYEM",80
8,"8169",48284,37528,37326,218,202,"ECP-GUANYEM",8436
8,"8112",12935,9822,9765,74,57,"ECP-GUANYEM",858
43,"43042",2198,1820,1816,8,4,"ECP-GUANYEM",180
8,"8158",3108,2458,2453,13,5,"ECP-GUANYEM",385
25,"25087",56,49,49,0,0,"ECP-GUANYEM",2
8,"8185",197,172,171,2,1,"ECP-GUANYEM",20
17,"17024",285,228,227,0,1,"ECP-GUANYEM",9
43,"43140",2438,1847,1837,16,10,"ECP-GUANYEM",293
25,"25100",184,145,144,1,1,"ECP-GUANYEM",9
8,"8183",4563,3628,3613,9,15,"ECP-GUANYEM",292
25,"25228",3115,2468,2459,19,9,"ECP-GUANYEM",195
8,"8150",251,211,211,0,0,"ECP-GUANYEM",15
17,"17183",255,216,216,0,0,"ECP-GUANYEM",9
8,"8213",6547,5270,5245,23,25,"ECP-GUANYEM",593
43,"43901",8750,6057,6004,43,53,"ECP-GUANYEM",596
8,"8268",971,746,737,3,9,"ECP-GUANYEM",42
25,"25137",8686,6327,6296,46,31,"ECP-GUANYEM",511
25,"25908",221,159,158,1,1,"ECP-GUANYEM",15
43,"43024",1556,1154,1137,3,17,"ECP-GUANYEM",161
43,"43149",684,533,533,4,0,"ECP-GUANYEM",24
25,"25039",261,216,216,1,0,"ECP-GUANYEM",24
17,"17196",242,198,198,1,0,"ECP-GUANYEM",21
43,"43043",3289,2624,2613,14,11,"ECP-GUANYEM",388
43,"43141",105,86,86,0,0,"ECP-GUANYEM",2
17,"17215",2227,1936,1925,12,11,"ECP-GUANYEM",147
25,"25149",1378,1108,1102,3,6,"ECP-GUANYEM",53
17,"17106",143,124,123,0,1,"ECP-GUANYEM",9
25,"25019",4646,3224,3199,22,25,"ECP-GUANYEM",363
17,"17234",179,147,146,2,1,"ECP-GUANYEM",13
8,"8269",2712,2258,2250,19,8,"ECP-GUANYEM",155
8,"8181",8061,6442,6402,28,40,"ECP-GUANYEM",933
25,"25105",103,89,88,1,1,"ECP-GUANYEM",7
25,"25094",139,116,116,0,0,"ECP-GUANYEM",6
8,"8234",3373,2742,2734,25,8,"ECP-GUANYEM",414
25,"25227",664,517,517,1,0,"ECP-GUANYEM",36
8,"8094",1586,1310,1306,10,4,"ECP-GUANYEM",139
8,"8051",18437,14951,14887,85,64,"ECP-GUANYEM",2369
43,"43044",3949,3060,3032,31,28,"ECP-GUANYEM",387
17,"17077",567,434,434,2,0,"ECP-GUANYEM",31
43,"43020",2276,1831,1819,12,12,"ECP-GUANYEM",297
17,"17068",246,194,193,0,1,"ECP-GUANYEM",16
43,"43132",363,292,291,2,1,"ECP-GUANYEM",33
25,"25171",2127,1639,1630,8,9,"ECP-GUANYEM",103
8,"8153",559,460,458,2,2,"ECP-GUANYEM",47
8,"8267",6748,5389,5362,28,27,"ECP-GUANYEM",943
43,"43034",468,393,393,0,0,"ECP-GUANYEM",21
43,"43064",2017,1569,1558,9,11,"ECP-GUANYEM",113
25,"25907",497,389,386,2,3,"ECP-GUANYEM",27
25,"25006",317,246,245,3,1,"ECP-GUANYEM",16
25,"25112",268,214,212,2,2,"ECP-GUANYEM",12
17,"17204",596,461,460,2,1,"ECP-GUANYEM",30
43,"43144",1236,1025,1021,8,4,"ECP-GUANYEM",112
25,"25051",1510,1176,1172,6,4,"ECP-GUANYEM",72
43,"43090",1169,749,742,2,7,"ECP-GUANYEM",138
17,"17202",3813,2876,2851,8,25,"ECP-GUANYEM",285
8,"8052",139,111,110,0,1,"ECP-GUANYEM",2
8,"8156",11155,8956,8923,60,33,"ECP-GUANYEM",1578
43,"43026",765,614,613,3,1,"ECP-GUANYEM",29
8,"8171",2066,1607,1597,7,10,"ECP-GUANYEM",80
8,"8139",177,156,156,0,0,"ECP-GUANYEM",18
43,"43103",905,746,740,8,6,"ECP-GUANYEM",100
8,"8297",135,111,111,1,0,"ECP-GUANYEM",8
43,"43078",843,653,644,4,9,"ECP-GUANYEM",50
43,"43062",259,223,220,2,3,"ECP-GUANYEM",26
43,"43168",84,65,65,1,0,"ECP-GUANYEM",0
8,"8010",4207,3327,3304,13,23,"ECP-GUANYEM",281
8,"8271",67,57,57,0,0,"ECP-GUANYEM",8
25,"25164",357,264,261,4,3,"ECP-GUANYEM",9
43,"43096",98,82,82,0,0,"ECP-GUANYEM",11
8,"8148",2334,1803,1794,6,9,"ECP-GUANYEM",314
25,"25002",467,357,356,2,1,"ECP-GUANYEM",24
8,"8079",334,284,282,0,2,"ECP-GUANYEM",15
25,"25033",1121,899,890,5,9,"ECP-GUANYEM",68
25,"25052",1562,1273,1264,3,9,"ECP-GUANYEM",70
43,"43022",1435,1130,1123,8,7,"ECP-GUANYEM",86
25,"25185",679,493,491,6,2,"ECP-GUANYEM",35
8,"8254",1753,1485,1482,3,3,"ECP-GUANYEM",76
17,"17020",3671,3021,3006,11,15,"ECP-GUANYEM",211
25,"25003",3721,2828,2815,19,13,"ECP-GUANYEM",158
8,"8054",9155,7468,7428,43,40,"ECP-GUANYEM",1403
43,"43097",399,341,341,1,0,"ECP-GUANYEM",32
8,"8235",3829,3176,3167,14,9,"ECP-GUANYEM",301
17,"17175",564,381,381,1,0,"ECP-GUANYEM",28
25,"25153",192,152,150,1,2,"ECP-GUANYEM",13
17,"17178",1056,804,798,3,6,"ECP-GUANYEM",60
17,"17211",831,694,691,1,3,"ECP-GUANYEM",29
8,"8022",12219,9089,9038,42,51,"ECP-GUANYEM",617
8,"8123",19489,16197,16135,58,62,"ECP-GUANYEM",2626
17,"17058",170,139,139,0,0,"ECP-GUANYEM",20
8,"8207",2014,1736,1730,9,6,"ECP-GUANYEM",126
17,"17150",1426,1199,1192,8,7,"ECP-GUANYEM",71
8,"8242",222,180,180,0,0,"ECP-GUANYEM",13
8,"8177",39,31,31,0,0,"ECP-GUANYEM",2
43,"43083",144,116,113,1,3,"ECP-GUANYEM",7
17,"17228",285,229,229,1,0,"ECP-GUANYEM",14
17,"17091",398,310,305,2,5,"ECP-GUANYEM",9
43,"43146",41,35,35,0,0,"ECP-GUANYEM",2
25,"25035",366,306,302,2,4,"ECP-GUANYEM",23
8,"8174",392,330,330,4,0,"ECP-GUANYEM",22
25,"25113",1116,912,908,8,4,"ECP-GUANYEM",39
17,"17184",1264,1068,1060,5,8,"ECP-GUANYEM",62
25,"25143",84,72,71,0,1,"ECP-GUANYEM",5
17,"17144",210,171,170,0,1,"ECP-GUANYEM",15
17,"17164",3932,3078,3054,8,24,"ECP-GUANYEM",165
8,"8178",451,389,388,3,1,"ECP-GUANYEM",39
8,"8205",61279,51629,51497,360,132,"ECP-GUANYEM",6438
17,"17154",99,84,83,0,1,"ECP-GUANYEM",21
25,"25202",108,75,75,0,0,"ECP-GUANYEM",9
8,"8188",115,95,95,0,0,"ECP-GUANYEM",1
17,"17074",532,436,426,2,10,"ECP-GUANYEM",36
8,"8283",6113,4832,4813,33,19,"ECP-GUANYEM",373
8,"8214",6966,5648,5633,21,15,"ECP-GUANYEM",596
8,"8301",49135,38575,38398,272,177,"ECP-GUANYEM",7763
25,"25114",95,79,79,0,0,"ECP-GUANYEM",3
17,"17102",548,439,435,3,4,"ECP-GUANYEM",21
8,"8266",43383,35117,34994,178,123,"ECP-GUANYEM",6771
17,"17165",634,516,512,3,4,"ECP-GUANYEM",35
17,"17194",78,62,62,0,0,"ECP-GUANYEM",5
43,"43107",383,308,308,1,0,"ECP-GUANYEM",52
8,"8152",116,94,94,0,0,"ECP-GUANYEM",7
25,"25249",176,139,138,1,1,"ECP-GUANYEM",8
17,"17083",2961,2321,2300,12,21,"ECP-GUANYEM",351
25,"25218",86,79,79,0,0,"ECP-GUANYEM",1
8,"8083",1672,1478,1471,7,7,"ECP-GUANYEM",61
43,"43072",93,74,74,0,0,"ECP-GUANYEM",3
8,"8198",4640,3713,3691,23,22,"ECP-GUANYEM",427
8,"8308",137,118,118,0,0,"ECP-GUANYEM",3
25,"25238",205,163,163,2,0,"ECP-GUANYEM",12
25,"25166",172,137,136,1,1,"ECP-GUANYEM",3
17,"17217",353,312,311,1,1,"ECP-GUANYEM",14
43,"43055",1988,1631,1622,7,9,"ECP-GUANYEM",104
8,"8262",6919,5090,5060,33,30,"ECP-GUANYEM",696
8,"8007",6775,5447,5419,21,28,"ECP-GUANYEM",523
17,"17111",958,772,771,3,1,"ECP-GUANYEM",67
17,"17021",122,98,98,0,0,"ECP-GUANYEM",12
17,"17006",1186,880,878,10,2,"ECP-GUANYEM",84
17,"17187",625,530,529,4,1,"ECP-GUANYEM",57
43,"43125",890,700,698,12,2,"ECP-GUANYEM",80
43,"43158",77,61,61,1,0,"ECP-GUANYEM",1
25,"25058",4358,3269,3254,7,15,"ECP-GUANYEM",190
43,"43084",521,424,423,2,1,"ECP-GUANYEM",25
17,"17225",207,161,161,0,0,"ECP-GUANYEM",2
43,"43002",1875,1367,1348,11,19,"ECP-GUANYEM",174
8,"8016",1812,1454,1448,6,6,"ECP-GUANYEM",127
8,"8110",13592,10111,10058,50,53,"ECP-GUANYEM",1413
43,"43117",143,114,113,0,1,"ECP-GUANYEM",6
43,"43037",17902,12787,12695,63,92,"ECP-GUANYEM",2047
25,"25104",122,91,91,0,0,"ECP-GUANYEM",4
25,"25239",595,367,366,3,1,"ECP-GUANYEM",31
17,"17016",719,584,581,1,3,"ECP-GUANYEM",50
8,"8119",6838,5352,5326,31,26,"ECP-GUANYEM",1062
8,"8067",5728,4535,4513,21,22,"ECP-GUANYEM",398
17,"17096",164,113,113,1,0,"ECP-GUANYEM",7
25,"25138",547,440,436,1,4,"ECP-GUANYEM",8
17,"17216",155,127,124,0,3,"ECP-GUANYEM",5
43,"43028",2766,2007,1988,7,19,"ECP-GUANYEM",323
8,"8905",2308,1943,1938,7,5,"ECP-GUANYEM",311
17,"17227",139,106,106,0,0,"ECP-GUANYEM",8
8,"8009",9480,7649,7620,35,29,"ECP-GUANYEM",925
25,"25906",210,157,155,0,2,"ECP-GUANYEM",8
25,"25060",69,49,49,1,0,"ECP-GUANYEM",4
25,"25150",165,136,133,0,3,"ECP-GUANYEM",5
25,"25125",389,303,300,1,3,"ECP-GUANYEM",4
43,"43175",537,426,419,5,7,"ECP-GUANYEM",27
25,"25156",784,608,605,4,3,"ECP-GUANYEM",45
8,"8244",6041,4994,4970,33,24,"ECP-GUANYEM",1054
43,"43018",385,335,334,3,1,"ECP-GUANYEM",26
8,"8212",491,406,402,1,4,"ECP-GUANYEM",12
17,"17902",1306,1076,1074,3,2,"ECP-GUANYEM",62
43,"43056",806,616,613,5,3,"ECP-GUANYEM",43
17,"17064",326,263,261,2,2,"ECP-GUANYEM",14
25,"25127",214,172,172,0,0,"ECP-GUANYEM",14
43,"43143",51,45,44,0,1,"ECP-GUANYEM",4
17,"17208",976,772,768,5,4,"ECP-GUANYEM",60
8,"8180",27072,21218,21100,126,118,"ECP-GUANYEM",4767
43,"43069",178,146,146,0,0,"ECP-GUANYEM",19
17,"17078",336,252,251,3,1,"ECP-GUANYEM",6
17,"17038",380,312,308,3,4,"ECP-GUANYEM",21
25,"25085",141,118,117,2,1,"ECP-GUANYEM",3
17,"17009",4051,3263,3248,14,15,"ECP-GUANYEM",258
8,"8069",3280,2691,2680,17,11,"ECP-GUANYEM",402
43,"43136",10463,7789,7749,36,40,"ECP-GUANYEM",918
8,"8306",527,390,388,2,2,"ECP-GUANYEM",56
17,"17189",1476,1278,1275,2,3,"ECP-GUANYEM",73
8,"8035",12871,9574,9538,31,36,"ECP-GUANYEM",1129
8,"8298",26980,20900,20817,91,83,"ECP-GUANYEM",1598
25,"25014",249,203,200,2,3,"ECP-GUANYEM",16
25,"25197",141,109,108,0,1,"ECP-GUANYEM",1
17,"17039",1740,1385,1380,8,5,"ECP-GUANYEM",84
25,"25209",1550,1192,1172,4,20,"ECP-GUANYEM",101
43,"43120",421,302,297,2,5,"ECP-GUANYEM",35
17,"17069",364,286,284,2,2,"ECP-GUANYEM",22
25,"25022",107,88,88,0,0,"ECP-GUANYEM",4
8,"8125",25485,19719,19627,101,92,"ECP-GUANYEM",4192
17,"17120",820,604,598,3,6,"ECP-GUANYEM",47
17,"17191",166,145,144,2,1,"ECP-GUANYEM",8
17,"17151",185,150,150,1,0,"ECP-GUANYEM",9
8,"8105",9724,7557,7505,49,52,"ECP-GUANYEM",1433
8,"8028",1088,783,780,2,3,"ECP-GUANYEM",141
17,"17152",11026,7610,7564,70,46,"ECP-GUANYEM",743
43,"43047",4209,2878,2856,23,22,"ECP-GUANYEM",317
8,"8012",1721,1340,1331,8,9,"ECP-GUANYEM",57
8,"8218",8104,6419,6389,34,30,"ECP-GUANYEM",885
43,"43156",3956,2993,2965,23,28,"ECP-GUANYEM",326
43,"43102",463,384,379,2,5,"ECP-GUANYEM",24
43,"43007",640,510,509,0,1,"ECP-GUANYEM",52
8,"8247",980,832,828,3,4,"ECP-GUANYEM",41
43,"43148",90763,69756,69423,299,333,"ECP-GUANYEM",9377
17,"17040",551,465,459,4,6,"ECP-GUANYEM",37
8,"8031",2336,1886,1882,11,4,"ECP-GUANYEM",157
17,"17198",433,332,329,0,3,"ECP-GUANYEM",39
43,"43077",455,342,339,2,3,"ECP-GUANYEM",24
17,"17901",983,790,789,3,1,"ECP-GUANYEM",60
8,"8224",878,697,695,1,2,"ECP-GUANYEM",98
25,"25124",157,114,114,0,0,"ECP-GUANYEM",11
17,"17081",248,192,190,0,2,"ECP-GUANYEM",9
17,"17134",223,189,189,1,0,"ECP-GUANYEM",17
17,"17100",195,157,154,0,3,"ECP-GUANYEM",4
8,"8300",5892,4912,4880,24,32,"ECP-GUANYEM",846
17,"17222",105,95,95,1,0,"ECP-GUANYEM",3
8,"8257",103,86,86,1,0,"ECP-GUANYEM",8
25,"25176",307,262,259,1,3,"ECP-GUANYEM",12
25,"25064",98,88,88,0,0,"ECP-GUANYEM",1
43,"43131",4772,3432,3401,18,31,"ECP-GUANYEM",490
25,"25910",91,70,67,2,3,"ECP-GUANYEM",4
25,"25089",97,72,71,1,1,"ECP-GUANYEM",11
25,"25070",811,677,675,4,2,"ECP-GUANYEM",45
43,"43114",375,306,305,0,1,"ECP-GUANYEM",34
17,"17003",102,75,75,0,0,"ECP-GUANYEM",3
25,"25067",706,537,532,4,5,"ECP-GUANYEM",33
17,"17212",142,117,117,2,0,"ECP-GUANYEM",3
8,"8901",240,203,201,1,2,"ECP-GUANYEM",12
25,"25077",440,331,330,1,1,"ECP-GUANYEM",20
17,"17076",122,101,100,1,1,"ECP-GUANYEM",12
25,"25223",911,732,723,6,9,"ECP-GUANYEM",50
8,"8293",228,187,187,1,0,"ECP-GUANYEM",8
17,"17124",1599,1258,1254,6,4,"ECP-GUANYEM",85
43,"43099",286,234,234,0,0,"ECP-GUANYEM",7
8,"8030",5209,4318,4305,16,13,"ECP-GUANYEM",453
17,"17145",1432,1113,1103,7,10,"ECP-GUANYEM",71
8,"8249",272,248,248,2,0,"ECP-GUANYEM",20
25,"25056",213,163,163,3,0,"ECP-GUANYEM",10
25,"25046",407,349,347,1,2,"ECP-GUANYEM",29
43,"43135",341,283,280,4,3,"ECP-GUANYEM",24
17,"17129",144,120,120,1,0,"ECP-GUANYEM",3
17,"17034",7205,5337,5291,16,46,"ECP-GUANYEM",568
25,"25903",229,189,188,0,1,"ECP-GUANYEM",8
25,"25034",2288,1733,1719,9,14,"ECP-GUANYEM",65
43,"43903",2333,1717,1700,11,17,"ECP-GUANYEM",154
25,"25139",491,390,388,3,2,"ECP-GUANYEM",34
43,"43080",227,195,195,0,0,"ECP-GUANYEM",13
43,"43151",109,98,98,0,0,"ECP-GUANYEM",4
25,"25151",736,592,584,1,8,"ECP-GUANYEM",35
25,"25904",162,147,147,3,0,"ECP-GUANYEM",12
17,"17137",3467,2925,2912,15,13,"ECP-GUANYEM",174
17,"17094",1068,772,766,1,6,"ECP-GUANYEM",59
25,"25069",425,329,327,1,2,"ECP-GUANYEM",10
8,"8216",25,19,19,0,0,"ECP-GUANYEM",2
25,"25205",562,451,447,7,4,"ECP-GUANYEM",31
25,"25079",285,228,227,0,1,"ECP-GUANYEM",6
43,"43092",7235,5200,5174,21,26,"ECP-GUANYEM",597
8,"8251",5127,3972,3940,17,32,"ECP-GUANYEM",547
17,"17138",845,650,646,0,4,"ECP-GUANYEM",70
17,"17025",1170,972,967,6,5,"ECP-GUANYEM",66
8,"8285",10321,8169,8120,52,49,"ECP-GUANYEM",671
25,"25152",144,106,106,1,0,"ECP-GUANYEM",3
8,"8210",4584,3455,3435,23,20,"ECP-GUANYEM",437
43,"43011",1079,912,909,1,3,"ECP-GUANYEM",70
43,"43019",1336,1020,1008,4,12,"ECP-GUANYEM",84
8,"8024",357,301,298,1,3,"ECP-GUANYEM",8
17,"17060",408,311,311,1,0,"ECP-GUANYEM",14
8,"8050",136,115,114,0,1,"ECP-GUANYEM",3
17,"17206",155,118,115,0,3,"ECP-GUANYEM",4
17,"17177",567,459,457,2,2,"ECP-GUANYEM",33
25,"25040",10614,7791,7734,58,57,"ECP-GUANYEM",623
8,"8208",5760,4660,4643,25,17,"ECP-GUANYEM",849
43,"43118",425,357,356,0,1,"ECP-GUANYEM",38
8,"8182",2892,2217,2204,18,13,"ECP-GUANYEM",322
8,"8042",2362,1910,1904,7,6,"ECP-GUANYEM",343
25,"25129",159,115,115,2,0,"ECP-GUANYEM",3
25,"25025",1378,996,983,8,13,"ECP-GUANYEM",127
43,"43023",214,186,186,1,0,"ECP-GUANYEM",21
8,"8111",215,200,199,4,1,"ECP-GUANYEM",9
8,"8295",11184,8566,8529,43,37,"ECP-GUANYEM",1551
25,"25037",366,286,284,3,2,"ECP-GUANYEM",9
25,"25020",274,221,221,2,0,"ECP-GUANYEM",7
17,"17071",1128,978,978,3,0,"ECP-GUANYEM",54
8,"8100",2092,1792,1782,16,10,"ECP-GUANYEM",78
25,"25093",629,489,487,4,2,"ECP-GUANYEM",30
17,"17054",347,271,271,0,0,"ECP-GUANYEM",24
43,"43119",838,630,628,4,2,"ECP-GUANYEM",67
43,"43021",345,270,269,3,1,"ECP-GUANYEM",26
43,"43045",146,128,127,0,1,"ECP-GUANYEM",8
43,"43086",5263,4046,4021,17,25,"ECP-GUANYEM",333
17,"17088",578,468,468,1,0,"ECP-GUANYEM",44
25,"25219",149,118,118,1,0,"ECP-GUANYEM",16
8,"8001",9079,7383,7341,40,42,"ECP-GUANYEM",1476
17,"17199",6955,5328,5308,23,20,"ECP-GUANYEM",390
25,"25001",139,104,103,1,1,"ECP-GUANYEM",13
25,"25110",2731,2121,2106,14,15,"ECP-GUANYEM",171
43,"43054",2792,2145,2134,21,11,"ECP-GUANYEM",132
25,"25021",2541,1891,1882,14,9,"ECP-GUANYEM",132
8,"8201",447,327,324,5,3,"ECP-GUANYEM",21
8,"8038",1525,1228,1220,2,8,"ECP-GUANYEM",115
25,"25005",274,202,202,2,0,"ECP-GUANYEM",8
17,"17063",173,157,156,2,1,"ECP-GUANYEM",4
25,"25208",333,252,249,0,3,"ECP-GUANYEM",40
17,"17209",615,519,517,2,2,"ECP-GUANYEM",43
43,"43038",21861,16504,16406,112,98,"ECP-GUANYEM",2103
25,"25045",54,31,31,5,0,"ECP-GUANYEM",4
43,"43115",128,112,111,1,1,"ECP-GUANYEM",4
17,"17012",1171,916,914,10,2,"ECP-GUANYEM",99
8,"8211",33731,27698,27561,126,137,"ECP-GUANYEM",5180
8,"8203",2472,1884,1873,4,11,"ECP-GUANYEM",254
8,"8044",4136,3193,3175,11,18,"ECP-GUANYEM",357
17,"17049",3204,2634,2615,9,19,"ECP-GUANYEM",237
25,"25244",362,296,294,2,2,"ECP-GUANYEM",14
8,"8071",241,200,200,0,0,"ECP-GUANYEM",24
8,"8307",49310,38223,38022,162,201,"ECP-GUANYEM",6370
25,"25909",140,108,107,2,1,"ECP-GUANYEM",9
43,"43905",14941,10510,10446,40,64,"ECP-GUANYEM",1317
8,"8059",344,292,290,2,2,"ECP-GUANYEM",22
8,"8230",7666,6202,6168,30,34,"ECP-GUANYEM",787
25,"25186",207,174,173,7,1,"ECP-GUANYEM",8
43,"43015",119,101,101,0,0,"ECP-GUANYEM",18
43,"43154",126,111,111,0,0,"ECP-GUANYEM",9
8,"8189",122,106,106,0,0,"ECP-GUANYEM",3
25,"25182",1043,842,839,9,3,"ECP-GUANYEM",78
25,"25163",236,181,179,3,2,"ECP-GUANYEM",7
17,"17047",4968,3447,3429,22,18,"ECP-GUANYEM",342
25,"25061",80,59,58,0,1,"ECP-GUANYEM",3
17,"17027",2866,2375,2364,8,11,"ECP-GUANYEM",201
43,"43157",345,303,303,0,0,"ECP-GUANYEM",13
17,"17126",318,279,279,0,0,"ECP-GUANYEM",17
8,"8282",6711,5696,5677,27,19,"ECP-GUANYEM",764
25,"25189",2164,1591,1583,11,8,"ECP-GUANYEM",184
8,"8291",4919,3865,3854,28,11,"ECP-GUANYEM",692
17,"17002",564,491,488,3,3,"ECP-GUANYEM",30
17,"17101",562,415,413,2,2,"ECP-GUANYEM",52
8,"8073",62572,48770,48527,255,243,"ECP-GUANYEM",10165
25,"25155",618,493,489,2,4,"ECP-GUANYEM",30
8,"8020",5172,4337,4327,26,10,"ECP-GUANYEM",666
8,"8274",4674,3710,3698,12,12,"ECP-GUANYEM",472
25,"25016",2083,1590,1587,8,3,"ECP-GUANYEM",117
17,"17085",291,248,246,0,2,"ECP-GUANYEM",17
43,"43005",3643,2765,2749,22,16,"ECP-GUANYEM",343
8,"8151",448,378,377,2,1,"ECP-GUANYEM",9
25,"25248",880,714,713,4,1,"ECP-GUANYEM",20
17,"17041",218,166,165,3,1,"ECP-GUANYEM",14
17,"17158",468,337,336,1,1,"ECP-GUANYEM",17
8,"8058",1787,1357,1340,5,17,"ECP-GUANYEM",199
8,"8286",2919,2210,2199,15,11,"ECP-GUANYEM",344
17,"17073",1939,1695,1693,7,2,"ECP-GUANYEM",96
25,"25190",257,215,215,0,0,"ECP-GUANYEM",21
43,"43017",116,98,98,1,0,"ECP-GUANYEM",5
17,"17093",922,716,715,2,1,"ECP-GUANYEM",66
8,"8223",1886,1434,1425,4,9,"ECP-GUANYEM",175
43,"43001",694,543,543,5,0,"ECP-GUANYEM",79
17,"17052",134,104,104,1,0,"ECP-GUANYEM",9
8,"8179",611,496,493,2,3,"ECP-GUANYEM",97
25,"25092",127,101,99,1,2,"ECP-GUANYEM",4
25,"25132",143,118,118,0,0,"ECP-GUANYEM",12
25,"25240",1385,1116,1110,10,6,"ECP-GUANYEM",82
25,"25215",505,299,299,4,0,"ECP-GUANYEM",25
25,"25115",801,638,637,4,1,"ECP-GUANYEM",38
8,"8144",713,565,563,5,2,"ECP-GUANYEM",37
25,"25120",92704,68713,68361,445,352,"ECP-GUANYEM",7087
25,"25231",494,410,408,2,2,"ECP-GUANYEM",33
25,"25075",131,102,102,0,0,"ECP-GUANYEM",8
8,"8299",377,318,317,0,1,"ECP-GUANYEM",24
25,"25175",176,135,135,1,0,"ECP-GUANYEM",12
8,"8296",1843,1520,1514,10,6,"ECP-GUANYEM",171
17,"17169",2497,2047,2042,8,5,"ECP-GUANYEM",186
8,"8227",2410,1882,1877,10,5,"ECP-GUANYEM",199
43,"43010",337,286,284,2,2,"ECP-GUANYEM",42
17,"17205",211,184,184,1,0,"ECP-GUANYEM",12
17,"17005",460,336,331,0,5,"ECP-GUANYEM",23
43,"43093",3884,2956,2933,14,23,"ECP-GUANYEM",290
17,"17065",324,254,253,0,1,"ECP-GUANYEM",13
8,"8277",171,150,150,0,0,"ECP-GUANYEM",17
8,"8233",1846,1485,1478,8,7,"ECP-GUANYEM",76
8,"8260",18400,14471,14406,87,65,"ECP-GUANYEM",2976
25,"25017",232,184,181,0,3,"ECP-GUANYEM",6
43,"43053",188,153,149,0,4,"ECP-GUANYEM",14
17,"17161",1018,859,855,1,4,"ECP-GUANYEM",74
25,"25167",226,185,185,2,0,"ECP-GUANYEM",23
17,"17190",838,681,677,0,4,"ECP-GUANYEM",63
25,"25128",127,87,87,0,0,"ECP-GUANYEM",10
43,"43134",273,224,223,5,1,"ECP-GUANYEM",24
43,"43070",238,194,193,1,1,"ECP-GUANYEM",11
8,"8090",137,113,113,2,0,"ECP-GUANYEM",7
8,"8116",558,459,459,0,0,"ECP-GUANYEM",15
8,"8137",274,232,229,0,3,"ECP-GUANYEM",16
25,"25008",1088,867,857,7,10,"ECP-GUANYEM",35
43,"43052",934,765,756,2,9,"ECP-GUANYEM",62
8,"8287",1057,877,871,7,6,"ECP-GUANYEM",88
43,"43159",81,63,62,0,1,"ECP-GUANYEM",1
8,"8172",20417,16196,16144,88,52,"ECP-GUANYEM",2821
25,"25252",557,424,422,4,2,"ECP-GUANYEM",26
43,"43085",235,198,194,0,4,"ECP-GUANYEM",13
17,"17087",222,177,176,0,1,"ECP-GUANYEM",11
8,"8232",1786,1444,1434,9,10,"ECP-GUANYEM",157
8,"8045",71,52,49,0,3,"ECP-GUANYEM",7
17,"17159",626,487,483,1,4,"ECP-GUANYEM",50
43,"43121",591,463,462,0,1,"ECP-GUANYEM",25
8,"8167",6048,4833,4822,48,11,"ECP-GUANYEM",1089
43,"43113",397,325,323,2,2,"ECP-GUANYEM",30
25,"25078",1001,807,805,5,2,"ECP-GUANYEM",54
8,"8197",7896,6197,6174,28,23,"ECP-GUANYEM",621
25,"25913",86,77,77,0,0,"ECP-GUANYEM",7
25,"25179",171,134,134,1,0,"ECP-GUANYEM",8
25,"25242",689,539,531,0,8,"ECP-GUANYEM",39
25,"25032",67,53,53,0,0,"ECP-GUANYEM",6
17,"17224",302,233,231,2,2,"ECP-GUANYEM",9
43,"43013",4392,3341,3321,14,20,"ECP-GUANYEM",285
8,"8305",27533,21656,21539,96,117,"ECP-GUANYEM",2567
8,"8270",18837,14541,14497,66,44,"ECP-GUANYEM",1764
25,"25097",84,72,72,1,0,"ECP-GUANYEM",3
25,"25243",3730,2637,2606,20,31,"ECP-GUANYEM",327
8,"8043",3378,2579,2569,20,10,"ECP-GUANYEM",474
8,"8228",288,239,239,2,0,"ECP-GUANYEM",20
8,"8202",12843,10074,10025,57,49,"ECP-GUANYEM",1152
8,"8113",52518,39750,39592,198,158,"ECP-GUANYEM",4349
17,"17233",2328,1924,1912,6,12,"ECP-GUANYEM",174
17,"17112",194,154,152,2,2,"ECP-GUANYEM",12
17,"17008",3594,2763,2741,16,22,"ECP-GUANYEM",199
17,"17082",436,341,339,0,2,"ECP-GUANYEM",25
8,"8165",1664,1315,1311,9,4,"ECP-GUANYEM",148
17,"17220",805,673,665,2,8,"ECP-GUANYEM",24
17,"17032",1742,1235,1224,6,11,"ECP-GUANYEM",132
25,"25251",713,562,558,4,4,"ECP-GUANYEM",32
43,"43060",2684,2158,2152,8,6,"ECP-GUANYEM",135
8,"8168",394,287,287,1,0,"ECP-GUANYEM",37
17,"17230",499,397,393,0,4,"ECP-GUANYEM",31
8,"8157",8547,6949,6918,39,31,"ECP-GUANYEM",1280
8,"8070",266,232,232,0,0,"ECP-GUANYEM",18
43,"43088",2026,1565,1562,9,3,"ECP-GUANYEM",166
8,"8281",4840,4009,3998,23,11,"ECP-GUANYEM",451
17,"17162",156,114,111,1,3,"ECP-GUANYEM",27
8,"8106",7469,5816,5795,34,21,"ECP-GUANYEM",825
25,"25221",117,92,92,0,0,"ECP-GUANYEM",7
8,"8068",6878,5456,5437,25,19,"ECP-GUANYEM",874
8,"8200",62161,48645,48330,261,315,"ECP-GUANYEM",10039
17,"17030",650,479,477,4,2,"ECP-GUANYEM",33
43,"43126",1211,1005,999,4,6,"ECP-GUANYEM",110
8,"8238",14851,12472,12428,50,44,"ECP-GUANYEM",1643
8,"8206",737,625,624,3,1,"ECP-GUANYEM",58
8,"8132",361,281,281,2,0,"ECP-GUANYEM",11
25,"25031",57,39,39,0,0,"ECP-GUANYEM",1
8,"8138",4432,3435,3413,10,22,"ECP-GUANYEM",362
8,"8025",1535,1221,1214,7,7,"ECP-GUANYEM",186
43,"43129",4611,3528,3495,21,33,"ECP-GUANYEM",245
8,"8146",1358,1086,1079,2,7,"ECP-GUANYEM",202
17,"17149",364,314,314,0,0,"ECP-GUANYEM",26
17,"17043",167,135,134,0,1,"ECP-GUANYEM",9
17,"17172",457,352,349,1,3,"ECP-GUANYEM",31
8,"8046",13478,10989,10939,67,50,"ECP-GUANYEM",1636
8,"8142",139,126,126,1,0,"ECP-GUANYEM",6
8,"8195",76,69,69,0,0,"ECP-GUANYEM",5
43,"43106",793,656,651,2,5,"ECP-GUANYEM",77
25,"25911",424,332,331,1,1,"ECP-GUANYEM",19
17,"17062",5978,4358,4334,26,24,"ECP-GUANYEM",418
25,"25134",603,492,490,1,2,"ECP-GUANYEM",25
43,"43166",1628,1292,1285,3,7,"ECP-GUANYEM",145
17,"17103",5084,3575,3543,13,32,"ECP-GUANYEM",567
17,"17153",188,162,162,0,0,"ECP-GUANYEM",19
17,"17170",180,147,147,2,0,"ECP-GUANYEM",2
25,"25233",285,231,229,2,2,"ECP-GUANYEM",17
43,"43098",354,291,291,1,0,"ECP-GUANYEM",32
8,"8084",1167,941,936,6,5,"ECP-GUANYEM",91
25,"25073",546,420,418,2,2,"ECP-GUANYEM",25
8,"8102",28794,22420,22317,92,103,"ECP-GUANYEM",2381
43,"43027",164,137,137,0,0,"ECP-GUANYEM",3
43,"43041",228,179,177,3,2,"ECP-GUANYEM",13
17,"17023",27144,20301,20146,120,155,"ECP-GUANYEM",3326
25,"25902",542,449,439,3,10,"ECP-GUANYEM",19
25,"25102",661,517,511,8,6,"ECP-GUANYEM",37
43,"43073",84,68,67,0,1,"ECP-GUANYEM",10
43,"43172",337,261,257,2,4,"ECP-GUANYEM",25
8,"8240",9453,7807,7776,21,31,"ECP-GUANYEM",1171
17,"17114",23269,17558,17474,91,84,"ECP-GUANYEM",1319
25,"25912",843,685,684,4,1,"ECP-GUANYEM",55
17,"17182",272,220,220,3,0,"ECP-GUANYEM",30
8,"8163",19497,14616,14548,67,68,"ECP-GUANYEM",1947
17,"17210",580,449,445,2,4,"ECP-GUANYEM",34
43,"43162",4418,3467,3453,20,14,"ECP-GUANYEM",394
17,"17050",674,585,582,5,3,"ECP-GUANYEM",40
17,"17166",547,460,459,2,1,"ECP-GUANYEM",24
17,"17221",4152,3260,3247,11,13,"ECP-GUANYEM",292
43,"43178",1421,1118,1113,7,5,"ECP-GUANYEM",124
8,"8003",7183,5761,5742,39,19,"ECP-GUANYEM",548
25,"25068",531,402,399,6,3,"ECP-GUANYEM",17
8,"8279",155280,121081,120515,802,566,"ECP-GUANYEM",21785
17,"17160",14733,10833,10766,43,67,"ECP-GUANYEM",1407
8,"8288",1676,1196,1182,6,14,"ECP-GUANYEM",174
8,"8302",9373,7001,6934,61,67,"ECP-GUANYEM",1306
43,"43173",99,80,78,0,2,"ECP-GUANYEM",4
8,"8032",2087,1607,1598,9,9,"ECP-GUANYEM",202
17,"17157",124,107,107,0,0,"ECP-GUANYEM",13
43,"43165",572,492,492,1,0,"ECP-GUANYEM",33
43,"43067",528,450,445,1,5,"ECP-GUANYEM",29
43,"43109",2704,1937,1922,16,15,"ECP-GUANYEM",323
43,"43059",250,214,214,1,0,"ECP-GUANYEM",16
8,"8147",17282,13644,13560,94,84,"ECP-GUANYEM",2491
8,"8280",95,78,78,1,0,"ECP-GUANYEM",10
25,"25042",208,160,160,1,0,"ECP-GUANYEM",8
43,"43016",3445,2628,2608,11,20,"ECP-GUANYEM",428
43,"43008",307,202,200,1,2,"ECP-GUANYEM",18
43,"43051",9092,6577,6502,26,75,"ECP-GUANYEM",1229
25,"25011",5260,3908,3871,30,37,"ECP-GUANYEM",330
43,"43104",1762,1410,1401,5,9,"ECP-GUANYEM",111
17,"17174",162,132,132,4,0,"ECP-GUANYEM",8
8,"8191",5270,4176,4162,19,14,"ECP-GUANYEM",511
17,"17056",1766,1438,1433,9,5,"ECP-GUANYEM",108
8,"8128",577,454,451,0,3,"ECP-GUANYEM",42
8,"8085",976,812,811,2,1,"ECP-GUANYEM",63
25,"25161",343,243,243,0,0,"ECP-GUANYEM",23
8,"8154",701,587,586,5,1,"ECP-GUANYEM",73
8,"8252",24729,19751,19642,125,109,"ECP-GUANYEM",4310
43,"43012",3647,3028,3019,15,9,"ECP-GUANYEM",423
8,"8226",926,811,807,1,4,"ECP-GUANYEM",41
43,"43091",123,93,93,1,0,"ECP-GUANYEM",29
25,"25133",686,528,527,2,1,"ECP-GUANYEM",24
17,"17201",143,120,120,0,0,"ECP-GUANYEM",9
17,"17080",144,124,124,2,0,"ECP-GUANYEM",6
17,"17070",110,94,94,0,0,"ECP-GUANYEM",3
43,"43071",891,713,706,6,7,"ECP-GUANYEM",64
17,"17033",5587,4157,4130,13,27,"ECP-GUANYEM",582
8,"8015",156003,117736,117183,704,553,"ECP-GUANYEM",22042
8,"8276",233,180,180,0,0,"ECP-GUANYEM",26
25,"25141",152,118,118,1,0,"ECP-GUANYEM",10
8,"8065",1180,967,964,4,3,"ECP-GUANYEM",80
8,"8155",6960,5427,5390,39,37,"ECP-GUANYEM",1020
8,"8250",7182,5461,5421,38,40,"ECP-GUANYEM",921
25,"25130",183,142,140,0,2,"ECP-GUANYEM",7
8,"8192",5679,4605,4589,20,16,"ECP-GUANYEM",459
8,"8095",67,53,52,0,1,"ECP-GUANYEM",2
25,"25140",773,573,571,5,2,"ECP-GUANYEM",66
17,"17028",297,238,237,1,1,"ECP-GUANYEM",10
17,"17130",322,268,268,0,0,"ECP-GUANYEM",9
43,"43128",905,751,747,4,4,"ECP-GUANYEM",77
17,"17218",570,468,465,5,3,"ECP-GUANYEM",44
43,"43139",1999,1552,1539,10,13,"ECP-GUANYEM",84
8,"8187",153380,120687,120090,637,597,"ECP-GUANYEM",20380
17,"17051",207,174,173,3,1,"ECP-GUANYEM",8
25,"25010",196,156,155,2,1,"ECP-GUANYEM",9
25,"25207",6430,4899,4867,41,32,"ECP-GUANYEM",362
43,"43025",590,476,472,0,4,"ECP-GUANYEM",34
43,"43057",38,31,31,1,0,"ECP-GUANYEM",3
17,"17105",247,194,194,1,0,"ECP-GUANYEM",34
43,"43122",111,98,97,0,1,"ECP-GUANYEM",19
17,"17903",889,726,721,4,5,"ECP-GUANYEM",32
25,"25145",76,66,66,1,0,"ECP-GUANYEM",2
17,"17135",395,309,307,0,2,"ECP-GUANYEM",27
25,"25174",390,324,324,0,0,"ECP-GUANYEM",14
8,"8237",1662,1334,1327,7,7,"ECP-GUANYEM",61
43,"43147",521,446,442,4,4,"ECP-GUANYEM",20
43,"43074",1812,1419,1412,4,7,"ECP-GUANYEM",167
43,"43063",536,401,397,1,4,"ECP-GUANYEM",38
8,"8194",25674,17691,17585,115,106,"ECP-GUANYEM",3251
8,"8108",5192,4204,4189,26,15,"ECP-GUANYEM",717
8,"8120",7048,5892,5881,49,11,"ECP-GUANYEM",324
25,"25206",250,189,188,2,1,"ECP-GUANYEM",4
17,"17197",131,113,113,1,0,"ECP-GUANYEM",9
17,"17067",697,581,578,4,3,"ECP-GUANYEM",32
17,"17142",2673,2250,2241,14,9,"ECP-GUANYEM",196
43,"43079",356,306,305,1,1,"ECP-GUANYEM",34
25,"25210",1079,867,853,4,14,"ECP-GUANYEM",37
25,"25123",189,151,151,0,0,"ECP-GUANYEM",8
8,"8062",1004,829,826,11,3,"ECP-GUANYEM",79
8,"8140",4778,3756,3737,19,19,"ECP-GUANYEM",420
8,"8166",962,753,745,7,8,"ECP-GUANYEM",38
25,"25024",352,273,272,0,1,"ECP-GUANYEM",19
25,"25096",888,663,661,2,2,"ECP-GUANYEM",38
25,"25148",219,168,168,1,0,"ECP-GUANYEM",2
17,"17075",334,282,281,5,1,"ECP-GUANYEM",19
8,"8109",208,184,183,0,1,"ECP-GUANYEM",5
8,"8204",3115,2548,2534,22,14,"ECP-GUANYEM",444
25,"25247",147,100,100,2,0,"ECP-GUANYEM",18
8,"8256",691,571,568,3,3,"ECP-GUANYEM",125
43,"43032",466,379,379,1,0,"ECP-GUANYEM",31
43,"43155",22619,16724,16624,101,100,"ECP-GUANYEM",2026
25,"25216",241,199,199,2,0,"ECP-GUANYEM",7
25,"25118",327,241,239,2,2,"ECP-GUANYEM",10
8,"8066",1463,1185,1181,9,4,"ECP-GUANYEM",207
8,"8902",3937,3176,3164,17,12,"ECP-GUANYEM",508
25,"25088",95,85,83,0,2,"ECP-GUANYEM",6
17,"17123",345,304,303,4,1,"ECP-GUANYEM",18
25,"25211",672,513,512,6,1,"ECP-GUANYEM",21
17,"17031",182,130,129,0,1,"ECP-GUANYEM",7
25,"25158",1606,1291,1277,5,14,"ECP-GUANYEM",78
43,"43174",144,128,127,0,1,"ECP-GUANYEM",12
8,"8225",94,81,81,1,0,"ECP-GUANYEM",4
17,"17117",14471,10565,10504,52,61,"ECP-GUANYEM",1115
25,"25170",261,230,228,4,2,"ECP-GUANYEM",10
8,"8033",13218,10480,10435,50,45,"ECP-GUANYEM",1408
25,"25059",813,621,612,3,9,"ECP-GUANYEM",64
17,"17007",1752,1430,1422,2,8,"ECP-GUANYEM",76
17,"17133",1273,1048,1043,7,5,"ECP-GUANYEM",49
25,"25126",284,233,232,1,1,"ECP-GUANYEM",16
8,"8304",816,686,678,1,8,"ECP-GUANYEM",41
8,"8258",813,661,657,6,4,"ECP-GUANYEM",26
8,"8255",137,105,105,1,0,"ECP-GUANYEM",4
17,"17036",2643,2076,2071,12,5,"ECP-GUANYEM",169
17,"17046",710,574,571,3,3,"ECP-GUANYEM",46
17,"17200",623,512,510,1,2,"ECP-GUANYEM",57
8,"8088",12248,9945,9904,57,41,"ECP-GUANYEM",1174
17,"17195",342,296,295,3,1,"ECP-GUANYEM",16
43,"43058",96,77,77,0,0,"ECP-GUANYEM",8
25,"25012",2342,1748,1739,10,9,"ECP-GUANYEM",218
17,"17098",303,245,245,2,0,"ECP-GUANYEM",15
17,"17019",1784,1472,1462,3,10,"ECP-GUANYEM",82
8,"8245",77805,57956,57666,313,290,"ECP-GUANYEM",11714
8,"8103",640,507,505,4,2,"ECP-GUANYEM",60
17,"17119",73,58,58,2,0,"ECP-GUANYEM",6
8,"8121",87292,67638,67328,362,310,"ECP-GUANYEM",10008
43,"43111",2098,1496,1483,8,13,"ECP-GUANYEM",230
8,"8170",442,338,338,0,0,"ECP-GUANYEM",20
8,"8903",197,177,176,0,1,"ECP-GUANYEM",10
8,"8135",6735,5445,5421,36,24,"ECP-GUANYEM",1124
8,"8199",651,542,542,4,0,"ECP-GUANYEM",34
25,"25029",1607,1270,1265,6,5,"ECP-GUANYEM",96
17,"17079",65381,50872,50631,242,241,"ECP-GUANYEM",4965
25,"25043",801,613,606,1,7,"ECP-GUANYEM",67
43,"43101",145,122,122,1,0,"ECP-GUANYEM",7
25,"25081",287,221,220,2,1,"ECP-GUANYEM",12
43,"43065",382,308,304,1,4,"ECP-GUANYEM",15
17,"17118",12916,9521,9460,37,61,"ECP-GUANYEM",912
43,"43164",306,228,228,0,0,"ECP-GUANYEM",33
8,"8231",21132,15940,15880,75,60,"ECP-GUANYEM",2780
17,"17140",639,539,527,4,12,"ECP-GUANYEM",34
17,"17097",199,172,170,1,2,"ECP-GUANYEM",10
43,"43081",633,532,531,7,1,"ECP-GUANYEM",62
8,"8076",16497,12734,12667,82,67,"ECP-GUANYEM",2142
43,"43068",483,367,365,5,2,"ECP-GUANYEM",22
25,"25230",1555,1221,1208,8,13,"ECP-GUANYEM",38
43,"43171",14705,11002,10956,62,46,"ECP-GUANYEM",1550
8,"8239",460,380,378,2,2,"ECP-GUANYEM",44
8,"8101",174954,129953,129198,680,755,"ECP-GUANYEM",23551
8,"8017",2827,2192,2182,16,10,"ECP-GUANYEM",234
25,"25232",1356,1066,1061,2,5,"ECP-GUANYEM",82
8,"8164",934,784,776,1,8,"ECP-GUANYEM",80
8,"8278",4893,4034,4018,17,16,"ECP-GUANYEM",257
17,"17057",968,826,822,1,4,"ECP-GUANYEM",51
17,"17226",895,673,669,3,4,"ECP-GUANYEM",56
43,"43176",746,588,586,7,2,"ECP-GUANYEM",44
25,"25111",113,90,89,0,1,"ECP-GUANYEM",2
43,"43089",281,209,208,0,1,"ECP-GUANYEM",33
25,"25030",123,90,90,1,0,"ECP-GUANYEM",4
17,"17167",2609,2122,2102,14,20,"ECP-GUANYEM",123
8,"8118",17542,14101,14059,56,42,"ECP-GUANYEM",2057
25,"25055",163,130,129,0,1,"ECP-GUANYEM",10
25,"25168",488,408,407,6,1,"ECP-GUANYEM",8
8,"8243",156,139,139,0,0,"ECP-GUANYEM",5
43,"43108",1778,1374,1365,6,9,"ECP-GUANYEM",100
43,"43061",38,28,28,0,0,"ECP-GUANYEM",1
43,"43906",2103,1595,1587,14,8,"ECP-GUANYEM",149
17,"17018",494,405,402,1,3,"ECP-GUANYEM",35
8,"8190",258,216,215,1,1,"ECP-GUANYEM",13
8,"8219",15629,12910,12865,58,45,"ECP-GUANYEM",1658
25,"25041",528,399,396,4,3,"ECP-GUANYEM",17
8,"8036",163,134,133,0,1,"ECP-GUANYEM",4
25,"25905",369,308,307,1,1,"ECP-GUANYEM",21
43,"43048",763,614,609,7,5,"ECP-GUANYEM",62
8,"8248",5616,4378,4365,32,13,"ECP-GUANYEM",719
8,"8023",6915,5339,5299,26,40,"ECP-GUANYEM",896
8,"8087",149,135,133,0,2,"ECP-GUANYEM",7
17,"17173",182,156,156,0,0,"ECP-GUANYEM",11
43,"43152",434,357,356,0,1,"ECP-GUANYEM",17
8,"8093",24,20,20,0,0,"ECP-GUANYEM",1
8,"8040",11004,8468,8431,24,37,"ECP-GUANYEM",1030
43,"43153",11092,8327,8291,34,36,"ECP-GUANYEM",1143
25,"25172",1779,1407,1405,3,2,"ECP-GUANYEM",73
8,"8013",1280,1040,1031,5,9,"ECP-GUANYEM",117
8,"8141",4573,3611,3595,26,16,"ECP-GUANYEM",252
17,"17014",63,51,50,0,1,"ECP-GUANYEM",2
43,"43100",3489,2820,2816,15,4,"ECP-GUANYEM",495
8,"8294",2063,1644,1643,10,1,"ECP-GUANYEM",259
17,"17193",4312,3202,3179,15,23,"ECP-GUANYEM",365
25,"25226",242,184,183,4,1,"ECP-GUANYEM",7
8,"8018",2551,1998,1984,6,14,"ECP-GUANYEM",217
25,"25007",1392,1089,1083,4,6,"ECP-GUANYEM",106
43,"43039",105,85,85,0,0,"ECP-GUANYEM",2
25,"25204",1191,936,930,5,6,"ECP-GUANYEM",39
25,"25086",521,414,411,2,3,"ECP-GUANYEM",28
43,"43029",314,253,252,0,1,"ECP-GUANYEM",27
17,"17186",3824,3115,3098,15,17,"ECP-GUANYEM",320
8,"8081",353,299,297,2,2,"ECP-GUANYEM",27
25,"25047",972,784,781,8,3,"ECP-GUANYEM",27
25,"25109",214,179,176,3,3,"ECP-GUANYEM",8
25,"25048",1632,1274,1264,7,10,"ECP-GUANYEM",85
8,"8086",14017,10746,10677,89,69,"ECP-GUANYEM",1715
25,"25217",10819,8163,8120,64,43,"ECP-GUANYEM",686
25,"25250",330,261,258,1,3,"ECP-GUANYEM",4
25,"25082",295,229,229,2,0,"ECP-GUANYEM",20
17,"17146",3127,2404,2381,11,23,"ECP-GUANYEM",364
17,"17037",114,98,98,6,0,"ECP-GUANYEM",2
8,"8253",128,113,113,0,0,"ECP-GUANYEM",7
25,"25050",3269,2457,2446,23,11,"ECP-GUANYEM",172
25,"25183",535,419,416,4,3,"ECP-GUANYEM",39
8,"8057",61,50,50,0,0,"ECP-GUANYEM",4
25,"25253",145,122,121,0,1,"ECP-GUANYEM",9
8,"8060",135,111,109,0,2,"ECP-GUANYEM",5
8,"8092",3714,2912,2889,8,23,"ECP-GUANYEM",176
1,"1054",1013,729,726,2,3,"EH Bildu",260
31,"31200",748,555,546,5,9,"EH Bildu",118
31,"31194",326,251,250,1,1,"EH Bildu",59
31,"31902",4649,3620,3598,34,22,"EH Bildu",410
31,"31141",107,76,74,0,2,"EH Bildu",3
48,"48001",5885,4359,4334,35,25,"EH Bildu",1087
20,"20008",704,455,449,6,6,"EH Bildu",228
48,"48085",10637,8270,8223,54,47,"EH Bildu",1487
31,"31064",1387,1174,1163,9,11,"EH Bildu",30
31,"31159",1105,880,871,3,9,"EH Bildu",191
1,"1002",8035,6227,6159,17,68,"EH Bildu",1314
31,"31114",374,291,286,4,5,"EH Bildu",43
1,"1047",967,686,673,8,13,"EH Bildu",30
31,"31151",57,42,42,1,0,"EH Bildu",6
48,"48067",1134,877,872,5,5,"EH Bildu",359
20,"20031",183,125,125,2,0,"EH Bildu",62
31,"31241",125,100,100,2,0,"EH Bildu",12
1,"1037",585,426,425,1,1,"EH Bildu",94
1,"1056",205,134,134,0,0,"EH Bildu",25
48,"48003",14444,11233,11162,43,71,"EH Bildu",2574
48,"48053",904,738,728,5,10,"EH Bildu",113
48,"48055",2596,2023,2005,12,18,"EH Bildu",585
31,"31172",365,287,275,4,12,"EH Bildu",25
20,"20041",234,156,151,2,5,"EH Bildu",57
48,"48915",347,259,259,4,0,"EH Bildu",135
31,"31246",128,105,101,3,4,"EH Bildu",15
31,"31154",211,125,124,2,1,"EH Bildu",31
31,"31128",341,255,250,3,5,"EH Bildu",70
31,"31196",31,28,28,0,0,"EH Bildu",7
31,"31031",220,158,157,1,1,"EH Bildu",71
31,"31262",234,201,199,2,2,"EH Bildu",38
31,"31180",197,155,154,2,1,"EH Bildu",16
20,"20062",945,727,726,3,1,"EH Bildu",257
31,"31014",266,195,195,4,0,"EH Bildu",46
20,"20901",1412,1034,1030,2,4,"EH Bildu",225
31,"31164",545,438,433,6,5,"EH Bildu",2
31,"31149",2271,1645,1628,9,17,"EH Bildu",832
31,"31163",2002,1507,1475,14,32,"EH Bildu",20
1,"1036",14772,10850,10746,69,104,"EH Bildu",2010
31,"31191",3018,2365,2337,22,28,"EH Bildu",127
31,"31059",183,145,143,0,2,"EH Bildu",46
20,"20038",380,296,295,0,1,"EH Bildu",138
1,"1041",152,107,103,2,4,"EH Bildu",6
31,"31102",136,75,75,2,0,"EH Bildu",21
1,"1032",500,372,362,1,10,"EH Bildu",46
31,"31108",1829,1460,1437,16,23,"EH Bildu",37
48,"48075",2067,1591,1565,11,26,"EH Bildu",361
20,"20036",13192,9864,9806,67,58,"EH Bildu",1511
48,"48070",528,392,390,2,2,"EH Bildu",236
48,"48065",3303,2541,2524,15,17,"EH Bildu",578
31,"31011",709,515,511,4,4,"EH Bildu",67
31,"31137",198,106,103,3,3,"EH Bildu",15
31,"31236",1318,958,950,8,8,"EH Bildu",206
31,"31181",134,94,93,1,1,"EH Bildu",32
31,"31235",157,121,118,0,3,"EH Bildu",30
31,"31167",831,651,636,3,15,"EH Bildu",84
31,"31140",115,83,83,2,0,"EH Bildu",16
1,"1039",195,157,153,0,4,"EH Bildu",16
20,"20045",46866,33932,33700,191,232,"EH Bildu",3054
20,"20065",2943,2145,2124,11,21,"EH Bildu",642
31,"31227",8111,6198,6129,69,69,"EH Bildu",1092
31,"31006",1877,1453,1436,16,17,"EH Bildu",26
48,"48046",12644,9809,9744,46,65,"EH Bildu",2612
31,"31144",763,504,503,1,1,"EH Bildu",243
31,"31136",452,337,333,5,4,"EH Bildu",73
20,"20018",11218,8145,8109,41,36,"EH Bildu",3254
31,"31199",141,96,94,0,2,"EH Bildu",30
48,"48093",888,720,715,2,5,"EH Bildu",242
48,"48064",613,494,492,1,2,"EH Bildu",173
20,"20077",5254,4083,4059,22,24,"EH Bildu",894
31,"31153",2173,1591,1580,10,11,"EH Bildu",546
31,"31072",5320,4046,3958,40,88,"EH Bildu",49
31,"31104",1751,1306,1280,1,26,"EH Bildu",67
31,"31081",334,259,256,7,3,"EH Bildu",95
48,"48914",325,286,285,0,1,"EH Bildu",108
31,"31214",87,66,64,0,2,"EH Bildu",17
31,"31147",106,88,86,3,2,"EH Bildu",8
20,"20015",1237,975,967,8,8,"EH Bildu",536
31,"31231",108,73,70,1,3,"EH Bildu",3
31,"31012",771,571,564,5,7,"EH Bildu",39
31,"31195",171,125,125,2,0,"EH Bildu",52
31,"31007",126,101,95,3,6,"EH Bildu",10
31,"31174",107,70,70,0,0,"EH Bildu",13
31,"31025",763,562,557,6,5,"EH Bildu",166
31,"31086",13640,11040,10966,116,74,"EH Bildu",1119
1,"1057",243,202,199,0,3,"EH Bildu",56
48,"48033",204,160,159,1,1,"EH Bildu",58
48,"48021",1336,990,983,4,7,"EH Bildu",256
31,"31145",161,131,129,1,2,"EH Bildu",1
48,"48091",1090,862,857,9,5,"EH Bildu",294
31,"31215",4669,3580,3508,35,72,"EH Bildu",45
1,"1017",816,579,574,2,5,"EH Bildu",145
20,"20001",257,174,172,1,2,"EH Bildu",73
48,"48051",216,157,157,0,0,"EH Bildu",24
20,"20027",2758,1980,1958,19,22,"EH Bildu",809
31,"31005",281,202,201,5,1,"EH Bildu",16
31,"31085",502,401,399,5,2,"EH Bildu",138
31,"31062",1075,870,861,10,9,"EH Bildu",14
31,"31170",45,37,36,2,1,"EH Bildu",7
31,"31143",93,58,52,0,6,"EH Bildu",4
48,"48002",7777,6034,5981,48,53,"EH Bildu",768
31,"31142",1390,994,982,8,12,"EH Bildu",138
31,"31124",207,151,150,2,1,"EH Bildu",10
48,"48066",347,291,291,0,0,"EH Bildu",80
31,"31023",7609,6371,6319,70,52,"EH Bildu",419
31,"31228",494,383,382,0,1,"EH Bildu",31
31,"31046",53,39,39,0,0,"EH Bildu",1
20,"20035",484,384,384,2,0,"EH Bildu",166
31,"31213",100,69,68,0,1,"EH Bildu",30
48,"48037",684,537,531,4,6,"EH Bildu",119
48,"48043",4539,3566,3556,22,10,"EH Bildu",598
31,"31113",127,84,83,1,1,"EH Bildu",9
20,"20007",327,235,230,2,5,"EH Bildu",125
48,"48062",293,247,245,0,2,"EH Bildu",84
48,"48009",772,628,622,2,6,"EH Bildu",256
31,"31216",3871,2861,2832,32,29,"EH Bildu",251
31,"31060",14185,10582,10485,103,97,"EH Bildu",1464
1,"1060",201,174,166,1,8,"EH Bildu",10
31,"31185",470,335,332,6,3,"EH Bildu",104
31,"31069",830,639,638,3,1,"EH Bildu",68
48,"48088",133,99,98,2,1,"EH Bildu",54
48,"48048",543,421,419,1,2,"EH Bildu",138
48,"48011",9652,7293,7251,37,42,"EH Bildu",1161
48,"48069",13094,10021,9954,49,67,"EH Bildu",1530
31,"31018",422,317,312,4,5,"EH Bildu",30
31,"31090",141,86,86,0,0,"EH Bildu",17
31,"31001",80,63,63,0,0,"EH Bildu",11
1,"1018",1408,998,993,6,5,"EH Bildu",274
31,"31041",1659,1245,1228,23,17,"EH Bildu",141
48,"48015",33109,24697,24475,161,222,"EH Bildu",2198
20,"20024",391,274,274,1,0,"EH Bildu",137
31,"31065",1859,1383,1366,16,17,"EH Bildu",62
48,"48071",6038,4711,4674,27,37,"EH Bildu",591
48,"48907",340,283,281,1,2,"EH Bildu",92
48,"48019",3461,2647,2633,12,14,"EH Bildu",582
31,"31004",32,26,26,0,0,"EH Bildu",3
48,"48077",3376,2656,2647,11,9,"EH Bildu",481
20,"20042",3172,2247,2231,9,16,"EH Bildu",758
31,"31032",1678,1285,1269,25,16,"EH Bildu",20
1,"1034",150,111,111,2,0,"EH Bildu",20
20,"20061",4392,3278,3264,11,14,"EH Bildu",964
48,"48024",999,813,811,2,2,"EH Bildu",281
31,"31121",65,51,51,0,0,"EH Bildu",8
31,"31189",1127,781,775,10,6,"EH Bildu",278
1,"1011",215,179,175,3,4,"EH Bildu",2
31,"31045",509,395,390,5,5,"EH Bildu",31
48,"48056",989,791,785,4,6,"EH Bildu",212
31,"31226",574,380,377,3,3,"EH Bildu",140
31,"31073",296,218,217,3,1,"EH Bildu",112
1,"1013",703,491,487,2,4,"EH Bildu",161
48,"48063",356,277,274,2,3,"EH Bildu",111
31,"31129",384,260,259,0,1,"EH Bildu",126
1,"1001",2005,1438,1419,4,19,"EH Bildu",214
31,"31111",91,69,69,1,0,"EH Bildu",23
1,"1006",176,127,127,2,0,"EH Bildu",8
48,"48089",3463,2746,2732,10,14,"EH Bildu",473
48,"48058",946,724,715,3,9,"EH Bildu",252
31,"31255",103,87,84,0,3,"EH Bildu",6
31,"31258",7879,6189,6140,57,49,"EH Bildu",1349
31,"31250",2748,1995,1982,21,13,"EH Bildu",577
31,"31056",185,141,134,3,7,"EH Bildu",22
48,"48041",686,581,579,2,2,"EH Bildu",151
31,"31237",186,151,149,1,2,"EH Bildu",10
48,"48025",860,694,694,3,0,"EH Bildu",240
48,"48004",326,261,260,3,1,"EH Bildu",116
20,"20043",1734,1254,1248,5,6,"EH Bildu",477
20,"20080",7709,5629,5588,28,41,"EH Bildu",897
31,"31020",433,273,272,1,1,"EH Bildu",154
31,"31225",35,29,29,1,0,"EH Bildu",4
48,"48045",5194,4138,4098,25,40,"EH Bildu",699
20,"20060",88,75,75,0,0,"EH Bildu",72
48,"48905",2490,1911,1891,16,20,"EH Bildu",398
48,"48012",2071,1685,1674,7,11,"EH Bildu",480
31,"31013",626,427,422,5,5,"EH Bildu",82
20,"20058",739,555,551,4,4,"EH Bildu",133
31,"31095",72,61,60,0,1,"EH Bildu",23
48,"48913",1224,977,967,6,10,"EH Bildu",167
1,"1027",430,295,293,2,2,"EH Bildu",67
20,"20068",188,142,142,1,0,"EH Bildu",85
31,"31184",65,48,46,0,2,"EH Bildu",17
1,"1019",148,121,121,0,0,"EH Bildu",13
31,"31082",623,433,433,3,0,"EH Bildu",145
48,"48006",309,265,265,0,0,"EH Bildu",111
31,"31158",248,182,177,2,5,"EH Bildu",47
48,"48016",5437,4282,4248,21,34,"EH Bildu",628
31,"31198",37,32,32,0,0,"EH Bildu",14
31,"31063",83,63,60,2,3,"EH Bildu",11
31,"31077",5407,4148,4081,39,67,"EH Bildu",48
20,"20004",227,156,154,4,2,"EH Bildu",39
31,"31222",58,38,38,3,0,"EH Bildu",9
20,"20011",1633,1297,1287,2,10,"EH Bildu",565
31,"31160",105,87,86,1,1,"EH Bildu",12
48,"48903",1807,1471,1462,6,9,"EH Bildu",148
31,"31135",112,76,75,2,1,"EH Bildu",0
1,"1023",262,210,206,3,4,"EH Bildu",23
31,"31223",959,718,711,8,7,"EH Bildu",116
31,"31209",147,116,116,0,0,"EH Bildu",25
48,"48023",580,493,489,0,4,"EH Bildu",184
31,"31087",181,136,135,6,1,"EH Bildu",50
20,"20072",4752,3445,3412,24,33,"EH Bildu",711
1,"1022",761,577,569,5,8,"EH Bildu",37
31,"31229",38,36,36,2,0,"EH Bildu",4
31,"31173",846,686,674,5,12,"EH Bildu",5
1,"1009",1265,920,914,6,6,"EH Bildu",325
31,"31079",67,60,60,0,0,"EH Bildu",2
20,"20069",147441,111102,110598,762,504,"EH Bildu",16740
31,"31251",3152,2437,2402,12,35,"EH Bildu",129
31,"31021",60,47,47,3,0,"EH Bildu",14
31,"31901",15510,12225,12133,114,92,"EH Bildu",1348
31,"31080",490,393,390,2,3,"EH Bildu",55
48,"48090",6016,4700,4639,24,61,"EH Bildu",501
48,"48049",545,448,448,0,0,"EH Bildu",154
20,"20010",1528,1156,1151,5,5,"EH Bildu",488
31,"31171",669,516,502,3,14,"EH Bildu",29
1,"1020",320,239,238,1,1,"EH Bildu",75
31,"31126",351,255,254,2,1,"EH Bildu",101
31,"31125",274,211,207,7,4,"EH Bildu",29
1,"1046",631,464,461,0,3,"EH Bildu",51
31,"31027",814,623,610,8,13,"EH Bildu",310
31,"31161",345,286,279,4,7,"EH Bildu",46
1,"1051",3558,2448,2433,14,15,"EH Bildu",705
1,"1004",1356,1007,998,3,9,"EH Bildu",200
48,"48904",3542,2832,2811,27,21,"EH Bildu",383
31,"31122",4946,3915,3882,59,33,"EH Bildu",769
31,"31162",48,34,33,1,1,"EH Bildu",5
31,"31203",30,22,22,1,0,"EH Bildu",2
31,"31244",156,95,94,5,1,"EH Bildu",12
20,"20034",3154,2336,2315,20,21,"EH Bildu",694
20,"20064",12436,8730,8652,59,78,"EH Bildu",1944
20,"20014",1156,772,765,4,7,"EH Bildu",349
48,"48060",3620,2615,2606,13,9,"EH Bildu",886
31,"31078",2419,1924,1899,18,25,"EH Bildu",35
31,"31152",1270,937,929,19,8,"EH Bildu",44
31,"31101",1412,1097,1087,11,10,"EH Bildu",231
1,"1062",315,236,229,2,7,"EH Bildu",20
31,"31047",236,181,179,5,2,"EH Bildu",20
48,"48061",799,636,636,2,0,"EH Bildu",136
31,"31908",1064,810,803,2,7,"EH Bildu",185
48,"48007",385,281,279,1,2,"EH Bildu",125
20,"20046",1248,918,909,11,9,"EH Bildu",307
31,"31204",36,27,27,1,0,"EH Bildu",4
20,"20076",7025,5263,5237,31,26,"EH Bildu",1506
31,"31106",718,585,581,3,4,"EH Bildu",11
1,"1902",730,551,545,6,6,"EH Bildu",45
31,"31070",2628,1930,1881,16,49,"EH Bildu",48
31,"31119",36,26,25,0,1,"EH Bildu",2
31,"31904",1561,1139,1130,7,9,"EH Bildu",280
1,"1055",840,608,602,10,6,"EH Bildu",98
20,"20009",11343,8168,8106,46,62,"EH Bildu",1820
31,"31265",78,52,47,1,5,"EH Bildu",7
48,"48909",202,172,172,2,0,"EH Bildu",84
48,"48028",691,576,573,1,3,"EH Bildu",265
31,"31067",1896,1418,1397,17,21,"EH Bildu",64
31,"31134",175,130,128,1,2,"EH Bildu",28
31,"31202",4345,3132,3085,36,47,"EH Bildu",64
31,"31130",322,237,235,7,2,"EH Bildu",73
20,"20081",7655,5629,5601,22,28,"EH Bildu",1826
31,"31253",119,106,105,0,1,"EH Bildu",46
31,"31248",270,158,154,6,4,"EH Bildu",35
31,"31252",83,57,57,0,0,"EH Bildu",19
20,"20044",364,263,262,0,1,"EH Bildu",115
20,"20040",15753,11440,11364,69,76,"EH Bildu",4044
31,"31117",589,420,419,5,1,"EH Bildu",288
1,"1021",469,333,330,1,3,"EH Bildu",40
31,"31050",6002,4111,4061,58,50,"EH Bildu",1314
20,"20071",15036,11090,11025,59,65,"EH Bildu",3292
48,"48097",1316,979,976,4,3,"EH Bildu",209
31,"31084",1948,1483,1472,9,11,"EH Bildu",737
1,"1901",2474,1655,1631,13,24,"EH Bildu",148
31,"31092",685,514,511,6,3,"EH Bildu",138
1,"1043",2337,1669,1656,18,13,"EH Bildu",180
31,"31009",672,510,503,4,7,"EH Bildu",78
31,"31061",48,46,46,0,0,"EH Bildu",0
1,"1053",592,376,373,2,3,"EH Bildu",117
20,"20059",8867,6792,6759,21,33,"EH Bildu",2742
20,"20079",18142,14055,13971,75,84,"EH Bildu",3446
31,"31019",1808,1392,1378,18,14,"EH Bildu",458
20,"20049",4159,3024,3004,11,20,"EH Bildu",1061
48,"48014",1242,915,910,4,5,"EH Bildu",182
31,"31127",135,96,96,0,0,"EH Bildu",27
31,"31132",148,121,121,2,0,"EH Bildu",32
48,"48901",5151,4042,4012,22,30,"EH Bildu",504
31,"31256",96,64,64,0,0,"EH Bildu",26
31,"31052",103,79,78,0,1,"EH Bildu",3
31,"31186",288,220,216,1,4,"EH Bildu",70
31,"31238",115,101,100,2,1,"EH Bildu",15
31,"31075",118,96,95,2,1,"EH Bildu",10
31,"31224",875,684,677,10,7,"EH Bildu",15
31,"31066",812,636,628,10,8,"EH Bildu",18
20,"20033",854,675,671,5,4,"EH Bildu",283
48,"48039",256,218,217,1,1,"EH Bildu",69
20,"20050",270,186,183,3,3,"EH Bildu",95
31,"31008",63,51,49,1,2,"EH Bildu",3
31,"31094",105,78,76,0,2,"EH Bildu",4
1,"1052",268,188,187,1,1,"EH Bildu",39
48,"48042",1365,1136,1130,7,6,"EH Bildu",93
48,"48912",2331,1843,1833,7,10,"EH Bildu",338
31,"31257",903,690,679,6,11,"EH Bildu",68
48,"48910",2802,2082,2073,3,9,"EH Bildu",455
31,"31112",93,71,70,0,1,"EH Bildu",12
1,"1016",421,236,229,3,7,"EH Bildu",48
31,"31071",15,13,13,0,0,"EH Bildu",1
31,"31197",65,56,56,0,0,"EH Bildu",4
31,"31193",1438,1129,1123,13,6,"EH Bildu",197
1,"1042",907,723,721,4,2,"EH Bildu",172
31,"31906",2683,2040,2023,28,17,"EH Bildu",211
31,"31010",5728,4211,4153,30,58,"EH Bildu",1115
48,"48072",970,735,730,1,5,"EH Bildu",335
48,"48010",474,368,368,0,0,"EH Bildu",100
31,"31083",50,41,41,1,0,"EH Bildu",10
31,"31118",158,120,116,2,4,"EH Bildu",15
31,"31015",1990,1533,1508,17,25,"EH Bildu",80
20,"20012",148,113,112,0,1,"EH Bildu",50
48,"48068",1528,1218,1211,5,7,"EH Bildu",303
31,"31038",1336,992,981,8,11,"EH Bildu",82
48,"48908",249,214,213,0,1,"EH Bildu",66
31,"31110",84,72,72,3,0,"EH Bildu",7
20,"20073",4698,3530,3515,29,15,"EH Bildu",1545
20,"20032",8681,6491,6429,22,62,"EH Bildu",1508
31,"31024",99,54,54,1,0,"EH Bildu",30
31,"31029",916,661,647,7,14,"EH Bildu",49
48,"48079",395,313,312,2,1,"EH Bildu",115
20,"20078",1145,882,879,4,3,"EH Bildu",546
48,"48073",6837,4950,4921,33,29,"EH Bildu",2167
1,"1008",802,576,570,3,6,"EH Bildu",116
48,"48038",1158,891,891,2,0,"EH Bildu",232
31,"31242",264,194,194,2,0,"EH Bildu",28
20,"20002",355,258,257,8,1,"EH Bildu",129
31,"31183",713,569,555,6,14,"EH Bildu",69
31,"31169",2205,1597,1568,17,29,"EH Bildu",22
48,"48096",6510,5247,5185,36,62,"EH Bildu",598
31,"31120",383,264,260,3,4,"EH Bildu",55
48,"48080",9946,7574,7499,46,75,"EH Bildu",836
31,"31211",17,13,13,1,0,"EH Bildu",0
1,"1061",152,129,129,2,0,"EH Bildu",50
48,"48027",22668,17326,17224,95,102,"EH Bildu",3494
20,"20052",1070,833,827,2,6,"EH Bildu",316
31,"31207",285,209,206,1,3,"EH Bildu",61
31,"31054",454,322,318,4,4,"EH Bildu",115
48,"48086",2015,1504,1486,6,18,"EH Bildu",273
31,"31076",2520,2110,2094,21,16,"EH Bildu",158
31,"31044",294,243,242,5,1,"EH Bildu",124
1,"1014",366,283,277,7,6,"EH Bildu",25
31,"31139",155,105,105,0,0,"EH Bildu",17
48,"48036",24038,18180,18050,94,130,"EH Bildu",2742
31,"31240",513,385,385,6,0,"EH Bildu",183
20,"20075",4346,3158,3134,19,24,"EH Bildu",1042
31,"31107",1680,1330,1312,16,18,"EH Bildu",15
48,"48026",1139,920,913,4,7,"EH Bildu",412
31,"31103",39,27,27,0,0,"EH Bildu",3
31,"31239",281,215,212,7,3,"EH Bildu",35
48,"48040",1309,979,973,5,6,"EH Bildu",217
31,"31254",1920,1457,1435,8,22,"EH Bildu",71
20,"20022",854,621,621,7,0,"EH Bildu",273
31,"31037",90,72,72,0,0,"EH Bildu",37
31,"31903",6862,4962,4915,31,47,"EH Bildu",863
31,"31208",2562,2067,2036,16,31,"EH Bildu",21
31,"31150",199,140,139,2,1,"EH Bildu",40
20,"20005",1267,884,882,2,2,"EH Bildu",388
1,"1058",1403,958,951,4,7,"EH Bildu",319
48,"48087",432,357,356,0,1,"EH Bildu",35
48,"48911",388,323,322,3,1,"EH Bildu",163
31,"31245",77,60,59,4,1,"EH Bildu",12
48,"48017",13150,9546,9504,38,42,"EH Bildu",2355
1,"1063",1830,1363,1353,4,10,"EH Bildu",334
48,"48092",869,676,674,9,2,"EH Bildu",124
20,"20039",2144,1704,1692,11,12,"EH Bildu",727
1,"1003",1179,908,903,6,5,"EH Bildu",459
31,"31115",160,116,116,3,0,"EH Bildu",33
31,"31187",101,68,68,1,0,"EH Bildu",21
20,"20013",5430,4144,4119,19,25,"EH Bildu",1287
20,"20063",8061,6042,5999,36,43,"EH Bildu",2885
31,"31243",302,241,237,5,4,"EH Bildu",54
31,"31088",5675,4331,4285,59,46,"EH Bildu",326
48,"48029",8613,6697,6642,52,55,"EH Bildu",448
20,"20054",459,313,312,1,1,"EH Bildu",230
31,"31148",92,67,65,4,2,"EH Bildu",1
20,"20903",4803,3514,3481,24,33,"EH Bildu",1007
20,"20037",103,77,77,0,0,"EH Bildu",34
31,"31201",151084,115375,114510,1072,865,"EH Bildu",14489
1,"1030",143,118,117,1,1,"EH Bildu",11
20,"20906",130,99,98,1,1,"EH Bildu",46
1,"1031",1163,948,928,6,20,"EH Bildu",129
20,"20006",254,169,169,0,0,"EH Bildu",76
31,"31003",117,97,97,1,0,"EH Bildu",37
20,"20030",21198,15734,15654,100,80,"EH Bildu",2689
31,"31039",92,72,70,1,2,"EH Bildu",19
31,"31247",147,117,115,0,2,"EH Bildu",49
31,"31123",617,392,388,3,4,"EH Bildu",124
20,"20051",6775,5124,5091,24,33,"EH Bildu",1377
31,"31049",679,512,505,2,7,"EH Bildu",265
31,"31040",173,139,139,1,0,"EH Bildu",38
48,"48050",187,153,149,0,4,"EH Bildu",67
48,"48094",3125,2407,2388,12,19,"EH Bildu",785
31,"31219",81,60,59,1,1,"EH Bildu",2
31,"31168",241,203,199,2,4,"EH Bildu",38
48,"48095",2326,1691,1680,11,11,"EH Bildu",395
20,"20019",9912,7226,7195,51,31,"EH Bildu",1517
48,"48054",24938,19329,19197,124,132,"EH Bildu",1804
48,"48052",1567,1309,1300,4,9,"EH Bildu",593
31,"31105",1478,1203,1189,21,14,"EH Bildu",10
48,"48018",867,605,603,3,2,"EH Bildu",248
20,"20028",2258,1579,1574,9,5,"EH Bildu",567
48,"48008",615,454,448,4,6,"EH Bildu",74
31,"31249",1823,1381,1373,21,8,"EH Bildu",19
31,"31133",35,28,28,0,0,"EH Bildu",15
31,"31002",433,324,324,4,0,"EH Bildu",51
31,"31058",202,163,160,2,3,"EH Bildu",37
31,"31057",1741,1365,1344,12,21,"EH Bildu",6
31,"31034",31,27,26,0,1,"EH Bildu",8
48,"48035",404,334,331,2,3,"EH Bildu",93
31,"31210",186,156,156,1,0,"EH Bildu",37
20,"20902",14229,10567,10495,53,72,"EH Bildu",1697
31,"31048",160,133,132,2,1,"EH Bildu",2
31,"31234",149,115,114,0,1,"EH Bildu",6
48,"48031",308,236,236,0,0,"EH Bildu",88
31,"31109",1664,1290,1283,10,7,"EH Bildu",211
20,"20023",446,299,299,1,0,"EH Bildu",122
31,"31116",58,45,43,2,2,"EH Bildu",4
1,"1059",189037,133121,131768,792,1353,"EH Bildu",15596
31,"31055",263,199,197,3,2,"EH Bildu",68
20,"20057",194,143,143,0,0,"EH Bildu",74
1,"1044",231,171,166,0,5,"EH Bildu",35
48,"48057",5745,4391,4376,13,15,"EH Bildu",1831
48,"48906",753,611,608,1,3,"EH Bildu",190
31,"31089",228,187,184,0,3,"EH Bildu",12
31,"31178",472,354,348,3,6,"EH Bildu",2
31,"31232",25574,19124,18913,236,211,"EH Bildu",472
31,"31206",2082,1610,1589,15,21,"EH Bildu",284
31,"31138",954,699,698,8,1,"EH Bildu",293
20,"20003",551,401,399,2,2,"EH Bildu",217
20,"20067",30618,21972,21854,138,118,"EH Bildu",4632
20,"20074",11503,8767,8720,26,47,"EH Bildu",3011
20,"20020",113,67,67,0,0,"EH Bildu",28
48,"48047",149,115,115,1,0,"EH Bildu",60
31,"31146",29,25,25,1,0,"EH Bildu",4
31,"31016",7752,6114,6064,47,50,"EH Bildu",1051
31,"31091",327,224,224,1,0,"EH Bildu",103
31,"31205",420,312,310,7,2,"EH Bildu",22
31,"31233",93,72,70,1,2,"EH Bildu",0
20,"20026",204,182,159,3,23,"EH Bildu",72
31,"31100",256,181,178,1,3,"EH Bildu",25
48,"48078",37991,28582,28382,202,200,"EH Bildu",2369
48,"48084",21858,15943,15796,116,147,"EH Bildu",1345
31,"31157",3470,2507,2473,32,34,"EH Bildu",119
31,"31022",483,349,345,3,4,"EH Bildu",162
31,"31166",250,184,184,2,0,"EH Bildu",21
31,"31221",1235,944,938,11,6,"EH Bildu",252
20,"20070",1083,831,823,2,8,"EH Bildu",352
31,"31261",237,174,173,3,1,"EH Bildu",5
31,"31179",483,348,344,2,4,"EH Bildu",8
48,"48081",1883,1532,1518,3,14,"EH Bildu",293
31,"31097",10521,7602,7550,76,52,"EH Bildu",1060
31,"31030",135,105,105,3,0,"EH Bildu",22
31,"31192",157,133,130,1,3,"EH Bildu",19
31,"31155",241,181,180,3,1,"EH Bildu",11
48,"48030",601,490,489,0,1,"EH Bildu",186
31,"31175",64,50,50,0,0,"EH Bildu",2
1,"1010",2315,1789,1770,14,19,"EH Bildu",354
31,"31053",503,375,370,4,5,"EH Bildu",55
31,"31176",2930,2204,2134,33,70,"EH Bildu",26
31,"31177",251,172,168,1,4,"EH Bildu",14
20,"20025",1116,835,830,2,5,"EH Bildu",356
31,"31096",101,85,84,3,1,"EH Bildu",15
31,"31156",239,191,191,1,0,"EH Bildu",52
31,"31017",370,288,286,3,2,"EH Bildu",68
31,"31182",30,28,28,1,0,"EH Bildu",8
31,"31042",2695,2071,2043,21,28,"EH Bildu",17
48,"48034",12639,9519,9443,77,76,"EH Bildu",884
31,"31212",129,102,102,6,0,"EH Bildu",3
48,"48059",400,329,325,0,4,"EH Bildu",121
48,"48902",18971,14015,13895,101,120,"EH Bildu",1514
31,"31026",132,116,112,0,4,"EH Bildu",6
20,"20053",4848,3479,3451,27,28,"EH Bildu",1192
48,"48083",6946,5238,5201,35,37,"EH Bildu",542
48,"48013",79423,59100,58630,458,470,"EH Bildu",4345
31,"31074",390,310,307,5,3,"EH Bildu",96
31,"31033",46,29,28,0,1,"EH Bildu",9
20,"20029",4272,3257,3239,18,18,"EH Bildu",990
20,"20021",186,112,112,0,0,"EH Bildu",46
31,"31259",476,347,346,0,1,"EH Bildu",125
48,"48020",272959,203643,202331,1472,1312,"EH Bildu",19133
20,"20905",153,124,124,1,0,"EH Bildu",70
31,"31264",177,107,105,2,2,"EH Bildu",37
20,"20016",1524,997,997,1,0,"EH Bildu",317
48,"48032",5773,4504,4476,5,28,"EH Bildu",1441
31,"31036",895,665,659,8,6,"EH Bildu",67
20,"20017",8484,6294,6263,25,31,"EH Bildu",1780
48,"48005",113,80,80,0,0,"EH Bildu",24
1,"1049",132,100,100,1,0,"EH Bildu",21
31,"31131",907,719,712,8,7,"EH Bildu",92
31,"31220",742,620,615,2,5,"EH Bildu",12
31,"31028",220,147,147,0,0,"EH Bildu",52
1,"1033",656,533,525,1,8,"EH Bildu",39
31,"31260",1249,904,901,15,3,"EH Bildu",176
31,"31098",1962,1562,1544,14,18,"EH Bildu",279
31,"31190",45,41,41,4,0,"EH Bildu",6
20,"20055",17378,12565,12482,55,83,"EH Bildu",3483
31,"31217",334,233,225,3,8,"EH Bildu",19
31,"31099",49,43,43,0,0,"EH Bildu",5
48,"48082",37396,27913,27694,172,219,"EH Bildu",3103
48,"48076",284,226,224,1,2,"EH Bildu",41
20,"20048",184,120,120,2,0,"EH Bildu",56
31,"31263",231,154,154,0,0,"EH Bildu",94
31,"31051",234,183,182,2,1,"EH Bildu",21
31,"31043",32,24,24,0,0,"EH Bildu",0
31,"31093",275,212,206,0,6,"EH Bildu",67
20,"20047",462,337,335,2,2,"EH Bildu",178
31,"31230",95,79,79,0,0,"EH Bildu",10
48,"48044",62054,49055,48840,373,215,"EH Bildu",5221
31,"31905",2968,2253,2236,21,17,"EH Bildu",105
31,"31165",2763,2121,2091,21,30,"EH Bildu",47
20,"20066",439,327,326,0,1,"EH Bildu",214
31,"31035",50,34,32,0,2,"EH Bildu",1
48,"48022",2316,1645,1631,11,14,"EH Bildu",193
48,"48074",3273,2480,2460,14,20,"EH Bildu",565
31,"31068",2816,2194,2136,17,58,"EH Bildu",37
31,"31907",11205,9216,9140,121,76,"EH Bildu",1115
20,"20904",89,50,49,0,1,"EH Bildu",40
20,"20907",117,88,87,0,1,"EH Bildu",35
20,"20056",4075,2983,2942,12,41,"EH Bildu",1080
1,"1028",1068,774,772,7,2,"EH Bildu",106
31,"31188",296,200,197,0,3,"EH Bildu",42
20,"20058",739,555,551,4,4,"ELAK/PCTE",2
20,"20046",1248,918,909,11,9,"ELAK/PCTE",0
20,"20061",4392,3278,3264,11,14,"ELAK/PCTE",1
20,"20002",355,258,257,8,1,"ELAK/PCTE",0
20,"20005",1267,884,882,2,2,"ELAK/PCTE",1
20,"20053",4848,3479,3451,27,28,"ELAK/PCTE",2
20,"20042",3172,2247,2231,9,16,"ELAK/PCTE",2
20,"20001",257,174,172,1,2,"ELAK/PCTE",0
20,"20012",148,113,112,0,1,"ELAK/PCTE",0
20,"20011",1633,1297,1287,2,10,"ELAK/PCTE",0
20,"20026",204,182,159,3,23,"ELAK/PCTE",0
20,"20905",153,124,124,1,0,"ELAK/PCTE",0
20,"20017",8484,6294,6263,25,31,"ELAK/PCTE",3
20,"20044",364,263,262,0,1,"ELAK/PCTE",1
20,"20072",4752,3445,3412,24,33,"ELAK/PCTE",2
20,"20074",11503,8767,8720,26,47,"ELAK/PCTE",12
20,"20906",130,99,98,1,1,"ELAK/PCTE",0
20,"20036",13192,9864,9806,67,58,"ELAK/PCTE",12
20,"20903",4803,3514,3481,24,33,"ELAK/PCTE",1
20,"20073",4698,3530,3515,29,15,"ELAK/PCTE",7
20,"20071",15036,11090,11025,59,65,"ELAK/PCTE",7
20,"20018",11218,8145,8109,41,36,"ELAK/PCTE",5
20,"20015",1237,975,967,8,8,"ELAK/PCTE",0
20,"20067",30618,21972,21854,138,118,"ELAK/PCTE",20
20,"20050",270,186,183,3,3,"ELAK/PCTE",0
20,"20030",21198,15734,15654,100,80,"ELAK/PCTE",8
20,"20902",14229,10567,10495,53,72,"ELAK/PCTE",6
20,"20006",254,169,169,0,0,"ELAK/PCTE",0
20,"20032",8681,6491,6429,22,62,"ELAK/PCTE",2
20,"20066",439,327,326,0,1,"ELAK/PCTE",0
20,"20041",234,156,151,2,5,"ELAK/PCTE",0
20,"20051",6775,5124,5091,24,33,"ELAK/PCTE",10
20,"20901",1412,1034,1030,2,4,"ELAK/PCTE",2
20,"20057",194,143,143,0,0,"ELAK/PCTE",0
20,"20048",184,120,120,2,0,"ELAK/PCTE",0
20,"20069",147441,111102,110598,762,504,"ELAK/PCTE",69
20,"20054",459,313,312,1,1,"ELAK/PCTE",0
20,"20028",2258,1579,1574,9,5,"ELAK/PCTE",2
20,"20023",446,299,299,1,0,"ELAK/PCTE",1
20,"20034",3154,2336,2315,20,21,"ELAK/PCTE",1
20,"20031",183,125,125,2,0,"ELAK/PCTE",0
20,"20076",7025,5263,5237,31,26,"ELAK/PCTE",3
20,"20035",484,384,384,2,0,"ELAK/PCTE",0
20,"20077",5254,4083,4059,22,24,"ELAK/PCTE",0
20,"20021",186,112,112,0,0,"ELAK/PCTE",0
20,"20081",7655,5629,5601,22,28,"ELAK/PCTE",3
20,"20014",1156,772,765,4,7,"ELAK/PCTE",2
20,"20019",9912,7226,7195,51,31,"ELAK/PCTE",6
20,"20003",551,401,399,2,2,"ELAK/PCTE",0
20,"20070",1083,831,823,2,8,"ELAK/PCTE",0
20,"20064",12436,8730,8652,59,78,"ELAK/PCTE",12
20,"20009",11343,8168,8106,46,62,"ELAK/PCTE",3
20,"20024",391,274,274,1,0,"ELAK/PCTE",0
20,"20038",380,296,295,0,1,"ELAK/PCTE",0
20,"20904",89,50,49,0,1,"ELAK/PCTE",0
20,"20022",854,621,621,7,0,"ELAK/PCTE",0
20,"20040",15753,11440,11364,69,76,"ELAK/PCTE",12
20,"20055",17378,12565,12482,55,83,"ELAK/PCTE",4
20,"20029",4272,3257,3239,18,18,"ELAK/PCTE",3
20,"20020",113,67,67,0,0,"ELAK/PCTE",0
20,"20059",8867,6792,6759,21,33,"ELAK/PCTE",3
20,"20010",1528,1156,1151,5,5,"ELAK/PCTE",1
20,"20062",945,727,726,3,1,"ELAK/PCTE",2
20,"20079",18142,14055,13971,75,84,"ELAK/PCTE",12
20,"20047",462,337,335,2,2,"ELAK/PCTE",0
20,"20045",46866,33932,33700,191,232,"ELAK/PCTE",36
20,"20060",88,75,75,0,0,"ELAK/PCTE",0
20,"20078",1145,882,879,4,3,"ELAK/PCTE",1
20,"20007",327,235,230,2,5,"ELAK/PCTE",0
20,"20049",4159,3024,3004,11,20,"ELAK/PCTE",2
20,"20052",1070,833,827,2,6,"ELAK/PCTE",1
20,"20004",227,156,154,4,2,"ELAK/PCTE",0
20,"20039",2144,1704,1692,11,12,"ELAK/PCTE",0
20,"20907",117,88,87,0,1,"ELAK/PCTE",0
20,"20016",1524,997,997,1,0,"ELAK/PCTE",0
20,"20043",1734,1254,1248,5,6,"ELAK/PCTE",1
20,"20037",103,77,77,0,0,"ELAK/PCTE",0
20,"20080",7709,5629,5588,28,41,"ELAK/PCTE",4
20,"20075",4346,3158,3134,19,24,"ELAK/PCTE",5
20,"20013",5430,4144,4119,19,25,"ELAK/PCTE",5
20,"20056",4075,2983,2942,12,41,"ELAK/PCTE",0
20,"20008",704,455,449,6,6,"ELAK/PCTE",0
20,"20027",2758,1980,1958,19,22,"ELAK/PCTE",0
20,"20065",2943,2145,2124,11,21,"ELAK/PCTE",2
20,"20063",8061,6042,5999,36,43,"ELAK/PCTE",5
20,"20033",854,675,671,5,4,"ELAK/PCTE",0
20,"20068",188,142,142,1,0,"ELAK/PCTE",0
20,"20025",1116,835,830,2,5,"ELAK/PCTE",1
7,"7020",3692,2833,2808,42,25,"EL PI",38
7,"7009",741,554,544,4,10,"EL PI",29
7,"7030",1590,1234,1202,8,32,"EL PI",55
7,"7017",882,652,646,6,6,"EL PI",114
7,"7024",7294,4213,4160,44,53,"EL PI",20
7,"7027",22047,14986,14853,139,133,"EL PI",474
7,"7055",7897,5264,5176,47,88,"EL PI",255
7,"7045",1300,1038,1030,6,8,"EL PI",19
7,"7034",1064,906,900,6,6,"EL PI",45
7,"7026",30991,19827,19602,161,225,"EL PI",104
7,"7002",6612,4721,4672,43,49,"EL PI",22
7,"7012",1909,1358,1343,15,15,"EL PI",64
7,"7004",4033,2898,2860,28,38,"EL PI",61
7,"7005",6975,4824,4775,43,49,"EL PI",248
7,"7038",2025,1581,1556,14,25,"EL PI",45
7,"7902",1091,776,743,10,33,"EL PI",6
7,"7033",28373,17884,17684,201,200,"EL PI",808
7,"7008",6047,4570,4513,31,57,"EL PI",81
7,"7025",446,363,362,4,1,"EL PI",5
7,"7014",7778,4724,4669,50,55,"EL PI",144
7,"7003",12374,7550,7442,51,108,"EL PI",381
7,"7053",1164,956,948,4,8,"EL PI",34
7,"7006",5332,3769,3722,25,47,"EL PI",304
7,"7010",5070,3815,3777,47,38,"EL PI",64
7,"7046",16718,10573,10469,94,104,"EL PI",118
7,"7041",2097,1662,1634,20,28,"EL PI",205
7,"7040",288348,192799,191053,1586,1746,"EL PI",2227
7,"7018",379,287,286,1,1,"EL PI",27
7,"7029",4366,3270,3229,25,41,"EL PI",122
7,"7037",3357,2142,2120,16,22,"EL PI",8
7,"7031",24784,16683,16527,160,156,"EL PI",246
7,"7013",7231,5372,5253,43,119,"EL PI",167
7,"7051",5414,3610,3575,37,35,"EL PI",234
7,"7028",920,686,676,8,10,"EL PI",15
7,"7001",3628,2792,2753,18,39,"EL PI",46
7,"7049",1480,1092,1075,10,17,"EL PI",124
7,"7035",1596,1242,1234,13,8,"EL PI",142
7,"7042",10785,7256,7191,60,65,"EL PI",524
7,"7062",7902,4889,4828,58,61,"EL PI",117
7,"7059",3035,2257,2226,13,31,"EL PI",138
7,"7052",4816,3276,3258,39,18,"EL PI",13
7,"7056",5245,3883,3841,32,42,"EL PI",66
7,"7021",230,183,178,3,5,"EL PI",3
7,"7064",5528,3793,3765,23,28,"EL PI",65
7,"7007",414,326,324,2,2,"EL PI",39
7,"7044",8791,6335,6196,66,139,"EL PI",741
7,"7061",9564,6678,6583,67,95,"EL PI",198
7,"7054",22958,14097,13908,123,189,"EL PI",59
7,"7058",2857,2258,2233,18,25,"EL PI",120
7,"7057",7404,5117,5028,50,89,"EL PI",144
7,"7063",1420,1139,1129,10,10,"EL PI",27
7,"7023",3757,2777,2735,43,42,"EL PI",36
7,"7048",18412,11528,11412,112,116,"EL PI",97
7,"7011",28642,19567,19396,147,171,"EL PI",145
7,"7050",3442,2303,2275,28,28,"EL PI",11
7,"7036",27950,20870,20707,154,163,"EL PI",326
7,"7032",20888,14257,14096,108,161,"EL PI",50
7,"7901",594,454,446,6,8,"EL PI",109
7,"7015",21976,14458,14297,205,161,"EL PI",156
7,"7060",2665,1976,1964,14,12,"EL PI",77
7,"7019",164,124,124,0,0,"EL PI",5
7,"7039",4970,3557,3489,36,68,"EL PI",292
7,"7016",2931,2201,2178,31,23,"EL PI",106
7,"7043",3430,2465,2438,24,27,"EL PI",250
7,"7065",2302,1633,1603,10,30,"EL PI",36
7,"7022",11615,8055,7934,91,121,"EL PI",423
7,"7047",2371,1775,1747,13,28,"EL PI",203
32,"32076",1974,1492,1472,17,20,"EN MAREA",7
15,"15090",1125,811,800,7,11,"EN MAREA",3
15,"15030",199972,151737,150397,1576,1340,"EN MAREA",1542
15,"15093",4048,2761,2720,41,41,"EN MAREA",18
27,"27035",180,127,123,0,4,"EN MAREA",1
32,"32034",1074,855,846,1,9,"EN MAREA",5
27,"27051",8012,5936,5832,70,104,"EN MAREA",82
36,"36038",66806,50974,50429,507,545,"EN MAREA",472
32,"32044",809,625,617,2,8,"EN MAREA",57
27,"27034",1025,647,636,4,11,"EN MAREA",6
36,"36048",5244,3859,3786,33,73,"EN MAREA",43
32,"32073",1281,941,932,9,9,"EN MAREA",7
15,"15067",7953,6004,5925,51,79,"EN MAREA",66
36,"36901",4152,3400,3338,15,62,"EN MAREA",48
15,"15035",11208,8175,8068,105,107,"EN MAREA",72
36,"36014",1872,1373,1345,14,28,"EN MAREA",25
36,"36028",4069,3012,2960,27,52,"EN MAREA",31
15,"15037",4031,2700,2677,13,23,"EN MAREA",20
27,"27042",1648,1247,1233,21,14,"EN MAREA",6
32,"32086",2563,1699,1686,19,13,"EN MAREA",12
32,"32002",2022,1510,1485,8,25,"EN MAREA",8
15,"15044",1209,889,876,4,13,"EN MAREA",6
27,"27902",7150,5067,4953,74,114,"EN MAREA",43
36,"36057",238171,181891,180030,1636,1861,"EN MAREA",1883
36,"36059",4663,3196,3115,31,81,"EN MAREA",24
27,"27049",1342,934,921,11,13,"EN MAREA",5
15,"15014",3836,2739,2698,38,41,"EN MAREA",15
15,"15084",3059,2236,2217,20,19,"EN MAREA",21
15,"15040",2675,2011,1979,20,32,"EN MAREA",9
27,"27001",2209,1290,1251,25,39,"EN MAREA",6
32,"32032",7932,5956,5831,55,125,"EN MAREA",195
36,"36006",11468,8959,8782,66,177,"EN MAREA",199
15,"15022",5574,3846,3798,41,48,"EN MAREA",16
36,"36047",2287,1601,1585,14,16,"EN MAREA",8
15,"15091",1103,773,758,16,15,"EN MAREA",5
15,"15056",5648,4033,3979,39,54,"EN MAREA",25
36,"36034",3319,2384,2347,16,37,"EN MAREA",8
32,"32078",1108,794,781,15,13,"EN MAREA",8
15,"15057",12051,8814,8660,89,154,"EN MAREA",121
32,"32006",1434,1033,1019,8,14,"EN MAREA",9
32,"32051",1407,1158,1153,12,5,"EN MAREA",5
32,"32029",436,340,337,1,3,"EN MAREA",9
27,"27018",3232,2114,2089,24,25,"EN MAREA",14
27,"27045",944,700,698,13,2,"EN MAREA",10
32,"32022",1238,924,916,5,8,"EN MAREA",8
36,"36027",4380,3262,3206,26,56,"EN MAREA",28
15,"15079",1466,1076,1052,11,24,"EN MAREA",9
27,"27031",15212,10826,10649,125,177,"EN MAREA",131
32,"32019",11512,8281,8161,96,120,"EN MAREA",64
36,"36044",2539,1768,1708,18,60,"EN MAREA",23
32,"32045",2360,1712,1689,18,23,"EN MAREA",19
15,"15049",1091,805,796,8,9,"EN MAREA",4
15,"15028",1393,1076,1063,8,13,"EN MAREA",32
32,"32017",1202,821,815,6,6,"EN MAREA",5
27,"27021",1649,1080,1048,14,32,"EN MAREA",12
32,"32067",1193,827,818,10,9,"EN MAREA",24
36,"36005",8122,5895,5776,65,119,"EN MAREA",42
27,"27056",1206,896,880,9,16,"EN MAREA",4
27,"27028",78798,58316,57546,629,770,"EN MAREA",688
32,"32066",551,399,396,1,3,"EN MAREA",2
15,"15011",15481,11249,11037,105,212,"EN MAREA",136
36,"36021",12099,9105,8974,85,131,"EN MAREA",207
15,"15013",6299,4549,4486,45,63,"EN MAREA",65
15,"15050",1748,1038,1027,15,11,"EN MAREA",6
36,"36037",2554,1839,1793,6,46,"EN MAREA",29
36,"36049",7019,5414,5283,48,131,"EN MAREA",152
32,"32024",4835,3484,3439,23,45,"EN MAREA",26
32,"32077",1104,820,815,10,5,"EN MAREA",8
36,"36033",12244,9553,9358,80,195,"EN MAREA",125
15,"15053",7548,5364,5309,44,55,"EN MAREA",66
15,"15078",78678,60510,59882,621,628,"EN MAREA",859
36,"36060",30432,22488,22196,199,292,"EN MAREA",230
32,"32080",286,223,220,1,3,"EN MAREA",5
27,"27026",2315,1620,1599,17,21,"EN MAREA",7
15,"15039",1224,874,850,11,24,"EN MAREA",6
15,"15001",4689,3422,3362,52,60,"EN MAREA",23
32,"32050",2280,1788,1775,19,13,"EN MAREA",22
27,"27046",1448,1074,1063,7,11,"EN MAREA",9
27,"27014",3162,2181,2139,17,42,"EN MAREA",11
32,"32069",4256,3358,3309,39,49,"EN MAREA",34
27,"27038",923,688,677,12,11,"EN MAREA",2
15,"15092",6250,4358,4297,28,61,"EN MAREA",41
27,"27013",3684,2997,2935,26,62,"EN MAREA",38
32,"32016",724,543,535,3,8,"EN MAREA",4
15,"15061",5199,3694,3601,40,93,"EN MAREA",30
15,"15020",3593,2491,2469,18,22,"EN MAREA",25
15,"15066",4008,2931,2886,30,45,"EN MAREA",20
32,"32056",1520,1125,1116,6,9,"EN MAREA",3
15,"15071",7805,5476,5401,62,75,"EN MAREA",52
27,"27039",4430,3437,3353,53,84,"EN MAREA",24
27,"27002",1546,1136,1103,9,33,"EN MAREA",5
36,"36058",4942,3470,3402,37,68,"EN MAREA",35
15,"15070",8797,6312,6173,108,139,"EN MAREA",72
32,"32061",1070,862,855,8,7,"EN MAREA",4
36,"36024",16395,12372,12165,102,207,"EN MAREA",82
15,"15003",1701,1234,1210,10,24,"EN MAREA",4
15,"15007",3179,2333,2304,22,29,"EN MAREA",15
15,"15901",3359,2237,2205,35,32,"EN MAREA",28
36,"36040",2517,1895,1853,18,42,"EN MAREA",10
32,"32027",1000,762,747,5,15,"EN MAREA",3
36,"36031",562,455,450,2,5,"EN MAREA",3
32,"32057",514,367,365,5,2,"EN MAREA",3
36,"36053",5784,4407,4327,28,80,"EN MAREA",35
27,"27058",3322,2551,2512,22,39,"EN MAREA",13
32,"32021",874,616,615,4,1,"EN MAREA",9
32,"32052",1819,1399,1379,15,20,"EN MAREA",11
27,"27015",4020,2809,2730,33,79,"EN MAREA",32
32,"32014",1045,775,769,5,6,"EN MAREA",8
15,"15033",2422,1887,1866,13,21,"EN MAREA",26
27,"27037",1017,759,748,10,11,"EN MAREA",1
27,"27030",3134,2209,2162,27,47,"EN MAREA",50
15,"15016",4569,3171,3146,18,25,"EN MAREA",8
32,"32081",2035,1592,1565,14,27,"EN MAREA",12
36,"36029",16086,12196,12005,126,191,"EN MAREA",185
27,"27010",4402,3015,2940,49,75,"EN MAREA",43
27,"27053",501,384,373,1,11,"EN MAREA",1
27,"27022",4683,3131,3059,30,72,"EN MAREA",30
32,"32075",4382,3546,3489,35,57,"EN MAREA",39
15,"15076",2514,1709,1683,19,26,"EN MAREA",5
32,"32090",738,530,525,3,5,"EN MAREA",128
32,"32047",1746,1272,1252,6,20,"EN MAREA",7
32,"32088",1610,1040,1019,11,21,"EN MAREA",8
15,"15023",6318,4501,4436,40,65,"EN MAREA",42
36,"36030",3946,2847,2810,26,37,"EN MAREA",36
32,"32013",2017,1388,1380,5,8,"EN MAREA",3
15,"15058",28606,22203,22022,261,181,"EN MAREA",156
32,"32010",360,276,273,3,3,"EN MAREA",0
32,"32004",1671,907,899,7,8,"EN MAREA",0
36,"36042",18072,13314,13091,130,223,"EN MAREA",142
36,"36032",3537,2676,2626,16,50,"EN MAREA",16
15,"15010",1819,1194,1181,16,13,"EN MAREA",6
32,"32011",918,526,521,6,5,"EN MAREA",3
15,"15042",2955,2057,2002,16,55,"EN MAREA",44
36,"36051",14315,10396,10223,70,173,"EN MAREA",118
27,"27007",2756,2148,2084,29,64,"EN MAREA",15
15,"15038",2123,1441,1413,25,28,"EN MAREA",14
36,"36009",4445,3081,2997,26,84,"EN MAREA",23
36,"36016",1064,707,696,7,11,"EN MAREA",4
15,"15012",3611,2695,2616,36,79,"EN MAREA",22
27,"27012",1276,776,768,9,8,"EN MAREA",5
27,"27043",1219,814,797,6,17,"EN MAREA",3
32,"32018",1179,950,936,3,14,"EN MAREA",12
36,"36055",13551,9908,9682,105,226,"EN MAREA",152
32,"32008",8572,6301,6216,65,85,"EN MAREA",65
36,"36007",1618,1163,1133,7,30,"EN MAREA",7
32,"32092",482,337,334,2,3,"EN MAREA",19
32,"32043",2512,1805,1789,16,16,"EN MAREA",10
32,"32020",2460,1899,1876,6,23,"EN MAREA",6
27,"27009",2022,1514,1488,17,26,"EN MAREA",11
27,"27040",3035,2285,2234,19,51,"EN MAREA",15
36,"36023",8279,6187,6085,46,102,"EN MAREA",83
27,"27020",3380,2764,2713,32,51,"EN MAREA",23
36,"36036",2556,1953,1914,14,39,"EN MAREA",41
15,"15005",25263,17634,17347,257,287,"EN MAREA",150
36,"36004",10123,7396,7273,93,123,"EN MAREA",112
36,"36045",24478,18627,18327,157,300,"EN MAREA",234
15,"15077",8155,5554,5433,59,121,"EN MAREA",32
27,"27023",2470,1833,1797,20,36,"EN MAREA",21
15,"15019",26006,18323,18075,280,248,"EN MAREA",109
27,"27055",1197,857,851,2,6,"EN MAREA",5
15,"15054",31802,22002,21676,368,326,"EN MAREA",156
36,"36054",11074,8032,7873,77,159,"EN MAREA",73
36,"36020",2184,1621,1599,13,22,"EN MAREA",18
15,"15024",4346,3210,3151,19,59,"EN MAREA",26
32,"32003",889,667,654,3,13,"EN MAREA",2
27,"27062",584,467,466,3,1,"EN MAREA",3
15,"15048",5048,3791,3730,38,61,"EN MAREA",33
36,"36041",13621,10098,9939,97,159,"EN MAREA",119
27,"27064",1503,1078,1039,12,39,"EN MAREA",9
27,"27060",2463,1695,1669,12,26,"EN MAREA",18
36,"36035",14571,11096,10917,105,179,"EN MAREA",141
27,"27066",12633,9139,8911,84,228,"EN MAREA",103
32,"32039",1142,895,890,7,5,"EN MAREA",72
36,"36002",3076,2225,2185,19,40,"EN MAREA",7
15,"15080",1640,1177,1150,9,27,"EN MAREA",4
36,"36018",3073,2184,2144,9,40,"EN MAREA",12
32,"32005",827,628,622,4,6,"EN MAREA",8
27,"27052",862,645,640,4,5,"EN MAREA",5
32,"32062",766,582,579,1,3,"EN MAREA",6
32,"32025",1013,773,761,7,12,"EN MAREA",8
32,"32058",5225,3915,3857,35,58,"EN MAREA",45
15,"15081",982,755,741,11,14,"EN MAREA",6
27,"27054",1145,907,890,5,17,"EN MAREA",11
36,"36013",2242,1468,1452,15,16,"EN MAREA",11
36,"36902",5052,3813,3724,21,89,"EN MAREA",28
36,"36025",2137,1387,1381,7,6,"EN MAREA",6
27,"27047",1525,1026,1008,5,18,"EN MAREA",6
15,"15046",6163,4625,4497,49,128,"EN MAREA",45
27,"27008",1345,965,946,17,19,"EN MAREA",7
32,"32084",902,636,631,2,5,"EN MAREA",7
27,"27027",1806,1392,1354,18,38,"EN MAREA",11
32,"32087",1675,1313,1288,18,25,"EN MAREA",3
32,"32012",716,497,487,7,10,"EN MAREA",14
15,"15015",2883,2079,2049,21,30,"EN MAREA",38
15,"15043",4978,3631,3572,39,59,"EN MAREA",26
32,"32068",1419,998,987,4,11,"EN MAREA",10
15,"15027",1555,1227,1204,18,23,"EN MAREA",8
27,"27024",1451,1122,1102,5,20,"EN MAREA",5
32,"32053",1363,1114,1098,14,16,"EN MAREA",7
27,"27016",6973,5139,5064,66,75,"EN MAREA",99
36,"36008",21884,16428,16170,165,258,"EN MAREA",341
27,"27048",2019,1499,1467,23,32,"EN MAREA",13
15,"15017",19860,14930,14706,204,224,"EN MAREA",136
36,"36017",17419,12867,12610,120,257,"EN MAREA",185
32,"32091",1703,1312,1306,4,6,"EN MAREA",2
32,"32042",1505,1097,1091,12,6,"EN MAREA",3
32,"32015",830,543,541,4,2,"EN MAREA",6
36,"36019",1463,1041,1030,14,11,"EN MAREA",7
32,"32041",759,510,502,2,8,"EN MAREA",5
15,"15065",7151,5281,5165,63,116,"EN MAREA",69
15,"15083",1036,784,768,7,16,"EN MAREA",5
32,"32048",864,550,544,1,6,"EN MAREA",1
27,"27004",1149,741,722,2,19,"EN MAREA",0
32,"32064",480,348,346,2,2,"EN MAREA",2
32,"32079",1287,1016,1006,6,10,"EN MAREA",12
32,"32071",1378,963,954,7,9,"EN MAREA",15
27,"27041",2238,1640,1615,10,25,"EN MAREA",14
32,"32063",1819,1313,1287,6,26,"EN MAREA",58
15,"15009",10615,8066,7919,93,147,"EN MAREA",81
27,"27006",2458,1713,1666,27,47,"EN MAREA",20
32,"32072",3687,2715,2682,22,33,"EN MAREA",25
36,"36052",7234,5292,5151,44,141,"EN MAREA",31
15,"15018",1087,771,761,8,10,"EN MAREA",6
32,"32046",1098,793,782,5,11,"EN MAREA",4
32,"32083",821,592,587,7,5,"EN MAREA",2
27,"27029",1427,1068,1047,13,21,"EN MAREA",8
27,"27019",8189,6148,6039,94,109,"EN MAREA",58
15,"15021",5244,3884,3806,70,78,"EN MAREA",29
27,"27044",2719,1848,1797,29,51,"EN MAREA",10
15,"15031",23779,17963,17787,213,176,"EN MAREA",184
36,"36050",7650,5616,5506,48,110,"EN MAREA",45
32,"32065",630,478,474,5,4,"EN MAREA",5
15,"15088",3415,2349,2323,28,26,"EN MAREA",40
15,"15002",24007,18075,17857,216,218,"EN MAREA",263
15,"15068",4849,3435,3392,55,43,"EN MAREA",26
32,"32060",765,577,567,2,10,"EN MAREA",8
15,"15902",4522,3220,3159,47,61,"EN MAREA",29
36,"36043",4682,3345,3303,17,42,"EN MAREA",21
27,"27065",12076,8393,8183,128,210,"EN MAREA",99
32,"32009",10590,7661,7574,68,87,"EN MAREA",68
32,"32028",1550,1176,1171,10,5,"EN MAREA",16
32,"32054",86475,64472,63712,676,760,"EN MAREA",656
36,"36015",4076,2903,2834,37,69,"EN MAREA",31
32,"32023",1132,867,862,7,5,"EN MAREA",14
15,"15086",2785,2015,1987,14,28,"EN MAREA",11
15,"15060",5843,4360,4281,65,79,"EN MAREA",27
15,"15072",9436,6962,6860,60,102,"EN MAREA",88
36,"36046",4043,3157,3084,27,73,"EN MAREA",44
36,"36010",2828,2217,2184,15,33,"EN MAREA",20
15,"15034",2724,1832,1811,8,21,"EN MAREA",28
15,"15052",4104,2928,2878,30,50,"EN MAREA",18
27,"27005",2551,1908,1868,26,40,"EN MAREA",11
32,"32070",512,307,304,8,3,"EN MAREA",7
32,"32001",5105,3760,3715,37,45,"EN MAREA",34
32,"32033",676,480,468,4,12,"EN MAREA",1
15,"15047",2269,1531,1497,25,34,"EN MAREA",17
15,"15073",21760,14900,14630,181,270,"EN MAREA",145
15,"15075",12785,9638,9519,121,119,"EN MAREA",111
32,"32035",1370,881,872,5,9,"EN MAREA",3
15,"15069",6588,4914,4830,58,84,"EN MAREA",46
36,"36026",19924,14342,14132,171,210,"EN MAREA",114
15,"15025",1000,639,631,6,8,"EN MAREA",4
32,"32036",1261,954,938,9,16,"EN MAREA",23
27,"27032",3194,2268,2223,20,45,"EN MAREA",20
36,"36003",10038,7747,7632,79,115,"EN MAREA",93
15,"15064",2127,1608,1577,29,31,"EN MAREA",20
15,"15032",3413,2487,2414,28,73,"EN MAREA",24
32,"32031",1014,764,756,5,8,"EN MAREA",5
32,"32030",944,690,685,7,5,"EN MAREA",3
15,"15051",4562,3302,3249,36,53,"EN MAREA",26
15,"15087",5692,3883,3838,53,45,"EN MAREA",24
32,"32038",399,274,271,3,3,"EN MAREA",2
15,"15008",5631,4320,4267,64,53,"EN MAREA",22
32,"32049",689,468,462,3,6,"EN MAREA",4
15,"15085",3220,2284,2239,23,45,"EN MAREA",53
32,"32040",1418,1083,1075,3,8,"EN MAREA",4
27,"27059",2055,1508,1471,13,37,"EN MAREA",43
36,"36001",2401,1739,1715,19,24,"EN MAREA",19
32,"32059",1703,1248,1228,12,20,"EN MAREA",10
27,"27017",961,667,654,1,13,"EN MAREA",27
15,"15006",5169,3527,3436,32,91,"EN MAREA",43
27,"27901",2275,1542,1531,27,11,"EN MAREA",13
15,"15055",4485,3097,3057,39,40,"EN MAREA",21
15,"15062",5652,3803,3728,25,75,"EN MAREA",39
32,"32085",10634,7655,7551,66,104,"EN MAREA",65
15,"15029",5403,3682,3622,62,60,"EN MAREA",34
32,"32026",2659,1988,1957,26,31,"EN MAREA",14
32,"32082",1178,880,872,12,8,"EN MAREA",8
36,"36039",15610,11844,11592,103,252,"EN MAREA",112
15,"15036",56248,40194,39764,508,430,"EN MAREA",307
32,"32037",681,534,523,6,11,"EN MAREA",3
27,"27011",2358,1582,1558,12,24,"EN MAREA",10
15,"15004",4873,3689,3623,31,66,"EN MAREA",25
27,"27061",1016,784,763,9,21,"EN MAREA",3
15,"15041",9581,7223,7082,96,141,"EN MAREA",77
27,"27063",1715,1236,1198,10,38,"EN MAREA",4
36,"36056",4961,3719,3635,30,84,"EN MAREA",66
15,"15082",15381,11803,11642,133,161,"EN MAREA",144
27,"27003",1772,1271,1241,6,30,"EN MAREA",12
36,"36061",8617,6498,6391,59,107,"EN MAREA",106
32,"32089",1220,872,857,15,15,"EN MAREA",6
27,"27025",2743,2191,2138,31,53,"EN MAREA",41
15,"15059",10255,7423,7262,122,161,"EN MAREA",38
15,"15045",3629,2263,2237,9,26,"EN MAREA",3
27,"27057",11097,7917,7735,88,182,"EN MAREA",80
32,"32074",993,737,734,4,3,"EN MAREA",5
15,"15074",3919,2865,2808,33,57,"EN MAREA",40
32,"32007",1412,1011,1001,9,10,"EN MAREA",3
36,"36022",9061,6640,6482,47,158,"EN MAREA",89
27,"27033",598,423,415,1,8,"EN MAREA",7
15,"15089",4324,3258,3200,33,58,"EN MAREA",56
27,"27050",2842,2100,2072,19,28,"EN MAREA",10
32,"32055",1230,908,889,5,19,"EN MAREA",8
8,"8045",71,52,49,0,3,"ERC-SOBIRAN",20
17,"17200",623,512,510,1,2,"ERC-SOBIRAN",200
25,"25231",494,410,408,2,2,"ERC-SOBIRAN",189
8,"8185",197,172,171,2,1,"ERC-SOBIRAN",59
25,"25006",317,246,245,3,1,"ERC-SOBIRAN",94
8,"8161",11625,8521,8470,44,51,"ERC-SOBIRAN",2076
43,"43146",41,35,35,0,0,"ERC-SOBIRAN",13
43,"43161",17113,12944,12881,64,63,"ERC-SOBIRAN",3982
25,"25153",192,152,150,1,2,"ERC-SOBIRAN",52
17,"17230",499,397,393,0,4,"ERC-SOBIRAN",121
43,"43057",38,31,31,1,0,"ERC-SOBIRAN",12
25,"25012",2342,1748,1739,10,9,"ERC-SOBIRAN",542
43,"43055",1988,1631,1622,7,9,"ERC-SOBIRAN",715
17,"17211",831,694,691,1,3,"ERC-SOBIRAN",261
8,"8298",26980,20900,20817,91,83,"ERC-SOBIRAN",6956
8,"8184",54876,41661,41447,248,214,"ERC-SOBIRAN",7535
43,"43902",2743,1996,1980,16,16,"ERC-SOBIRAN",617
43,"43129",4611,3528,3495,21,33,"ERC-SOBIRAN",1180
8,"8071",241,200,200,0,0,"ERC-SOBIRAN",98
8,"8167",6048,4833,4822,48,11,"ERC-SOBIRAN",786
43,"43004",6274,4744,4691,39,53,"ERC-SOBIRAN",2015
17,"17151",185,150,150,1,0,"ERC-SOBIRAN",64
43,"43144",1236,1025,1021,8,4,"ERC-SOBIRAN",336
43,"43051",9092,6577,6502,26,75,"ERC-SOBIRAN",934
25,"25100",184,145,144,1,1,"ERC-SOBIRAN",52
17,"17012",1171,916,914,10,2,"ERC-SOBIRAN",326
17,"17013",2774,2180,2173,15,7,"ERC-SOBIRAN",598
17,"17194",78,62,62,0,0,"ERC-SOBIRAN",20
17,"17102",548,439,435,3,4,"ERC-SOBIRAN",205
43,"43153",11092,8327,8291,34,36,"ERC-SOBIRAN",2136
17,"17201",143,120,120,0,0,"ERC-SOBIRAN",52
8,"8143",2719,2121,2109,10,12,"ERC-SOBIRAN",609
25,"25132",143,118,118,0,0,"ERC-SOBIRAN",43
43,"43097",399,341,341,1,0,"ERC-SOBIRAN",121
25,"25013",2108,1570,1557,12,13,"ERC-SOBIRAN",427
8,"8128",577,454,451,0,3,"ERC-SOBIRAN",175
17,"17181",3467,2664,2648,10,16,"ERC-SOBIRAN",797
25,"25224",126,98,98,0,0,"ERC-SOBIRAN",55
17,"17083",2961,2321,2300,12,21,"ERC-SOBIRAN",687
8,"8285",10321,8169,8120,52,49,"ERC-SOBIRAN",2946
43,"43044",3949,3060,3032,31,28,"ERC-SOBIRAN",772
8,"8064",1920,1516,1506,6,10,"ERC-SOBIRAN",612
25,"25111",113,90,89,0,1,"ERC-SOBIRAN",28
8,"8078",219,176,172,1,4,"ERC-SOBIRAN",68
8,"8107",11900,9303,9187,43,116,"ERC-SOBIRAN",2040
8,"8073",62572,48770,48527,255,243,"ERC-SOBIRAN",6077
8,"8188",115,95,95,0,0,"ERC-SOBIRAN",41
8,"8902",3937,3176,3164,17,12,"ERC-SOBIRAN",830
8,"8293",228,187,187,1,0,"ERC-SOBIRAN",104
17,"17144",210,171,170,0,1,"ERC-SOBIRAN",57
17,"17226",895,673,669,3,4,"ERC-SOBIRAN",136
8,"8215",2589,2044,2034,19,10,"ERC-SOBIRAN",760
25,"25141",152,118,118,1,0,"ERC-SOBIRAN",38
17,"17003",102,75,75,0,0,"ERC-SOBIRAN",34
8,"8284",12482,8959,8887,41,72,"ERC-SOBIRAN",2230
25,"25234",4201,3087,3072,13,15,"ERC-SOBIRAN",926
8,"8246",1672,1412,1406,7,6,"ERC-SOBIRAN",641
17,"17049",3204,2634,2615,9,19,"ERC-SOBIRAN",836
43,"43121",591,463,462,0,1,"ERC-SOBIRAN",237
17,"17134",223,189,189,1,0,"ERC-SOBIRAN",81
25,"25060",69,49,49,1,0,"ERC-SOBIRAN",15
8,"8159",14323,11399,11359,57,40,"ERC-SOBIRAN",2678
25,"25203",8798,6279,6231,26,48,"ERC-SOBIRAN",1920
17,"17185",2275,1777,1768,7,9,"ERC-SOBIRAN",609
8,"8254",1753,1485,1482,3,3,"ERC-SOBIRAN",712
8,"8105",9724,7557,7505,49,52,"ERC-SOBIRAN",838
25,"25041",528,399,396,4,3,"ERC-SOBIRAN",186
17,"17020",3671,3021,3006,11,15,"ERC-SOBIRAN",1126
25,"25173",1649,1278,1262,5,16,"ERC-SOBIRAN",293
17,"17176",123,110,110,1,0,"ERC-SOBIRAN",39
25,"25157",162,137,137,4,0,"ERC-SOBIRAN",41
17,"17030",650,479,477,4,2,"ERC-SOBIRAN",139
8,"8036",163,134,133,0,1,"ERC-SOBIRAN",61
17,"17221",4152,3260,3247,11,13,"ERC-SOBIRAN",907
25,"25137",8686,6327,6296,46,31,"ERC-SOBIRAN",1997
43,"43105",156,132,132,3,0,"ERC-SOBIRAN",58
25,"25226",242,184,183,4,1,"ERC-SOBIRAN",94
25,"25022",107,88,88,0,0,"ERC-SOBIRAN",44
17,"17136",195,156,155,0,1,"ERC-SOBIRAN",47
8,"8213",6547,5270,5245,23,25,"ERC-SOBIRAN",1725
8,"8068",6878,5456,5437,25,19,"ERC-SOBIRAN",1546
8,"8001",9079,7383,7341,40,42,"ERC-SOBIRAN",1215
43,"43072",93,74,74,0,0,"ERC-SOBIRAN",29
8,"8023",6915,5339,5299,26,40,"ERC-SOBIRAN",1648
8,"8207",2014,1736,1730,9,6,"ERC-SOBIRAN",725
8,"8157",8547,6949,6918,39,31,"ERC-SOBIRAN",1562
17,"17070",110,94,94,0,0,"ERC-SOBIRAN",42
17,"17120",820,604,598,3,6,"ERC-SOBIRAN",202
17,"17064",326,263,261,2,2,"ERC-SOBIRAN",94
8,"8079",334,284,282,0,2,"ERC-SOBIRAN",130
25,"25902",542,449,439,3,10,"ERC-SOBIRAN",181
25,"25155",618,493,489,2,4,"ERC-SOBIRAN",192
17,"17015",12819,10133,10078,38,55,"ERC-SOBIRAN",3789
8,"8214",6966,5648,5633,21,15,"ERC-SOBIRAN",2021
17,"17112",194,154,152,2,2,"ERC-SOBIRAN",57
43,"43147",521,446,442,4,4,"ERC-SOBIRAN",191
17,"17223",800,623,616,5,7,"ERC-SOBIRAN",188
17,"17092",3467,2660,2633,17,27,"ERC-SOBIRAN",900
25,"25225",541,427,420,4,7,"ERC-SOBIRAN",183
25,"25209",1550,1192,1172,4,20,"ERC-SOBIRAN",435
17,"17133",1273,1048,1043,7,5,"ERC-SOBIRAN",290
17,"17040",551,465,459,4,6,"ERC-SOBIRAN",149
8,"8148",2334,1803,1794,6,9,"ERC-SOBIRAN",396
17,"17024",285,228,227,0,1,"ERC-SOBIRAN",79
8,"8169",48284,37528,37326,218,202,"ERC-SOBIRAN",5213
43,"43099",286,234,234,0,0,"ERC-SOBIRAN",90
25,"25903",229,189,188,0,1,"ERC-SOBIRAN",88
25,"25092",127,101,99,1,2,"ERC-SOBIRAN",42
8,"8086",14017,10746,10677,89,69,"ERC-SOBIRAN",2538
25,"25192",724,564,558,4,6,"ERC-SOBIRAN",217
17,"17126",318,279,279,0,0,"ERC-SOBIRAN",128
25,"25015",335,262,260,8,2,"ERC-SOBIRAN",107
25,"25166",172,137,136,1,1,"ERC-SOBIRAN",61
43,"43089",281,209,208,0,1,"ERC-SOBIRAN",50
43,"43016",3445,2628,2608,11,20,"ERC-SOBIRAN",526
25,"25057",214,162,161,0,1,"ERC-SOBIRAN",40
25,"25189",2164,1591,1583,11,8,"ERC-SOBIRAN",557
43,"43056",806,616,613,5,3,"ERC-SOBIRAN",318
25,"25201",110,89,89,0,0,"ERC-SOBIRAN",33
43,"43163",26013,18942,18796,89,146,"ERC-SOBIRAN",3927
43,"43027",164,137,137,0,0,"ERC-SOBIRAN",50
17,"17031",182,130,129,0,1,"ERC-SOBIRAN",55
17,"17187",625,530,529,4,1,"ERC-SOBIRAN",189
8,"8147",17282,13644,13560,94,84,"ERC-SOBIRAN",3421
25,"25064",98,88,88,0,0,"ERC-SOBIRAN",35
43,"43049",727,589,584,2,5,"ERC-SOBIRAN",308
8,"8223",1886,1434,1425,4,9,"ERC-SOBIRAN",544
43,"43050",2634,1881,1868,13,13,"ERC-SOBIRAN",398
43,"43059",250,214,214,1,0,"ERC-SOBIRAN",94
43,"43040",326,278,276,0,2,"ERC-SOBIRAN",131
17,"17105",247,194,194,1,0,"ERC-SOBIRAN",63
8,"8181",8061,6442,6402,28,40,"ERC-SOBIRAN",1880
43,"43019",1336,1020,1008,4,12,"ERC-SOBIRAN",438
8,"8289",4457,3605,3594,20,11,"ERC-SOBIRAN",1373
43,"43084",521,424,423,2,1,"ERC-SOBIRAN",227
8,"8252",24729,19751,19642,125,109,"ERC-SOBIRAN",2909
17,"17139",1394,1163,1154,3,9,"ERC-SOBIRAN",406
8,"8278",4893,4034,4018,17,16,"ERC-SOBIRAN",1703
17,"17143",144,115,115,0,0,"ERC-SOBIRAN",43
17,"17115",278,226,222,2,4,"ERC-SOBIRAN",94
17,"17152",11026,7610,7564,70,46,"ERC-SOBIRAN",1641
43,"43142",1083,850,842,8,8,"ERC-SOBIRAN",317
43,"43020",2276,1831,1819,12,12,"ERC-SOBIRAN",395
8,"8905",2308,1943,1938,7,5,"ERC-SOBIRAN",654
17,"17178",1056,804,798,3,6,"ERC-SOBIRAN",308
8,"8224",878,697,695,1,2,"ERC-SOBIRAN",260
43,"43118",425,357,356,0,1,"ERC-SOBIRAN",146
17,"17027",2866,2375,2364,8,11,"ERC-SOBIRAN",1006
43,"43132",363,292,291,2,1,"ERC-SOBIRAN",128
17,"17198",433,332,329,0,3,"ERC-SOBIRAN",96
25,"25242",689,539,531,0,8,"ERC-SOBIRAN",174
17,"17117",14471,10565,10504,52,61,"ERC-SOBIRAN",2880
43,"43167",384,334,333,2,1,"ERC-SOBIRAN",148
43,"43060",2684,2158,2152,8,6,"ERC-SOBIRAN",1111
17,"17100",195,157,154,0,3,"ERC-SOBIRAN",46
8,"8204",3115,2548,2534,22,14,"ERC-SOBIRAN",714
8,"8072",10699,8226,8193,45,33,"ERC-SOBIRAN",2581
25,"25910",91,70,67,2,3,"ERC-SOBIRAN",21
8,"8256",691,571,568,3,3,"ERC-SOBIRAN",195
43,"43125",890,700,698,12,2,"ERC-SOBIRAN",249
17,"17183",255,216,216,0,0,"ERC-SOBIRAN",71
8,"8032",2087,1607,1598,9,9,"ERC-SOBIRAN",493
25,"25183",535,419,416,4,3,"ERC-SOBIRAN",154
25,"25219",149,118,118,1,0,"ERC-SOBIRAN",44
17,"17205",211,184,184,1,0,"ERC-SOBIRAN",64
8,"8101",174954,129953,129198,680,755,"ERC-SOBIRAN",17597
25,"25129",159,115,115,2,0,"ERC-SOBIRAN",54
8,"8231",21132,15940,15880,75,60,"ERC-SOBIRAN",3281
8,"8096",43555,34070,33871,194,199,"ERC-SOBIRAN",8011
8,"8016",1812,1454,1448,6,6,"ERC-SOBIRAN",543
25,"25152",144,106,106,1,0,"ERC-SOBIRAN",39
43,"43169",450,396,396,3,0,"ERC-SOBIRAN",214
17,"17079",65381,50872,50631,242,241,"ERC-SOBIRAN",13274
25,"25202",108,75,75,0,0,"ERC-SOBIRAN",31
17,"17161",1018,859,855,1,4,"ERC-SOBIRAN",353
43,"43907",4359,3370,3346,22,24,"ERC-SOBIRAN",341
17,"17142",2673,2250,2241,14,9,"ERC-SOBIRAN",709
43,"43022",1435,1130,1123,8,7,"ERC-SOBIRAN",342
25,"25122",1925,1505,1497,23,8,"ERC-SOBIRAN",667
17,"17001",580,459,454,3,5,"ERC-SOBIRAN",181
25,"25043",801,613,606,1,7,"ERC-SOBIRAN",294
8,"8263",21151,16360,16269,116,91,"ERC-SOBIRAN",3789
17,"17080",144,124,124,2,0,"ERC-SOBIRAN",47
17,"17098",303,245,245,2,0,"ERC-SOBIRAN",86
8,"8194",25674,17691,17585,115,106,"ERC-SOBIRAN",2593
25,"25027",977,765,763,4,2,"ERC-SOBIRAN",319
43,"43071",891,713,706,6,7,"ERC-SOBIRAN",219
43,"43145",4209,3409,3391,9,18,"ERC-SOBIRAN",1109
25,"25194",415,325,325,3,0,"ERC-SOBIRAN",116
17,"17174",162,132,132,4,0,"ERC-SOBIRAN",52
8,"8075",4059,3127,3119,14,8,"ERC-SOBIRAN",929
8,"8259",6904,5626,5601,27,25,"ERC-SOBIRAN",1796
17,"17209",615,519,517,2,2,"ERC-SOBIRAN",171
17,"17146",3127,2404,2381,11,23,"ERC-SOBIRAN",742
8,"8015",156003,117736,117183,704,553,"ERC-SOBIRAN",20763
17,"17175",564,381,381,1,0,"ERC-SOBIRAN",105
17,"17232",149,117,116,0,1,"ERC-SOBIRAN",41
8,"8028",1088,783,780,2,3,"ERC-SOBIRAN",183
8,"8037",1930,1618,1610,10,8,"ERC-SOBIRAN",681
25,"25154",118,94,94,0,0,"ERC-SOBIRAN",34
25,"25148",219,168,168,1,0,"ERC-SOBIRAN",78
17,"17019",1784,1472,1462,3,10,"ERC-SOBIRAN",517
8,"8046",13478,10989,10939,67,50,"ERC-SOBIRAN",3504
25,"25004",575,470,467,2,3,"ERC-SOBIRAN",169
25,"25048",1632,1274,1264,7,10,"ERC-SOBIRAN",475
17,"17192",146,121,120,0,1,"ERC-SOBIRAN",33
17,"17060",408,311,311,1,0,"ERC-SOBIRAN",125
43,"43086",5263,4046,4021,17,25,"ERC-SOBIRAN",1616
8,"8257",103,86,86,1,0,"ERC-SOBIRAN",22
8,"8210",4584,3455,3435,23,20,"ERC-SOBIRAN",1209
8,"8029",3560,3027,3019,13,8,"ERC-SOBIRAN",990
8,"8178",451,389,388,3,1,"ERC-SOBIRAN",141
8,"8151",448,378,377,2,1,"ERC-SOBIRAN",137
8,"8154",701,587,586,5,1,"ERC-SOBIRAN",196
8,"8056",42727,33215,33054,220,161,"ERC-SOBIRAN",5685
17,"17212",142,117,117,2,0,"ERC-SOBIRAN",51
43,"43033",768,609,607,3,2,"ERC-SOBIRAN",260
43,"43156",3956,2993,2965,23,28,"ERC-SOBIRAN",869
43,"43107",383,308,308,1,0,"ERC-SOBIRAN",146
17,"17101",562,415,413,2,2,"ERC-SOBIRAN",149
17,"17193",4312,3202,3179,15,23,"ERC-SOBIRAN",838
8,"8142",139,126,126,1,0,"ERC-SOBIRAN",41
43,"43124",472,379,373,1,6,"ERC-SOBIRAN",145
17,"17093",922,716,715,2,1,"ERC-SOBIRAN",310
43,"43025",590,476,472,0,4,"ERC-SOBIRAN",184
25,"25102",661,517,511,8,6,"ERC-SOBIRAN",152
25,"25025",1378,996,983,8,13,"ERC-SOBIRAN",145
25,"25248",880,714,713,4,1,"ERC-SOBIRAN",315
17,"17042",408,313,311,0,2,"ERC-SOBIRAN",110
25,"25172",1779,1407,1405,3,2,"ERC-SOBIRAN",570
25,"25161",343,243,243,0,0,"ERC-SOBIRAN",111
8,"8112",12935,9822,9765,74,57,"ERC-SOBIRAN",3250
17,"17084",231,181,180,1,1,"ERC-SOBIRAN",74
25,"25123",189,151,151,0,0,"ERC-SOBIRAN",70
43,"43031",1446,1180,1178,7,2,"ERC-SOBIRAN",402
8,"8212",491,406,402,1,4,"ERC-SOBIRAN",169
43,"43042",2198,1820,1816,8,4,"ERC-SOBIRAN",680
25,"25103",136,103,102,2,1,"ERC-SOBIRAN",43
25,"25191",321,248,244,3,4,"ERC-SOBIRAN",95
17,"17061",183,148,148,0,0,"ERC-SOBIRAN",67
25,"25029",1607,1270,1265,6,5,"ERC-SOBIRAN",523
43,"43064",2017,1569,1558,9,11,"ERC-SOBIRAN",586
25,"25215",505,299,299,4,0,"ERC-SOBIRAN",86
8,"8136",11614,9159,9079,84,80,"ERC-SOBIRAN",1272
8,"8052",139,111,110,0,1,"ERC-SOBIRAN",33
17,"17215",2227,1936,1925,12,11,"ERC-SOBIRAN",777
43,"43158",77,61,61,1,0,"ERC-SOBIRAN",22
8,"8099",753,565,561,2,4,"ERC-SOBIRAN",212
17,"17158",468,337,336,1,1,"ERC-SOBIRAN",102
8,"8055",541,443,442,2,1,"ERC-SOBIRAN",194
25,"25079",285,228,227,0,1,"ERC-SOBIRAN",85
17,"17085",291,248,246,0,2,"ERC-SOBIRAN",113
8,"8242",222,180,180,0,0,"ERC-SOBIRAN",62
43,"43075",86,71,69,0,2,"ERC-SOBIRAN",38
17,"17138",845,650,646,0,4,"ERC-SOBIRAN",193
43,"43003",350,266,264,3,2,"ERC-SOBIRAN",70
17,"17035",550,460,460,3,0,"ERC-SOBIRAN",176
8,"8094",1586,1310,1306,10,4,"ERC-SOBIRAN",504
25,"25217",10819,8163,8120,64,43,"ERC-SOBIRAN",2879
8,"8171",2066,1607,1597,7,10,"ERC-SOBIRAN",604
8,"8286",2919,2210,2199,15,11,"ERC-SOBIRAN",485
17,"17086",1745,1223,1210,7,13,"ERC-SOBIRAN",300
8,"8008",179,139,138,0,1,"ERC-SOBIRAN",65
17,"17207",2411,2006,1992,8,14,"ERC-SOBIRAN",796
43,"43159",81,63,62,0,1,"ERC-SOBIRAN",20
8,"8287",1057,877,871,7,6,"ERC-SOBIRAN",386
25,"25906",210,157,155,0,2,"ERC-SOBIRAN",67
25,"25182",1043,842,839,9,3,"ERC-SOBIRAN",280
8,"8120",7048,5892,5881,49,11,"ERC-SOBIRAN",1743
8,"8048",569,442,442,2,0,"ERC-SOBIRAN",212
8,"8206",737,625,624,3,1,"ERC-SOBIRAN",244
25,"25038",1482,1111,1094,11,17,"ERC-SOBIRAN",337
8,"8083",1672,1478,1471,7,7,"ERC-SOBIRAN",598
25,"25069",425,329,327,1,2,"ERC-SOBIRAN",174
17,"17901",983,790,789,3,1,"ERC-SOBIRAN",294
8,"8022",12219,9089,9038,42,51,"ERC-SOBIRAN",3493
8,"8132",361,281,281,2,0,"ERC-SOBIRAN",87
17,"17180",8500,6462,6431,28,31,"ERC-SOBIRAN",2029
43,"43070",238,194,193,1,1,"ERC-SOBIRAN",93
43,"43018",385,335,334,3,1,"ERC-SOBIRAN",100
17,"17163",2824,2358,2351,13,7,"ERC-SOBIRAN",845
25,"25007",1392,1089,1083,4,6,"ERC-SOBIRAN",388
17,"17208",976,772,768,5,4,"ERC-SOBIRAN",272
8,"8156",11155,8956,8923,60,33,"ERC-SOBIRAN",2225
8,"8306",527,390,388,2,2,"ERC-SOBIRAN",144
8,"8297",135,111,111,1,0,"ERC-SOBIRAN",31
8,"8041",10692,7805,7732,48,73,"ERC-SOBIRAN",1012
43,"43133",5605,4202,4168,21,34,"ERC-SOBIRAN",1469
43,"43176",746,588,586,7,2,"ERC-SOBIRAN",262
43,"43021",345,270,269,3,1,"ERC-SOBIRAN",107
25,"25230",1555,1221,1208,8,13,"ERC-SOBIRAN",514
8,"8011",1745,1414,1407,10,7,"ERC-SOBIRAN",704
17,"17119",73,58,58,2,0,"ERC-SOBIRAN",19
8,"8272",165,133,133,0,0,"ERC-SOBIRAN",59
43,"43177",284,243,242,0,1,"ERC-SOBIRAN",109
8,"8131",741,585,585,4,0,"ERC-SOBIRAN",256
43,"43088",2026,1565,1562,9,3,"ERC-SOBIRAN",624
8,"8211",33731,27698,27561,126,137,"ERC-SOBIRAN",5304
8,"8002",220,184,183,2,1,"ERC-SOBIRAN",63
8,"8237",1662,1334,1327,7,7,"ERC-SOBIRAN",528
17,"17099",78,59,59,0,0,"ERC-SOBIRAN",17
43,"43096",98,82,82,0,0,"ERC-SOBIRAN",37
43,"43063",536,401,397,1,4,"ERC-SOBIRAN",114
8,"8149",984,770,768,3,2,"ERC-SOBIRAN",316
8,"8229",521,435,433,3,2,"ERC-SOBIRAN",184
25,"25909",140,108,107,2,1,"ERC-SOBIRAN",40
8,"8012",1721,1340,1331,8,9,"ERC-SOBIRAN",604
17,"17036",2643,2076,2071,12,5,"ERC-SOBIRAN",743
25,"25031",57,39,39,0,0,"ERC-SOBIRAN",4
17,"17037",114,98,98,6,0,"ERC-SOBIRAN",32
17,"17054",347,271,271,0,0,"ERC-SOBIRAN",93
43,"43162",4418,3467,3453,20,14,"ERC-SOBIRAN",800
8,"8291",4919,3865,3854,28,11,"ERC-SOBIRAN",1024
17,"17150",1426,1199,1192,8,7,"ERC-SOBIRAN",396
8,"8049",1320,981,977,5,4,"ERC-SOBIRAN",446
8,"8221",12699,10571,10537,53,34,"ERC-SOBIRAN",2733
25,"25175",176,135,135,1,0,"ERC-SOBIRAN",54
8,"8020",5172,4337,4327,26,10,"ERC-SOBIRAN",1290
8,"8170",442,338,338,0,0,"ERC-SOBIRAN",118
25,"25250",330,261,258,1,3,"ERC-SOBIRAN",123
17,"17050",674,585,582,5,3,"ERC-SOBIRAN",232
43,"43130",177,145,145,0,0,"ERC-SOBIRAN",69
43,"43090",1169,749,742,2,7,"ERC-SOBIRAN",125
17,"17130",322,268,268,0,0,"ERC-SOBIRAN",127
43,"43005",3643,2765,2749,22,16,"ERC-SOBIRAN",849
8,"8290",1534,1289,1284,9,5,"ERC-SOBIRAN",482
43,"43011",1079,912,909,1,3,"ERC-SOBIRAN",353
25,"25908",221,159,158,1,1,"ERC-SOBIRAN",58
8,"8901",240,203,201,1,2,"ERC-SOBIRAN",90
8,"8196",19444,15361,15263,90,98,"ERC-SOBIRAN",2148
43,"43106",793,656,651,2,5,"ERC-SOBIRAN",247
17,"17082",436,341,339,0,2,"ERC-SOBIRAN",121
43,"43073",84,68,67,0,1,"ERC-SOBIRAN",19
17,"17041",218,166,165,3,1,"ERC-SOBIRAN",85
25,"25143",84,72,71,0,1,"ERC-SOBIRAN",23
25,"25233",285,231,229,2,2,"ERC-SOBIRAN",75
8,"8047",3737,2903,2876,16,27,"ERC-SOBIRAN",905
17,"17164",3932,3078,3054,8,24,"ERC-SOBIRAN",1170
8,"8134",842,649,646,3,3,"ERC-SOBIRAN",240
17,"17145",1432,1113,1103,7,10,"ERC-SOBIRAN",385
17,"17234",179,147,146,2,1,"ERC-SOBIRAN",52
43,"43074",1812,1419,1412,4,7,"ERC-SOBIRAN",504
17,"17213",5535,3998,3985,20,13,"ERC-SOBIRAN",1081
17,"17063",173,157,156,2,1,"ERC-SOBIRAN",83
25,"25126",284,233,232,1,1,"ERC-SOBIRAN",108
8,"8301",49135,38575,38398,272,177,"ERC-SOBIRAN",4758
17,"17023",27144,20301,20146,120,155,"ERC-SOBIRAN",4139
25,"25190",257,215,215,0,0,"ERC-SOBIRAN",95
17,"17090",544,469,468,0,1,"ERC-SOBIRAN",165
25,"25046",407,349,347,1,2,"ERC-SOBIRAN",156
43,"43102",463,384,379,2,5,"ERC-SOBIRAN",183
17,"17214",723,584,580,7,4,"ERC-SOBIRAN",227
25,"25093",629,489,487,4,2,"ERC-SOBIRAN",174
43,"43178",1421,1118,1113,7,5,"ERC-SOBIRAN",369
25,"25112",268,214,212,2,2,"ERC-SOBIRAN",72
25,"25204",1191,936,930,5,6,"ERC-SOBIRAN",390
8,"8100",2092,1792,1782,16,10,"ERC-SOBIRAN",725
43,"43001",694,543,543,5,0,"ERC-SOBIRAN",191
25,"25196",112,94,93,0,1,"ERC-SOBIRAN",27
8,"8236",1557,1204,1202,2,2,"ERC-SOBIRAN",529
17,"17043",167,135,134,0,1,"ERC-SOBIRAN",52
43,"43026",765,614,613,3,1,"ERC-SOBIRAN",302
25,"25008",1088,867,857,7,10,"ERC-SOBIRAN",380
17,"17065",324,254,253,0,1,"ERC-SOBIRAN",96
8,"8058",1787,1357,1340,5,17,"ERC-SOBIRAN",384
17,"17034",7205,5337,5291,16,46,"ERC-SOBIRAN",1556
43,"43174",144,128,127,0,1,"ERC-SOBIRAN",62
8,"8239",460,380,378,2,2,"ERC-SOBIRAN",127
25,"25118",327,241,239,2,2,"ERC-SOBIRAN",86
17,"17225",207,161,161,0,0,"ERC-SOBIRAN",80
8,"8269",2712,2258,2250,19,8,"ERC-SOBIRAN",1011
8,"8904",10514,7733,7697,38,36,"ERC-SOBIRAN",616
17,"17196",242,198,198,1,0,"ERC-SOBIRAN",80
8,"8127",2240,1694,1683,13,11,"ERC-SOBIRAN",525
8,"8226",926,811,807,1,4,"ERC-SOBIRAN",383
8,"8145",2701,2156,2144,7,12,"ERC-SOBIRAN",698
8,"8111",215,200,199,4,1,"ERC-SOBIRAN",46
8,"8119",6838,5352,5326,31,26,"ERC-SOBIRAN",1232
8,"8024",357,301,298,1,3,"ERC-SOBIRAN",128
17,"17076",122,101,100,1,1,"ERC-SOBIRAN",36
25,"25081",287,221,220,2,1,"ERC-SOBIRAN",86
43,"43068",483,367,365,5,2,"ERC-SOBIRAN",105
25,"25240",1385,1116,1110,10,6,"ERC-SOBIRAN",398
8,"8261",2378,1821,1815,14,6,"ERC-SOBIRAN",514
17,"17046",710,574,571,3,3,"ERC-SOBIRAN",256
8,"8209",6896,5269,5244,25,25,"ERC-SOBIRAN",1317
43,"43094",2120,1659,1646,9,13,"ERC-SOBIRAN",699
43,"43151",109,98,98,0,0,"ERC-SOBIRAN",47
43,"43058",96,77,77,0,0,"ERC-SOBIRAN",35
17,"17077",567,434,434,2,0,"ERC-SOBIRAN",148
17,"17033",5587,4157,4130,13,27,"ERC-SOBIRAN",1114
25,"25072",5874,4468,4450,24,18,"ERC-SOBIRAN",1496
8,"8054",9155,7468,7428,43,40,"ERC-SOBIRAN",1792
8,"8241",69,56,56,0,0,"ERC-SOBIRAN",16
17,"17155",14861,10307,10234,52,73,"ERC-SOBIRAN",2380
8,"8129",484,406,405,3,1,"ERC-SOBIRAN",184
8,"8009",9480,7649,7620,35,29,"ERC-SOBIRAN",2328
43,"43143",51,45,44,0,1,"ERC-SOBIRAN",13
17,"17010",327,264,263,2,1,"ERC-SOBIRAN",86
25,"25068",531,402,399,6,3,"ERC-SOBIRAN",138
17,"17058",170,139,139,0,0,"ERC-SOBIRAN",34
8,"8010",4207,3327,3304,13,23,"ERC-SOBIRAN",1235
25,"25085",141,118,117,2,1,"ERC-SOBIRAN",31
25,"25140",773,573,571,5,2,"ERC-SOBIRAN",222
43,"43160",1322,1051,1045,0,6,"ERC-SOBIRAN",303
8,"8280",95,78,78,1,0,"ERC-SOBIRAN",28
43,"43166",1628,1292,1285,3,7,"ERC-SOBIRAN",402
17,"17038",380,312,308,3,4,"ERC-SOBIRAN",128
17,"17109",698,558,553,1,5,"ERC-SOBIRAN",223
8,"8175",3368,2496,2486,16,10,"ERC-SOBIRAN",1066
25,"25185",679,493,491,6,2,"ERC-SOBIRAN",202
17,"17141",6072,4251,4221,14,30,"ERC-SOBIRAN",1177
25,"25062",695,578,573,3,5,"ERC-SOBIRAN",238
25,"25099",1291,981,978,2,3,"ERC-SOBIRAN",392
8,"8228",288,239,239,2,0,"ERC-SOBIRAN",114
43,"43079",356,306,305,1,1,"ERC-SOBIRAN",118
25,"25042",208,160,160,1,0,"ERC-SOBIRAN",39
43,"43136",10463,7789,7749,36,40,"ERC-SOBIRAN",3318
43,"43120",421,302,297,2,5,"ERC-SOBIRAN",76
17,"17009",4051,3263,3248,14,15,"ERC-SOBIRAN",1218
8,"8044",4136,3193,3175,11,18,"ERC-SOBIRAN",1014
8,"8114",18648,14251,14170,69,81,"ERC-SOBIRAN",2994
17,"17029",199,160,157,1,3,"ERC-SOBIRAN",56
8,"8061",1590,1236,1233,8,3,"ERC-SOBIRAN",309
8,"8088",12248,9945,9904,57,41,"ERC-SOBIRAN",3251
25,"25220",994,822,816,3,6,"ERC-SOBIRAN",220
8,"8053",2865,2105,2098,17,7,"ERC-SOBIRAN",617
8,"8304",816,686,678,1,8,"ERC-SOBIRAN",316
43,"43113",397,325,323,2,2,"ERC-SOBIRAN",87
43,"43135",341,283,280,4,3,"ERC-SOBIRAN",106
8,"8267",6748,5389,5362,28,27,"ERC-SOBIRAN",1309
17,"17074",532,436,426,2,10,"ERC-SOBIRAN",166
43,"43110",251,184,184,1,0,"ERC-SOBIRAN",69
8,"8018",2551,1998,1984,6,14,"ERC-SOBIRAN",613
17,"17111",958,772,771,3,1,"ERC-SOBIRAN",274
43,"43170",878,706,704,7,2,"ERC-SOBIRAN",282
8,"8195",76,69,69,0,0,"ERC-SOBIRAN",17
8,"8077",34578,27617,27501,134,116,"ERC-SOBIRAN",4318
8,"8130",108,89,86,2,3,"ERC-SOBIRAN",44
43,"43083",144,116,113,1,3,"ERC-SOBIRAN",36
25,"25216",241,199,199,2,0,"ERC-SOBIRAN",87
25,"25087",56,49,49,0,0,"ERC-SOBIRAN",14
17,"17186",3824,3115,3098,15,17,"ERC-SOBIRAN",897
8,"8133",128,98,98,5,0,"ERC-SOBIRAN",33
43,"43111",2098,1496,1483,8,13,"ERC-SOBIRAN",382
43,"43901",8750,6057,6004,43,53,"ERC-SOBIRAN",2381
8,"8035",12871,9574,9538,31,36,"ERC-SOBIRAN",2798
25,"25176",307,262,259,1,3,"ERC-SOBIRAN",103
25,"25911",424,332,331,1,1,"ERC-SOBIRAN",143
25,"25055",163,130,129,0,1,"ERC-SOBIRAN",40
8,"8124",37130,29069,28915,146,154,"ERC-SOBIRAN",5231
8,"8266",43383,35117,34994,178,123,"ERC-SOBIRAN",6744
25,"25024",352,273,272,0,1,"ERC-SOBIRAN",129
8,"8005",6380,5122,5106,18,16,"ERC-SOBIRAN",1687
8,"8125",25485,19719,19627,101,92,"ERC-SOBIRAN",3573
25,"25005",274,202,202,2,0,"ERC-SOBIRAN",77
17,"17184",1264,1068,1060,5,8,"ERC-SOBIRAN",434
25,"25077",440,331,330,1,1,"ERC-SOBIRAN",132
25,"25212",224,195,195,2,0,"ERC-SOBIRAN",69
17,"17073",1939,1695,1693,7,2,"ERC-SOBIRAN",548
17,"17124",1599,1258,1254,6,4,"ERC-SOBIRAN",431
25,"25089",97,72,71,1,1,"ERC-SOBIRAN",33
25,"25912",843,685,684,4,1,"ERC-SOBIRAN",159
8,"8249",272,248,248,2,0,"ERC-SOBIRAN",101
8,"8152",116,94,94,0,0,"ERC-SOBIRAN",40
8,"8232",1786,1444,1434,9,10,"ERC-SOBIRAN",545
8,"8091",5413,4301,4283,20,18,"ERC-SOBIRAN",1240
43,"43091",123,93,93,1,0,"ERC-SOBIRAN",36
43,"43140",2438,1847,1837,16,10,"ERC-SOBIRAN",343
17,"17114",23269,17558,17474,91,84,"ERC-SOBIRAN",5726
25,"25040",10614,7791,7734,58,57,"ERC-SOBIRAN",2613
8,"8218",8104,6419,6389,34,30,"ERC-SOBIRAN",1659
25,"25221",117,92,92,0,0,"ERC-SOBIRAN",43
25,"25053",1092,879,873,8,6,"ERC-SOBIRAN",329
17,"17004",533,445,441,3,4,"ERC-SOBIRAN",194
25,"25179",171,134,134,1,0,"ERC-SOBIRAN",61
25,"25037",366,286,284,3,2,"ERC-SOBIRAN",108
43,"43047",4209,2878,2856,23,22,"ERC-SOBIRAN",513
8,"8062",1004,829,826,11,3,"ERC-SOBIRAN",311
25,"25032",67,53,53,0,0,"ERC-SOBIRAN",28
17,"17088",578,468,468,1,0,"ERC-SOBIRAN",217
43,"43157",345,303,303,0,0,"ERC-SOBIRAN",138
43,"43045",146,128,127,0,1,"ERC-SOBIRAN",63
25,"25170",261,230,228,4,2,"ERC-SOBIRAN",78
8,"8216",25,19,19,0,0,"ERC-SOBIRAN",11
43,"43149",684,533,533,4,0,"ERC-SOBIRAN",164
8,"8277",171,150,150,0,0,"ERC-SOBIRAN",50
8,"8084",1167,941,936,6,5,"ERC-SOBIRAN",354
25,"25904",162,147,147,3,0,"ERC-SOBIRAN",40
8,"8225",94,81,81,1,0,"ERC-SOBIRAN",31
8,"8144",713,565,563,5,2,"ERC-SOBIRAN",245
17,"17157",124,107,107,0,0,"ERC-SOBIRAN",32
25,"25193",767,614,606,6,8,"ERC-SOBIRAN",238
43,"43117",143,114,113,0,1,"ERC-SOBIRAN",36
43,"43043",3289,2624,2613,14,11,"ERC-SOBIRAN",674
17,"17026",543,450,449,4,1,"ERC-SOBIRAN",155
17,"17197",131,113,113,1,0,"ERC-SOBIRAN",37
25,"25251",713,562,558,4,4,"ERC-SOBIRAN",215
8,"8199",651,542,542,4,0,"ERC-SOBIRAN",198
8,"8260",18400,14471,14406,87,65,"ERC-SOBIRAN",2571
17,"17903",889,726,721,4,5,"ERC-SOBIRAN",257
8,"8243",156,139,139,0,0,"ERC-SOBIRAN",66
8,"8234",3373,2742,2734,25,8,"ERC-SOBIRAN",945
17,"17159",626,487,483,1,4,"ERC-SOBIRAN",181
43,"43076",460,378,377,2,1,"ERC-SOBIRAN",177
43,"43085",235,198,194,0,4,"ERC-SOBIRAN",83
8,"8042",2362,1910,1904,7,6,"ERC-SOBIRAN",464
25,"25105",103,89,88,1,1,"ERC-SOBIRAN",36
8,"8296",1843,1520,1514,10,6,"ERC-SOBIRAN",520
8,"8126",8865,7125,7098,33,27,"ERC-SOBIRAN",1902
25,"25238",205,163,163,2,0,"ERC-SOBIRAN",56
17,"17125",131,98,97,1,1,"ERC-SOBIRAN",38
8,"8109",208,184,183,0,1,"ERC-SOBIRAN",93
43,"43905",14941,10510,10446,40,64,"ERC-SOBIRAN",1663
25,"25163",236,181,179,3,2,"ERC-SOBIRAN",74
25,"25061",80,59,58,0,1,"ERC-SOBIRAN",22
8,"8189",122,106,106,0,0,"ERC-SOBIRAN",47
25,"25097",84,72,72,1,0,"ERC-SOBIRAN",46
8,"8103",640,507,505,4,2,"ERC-SOBIRAN",197
17,"17103",5084,3575,3543,13,32,"ERC-SOBIRAN",822
43,"43013",4392,3341,3321,14,20,"ERC-SOBIRAN",1295
43,"43173",99,80,78,0,2,"ERC-SOBIRAN",35
17,"17199",6955,5328,5308,23,20,"ERC-SOBIRAN",1818
43,"43037",17902,12787,12695,63,92,"ERC-SOBIRAN",2542
43,"43078",843,653,644,4,9,"ERC-SOBIRAN",203
43,"43168",84,65,65,1,0,"ERC-SOBIRAN",32
8,"8060",135,111,109,0,2,"ERC-SOBIRAN",29
25,"25098",232,172,170,2,2,"ERC-SOBIRAN",65
8,"8104",653,516,516,2,0,"ERC-SOBIRAN",221
17,"17048",6251,4565,4537,20,28,"ERC-SOBIRAN",1040
25,"25011",5260,3908,3871,30,37,"ERC-SOBIRAN",1517
43,"43095",2564,1995,1984,14,11,"ERC-SOBIRAN",552
8,"8122",1716,1260,1254,8,6,"ERC-SOBIRAN",442
25,"25208",333,252,249,0,3,"ERC-SOBIRAN",114
25,"25002",467,357,356,2,1,"ERC-SOBIRAN",142
8,"8026",193,161,161,1,0,"ERC-SOBIRAN",63
17,"17110",1329,1064,1054,5,10,"ERC-SOBIRAN",266
8,"8202",12843,10074,10025,57,49,"ERC-SOBIRAN",2967
25,"25086",521,414,411,2,3,"ERC-SOBIRAN",198
25,"25131",402,321,320,1,1,"ERC-SOBIRAN",149
25,"25033",1121,899,890,5,9,"ERC-SOBIRAN",381
8,"8027",720,592,588,3,4,"ERC-SOBIRAN",189
43,"43014",14357,10596,10542,60,54,"ERC-SOBIRAN",4252
43,"43038",21861,16504,16406,112,98,"ERC-SOBIRAN",3758
25,"25174",390,324,324,0,0,"ERC-SOBIRAN",122
43,"43023",214,186,186,1,0,"ERC-SOBIRAN",86
8,"8003",7183,5761,5742,39,19,"ERC-SOBIRAN",1796
25,"25034",2288,1733,1719,9,14,"ERC-SOBIRAN",738
8,"8281",4840,4009,3998,23,11,"ERC-SOBIRAN",1324
25,"25227",664,517,517,1,0,"ERC-SOBIRAN",214
43,"43061",38,28,28,0,0,"ERC-SOBIRAN",9
43,"43127",759,630,626,3,4,"ERC-SOBIRAN",260
25,"25171",2127,1639,1630,8,9,"ERC-SOBIRAN",643
8,"8080",39,30,30,0,0,"ERC-SOBIRAN",13
8,"8106",7469,5816,5795,34,21,"ERC-SOBIRAN",1831
17,"17191",166,145,144,2,1,"ERC-SOBIRAN",44
17,"17217",353,312,311,1,1,"ERC-SOBIRAN",112
8,"8273",2353,1944,1934,9,10,"ERC-SOBIRAN",776
8,"8138",4432,3435,3413,10,22,"ERC-SOBIRAN",1386
17,"17087",222,177,176,0,1,"ERC-SOBIRAN",68
8,"8066",1463,1185,1181,9,4,"ERC-SOBIRAN",316
25,"25109",214,179,176,3,3,"ERC-SOBIRAN",53
43,"43114",375,306,305,0,1,"ERC-SOBIRAN",153
17,"17233",2328,1924,1912,6,12,"ERC-SOBIRAN",614
25,"25133",686,528,527,2,1,"ERC-SOBIRAN",214
8,"8274",4674,3710,3698,12,12,"ERC-SOBIRAN",985
8,"8081",353,299,297,2,2,"ERC-SOBIRAN",103
43,"43081",633,532,531,7,1,"ERC-SOBIRAN",209
17,"17091",398,310,305,2,5,"ERC-SOBIRAN",126
17,"17062",5978,4358,4334,26,24,"ERC-SOBIRAN",1255
25,"25076",134,94,93,0,1,"ERC-SOBIRAN",28
17,"17173",182,156,156,0,0,"ERC-SOBIRAN",50
25,"25222",66,57,57,0,0,"ERC-SOBIRAN",13
43,"43148",90763,69756,69423,299,333,"ERC-SOBIRAN",14227
43,"43008",307,202,200,1,2,"ERC-SOBIRAN",63
8,"8090",137,113,113,2,0,"ERC-SOBIRAN",46
17,"17203",165,135,135,0,0,"ERC-SOBIRAN",54
8,"8283",6113,4832,4813,33,19,"ERC-SOBIRAN",1798
43,"43041",228,179,177,3,2,"ERC-SOBIRAN",59
43,"43139",1999,1552,1539,10,13,"ERC-SOBIRAN",611
25,"25177",358,270,268,1,2,"ERC-SOBIRAN",120
17,"17067",697,581,578,4,3,"ERC-SOBIRAN",222
8,"8014",2000,1578,1567,5,11,"ERC-SOBIRAN",673
17,"17032",1742,1235,1224,6,11,"ERC-SOBIRAN",430
17,"17154",99,84,83,0,1,"ERC-SOBIRAN",29
43,"43164",306,228,228,0,0,"ERC-SOBIRAN",41
43,"43082",351,303,297,1,6,"ERC-SOBIRAN",115
43,"43115",128,112,111,1,1,"ERC-SOBIRAN",46
43,"43009",1391,1086,1078,3,8,"ERC-SOBIRAN",365
17,"17165",634,516,512,3,4,"ERC-SOBIRAN",180
17,"17021",122,98,98,0,0,"ERC-SOBIRAN",33
8,"8238",14851,12472,12428,50,44,"ERC-SOBIRAN",3790
43,"43034",468,393,393,0,0,"ERC-SOBIRAN",168
8,"8065",1180,967,964,4,3,"ERC-SOBIRAN",341
43,"43165",572,492,492,1,0,"ERC-SOBIRAN",216
17,"17081",248,192,190,0,2,"ERC-SOBIRAN",70
8,"8117",2480,2055,2050,16,5,"ERC-SOBIRAN",731
17,"17172",457,352,349,1,3,"ERC-SOBIRAN",121
43,"43119",838,630,628,4,2,"ERC-SOBIRAN",199
25,"25253",145,122,121,0,1,"ERC-SOBIRAN",63
17,"17075",334,282,281,5,1,"ERC-SOBIRAN",130
8,"8253",128,113,113,0,0,"ERC-SOBIRAN",56
25,"25104",122,91,91,0,0,"ERC-SOBIRAN",32
17,"17094",1068,772,766,1,6,"ERC-SOBIRAN",291
25,"25039",261,216,216,1,0,"ERC-SOBIRAN",72
43,"43093",3884,2956,2933,14,23,"ERC-SOBIRAN",1022
17,"17055",143,126,125,0,1,"ERC-SOBIRAN",53
8,"8303",256,215,213,1,2,"ERC-SOBIRAN",101
17,"17902",1306,1076,1074,3,2,"ERC-SOBIRAN",375
17,"17147",7959,6164,6130,45,34,"ERC-SOBIRAN",1984
17,"17025",1170,972,967,6,5,"ERC-SOBIRAN",337
17,"17066",27323,18373,18269,98,104,"ERC-SOBIRAN",4763
25,"25205",562,451,447,7,4,"ERC-SOBIRAN",162
25,"25045",54,31,31,5,0,"ERC-SOBIRAN",6
17,"17006",1186,880,878,10,2,"ERC-SOBIRAN",344
25,"25070",811,677,675,4,2,"ERC-SOBIRAN",283
25,"25239",595,367,366,3,1,"ERC-SOBIRAN",138
25,"25094",139,116,116,0,0,"ERC-SOBIRAN",35
17,"17206",155,118,115,0,3,"ERC-SOBIRAN",42
43,"43150",1238,1034,1026,6,8,"ERC-SOBIRAN",383
43,"43175",537,426,419,5,7,"ERC-SOBIRAN",146
8,"8220",2411,2119,2115,13,4,"ERC-SOBIRAN",924
17,"17095",19938,13998,13918,69,80,"ERC-SOBIRAN",2524
25,"25119",2245,1798,1792,10,6,"ERC-SOBIRAN",760
25,"25150",165,136,133,0,3,"ERC-SOBIRAN",42
8,"8208",5760,4660,4643,25,17,"ERC-SOBIRAN",1223
8,"8163",19497,14616,14548,67,68,"ERC-SOBIRAN",3369
17,"17168",379,332,329,0,3,"ERC-SOBIRAN",138
25,"25082",295,229,229,2,0,"ERC-SOBIRAN",114
8,"8017",2827,2192,2182,16,10,"ERC-SOBIRAN",787
43,"43066",155,121,121,1,0,"ERC-SOBIRAN",55
43,"43116",463,381,379,2,2,"ERC-SOBIRAN",171
8,"8177",39,31,31,0,0,"ERC-SOBIRAN",11
8,"8172",20417,16196,16144,88,52,"ERC-SOBIRAN",4283
43,"43036",865,605,602,1,3,"ERC-SOBIRAN",142
25,"25136",96,79,79,2,0,"ERC-SOBIRAN",26
25,"25218",86,79,79,0,0,"ERC-SOBIRAN",40
25,"25130",183,142,140,0,2,"ERC-SOBIRAN",61
8,"8279",155280,121081,120515,802,566,"ERC-SOBIRAN",25143
8,"8288",1676,1196,1182,6,14,"ERC-SOBIRAN",297
17,"17047",4968,3447,3429,22,18,"ERC-SOBIRAN",863
25,"25146",221,172,170,3,2,"ERC-SOBIRAN",47
43,"43103",905,746,740,8,6,"ERC-SOBIRAN",199
8,"8164",934,784,776,1,8,"ERC-SOBIRAN",303
25,"25010",196,156,155,2,1,"ERC-SOBIRAN",78
8,"8087",149,135,133,0,2,"ERC-SOBIRAN",49
8,"8201",447,327,324,5,3,"ERC-SOBIRAN",137
25,"25073",546,420,418,2,2,"ERC-SOBIRAN",208
8,"8139",177,156,156,0,0,"ERC-SOBIRAN",60
8,"8271",67,57,57,0,0,"ERC-SOBIRAN",26
8,"8174",392,330,330,4,0,"ERC-SOBIRAN",136
43,"43054",2792,2145,2134,21,11,"ERC-SOBIRAN",986
25,"25197",141,109,108,0,1,"ERC-SOBIRAN",55
43,"43067",528,450,445,1,5,"ERC-SOBIRAN",251
43,"43006",676,531,525,4,6,"ERC-SOBIRAN",234
43,"43104",1762,1410,1401,5,9,"ERC-SOBIRAN",708
43,"43046",90,73,73,1,0,"ERC-SOBIRAN",36
17,"17089",5695,4211,4194,13,17,"ERC-SOBIRAN",1319
43,"43062",259,223,220,2,3,"ERC-SOBIRAN",60
43,"43137",1905,1515,1499,15,16,"ERC-SOBIRAN",450
8,"8255",137,105,105,1,0,"ERC-SOBIRAN",31
25,"25059",813,621,612,3,9,"ERC-SOBIRAN",67
8,"8102",28794,22420,22317,92,103,"ERC-SOBIRAN",7162
43,"43112",250,204,204,1,0,"ERC-SOBIRAN",96
8,"8307",49310,38223,38022,162,201,"ERC-SOBIRAN",9603
25,"25074",180,157,155,2,2,"ERC-SOBIRAN",67
25,"25165",276,221,219,1,2,"ERC-SOBIRAN",88
25,"25063",95,61,61,0,0,"ERC-SOBIRAN",9
8,"8247",980,832,828,3,4,"ERC-SOBIRAN",360
17,"17210",580,449,445,2,4,"ERC-SOBIRAN",162
25,"25138",547,440,436,1,4,"ERC-SOBIRAN",210
8,"8034",784,648,646,1,2,"ERC-SOBIRAN",265
25,"25169",167,118,117,0,1,"ERC-SOBIRAN",43
8,"8089",34019,26317,26191,170,126,"ERC-SOBIRAN",4426
8,"8299",377,318,317,0,1,"ERC-SOBIRAN",150
25,"25020",274,221,221,2,0,"ERC-SOBIRAN",92
25,"25210",1079,867,853,4,14,"ERC-SOBIRAN",349
25,"25255",395,321,318,2,3,"ERC-SOBIRAN",101
17,"17227",139,106,106,0,0,"ERC-SOBIRAN",51
43,"43069",178,146,146,0,0,"ERC-SOBIRAN",51
25,"25051",1510,1176,1172,6,4,"ERC-SOBIRAN",486
8,"8121",87292,67638,67328,362,310,"ERC-SOBIRAN",14870
25,"25115",801,638,637,4,1,"ERC-SOBIRAN",217
25,"25047",972,784,781,8,3,"ERC-SOBIRAN",365
25,"25035",366,306,302,2,4,"ERC-SOBIRAN",113
8,"8013",1280,1040,1031,5,9,"ERC-SOBIRAN",326
8,"8063",467,406,405,3,1,"ERC-SOBIRAN",202
43,"43032",466,379,379,1,0,"ERC-SOBIRAN",131
17,"17002",564,491,488,3,3,"ERC-SOBIRAN",161
8,"8150",251,211,211,0,0,"ERC-SOBIRAN",97
8,"8230",7666,6202,6168,30,34,"ERC-SOBIRAN",1563
8,"8098",2409,1916,1912,9,4,"ERC-SOBIRAN",558
43,"43048",763,614,609,7,5,"ERC-SOBIRAN",222
17,"17069",364,286,284,2,2,"ERC-SOBIRAN",102
8,"8248",5616,4378,4365,32,13,"ERC-SOBIRAN",1403
8,"8240",9453,7807,7776,21,31,"ERC-SOBIRAN",2540
17,"17222",105,95,95,1,0,"ERC-SOBIRAN",51
8,"8168",394,287,287,1,0,"ERC-SOBIRAN",70
8,"8116",558,459,459,0,0,"ERC-SOBIRAN",204
43,"43131",4772,3432,3401,18,31,"ERC-SOBIRAN",614
25,"25114",95,79,79,0,0,"ERC-SOBIRAN",28
8,"8275",248,223,222,1,1,"ERC-SOBIRAN",82
8,"8070",266,232,232,0,0,"ERC-SOBIRAN",101
25,"25168",488,408,407,6,1,"ERC-SOBIRAN",150
43,"43172",337,261,257,2,4,"ERC-SOBIRAN",101
8,"8074",11054,8273,8235,34,38,"ERC-SOBIRAN",1738
8,"8179",611,496,493,2,3,"ERC-SOBIRAN",163
8,"8006",11774,9039,8981,33,58,"ERC-SOBIRAN",2981
8,"8021",61,47,45,0,2,"ERC-SOBIRAN",22
25,"25056",213,163,163,3,0,"ERC-SOBIRAN",68
8,"8085",976,812,811,2,1,"ERC-SOBIRAN",313
25,"25023",4527,3621,3601,23,20,"ERC-SOBIRAN",1199
8,"8146",1358,1086,1079,2,7,"ERC-SOBIRAN",275
17,"17204",596,461,460,2,1,"ERC-SOBIRAN",143
25,"25135",1000,773,769,2,4,"ERC-SOBIRAN",290
8,"8176",161,132,131,2,1,"ERC-SOBIRAN",44
8,"8197",7896,6197,6174,28,23,"ERC-SOBIRAN",1900
43,"43903",2333,1717,1700,11,17,"ERC-SOBIRAN",807
8,"8166",962,753,745,7,8,"ERC-SOBIRAN",266
17,"17078",336,252,251,3,1,"ERC-SOBIRAN",95
8,"8244",6041,4994,4970,33,24,"ERC-SOBIRAN",1383
8,"8302",9373,7001,6934,61,67,"ERC-SOBIRAN",1088
8,"8305",27533,21656,21539,96,117,"ERC-SOBIRAN",6789
8,"8069",3280,2691,2680,17,11,"ERC-SOBIRAN",902
8,"8294",2063,1644,1643,10,1,"ERC-SOBIRAN",563
8,"8190",258,216,215,1,1,"ERC-SOBIRAN",99
8,"8268",971,746,737,3,9,"ERC-SOBIRAN",315
25,"25017",232,184,181,0,3,"ERC-SOBIRAN",83
43,"43141",105,86,86,0,0,"ERC-SOBIRAN",28
17,"17167",2609,2122,2102,14,20,"ERC-SOBIRAN",805
8,"8153",559,460,458,2,2,"ERC-SOBIRAN",194
8,"8233",1846,1485,1478,8,7,"ERC-SOBIRAN",664
25,"25158",1606,1291,1277,5,14,"ERC-SOBIRAN",510
8,"8004",209,194,191,0,3,"ERC-SOBIRAN",72
25,"25134",603,492,490,1,2,"ERC-SOBIRAN",216
17,"17044",6930,5514,5493,26,21,"ERC-SOBIRAN",1892
8,"8076",16497,12734,12667,82,67,"ERC-SOBIRAN",3148
8,"8093",24,20,20,0,0,"ERC-SOBIRAN",13
8,"8067",5728,4535,4513,21,22,"ERC-SOBIRAN",1763
8,"8033",13218,10480,10435,50,45,"ERC-SOBIRAN",3341
43,"43904",2861,2083,2058,27,25,"ERC-SOBIRAN",743
17,"17148",1531,1165,1153,4,12,"ERC-SOBIRAN",272
17,"17056",1766,1438,1433,9,5,"ERC-SOBIRAN",430
8,"8050",136,115,114,0,1,"ERC-SOBIRAN",49
17,"17177",567,459,457,2,2,"ERC-SOBIRAN",174
25,"25067",706,537,532,4,5,"ERC-SOBIRAN",174
43,"43012",3647,3028,3019,15,9,"ERC-SOBIRAN",882
25,"25049",155,113,111,0,2,"ERC-SOBIRAN",42
43,"43126",1211,1005,999,4,6,"ERC-SOBIRAN",353
17,"17216",155,127,124,0,3,"ERC-SOBIRAN",44
17,"17171",172,143,141,0,2,"ERC-SOBIRAN",60
25,"25016",2083,1590,1587,8,3,"ERC-SOBIRAN",667
17,"17121",229,184,184,1,0,"ERC-SOBIRAN",65
25,"25003",3721,2828,2815,19,13,"ERC-SOBIRAN",1157
8,"8191",5270,4176,4162,19,14,"ERC-SOBIRAN",1306
8,"8276",233,180,180,0,0,"ERC-SOBIRAN",68
25,"25050",3269,2457,2446,23,11,"ERC-SOBIRAN",1061
43,"43007",640,510,509,0,1,"ERC-SOBIRAN",192
17,"17071",1128,978,978,3,0,"ERC-SOBIRAN",396
8,"8227",2410,1882,1877,10,5,"ERC-SOBIRAN",685
8,"8155",6960,5427,5390,39,37,"ERC-SOBIRAN",1302
8,"8182",2892,2217,2204,18,13,"ERC-SOBIRAN",506
43,"43108",1778,1374,1365,6,9,"ERC-SOBIRAN",431
8,"8118",17542,14101,14059,56,42,"ERC-SOBIRAN",4422
17,"17140",639,539,527,4,12,"ERC-SOBIRAN",164
17,"17107",269,221,219,2,2,"ERC-SOBIRAN",95
8,"8165",1664,1315,1311,9,4,"ERC-SOBIRAN",416
25,"25021",2541,1891,1882,14,9,"ERC-SOBIRAN",752
25,"25121",635,436,429,1,7,"ERC-SOBIRAN",87
8,"8043",3378,2579,2569,20,10,"ERC-SOBIRAN",537
25,"25001",139,104,103,1,1,"ERC-SOBIRAN",39
43,"43128",905,751,747,4,4,"ERC-SOBIRAN",273
8,"8193",984,792,790,5,2,"ERC-SOBIRAN",335
8,"8007",6775,5447,5419,21,28,"ERC-SOBIRAN",2159
8,"8308",137,118,118,0,0,"ERC-SOBIRAN",36
17,"17132",1333,1088,1080,9,8,"ERC-SOBIRAN",381
25,"25145",76,66,66,1,0,"ERC-SOBIRAN",22
17,"17190",838,681,677,0,4,"ERC-SOBIRAN",284
17,"17218",570,468,465,5,3,"ERC-SOBIRAN",134
25,"25247",147,100,100,2,0,"ERC-SOBIRAN",8
8,"8205",61279,51629,51497,360,132,"ERC-SOBIRAN",13772
25,"25211",672,513,512,6,1,"ERC-SOBIRAN",263
25,"25101",543,454,449,1,5,"ERC-SOBIRAN",190
8,"8137",274,232,229,0,3,"ERC-SOBIRAN",90
43,"43065",382,308,304,1,4,"ERC-SOBIRAN",143
17,"17039",1740,1385,1380,8,5,"ERC-SOBIRAN",454
25,"25254",711,576,571,5,5,"ERC-SOBIRAN",200
8,"8258",813,661,657,6,4,"ERC-SOBIRAN",343
8,"8097",1080,891,880,2,11,"ERC-SOBIRAN",331
25,"25142",365,300,299,2,1,"ERC-SOBIRAN",129
17,"17106",143,124,123,0,1,"ERC-SOBIRAN",49
17,"17096",164,113,113,1,0,"ERC-SOBIRAN",45
25,"25223",911,732,723,6,9,"ERC-SOBIRAN",304
17,"17007",1752,1430,1422,2,8,"ERC-SOBIRAN",386
8,"8123",19489,16197,16135,58,62,"ERC-SOBIRAN",4725
25,"25200",323,253,252,0,1,"ERC-SOBIRAN",137
8,"8115",3825,2994,2975,12,19,"ERC-SOBIRAN",726
43,"43122",111,98,97,0,1,"ERC-SOBIRAN",40
25,"25075",131,102,102,0,0,"ERC-SOBIRAN",41
8,"8140",4778,3756,3737,19,19,"ERC-SOBIRAN",1166
25,"25907",497,389,386,2,3,"ERC-SOBIRAN",173
8,"8051",18437,14951,14887,85,64,"ERC-SOBIRAN",4208
17,"17169",2497,2047,2042,8,5,"ERC-SOBIRAN",644
8,"8031",2336,1886,1882,11,4,"ERC-SOBIRAN",652
8,"8300",5892,4912,4880,24,32,"ERC-SOBIRAN",1287
8,"8162",2124,1659,1651,7,8,"ERC-SOBIRAN",534
25,"25167",226,185,185,2,0,"ERC-SOBIRAN",47
25,"25232",1356,1066,1061,2,5,"ERC-SOBIRAN",336
25,"25113",1116,912,908,8,4,"ERC-SOBIRAN",396
8,"8187",153380,120687,120090,637,597,"ERC-SOBIRAN",26086
8,"8295",11184,8566,8529,43,37,"ERC-SOBIRAN",1824
25,"25901",287,209,207,1,2,"ERC-SOBIRAN",90
43,"43024",1556,1154,1137,3,17,"ERC-SOBIRAN",255
8,"8903",197,177,176,0,1,"ERC-SOBIRAN",78
8,"8082",1143,868,861,4,7,"ERC-SOBIRAN",161
25,"25243",3730,2637,2606,20,31,"ERC-SOBIRAN",378
25,"25036",184,144,143,0,1,"ERC-SOBIRAN",43
25,"25014",249,203,200,2,3,"ERC-SOBIRAN",91
43,"43101",145,122,122,1,0,"ERC-SOBIRAN",45
25,"25181",175,136,135,0,1,"ERC-SOBIRAN",40
17,"17116",354,283,282,0,1,"ERC-SOBIRAN",122
43,"43015",119,101,101,0,0,"ERC-SOBIRAN",51
17,"17128",316,255,252,1,3,"ERC-SOBIRAN",98
25,"25186",207,174,173,7,1,"ERC-SOBIRAN",55
17,"17220",805,673,665,2,8,"ERC-SOBIRAN",265
8,"8030",5209,4318,4305,16,13,"ERC-SOBIRAN",1478
17,"17129",144,120,120,1,0,"ERC-SOBIRAN",49
17,"17052",134,104,104,1,0,"ERC-SOBIRAN",44
25,"25156",784,608,605,4,3,"ERC-SOBIRAN",251
43,"43134",273,224,223,5,1,"ERC-SOBIRAN",61
17,"17016",719,584,581,1,3,"ERC-SOBIRAN",221
17,"17188",169,139,138,1,1,"ERC-SOBIRAN",43
43,"43039",105,85,85,0,0,"ERC-SOBIRAN",43
25,"25913",86,77,77,0,0,"ERC-SOBIRAN",41
25,"25127",214,172,172,0,0,"ERC-SOBIRAN",83
8,"8039",402,334,334,2,0,"ERC-SOBIRAN",115
8,"8198",4640,3713,3691,23,22,"ERC-SOBIRAN",1291
8,"8040",11004,8468,8431,24,37,"ERC-SOBIRAN",2770
17,"17162",156,114,111,1,3,"ERC-SOBIRAN",25
17,"17153",188,162,162,0,0,"ERC-SOBIRAN",58
17,"17057",968,826,822,1,4,"ERC-SOBIRAN",353
17,"17118",12916,9521,9460,37,61,"ERC-SOBIRAN",2852
8,"8092",3714,2912,2889,8,23,"ERC-SOBIRAN",1160
17,"17189",1476,1278,1275,2,3,"ERC-SOBIRAN",415
25,"25180",228,176,174,1,2,"ERC-SOBIRAN",68
17,"17068",246,194,193,0,1,"ERC-SOBIRAN",59
8,"8180",27072,21218,21100,126,118,"ERC-SOBIRAN",3077
25,"25245",430,346,342,1,4,"ERC-SOBIRAN",111
17,"17166",547,460,459,2,1,"ERC-SOBIRAN",194
43,"43154",126,111,111,0,0,"ERC-SOBIRAN",61
25,"25030",123,90,90,1,0,"ERC-SOBIRAN",35
17,"17014",63,51,50,0,1,"ERC-SOBIRAN",21
25,"25044",178,145,144,6,1,"ERC-SOBIRAN",40
25,"25124",157,114,114,0,0,"ERC-SOBIRAN",36
8,"8038",1525,1228,1220,2,8,"ERC-SOBIRAN",487
8,"8222",1819,1484,1476,11,8,"ERC-SOBIRAN",553
25,"25149",1378,1108,1102,3,6,"ERC-SOBIRAN",384
25,"25905",369,308,307,1,1,"ERC-SOBIRAN",112
43,"43152",434,357,356,0,1,"ERC-SOBIRAN",156
17,"17135",395,309,307,0,2,"ERC-SOBIRAN",131
43,"43077",455,342,339,2,3,"ERC-SOBIRAN",95
8,"8270",18837,14541,14497,66,44,"ERC-SOBIRAN",3714
8,"8113",52518,39750,39592,198,158,"ERC-SOBIRAN",12191
8,"8183",4563,3628,3613,9,15,"ERC-SOBIRAN",1399
43,"43155",22619,16724,16624,101,100,"ERC-SOBIRAN",5237
25,"25164",357,264,261,4,3,"ERC-SOBIRAN",99
8,"8160",316,252,247,2,5,"ERC-SOBIRAN",90
25,"25019",4646,3224,3199,22,25,"ERC-SOBIRAN",894
43,"43028",2766,2007,1988,7,19,"ERC-SOBIRAN",426
17,"17149",364,314,314,0,0,"ERC-SOBIRAN",106
8,"8019",1117818,875679,872180,4327,3499,"ERC-SOBIRAN",201760
17,"17182",272,220,220,3,0,"ERC-SOBIRAN",35
8,"8217",25355,20935,20855,110,80,"ERC-SOBIRAN",3630
43,"43035",235,205,203,7,2,"ERC-SOBIRAN",77
43,"43053",188,153,149,0,4,"ERC-SOBIRAN",58
43,"43080",227,195,195,0,0,"ERC-SOBIRAN",65
8,"8203",2472,1884,1873,4,11,"ERC-SOBIRAN",617
17,"17051",207,174,173,3,1,"ERC-SOBIRAN",52
25,"25110",2731,2121,2106,14,15,"ERC-SOBIRAN",749
17,"17123",345,304,303,4,1,"ERC-SOBIRAN",87
25,"25252",557,424,422,4,2,"ERC-SOBIRAN",154
8,"8262",6919,5090,5060,33,30,"ERC-SOBIRAN",1571
43,"43171",14705,11002,10956,62,46,"ERC-SOBIRAN",1379
43,"43010",337,286,284,2,2,"ERC-SOBIRAN",76
8,"8192",5679,4605,4589,20,16,"ERC-SOBIRAN",1701
8,"8282",6711,5696,5677,27,19,"ERC-SOBIRAN",1942
8,"8158",3108,2458,2453,13,5,"ERC-SOBIRAN",733
25,"25206",250,189,188,2,1,"ERC-SOBIRAN",102
17,"17011",651,544,544,4,0,"ERC-SOBIRAN",203
8,"8141",4573,3611,3595,26,16,"ERC-SOBIRAN",1357
43,"43092",7235,5200,5174,21,26,"ERC-SOBIRAN",1078
25,"25128",127,87,87,0,0,"ERC-SOBIRAN",33
25,"25125",389,303,300,1,3,"ERC-SOBIRAN",135
17,"17202",3813,2876,2851,8,25,"ERC-SOBIRAN",862
43,"43138",2648,1926,1896,8,30,"ERC-SOBIRAN",602
8,"8264",4535,3623,3613,13,10,"ERC-SOBIRAN",1057
43,"43123",71092,53689,53369,241,320,"ERC-SOBIRAN",12847
43,"43030",482,373,372,2,1,"ERC-SOBIRAN",140
8,"8108",5192,4204,4189,26,15,"ERC-SOBIRAN",922
8,"8110",13592,10111,10058,50,53,"ERC-SOBIRAN",2588
43,"43002",1875,1367,1348,11,19,"ERC-SOBIRAN",228
25,"25244",362,296,294,2,2,"ERC-SOBIRAN",122
43,"43100",3489,2820,2816,15,4,"ERC-SOBIRAN",597
17,"17097",199,172,170,1,2,"ERC-SOBIRAN",60
8,"8219",15629,12910,12865,58,45,"ERC-SOBIRAN",4147
8,"8265",1590,1339,1334,6,5,"ERC-SOBIRAN",592
8,"8245",77805,57956,57666,313,290,"ERC-SOBIRAN",6188
17,"17028",297,238,237,1,1,"ERC-SOBIRAN",84
8,"8025",1535,1221,1214,7,7,"ERC-SOBIRAN",412
8,"8235",3829,3176,3167,14,9,"ERC-SOBIRAN",1160
25,"25071",42,32,31,0,1,"ERC-SOBIRAN",19
43,"43052",934,765,756,2,9,"ERC-SOBIRAN",341
25,"25009",605,505,491,5,14,"ERC-SOBIRAN",192
17,"17018",494,405,402,1,3,"ERC-SOBIRAN",163
25,"25052",1562,1273,1264,3,9,"ERC-SOBIRAN",622
25,"25120",92704,68713,68361,445,352,"ERC-SOBIRAN",18204
8,"8135",6735,5445,5421,36,24,"ERC-SOBIRAN",846
17,"17170",180,147,147,2,0,"ERC-SOBIRAN",81
17,"17022",7008,5386,5354,22,32,"ERC-SOBIRAN",1910
25,"25207",6430,4899,4867,41,32,"ERC-SOBIRAN",1886
8,"8057",61,50,50,0,0,"ERC-SOBIRAN",23
43,"43017",116,98,98,1,0,"ERC-SOBIRAN",49
25,"25151",736,592,584,1,8,"ERC-SOBIRAN",209
25,"25249",176,139,138,1,1,"ERC-SOBIRAN",58
17,"17228",285,229,229,1,0,"ERC-SOBIRAN",87
17,"17160",14733,10833,10766,43,67,"ERC-SOBIRAN",2774
25,"25078",1001,807,805,5,2,"ERC-SOBIRAN",391
8,"8250",7182,5461,5421,38,40,"ERC-SOBIRAN",901
17,"17008",3594,2763,2741,16,22,"ERC-SOBIRAN",815
17,"17137",3467,2925,2912,15,13,"ERC-SOBIRAN",1260
8,"8251",5127,3972,3940,17,32,"ERC-SOBIRAN",1027
25,"25058",4358,3269,3254,7,15,"ERC-SOBIRAN",1311
8,"8292",1062,835,831,3,4,"ERC-SOBIRAN",289
17,"17224",302,233,231,2,2,"ERC-SOBIRAN",80
25,"25228",3115,2468,2459,19,9,"ERC-SOBIRAN",859
43,"43098",354,291,291,1,0,"ERC-SOBIRAN",93
43,"43906",2103,1595,1587,14,8,"ERC-SOBIRAN",465
25,"25096",888,663,661,2,2,"ERC-SOBIRAN",257
8,"8059",344,292,290,2,2,"ERC-SOBIRAN",134
25,"25139",491,390,388,3,2,"ERC-SOBIRAN",192
43,"43109",2704,1937,1922,16,15,"ERC-SOBIRAN",361
43,"43029",314,253,252,0,1,"ERC-SOBIRAN",134
25,"25088",95,85,83,0,2,"ERC-SOBIRAN",23
8,"8095",67,53,52,0,1,"ERC-SOBIRAN",24
8,"8200",62161,48645,48330,261,315,"ERC-SOBIRAN",7546
17,"17005",460,336,331,0,5,"ERC-SOBIRAN",125
17,"17195",342,296,295,3,1,"ERC-SOBIRAN",129
46,"46230",14084,10694,10599,67,95,"ERPV",16
3,"3117",377,320,313,1,7,"ERPV",0
12,"12071",1267,1021,1006,11,15,"ERPV",5
3,"3003",455,395,388,0,7,"ERPV",0
46,"46112",542,460,454,0,6,"ERPV",0
46,"46094",20691,15841,15672,88,169,"ERPV",29
46,"46182",1310,988,977,5,11,"ERPV",3
46,"46029",20423,15450,15274,100,176,"ERPV",62
3,"3024",3948,3210,3164,14,46,"ERPV",2
46,"46183",6028,4620,4534,29,86,"ERPV",6
12,"12048",249,181,175,2,6,"ERPV",1
46,"46252",128,106,106,2,0,"ERPV",0
12,"12901",3357,2693,2675,19,18,"ERPV",3
46,"46216",5252,4291,4263,23,28,"ERPV",2
46,"46051",8384,6550,6452,24,98,"ERPV",8
46,"46001",783,612,607,4,5,"ERPV",1
46,"46125",846,681,675,1,6,"ERPV",1
3,"3053",7469,5950,5865,26,85,"ERPV",18
3,"3015",12807,9782,9634,63,148,"ERPV",7
46,"46046",884,654,643,3,11,"ERPV",3
12,"12017",148,120,116,0,4,"ERPV",0
12,"12110",219,168,166,1,2,"ERPV",1
3,"3130",43,23,23,0,0,"ERPV",0
46,"46037",1109,927,918,4,9,"ERPV",0
3,"3066",41802,31046,30696,285,350,"ERPV",30
46,"46119",752,627,614,8,13,"ERPV",1
46,"46226",31,27,27,0,0,"ERPV",0
3,"3125",336,259,257,1,2,"ERPV",0
3,"3068",42,40,40,3,0,"ERPV",0
46,"46077",7344,5873,5761,49,112,"ERPV",8
12,"12133",60,53,52,1,1,"ERPV",1
3,"3903",2577,1996,1973,11,23,"ERPV",0
12,"12084",17723,13501,13281,118,220,"ERPV",19
3,"3069",3311,2356,2327,12,29,"ERPV",1
46,"46142",761,580,565,4,15,"ERPV",1
12,"12140",1140,936,922,7,14,"ERPV",1
46,"46243",124,105,104,0,1,"ERPV",0
46,"46132",2196,1877,1853,10,24,"ERPV",1
3,"3023",1379,1216,1199,6,17,"ERPV",2
12,"12055",106,85,83,2,2,"ERPV",1
3,"3093",19713,15195,14988,108,207,"ERPV",26
46,"46061",343,285,280,4,5,"ERPV",0
12,"12056",257,218,216,1,2,"ERPV",0
3,"3103",245,212,211,4,1,"ERPV",0
3,"3008",159,127,126,0,1,"ERPV",1
12,"12007",731,649,642,8,7,"ERPV",0
46,"46069",157,130,129,0,1,"ERPV",0
12,"12065",171,150,147,0,3,"ERPV",0
46,"46162",1177,954,938,4,16,"ERPV",0
46,"46076",591,497,487,0,10,"ERPV",0
46,"46045",1243,1033,1018,3,15,"ERPV",10
46,"46211",1837,1490,1462,11,28,"ERPV",4
46,"46255",3209,2415,2381,18,34,"ERPV",4
46,"46064",525,427,424,4,3,"ERPV",0
46,"46175",428,367,354,3,13,"ERPV",2
3,"3028",964,804,795,6,9,"ERPV",4
46,"46203",3544,2851,2810,21,41,"ERPV",4
46,"46031",10521,7735,7607,62,128,"ERPV",28
46,"46122",2730,2103,2071,19,32,"ERPV",15
46,"46258",2636,2100,2079,9,21,"ERPV",4
3,"3076",8736,6571,6467,40,104,"ERPV",7
12,"12020",120,107,107,0,0,"ERPV",0
3,"3138",3183,2390,2359,16,31,"ERPV",7
46,"46229",911,755,752,5,3,"ERPV",1
3,"3064",5004,3782,3736,20,46,"ERPV",4
3,"3084",497,429,429,4,0,"ERPV",0
12,"12102",521,442,434,2,8,"ERPV",0
46,"46084",1503,1225,1195,1,30,"ERPV",2
46,"46246",1042,860,838,2,22,"ERPV",3
3,"3030",563,474,466,2,8,"ERPV",1
3,"3119",17223,13244,13116,75,128,"ERPV",21
46,"46196",140,115,114,0,1,"ERPV",0
12,"12128",1362,1099,1076,9,23,"ERPV",2
3,"3054",336,277,272,2,5,"ERPV",0
46,"46108",426,346,342,1,4,"ERPV",1
46,"46105",16132,11703,11582,64,121,"ERPV",26
46,"46210",344,265,258,2,7,"ERPV",0
12,"12083",89,73,71,1,2,"ERPV",0
46,"46169",32294,24909,24676,157,233,"ERPV",20
3,"3081",1494,1163,1141,5,22,"ERPV",5
46,"46107",1849,1501,1480,5,21,"ERPV",2
46,"46138",360,305,303,2,2,"ERPV",0
46,"46155",993,785,772,2,13,"ERPV",3
46,"46102",19635,15330,15207,95,123,"ERPV",23
3,"3032",99,87,87,0,0,"ERPV",0
3,"3004",599,465,458,4,7,"ERPV",0
46,"46080",985,799,788,5,11,"ERPV",1
3,"3114",1581,1263,1237,9,26,"ERPV",2
3,"3094",9626,7206,7138,42,68,"ERPV",6
12,"12074",761,659,645,7,14,"ERPV",1
46,"46048",3509,2758,2720,11,38,"ERPV",5
46,"46025",2455,2002,1981,6,21,"ERPV",4
3,"3055",5247,4042,3991,24,51,"ERPV",0
12,"12142",145,123,121,1,2,"ERPV",1
12,"12026",835,656,639,4,17,"ERPV",2
12,"12001",1033,834,825,8,9,"ERPV",1
12,"12089",4546,3353,3304,12,49,"ERPV",24
46,"46236",937,764,755,5,9,"ERPV",0
12,"12009",17859,13054,12911,98,143,"ERPV",14
3,"3127",351,290,277,2,13,"ERPV",0
46,"46164",12073,8987,8836,63,151,"ERPV",13
12,"12098",533,446,440,4,6,"ERPV",0
46,"46141",437,367,360,5,7,"ERPV",0
3,"3007",169,145,141,0,4,"ERPV",0
46,"46121",111,96,94,2,2,"ERPV",0
46,"46250",581614,454786,451184,2675,3602,"ERPV",490
46,"46082",4958,3801,3759,21,42,"ERPV",7
3,"3033",102,87,85,0,2,"ERPV",1
46,"46261",1709,1367,1340,14,27,"ERPV",0
46,"46145",22099,16685,16499,128,186,"ERPV",41
12,"12033",1951,1528,1506,10,22,"ERPV",0
46,"46104",1891,1515,1481,17,34,"ERPV",2
12,"12036",546,428,420,9,8,"ERPV",5
46,"46017",32990,23940,23694,155,246,"ERPV",46
12,"12085",5079,3504,3459,13,45,"ERPV",12
12,"12114",194,161,160,2,1,"ERPV",0
3,"3011",8014,5870,5810,38,60,"ERPV",4
46,"46213",15504,11420,11232,124,188,"ERPV",5
3,"3038",335,275,267,1,8,"ERPV",1
46,"46060",9287,7184,7110,40,74,"ERPV",12
3,"3090",17881,13593,13437,108,156,"ERPV",24
3,"3034",1391,1107,1090,7,17,"ERPV",1
12,"12117",3545,2770,2698,11,72,"ERPV",6
12,"12058",64,56,56,0,0,"ERPV",0
46,"46039",2121,1730,1698,19,32,"ERPV",1
46,"46074",2678,2158,2135,13,23,"ERPV",2
46,"46150",1797,1275,1257,9,18,"ERPV",1
12,"12103",90,75,70,1,5,"ERPV",0
46,"46259",462,395,394,2,1,"ERPV",0
3,"3083",5487,3993,3934,28,59,"ERPV",20
12,"12112",110,97,96,1,1,"ERPV",0
12,"12053",2030,1656,1636,10,20,"ERPV",2
3,"3129",1218,994,982,5,12,"ERPV",0
3,"3131",179,147,139,0,8,"ERPV",0
3,"3901",1109,827,820,5,7,"ERPV",3
12,"12069",53,45,44,1,1,"ERPV",0
46,"46033",196,169,168,3,1,"ERPV",0
46,"46195",1982,1562,1554,2,8,"ERPV",2
3,"3016",91,77,77,1,0,"ERPV",0
46,"46154",797,645,630,1,15,"ERPV",0
46,"46245",528,430,426,2,4,"ERPV",0
12,"12129",1801,1382,1356,17,26,"ERPV",2
12,"12037",17,17,17,1,0,"ERPV",0
12,"12057",578,485,473,3,12,"ERPV",3
46,"46073",1077,867,862,10,5,"ERPV",1
3,"3099",42876,32576,32172,192,404,"ERPV",15
12,"12902",2248,1678,1653,7,25,"ERPV",4
3,"3123",7576,5900,5814,36,86,"ERPV",5
46,"46115",352,261,260,0,1,"ERPV",0
46,"46189",473,412,408,2,4,"ERPV",0
12,"12072",1082,901,889,15,12,"ERPV",0
46,"46027",932,769,755,1,14,"ERPV",2
3,"3089",9497,6952,6794,55,158,"ERPV",5
46,"46172",5412,3878,3832,18,46,"ERPV",4
12,"12138",19179,14217,14006,124,211,"ERPV",168
46,"46165",7298,5744,5697,38,47,"ERPV",8
46,"46088",150,129,127,0,2,"ERPV",0
3,"3021",5578,4720,4626,35,94,"ERPV",6
46,"46136",2619,2030,2003,24,27,"ERPV",1
3,"3048",4971,3808,3739,19,69,"ERPV",8
46,"46047",532,447,441,4,6,"ERPV",0
3,"3111",5565,4183,4149,29,34,"ERPV",2
3,"3086",166,143,143,1,0,"ERPV",1
46,"46190",50023,37273,36976,250,297,"ERPV",29
46,"46263",239,204,200,3,4,"ERPV",0
46,"46116",13608,10792,10731,76,61,"ERPV",19
46,"46156",2024,1642,1628,7,14,"ERPV",1
3,"3001",345,285,282,1,3,"ERPV",0
46,"46179",2116,1723,1678,18,45,"ERPV",2
12,"12052",539,453,439,5,14,"ERPV",2
12,"12109",653,544,533,3,11,"ERPV",0
46,"46241",389,318,313,4,5,"ERPV",2
46,"46120",1183,958,936,3,22,"ERPV",2
46,"46180",651,525,519,0,6,"ERPV",1
46,"46201",62,47,47,0,0,"ERPV",0
3,"3077",1374,1131,1114,9,17,"ERPV",1
3,"3109",2976,2375,2345,11,30,"ERPV",1
46,"46050",186,157,154,1,3,"ERPV",0
3,"3113",4342,3194,3154,23,40,"ERPV",1
12,"12043",560,460,450,2,10,"ERPV",0
46,"46063",1783,1368,1345,9,23,"ERPV",3
3,"3102",7226,5600,5516,28,84,"ERPV",22
12,"12119",137,107,104,1,3,"ERPV",1
12,"12040",118683,91285,90499,666,786,"ERPV",171
46,"46128",1581,1324,1287,2,37,"ERPV",2
46,"46003",953,828,811,5,17,"ERPV",0
46,"46219",122,105,104,0,1,"ERPV",0
46,"46232",872,714,706,3,8,"ERPV",0
46,"46091",115,99,99,0,0,"ERPV",0
3,"3071",3988,3125,3088,28,37,"ERPV",9
3,"3031",41857,28648,28362,163,286,"ERPV",24
12,"12005",8052,6056,5935,50,121,"ERPV",13
3,"3041",6093,4444,4398,13,46,"ERPV",13
46,"46251",2442,2017,1976,9,41,"ERPV",4
46,"46040",995,807,794,7,13,"ERPV",2
3,"3065",169399,128218,127256,967,962,"ERPV",113
46,"46161",1472,1200,1172,7,28,"ERPV",2
3,"3035",632,529,525,2,4,"ERPV",0
46,"46028",388,324,319,1,5,"ERPV",0
46,"46021",23977,18032,17879,125,153,"ERPV",25
46,"46129",512,408,400,4,8,"ERPV",1
3,"3122",43704,31952,31681,218,271,"ERPV",22
46,"46130",857,680,669,6,11,"ERPV",0
12,"12027",17473,12829,12683,90,146,"ERPV",105
46,"46015",7477,5857,5808,33,49,"ERPV",9
12,"12042",574,486,479,8,7,"ERPV",0
12,"12121",1044,941,915,4,26,"ERPV",2
3,"3012",1133,910,897,7,13,"ERPV",0
12,"12127",67,50,50,1,0,"ERPV",2
46,"46058",1734,1349,1325,9,24,"ERPV",9
12,"12060",430,368,365,1,3,"ERPV",1
12,"12099",586,449,434,3,15,"ERPV",6
46,"46194",15813,11654,11511,83,143,"ERPV",16
3,"3097",996,833,816,4,17,"ERPV",1
46,"46140",377,312,312,2,0,"ERPV",0
46,"46009",3140,2582,2536,14,46,"ERPV",7
46,"46043",135,119,116,1,3,"ERPV",0
46,"46013",17712,14181,14075,88,106,"ERPV",24
46,"46257",5428,4237,4190,23,47,"ERPV",10
12,"12075",107,89,87,0,2,"ERPV",0
46,"46053",537,459,457,2,2,"ERPV",1
3,"3132",515,417,414,4,3,"ERPV",1
3,"3027",172,156,153,0,3,"ERPV",1
46,"46151",757,586,579,0,7,"ERPV",2
46,"46016",1075,887,880,8,7,"ERPV",2
3,"3006",494,413,409,1,4,"ERPV",3
3,"3124",460,401,390,2,11,"ERPV",2
3,"3040",258,223,217,1,6,"ERPV",0
3,"3095",4740,3702,3657,23,45,"ERPV",14
3,"3128",4295,3007,2982,24,25,"ERPV",7
12,"12092",126,108,106,1,2,"ERPV",0
46,"46098",2403,1807,1772,8,35,"ERPV",4
3,"3047",9711,6910,6791,36,119,"ERPV",10
3,"3014",238879,176118,174768,1105,1350,"ERPV",160
46,"46081",9993,7972,7882,51,90,"ERPV",15
46,"46057",474,319,313,1,6,"ERPV",0
46,"46159",23051,17496,17359,104,137,"ERPV",22
12,"12108",438,382,379,4,3,"ERPV",0
12,"12006",174,149,149,2,0,"ERPV",0
3,"3118",2426,1741,1718,8,23,"ERPV",0
46,"46011",7523,5320,5235,28,85,"ERPV",8
46,"46903",6285,5035,4996,27,39,"ERPV",3
12,"12003",943,745,731,6,14,"ERPV",4
3,"3088",5810,4380,4313,31,67,"ERPV",5
46,"46019",8948,7150,7067,40,83,"ERPV",11
46,"46187",1304,991,982,8,9,"ERPV",0
12,"12038",156,110,109,1,1,"ERPV",0
3,"3056",8629,6838,6737,38,101,"ERPV",19
3,"3116",1159,901,884,3,17,"ERPV",1
12,"12070",499,434,430,3,4,"ERPV",1
3,"3073",222,200,196,3,4,"ERPV",1
46,"46065",1576,1246,1228,6,18,"ERPV",3
12,"12125",222,189,187,0,2,"ERPV",0
3,"3080",1328,1077,1064,4,13,"ERPV",0
3,"3036",86,77,75,2,2,"ERPV",0
46,"46059",1240,1038,1030,3,8,"ERPV",8
46,"46171",16429,12527,12373,61,154,"ERPV",24
46,"46222",394,325,324,1,1,"ERPV",1
46,"46100",281,210,205,0,5,"ERPV",0
46,"46225",348,279,273,2,6,"ERPV",3
12,"12132",484,415,412,4,3,"ERPV",2
46,"46103",1338,1056,1042,5,14,"ERPV",4
46,"46249",9159,7113,7012,73,101,"ERPV",1
46,"46215",1397,1104,1093,12,11,"ERPV",15
12,"12021",4377,3528,3473,23,55,"ERPV",2
12,"12014",167,131,127,1,4,"ERPV",1
46,"46168",1982,1543,1522,5,21,"ERPV",1
46,"46242",330,279,279,0,0,"ERPV",0
12,"12078",333,238,235,1,3,"ERPV",1
46,"46178",4943,3684,3641,21,43,"ERPV",3
3,"3018",12439,9387,9283,50,104,"ERPV",16
46,"46118",3670,2930,2894,25,36,"ERPV",2
12,"12139",302,219,217,3,2,"ERPV",4
3,"3017",379,321,311,1,10,"ERPV",1
3,"3067",93,87,87,0,0,"ERPV",1
12,"12051",448,324,319,2,5,"ERPV",1
12,"12073",132,110,107,1,3,"ERPV",0
3,"3100",496,402,395,2,7,"ERPV",2
12,"12093",165,128,126,0,2,"ERPV",6
3,"3107",2769,2011,1986,10,25,"ERPV",6
46,"46200",1848,1560,1539,6,21,"ERPV",2
3,"3115",255,222,221,2,1,"ERPV",0
3,"3045",213,178,173,4,5,"ERPV",2
3,"3026",1316,1040,1024,5,16,"ERPV",0
3,"3046",1619,1213,1190,17,23,"ERPV",1
3,"3002",3631,2841,2801,16,40,"ERPV",2
46,"46247",961,695,687,3,8,"ERPV",1
46,"46146",1641,1314,1281,11,33,"ERPV",5
3,"3075",149,125,125,0,0,"ERPV",0
3,"3050",19334,14377,14253,71,124,"ERPV",27
12,"12124",1840,1477,1460,8,17,"ERPV",2
46,"46904",805,643,628,13,15,"ERPV",3
46,"46177",4778,3767,3711,17,56,"ERPV",14
46,"46191",1949,1541,1505,7,36,"ERPV",0
12,"12045",328,275,271,2,4,"ERPV",3
12,"12004",4177,3225,3187,13,38,"ERPV",9
46,"46231",2401,1780,1770,8,10,"ERPV",4
3,"3904",1420,1112,1095,5,17,"ERPV",0
12,"12010",237,203,198,1,5,"ERPV",1
12,"12064",80,75,73,1,2,"ERPV",0
46,"46066",1285,1058,1043,6,15,"ERPV",5
12,"12008",224,197,194,1,3,"ERPV",1
12,"12101",356,297,289,2,8,"ERPV",3
12,"12113",87,65,64,0,1,"ERPV",0
46,"46144",628,511,505,1,6,"ERPV",0
12,"12122",767,655,646,3,9,"ERPV",1
46,"46030",796,653,633,7,20,"ERPV",0
46,"46070",17700,13558,13437,115,121,"ERPV",14
3,"3106",564,485,479,4,6,"ERPV",0
46,"46223",7781,6057,5995,42,62,"ERPV",6
46,"46041",327,251,250,2,1,"ERPV",0
12,"12095",950,763,756,9,7,"ERPV",2
3,"3044",4557,3650,3600,17,50,"ERPV",2
46,"46148",1509,1208,1195,7,13,"ERPV",2
46,"46239",453,372,366,2,6,"ERPV",0
12,"12120",161,138,138,0,0,"ERPV",0
12,"12018",283,242,235,0,7,"ERPV",1
12,"12022",328,273,269,1,4,"ERPV",0
12,"12044",452,403,400,4,3,"ERPV",2
3,"3022",137,122,119,0,3,"ERPV",0
12,"12024",133,117,117,0,0,"ERPV",0
12,"12049",421,339,329,2,10,"ERPV",2
3,"3091",241,201,196,0,5,"ERPV",0
12,"12063",44,37,37,1,0,"ERPV",0
46,"46143",4230,3255,3200,20,55,"ERPV",4
46,"46079",313,252,248,1,4,"ERPV",0
12,"12111",334,283,279,4,4,"ERPV",1
46,"46237",7148,5537,5472,36,65,"ERPV",7
46,"46227",888,708,693,6,15,"ERPV",4
46,"46012",929,727,707,3,20,"ERPV",0
3,"3098",518,412,400,1,12,"ERPV",2
12,"12131",59,50,50,0,0,"ERPV",0
46,"46170",3408,2769,2720,16,49,"ERPV",2
46,"46131",49504,37495,37064,259,431,"ERPV",66
12,"12068",41,26,25,1,1,"ERPV",0
12,"12104",6814,5486,5406,35,80,"ERPV",4
46,"46134",2380,1836,1825,5,11,"ERPV",2
46,"46160",1907,1508,1485,5,23,"ERPV",2
3,"3037",341,289,284,1,5,"ERPV",0
12,"12141",92,81,81,0,0,"ERPV",0
12,"12025",121,102,99,0,3,"ERPV",1
46,"46157",2960,2329,2296,12,33,"ERPV",3
3,"3092",6688,5444,5370,36,74,"ERPV",15
3,"3010",336,295,280,0,15,"ERPV",1
3,"3135",192,157,155,0,2,"ERPV",3
46,"46254",943,751,734,4,17,"ERPV",0
3,"3110",312,271,269,1,2,"ERPV",1
3,"3902",10578,7654,7530,56,124,"ERPV",8
3,"3096",5779,4433,4352,30,81,"ERPV",6
3,"3057",177,148,147,0,1,"ERPV",0
46,"46209",1901,1517,1500,5,17,"ERPV",2
12,"12011",4582,3511,3431,27,80,"ERPV",7
46,"46902",356,300,296,8,4,"ERPV",1
3,"3051",344,312,307,2,5,"ERPV",2
12,"12130",420,345,341,0,4,"ERPV",0
46,"46038",307,243,241,0,2,"ERPV",0
3,"3085",269,243,237,0,6,"ERPV",0
12,"12123",43,35,34,1,1,"ERPV",0
46,"46109",6174,4763,4639,30,124,"ERPV",3
3,"3140",26027,19805,19438,230,367,"ERPV",19
46,"46126",5574,4565,4528,25,37,"ERPV",9
46,"46234",327,264,263,5,1,"ERPV",0
12,"12118",76,64,63,0,1,"ERPV",0
12,"12115",208,170,167,1,3,"ERPV",1
12,"12012",2613,2217,2180,6,37,"ERPV",3
3,"3136",410,329,323,3,6,"ERPV",1
46,"46085",11075,8106,8011,54,95,"ERPV",24
46,"46173",1319,1084,1062,6,22,"ERPV",0
12,"12097",65,54,54,1,0,"ERPV",0
3,"3049",12143,9418,9302,47,116,"ERPV",7
46,"46092",263,182,179,1,3,"ERPV",0
3,"3120",2421,1823,1786,9,37,"ERPV",1
46,"46184",26453,21076,20810,172,266,"ERPV",45
46,"46221",345,294,294,0,0,"ERPV",0
12,"12134",135,102,100,0,2,"ERPV",0
46,"46110",21317,15839,15699,89,140,"ERPV",16
12,"12116",67,57,57,0,0,"ERPV",0
12,"12028",12955,10391,10301,68,90,"ERPV",9
46,"46067",1744,1451,1432,4,19,"ERPV",1
46,"46147",17133,12260,12120,59,140,"ERPV",13
46,"46198",871,707,693,4,14,"ERPV",0
46,"46114",574,457,452,1,5,"ERPV",1
46,"46248",4886,3672,3613,25,59,"ERPV",3
46,"46202",17660,13782,13645,93,137,"ERPV",27
12,"12107",351,312,306,1,6,"ERPV",1
46,"46185",364,315,310,1,5,"ERPV",1
46,"46099",772,620,614,1,6,"ERPV",0
3,"3078",474,372,371,2,1,"ERPV",0
46,"46260",2647,2136,2113,8,23,"ERPV",4
46,"46111",11326,8603,8492,55,111,"ERPV",12
12,"12050",1230,987,972,10,15,"ERPV",1
46,"46240",206,175,169,2,6,"ERPV",1
46,"46139",4512,3612,3567,25,45,"ERPV",4
46,"46152",87,69,69,0,0,"ERPV",0
3,"3052",967,805,790,4,15,"ERPV",0
3,"3139",23061,16378,16178,128,200,"ERPV",42
3,"3058",4967,4031,3967,24,64,"ERPV",3
3,"3019",15465,12156,11988,80,168,"ERPV",11
3,"3042",1462,1025,1008,3,17,"ERPV",3
12,"12031",3942,2976,2931,24,45,"ERPV",3
12,"12080",1900,1604,1575,10,29,"ERPV",8
3,"3043",2899,2466,2434,21,32,"ERPV",5
46,"46089",2170,1692,1672,6,20,"ERPV",2
46,"46024",444,339,335,1,4,"ERPV",0
46,"46214",16415,12723,12610,74,113,"ERPV",21
3,"3133",41499,26593,26308,151,285,"ERPV",30
46,"46042",3348,2825,2774,11,51,"ERPV",3
46,"46008",2624,2036,1996,9,40,"ERPV",7
12,"12032",23649,17680,17505,118,175,"ERPV",40
3,"3070",2106,1554,1528,9,26,"ERPV",1
46,"46083",15374,11259,11096,56,163,"ERPV",24
3,"3059",20590,15909,15766,96,143,"ERPV",56
46,"46049",268,231,228,1,3,"ERPV",0
46,"46010",950,727,718,6,9,"ERPV",1
46,"46253",114,85,85,2,0,"ERPV",0
46,"46090",1633,1413,1392,5,21,"ERPV",0
46,"46188",693,591,585,3,6,"ERPV",1
46,"46218",1031,907,885,6,22,"ERPV",3
46,"46086",80,69,69,0,0,"ERPV",0
46,"46023",328,277,269,1,8,"ERPV",0
3,"3005",7903,6247,6195,37,52,"ERPV",4
3,"3029",244,174,167,1,7,"ERPV",1
12,"12105",816,639,625,5,14,"ERPV",0
3,"3121",21787,15670,15453,81,217,"ERPV",19
46,"46071",470,382,366,0,16,"ERPV",1
46,"46166",8202,6482,6399,39,83,"ERPV",6
12,"12061",380,277,274,2,3,"ERPV",3
46,"46186",19529,15294,15125,69,169,"ERPV",8
46,"46044",4198,3399,3337,13,62,"ERPV",1
12,"12126",24347,19023,18749,152,274,"ERPV",29
3,"3082",12936,9025,8931,57,94,"ERPV",25
3,"3062",221,182,180,1,2,"ERPV",0
46,"46217",893,733,723,6,10,"ERPV",0
46,"46174",949,789,770,4,19,"ERPV",2
46,"46093",2134,1700,1687,8,13,"ERPV",1
3,"3025",1292,1009,991,7,18,"ERPV",0
46,"46207",6686,5220,5137,36,83,"ERPV",5
46,"46055",1284,1031,1021,2,10,"ERPV",6
46,"46181",16908,12749,12597,82,152,"ERPV",25
46,"46020",3792,3028,2973,11,55,"ERPV",3
12,"12100",1281,1118,1102,5,16,"ERPV",5
12,"12136",2606,2262,2223,17,39,"ERPV",3
3,"3039",89,70,70,0,0,"ERPV",1
46,"46153",435,364,356,1,8,"ERPV",0
46,"46193",8964,7206,7156,27,50,"ERPV",7
46,"46235",21270,15754,15592,101,162,"ERPV",82
12,"12094",875,694,682,2,12,"ERPV",4
46,"46212",1590,1209,1192,4,17,"ERPV",2
46,"46208",1070,875,866,2,9,"ERPV",2
12,"12076",76,64,64,1,0,"ERPV",2
46,"46075",147,136,134,2,2,"ERPV",0
12,"12137",37,27,27,0,0,"ERPV",0
3,"3074",1750,1433,1427,3,6,"ERPV",0
46,"46056",175,156,156,3,0,"ERPV",0
3,"3013",1070,882,869,3,13,"ERPV",1
46,"46026",1202,1012,997,1,15,"ERPV",0
46,"46006",4468,3731,3683,22,48,"ERPV",6
46,"46176",2045,1450,1434,12,16,"ERPV",4
46,"46205",14233,11274,11145,55,129,"ERPV",24
46,"46106",1466,1156,1142,3,14,"ERPV",4
46,"46192",790,599,586,8,13,"ERPV",1
12,"12002",115,99,97,0,2,"ERPV",1
46,"46149",344,260,256,2,4,"ERPV",0
12,"12046",182,161,161,1,0,"ERPV",0
46,"46101",816,696,687,3,9,"ERPV",0
46,"46158",1040,805,796,4,9,"ERPV",0
12,"12029",673,566,556,3,10,"ERPV",5
12,"12041",100,76,75,0,1,"ERPV",0
46,"46078",28394,20928,20748,156,180,"ERPV",24
46,"46135",9827,7928,7883,44,45,"ERPV",6
12,"12087",25,19,18,2,1,"ERPV",0
46,"46097",958,764,756,6,8,"ERPV",0
46,"46036",558,391,379,2,12,"ERPV",1
46,"46197",1926,1473,1455,9,18,"ERPV",9
46,"46262",213,170,165,1,5,"ERPV",0
3,"3101",4911,3827,3772,20,55,"ERPV",22
12,"12090",104,85,83,1,2,"ERPV",0
46,"46004",1919,1641,1616,14,25,"ERPV",1
12,"12091",176,131,130,0,1,"ERPV",0
46,"46035",6855,5500,5422,34,78,"ERPV",11
3,"3072",348,297,295,2,2,"ERPV",1
12,"12034",1400,1108,1080,7,28,"ERPV",11
46,"46032",5692,4518,4476,22,42,"ERPV",8
46,"46062",4572,3571,3510,20,61,"ERPV",7
12,"12079",419,346,336,2,10,"ERPV",1
46,"46054",11390,8717,8604,52,113,"ERPV",15
46,"46256",7211,5263,5209,27,54,"ERPV",6
46,"46124",785,680,675,5,5,"ERPV",0
46,"46005",23013,17487,17286,112,201,"ERPV",17
46,"46127",2740,2174,2147,11,27,"ERPV",3
12,"12106",1163,980,951,7,29,"ERPV",0
3,"3061",1054,830,816,3,14,"ERPV",2
12,"12039",792,688,680,3,8,"ERPV",0
46,"46228",2417,1953,1913,13,40,"ERPV",1
3,"3105",5471,4099,4003,14,96,"ERPV",5
46,"46224",154,124,124,2,0,"ERPV",0
12,"12082",9573,7672,7570,55,102,"ERPV",8
46,"46123",1948,1469,1446,5,23,"ERPV",4
12,"12088",57,54,54,0,0,"ERPV",0
46,"46018",567,483,479,3,4,"ERPV",0
46,"46137",242,200,200,3,0,"ERPV",1
3,"3060",106,84,84,0,0,"ERPV",0
46,"46068",345,308,307,4,1,"ERPV",1
46,"46220",48968,35430,34964,306,466,"ERPV",84
46,"46238",13105,9717,9610,57,107,"ERPV",24
46,"46117",500,407,399,1,8,"ERPV",1
46,"46087",109,98,98,1,0,"ERPV",0
46,"46199",5842,4451,4414,23,37,"ERPV",4
12,"12013",137,113,113,0,0,"ERPV",1
46,"46022",15325,11197,11072,70,125,"ERPV",12
46,"46167",345,255,255,0,0,"ERPV",1
3,"3020",95,84,84,2,0,"ERPV",0
3,"3104",27091,21366,21119,250,247,"ERPV",20
46,"46014",3130,2488,2462,7,26,"ERPV",9
3,"3009",46121,36093,35720,235,373,"ERPV",98
46,"46204",6657,5262,5204,27,58,"ERPV",12
12,"12081",602,488,481,0,7,"ERPV",1
3,"3137",657,484,480,5,4,"ERPV",3
46,"46007",12284,9370,9265,65,105,"ERPV",12
46,"46096",257,220,217,0,3,"ERPV",1
46,"46163",1856,1522,1501,4,21,"ERPV",6
46,"46206",557,461,455,6,6,"ERPV",0
46,"46002",1215,963,959,5,4,"ERPV",1
12,"12059",228,191,188,0,3,"ERPV",1
12,"12077",4790,3594,3565,39,29,"ERPV",3
46,"46113",2527,1906,1892,12,14,"ERPV",5
46,"46052",508,436,426,3,10,"ERPV",0
46,"46233",3781,2901,2847,22,54,"ERPV",5
3,"3063",27121,19869,19713,131,156,"ERPV",40
12,"12096",744,588,580,7,8,"ERPV",10
12,"12016",1550,1281,1260,11,21,"ERPV",0
46,"46095",578,467,458,1,9,"ERPV",0
3,"3112",637,526,520,0,6,"ERPV",0
46,"46034",1811,1407,1389,13,18,"ERPV",2
3,"3079",18403,14632,14382,114,250,"ERPV",20
46,"46133",472,374,374,2,0,"ERPV",0
46,"46072",3542,3008,2961,33,47,"ERPV",13
12,"12015",114,99,98,0,1,"ERPV",2
12,"12067",523,423,416,1,7,"ERPV",0
46,"46244",59626,44018,43679,342,339,"ERPV",25
12,"12135",36194,27266,26961,192,305,"ERPV",52
3,"3134",141,119,117,0,2,"ERPV",0
38,"38032",13536,9924,9867,63,57,"F8",16
38,"38016",1178,654,648,6,6,"F8",0
38,"38002",972,678,640,3,38,"F8",4
38,"38047",1756,1276,1259,6,17,"F8",0
38,"38007",1625,1124,1104,2,20,"F8",0
38,"38019",13758,8870,8776,46,94,"F8",10
38,"38022",18629,12903,12759,84,144,"F8",13
38,"38040",5446,3513,3462,13,51,"F8",1
38,"38010",3974,2814,2777,20,37,"F8",2
38,"38005",5666,3795,3761,24,34,"F8",3
38,"38023",125528,88323,87456,598,867,"F8",107
38,"38017",30646,18576,18373,100,203,"F8",26
38,"38030",1945,1430,1420,6,10,"F8",1
38,"38049",2683,1781,1743,18,38,"F8",3
38,"38050",2436,1564,1529,12,35,"F8",0
38,"38018",4455,3242,3198,24,44,"F8",4
38,"38006",41302,23632,23415,133,217,"F8",32
38,"38031",29154,22871,22598,143,273,"F8",21
38,"38901",1456,1024,1010,9,14,"F8",2
38,"38034",3998,3033,2993,19,40,"F8",2
38,"38001",20907,12323,12197,70,126,"F8",8
38,"38052",1280,893,887,4,6,"F8",1
38,"38036",6831,4947,4829,58,118,"F8",10
38,"38051",7326,5418,5352,27,66,"F8",3
38,"38035",10384,6657,6596,50,61,"F8",5
38,"38011",21563,15380,15214,69,166,"F8",20
38,"38014",1341,991,981,6,10,"F8",1
38,"38044",2199,1443,1429,10,14,"F8",0
38,"38045",3549,2149,2109,6,40,"F8",1
38,"38013",3019,2023,1991,12,32,"F8",2
38,"38046",9271,7297,7212,53,85,"F8",12
38,"38048",3957,2889,2842,12,47,"F8",2
38,"38008",5658,4126,4056,19,70,"F8",6
38,"38027",5545,3937,3896,22,41,"F8",1
38,"38020",15899,11057,10924,90,133,"F8",10
38,"38043",19265,14000,13856,115,144,"F8",14
38,"38012",2310,1705,1687,6,18,"F8",1
38,"38026",33514,26298,26076,191,222,"F8",18
38,"38039",11112,8233,8161,54,72,"F8",13
38,"38028",22035,15684,15522,86,162,"F8",8
38,"38024",15310,10234,10088,82,146,"F8",12
38,"38042",3781,2799,2774,11,25,"F8",2
38,"38037",12803,8628,8517,48,111,"F8",6
38,"38038",164468,112475,111577,728,898,"F8",145
38,"38003",1510,1058,1047,4,11,"F8",3
38,"38009",4299,3105,3069,16,36,"F8",4
38,"38033",3594,2512,2467,11,45,"F8",0
38,"38053",3763,2628,2588,21,40,"F8",0
38,"38029",1493,839,823,5,16,"F8",2
38,"38004",4490,3242,3202,18,40,"F8",5
38,"38041",6970,5288,5258,38,30,"F8",6
38,"38015",4067,2951,2926,22,25,"F8",0
38,"38021",1599,1079,1057,8,22,"F8",0
38,"38025",7088,5166,5089,39,77,"F8",3
34,"34170",51,35,35,0,0,"FE de las J",0
47,"47089",132,116,115,1,1,"FE de las J",0
47,"47186",244448,197042,195276,1561,1766,"FE de las J",126
5,"5002",1890,1497,1468,8,29,"FE de las J",3
34,"34108",502,424,415,6,9,"FE de las J",0
5,"5156",234,153,151,0,2,"FE de las J",0
47,"47211",48,43,43,1,0,"FE de las J",0
5,"5038",113,89,88,0,1,"FE de las J",0
34,"34112",39,30,30,0,0,"FE de las J",0
47,"47205",355,263,258,3,5,"FE de las J",0
5,"5254",181,155,153,0,2,"FE de las J",1
47,"47022",59,56,54,1,2,"FE de las J",0
34,"34019",110,92,91,2,1,"FE de las J",0
34,"34024",25,17,16,1,1,"FE de las J",0
12,"12901",3357,2693,2675,19,18,"FE de las J",1
5,"5228",167,124,124,0,0,"FE de las J",0
47,"47146",278,232,230,3,2,"FE de las J",0
47,"47110",438,352,347,4,5,"FE de las J",0
34,"34174",178,150,149,2,1,"FE de las J",0
34,"34175",87,67,66,0,1,"FE de las J",0
12,"12043",560,460,450,2,10,"FE de las J",0
47,"47042",50,41,39,0,2,"FE de las J",0
47,"47227",55,46,46,0,0,"FE de las J",0
34,"34089",140,119,114,2,5,"FE de las J",0
5,"5077",158,133,131,1,2,"FE de las J",0
47,"47176",202,138,138,1,0,"FE de las J",0
5,"5176",223,173,166,2,7,"FE de las J",0
34,"34158",286,194,194,0,0,"FE de las J",0
5,"5159",228,160,159,2,1,"FE de las J",0
5,"5257",135,104,104,0,0,"FE de las J",1
5,"5073",289,239,238,0,1,"FE de las J",0
47,"47138",219,182,177,1,5,"FE de las J",0
5,"5183",123,104,96,0,8,"FE de las J",0
47,"47165",6822,5456,5296,62,160,"FE de las J",1
12,"12130",420,345,341,0,4,"FE de las J",0
12,"12135",36194,27266,26961,192,305,"FE de las J",27
5,"5015",68,48,48,1,0,"FE de las J",0
5,"5007",110,81,80,2,1,"FE de las J",1
5,"5059",92,63,63,0,0,"FE de las J",1
34,"34134",40,31,31,1,0,"FE de las J",0
47,"47231",4458,3677,3651,47,26,"FE de las J",3
5,"5135",398,324,320,2,4,"FE de las J",0
5,"5124",92,71,70,1,1,"FE de las J",0
34,"34047",1738,1439,1420,8,19,"FE de las J",0
47,"47122",2016,1655,1617,15,38,"FE de las J",2
47,"47115",276,231,223,1,8,"FE de las J",0
12,"12118",76,64,63,0,1,"FE de las J",0
5,"5089",455,354,340,1,14,"FE de las J",0
5,"5049",410,310,305,3,5,"FE de las J",2
34,"34124",63,58,58,0,0,"FE de las J",0
34,"34146",53,47,46,0,1,"FE de las J",0
5,"5200",40,27,26,0,1,"FE de las J",0
47,"47168",30,29,29,0,0,"FE de las J",0
34,"34133",105,88,86,1,2,"FE de las J",0
47,"47019",91,74,73,0,1,"FE de las J",0
47,"47067",153,119,119,3,0,"FE de las J",0
5,"5026",187,163,159,1,4,"FE de las J",1
34,"34072",143,130,128,1,2,"FE de las J",0
47,"47004",1136,950,939,5,11,"FE de las J",0
5,"5216",213,166,165,0,1,"FE de las J",0
34,"34208",47,38,38,0,0,"FE de las J",0
12,"12136",2606,2262,2223,17,39,"FE de las J",1
47,"47179",373,275,273,1,2,"FE de las J",0
47,"47204",235,182,178,0,4,"FE de las J",1
5,"5214",27,22,22,0,0,"FE de las J",0
5,"5117",193,169,167,0,2,"FE de las J",0
34,"34206",814,668,660,13,8,"FE de las J",0
5,"5151",80,64,64,1,0,"FE de las J",0
5,"5101",277,224,222,0,2,"FE de las J",0
34,"34157",2364,1881,1846,13,35,"FE de las J",1
12,"12114",194,161,160,2,1,"FE de las J",0
5,"5241",3041,2242,2204,24,38,"FE de las J",4
34,"34053",200,176,171,5,5,"FE de las J",0
12,"12026",835,656,639,4,17,"FE de las J",1
47,"47169",61,53,53,0,0,"FE de las J",0
5,"5134",49,41,40,0,1,"FE de las J",0
47,"47216",114,102,98,0,4,"FE de las J",0
5,"5232",106,87,84,1,3,"FE de las J",0
47,"47101",1644,1354,1337,9,17,"FE de las J",0
34,"34042",292,244,243,3,1,"FE de las J",2
12,"12055",106,85,83,2,2,"FE de las J",0
5,"5097",476,332,327,0,5,"FE de las J",1
5,"5140",106,91,89,0,2,"FE de las J",0
5,"5021",1871,1469,1440,15,29,"FE de las J",2
34,"34076",545,475,473,2,2,"FE de las J",1
34,"34061",96,77,77,2,0,"FE de las J",0
47,"47194",292,245,243,1,2,"FE de las J",0
47,"47147",102,85,85,0,0,"FE de las J",0
47,"47038",101,79,79,0,0,"FE de las J",0
47,"47084",1101,880,871,7,9,"FE de las J",0
47,"47149",45,39,39,1,0,"FE de las J",0
47,"47185",87,77,77,0,0,"FE de las J",0
34,"34059",402,326,320,3,6,"FE de las J",1
12,"12075",107,89,87,0,2,"FE de las J",0
5,"5189",396,325,321,1,4,"FE de las J",0
12,"12021",4377,3528,3473,23,55,"FE de las J",3
47,"47097",307,258,256,4,2,"FE de las J",0
12,"12008",224,197,194,1,3,"FE de las J",0
47,"47199",71,59,59,3,0,"FE de las J",0
47,"47010",14572,12316,12186,102,130,"FE de las J",8
5,"5158",345,279,274,2,5,"FE de las J",0
5,"5180",82,61,60,0,1,"FE de las J",0
5,"5088",29,23,23,0,0,"FE de las J",0
34,"34137",24,23,22,2,1,"FE de las J",0
5,"5148",23,17,17,0,0,"FE de las J",0
47,"47063",89,71,71,0,0,"FE de las J",0
47,"47192",94,82,81,2,1,"FE de las J",0
34,"34091",122,103,102,4,1,"FE de las J",0
12,"12044",452,403,400,4,3,"FE de las J",0
12,"12072",1082,901,889,15,12,"FE de las J",1
5,"5112",95,66,64,2,2,"FE de las J",0
5,"5207",645,543,540,3,3,"FE de las J",0
5,"5267",107,71,70,3,1,"FE de las J",0
5,"5086",76,64,61,0,3,"FE de las J",0
12,"12074",761,659,645,7,14,"FE de las J",0
34,"34232",735,595,584,8,11,"FE de las J",1
47,"47106",44,35,35,0,0,"FE de las J",0
12,"12079",419,346,336,2,10,"FE de las J",0
5,"5094",132,109,108,1,1,"FE de las J",0
5,"5904",112,81,81,3,0,"FE de las J",0
47,"47005",502,420,414,2,6,"FE de las J",1
34,"34041",84,73,72,3,1,"FE de las J",0
47,"47123",461,391,390,3,1,"FE de las J",0
47,"47068",30,23,23,0,0,"FE de las J",0
34,"34136",149,105,102,0,3,"FE de las J",0
47,"47177",100,80,79,0,1,"FE de las J",0
12,"12131",59,50,50,0,0,"FE de las J",0
5,"5005",171,142,142,2,0,"FE de las J",0
5,"5087",149,112,111,1,1,"FE de las J",0
47,"47217",1973,1569,1541,19,28,"FE de las J",3
47,"47027",2775,2246,2222,14,24,"FE de las J",2
12,"12001",1033,834,825,8,9,"FE de las J",0
34,"34048",63,54,53,2,1,"FE de las J",0
47,"47098",556,480,475,4,5,"FE de las J",1
12,"12084",17723,13501,13281,118,220,"FE de las J",14
34,"34057",462,345,330,3,15,"FE de las J",0
12,"12053",2030,1656,1636,10,20,"FE de las J",1
47,"47048",175,148,148,0,0,"FE de las J",1
5,"5136",84,64,64,2,0,"FE de las J",0
5,"5235",139,106,101,0,5,"FE de las J",0
12,"12058",64,56,56,0,0,"FE de las J",0
47,"47158",858,672,663,8,9,"FE de las J",0
5,"5172",116,95,93,0,2,"FE de las J",0
47,"47094",123,110,109,1,1,"FE de las J",0
12,"12085",5079,3504,3459,13,45,"FE de las J",6
47,"47172",135,119,119,0,0,"FE de las J",0
47,"47129",855,715,696,3,19,"FE de las J",1
5,"5167",225,181,175,1,6,"FE de las J",0
5,"5001",179,153,152,2,1,"FE de las J",0
5,"5155",46,36,36,0,0,"FE de las J",0
34,"34093",81,70,70,0,0,"FE de las J",0
34,"34904",300,220,220,0,0,"FE de las J",0
47,"47099",155,135,133,0,2,"FE de las J",0
5,"5165",370,293,285,4,8,"FE de las J",0
12,"12073",132,110,107,1,3,"FE de las J",0
5,"5043",75,62,62,0,0,"FE de las J",0
12,"12049",421,339,329,2,10,"FE de las J",0
47,"47180",57,46,46,1,0,"FE de las J",0
12,"12082",9573,7672,7570,55,102,"FE de las J",4
5,"5017",86,74,73,0,1,"FE de las J",0
34,"34185",68,53,51,1,2,"FE de las J",0
34,"34223",205,160,157,1,3,"FE de las J",0
12,"12094",875,694,682,2,12,"FE de las J",0
47,"47207",260,213,211,2,2,"FE de las J",0
34,"34032",37,34,34,1,0,"FE de las J",0
34,"34123",1637,1376,1354,8,22,"FE de las J",1
34,"34094",61,44,44,0,0,"FE de las J",0
47,"47051",321,274,272,1,2,"FE de las J",0
34,"34224",42,30,29,0,1,"FE de las J",0
34,"34171",941,702,688,9,14,"FE de las J",1
34,"34022",1019,856,849,8,7,"FE de las J",1
34,"34114",198,152,152,0,0,"FE de las J",0
47,"47069",118,96,92,1,4,"FE de las J",0
47,"47162",68,55,55,0,0,"FE de las J",1
34,"34902",123,98,98,4,0,"FE de las J",0
47,"47174",270,215,208,2,7,"FE de las J",1
12,"12098",533,446,440,4,6,"FE de las J",0
12,"12037",17,17,17,1,0,"FE de las J",0
34,"34245",310,244,240,3,4,"FE de las J",2
47,"47096",126,106,105,0,1,"FE de las J",0
47,"47214",1364,1112,1074,7,38,"FE de las J",0
34,"34129",170,134,132,2,2,"FE de las J",0
47,"47009",99,84,84,0,0,"FE de las J",0
5,"5258",107,96,96,2,0,"FE de las J",1
5,"5054",1203,946,927,5,19,"FE de las J",0
34,"34139",160,119,118,0,1,"FE de las J",0
47,"47002",18,18,18,0,0,"FE de las J",0
12,"12108",438,382,379,4,3,"FE de las J",0
34,"34213",52,42,42,0,0,"FE de las J",0
12,"12099",586,449,434,3,15,"FE de las J",1
5,"5249",96,69,69,0,0,"FE de las J",0
5,"5192",93,81,78,0,3,"FE de las J",0
47,"47036",205,162,157,1,5,"FE de las J",0
47,"47153",104,76,75,0,1,"FE de las J",0
5,"5177",139,117,117,0,0,"FE de las J",0
12,"12042",574,486,479,8,7,"FE de las J",1
47,"47037",163,134,128,2,6,"FE de las J",0
5,"5256",112,94,92,1,2,"FE de las J",1
12,"12041",100,76,75,0,1,"FE de las J",0
47,"47053",126,100,97,0,3,"FE de las J",0
5,"5107",55,43,43,2,0,"FE de las J",0
5,"5069",74,63,62,0,1,"FE de las J",0
47,"47013",90,80,78,4,2,"FE de las J",0
47,"47187",75,54,53,0,1,"FE de las J",0
34,"34238",305,261,260,2,1,"FE de las J",0
47,"47092",102,86,85,0,1,"FE de las J",0
12,"12007",731,649,642,8,7,"FE de las J",0
34,"34131",58,51,51,0,0,"FE de las J",0
5,"5105",336,272,266,2,6,"FE de las J",1
5,"5234",46,43,43,0,0,"FE de las J",0
12,"12010",237,203,198,1,5,"FE de las J",0
5,"5013",847,708,701,0,7,"FE de las J",0
47,"47066",1407,1131,1122,11,9,"FE de las J",0
5,"5058",72,52,52,0,0,"FE de las J",0
5,"5115",516,397,395,3,2,"FE de las J",0
12,"12128",1362,1099,1076,9,23,"FE de las J",2
47,"47025",114,98,98,0,0,"FE de las J",0
34,"34151",147,99,97,1,2,"FE de las J",0
12,"12110",219,168,166,1,2,"FE de las J",0
47,"47074",141,122,122,2,0,"FE de las J",0
5,"5145",47,27,27,1,0,"FE de las J",0
34,"34102",202,173,171,2,2,"FE de las J",0
12,"12107",351,312,306,1,6,"FE de las J",0
5,"5063",31,27,27,0,0,"FE de las J",0
47,"47145",586,446,440,2,6,"FE de las J",1
47,"47062",157,134,134,0,0,"FE de las J",0
5,"5215",159,126,124,0,2,"FE de las J",0
12,"12120",161,138,138,0,0,"FE de las J",0
34,"34011",386,326,321,2,5,"FE de las J",0
5,"5138",289,224,223,2,1,"FE de las J",1
34,"34012",340,271,265,2,6,"FE de las J",1
34,"34045",73,67,65,0,2,"FE de las J",0
47,"47175",6704,5296,5222,52,74,"FE de las J",1
5,"5129",116,82,76,1,6,"FE de las J",0
34,"34015",39,32,31,0,1,"FE de las J",0
34,"34031",26,24,24,0,0,"FE de las J",0
5,"5095",236,193,191,0,2,"FE de las J",0
12,"12137",37,27,27,0,0,"FE de las J",0
5,"5160",296,236,232,1,4,"FE de las J",0
5,"5019",44838,36021,35637,287,384,"FE de las J",32
12,"12102",521,442,434,2,8,"FE de las J",0
47,"47184",541,447,441,0,6,"FE de las J",1
5,"5139",66,59,59,0,0,"FE de las J",0
34,"34086",99,92,90,2,2,"FE de las J",0
5,"5126",62,53,52,0,1,"FE de las J",0
34,"34070",135,101,101,1,0,"FE de las J",0
47,"47112",2570,2098,2075,13,23,"FE de las J",1
34,"34017",889,743,738,6,5,"FE de las J",1
5,"5217",54,44,43,0,1,"FE de las J",0
47,"47132",39,33,33,0,0,"FE de las J",0
34,"34186",47,41,41,0,0,"FE de las J",0
34,"34081",60,48,48,0,0,"FE de las J",0
5,"5076",473,417,413,7,4,"FE de las J",2
47,"47018",36,31,29,0,2,"FE de las J",0
34,"34082",80,68,68,0,0,"FE de las J",1
34,"34210",103,90,90,1,0,"FE de las J",0
47,"47080",35,23,21,0,2,"FE de las J",0
5,"5191",124,105,105,0,0,"FE de las J",0
5,"5903",138,94,92,0,2,"FE de las J",0
34,"34221",170,138,136,2,2,"FE de las J",0
5,"5149",100,82,79,0,3,"FE de las J",0
47,"47221",100,84,83,1,1,"FE de las J",0
12,"12048",249,181,175,2,6,"FE de las J",0
47,"47052",6752,5665,5589,57,76,"FE de las J",6
34,"34125",79,59,58,0,1,"FE de las J",0
5,"5243",81,63,62,1,1,"FE de las J",0
34,"34079",1715,1421,1402,10,19,"FE de las J",0
47,"47114",3911,2864,2807,28,57,"FE de las J",4
34,"34063",87,77,77,1,0,"FE de las J",0
5,"5231",151,126,126,0,0,"FE de las J",0
12,"12142",145,123,121,1,2,"FE de las J",0
34,"34190",49,36,36,3,0,"FE de las J",0
34,"34152",125,104,101,0,3,"FE de las J",0
12,"12111",334,283,279,4,4,"FE de las J",0
47,"47156",150,128,128,2,0,"FE de las J",0
12,"12020",120,107,107,0,0,"FE de las J",2
34,"34104",233,190,189,1,1,"FE de las J",0
47,"47057",273,204,200,0,4,"FE de las J",1
47,"47143",110,78,78,1,0,"FE de las J",0
47,"47222",86,71,71,0,0,"FE de las J",0
34,"34009",30,26,26,0,0,"FE de las J",0
5,"5184",240,207,204,1,3,"FE de las J",0
47,"47012",101,80,80,0,0,"FE de las J",0
5,"5060",109,88,88,0,0,"FE de las J",0
34,"34036",238,199,198,1,1,"FE de las J",1
34,"34074",683,545,540,4,5,"FE de las J",3
47,"47103",255,215,214,3,1,"FE de las J",0
5,"5079",68,56,56,0,0,"FE de las J",0
47,"47071",398,345,341,2,4,"FE de las J",0
12,"12106",1163,980,951,7,29,"FE de las J",0
34,"34237",573,479,472,4,7,"FE de las J",0
5,"5047",4118,3334,3248,25,86,"FE de las J",4
47,"47127",138,92,89,1,3,"FE de las J",0
34,"34018",205,181,177,2,4,"FE de las J",0
47,"47055",192,157,154,1,3,"FE de las J",0
47,"47001",52,47,46,0,1,"FE de las J",0
5,"5209",75,58,57,0,1,"FE de las J",0
5,"5053",80,57,57,2,0,"FE de las J",1
12,"12902",2248,1678,1653,7,25,"FE de las J",0
5,"5222",152,111,109,0,2,"FE de las J",0
5,"5120",32,25,25,1,0,"FE de las J",0
5,"5072",94,86,85,1,1,"FE de las J",0
47,"47182",1335,1034,1022,6,12,"FE de las J",1
12,"12105",816,639,625,5,14,"FE de las J",0
12,"12046",182,161,161,1,0,"FE de las J",0
34,"34903",183,128,128,1,0,"FE de las J",0
5,"5188",41,36,34,0,2,"FE de las J",0
5,"5239",231,177,174,1,3,"FE de las J",1
34,"34038",268,198,197,0,1,"FE de las J",0
47,"47139",1004,790,776,2,14,"FE de las J",1
5,"5014",5291,4096,4044,29,52,"FE de las J",4
5,"5132",881,634,626,2,8,"FE de las J",0
47,"47193",1609,1347,1332,9,15,"FE de las J",0
47,"47155",3410,2694,2660,21,34,"FE de las J",4
34,"34169",381,314,309,6,5,"FE de las J",0
5,"5181",46,39,39,0,0,"FE de las J",0
47,"47006",186,153,149,1,4,"FE de las J",0
5,"5260",97,81,80,1,1,"FE de las J",1
12,"12027",17473,12829,12683,90,146,"FE de las J",6
12,"12103",90,75,70,1,5,"FE de las J",0
5,"5901",253,173,171,1,2,"FE de las J",0
47,"47016",70,62,61,0,1,"FE de las J",0
34,"34046",44,31,31,0,0,"FE de las J",0
5,"5185",90,71,70,0,1,"FE de las J",0
47,"47014",47,43,43,1,0,"FE de las J",0
34,"34126",254,220,219,3,1,"FE de las J",0
34,"34233",128,118,117,2,1,"FE de las J",1
34,"34084",155,127,126,1,1,"FE de las J",0
5,"5096",79,62,62,1,0,"FE de las J",0
5,"5226",65,52,52,0,0,"FE de las J",0
47,"47198",66,47,47,0,0,"FE de las J",0
5,"5204",583,486,482,4,4,"FE de las J",0
34,"34067",129,87,87,0,0,"FE de las J",0
5,"5195",206,157,157,0,0,"FE de las J",0
34,"34033",17,15,15,0,0,"FE de las J",0
47,"47161",3945,3370,3344,20,26,"FE de las J",1
5,"5110",706,550,546,4,4,"FE de las J",0
5,"5253",78,62,60,0,2,"FE de las J",0
5,"5187",1728,1394,1364,7,30,"FE de las J",1
5,"5175",149,122,119,1,3,"FE de las J",0
47,"47065",817,658,653,2,5,"FE de las J",0
12,"12117",3545,2770,2698,11,72,"FE de las J",1
5,"5041",995,776,767,3,9,"FE de las J",0
12,"12069",53,45,44,1,1,"FE de las J",0
34,"34121",183,155,151,1,4,"FE de las J",0
5,"5141",95,82,82,0,0,"FE de las J",0
47,"47196",28,24,24,0,0,"FE de las J",0
12,"12113",87,65,64,0,1,"FE de las J",0
34,"34182",753,609,604,6,5,"FE de las J",0
34,"34234",68,59,57,0,2,"FE de las J",0
5,"5163",1705,1360,1345,4,15,"FE de las J",0
12,"12051",448,324,319,2,5,"FE de las J",0
47,"47081",41,36,36,0,0,"FE de las J",0
12,"12101",356,297,289,2,8,"FE de las J",0
47,"47166",251,196,189,3,7,"FE de las J",0
34,"34184",49,39,38,0,1,"FE de las J",0
47,"47229",231,174,168,0,6,"FE de las J",0
47,"47118",149,111,108,1,3,"FE de las J",0
5,"5100",267,217,212,1,5,"FE de las J",0
47,"47190",95,81,81,1,0,"FE de las J",1
47,"47170",43,34,32,0,2,"FE de las J",0
47,"47095",41,36,34,2,2,"FE de las J",0
47,"47105",175,152,149,1,3,"FE de las J",0
5,"5229",82,67,67,1,0,"FE de las J",0
5,"5230",65,58,58,4,0,"FE de las J",0
12,"12080",1900,1604,1575,10,29,"FE de las J",0
47,"47007",4036,3261,3217,25,44,"FE de las J",5
5,"5166",160,128,123,1,5,"FE de las J",0
47,"47164",350,290,286,2,4,"FE de las J",1
47,"47173",885,708,704,7,4,"FE de las J",1
34,"34060",135,111,110,0,1,"FE de las J",0
5,"5247",227,182,177,1,5,"FE de las J",0
12,"12032",23649,17680,17505,118,175,"FE de las J",20
47,"47031",196,155,155,3,0,"FE de las J",0
5,"5170",50,38,38,0,0,"FE de las J",0
5,"5036",116,100,100,0,0,"FE de las J",0
47,"47090",2435,1956,1921,12,35,"FE de las J",1
34,"34156",50,43,43,0,0,"FE de las J",0
5,"5127",608,499,496,0,3,"FE de las J",0
47,"47133",2776,2317,2292,28,25,"FE de las J",2
5,"5179",199,181,175,0,6,"FE de las J",0
5,"5123",103,85,85,1,0,"FE de las J",0
47,"47151",28,22,22,0,0,"FE de las J",0
5,"5070",30,28,28,0,0,"FE de las J",0
5,"5206",29,21,20,1,1,"FE de las J",0
5,"5066",439,373,367,2,6,"FE de las J",0
12,"12029",673,566,556,3,10,"FE de las J",1
34,"34120",63965,50687,50117,471,570,"FE de las J",35
34,"34062",150,108,107,1,1,"FE de las J",2
47,"47208",56,37,37,0,0,"FE de las J",0
12,"12022",328,273,269,1,4,"FE de las J",0
5,"5116",96,77,75,0,2,"FE de las J",0
34,"34246",69,53,53,0,0,"FE de las J",0
47,"47128",56,49,46,0,3,"FE de las J",0
12,"12093",165,128,126,0,2,"FE de las J",0
12,"12003",943,745,731,6,14,"FE de las J",1
34,"34135",399,320,315,4,5,"FE de las J",0
47,"47078",159,135,131,0,4,"FE de las J",0
34,"34003",150,122,120,2,2,"FE de las J",0
34,"34122",86,68,66,0,2,"FE de las J",0
5,"5152",655,537,534,3,3,"FE de las J",0
47,"47152",68,59,59,0,0,"FE de las J",0
47,"47226",149,124,123,0,1,"FE de las J",0
5,"5034",14,12,12,0,0,"FE de las J",0
12,"12125",222,189,187,0,2,"FE de las J",0
34,"34088",264,211,207,1,4,"FE de las J",0
34,"34096",50,44,44,0,0,"FE de las J",0
12,"12067",523,423,416,1,7,"FE de las J",0
5,"5261",33,26,26,0,0,"FE de las J",0
34,"34110",82,66,65,0,1,"FE de las J",0
5,"5078",100,87,86,0,1,"FE de las J",0
12,"12083",89,73,71,1,2,"FE de las J",0
34,"34177",176,154,152,2,2,"FE de las J",1
12,"12088",57,54,54,0,0,"FE de las J",0
47,"47119",87,66,65,1,1,"FE de las J",0
34,"34023",5098,4016,3973,48,43,"FE de las J",6
5,"5040",64,51,51,1,0,"FE de las J",0
5,"5012",121,100,97,0,3,"FE de las J",0
5,"5080",44,31,29,0,2,"FE de las J",0
12,"12036",546,428,420,9,8,"FE de las J",0
5,"5171",67,57,51,1,6,"FE de las J",0
12,"12089",4546,3353,3304,12,49,"FE de las J",2
47,"47148",423,342,339,2,3,"FE de las J",0
5,"5131",95,72,71,0,1,"FE de las J",0
34,"34199",1159,910,880,7,30,"FE de las J",0
47,"47077",237,187,183,2,4,"FE de las J",0
47,"47029",50,43,43,1,0,"FE de las J",0
47,"47049",91,66,64,0,2,"FE de las J",0
47,"47015",176,136,135,0,1,"FE de las J",0
34,"34028",134,110,107,3,3,"FE de las J",0
5,"5210",79,57,57,0,0,"FE de las J",0
5,"5147",147,119,117,0,2,"FE de las J",0
5,"5085",30,27,27,0,0,"FE de las J",0
47,"47056",83,71,71,0,0,"FE de las J",0
34,"34001",39,32,32,3,0,"FE de las J",0
47,"47163",280,238,232,2,6,"FE de las J",0
5,"5008",208,168,163,1,5,"FE de las J",0
47,"47070",30,26,25,0,1,"FE de las J",0
47,"47075",4775,3849,3784,38,65,"FE de las J",5
5,"5056",94,83,83,0,0,"FE de las J",0
34,"34140",96,69,69,1,0,"FE de las J",0
5,"5173",59,52,52,0,0,"FE de las J",0
5,"5264",57,40,38,1,2,"FE de las J",0
5,"5224",100,91,90,1,1,"FE de las J",0
47,"47150",259,206,202,0,4,"FE de las J",0
34,"34228",76,62,62,0,0,"FE de las J",0
12,"12068",41,26,25,1,1,"FE de las J",0
47,"47203",58,48,48,0,0,"FE de las J",0
12,"12060",430,368,365,1,3,"FE de las J",1
5,"5225",353,300,297,2,3,"FE de las J",0
5,"5212",197,138,136,0,2,"FE de las J",1
5,"5039",48,47,47,0,0,"FE de las J",0
5,"5242",686,588,585,11,3,"FE de las J",0
47,"47021",72,63,63,0,0,"FE de las J",0
5,"5065",459,393,382,1,11,"FE de las J",2
47,"47035",902,715,707,5,8,"FE de las J",0
5,"5266",102,79,78,0,1,"FE de las J",0
5,"5238",739,589,586,1,3,"FE de las J",1
12,"12081",602,488,481,0,7,"FE de las J",1
34,"34116",55,45,45,0,0,"FE de las J",0
47,"47141",118,103,102,0,1,"FE de las J",0
12,"12129",1801,1382,1356,17,26,"FE de las J",1
47,"47087",368,292,288,3,4,"FE de las J",0
12,"12005",8052,6056,5935,50,121,"FE de las J",8
12,"12078",333,238,235,1,3,"FE de las J",0
47,"47218",979,757,745,5,12,"FE de las J",2
47,"47011",557,478,476,5,2,"FE de las J",1
34,"34205",55,44,44,0,0,"FE de las J",0
12,"12095",950,763,756,9,7,"FE de las J",1
47,"47124",388,322,319,2,3,"FE de las J",1
5,"5037",219,143,142,2,1,"FE de las J",0
12,"12009",17859,13054,12911,98,143,"FE de las J",11
47,"47113",142,117,117,1,0,"FE de las J",0
34,"34211",175,160,160,0,0,"FE de las J",0
47,"47215",48,44,44,0,0,"FE de las J",0
47,"47039",166,134,134,0,0,"FE de las J",0
34,"34073",180,149,145,2,4,"FE de las J",0
12,"12139",302,219,217,3,2,"FE de las J",0
5,"5201",499,414,407,2,7,"FE de las J",0
34,"34154",76,59,58,0,1,"FE de las J",0
34,"34201",171,139,139,0,0,"FE de las J",0
5,"5046",39,37,37,0,0,"FE de las J",0
47,"47135",82,69,67,1,2,"FE de las J",0
12,"12140",1140,936,922,7,14,"FE de las J",0
5,"5018",24,18,17,0,1,"FE de las J",0
12,"12015",114,99,98,0,1,"FE de las J",0
47,"47020",272,228,225,5,3,"FE de las J",0
34,"34155",120,104,103,0,1,"FE de las J",0
47,"47017",198,162,160,1,2,"FE de las J",1
47,"47079",54,48,48,0,0,"FE de las J",0
47,"47111",998,806,795,6,11,"FE de las J",0
5,"5190",53,47,47,1,0,"FE de las J",0
34,"34052",167,144,143,2,1,"FE de las J",0
34,"34159",370,247,244,5,3,"FE de las J",0
5,"5252",58,38,38,0,0,"FE de las J",0
34,"34215",162,143,142,3,1,"FE de las J",0
5,"5035",96,78,78,0,0,"FE de las J",0
34,"34106",113,101,101,0,0,"FE de las J",0
12,"12141",92,81,81,0,0,"FE de las J",0
47,"47144",75,63,63,1,0,"FE de las J",0
12,"12104",6814,5486,5406,35,80,"FE de las J",2
5,"5062",166,136,133,0,3,"FE de las J",0
47,"47100",119,104,102,2,2,"FE de las J",0
12,"12071",1267,1021,1006,11,15,"FE de las J",0
47,"47028",30,17,17,0,0,"FE de las J",0
47,"47104",2836,2339,2267,23,72,"FE de las J",0
5,"5084",69,46,46,0,0,"FE de las J",0
34,"34107",73,54,54,2,0,"FE de las J",0
12,"12138",19179,14217,14006,124,211,"FE de las J",7
5,"5044",250,189,189,1,0,"FE de las J",0
47,"47046",125,107,104,1,3,"FE de las J",0
47,"47195",430,335,320,2,15,"FE de las J",0
5,"5236",106,77,77,0,0,"FE de las J",0
34,"34178",119,105,104,0,1,"FE de las J",0
34,"34231",217,184,178,0,6,"FE de las J",0
47,"47026",49,40,39,0,1,"FE de las J",0
34,"34050",185,156,156,2,0,"FE de las J",0
47,"47102",264,217,211,1,6,"FE de las J",0
5,"5219",37,30,30,0,0,"FE de las J",0
34,"34035",100,84,82,1,2,"FE de las J",0
12,"12121",1044,941,915,4,26,"FE de las J",0
5,"5023",175,158,155,2,3,"FE de las J",0
5,"5108",40,28,28,0,0,"FE de las J",0
34,"34039",62,49,49,0,0,"FE de las J",0
34,"34103",97,84,81,0,3,"FE de las J",0
34,"34127",80,64,64,1,0,"FE de las J",0
34,"34066",57,52,48,1,4,"FE de las J",0
47,"47061",243,203,197,3,6,"FE de las J",0
47,"47197",867,721,717,2,4,"FE de las J",0
47,"47137",31,23,23,0,0,"FE de las J",0
5,"5220",363,312,308,5,4,"FE de las J",1
47,"47082",810,679,668,8,11,"FE de las J",1
34,"34051",91,81,79,0,2,"FE de las J",1
34,"34010",553,454,449,3,5,"FE de las J",0
34,"34004",5533,4345,4286,41,59,"FE de las J",5
34,"34149",21,18,18,0,0,"FE de las J",0
5,"5092",146,118,116,0,2,"FE de las J",0
34,"34005",792,659,645,5,14,"FE de las J",1
47,"47178",166,144,143,4,1,"FE de las J",0
34,"34143",157,125,120,1,5,"FE de las J",0
34,"34216",60,46,46,0,0,"FE de las J",0
47,"47116",403,321,320,3,1,"FE de las J",0
47,"47083",83,66,65,1,1,"FE de las J",1
34,"34196",88,74,74,4,0,"FE de las J",0
5,"5262",323,254,254,0,0,"FE de las J",0
12,"12076",76,64,64,1,0,"FE de las J",0
5,"5244",41,32,32,0,0,"FE de las J",0
12,"12033",1951,1528,1506,10,22,"FE de las J",2
12,"12002",115,99,97,0,2,"FE de las J",0
34,"34092",260,210,206,0,4,"FE de las J",0
5,"5259",106,87,87,0,0,"FE de las J",0
47,"47189",151,126,123,0,3,"FE de las J",0
34,"34240",87,65,63,3,2,"FE de las J",0
5,"5099",457,392,389,2,3,"FE de las J",2
47,"47225",74,61,60,0,1,"FE de las J",0
34,"34236",147,111,111,0,0,"FE de las J",0
12,"12018",283,242,235,0,7,"FE de las J",2
47,"47121",521,429,422,5,7,"FE de las J",0
47,"47183",139,118,118,1,0,"FE de las J",0
34,"34163",46,40,40,1,0,"FE de las J",0
47,"47040",61,45,44,0,1,"FE de las J",0
12,"12127",67,50,50,1,0,"FE de las J",1
47,"47050",3898,3084,3047,36,37,"FE de las J",2
12,"12024",133,117,117,0,0,"FE de las J",0
34,"34099",52,45,41,0,4,"FE de las J",0
47,"47030",941,759,740,3,19,"FE de las J",1
5,"5142",90,83,81,0,2,"FE de las J",0
5,"5245",348,295,290,3,5,"FE de las J",3
47,"47043",309,276,273,1,3,"FE de las J",1
34,"34147",160,125,124,1,1,"FE de las J",1
47,"47024",232,189,188,0,1,"FE de las J",0
34,"34180",64,55,55,2,0,"FE de las J",5
5,"5113",62,49,49,0,0,"FE de las J",0
5,"5169",219,176,173,1,3,"FE de las J",0
34,"34141",176,154,152,0,2,"FE de las J",1
47,"47076",17721,14605,14438,134,167,"FE de las J",14
47,"47171",384,315,311,5,4,"FE de las J",1
34,"34167",110,88,88,0,0,"FE de las J",0
5,"5030",43,36,36,0,0,"FE de las J",0
12,"12100",1281,1118,1102,5,16,"FE de las J",0
47,"47034",72,57,57,1,0,"FE de las J",0
5,"5057",2401,1949,1917,19,32,"FE de las J",2
5,"5016",6354,5090,5005,40,85,"FE de las J",2
34,"34101",45,39,38,0,1,"FE de las J",0
12,"12057",578,485,473,3,12,"FE de las J",0
5,"5119",24,16,16,1,0,"FE de las J",0
34,"34077",381,301,293,2,8,"FE de las J",0
47,"47059",97,75,75,0,0,"FE de las J",0
12,"12040",118683,91285,90499,666,786,"FE de las J",57
5,"5227",340,237,234,0,3,"FE de las J",0
47,"47109",171,130,130,1,0,"FE de las J",0
12,"12011",4582,3511,3431,27,80,"FE de las J",2
5,"5033",170,146,145,0,1,"FE de las J",1
34,"34189",53,39,39,1,0,"FE de las J",0
34,"34098",783,614,605,3,9,"FE de las J",0
34,"34006",79,73,70,3,3,"FE de las J",0
34,"34087",122,105,105,0,0,"FE de las J",0
5,"5168",3500,2774,2730,25,44,"FE de las J",0
47,"47125",51,46,45,0,1,"FE de las J",0
5,"5164",17,12,12,0,0,"FE de las J",0
34,"34179",26,20,19,0,1,"FE de las J",0
12,"12063",44,37,37,1,0,"FE de las J",0
47,"47064",37,32,29,0,3,"FE de las J",0
5,"5251",56,39,39,0,0,"FE de las J",0
47,"47033",204,167,167,2,0,"FE de las J",0
5,"5067",74,61,60,0,1,"FE de las J",0
12,"12038",156,110,109,1,1,"FE de las J",0
47,"47157",495,428,426,3,2,"FE de las J",0
47,"47206",78,64,64,0,0,"FE de las J",0
5,"5114",1264,1061,1030,3,31,"FE de las J",0
12,"12052",539,453,439,5,14,"FE de las J",0
5,"5178",345,287,283,1,4,"FE de las J",1
34,"34242",93,66,64,1,2,"FE de las J",0
12,"12109",653,544,533,3,11,"FE de las J",0
5,"5174",65,53,52,1,1,"FE de las J",0
34,"34020",51,38,38,0,0,"FE de las J",0
5,"5093",353,275,269,0,6,"FE de las J",0
5,"5182",731,494,490,6,4,"FE de las J",0
12,"12112",110,97,96,1,1,"FE de las J",0
5,"5154",34,25,25,1,0,"FE de las J",0
12,"12064",80,75,73,1,2,"FE de las J",0
47,"47058",202,154,153,3,1,"FE de las J",0
34,"34160",134,114,112,0,2,"FE de las J",0
12,"12126",24347,19023,18749,152,274,"FE de las J",11
5,"5199",37,31,31,0,0,"FE de las J",0
12,"12123",43,35,34,1,1,"FE de las J",0
5,"5061",261,214,208,0,6,"FE de las J",0
12,"12031",3942,2976,2931,24,45,"FE de las J",2
34,"34225",5001,4070,4021,48,49,"FE de las J",4
34,"34049",329,251,247,5,4,"FE de las J",1
5,"5022",1571,1295,1282,5,13,"FE de las J",2
5,"5045",80,65,65,0,0,"FE de las J",0
47,"47154",146,122,118,2,4,"FE de las J",1
12,"12014",167,131,127,1,4,"FE de las J",0
34,"34037",276,224,223,2,1,"FE de las J",2
5,"5221",323,249,244,1,5,"FE de las J",0
47,"47131",165,127,127,3,0,"FE de las J",1
47,"47088",105,90,90,0,0,"FE de las J",0
5,"5125",56,47,43,0,4,"FE de las J",0
34,"34227",72,63,61,4,2,"FE de las J",0
47,"47219",40,38,34,0,4,"FE de las J",0
34,"34192",82,68,68,0,0,"FE de las J",0
12,"12133",60,53,52,1,1,"FE de las J",0
47,"47140",110,91,90,0,1,"FE de las J",0
47,"47117",286,240,235,0,5,"FE de las J",0
34,"34100",131,100,97,1,3,"FE de las J",1
34,"34217",1251,1053,1042,7,11,"FE de las J",0
5,"5064",102,83,81,2,2,"FE de las J",1
12,"12004",4177,3225,3187,13,38,"FE de las J",2
34,"34176",127,106,104,2,2,"FE de las J",0
12,"12045",328,275,271,2,4,"FE de las J",0
34,"34214",178,141,141,1,0,"FE de las J",0
34,"34901",1071,854,847,4,7,"FE de las J",1
47,"47210",402,300,289,2,11,"FE de las J",0
5,"5237",155,131,129,1,2,"FE de las J",0
34,"34204",52,41,41,1,0,"FE de las J",0
5,"5186",1558,1255,1247,9,8,"FE de las J",1
47,"47224",97,74,74,0,0,"FE de las J",0
5,"5118",68,44,43,0,1,"FE de las J",0
34,"34229",58,42,40,1,2,"FE de las J",0
12,"12025",121,102,99,0,3,"FE de las J",0
5,"5157",235,175,174,2,1,"FE de las J",0
5,"5265",79,59,59,0,0,"FE de las J",0
12,"12028",12955,10391,10301,68,90,"FE de las J",3
34,"34243",320,260,258,1,2,"FE de las J",0
5,"5144",66,51,51,0,0,"FE de las J",0
34,"34168",45,39,39,0,0,"FE de las J",0
5,"5104",33,24,23,0,1,"FE de las J",0
12,"12132",484,415,412,4,3,"FE de las J",2
47,"47091",74,64,63,1,1,"FE de las J",0
12,"12092",126,108,106,1,2,"FE de las J",0
5,"5102",1681,1358,1329,4,29,"FE de las J",0
12,"12061",380,277,274,2,3,"FE de las J",0
5,"5218",105,82,81,0,1,"FE de las J",0
47,"47045",734,601,590,5,11,"FE de las J",0
5,"5143",62,51,51,0,0,"FE de las J",0
34,"34068",29,24,23,0,1,"FE de las J",0
5,"5211",430,364,357,6,7,"FE de las J",0
34,"34241",18,17,14,4,3,"FE de las J",0
5,"5074",665,571,565,2,6,"FE de las J",0
5,"5090",77,70,69,0,1,"FE de las J",0
5,"5042",141,117,116,0,1,"FE de las J",0
47,"47003",204,171,168,4,3,"FE de las J",0
34,"34113",40,37,37,0,0,"FE de las J",0
47,"47160",392,317,314,2,3,"FE de las J",0
5,"5055",540,448,445,1,3,"FE de las J",0
47,"47212",358,312,311,3,1,"FE de las J",1
34,"34058",185,161,161,1,0,"FE de las J",0
12,"12017",148,120,116,0,4,"FE de las J",1
34,"34025",53,37,37,2,0,"FE de las J",0
34,"34218",445,352,345,2,7,"FE de las J",0
34,"34202",28,20,20,1,0,"FE de las J",0
47,"47093",797,628,615,6,13,"FE de las J",0
47,"47230",288,236,233,1,3,"FE de las J",0
5,"5193",180,156,156,2,0,"FE de las J",0
47,"47223",152,123,120,2,3,"FE de las J",0
34,"34056",1949,1537,1511,7,26,"FE de las J",0
5,"5024",198,142,139,2,3,"FE de las J",0
47,"47181",165,143,143,0,0,"FE de las J",0
5,"5162",75,58,58,0,0,"FE de las J",0
12,"12059",228,191,188,0,3,"FE de las J",0
34,"34130",198,165,161,2,4,"FE de las J",0
5,"5025",82,70,70,0,0,"FE de las J",0
47,"47041",153,119,116,2,3,"FE de las J",0
34,"34071",161,138,138,0,0,"FE de las J",0
12,"12006",174,149,149,2,0,"FE de las J",0
47,"47228",439,353,352,1,1,"FE de las J",0
47,"47213",108,84,84,0,0,"FE de las J",0
5,"5048",106,98,94,1,4,"FE de las J",0
47,"47085",16381,12697,12540,129,157,"FE de las J",4
5,"5205",79,66,66,0,0,"FE de las J",0
47,"47142",124,94,92,0,2,"FE de las J",0
5,"5103",66,48,48,0,0,"FE de las J",0
5,"5075",99,79,79,1,0,"FE de las J",0
5,"5153",87,65,65,1,0,"FE de las J",0
12,"12077",4790,3594,3565,39,29,"FE de las J",3
47,"47126",44,42,42,1,0,"FE de las J",0
12,"12096",744,588,580,7,8,"FE de las J",0
5,"5010",145,119,118,1,1,"FE de las J",0
5,"5130",94,86,86,0,0,"FE de las J",0
47,"47060",231,198,195,4,3,"FE de las J",0
34,"34222",109,81,79,1,2,"FE de las J",0
5,"5051",162,135,131,0,4,"FE de las J",1
5,"5122",119,90,88,1,2,"FE de las J",0
47,"47023",3057,2577,2557,21,20,"FE de las J",1
5,"5121",262,201,199,0,2,"FE de las J",1
12,"12122",767,655,646,3,9,"FE de las J",0
47,"47008",22,15,15,0,0,"FE de las J",0
5,"5902",293,246,242,1,4,"FE de las J",0
47,"47191",115,85,84,0,1,"FE de las J",0
12,"12050",1230,987,972,10,15,"FE de las J",0
12,"12012",2613,2217,2180,6,37,"FE de las J",2
12,"12116",67,57,57,0,0,"FE de las J",0
5,"5240",3323,2389,2346,16,43,"FE de las J",1
34,"34029",659,557,551,5,6,"FE de las J",0
5,"5133",67,48,48,0,0,"FE de las J",0
12,"12016",1550,1281,1260,11,21,"FE de las J",2
12,"12091",176,131,130,0,1,"FE de las J",0
34,"34230",17,13,13,0,0,"FE de las J",0
5,"5263",163,121,120,0,1,"FE de las J",1
5,"5246",52,39,39,0,0,"FE de las J",0
12,"12070",499,434,430,3,4,"FE de las J",0
5,"5905",222,165,164,1,1,"FE de las J",0
47,"47209",34,25,25,0,0,"FE de las J",1
12,"12056",257,218,216,1,2,"FE de las J",0
34,"34161",22,17,16,0,1,"FE de las J",0
5,"5052",87,77,77,0,0,"FE de las J",0
47,"47032",153,121,121,1,0,"FE de las J",0
12,"12115",208,170,167,1,3,"FE de las J",0
34,"34083",1664,1244,1229,10,15,"FE de las J",2
12,"12065",171,150,147,0,3,"FE de las J",0
5,"5128",342,274,267,1,7,"FE de las J",0
5,"5029",99,69,69,0,0,"FE de las J",0
5,"5194",132,111,111,0,0,"FE de las J",0
47,"47073",116,91,89,0,2,"FE de las J",0
5,"5106",28,22,22,0,0,"FE de las J",0
34,"34027",1046,791,783,13,8,"FE de las J",0
5,"5213",95,77,75,0,2,"FE de las J",0
5,"5161",550,444,434,2,10,"FE de las J",1
34,"34181",422,324,321,3,3,"FE de las J",3
12,"12034",1400,1108,1080,7,28,"FE de las J",1
34,"34080",5291,3802,3728,35,74,"FE de las J",2
12,"12090",104,85,83,1,2,"FE de las J",0
5,"5027",260,217,211,3,6,"FE de las J",0
5,"5081",37,29,29,0,0,"FE de las J",0
47,"47134",148,127,126,6,1,"FE de las J",0
34,"34069",2184,1737,1701,16,36,"FE de las J",4
34,"34165",59,51,50,1,1,"FE de las J",0
47,"47159",831,703,693,0,10,"FE de las J",0
47,"47200",71,62,62,0,0,"FE de las J",0
47,"47130",99,76,76,2,0,"FE de las J",0
5,"5233",226,198,197,0,1,"FE de las J",0
12,"12087",25,19,18,2,1,"FE de las J",0
47,"47220",154,119,119,1,0,"FE de las J",0
5,"5197",100,84,83,0,1,"FE de las J",0
47,"47232",100,76,76,1,0,"FE de las J",0
5,"5196",57,45,42,0,3,"FE de las J",0
5,"5109",441,363,356,5,7,"FE de las J",2
12,"12119",137,107,104,1,3,"FE de las J",0
47,"47047",202,164,161,3,3,"FE de las J",0
47,"47044",323,282,279,1,3,"FE de las J",1
5,"5198",71,51,51,0,0,"FE de las J",0
47,"47188",99,77,77,0,0,"FE de las J",0
47,"47167",242,212,210,0,2,"FE de las J",0
34,"34034",115,96,95,3,1,"FE de las J",0
12,"12013",137,113,113,0,0,"FE de las J",0
34,"34055",263,214,213,3,1,"FE de las J",0
47,"47054",613,501,498,0,3,"FE de las J",0
34,"34109",63,42,41,0,1,"FE de las J",0
5,"5082",495,399,394,1,5,"FE de las J",0
12,"12134",135,102,100,0,2,"FE de las J",0
47,"47086",3823,3090,3046,24,44,"FE de las J",2
34,"34132",107,84,83,0,1,"FE de las J",0
5,"5083",141,104,103,2,1,"FE de las J",0
34,"34220",149,133,132,0,1,"FE de las J",0
12,"12097",65,54,54,1,0,"FE de las J",0
12,"12039",792,688,680,3,8,"FE de las J",1
12,"12124",1840,1477,1460,8,17,"FE de las J",0
5,"5208",38,31,31,0,0,"FE de las J",0
50,"50009",97,72,71,1,1,"FIA",0
50,"50116",170,132,131,0,1,"FIA",0
50,"50125",345,264,261,3,3,"FIA",0
50,"50152",1368,1061,1043,6,18,"FIA",0
22,"22247",30,21,21,0,0,"FIA",0
50,"50901",140,108,108,0,0,"FIA",0
22,"22904",761,581,566,2,15,"FIA",0
50,"50047",43,32,31,1,1,"FIA",0
50,"50037",127,93,93,0,0,"FIA",0
50,"50046",167,134,130,3,4,"FIA",0
50,"50078",231,173,171,0,2,"FIA",0
22,"22105",101,82,82,4,0,"FIA",0
50,"50211",237,177,173,0,4,"FIA",0
50,"50067",13788,10562,10413,107,149,"FIA",7
22,"22236",236,207,203,2,4,"FIA",0
50,"50196",102,83,81,2,2,"FIA",0
50,"50083",84,70,68,0,2,"FIA",0
50,"50136",534,416,405,2,11,"FIA",0
22,"22250",344,271,264,6,7,"FIA",0
50,"50174",83,58,58,0,0,"FIA",0
50,"50102",820,653,642,9,11,"FIA",0
22,"22068",65,46,44,1,2,"FIA",0
22,"22907",1444,1149,1137,12,12,"FIA",0
50,"50075",72,59,59,1,0,"FIA",0
50,"50015",81,61,59,1,2,"FIA",0
50,"50237",102,81,81,3,0,"FIA",0
50,"50253",382,318,315,2,3,"FIA",0
50,"50276",119,91,91,1,0,"FIA",1
22,"22156",296,246,242,3,4,"FIA",0
50,"50222",1570,1126,1105,17,21,"FIA",1
50,"50280",301,246,240,1,6,"FIA",0
50,"50168",27,20,20,0,0,"FIA",0
50,"50035",75,63,62,0,1,"FIA",0
50,"50063",61,54,54,0,0,"FIA",0
50,"50205",74,58,57,0,1,"FIA",0
50,"50140",157,108,108,0,0,"FIA",0
22,"22063",159,133,132,2,1,"FIA",0
50,"50106",127,97,96,0,1,"FIA",0
50,"50001",88,71,70,0,1,"FIA",0
22,"22193",269,220,217,2,3,"FIA",1
50,"50256",74,46,45,0,1,"FIA",0
22,"22206",182,145,145,0,0,"FIA",0
50,"50108",52,43,42,0,1,"FIA",0
50,"50198",49,43,43,1,0,"FIA",0
22,"22124",182,148,148,1,0,"FIA",0
22,"22013",275,218,217,6,1,"FIA",0
22,"22244",46,37,37,2,0,"FIA",0
22,"22067",71,52,52,0,0,"FIA",0
50,"50150",621,451,450,2,1,"FIA",1
50,"50121",277,220,218,2,2,"FIA",1
50,"50189",678,544,534,5,10,"FIA",0
50,"50137",964,790,781,9,9,"FIA",0
50,"50107",988,837,828,11,9,"FIA",1
22,"22128",192,155,154,2,1,"FIA",0
50,"50175",924,713,710,9,3,"FIA",1
22,"22254",1094,857,850,11,7,"FIA",0
22,"22066",748,576,567,6,9,"FIA",1
50,"50183",319,242,241,4,1,"FIA",0
50,"50290",358,272,266,6,6,"FIA",0
50,"50297",502835,394653,391387,3269,3266,"FIA",491
22,"22143",197,134,132,1,2,"FIA",0
22,"22189",178,143,143,0,0,"FIA",0
50,"50262",1163,930,912,15,18,"FIA",1
50,"50071",127,89,88,0,1,"FIA",0
50,"50283",69,53,52,3,1,"FIA",0
50,"50232",160,116,114,2,2,"FIA",0
22,"22103",676,520,517,6,3,"FIA",0
22,"22081",243,187,186,0,1,"FIA",0
50,"50293",392,295,293,6,2,"FIA",0
50,"50247",842,621,616,7,5,"FIA",1
22,"22249",118,93,93,2,0,"FIA",0
22,"22122",65,58,58,3,0,"FIA",0
50,"50221",32,22,22,0,0,"FIA",0
50,"50170",364,286,279,1,7,"FIA",0
50,"50180",106,84,84,1,0,"FIA",0
50,"50020",802,606,600,7,6,"FIA",0
50,"50016",44,31,31,0,0,"FIA",0
50,"50902",79,69,69,0,0,"FIA",0
22,"22225",2610,1867,1843,15,24,"FIA",1
22,"22232",87,66,65,2,1,"FIA",0
22,"22905",287,226,224,2,2,"FIA",1
50,"50122",67,55,54,0,1,"FIA",0
50,"50248",502,390,377,6,13,"FIA",0
22,"22004",124,90,88,1,2,"FIA",1
50,"50054",56,48,47,0,1,"FIA",0
22,"22085",96,82,81,0,1,"FIA",0
22,"22114",124,86,82,1,4,"FIA",0
50,"50118",2110,1622,1605,19,17,"FIA",3
22,"22059",1139,867,855,10,12,"FIA",3
50,"50161",103,80,80,0,0,"FIA",0
22,"22020",119,91,87,1,4,"FIA",0
50,"50052",85,64,64,0,0,"FIA",0
50,"50207",93,68,67,2,1,"FIA",0
50,"50267",573,440,434,7,6,"FIA",0
22,"22074",275,223,221,10,2,"FIA",0
22,"22086",209,157,155,1,2,"FIA",0
50,"50030",201,138,136,1,2,"FIA",0
22,"22908",188,133,131,0,2,"FIA",0
22,"22107",100,68,67,0,1,"FIA",1
50,"50157",286,226,220,0,6,"FIA",0
22,"22036",88,76,75,0,1,"FIA",0
22,"22901",714,521,508,3,13,"FIA",2
22,"22167",473,392,384,4,8,"FIA",0
22,"22252",118,100,99,0,1,"FIA",0
50,"50230",1134,853,846,6,7,"FIA",0
50,"50048",33,25,25,0,0,"FIA",0
50,"50110",336,268,266,1,2,"FIA",0
50,"50238",86,66,66,2,0,"FIA",0
22,"22199",6926,5113,5051,44,62,"FIA",7
50,"50146",190,152,149,0,3,"FIA",1
50,"50034",787,568,556,3,12,"FIA",0
50,"50257",163,136,134,1,2,"FIA",0
22,"22177",97,81,81,1,0,"FIA",0
50,"50181",1000,770,754,7,16,"FIA",1
50,"50159",641,527,526,8,1,"FIA",0
50,"50172",178,134,131,3,3,"FIA",0
50,"50163",3787,3041,3022,31,19,"FIA",4
50,"50261",205,171,167,1,4,"FIA",0
50,"50233",104,82,82,0,0,"FIA",0
22,"22090",85,66,66,1,0,"FIA",0
50,"50038",1405,1112,1099,13,13,"FIA",1
22,"22149",308,247,246,3,1,"FIA",0
22,"22045",73,57,56,0,1,"FIA",0
50,"50282",57,47,45,0,2,"FIA",0
22,"22110",707,531,528,2,3,"FIA",0
50,"50044",222,161,161,3,0,"FIA",0
22,"22035",226,174,174,0,0,"FIA",1
22,"22009",585,439,435,4,4,"FIA",0
50,"50039",467,366,364,3,2,"FIA",0
50,"50058",63,54,53,2,1,"FIA",0
50,"50258",53,33,33,3,0,"FIA",0
22,"22204",1119,836,832,9,4,"FIA",0
50,"50239",63,47,47,0,0,"FIA",0
22,"22046",714,592,587,13,5,"FIA",0
50,"50023",208,165,164,2,1,"FIA",1
22,"22226",771,598,591,6,7,"FIA",2
50,"50281",68,55,52,0,3,"FIA",0
50,"50144",31,26,25,0,1,"FIA",0
22,"22157",183,136,134,1,2,"FIA",0
50,"50138",47,42,42,1,0,"FIA",0
50,"50065",55,43,43,1,0,"FIA",0
50,"50084",66,47,47,0,0,"FIA",0
22,"22201",266,192,192,2,0,"FIA",0
22,"22014",233,185,182,3,3,"FIA",0
22,"22182",233,178,174,1,4,"FIA",0
50,"50080",34,29,29,0,0,"FIA",0
22,"22135",174,132,132,5,0,"FIA",0
50,"50155",90,70,69,0,1,"FIA",0
22,"22015",300,232,226,5,6,"FIA",0
50,"50119",872,684,680,4,4,"FIA",0
50,"50203",1057,849,837,9,12,"FIA",1
22,"22055",310,258,255,2,3,"FIA",0
22,"22168",23,21,20,0,1,"FIA",1
50,"50165",1783,1359,1330,20,29,"FIA",0
50,"50193",663,536,516,1,20,"FIA",0
50,"50197",96,78,78,1,0,"FIA",0
50,"50073",2117,1735,1706,13,29,"FIA",2
50,"50082",84,63,63,0,0,"FIA",0
22,"22131",83,65,65,0,0,"FIA",0
50,"50095",12136,9020,8928,99,92,"FIA",6
22,"22039",805,667,662,5,5,"FIA",0
50,"50076",75,64,63,0,1,"FIA",0
22,"22174",462,381,377,0,4,"FIA",4
50,"50273",32,24,24,0,0,"FIA",0
50,"50188",27,24,24,0,0,"FIA",0
50,"50195",53,42,41,0,1,"FIA",0
22,"22203",76,61,61,0,0,"FIA",0
22,"22075",119,87,87,1,0,"FIA",0
22,"22162",129,99,99,0,0,"FIA",0
50,"50179",264,231,228,0,3,"FIA",0
50,"50126",2262,1736,1708,20,28,"FIA",0
50,"50223",916,751,745,13,6,"FIA",0
50,"50252",5057,3661,3613,36,48,"FIA",4
22,"22061",6583,5027,4973,51,54,"FIA",2
50,"50090",134,108,108,0,0,"FIA",0
22,"22050",93,79,79,2,0,"FIA",0
50,"50177",276,226,223,0,3,"FIA",0
22,"22029",119,103,103,0,0,"FIA",0
50,"50151",603,490,489,3,1,"FIA",0
22,"22011",97,78,75,2,3,"FIA",0
50,"50128",27,24,24,0,0,"FIA",0
50,"50033",65,50,50,1,0,"FIA",0
50,"50244",191,153,150,1,3,"FIA",0
50,"50002",125,96,91,1,5,"FIA",0
22,"22136",749,579,576,5,3,"FIA",0
50,"50057",1332,1001,986,10,15,"FIA",6
50,"50288",3444,2689,2668,24,21,"FIA",7
22,"22018",308,234,232,2,2,"FIA",0
50,"50081",491,390,384,5,6,"FIA",0
22,"22077",362,301,293,3,8,"FIA",2
50,"50218",110,92,92,0,0,"FIA",0
22,"22246",71,50,50,0,0,"FIA",0
50,"50294",64,49,47,0,2,"FIA",0
50,"50091",40,35,35,0,0,"FIA",0
50,"50266",121,85,80,0,5,"FIA",0
50,"50209",2747,1993,1975,29,18,"FIA",0
22,"22003",132,114,114,0,0,"FIA",0
22,"22229",108,80,80,2,0,"FIA",0
50,"50079",227,182,178,1,4,"FIA",0
50,"50153",922,705,704,6,1,"FIA",0
22,"22217",372,296,290,5,6,"FIA",0
50,"50191",445,341,337,2,4,"FIA",0
22,"22200",239,181,178,0,3,"FIA",0
50,"50219",4283,3274,3213,53,61,"FIA",5
22,"22027",306,230,225,3,5,"FIA",0
50,"50130",362,252,249,1,3,"FIA",0
22,"22251",334,269,263,4,6,"FIA",0
50,"50154",116,98,98,0,0,"FIA",0
22,"22175",184,139,137,1,2,"FIA",0
50,"50004",478,380,376,2,4,"FIA",1
50,"50255",197,162,160,2,2,"FIA",0
22,"22047",241,213,212,2,1,"FIA",0
22,"22040",144,124,120,1,4,"FIA",0
50,"50192",233,189,183,0,6,"FIA",1
22,"22079",114,89,88,1,1,"FIA",0
22,"22129",163,117,116,0,1,"FIA",0
22,"22172",520,412,407,3,5,"FIA",0
22,"22248",104,83,82,0,1,"FIA",0
50,"50068",1947,1402,1389,11,13,"FIA",1
22,"22197",439,356,353,10,3,"FIA",1
50,"50093",83,66,66,1,0,"FIA",0
50,"50231",257,210,207,3,3,"FIA",0
50,"50098",162,121,120,3,1,"FIA",0
50,"50056",405,332,330,4,2,"FIA",0
22,"22080",264,208,202,2,6,"FIA",1
50,"50149",33,25,25,1,0,"FIA",0
22,"22906",174,137,134,5,3,"FIA",0
50,"50085",183,136,136,1,0,"FIA",0
50,"50251",8207,6352,6242,46,110,"FIA",3
50,"50206",453,371,370,5,1,"FIA",0
50,"50235",2412,1826,1807,22,19,"FIA",0
50,"50018",893,705,696,3,9,"FIA",0
22,"22209",159,139,136,5,3,"FIA",0
50,"50279",73,61,60,2,1,"FIA",0
22,"22164",43,33,31,0,2,"FIA",1
22,"22042",117,96,95,1,1,"FIA",0
22,"22220",150,120,117,0,3,"FIA",0
50,"50028",77,59,58,1,1,"FIA",0
22,"22016",566,423,420,4,3,"FIA",0
22,"22094",98,72,71,2,1,"FIA",0
50,"50041",17,14,14,0,0,"FIA",0
50,"50013",200,166,166,3,0,"FIA",1
50,"50051",800,615,608,3,7,"FIA",0
22,"22178",103,84,84,2,0,"FIA",0
50,"50216",240,189,181,3,8,"FIA",0
50,"50217",431,346,344,0,2,"FIA",0
50,"50100",306,238,235,3,3,"FIA",0
50,"50210",36,29,29,0,0,"FIA",0
22,"22053",786,573,567,3,6,"FIA",0
50,"50213",93,76,75,0,1,"FIA",0
50,"50117",125,100,100,3,0,"FIA",0
22,"22165",452,360,356,1,4,"FIA",0
50,"50143",546,409,401,5,8,"FIA",0
50,"50148",290,229,227,2,2,"FIA",0
50,"50045",1198,957,951,3,6,"FIA",2
50,"50059",754,599,589,6,10,"FIA",0
22,"22176",170,136,135,0,1,"FIA",0
22,"22069",418,337,334,5,3,"FIA",1
22,"22024",222,179,177,1,2,"FIA",1
22,"22025",1035,764,755,24,9,"FIA",1
22,"22909",301,233,231,4,2,"FIA",0
50,"50260",32,28,28,0,0,"FIA",0
50,"50011",116,100,99,0,1,"FIA",0
22,"22109",266,207,205,3,2,"FIA",2
50,"50021",25,23,23,1,0,"FIA",0
50,"50272",13174,10143,10042,103,101,"FIA",27
22,"22096",320,274,272,2,2,"FIA",2
22,"22116",1369,1025,1003,8,22,"FIA",0
50,"50003",119,95,95,1,0,"FIA",0
50,"50291",93,78,77,1,1,"FIA",0
50,"50129",213,151,149,5,2,"FIA",0
22,"22113",470,369,369,2,0,"FIA",0
50,"50120",55,43,43,2,0,"FIA",0
50,"50142",24,18,18,0,0,"FIA",0
50,"50109",98,69,67,3,2,"FIA",0
50,"50156",209,174,171,1,3,"FIA",0
22,"22170",668,529,520,4,9,"FIA",0
50,"50160",2150,1652,1619,14,33,"FIA",4
50,"50060",170,137,135,2,2,"FIA",0
50,"50169",336,261,259,2,2,"FIA",0
22,"22160",212,171,170,3,1,"FIA",0
50,"50298",5427,4373,4323,30,50,"FIA",3
50,"50259",84,58,58,0,0,"FIA",0
22,"22089",276,216,216,2,0,"FIA",0
22,"22106",20,15,15,0,0,"FIA",0
22,"22028",362,284,282,5,2,"FIA",0
22,"22125",39429,29988,29612,337,376,"FIA",22
22,"22184",168,142,139,2,3,"FIA",1
22,"22102",181,153,151,1,2,"FIA",0
22,"22137",1015,741,733,9,8,"FIA",0
22,"22213",2923,2261,2221,24,40,"FIA",0
50,"50086",178,121,119,2,2,"FIA",0
50,"50201",444,357,354,1,3,"FIA",0
22,"22006",272,206,201,2,5,"FIA",0
50,"50124",399,316,316,3,0,"FIA",1
50,"50043",246,172,170,2,2,"FIA",0
50,"50234",242,194,187,3,7,"FIA",1
50,"50271",248,197,189,2,8,"FIA",0
50,"50202",131,90,88,1,2,"FIA",1
22,"22181",88,60,59,1,1,"FIA",0
22,"22139",78,60,60,0,0,"FIA",0
22,"22083",445,379,372,5,7,"FIA",0
22,"22051",91,78,78,1,0,"FIA",0
50,"50050",86,65,65,1,0,"FIA",0
50,"50903",2238,1750,1732,11,18,"FIA",0
22,"22144",257,207,204,1,3,"FIA",1
50,"50162",137,112,110,2,2,"FIA",0
22,"22235",88,72,72,1,0,"FIA",0
22,"22186",191,165,164,2,1,"FIA",0
50,"50229",65,57,56,0,1,"FIA",0
50,"50031",139,97,90,0,7,"FIA",1
50,"50006",908,705,689,3,16,"FIA",0
50,"50200",475,416,407,4,9,"FIA",0
50,"50264",147,122,120,0,2,"FIA",0
50,"50025",4516,3417,3364,35,53,"FIA",1
22,"22099",465,365,362,3,3,"FIA",0
50,"50089",8584,6951,6912,34,39,"FIA",2
50,"50185",136,103,102,0,1,"FIA",0
50,"50242",93,72,70,0,2,"FIA",0
50,"50166",236,200,198,1,2,"FIA",0
22,"22008",155,127,125,0,2,"FIA",0
22,"22141",114,86,85,0,1,"FIA",0
50,"50096",36,22,22,0,0,"FIA",0
22,"22234",745,587,578,11,9,"FIA",0
50,"50245",76,58,58,0,0,"FIA",0
50,"50274",66,48,47,0,1,"FIA",0
50,"50032",242,179,176,1,3,"FIA",0
50,"50227",110,74,73,2,1,"FIA",0
50,"50104",326,264,259,4,5,"FIA",0
22,"22142",94,80,80,2,0,"FIA",0
22,"22133",108,85,83,1,2,"FIA",0
50,"50277",49,37,37,3,0,"FIA",0
22,"22078",438,326,323,3,3,"FIA",0
22,"22207",121,78,78,1,0,"FIA",1
50,"50194",81,59,59,1,0,"FIA",0
22,"22037",112,96,96,0,0,"FIA",0
22,"22158",11951,8877,8801,69,76,"FIA",10
50,"50243",311,252,247,1,5,"FIA",0
50,"50005",239,204,201,2,3,"FIA",0
50,"50287",252,200,196,7,4,"FIA",0
22,"22044",234,184,183,3,1,"FIA",0
50,"50105",279,216,213,4,3,"FIA",1
22,"22223",74,63,63,1,0,"FIA",0
50,"50241",595,434,423,3,11,"FIA",0
50,"50115",3275,2399,2355,32,44,"FIA",2
50,"50066",2835,2199,2177,19,22,"FIA",4
22,"22019",175,151,151,0,0,"FIA",0
50,"50077",206,158,157,1,1,"FIA",0
50,"50074",6166,4547,4444,33,103,"FIA",6
50,"50164",388,279,272,2,7,"FIA",0
22,"22227",199,155,154,1,1,"FIA",0
50,"50254",174,123,122,0,1,"FIA",0
22,"22007",756,576,571,5,5,"FIA",0
50,"50285",650,466,462,7,4,"FIA",0
50,"50178",276,193,193,4,0,"FIA",1
22,"22060",1172,906,901,13,5,"FIA",0
50,"50176",222,161,156,3,5,"FIA",0
22,"22188",76,60,59,1,1,"FIA",0
50,"50236",101,82,80,1,2,"FIA",0
22,"22127",529,434,432,4,2,"FIA",0
50,"50187",56,43,43,0,0,"FIA",0
50,"50212",32,29,29,1,0,"FIA",0
22,"22043",93,68,67,1,1,"FIA",1
50,"50295",49,46,46,0,0,"FIA",0
50,"50055",3627,2627,2571,41,56,"FIA",5
22,"22221",90,58,56,0,2,"FIA",0
50,"50240",965,720,702,9,18,"FIA",0
50,"50214",18,10,10,0,0,"FIA",0
22,"22088",143,111,111,1,0,"FIA",0
50,"50010",66,56,55,2,1,"FIA",0
22,"22057",364,286,284,3,2,"FIA",1
50,"50123",436,344,338,1,6,"FIA",0
22,"22032",107,74,74,2,0,"FIA",0
22,"22041",152,121,119,2,2,"FIA",0
22,"22022",543,441,433,4,8,"FIA",1
22,"22208",194,159,156,1,3,"FIA",0
50,"50173",149,107,105,0,2,"FIA",0
50,"50190",675,565,553,5,12,"FIA",0
50,"50062",1863,1441,1416,9,25,"FIA",4
22,"22187",294,244,243,2,1,"FIA",1
50,"50087",29,18,18,0,0,"FIA",0
22,"22112",9516,7043,6956,84,87,"FIA",7
22,"22253",57,48,47,0,1,"FIA",2
22,"22095",65,57,56,1,1,"FIA",0
50,"50099",3042,2299,2265,20,34,"FIA",2
50,"50012",96,79,79,1,0,"FIA",0
50,"50250",56,45,45,0,0,"FIA",0
22,"22214",118,98,97,1,1,"FIA",0
22,"22243",39,28,28,0,0,"FIA",0
22,"22215",128,91,91,1,0,"FIA",0
22,"22228",529,421,417,3,4,"FIA",0
22,"22052",885,708,702,6,6,"FIA",1
50,"50113",584,505,495,3,10,"FIA",0
50,"50070",49,28,28,0,0,"FIA",0
50,"50029",604,475,467,7,8,"FIA",1
22,"22212",70,56,56,0,0,"FIA",0
22,"22062",154,115,115,1,0,"FIA",0
50,"50027",224,170,165,1,5,"FIA",0
50,"50224",65,54,54,1,0,"FIA",0
50,"50017",1779,1386,1373,14,13,"FIA",1
50,"50269",279,189,186,1,3,"FIA",0
50,"50296",382,288,272,1,16,"FIA",1
22,"22001",214,162,162,0,0,"FIA",1
50,"50204",2394,1876,1855,21,21,"FIA",1
50,"50061",193,173,169,1,4,"FIA",0
50,"50289",51,40,38,1,2,"FIA",0
50,"50182",3675,2846,2810,36,36,"FIA",1
50,"50092",300,234,230,1,4,"FIA",0
50,"50167",215,181,179,1,2,"FIA",0
22,"22151",88,66,65,0,1,"FIA",0
50,"50171",96,78,78,1,0,"FIA",0
22,"22190",122,89,89,0,0,"FIA",0
50,"50132",771,589,576,2,13,"FIA",2
22,"22173",218,162,160,1,2,"FIA",0
22,"22245",306,266,263,0,3,"FIA",1
50,"50111",183,144,142,2,2,"FIA",3
50,"50208",1748,1360,1344,11,16,"FIA",0
50,"50265",74,56,56,0,0,"FIA",0
22,"22130",10128,7355,7294,61,61,"FIA",13
50,"50024",556,427,426,6,1,"FIA",0
22,"22087",58,47,47,0,0,"FIA",0
22,"22242",63,47,45,1,2,"FIA",0
22,"22064",162,121,121,0,0,"FIA",0
22,"22021",1884,1465,1450,13,15,"FIA",1
22,"22126",87,66,66,0,0,"FIA",0
22,"22222",517,407,398,5,9,"FIA",1
50,"50036",100,80,80,0,0,"FIA",0
50,"50094",1518,1172,1155,20,17,"FIA",0
22,"22048",12593,9614,9528,82,86,"FIA",8
22,"22903",622,538,533,3,5,"FIA",0
22,"22155",65,54,54,0,0,"FIA",0
22,"22049",74,63,63,0,0,"FIA",0
22,"22023",389,313,305,6,8,"FIA",0
50,"50292",129,113,113,1,0,"FIA",0
50,"50147",751,564,559,3,5,"FIA",1
22,"22002",106,95,94,0,1,"FIA",1
50,"50135",88,74,74,3,0,"FIA",0
50,"50215",20,18,18,0,0,"FIA",0
22,"22163",419,363,361,1,2,"FIA",0
50,"50014",119,85,85,0,0,"FIA",0
50,"50053",650,505,497,4,8,"FIA",0
22,"22205",459,347,345,1,2,"FIA",1
22,"22150",461,368,362,1,6,"FIA",1
50,"50246",38,28,28,0,0,"FIA",0
22,"22017",822,664,660,5,4,"FIA",0
50,"50064",438,368,362,1,6,"FIA",1
22,"22239",88,71,71,0,0,"FIA",0
22,"22195",234,193,192,0,1,"FIA",0
50,"50263",176,119,116,0,3,"FIA",0
22,"22117",2414,1798,1784,18,14,"FIA",1
22,"22202",145,127,126,0,1,"FIA",0
50,"50184",90,79,79,0,0,"FIA",0
50,"50141",109,90,90,1,0,"FIA",0
50,"50072",195,164,161,3,3,"FIA",0
50,"50101",832,625,614,1,11,"FIA",1
50,"50249",284,229,227,1,2,"FIA",0
50,"50040",86,71,71,0,0,"FIA",0
50,"50278",177,137,137,2,0,"FIA",0
50,"50008",5185,3753,3711,35,42,"FIA",11
22,"22054",1617,1196,1183,15,13,"FIA",0
50,"50069",67,44,44,0,0,"FIA",0
22,"22082",285,230,226,2,4,"FIA",0
50,"50134",118,91,89,0,2,"FIA",0
22,"22218",40,32,31,1,1,"FIA",1
22,"22902",208,160,156,0,4,"FIA",1
50,"50131",210,157,156,0,1,"FIA",0
50,"50139",322,257,256,0,1,"FIA",0
22,"22084",555,438,433,5,5,"FIA",0
50,"50186",37,28,28,0,0,"FIA",0
22,"22012",102,81,80,1,1,"FIA",0
50,"50220",43,37,37,0,0,"FIA",0
50,"50019",64,48,47,0,1,"FIA",0
50,"50088",282,233,227,2,6,"FIA",0
50,"50199",325,238,232,3,6,"FIA",0
22,"22115",347,262,261,1,1,"FIA",0
22,"22058",191,157,157,3,0,"FIA",0
50,"50284",132,105,104,1,1,"FIA",0
22,"22119",1256,963,954,5,9,"FIA",0
50,"50268",42,33,32,1,1,"FIA",0
50,"50114",132,111,111,1,0,"FIA",0
50,"50270",38,32,30,1,2,"FIA",0
50,"50007",49,34,34,0,0,"FIA",0
22,"22111",146,115,115,1,0,"FIA",1
22,"22230",288,229,228,3,1,"FIA",0
50,"50228",250,217,214,3,3,"FIA",1
50,"50275",110,55,55,0,0,"FIA",0
22,"22076",288,228,226,1,2,"FIA",0
50,"50026",421,340,328,4,12,"FIA",0
50,"50133",100,82,82,2,0,"FIA",0
22,"22072",194,141,140,0,1,"FIA",2
50,"50042",16,16,16,0,0,"FIA",0
22,"22233",80,50,50,0,0,"FIA",0
50,"50022",504,396,386,11,10,"FIA",1
50,"50225",1532,1072,1064,10,8,"FIA",1
50,"50286",75,58,55,0,3,"FIA",0
8,"8074",11054,8273,8235,34,38,"FRONT REPUB",138
8,"8015",156003,117736,117183,704,553,"FRONT REPUB",2228
8,"8226",926,811,807,1,4,"FRONT REPUB",62
43,"43050",2634,1881,1868,13,13,"FRONT REPUB",23
17,"17224",302,233,231,2,2,"FRONT REPUB",8
8,"8120",7048,5892,5881,49,11,"FRONT REPUB",192
25,"25252",557,424,422,4,2,"FRONT REPUB",8
25,"25909",140,108,107,2,1,"FRONT REPUB",4
43,"43041",228,179,177,3,2,"FRONT REPUB",1
8,"8182",2892,2217,2204,18,13,"FRONT REPUB",41
17,"17145",1432,1113,1103,7,10,"FRONT REPUB",70
43,"43012",3647,3028,3019,15,9,"FRONT REPUB",66
25,"25203",8798,6279,6231,26,48,"FRONT REPUB",140
8,"8105",9724,7557,7505,49,52,"FRONT REPUB",39
17,"17077",567,434,434,2,0,"FRONT REPUB",16
25,"25022",107,88,88,0,0,"FRONT REPUB",1
17,"17226",895,673,669,3,4,"FRONT REPUB",10
17,"17093",922,716,715,2,1,"FRONT REPUB",26
17,"17007",1752,1430,1422,2,8,"FRONT REPUB",51
8,"8287",1057,877,871,7,6,"FRONT REPUB",36
17,"17049",3204,2634,2615,9,19,"FRONT REPUB",292
8,"8048",569,442,442,2,0,"FRONT REPUB",14
43,"43142",1083,850,842,8,8,"FRONT REPUB",21
25,"25146",221,172,170,3,2,"FRONT REPUB",10
8,"8215",2589,2044,2034,19,10,"FRONT REPUB",98
8,"8006",11774,9039,8981,33,58,"FRONT REPUB",410
17,"17111",958,772,771,3,1,"FRONT REPUB",44
17,"17155",14861,10307,10234,52,73,"FRONT REPUB",409
25,"25166",172,137,136,1,1,"FRONT REPUB",2
25,"25064",98,88,88,0,0,"FRONT REPUB",7
17,"17178",1056,804,798,3,6,"FRONT REPUB",30
8,"8146",1358,1086,1079,2,7,"FRONT REPUB",19
17,"17232",149,117,116,0,1,"FRONT REPUB",9
17,"17100",195,157,154,0,3,"FRONT REPUB",8
43,"43116",463,381,379,2,2,"FRONT REPUB",14
25,"25181",175,136,135,0,1,"FRONT REPUB",5
8,"8252",24729,19751,19642,125,109,"FRONT REPUB",234
25,"25254",711,576,571,5,5,"FRONT REPUB",11
8,"8261",2378,1821,1815,14,6,"FRONT REPUB",71
43,"43099",286,234,234,0,0,"FRONT REPUB",4
25,"25224",126,98,98,0,0,"FRONT REPUB",5
25,"25093",629,489,487,4,2,"FRONT REPUB",7
8,"8302",9373,7001,6934,61,67,"FRONT REPUB",83
25,"25027",977,765,763,4,2,"FRONT REPUB",17
17,"17163",2824,2358,2351,13,7,"FRONT REPUB",110
8,"8241",69,56,56,0,0,"FRONT REPUB",5
43,"43170",878,706,704,7,2,"FRONT REPUB",22
25,"25127",214,172,172,0,0,"FRONT REPUB",15
25,"25175",176,135,135,1,0,"FRONT REPUB",2
8,"8057",61,50,50,0,0,"FRONT REPUB",5
8,"8003",7183,5761,5742,39,19,"FRONT REPUB",186
25,"25007",1392,1089,1083,4,6,"FRONT REPUB",29
25,"25227",664,517,517,1,0,"FRONT REPUB",27
25,"25019",4646,3224,3199,22,25,"FRONT REPUB",69
8,"8188",115,95,95,0,0,"FRONT REPUB",8
8,"8242",222,180,180,0,0,"FRONT REPUB",12
8,"8016",1812,1454,1448,6,6,"FRONT REPUB",62
8,"8180",27072,21218,21100,126,118,"FRONT REPUB",299
8,"8207",2014,1736,1730,9,6,"FRONT REPUB",170
43,"43154",126,111,111,0,0,"FRONT REPUB",2
17,"17024",285,228,227,0,1,"FRONT REPUB",2
17,"17090",544,469,468,0,1,"FRONT REPUB",14
43,"43011",1079,912,909,1,3,"FRONT REPUB",49
8,"8181",8061,6442,6402,28,40,"FRONT REPUB",169
25,"25180",228,176,174,1,2,"FRONT REPUB",1
43,"43117",143,114,113,0,1,"FRONT REPUB",0
43,"43056",806,616,613,5,3,"FRONT REPUB",21
8,"8012",1721,1340,1331,8,9,"FRONT REPUB",76
43,"43127",759,630,626,3,4,"FRONT REPUB",29
43,"43132",363,292,291,2,1,"FRONT REPUB",9
17,"17215",2227,1936,1925,12,11,"FRONT REPUB",61
25,"25239",595,367,366,3,1,"FRONT REPUB",8
43,"43130",177,145,145,0,0,"FRONT REPUB",11
25,"25046",407,349,347,1,2,"FRONT REPUB",16
17,"17196",242,198,198,1,0,"FRONT REPUB",3
43,"43058",96,77,77,0,0,"FRONT REPUB",2
8,"8266",43383,35117,34994,178,123,"FRONT REPUB",773
8,"8275",248,223,222,1,1,"FRONT REPUB",21
25,"25220",994,822,816,3,6,"FRONT REPUB",21
8,"8140",4778,3756,3737,19,19,"FRONT REPUB",128
43,"43052",934,765,756,2,9,"FRONT REPUB",16
8,"8013",1280,1040,1031,5,9,"FRONT REPUB",25
43,"43902",2743,1996,1980,16,16,"FRONT REPUB",15
8,"8232",1786,1444,1434,9,10,"FRONT REPUB",65
25,"25085",141,118,117,2,1,"FRONT REPUB",10
17,"17115",278,226,222,2,4,"FRONT REPUB",16
8,"8065",1180,967,964,4,3,"FRONT REPUB",33
8,"8152",116,94,94,0,0,"FRONT REPUB",6
25,"25112",268,214,212,2,2,"FRONT REPUB",8
17,"17146",3127,2404,2381,11,23,"FRONT REPUB",85
25,"25075",131,102,102,0,0,"FRONT REPUB",6
8,"8195",76,69,69,0,0,"FRONT REPUB",1
8,"8229",521,435,433,3,2,"FRONT REPUB",19
43,"43006",676,531,525,4,6,"FRONT REPUB",7
17,"17031",182,130,129,0,1,"FRONT REPUB",12
25,"25137",8686,6327,6296,46,31,"FRONT REPUB",155
8,"8072",10699,8226,8193,45,33,"FRONT REPUB",188
8,"8292",1062,835,831,3,4,"FRONT REPUB",36
25,"25055",163,130,129,0,1,"FRONT REPUB",4
17,"17172",457,352,349,1,3,"FRONT REPUB",22
43,"43051",9092,6577,6502,26,75,"FRONT REPUB",49
8,"8084",1167,941,936,6,5,"FRONT REPUB",56
17,"17141",6072,4251,4221,14,30,"FRONT REPUB",109
43,"43070",238,194,193,1,1,"FRONT REPUB",7
17,"17192",146,121,120,0,1,"FRONT REPUB",7
8,"8239",460,380,378,2,2,"FRONT REPUB",15
8,"8185",197,172,171,2,1,"FRONT REPUB",7
17,"17191",166,145,144,2,1,"FRONT REPUB",18
17,"17035",550,460,460,3,0,"FRONT REPUB",26
8,"8126",8865,7125,7098,33,27,"FRONT REPUB",172
25,"25234",4201,3087,3072,13,15,"FRONT REPUB",81
25,"25077",440,331,330,1,1,"FRONT REPUB",18
8,"8905",2308,1943,1938,7,5,"FRONT REPUB",55
17,"17080",144,124,124,2,0,"FRONT REPUB",12
25,"25231",494,410,408,2,2,"FRONT REPUB",6
17,"17117",14471,10565,10504,52,61,"FRONT REPUB",254
25,"25912",843,685,684,4,1,"FRONT REPUB",20
17,"17136",195,156,155,0,1,"FRONT REPUB",11
43,"43074",1812,1419,1412,4,7,"FRONT REPUB",31
8,"8136",11614,9159,9079,84,80,"FRONT REPUB",106
8,"8129",484,406,405,3,1,"FRONT REPUB",20
8,"8151",448,378,377,2,1,"FRONT REPUB",18
8,"8213",6547,5270,5245,23,25,"FRONT REPUB",151
43,"43141",105,86,86,0,0,"FRONT REPUB",1
17,"17001",580,459,454,3,5,"FRONT REPUB",26
17,"17902",1306,1076,1074,3,2,"FRONT REPUB",51
8,"8054",9155,7468,7428,43,40,"FRONT REPUB",182
43,"43165",572,492,492,1,0,"FRONT REPUB",19
8,"8097",1080,891,880,2,11,"FRONT REPUB",46
8,"8101",174954,129953,129198,680,755,"FRONT REPUB",1722
43,"43066",155,121,121,1,0,"FRONT REPUB",2
25,"25068",531,402,399,6,3,"FRONT REPUB",15
25,"25126",284,233,232,1,1,"FRONT REPUB",9
43,"43027",164,137,137,0,0,"FRONT REPUB",3
43,"43031",1446,1180,1178,7,2,"FRONT REPUB",39
43,"43156",3956,2993,2965,23,28,"FRONT REPUB",80
8,"8295",11184,8566,8529,43,37,"FRONT REPUB",116
8,"8058",1787,1357,1340,5,17,"FRONT REPUB",27
43,"43026",765,614,613,3,1,"FRONT REPUB",33
25,"25039",261,216,216,1,0,"FRONT REPUB",14
43,"43166",1628,1292,1285,3,7,"FRONT REPUB",32
43,"43095",2564,1995,1984,14,11,"FRONT REPUB",28
8,"8162",2124,1659,1651,7,8,"FRONT REPUB",54
8,"8303",256,215,213,1,2,"FRONT REPUB",11
25,"25033",1121,899,890,5,9,"FRONT REPUB",33
25,"25133",686,528,527,2,1,"FRONT REPUB",10
43,"43124",472,379,373,1,6,"FRONT REPUB",5
25,"25043",801,613,606,1,7,"FRONT REPUB",20
25,"25092",127,101,99,1,2,"FRONT REPUB",7
8,"8165",1664,1315,1311,9,4,"FRONT REPUB",47
17,"17181",3467,2664,2648,10,16,"FRONT REPUB",67
25,"25145",76,66,66,1,0,"FRONT REPUB",7
8,"8169",48284,37528,37326,218,202,"FRONT REPUB",434
17,"17223",800,623,616,5,7,"FRONT REPUB",47
43,"43082",351,303,297,1,6,"FRONT REPUB",11
8,"8096",43555,34070,33871,194,199,"FRONT REPUB",758
17,"17148",1531,1165,1153,4,12,"FRONT REPUB",42
25,"25149",1378,1108,1102,3,6,"FRONT REPUB",13
8,"8017",2827,2192,2182,16,10,"FRONT REPUB",64
8,"8308",137,118,118,0,0,"FRONT REPUB",6
43,"43009",1391,1086,1078,3,8,"FRONT REPUB",54
8,"8233",1846,1485,1478,8,7,"FRONT REPUB",73
25,"25182",1043,842,839,9,3,"FRONT REPUB",10
8,"8135",6735,5445,5421,36,24,"FRONT REPUB",93
25,"25136",96,79,79,2,0,"FRONT REPUB",8
17,"17081",248,192,190,0,2,"FRONT REPUB",6
8,"8189",122,106,106,0,0,"FRONT REPUB",3
25,"25910",91,70,67,2,3,"FRONT REPUB",3
43,"43025",590,476,472,0,4,"FRONT REPUB",5
17,"17061",183,148,148,0,0,"FRONT REPUB",7
8,"8158",3108,2458,2453,13,5,"FRONT REPUB",51
8,"8141",4573,3611,3595,26,16,"FRONT REPUB",196
17,"17006",1186,880,878,10,2,"FRONT REPUB",23
8,"8247",980,832,828,3,4,"FRONT REPUB",63
8,"8114",18648,14251,14170,69,81,"FRONT REPUB",196
8,"8280",95,78,78,1,0,"FRONT REPUB",0
17,"17199",6955,5328,5308,23,20,"FRONT REPUB",215
8,"8043",3378,2579,2569,20,10,"FRONT REPUB",47
8,"8245",77805,57956,57666,313,290,"FRONT REPUB",655
43,"43149",684,533,533,4,0,"FRONT REPUB",8
17,"17034",7205,5337,5291,16,46,"FRONT REPUB",145
25,"25128",127,87,87,0,0,"FRONT REPUB",5
43,"43088",2026,1565,1562,9,3,"FRONT REPUB",38
43,"43046",90,73,73,1,0,"FRONT REPUB",1
25,"25008",1088,867,857,7,10,"FRONT REPUB",17
25,"25250",330,261,258,1,3,"FRONT REPUB",6
17,"17139",1394,1163,1154,3,9,"FRONT REPUB",45
17,"17168",379,332,329,0,3,"FRONT REPUB",25
25,"25111",113,90,89,0,1,"FRONT REPUB",3
25,"25197",141,109,108,0,1,"FRONT REPUB",13
43,"43153",11092,8327,8291,34,36,"FRONT REPUB",185
43,"43177",284,243,242,0,1,"FRONT REPUB",7
8,"8231",21132,15940,15880,75,60,"FRONT REPUB",432
17,"17056",1766,1438,1433,9,5,"FRONT REPUB",74
25,"25060",69,49,49,1,0,"FRONT REPUB",3
8,"8160",316,252,247,2,5,"FRONT REPUB",18
17,"17220",805,673,665,2,8,"FRONT REPUB",42
43,"43096",98,82,82,0,0,"FRONT REPUB",1
25,"25052",1562,1273,1264,3,9,"FRONT REPUB",34
8,"8285",10321,8169,8120,52,49,"FRONT REPUB",442
8,"8259",6904,5626,5601,27,25,"FRONT REPUB",251
8,"8211",33731,27698,27561,126,137,"FRONT REPUB",494
8,"8027",720,592,588,3,4,"FRONT REPUB",30
25,"25223",911,732,723,6,9,"FRONT REPUB",33
25,"25903",229,189,188,0,1,"FRONT REPUB",11
43,"43140",2438,1847,1837,16,10,"FRONT REPUB",22
17,"17054",347,271,271,0,0,"FRONT REPUB",10
17,"17064",326,263,261,2,2,"FRONT REPUB",16
25,"25023",4527,3621,3601,23,20,"FRONT REPUB",86
8,"8109",208,184,183,0,1,"FRONT REPUB",23
25,"25103",136,103,102,2,1,"FRONT REPUB",5
25,"25191",321,248,244,3,4,"FRONT REPUB",12
17,"17110",1329,1064,1054,5,10,"FRONT REPUB",22
17,"17020",3671,3021,3006,11,15,"FRONT REPUB",155
8,"8273",2353,1944,1934,9,10,"FRONT REPUB",95
8,"8019",1117818,875679,872180,4327,3499,"FRONT REPUB",28827
25,"25901",287,209,207,1,2,"FRONT REPUB",6
25,"25222",66,57,57,0,0,"FRONT REPUB",2
8,"8098",2409,1916,1912,9,4,"FRONT REPUB",59
8,"8069",3280,2691,2680,17,11,"FRONT REPUB",76
43,"43111",2098,1496,1483,8,13,"FRONT REPUB",13
25,"25011",5260,3908,3871,30,37,"FRONT REPUB",76
43,"43019",1336,1020,1008,4,12,"FRONT REPUB",20
17,"17044",6930,5514,5493,26,21,"FRONT REPUB",222
17,"17019",1784,1472,1462,3,10,"FRONT REPUB",46
25,"25209",1550,1192,1172,4,20,"FRONT REPUB",37
8,"8062",1004,829,826,11,3,"FRONT REPUB",27
8,"8298",26980,20900,20817,91,83,"FRONT REPUB",1196
25,"25152",144,106,106,1,0,"FRONT REPUB",1
8,"8166",962,753,745,7,8,"FRONT REPUB",23
8,"8088",12248,9945,9904,57,41,"FRONT REPUB",564
25,"25212",224,195,195,2,0,"FRONT REPUB",8
17,"17010",327,264,263,2,1,"FRONT REPUB",31
25,"25067",706,537,532,4,5,"FRONT REPUB",19
25,"25014",249,203,200,2,3,"FRONT REPUB",20
43,"43109",2704,1937,1922,16,15,"FRONT REPUB",16
43,"43033",768,609,607,3,2,"FRONT REPUB",12
8,"8108",5192,4204,4189,26,15,"FRONT REPUB",46
8,"8056",42727,33215,33054,220,161,"FRONT REPUB",391
8,"8301",49135,38575,38398,272,177,"FRONT REPUB",303
17,"17185",2275,1777,1768,7,9,"FRONT REPUB",61
8,"8099",753,565,561,2,4,"FRONT REPUB",24
8,"8902",3937,3176,3164,17,12,"FRONT REPUB",95
25,"25156",784,608,605,4,3,"FRONT REPUB",3
17,"17042",408,313,311,0,2,"FRONT REPUB",3
8,"8022",12219,9089,9038,42,51,"FRONT REPUB",512
43,"43100",3489,2820,2816,15,4,"FRONT REPUB",58
25,"25020",274,221,221,2,0,"FRONT REPUB",5
25,"25057",214,162,161,0,1,"FRONT REPUB",7
8,"8238",14851,12472,12428,50,44,"FRONT REPUB",399
43,"43007",640,510,509,0,1,"FRONT REPUB",8
17,"17011",651,544,544,4,0,"FRONT REPUB",33
25,"25058",4358,3269,3254,7,15,"FRONT REPUB",130
8,"8118",17542,14101,14059,56,42,"FRONT REPUB",466
8,"8156",11155,8956,8923,60,33,"FRONT REPUB",175
43,"43034",468,393,393,0,0,"FRONT REPUB",5
8,"8170",442,338,338,0,0,"FRONT REPUB",15
43,"43125",890,700,698,12,2,"FRONT REPUB",22
25,"25104",122,91,91,0,0,"FRONT REPUB",1
8,"8190",258,216,215,1,1,"FRONT REPUB",11
17,"17126",318,279,279,0,0,"FRONT REPUB",9
25,"25069",425,329,327,1,2,"FRONT REPUB",7
8,"8139",177,156,156,0,0,"FRONT REPUB",15
8,"8289",4457,3605,3594,20,11,"FRONT REPUB",138
17,"17147",7959,6164,6130,45,34,"FRONT REPUB",191
17,"17088",578,468,468,1,0,"FRONT REPUB",27
17,"17060",408,311,311,1,0,"FRONT REPUB",15
8,"8254",1753,1485,1482,3,3,"FRONT REPUB",107
17,"17082",436,341,339,0,2,"FRONT REPUB",9
8,"8184",54876,41661,41447,248,214,"FRONT REPUB",714
8,"8171",2066,1607,1597,7,10,"FRONT REPUB",95
8,"8148",2334,1803,1794,6,9,"FRONT REPUB",32
43,"43049",727,589,584,2,5,"FRONT REPUB",27
17,"17184",1264,1068,1060,5,8,"FRONT REPUB",36
43,"43023",214,186,186,1,0,"FRONT REPUB",5
8,"8102",28794,22420,22317,92,103,"FRONT REPUB",790
8,"8234",3373,2742,2734,25,8,"FRONT REPUB",126
8,"8076",16497,12734,12667,82,67,"FRONT REPUB",241
43,"43150",1238,1034,1026,6,8,"FRONT REPUB",46
8,"8172",20417,16196,16144,88,52,"FRONT REPUB",569
8,"8217",25355,20935,20855,110,80,"FRONT REPUB",264
17,"17086",1745,1223,1210,7,13,"FRONT REPUB",27
43,"43118",425,357,356,0,1,"FRONT REPUB",18
8,"8258",813,661,657,6,4,"FRONT REPUB",58
17,"17004",533,445,441,3,4,"FRONT REPUB",25
43,"43151",109,98,98,0,0,"FRONT REPUB",6
8,"8039",402,334,334,2,0,"FRONT REPUB",28
8,"8235",3829,3176,3167,14,9,"FRONT REPUB",187
43,"43042",2198,1820,1816,8,4,"FRONT REPUB",47
8,"8100",2092,1792,1782,16,10,"FRONT REPUB",94
25,"25904",162,147,147,3,0,"FRONT REPUB",4
17,"17152",11026,7610,7564,70,46,"FRONT REPUB",93
25,"25228",3115,2468,2459,19,9,"FRONT REPUB",27
25,"25201",110,89,89,0,0,"FRONT REPUB",3
8,"8210",4584,3455,3435,23,20,"FRONT REPUB",158
43,"43053",188,153,149,0,4,"FRONT REPUB",7
17,"17228",285,229,229,1,0,"FRONT REPUB",8
8,"8174",392,330,330,4,0,"FRONT REPUB",11
43,"43135",341,283,280,4,3,"FRONT REPUB",11
8,"8306",527,390,388,2,2,"FRONT REPUB",13
8,"8147",17282,13644,13560,94,84,"FRONT REPUB",384
25,"25905",369,308,307,1,1,"FRONT REPUB",11
17,"17206",155,118,115,0,3,"FRONT REPUB",13
17,"17069",364,286,284,2,2,"FRONT REPUB",15
8,"8066",1463,1185,1181,9,4,"FRONT REPUB",24
8,"8205",61279,51629,51497,360,132,"FRONT REPUB",1847
43,"43155",22619,16724,16624,101,100,"FRONT REPUB",301
17,"17029",199,160,157,1,3,"FRONT REPUB",15
43,"43013",4392,3341,3321,14,20,"FRONT REPUB",59
43,"43022",1435,1130,1123,8,7,"FRONT REPUB",15
25,"25251",713,562,558,4,4,"FRONT REPUB",14
43,"43112",250,204,204,1,0,"FRONT REPUB",24
25,"25110",2731,2121,2106,14,15,"FRONT REPUB",79
17,"17101",562,415,413,2,2,"FRONT REPUB",16
17,"17083",2961,2321,2300,12,21,"FRONT REPUB",52
43,"43129",4611,3528,3495,21,33,"FRONT REPUB",59
8,"8011",1745,1414,1407,10,7,"FRONT REPUB",100
8,"8272",165,133,133,0,0,"FRONT REPUB",19
8,"8237",1662,1334,1327,7,7,"FRONT REPUB",84
8,"8157",8547,6949,6918,39,31,"FRONT REPUB",107
8,"8194",25674,17691,17585,115,106,"FRONT REPUB",237
17,"17162",156,114,111,1,3,"FRONT REPUB",8
25,"25221",117,92,92,0,0,"FRONT REPUB",6
43,"43094",2120,1659,1646,9,13,"FRONT REPUB",41
17,"17114",23269,17558,17474,91,84,"FRONT REPUB",612
43,"43164",306,228,228,0,0,"FRONT REPUB",1
8,"8200",62161,48645,48330,261,315,"FRONT REPUB",609
8,"8028",1088,783,780,2,3,"FRONT REPUB",10
8,"8291",4919,3865,3854,28,11,"FRONT REPUB",73
25,"25013",2108,1570,1557,12,13,"FRONT REPUB",19
17,"17143",144,115,115,0,0,"FRONT REPUB",9
17,"17084",231,181,180,1,1,"FRONT REPUB",8
17,"17221",4152,3260,3247,11,13,"FRONT REPUB",78
17,"17901",983,790,789,3,1,"FRONT REPUB",57
8,"8220",2411,2119,2115,13,4,"FRONT REPUB",131
8,"8264",4535,3623,3613,13,10,"FRONT REPUB",95
25,"25035",366,306,302,2,4,"FRONT REPUB",3
17,"17183",255,216,216,0,0,"FRONT REPUB",14
25,"25232",1356,1066,1061,2,5,"FRONT REPUB",25
17,"17233",2328,1924,1912,6,12,"FRONT REPUB",77
17,"17211",831,694,691,1,3,"FRONT REPUB",63
8,"8001",9079,7383,7341,40,42,"FRONT REPUB",102
43,"43128",905,751,747,4,4,"FRONT REPUB",18
25,"25158",1606,1291,1277,5,14,"FRONT REPUB",43
43,"43144",1236,1025,1021,8,4,"FRONT REPUB",50
25,"25243",3730,2637,2606,20,31,"FRONT REPUB",24
43,"43904",2861,2083,2058,27,25,"FRONT REPUB",22
43,"43114",375,306,305,0,1,"FRONT REPUB",12
8,"8159",14323,11399,11359,57,40,"FRONT REPUB",194
43,"43163",26013,18942,18796,89,146,"FRONT REPUB",225
8,"8228",288,239,239,2,0,"FRONT REPUB",6
8,"8293",228,187,187,1,0,"FRONT REPUB",5
17,"17135",395,309,307,0,2,"FRONT REPUB",9
25,"25141",152,118,118,1,0,"FRONT REPUB",11
17,"17098",303,245,245,2,0,"FRONT REPUB",15
25,"25233",285,231,229,2,2,"FRONT REPUB",5
17,"17193",4312,3202,3179,15,23,"FRONT REPUB",77
8,"8283",6113,4832,4813,33,19,"FRONT REPUB",239
8,"8091",5413,4301,4283,20,18,"FRONT REPUB",152
43,"43107",383,308,308,1,0,"FRONT REPUB",9
17,"17125",131,98,97,1,1,"FRONT REPUB",10
8,"8267",6748,5389,5362,28,27,"FRONT REPUB",165
17,"17213",5535,3998,3985,20,13,"FRONT REPUB",139
17,"17234",179,147,146,2,1,"FRONT REPUB",11
8,"8077",34578,27617,27501,134,116,"FRONT REPUB",389
17,"17016",719,584,581,1,3,"FRONT REPUB",34
25,"25190",257,215,215,0,0,"FRONT REPUB",14
17,"17033",5587,4157,4130,13,27,"FRONT REPUB",153
25,"25169",167,118,117,0,1,"FRONT REPUB",9
25,"25037",366,286,284,3,2,"FRONT REPUB",16
25,"25168",488,408,407,6,1,"FRONT REPUB",13
43,"43089",281,209,208,0,1,"FRONT REPUB",9
8,"8117",2480,2055,2050,16,5,"FRONT REPUB",110
25,"25196",112,94,93,0,1,"FRONT REPUB",5
43,"43045",146,128,127,0,1,"FRONT REPUB",6
8,"8155",6960,5427,5390,39,37,"FRONT REPUB",104
43,"43157",345,303,303,0,0,"FRONT REPUB",13
25,"25079",285,228,227,0,1,"FRONT REPUB",5
17,"17157",124,107,107,0,0,"FRONT REPUB",6
8,"8023",6915,5339,5299,26,40,"FRONT REPUB",167
17,"17186",3824,3115,3098,15,17,"FRONT REPUB",142
43,"43018",385,335,334,3,1,"FRONT REPUB",4
8,"8153",559,460,458,2,2,"FRONT REPUB",34
43,"43161",17113,12944,12881,64,63,"FRONT REPUB",407
8,"8093",24,20,20,0,0,"FRONT REPUB",3
25,"25226",242,184,183,4,1,"FRONT REPUB",7
43,"43086",5263,4046,4021,17,25,"FRONT REPUB",124
8,"8075",4059,3127,3119,14,8,"FRONT REPUB",100
8,"8251",5127,3972,3940,17,32,"FRONT REPUB",58
25,"25048",1632,1274,1264,7,10,"FRONT REPUB",35
25,"25119",2245,1798,1792,10,6,"FRONT REPUB",46
17,"17038",380,312,308,3,4,"FRONT REPUB",14
43,"43005",3643,2765,2749,22,16,"FRONT REPUB",67
8,"8214",6966,5648,5633,21,15,"FRONT REPUB",221
8,"8116",558,459,459,0,0,"FRONT REPUB",25
43,"43068",483,367,365,5,2,"FRONT REPUB",9
8,"8085",976,812,811,2,1,"FRONT REPUB",24
43,"43076",460,378,377,2,1,"FRONT REPUB",17
25,"25138",547,440,436,1,4,"FRONT REPUB",12
43,"43060",2684,2158,2152,8,6,"FRONT REPUB",97
17,"17129",144,120,120,1,0,"FRONT REPUB",3
8,"8094",1586,1310,1306,10,4,"FRONT REPUB",44
43,"43126",1211,1005,999,4,6,"FRONT REPUB",36
8,"8137",274,232,229,0,3,"FRONT REPUB",5
8,"8005",6380,5122,5106,18,16,"FRONT REPUB",156
43,"43115",128,112,111,1,1,"FRONT REPUB",8
17,"17130",322,268,268,0,0,"FRONT REPUB",14
43,"43004",6274,4744,4691,39,53,"FRONT REPUB",109
43,"43077",455,342,339,2,3,"FRONT REPUB",0
43,"43102",463,384,379,2,5,"FRONT REPUB",2
8,"8236",1557,1204,1202,2,2,"FRONT REPUB",51
17,"17102",548,439,435,3,4,"FRONT REPUB",19
8,"8183",4563,3628,3613,9,15,"FRONT REPUB",162
43,"43064",2017,1569,1558,9,11,"FRONT REPUB",38
17,"17071",1128,978,978,3,0,"FRONT REPUB",62
43,"43137",1905,1515,1499,15,16,"FRONT REPUB",35
8,"8095",67,53,52,0,1,"FRONT REPUB",3
17,"17068",246,194,193,0,1,"FRONT REPUB",5
8,"8112",12935,9822,9765,74,57,"FRONT REPUB",408
25,"25172",1779,1407,1405,3,2,"FRONT REPUB",33
25,"25021",2541,1891,1882,14,9,"FRONT REPUB",55
8,"8078",219,176,172,1,4,"FRONT REPUB",13
25,"25001",139,104,103,1,1,"FRONT REPUB",4
8,"8904",10514,7733,7697,38,36,"FRONT REPUB",66
17,"17048",6251,4565,4537,20,28,"FRONT REPUB",71
43,"43062",259,223,220,2,3,"FRONT REPUB",7
43,"43065",382,308,304,1,4,"FRONT REPUB",9
17,"17058",170,139,139,0,0,"FRONT REPUB",18
43,"43030",482,373,372,2,1,"FRONT REPUB",4
17,"17190",838,681,677,0,4,"FRONT REPUB",40
43,"43136",10463,7789,7749,36,40,"FRONT REPUB",194
17,"17015",12819,10133,10078,38,55,"FRONT REPUB",386
8,"8090",137,113,113,2,0,"FRONT REPUB",0
25,"25031",57,39,39,0,0,"FRONT REPUB",0
25,"25185",679,493,491,6,2,"FRONT REPUB",12
25,"25173",1649,1278,1262,5,16,"FRONT REPUB",38
43,"43104",1762,1410,1401,5,9,"FRONT REPUB",51
43,"43055",1988,1631,1622,7,9,"FRONT REPUB",57
17,"17142",2673,2250,2241,14,9,"FRONT REPUB",82
8,"8122",1716,1260,1254,8,6,"FRONT REPUB",65
8,"8203",2472,1884,1873,4,11,"FRONT REPUB",90
43,"43014",14357,10596,10542,60,54,"FRONT REPUB",197
43,"43907",4359,3370,3346,22,24,"FRONT REPUB",25
17,"17089",5695,4211,4194,13,17,"FRONT REPUB",133
25,"25081",287,221,220,2,1,"FRONT REPUB",8
25,"25139",491,390,388,3,2,"FRONT REPUB",8
17,"17121",229,184,184,1,0,"FRONT REPUB",11
17,"17182",272,220,220,3,0,"FRONT REPUB",2
25,"25124",157,114,114,0,0,"FRONT REPUB",5
25,"25100",184,145,144,1,1,"FRONT REPUB",7
17,"17021",122,98,98,0,0,"FRONT REPUB",12
25,"25063",95,61,61,0,0,"FRONT REPUB",1
25,"25003",3721,2828,2815,19,13,"FRONT REPUB",62
17,"17204",596,461,460,2,1,"FRONT REPUB",9
17,"17165",634,516,512,3,4,"FRONT REPUB",22
17,"17087",222,177,176,0,1,"FRONT REPUB",16
25,"25153",192,152,150,1,2,"FRONT REPUB",6
8,"8037",1930,1618,1610,10,8,"FRONT REPUB",109
8,"8256",691,571,568,3,3,"FRONT REPUB",0
8,"8124",37130,29069,28915,146,154,"FRONT REPUB",399
25,"25004",575,470,467,2,3,"FRONT REPUB",8
8,"8204",3115,2548,2534,22,14,"FRONT REPUB",39
17,"17062",5978,4358,4334,26,24,"FRONT REPUB",188
17,"17150",1426,1199,1192,8,7,"FRONT REPUB",46
17,"17055",143,126,125,0,1,"FRONT REPUB",13
43,"43067",528,450,445,1,5,"FRONT REPUB",5
17,"17225",207,161,161,0,0,"FRONT REPUB",5
43,"43008",307,202,200,1,2,"FRONT REPUB",0
8,"8274",4674,3710,3698,12,12,"FRONT REPUB",118
25,"25076",134,94,93,0,1,"FRONT REPUB",5
8,"8168",394,287,287,1,0,"FRONT REPUB",13
43,"43169",450,396,396,3,0,"FRONT REPUB",21
8,"8044",4136,3193,3175,11,18,"FRONT REPUB",122
8,"8035",12871,9574,9538,31,36,"FRONT REPUB",359
8,"8223",1886,1434,1425,4,9,"FRONT REPUB",54
8,"8073",62572,48770,48527,255,243,"FRONT REPUB",566
17,"17012",1171,916,914,10,2,"FRONT REPUB",16
17,"17023",27144,20301,20146,120,155,"FRONT REPUB",388
8,"8178",451,389,388,3,1,"FRONT REPUB",20
43,"43148",90763,69756,69423,299,333,"FRONT REPUB",1186
8,"8014",2000,1578,1567,5,11,"FRONT REPUB",59
8,"8249",272,248,248,2,0,"FRONT REPUB",9
25,"25248",880,714,713,4,1,"FRONT REPUB",26
17,"17194",78,62,62,0,0,"FRONT REPUB",8
17,"17063",173,157,156,2,1,"FRONT REPUB",13
25,"25040",10614,7791,7734,58,57,"FRONT REPUB",207
8,"8179",611,496,493,2,3,"FRONT REPUB",9
25,"25025",1378,996,983,8,13,"FRONT REPUB",17
8,"8206",737,625,624,3,1,"FRONT REPUB",30
8,"8143",2719,2121,2109,10,12,"FRONT REPUB",43
17,"17075",334,282,281,5,1,"FRONT REPUB",26
8,"8198",4640,3713,3691,23,22,"FRONT REPUB",192
43,"43092",7235,5200,5174,21,26,"FRONT REPUB",56
17,"17208",976,772,768,5,4,"FRONT REPUB",43
25,"25907",497,389,386,2,3,"FRONT REPUB",23
8,"8177",39,31,31,0,0,"FRONT REPUB",4
8,"8034",784,648,646,1,2,"FRONT REPUB",57
25,"25038",1482,1111,1094,11,17,"FRONT REPUB",14
25,"25078",1001,807,805,5,2,"FRONT REPUB",22
8,"8110",13592,10111,10058,50,53,"FRONT REPUB",274
25,"25170",261,230,228,4,2,"FRONT REPUB",6
8,"8294",2063,1644,1643,10,1,"FRONT REPUB",101
17,"17005",460,336,331,0,5,"FRONT REPUB",20
25,"25204",1191,936,930,5,6,"FRONT REPUB",6
43,"43176",746,588,586,7,2,"FRONT REPUB",9
43,"43168",84,65,65,1,0,"FRONT REPUB",3
43,"43120",421,302,297,2,5,"FRONT REPUB",5
17,"17085",291,248,246,0,2,"FRONT REPUB",23
8,"8119",6838,5352,5326,31,26,"FRONT REPUB",90
43,"43084",521,424,423,2,1,"FRONT REPUB",12
25,"25205",562,451,447,7,4,"FRONT REPUB",7
8,"8268",971,746,737,3,9,"FRONT REPUB",11
17,"17138",845,650,646,0,4,"FRONT REPUB",12
25,"25202",108,75,75,0,0,"FRONT REPUB",5
8,"8041",10692,7805,7732,48,73,"FRONT REPUB",77
43,"43158",77,61,61,1,0,"FRONT REPUB",2
8,"8067",5728,4535,4513,21,22,"FRONT REPUB",200
8,"8024",357,301,298,1,3,"FRONT REPUB",12
25,"25129",159,115,115,2,0,"FRONT REPUB",5
8,"8304",816,686,678,1,8,"FRONT REPUB",30
17,"17026",543,450,449,4,1,"FRONT REPUB",26
8,"8278",4893,4034,4018,17,16,"FRONT REPUB",209
25,"25150",165,136,133,0,3,"FRONT REPUB",2
8,"8042",2362,1910,1904,7,6,"FRONT REPUB",59
43,"43905",14941,10510,10446,40,64,"FRONT REPUB",97
8,"8053",2865,2105,2098,17,7,"FRONT REPUB",35
17,"17188",169,139,138,1,1,"FRONT REPUB",10
25,"25161",343,243,243,0,0,"FRONT REPUB",8
43,"43110",251,184,184,1,0,"FRONT REPUB",4
25,"25218",86,79,79,0,0,"FRONT REPUB",3
43,"43036",865,605,602,1,3,"FRONT REPUB",24
8,"8218",8104,6419,6389,34,30,"FRONT REPUB",149
25,"25032",67,53,53,0,0,"FRONT REPUB",1
8,"8221",12699,10571,10537,53,34,"FRONT REPUB",348
17,"17099",78,59,59,0,0,"FRONT REPUB",1
17,"17175",564,381,381,1,0,"FRONT REPUB",10
17,"17118",12916,9521,9460,37,61,"FRONT REPUB",253
25,"25097",84,72,72,1,0,"FRONT REPUB",0
25,"25050",3269,2457,2446,23,11,"FRONT REPUB",71
17,"17140",639,539,527,4,12,"FRONT REPUB",11
25,"25121",635,436,429,1,7,"FRONT REPUB",6
43,"43029",314,253,252,0,1,"FRONT REPUB",8
17,"17170",180,147,147,2,0,"FRONT REPUB",8
8,"8104",653,516,516,2,0,"FRONT REPUB",38
25,"25216",241,199,199,2,0,"FRONT REPUB",10
43,"43035",235,205,203,7,2,"FRONT REPUB",7
8,"8225",94,81,81,1,0,"FRONT REPUB",4
43,"43103",905,746,740,8,6,"FRONT REPUB",5
25,"25051",1510,1176,1172,6,4,"FRONT REPUB",52
25,"25253",145,122,121,0,1,"FRONT REPUB",4
17,"17180",8500,6462,6431,28,31,"FRONT REPUB",274
25,"25062",695,578,573,3,5,"FRONT REPUB",18
17,"17079",65381,50872,50631,242,241,"FRONT REPUB",2478
17,"17167",2609,2122,2102,14,20,"FRONT REPUB",101
25,"25140",773,573,571,5,2,"FRONT REPUB",16
43,"43079",356,306,305,1,1,"FRONT REPUB",4
8,"8202",12843,10074,10025,57,49,"FRONT REPUB",480
43,"43038",21861,16504,16406,112,98,"FRONT REPUB",244
8,"8061",1590,1236,1233,8,3,"FRONT REPUB",18
25,"25132",143,118,118,0,0,"FRONT REPUB",0
8,"8070",266,232,232,0,0,"FRONT REPUB",17
8,"8255",137,105,105,1,0,"FRONT REPUB",13
8,"8134",842,649,646,3,3,"FRONT REPUB",37
17,"17133",1273,1048,1043,7,5,"FRONT REPUB",46
25,"25056",213,163,163,3,0,"FRONT REPUB",3
8,"8290",1534,1289,1284,9,5,"FRONT REPUB",49
43,"43072",93,74,74,0,0,"FRONT REPUB",2
43,"43071",891,713,706,6,7,"FRONT REPUB",12
8,"8106",7469,5816,5795,34,21,"FRONT REPUB",197
17,"17134",223,189,189,1,0,"FRONT REPUB",19
43,"43048",763,614,609,7,5,"FRONT REPUB",13
25,"25044",178,145,144,6,1,"FRONT REPUB",3
43,"43903",2333,1717,1700,11,17,"FRONT REPUB",15
17,"17013",2774,2180,2173,15,7,"FRONT REPUB",44
8,"8025",1535,1221,1214,7,7,"FRONT REPUB",62
25,"25215",505,299,299,4,0,"FRONT REPUB",7
8,"8071",241,200,200,0,0,"FRONT REPUB",9
17,"17037",114,98,98,6,0,"FRONT REPUB",4
25,"25249",176,139,138,1,1,"FRONT REPUB",4
43,"43097",399,341,341,1,0,"FRONT REPUB",17
43,"43113",397,325,323,2,2,"FRONT REPUB",13
17,"17091",398,310,305,2,5,"FRONT REPUB",10
8,"8133",128,98,98,5,0,"FRONT REPUB",2
43,"43054",2792,2145,2134,21,11,"FRONT REPUB",69
8,"8060",135,111,109,0,2,"FRONT REPUB",7
8,"8271",67,57,57,0,0,"FRONT REPUB",9
43,"43171",14705,11002,10956,62,46,"FRONT REPUB",102
17,"17002",564,491,488,3,3,"FRONT REPUB",32
17,"17202",3813,2876,2851,8,25,"FRONT REPUB",81
25,"25088",95,85,83,0,2,"FRONT REPUB",0
43,"43040",326,278,276,0,2,"FRONT REPUB",14
17,"17112",194,154,152,2,2,"FRONT REPUB",8
25,"25244",362,296,294,2,2,"FRONT REPUB",10
25,"25114",95,79,79,0,0,"FRONT REPUB",2
25,"25036",184,144,143,0,1,"FRONT REPUB",3
17,"17164",3932,3078,3054,8,24,"FRONT REPUB",145
43,"43139",1999,1552,1539,10,13,"FRONT REPUB",57
43,"43131",4772,3432,3401,18,31,"FRONT REPUB",19
8,"8901",240,203,201,1,2,"FRONT REPUB",7
8,"8125",25485,19719,19627,101,92,"FRONT REPUB",259
25,"25102",661,517,511,8,6,"FRONT REPUB",8
25,"25135",1000,773,769,2,4,"FRONT REPUB",14
25,"25070",811,677,675,4,2,"FRONT REPUB",23
8,"8197",7896,6197,6174,28,23,"FRONT REPUB",138
8,"8050",136,115,114,0,1,"FRONT REPUB",5
25,"25049",155,113,111,0,2,"FRONT REPUB",7
25,"25902",542,449,439,3,10,"FRONT REPUB",24
8,"8021",61,47,45,0,2,"FRONT REPUB",0
8,"8209",6896,5269,5244,25,25,"FRONT REPUB",120
43,"43001",694,543,543,5,0,"FRONT REPUB",9
17,"17074",532,436,426,2,10,"FRONT REPUB",16
8,"8284",12482,8959,8887,41,72,"FRONT REPUB",172
43,"43061",38,28,28,0,0,"FRONT REPUB",0
25,"25109",214,179,176,3,3,"FRONT REPUB",5
25,"25123",189,151,151,0,0,"FRONT REPUB",4
8,"8018",2551,1998,1984,6,14,"FRONT REPUB",68
43,"43143",51,45,44,0,1,"FRONT REPUB",1
25,"25194",415,325,325,3,0,"FRONT REPUB",12
25,"25061",80,59,58,0,1,"FRONT REPUB",2
43,"43083",144,116,113,1,3,"FRONT REPUB",1
43,"43075",86,71,69,0,2,"FRONT REPUB",0
43,"43002",1875,1367,1348,11,19,"FRONT REPUB",13
17,"17166",547,460,459,2,1,"FRONT REPUB",26
43,"43078",843,653,644,4,9,"FRONT REPUB",13
8,"8903",197,177,176,0,1,"FRONT REPUB",11
17,"17205",211,184,184,1,0,"FRONT REPUB",9
25,"25225",541,427,420,4,7,"FRONT REPUB",11
43,"43059",250,214,214,1,0,"FRONT REPUB",9
17,"17025",1170,972,967,6,5,"FRONT REPUB",71
17,"17105",247,194,194,1,0,"FRONT REPUB",18
17,"17128",316,255,252,1,3,"FRONT REPUB",15
17,"17116",354,283,282,0,1,"FRONT REPUB",27
17,"17177",567,459,457,2,2,"FRONT REPUB",5
8,"8145",2701,2156,2144,7,12,"FRONT REPUB",75
17,"17076",122,101,100,1,1,"FRONT REPUB",7
25,"25030",123,90,90,1,0,"FRONT REPUB",6
8,"8154",701,587,586,5,1,"FRONT REPUB",29
8,"8191",5270,4176,4162,19,14,"FRONT REPUB",172
17,"17095",19938,13998,13918,69,80,"FRONT REPUB",179
17,"17067",697,581,578,4,3,"FRONT REPUB",22
25,"25240",1385,1116,1110,10,6,"FRONT REPUB",30
25,"25193",767,614,606,6,8,"FRONT REPUB",45
17,"17124",1599,1258,1254,6,4,"FRONT REPUB",53
25,"25082",295,229,229,2,0,"FRONT REPUB",7
17,"17052",134,104,104,1,0,"FRONT REPUB",4
25,"25105",103,89,88,1,1,"FRONT REPUB",0
17,"17106",143,124,123,0,1,"FRONT REPUB",4
8,"8296",1843,1520,1514,10,6,"FRONT REPUB",49
8,"8086",14017,10746,10677,89,69,"FRONT REPUB",226
17,"17096",164,113,113,1,0,"FRONT REPUB",8
17,"17046",710,574,571,3,3,"FRONT REPUB",17
43,"43015",119,101,101,0,0,"FRONT REPUB",5
43,"43039",105,85,85,0,0,"FRONT REPUB",12
43,"43172",337,261,257,2,4,"FRONT REPUB",7
8,"8227",2410,1882,1877,10,5,"FRONT REPUB",69
43,"43119",838,630,628,4,2,"FRONT REPUB",22
8,"8138",4432,3435,3413,10,22,"FRONT REPUB",220
8,"8051",18437,14951,14887,85,64,"FRONT REPUB",429
17,"17169",2497,2047,2042,8,5,"FRONT REPUB",88
25,"25010",196,156,155,2,1,"FRONT REPUB",6
17,"17078",336,252,251,3,1,"FRONT REPUB",12
8,"8087",149,135,133,0,2,"FRONT REPUB",15
8,"8046",13478,10989,10939,67,50,"FRONT REPUB",571
8,"8010",4207,3327,3304,13,23,"FRONT REPUB",233
43,"43037",17902,12787,12695,63,92,"FRONT REPUB",162
25,"25151",736,592,584,1,8,"FRONT REPUB",23
25,"25122",1925,1505,1497,23,8,"FRONT REPUB",39
8,"8288",1676,1196,1182,6,14,"FRONT REPUB",25
8,"8130",108,89,86,2,3,"FRONT REPUB",5
17,"17028",297,238,237,1,1,"FRONT REPUB",15
8,"8175",3368,2496,2486,16,10,"FRONT REPUB",94
8,"8248",5616,4378,4365,32,13,"FRONT REPUB",106
17,"17218",570,468,465,5,3,"FRONT REPUB",31
17,"17161",1018,859,855,1,4,"FRONT REPUB",60
25,"25042",208,160,160,1,0,"FRONT REPUB",3
8,"8113",52518,39750,39592,198,158,"FRONT REPUB",1614
8,"8131",741,585,585,4,0,"FRONT REPUB",44
17,"17151",185,150,150,1,0,"FRONT REPUB",9
25,"25131",402,321,320,1,1,"FRONT REPUB",3
17,"17200",623,512,510,1,2,"FRONT REPUB",46
8,"8079",334,284,282,0,2,"FRONT REPUB",23
8,"8059",344,292,290,2,2,"FRONT REPUB",15
25,"25015",335,262,260,8,2,"FRONT REPUB",8
25,"25006",317,246,245,3,1,"FRONT REPUB",9
8,"8240",9453,7807,7776,21,31,"FRONT REPUB",268
8,"8281",4840,4009,3998,23,11,"FRONT REPUB",162
43,"43047",4209,2878,2856,23,22,"FRONT REPUB",48
43,"43017",116,98,98,1,0,"FRONT REPUB",8
8,"8080",39,30,30,0,0,"FRONT REPUB",1
25,"25165",276,221,219,1,2,"FRONT REPUB",12
25,"25142",365,300,299,2,1,"FRONT REPUB",9
8,"8083",1672,1478,1471,7,7,"FRONT REPUB",125
43,"43091",123,93,93,1,0,"FRONT REPUB",6
17,"17189",1476,1278,1275,2,3,"FRONT REPUB",92
43,"43105",156,132,132,3,0,"FRONT REPUB",19
25,"25130",183,142,140,0,2,"FRONT REPUB",6
43,"43044",3949,3060,3032,31,28,"FRONT REPUB",60
8,"8279",155280,121081,120515,802,566,"FRONT REPUB",2708
17,"17065",324,254,253,0,1,"FRONT REPUB",19
25,"25189",2164,1591,1583,11,8,"FRONT REPUB",36
43,"43010",337,286,284,2,2,"FRONT REPUB",7
25,"25087",56,49,49,0,0,"FRONT REPUB",6
17,"17094",1068,772,766,1,6,"FRONT REPUB",20
25,"25167",226,185,185,2,0,"FRONT REPUB",15
25,"25045",54,31,31,5,0,"FRONT REPUB",0
25,"25176",307,262,259,1,3,"FRONT REPUB",6
43,"43901",8750,6057,6004,43,53,"FRONT REPUB",65
17,"17222",105,95,95,1,0,"FRONT REPUB",6
17,"17212",142,117,117,2,0,"FRONT REPUB",8
8,"8055",541,443,442,2,1,"FRONT REPUB",29
8,"8265",1590,1339,1334,6,5,"FRONT REPUB",105
8,"8032",2087,1607,1598,9,9,"FRONT REPUB",63
43,"43123",71092,53689,53369,241,320,"FRONT REPUB",1105
17,"17092",3467,2660,2633,17,27,"FRONT REPUB",60
8,"8038",1525,1228,1220,2,8,"FRONT REPUB",40
43,"43147",521,446,442,4,4,"FRONT REPUB",21
25,"25177",358,270,268,1,2,"FRONT REPUB",11
8,"8047",3737,2903,2876,16,27,"FRONT REPUB",96
17,"17158",468,337,336,1,1,"FRONT REPUB",11
25,"25089",97,72,71,1,1,"FRONT REPUB",6
8,"8243",156,139,139,0,0,"FRONT REPUB",4
8,"8260",18400,14471,14406,87,65,"FRONT REPUB",180
8,"8033",13218,10480,10435,50,45,"FRONT REPUB",406
17,"17070",110,94,94,0,0,"FRONT REPUB",2
17,"17154",99,84,83,0,1,"FRONT REPUB",8
17,"17197",131,113,113,1,0,"FRONT REPUB",3
25,"25206",250,189,188,2,1,"FRONT REPUB",8
25,"25009",605,505,491,5,14,"FRONT REPUB",12
25,"25041",528,399,396,4,3,"FRONT REPUB",7
25,"25115",801,638,637,4,1,"FRONT REPUB",9
43,"43028",2766,2007,1988,7,19,"FRONT REPUB",46
8,"8192",5679,4605,4589,20,16,"FRONT REPUB",215
17,"17159",626,487,483,1,4,"FRONT REPUB",23
8,"8115",3825,2994,2975,12,19,"FRONT REPUB",46
25,"25179",171,134,134,1,0,"FRONT REPUB",5
43,"43175",537,426,419,5,7,"FRONT REPUB",17
8,"8040",11004,8468,8431,24,37,"FRONT REPUB",329
25,"25207",6430,4899,4867,41,32,"FRONT REPUB",213
17,"17008",3594,2763,2741,16,22,"FRONT REPUB",139
25,"25148",219,168,168,1,0,"FRONT REPUB",3
43,"43085",235,198,194,0,4,"FRONT REPUB",8
17,"17214",723,584,580,7,4,"FRONT REPUB",23
25,"25219",149,118,118,1,0,"FRONT REPUB",17
17,"17107",269,221,219,2,2,"FRONT REPUB",5
17,"17137",3467,2925,2912,15,13,"FRONT REPUB",126
25,"25118",327,241,239,2,2,"FRONT REPUB",8
17,"17195",342,296,295,3,1,"FRONT REPUB",11
25,"25017",232,184,181,0,3,"FRONT REPUB",4
43,"43133",5605,4202,4168,21,34,"FRONT REPUB",76
8,"8045",71,52,49,0,3,"FRONT REPUB",4
8,"8127",2240,1694,1683,13,11,"FRONT REPUB",55
25,"25002",467,357,356,2,1,"FRONT REPUB",29
43,"43043",3289,2624,2613,14,11,"FRONT REPUB",77
43,"43174",144,128,127,0,1,"FRONT REPUB",11
8,"8286",2919,2210,2199,15,11,"FRONT REPUB",46
8,"8199",651,542,542,4,0,"FRONT REPUB",21
17,"17903",889,726,721,4,5,"FRONT REPUB",28
8,"8008",179,139,138,0,1,"FRONT REPUB",7
25,"25098",232,172,170,2,2,"FRONT REPUB",4
43,"43093",3884,2956,2933,14,23,"FRONT REPUB",87
17,"17120",820,604,598,3,6,"FRONT REPUB",16
8,"8128",577,454,451,0,3,"FRONT REPUB",41
43,"43160",1322,1051,1045,0,6,"FRONT REPUB",24
25,"25186",207,174,173,7,1,"FRONT REPUB",14
8,"8036",163,134,133,0,1,"FRONT REPUB",4
8,"8030",5209,4318,4305,16,13,"FRONT REPUB",148
8,"8307",49310,38223,38022,162,201,"FRONT REPUB",1297
8,"8132",361,281,281,2,0,"FRONT REPUB",17
17,"17198",433,332,329,0,3,"FRONT REPUB",17
17,"17210",580,449,445,2,4,"FRONT REPUB",22
17,"17201",143,120,120,0,0,"FRONT REPUB",6
25,"25012",2342,1748,1739,10,9,"FRONT REPUB",54
8,"8031",2336,1886,1882,11,4,"FRONT REPUB",72
8,"8089",34019,26317,26191,170,126,"FRONT REPUB",307
43,"43003",350,266,264,3,2,"FRONT REPUB",10
8,"8193",984,792,790,5,2,"FRONT REPUB",26
17,"17022",7008,5386,5354,22,32,"FRONT REPUB",276
25,"25096",888,663,661,2,2,"FRONT REPUB",17
8,"8103",640,507,505,4,2,"FRONT REPUB",28
8,"8161",11625,8521,8470,44,51,"FRONT REPUB",180
17,"17097",199,172,170,1,2,"FRONT REPUB",28
43,"43146",41,35,35,0,0,"FRONT REPUB",5
43,"43122",111,98,97,0,1,"FRONT REPUB",2
17,"17119",73,58,58,2,0,"FRONT REPUB",8
25,"25208",333,252,249,0,3,"FRONT REPUB",16
25,"25164",357,264,261,4,3,"FRONT REPUB",1
25,"25174",390,324,324,0,0,"FRONT REPUB",6
8,"8299",377,318,317,0,1,"FRONT REPUB",25
8,"8212",491,406,402,1,4,"FRONT REPUB",21
25,"25154",118,94,94,0,0,"FRONT REPUB",2
8,"8020",5172,4337,4327,26,10,"FRONT REPUB",154
25,"25005",274,202,202,2,0,"FRONT REPUB",8
8,"8082",1143,868,861,4,7,"FRONT REPUB",12
43,"43073",84,68,67,0,1,"FRONT REPUB",0
17,"17132",1333,1088,1080,9,8,"FRONT REPUB",49
25,"25086",521,414,411,2,3,"FRONT REPUB",23
8,"8064",1920,1516,1506,6,10,"FRONT REPUB",63
25,"25073",546,420,418,2,2,"FRONT REPUB",9
43,"43101",145,122,122,1,0,"FRONT REPUB",12
43,"43090",1169,749,742,2,7,"FRONT REPUB",8
8,"8257",103,86,86,1,0,"FRONT REPUB",6
25,"25155",618,493,489,2,4,"FRONT REPUB",16
8,"8246",1672,1412,1406,7,6,"FRONT REPUB",88
17,"17174",162,132,132,4,0,"FRONT REPUB",16
17,"17047",4968,3447,3429,22,18,"FRONT REPUB",134
43,"43134",273,224,223,5,1,"FRONT REPUB",7
43,"43145",4209,3409,3391,9,18,"FRONT REPUB",125
17,"17030",650,479,477,4,2,"FRONT REPUB",17
43,"43020",2276,1831,1819,12,12,"FRONT REPUB",23
17,"17050",674,585,582,5,3,"FRONT REPUB",51
8,"8276",233,180,180,0,0,"FRONT REPUB",12
8,"8163",19497,14616,14548,67,68,"FRONT REPUB",253
17,"17209",615,519,517,2,2,"FRONT REPUB",17
17,"17171",172,143,141,0,2,"FRONT REPUB",11
17,"17230",499,397,393,0,4,"FRONT REPUB",8
8,"8262",6919,5090,5060,33,30,"FRONT REPUB",132
8,"8305",27533,21656,21539,96,117,"FRONT REPUB",807
8,"8026",193,161,161,1,0,"FRONT REPUB",8
43,"43173",99,80,78,0,2,"FRONT REPUB",9
8,"8250",7182,5461,5421,38,40,"FRONT REPUB",71
25,"25238",205,163,163,2,0,"FRONT REPUB",12
43,"43016",3445,2628,2608,11,20,"FRONT REPUB",45
8,"8196",19444,15361,15263,90,98,"FRONT REPUB",150
43,"43098",354,291,291,1,0,"FRONT REPUB",8
25,"25053",1092,879,873,8,6,"FRONT REPUB",16
25,"25157",162,137,137,4,0,"FRONT REPUB",1
25,"25029",1607,1270,1265,6,5,"FRONT REPUB",46
8,"8167",6048,4833,4822,48,11,"FRONT REPUB",32
8,"8224",878,697,695,1,2,"FRONT REPUB",32
8,"8068",6878,5456,5437,25,19,"FRONT REPUB",107
8,"8049",1320,981,977,5,4,"FRONT REPUB",50
25,"25217",10819,8163,8120,64,43,"FRONT REPUB",303
17,"17187",625,530,529,4,1,"FRONT REPUB",35
43,"43057",38,31,31,1,0,"FRONT REPUB",1
17,"17203",165,135,135,0,0,"FRONT REPUB",15
17,"17066",27323,18373,18269,98,104,"FRONT REPUB",495
25,"25059",813,621,612,3,9,"FRONT REPUB",1
17,"17217",353,312,311,1,1,"FRONT REPUB",52
8,"8269",2712,2258,2250,19,8,"FRONT REPUB",109
17,"17039",1740,1385,1380,8,5,"FRONT REPUB",58
17,"17103",5084,3575,3543,13,32,"FRONT REPUB",96
25,"25143",84,72,71,0,1,"FRONT REPUB",2
25,"25911",424,332,331,1,1,"FRONT REPUB",16
17,"17018",494,405,402,1,3,"FRONT REPUB",27
17,"17149",364,314,314,0,0,"FRONT REPUB",38
8,"8253",128,113,113,0,0,"FRONT REPUB",7
25,"25906",210,157,155,0,2,"FRONT REPUB",0
43,"43178",1421,1118,1113,7,5,"FRONT REPUB",15
17,"17036",2643,2076,2071,12,5,"FRONT REPUB",75
17,"17227",139,106,106,0,0,"FRONT REPUB",8
8,"8002",220,184,183,2,1,"FRONT REPUB",17
43,"43162",4418,3467,3453,20,14,"FRONT REPUB",46
8,"8219",15629,12910,12865,58,45,"FRONT REPUB",535
25,"25034",2288,1733,1719,9,14,"FRONT REPUB",41
25,"25230",1555,1221,1208,8,13,"FRONT REPUB",17
8,"8144",713,565,563,5,2,"FRONT REPUB",29
8,"8230",7666,6202,6168,30,34,"FRONT REPUB",181
25,"25024",352,273,272,0,1,"FRONT REPUB",2
17,"17073",1939,1695,1693,7,2,"FRONT REPUB",86
17,"17160",14733,10833,10766,43,67,"FRONT REPUB",183
25,"25072",5874,4468,4450,24,18,"FRONT REPUB",179
8,"8244",6041,4994,4970,33,24,"FRONT REPUB",129
8,"8216",25,19,19,0,0,"FRONT REPUB",0
25,"25255",395,321,318,2,3,"FRONT REPUB",8
8,"8029",3560,3027,3019,13,8,"FRONT REPUB",113
25,"25171",2127,1639,1630,8,9,"FRONT REPUB",65
8,"8297",135,111,111,1,0,"FRONT REPUB",4
8,"8187",153380,120687,120090,637,597,"FRONT REPUB",3337
43,"43024",1556,1154,1137,3,17,"FRONT REPUB",20
8,"8201",447,327,324,5,3,"FRONT REPUB",6
17,"17207",2411,2006,1992,8,14,"FRONT REPUB",64
43,"43167",384,334,333,2,1,"FRONT REPUB",10
25,"25134",603,492,490,1,2,"FRONT REPUB",8
8,"8111",215,200,199,4,1,"FRONT REPUB",15
17,"17009",4051,3263,3248,14,15,"FRONT REPUB",252
17,"17109",698,558,553,1,5,"FRONT REPUB",49
8,"8007",6775,5447,5419,21,28,"FRONT REPUB",267
25,"25074",180,157,155,2,2,"FRONT REPUB",8
43,"43081",633,532,531,7,1,"FRONT REPUB",16
43,"43021",345,270,269,3,1,"FRONT REPUB",10
8,"8052",139,111,110,0,1,"FRONT REPUB",6
8,"8263",21151,16360,16269,116,91,"FRONT REPUB",173
17,"17051",207,174,173,3,1,"FRONT REPUB",19
8,"8300",5892,4912,4880,24,32,"FRONT REPUB",135
8,"8092",3714,2912,2889,8,23,"FRONT REPUB",164
8,"8123",19489,16197,16135,58,62,"FRONT REPUB",503
17,"17216",155,127,124,0,3,"FRONT REPUB",14
43,"43063",536,401,397,1,4,"FRONT REPUB",7
8,"8081",353,299,297,2,2,"FRONT REPUB",21
25,"25099",1291,981,978,2,3,"FRONT REPUB",27
8,"8270",18837,14541,14497,66,44,"FRONT REPUB",350
8,"8176",161,132,131,2,1,"FRONT REPUB",7
25,"25163",236,181,179,3,2,"FRONT REPUB",9
25,"25211",672,513,512,6,1,"FRONT REPUB",10
8,"8277",171,150,150,0,0,"FRONT REPUB",10
8,"8150",251,211,211,0,0,"FRONT REPUB",6
8,"8282",6711,5696,5677,27,19,"FRONT REPUB",205
17,"17040",551,465,459,4,6,"FRONT REPUB",34
17,"17043",167,135,134,0,1,"FRONT REPUB",7
43,"43108",1778,1374,1365,6,9,"FRONT REPUB",50
25,"25047",972,784,781,8,3,"FRONT REPUB",28
25,"25908",221,159,158,1,1,"FRONT REPUB",3
8,"8121",87292,67638,67328,362,310,"FRONT REPUB",1753
25,"25071",42,32,31,0,1,"FRONT REPUB",1
17,"17041",218,166,165,3,1,"FRONT REPUB",5
17,"17032",1742,1235,1224,6,11,"FRONT REPUB",34
17,"17027",2866,2375,2364,8,11,"FRONT REPUB",103
25,"25101",543,454,449,1,5,"FRONT REPUB",31
17,"17123",345,304,303,4,1,"FRONT REPUB",12
25,"25200",323,253,252,0,1,"FRONT REPUB",8
25,"25913",86,77,77,0,0,"FRONT REPUB",2
25,"25094",139,116,116,0,0,"FRONT REPUB",5
25,"25016",2083,1590,1587,8,3,"FRONT REPUB",35
8,"8164",934,784,776,1,8,"FRONT REPUB",49
43,"43152",434,357,356,0,1,"FRONT REPUB",4
8,"8208",5760,4660,4643,25,17,"FRONT REPUB",112
17,"17057",968,826,822,1,4,"FRONT REPUB",35
8,"8149",984,770,768,3,2,"FRONT REPUB",63
43,"43121",591,463,462,0,1,"FRONT REPUB",23
25,"25125",389,303,300,1,3,"FRONT REPUB",8
25,"25120",92704,68713,68361,445,352,"FRONT REPUB",1600
17,"17003",102,75,75,0,0,"FRONT REPUB",6
43,"43159",81,63,62,0,1,"FRONT REPUB",4
25,"25192",724,564,558,4,6,"FRONT REPUB",23
43,"43106",793,656,651,2,5,"FRONT REPUB",16
43,"43138",2648,1926,1896,8,30,"FRONT REPUB",29
8,"8009",9480,7649,7620,35,29,"FRONT REPUB",324
25,"25113",1116,912,908,8,4,"FRONT REPUB",27
25,"25210",1079,867,853,4,14,"FRONT REPUB",11
17,"17014",63,51,50,0,1,"FRONT REPUB",2
43,"43906",2103,1595,1587,14,8,"FRONT REPUB",34
17,"17153",188,162,162,0,0,"FRONT REPUB",20
43,"43080",227,195,195,0,0,"FRONT REPUB",7
25,"25247",147,100,100,2,0,"FRONT REPUB",1
43,"43032",466,379,379,1,0,"FRONT REPUB",4
17,"17176",123,110,110,1,0,"FRONT REPUB",2
17,"17144",210,171,170,0,1,"FRONT REPUB",7
25,"25242",689,539,531,0,8,"FRONT REPUB",33
17,"17173",182,156,156,0,0,"FRONT REPUB",21
25,"25183",535,419,416,4,3,"FRONT REPUB",20
8,"8142",139,126,126,1,0,"FRONT REPUB",13
25,"25245",430,346,342,1,4,"FRONT REPUB",7
8,"8004",209,194,191,0,3,"FRONT REPUB",22
43,"43069",178,146,146,0,0,"FRONT REPUB",6
8,"8222",1819,1484,1476,11,8,"FRONT REPUB",58
8,"8063",467,406,405,3,1,"FRONT REPUB",12
8,"8107",11900,9303,9187,43,116,"FRONT REPUB",130
31,"31216",3871,2861,2832,32,29,"GBAI",150
31,"31075",118,96,95,2,1,"GBAI",5
31,"31049",679,512,505,2,7,"GBAI",64
31,"31121",65,51,51,0,0,"GBAI",2
31,"31157",3470,2507,2473,32,34,"GBAI",96
31,"31058",202,163,160,2,3,"GBAI",35
31,"31184",65,48,46,0,2,"GBAI",5
31,"31022",483,349,345,3,4,"GBAI",81
31,"31028",220,147,147,0,0,"GBAI",21
31,"31054",454,322,318,4,4,"GBAI",42
31,"31241",125,100,100,2,0,"GBAI",12
31,"31007",126,101,95,3,6,"GBAI",4
31,"31120",383,264,260,3,4,"GBAI",30
31,"31037",90,72,72,0,0,"GBAI",17
31,"31127",135,96,96,0,0,"GBAI",18
31,"31115",160,116,116,3,0,"GBAI",22
31,"31076",2520,2110,2094,21,16,"GBAI",108
31,"31244",156,95,94,5,1,"GBAI",35
31,"31251",3152,2437,2402,12,35,"GBAI",130
31,"31265",78,52,47,1,5,"GBAI",8
31,"31180",197,155,154,2,1,"GBAI",8
31,"31117",589,420,419,5,1,"GBAI",56
31,"31001",80,63,63,0,0,"GBAI",9
31,"31135",112,76,75,2,1,"GBAI",6
31,"31086",13640,11040,10966,116,74,"GBAI",708
31,"31199",141,96,94,0,2,"GBAI",19
31,"31194",326,251,250,1,1,"GBAI",35
31,"31144",763,504,503,1,1,"GBAI",73
31,"31211",17,13,13,1,0,"GBAI",2
31,"31081",334,259,256,7,3,"GBAI",61
31,"31205",420,312,310,7,2,"GBAI",5
31,"31219",81,60,59,1,1,"GBAI",2
31,"31224",875,684,677,10,7,"GBAI",17
31,"31014",266,195,195,4,0,"GBAI",11
31,"31067",1896,1418,1397,17,21,"GBAI",38
31,"31131",907,719,712,8,7,"GBAI",73
31,"31254",1920,1457,1435,8,22,"GBAI",14
31,"31901",15510,12225,12133,114,92,"GBAI",702
31,"31061",48,46,46,0,0,"GBAI",2
31,"31116",58,45,43,2,2,"GBAI",1
31,"31153",2173,1591,1580,10,11,"GBAI",349
31,"31177",251,172,168,1,4,"GBAI",10
31,"31004",32,26,26,0,0,"GBAI",3
31,"31046",53,39,39,0,0,"GBAI",0
31,"31019",1808,1392,1378,18,14,"GBAI",97
31,"31207",285,209,206,1,3,"GBAI",24
31,"31095",72,61,60,0,1,"GBAI",6
31,"31053",503,375,370,4,5,"GBAI",17
31,"31073",296,218,217,3,1,"GBAI",32
31,"31129",384,260,259,0,1,"GBAI",63
31,"31052",103,79,78,0,1,"GBAI",3
31,"31015",1990,1533,1508,17,25,"GBAI",31
31,"31141",107,76,74,0,2,"GBAI",3
31,"31059",183,145,143,0,2,"GBAI",15
31,"31109",1664,1290,1283,10,7,"GBAI",74
31,"31253",119,106,105,0,1,"GBAI",17
31,"31230",95,79,79,0,0,"GBAI",8
31,"31071",15,13,13,0,0,"GBAI",0
31,"31239",281,215,212,7,3,"GBAI",56
31,"31166",250,184,184,2,0,"GBAI",6
31,"31236",1318,958,950,8,8,"GBAI",132
31,"31173",846,686,674,5,12,"GBAI",5
31,"31080",490,393,390,2,3,"GBAI",16
31,"31169",2205,1597,1568,17,29,"GBAI",12
31,"31178",472,354,348,3,6,"GBAI",10
31,"31097",10521,7602,7550,76,52,"GBAI",466
31,"31214",87,66,64,0,2,"GBAI",14
31,"31130",322,237,235,7,2,"GBAI",30
31,"31036",895,665,659,8,6,"GBAI",40
31,"31064",1387,1174,1163,9,11,"GBAI",17
31,"31176",2930,2204,2134,33,70,"GBAI",16
31,"31091",327,224,224,1,0,"GBAI",52
31,"31149",2271,1645,1628,9,17,"GBAI",270
31,"31133",35,28,28,0,0,"GBAI",4
31,"31198",37,32,32,0,0,"GBAI",5
31,"31040",173,139,139,1,0,"GBAI",14
31,"31152",1270,937,929,19,8,"GBAI",47
31,"31057",1741,1365,1344,12,21,"GBAI",6
31,"31193",1438,1129,1123,13,6,"GBAI",91
31,"31092",685,514,511,6,3,"GBAI",90
31,"31096",101,85,84,3,1,"GBAI",4
31,"31140",115,83,83,2,0,"GBAI",13
31,"31248",270,158,154,6,4,"GBAI",19
31,"31252",83,57,57,0,0,"GBAI",6
31,"31103",39,27,27,0,0,"GBAI",0
31,"31083",50,41,41,1,0,"GBAI",5
31,"31008",63,51,49,1,2,"GBAI",2
31,"31172",365,287,275,4,12,"GBAI",13
31,"31227",8111,6198,6129,69,69,"GBAI",261
31,"31136",452,337,333,5,4,"GBAI",27
31,"31240",513,385,385,6,0,"GBAI",81
31,"31042",2695,2071,2043,21,28,"GBAI",7
31,"31088",5675,4331,4285,59,46,"GBAI",183
31,"31006",1877,1453,1436,16,17,"GBAI",7
31,"31150",199,140,139,2,1,"GBAI",4
31,"31050",6002,4111,4061,58,50,"GBAI",731
31,"31010",5728,4211,4153,30,58,"GBAI",591
31,"31186",288,220,216,1,4,"GBAI",17
31,"31206",2082,1610,1589,15,21,"GBAI",94
31,"31090",141,86,86,0,0,"GBAI",34
31,"31101",1412,1097,1087,11,10,"GBAI",62
31,"31038",1336,992,981,8,11,"GBAI",107
31,"31156",239,191,191,1,0,"GBAI",23
31,"31124",207,151,150,2,1,"GBAI",14
31,"31142",1390,994,982,8,12,"GBAI",21
31,"31209",147,116,116,0,0,"GBAI",4
31,"31138",954,699,698,8,1,"GBAI",129
31,"31029",916,661,647,7,14,"GBAI",35
31,"31087",181,136,135,6,1,"GBAI",24
31,"31161",345,286,279,4,7,"GBAI",25
31,"31175",64,50,50,0,0,"GBAI",5
31,"31163",2002,1507,1475,14,32,"GBAI",26
31,"31065",1859,1383,1366,16,17,"GBAI",32
31,"31202",4345,3132,3085,36,47,"GBAI",75
31,"31257",903,690,679,6,11,"GBAI",41
31,"31125",274,211,207,7,4,"GBAI",12
31,"31197",65,56,56,0,0,"GBAI",1
31,"31260",1249,904,901,15,3,"GBAI",53
31,"31158",248,182,177,2,5,"GBAI",18
31,"31162",48,34,33,1,1,"GBAI",1
31,"31154",211,125,124,2,1,"GBAI",17
31,"31168",241,203,199,2,4,"GBAI",16
31,"31068",2816,2194,2136,17,58,"GBAI",19
31,"31907",11205,9216,9140,121,76,"GBAI",611
31,"31192",157,133,130,1,3,"GBAI",4
31,"31021",60,47,47,3,0,"GBAI",6
31,"31263",231,154,154,0,0,"GBAI",29
31,"31055",263,199,197,3,2,"GBAI",64
31,"31041",1659,1245,1228,23,17,"GBAI",62
31,"31902",4649,3620,3598,34,22,"GBAI",275
31,"31093",275,212,206,0,6,"GBAI",22
31,"31016",7752,6114,6064,47,50,"GBAI",365
31,"31213",100,69,68,0,1,"GBAI",17
31,"31078",2419,1924,1899,18,25,"GBAI",14
31,"31051",234,183,182,2,1,"GBAI",8
31,"31146",29,25,25,1,0,"GBAI",0
31,"31107",1680,1330,1312,16,18,"GBAI",16
31,"31113",127,84,83,1,1,"GBAI",14
31,"31023",7609,6371,6319,70,52,"GBAI",373
31,"31908",1064,810,803,2,7,"GBAI",174
31,"31110",84,72,72,3,0,"GBAI",1
31,"31011",709,515,511,4,4,"GBAI",40
31,"31106",718,585,581,3,4,"GBAI",2
31,"31026",132,116,112,0,4,"GBAI",5
31,"31182",30,28,28,1,0,"GBAI",1
31,"31242",264,194,194,2,0,"GBAI",21
31,"31904",1561,1139,1130,7,9,"GBAI",106
31,"31151",57,42,42,1,0,"GBAI",4
31,"31228",494,383,382,0,1,"GBAI",26
31,"31032",1678,1285,1269,25,16,"GBAI",9
31,"31204",36,27,27,1,0,"GBAI",1
31,"31039",92,72,70,1,2,"GBAI",6
31,"31134",175,130,128,1,2,"GBAI",16
31,"31238",115,101,100,2,1,"GBAI",9
31,"31098",1962,1562,1544,14,18,"GBAI",137
31,"31062",1075,870,861,10,9,"GBAI",5
31,"31119",36,26,25,0,1,"GBAI",5
31,"31035",50,34,32,0,2,"GBAI",3
31,"31034",31,27,26,0,1,"GBAI",3
31,"31074",390,310,307,5,3,"GBAI",19
31,"31262",234,201,199,2,2,"GBAI",17
31,"31188",296,200,197,0,3,"GBAI",15
31,"31056",185,141,134,3,7,"GBAI",3
31,"31174",107,70,70,0,0,"GBAI",4
31,"31104",1751,1306,1280,1,26,"GBAI",39
31,"31108",1829,1460,1437,16,23,"GBAI",18
31,"31122",4946,3915,3882,59,33,"GBAI",308
31,"31100",256,181,178,1,3,"GBAI",13
31,"31212",129,102,102,6,0,"GBAI",1
31,"31225",35,29,29,1,0,"GBAI",2
31,"31234",149,115,114,0,1,"GBAI",9
31,"31255",103,87,84,0,3,"GBAI",4
31,"31196",31,28,28,0,0,"GBAI",1
31,"31137",198,106,103,3,3,"GBAI",31
31,"31123",617,392,388,3,4,"GBAI",49
31,"31181",134,94,93,1,1,"GBAI",7
31,"31189",1127,781,775,10,6,"GBAI",68
31,"31208",2562,2067,2036,16,31,"GBAI",48
31,"31191",3018,2365,2337,22,28,"GBAI",113
31,"31264",177,107,105,2,2,"GBAI",21
31,"31020",433,273,272,1,1,"GBAI",63
31,"31246",128,105,101,3,4,"GBAI",10
31,"31031",220,158,157,1,1,"GBAI",31
31,"31210",186,156,156,1,0,"GBAI",17
31,"31148",92,67,65,4,2,"GBAI",7
31,"31102",136,75,75,2,0,"GBAI",20
31,"31111",91,69,69,1,0,"GBAI",9
31,"31179",483,348,344,2,4,"GBAI",6
31,"31164",545,438,433,6,5,"GBAI",4
31,"31159",1105,880,871,3,9,"GBAI",89
31,"31261",237,174,173,3,1,"GBAI",8
31,"31084",1948,1483,1472,9,11,"GBAI",274
31,"31003",117,97,97,1,0,"GBAI",8
31,"31143",93,58,52,0,6,"GBAI",10
31,"31012",771,571,564,5,7,"GBAI",15
31,"31114",374,291,286,4,5,"GBAI",7
31,"31190",45,41,41,4,0,"GBAI",3
31,"31063",83,63,60,2,3,"GBAI",5
31,"31066",812,636,628,10,8,"GBAI",18
31,"31160",105,87,86,1,1,"GBAI",5
31,"31245",77,60,59,4,1,"GBAI",12
31,"31215",4669,3580,3508,35,72,"GBAI",21
31,"31249",1823,1381,1373,21,8,"GBAI",21
31,"31222",58,38,38,3,0,"GBAI",5
31,"31027",814,623,610,8,13,"GBAI",141
31,"31226",574,380,377,3,3,"GBAI",87
31,"31077",5407,4148,4081,39,67,"GBAI",45
31,"31185",470,335,332,6,3,"GBAI",41
31,"31072",5320,4046,3958,40,88,"GBAI",36
31,"31024",99,54,54,1,0,"GBAI",13
31,"31165",2763,2121,2091,21,30,"GBAI",26
31,"31250",2748,1995,1982,21,13,"GBAI",345
31,"31170",45,37,36,2,1,"GBAI",8
31,"31155",241,181,180,3,1,"GBAI",5
31,"31128",341,255,250,3,5,"GBAI",18
31,"31187",101,68,68,1,0,"GBAI",21
31,"31217",334,233,225,3,8,"GBAI",9
31,"31145",161,131,129,1,2,"GBAI",2
31,"31237",186,151,149,1,2,"GBAI",11
31,"31085",502,401,399,5,2,"GBAI",46
31,"31002",433,324,324,4,0,"GBAI",29
31,"31195",171,125,125,2,0,"GBAI",21
31,"31105",1478,1203,1189,21,14,"GBAI",10
31,"31047",236,181,179,5,2,"GBAI",15
31,"31220",742,620,615,2,5,"GBAI",10
31,"31030",135,105,105,3,0,"GBAI",8
31,"31256",96,64,64,0,0,"GBAI",19
31,"31025",763,562,557,6,5,"GBAI",60
31,"31089",228,187,184,0,3,"GBAI",16
31,"31183",713,569,555,6,14,"GBAI",69
31,"31017",370,288,286,3,2,"GBAI",39
31,"31905",2968,2253,2236,21,17,"GBAI",62
31,"31903",6862,4962,4915,31,47,"GBAI",178
31,"31229",38,36,36,2,0,"GBAI",4
31,"31005",281,202,201,5,1,"GBAI",4
31,"31094",105,78,76,0,2,"GBAI",1
31,"31112",93,71,70,0,1,"GBAI",13
31,"31060",14185,10582,10485,103,97,"GBAI",628
31,"31203",30,22,22,1,0,"GBAI",1
31,"31009",672,510,503,4,7,"GBAI",36
31,"31235",157,121,118,0,3,"GBAI",11
31,"31013",626,427,422,5,5,"GBAI",39
31,"31044",294,243,242,5,1,"GBAI",39
31,"31132",148,121,121,2,0,"GBAI",1
31,"31200",748,555,546,5,9,"GBAI",26
31,"31082",623,433,433,3,0,"GBAI",93
31,"31139",155,105,105,0,0,"GBAI",6
31,"31069",830,639,638,3,1,"GBAI",13
31,"31243",302,241,237,5,4,"GBAI",23
31,"31043",32,24,24,0,0,"GBAI",6
31,"31099",49,43,43,0,0,"GBAI",4
31,"31258",7879,6189,6140,57,49,"GBAI",509
31,"31247",147,117,115,0,2,"GBAI",11
31,"31147",106,88,86,3,2,"GBAI",5
31,"31171",669,516,502,3,14,"GBAI",17
31,"31045",509,395,390,5,5,"GBAI",20
31,"31201",151084,115375,114510,1072,865,"GBAI",6879
31,"31231",108,73,70,1,3,"GBAI",0
31,"31048",160,133,132,2,1,"GBAI",1
31,"31259",476,347,346,0,1,"GBAI",85
31,"31232",25574,19124,18913,236,211,"GBAI",260
31,"31018",422,317,312,4,5,"GBAI",12
31,"31906",2683,2040,2023,28,17,"GBAI",115
31,"31126",351,255,254,2,1,"GBAI",36
31,"31118",158,120,116,2,4,"GBAI",22
31,"31079",67,60,60,0,0,"GBAI",2
31,"31167",831,651,636,3,15,"GBAI",35
31,"31070",2628,1930,1881,16,49,"GBAI",12
31,"31221",1235,944,938,11,6,"GBAI",181
31,"31233",93,72,70,1,2,"GBAI",1
31,"31223",959,718,711,8,7,"GBAI",16
31,"31033",46,29,28,0,1,"GBAI",6
18,"18170",324,225,224,1,1,"IZAR",0
18,"18062",11041,8531,8355,71,176,"IZAR",2
18,"18908",784,599,581,0,18,"IZAR",0
18,"18051",1090,800,795,13,5,"IZAR",0
18,"18035",1190,965,952,4,13,"IZAR",0
18,"18140",42374,29390,29025,221,365,"IZAR",6
18,"18027",2604,1902,1887,6,15,"IZAR",2
18,"18089",14540,10725,10583,65,142,"IZAR",1
18,"18167",1850,1330,1317,17,13,"IZAR",0
18,"18048",2462,1873,1832,16,41,"IZAR",0
18,"18150",6903,5149,5063,42,86,"IZAR",1
18,"18002",526,400,400,0,0,"IZAR",0
18,"18144",803,650,640,2,10,"IZAR",0
18,"18143",949,757,740,5,17,"IZAR",0
18,"18088",1530,1152,1142,0,10,"IZAR",0
18,"18135",4434,3169,3105,23,64,"IZAR",2
18,"18101",9410,7280,7181,72,99,"IZAR",3
18,"18085",701,465,460,1,5,"IZAR",0
18,"18011",4376,3286,3248,18,38,"IZAR",2
18,"18138",2482,1698,1668,20,30,"IZAR",2
18,"18045",1060,748,737,10,11,"IZAR",0
18,"18022",13804,9877,9714,92,163,"IZAR",8
18,"18177",373,253,252,1,1,"IZAR",0
18,"18005",362,268,265,0,3,"IZAR",0
18,"18084",4458,3467,3417,17,50,"IZAR",0
18,"18187",512,388,387,0,1,"IZAR",0
18,"18111",2849,2193,2160,24,33,"IZAR",2
18,"18102",8227,6100,5969,32,131,"IZAR",0
18,"18132",3124,2575,2548,17,27,"IZAR",1
18,"18076",790,607,604,1,3,"IZAR",0
18,"18099",1581,1279,1245,5,34,"IZAR",2
18,"18912",1367,990,984,5,6,"IZAR",0
18,"18123",288,219,219,2,0,"IZAR",0
18,"18112",110,80,76,0,4,"IZAR",0
18,"18042",418,344,340,7,4,"IZAR",0
18,"18127",16822,12735,12537,106,198,"IZAR",6
18,"18175",11786,8883,8730,58,153,"IZAR",4
18,"18068",1606,1293,1277,11,16,"IZAR",0
18,"18103",722,556,555,3,1,"IZAR",1
18,"18119",1712,1352,1317,11,35,"IZAR",0
18,"18116",2853,2265,2233,15,32,"IZAR",0
18,"18194",2045,1394,1370,11,24,"IZAR",0
18,"18105",3822,2688,2650,12,38,"IZAR",0
18,"18120",257,219,217,1,2,"IZAR",0
18,"18911",7869,5871,5765,49,106,"IZAR",2
18,"18182",1917,1391,1381,7,10,"IZAR",0
18,"18902",755,611,595,1,16,"IZAR",0
18,"18043",130,93,93,0,0,"IZAR",0
18,"18044",164,113,112,0,1,"IZAR",0
18,"18037",528,435,426,2,9,"IZAR",0
18,"18134",6069,4431,4345,30,86,"IZAR",4
18,"18087",182514,141305,139588,865,1717,"IZAR",43
18,"18181",202,150,148,0,2,"IZAR",0
18,"18178",671,535,532,0,3,"IZAR",0
18,"18916",1778,1249,1236,9,13,"IZAR",0
18,"18010",532,420,416,2,4,"IZAR",0
18,"18901",488,335,329,2,6,"IZAR",0
18,"18188",1648,1295,1276,4,19,"IZAR",0
18,"18001",230,173,170,1,3,"IZAR",1
18,"18184",2170,1688,1656,3,32,"IZAR",0
18,"18074",264,207,205,0,2,"IZAR",0
18,"18053",1561,1102,1099,3,3,"IZAR",0
18,"18162",929,730,719,4,11,"IZAR",0
18,"18018",554,457,451,0,6,"IZAR",0
18,"18151",259,194,193,3,1,"IZAR",0
18,"18098",5994,4293,4247,29,46,"IZAR",1
18,"18136",1782,1382,1359,12,23,"IZAR",0
18,"18094",2304,1845,1798,16,47,"IZAR",0
18,"18065",591,482,468,4,14,"IZAR",0
18,"18016",308,232,231,5,1,"IZAR",0
18,"18050",1670,1231,1213,9,18,"IZAR",0
18,"18100",7981,5900,5769,44,131,"IZAR",3
18,"18180",627,442,435,4,7,"IZAR",0
18,"18030",567,448,442,4,6,"IZAR",1
18,"18165",4251,3113,3073,20,40,"IZAR",74
18,"18147",3644,2492,2441,18,51,"IZAR",0
18,"18117",507,402,396,5,6,"IZAR",0
18,"18148",803,652,648,0,4,"IZAR",0
18,"18107",924,694,680,3,14,"IZAR",0
18,"18056",3418,2523,2478,22,45,"IZAR",1
18,"18164",1794,1225,1205,9,20,"IZAR",0
18,"18192",1466,1171,1156,1,15,"IZAR",0
18,"18910",730,491,487,0,4,"IZAR",0
18,"18171",2111,1679,1638,8,41,"IZAR",1
18,"18040",226,146,145,0,1,"IZAR",0
18,"18034",486,376,374,4,2,"IZAR",0
18,"18174",434,362,357,0,5,"IZAR",1
18,"18064",366,307,306,0,1,"IZAR",0
18,"18185",542,454,453,2,1,"IZAR",0
18,"18054",838,649,648,8,1,"IZAR",0
18,"18021",17869,13238,13004,110,234,"IZAR",12
18,"18046",1753,1206,1185,1,21,"IZAR",2
18,"18137",1002,776,773,0,3,"IZAR",0
18,"18015",425,333,333,0,0,"IZAR",0
18,"18909",539,432,426,1,6,"IZAR",0
18,"18004",687,521,515,4,6,"IZAR",0
18,"18115",2650,1988,1975,20,13,"IZAR",0
18,"18032",242,180,178,2,2,"IZAR",0
18,"18067",681,511,507,3,4,"IZAR",0
18,"18161",251,222,220,1,2,"IZAR",0
18,"18093",2756,1902,1885,8,17,"IZAR",0
18,"18025",279,214,212,0,2,"IZAR",0
18,"18146",937,690,682,6,8,"IZAR",0
18,"18083",228,189,188,1,1,"IZAR",0
18,"18057",5540,4306,4246,30,60,"IZAR",2
18,"18114",591,443,437,2,6,"IZAR",1
18,"18038",1047,810,787,4,23,"IZAR",0
18,"18033",279,221,220,1,1,"IZAR",0
18,"18904",743,555,545,1,10,"IZAR",0
18,"18079",3469,2667,2623,16,44,"IZAR",1
18,"18013",4152,3168,3103,16,65,"IZAR",1
18,"18071",5612,4271,4184,29,87,"IZAR",1
18,"18915",731,539,532,1,7,"IZAR",0
18,"18153",8796,6686,6594,59,92,"IZAR",2
18,"18007",741,533,527,6,6,"IZAR",1
18,"18183",624,442,441,1,1,"IZAR",0
18,"18095",2002,1566,1537,11,29,"IZAR",1
18,"18014",6898,5262,5162,43,100,"IZAR",4
18,"18063",1217,712,702,6,10,"IZAR",0
18,"18082",827,587,577,5,10,"IZAR",0
18,"18179",503,346,343,3,3,"IZAR",0
18,"18906",911,722,716,4,6,"IZAR",0
18,"18049",596,485,481,0,4,"IZAR",0
18,"18193",14802,11165,10973,110,192,"IZAR",7
18,"18061",1000,827,822,1,5,"IZAR",0
18,"18047",6074,4437,4353,33,84,"IZAR",2
18,"18012",2143,1651,1634,8,17,"IZAR",0
18,"18078",710,561,554,4,7,"IZAR",0
18,"18086",339,291,289,0,2,"IZAR",0
18,"18914",1657,1315,1278,5,37,"IZAR",1
18,"18913",781,590,577,5,13,"IZAR",0
18,"18141",384,269,264,0,5,"IZAR",0
18,"18173",8972,6594,6459,58,135,"IZAR",5
18,"18020",501,365,358,2,7,"IZAR",0
18,"18096",344,265,265,2,0,"IZAR",0
18,"18145",10869,8532,8405,69,127,"IZAR",2
18,"18176",241,182,180,0,2,"IZAR",0
18,"18028",907,766,756,0,10,"IZAR",0
18,"18905",15550,11394,11230,132,164,"IZAR",4
18,"18059",4253,3166,3123,22,43,"IZAR",2
18,"18036",3970,3197,3149,26,48,"IZAR",0
18,"18128",342,274,272,1,2,"IZAR",0
18,"18069",497,374,366,4,8,"IZAR",0
18,"18122",16001,11761,11556,110,205,"IZAR",2
18,"18163",315,246,241,1,5,"IZAR",0
18,"18159",999,828,824,1,4,"IZAR",0
18,"18157",1148,914,898,8,16,"IZAR",1
18,"18066",2108,1537,1525,9,12,"IZAR",1
18,"18003",14413,11095,10883,92,212,"IZAR",9
18,"18097",995,708,702,4,6,"IZAR",0
18,"18907",1774,1426,1415,10,11,"IZAR",1
18,"18023",15645,11708,11561,91,147,"IZAR",5
18,"18154",975,701,699,3,2,"IZAR",0
18,"18152",906,692,686,1,6,"IZAR",0
18,"18106",415,300,295,0,5,"IZAR",0
18,"18108",826,677,669,3,8,"IZAR",0
18,"18121",130,104,103,3,1,"IZAR",0
18,"18017",18148,12712,12523,96,189,"IZAR",4
18,"18006",4087,3109,3042,28,67,"IZAR",1
18,"18133",2109,1632,1618,12,14,"IZAR",0
18,"18077",471,372,366,5,6,"IZAR",0
18,"18149",5401,4290,4212,28,78,"IZAR",1
18,"18126",1450,1115,1087,11,28,"IZAR",0
18,"18039",3382,2517,2490,20,27,"IZAR",0
18,"18072",664,481,473,0,8,"IZAR",0
18,"18109",599,452,448,3,4,"IZAR",0
18,"18158",8010,5524,5449,23,75,"IZAR",0
18,"18189",772,619,611,4,8,"IZAR",0
18,"18029",1813,1183,1169,9,14,"IZAR",0
18,"18168",781,613,604,6,9,"IZAR",0
18,"18024",831,682,667,6,15,"IZAR",0
18,"18070",289,224,222,3,2,"IZAR",0
18,"18124",359,269,267,0,2,"IZAR",0
18,"18903",851,644,636,1,8,"IZAR",0
43,"43096",98,82,82,0,0,"IZQP",0
43,"43116",463,381,379,2,2,"IZQP",0
25,"25903",229,189,188,0,1,"IZQP",0
43,"43064",2017,1569,1558,9,11,"IZQP",0
25,"25068",531,402,399,6,3,"IZQP",1
43,"43080",227,195,195,0,0,"IZQP",1
17,"17117",14471,10565,10504,52,61,"IZQP",5
17,"17223",800,623,616,5,7,"IZQP",0
25,"25909",140,108,107,2,1,"IZQP",0
17,"17139",1394,1163,1154,3,9,"IZQP",0
25,"25027",977,765,763,4,2,"IZQP",0
17,"17042",408,313,311,0,2,"IZQP",0
8,"8265",1590,1339,1334,6,5,"IZQP",0
8,"8140",4778,3756,3737,19,19,"IZQP",4
43,"43170",878,706,704,7,2,"IZQP",0
43,"43150",1238,1034,1026,6,8,"IZQP",2
25,"25227",664,517,517,1,0,"IZQP",0
8,"8180",27072,21218,21100,126,118,"IZQP",18
30,"30016",152709,110165,109114,717,1051,"IZQP",110
8,"8102",28794,22420,22317,92,103,"IZQP",14
17,"17152",11026,7610,7564,70,46,"IZQP",1
25,"25047",972,784,781,8,3,"IZQP",0
25,"25126",284,233,232,1,1,"IZQP",0
43,"43145",4209,3409,3391,9,18,"IZQP",0
25,"25129",159,115,115,2,0,"IZQP",0
25,"25122",1925,1505,1497,23,8,"IZQP",1
17,"17174",162,132,132,4,0,"IZQP",0
25,"25203",8798,6279,6231,26,48,"IZQP",1
17,"17024",285,228,227,0,1,"IZQP",0
17,"17011",651,544,544,4,0,"IZQP",0
25,"25146",221,172,170,3,2,"IZQP",0
8,"8056",42727,33215,33054,220,161,"IZQP",24
8,"8003",7183,5761,5742,39,19,"IZQP",4
30,"30026",16252,11142,10977,65,165,"IZQP",11
8,"8902",3937,3176,3164,17,12,"IZQP",4
25,"25245",430,346,342,1,4,"IZQP",0
8,"8185",197,172,171,2,1,"IZQP",0
8,"8014",2000,1578,1567,5,11,"IZQP",1
17,"17120",820,604,598,3,6,"IZQP",0
25,"25096",888,663,661,2,2,"IZQP",0
17,"17030",650,479,477,4,2,"IZQP",0
30,"30043",25401,20378,19992,131,386,"IZQP",28
8,"8194",25674,17691,17585,115,106,"IZQP",65
43,"43075",86,71,69,0,2,"IZQP",0
8,"8096",43555,34070,33871,194,199,"IZQP",16
30,"30020",6431,4991,4940,19,51,"IZQP",2
25,"25231",494,410,408,2,2,"IZQP",0
17,"17074",532,436,426,2,10,"IZQP",0
17,"17099",78,59,59,0,0,"IZQP",0
25,"25013",2108,1570,1557,12,13,"IZQP",0
43,"43097",399,341,341,1,0,"IZQP",0
8,"8160",316,252,247,2,5,"IZQP",0
8,"8176",161,132,131,2,1,"IZQP",0
43,"43172",337,261,257,2,4,"IZQP",0
30,"30019",25846,18755,18517,172,238,"IZQP",15
25,"25182",1043,842,839,9,3,"IZQP",0
17,"17115",278,226,222,2,4,"IZQP",0
17,"17084",231,181,180,1,1,"IZQP",0
43,"43131",4772,3432,3401,18,31,"IZQP",2
25,"25141",152,118,118,1,0,"IZQP",0
8,"8049",1320,981,977,5,4,"IZQP",0
8,"8161",11625,8521,8470,44,51,"IZQP",6
25,"25005",274,202,202,2,0,"IZQP",0
25,"25059",813,621,612,3,9,"IZQP",1
43,"43050",2634,1881,1868,13,13,"IZQP",1
30,"30007",6484,4774,4727,25,47,"IZQP",4
17,"17031",182,130,129,0,1,"IZQP",0
8,"8172",20417,16196,16144,88,52,"IZQP",5
43,"43162",4418,3467,3453,20,14,"IZQP",1
43,"43082",351,303,297,1,6,"IZQP",0
30,"30031",500,435,433,3,2,"IZQP",0
25,"25037",366,286,284,3,2,"IZQP",0
8,"8006",11774,9039,8981,33,58,"IZQP",5
8,"8242",222,180,180,0,0,"IZQP",0
25,"25039",261,216,216,1,0,"IZQP",0
8,"8285",10321,8169,8120,52,49,"IZQP",2
8,"8031",2336,1886,1882,11,4,"IZQP",1
25,"25040",10614,7791,7734,58,57,"IZQP",4
17,"17142",2673,2250,2241,14,9,"IZQP",1
8,"8211",33731,27698,27561,126,137,"IZQP",19
8,"8300",5892,4912,4880,24,32,"IZQP",5
25,"25908",221,159,158,1,1,"IZQP",0
8,"8195",76,69,69,0,0,"IZQP",0
8,"8171",2066,1607,1597,7,10,"IZQP",0
17,"17181",3467,2664,2648,10,16,"IZQP",2
43,"43156",3956,2993,2965,23,28,"IZQP",1
8,"8165",1664,1315,1311,9,4,"IZQP",1
8,"8240",9453,7807,7776,21,31,"IZQP",3
17,"17184",1264,1068,1060,5,8,"IZQP",0
17,"17056",1766,1438,1433,9,5,"IZQP",0
25,"25093",629,489,487,4,2,"IZQP",0
8,"8063",467,406,405,3,1,"IZQP",0
30,"30009",12689,10036,9909,50,127,"IZQP",7
8,"8175",3368,2496,2486,16,10,"IZQP",2
8,"8184",54876,41661,41447,248,214,"IZQP",30
43,"43030",482,373,372,2,1,"IZQP",0
17,"17016",719,584,581,1,3,"IZQP",0
8,"8249",272,248,248,2,0,"IZQP",0
8,"8214",6966,5648,5633,21,15,"IZQP",4
8,"8074",11054,8273,8235,34,38,"IZQP",4
8,"8233",1846,1485,1478,8,7,"IZQP",0
8,"8247",980,832,828,3,4,"IZQP",0
25,"25124",157,114,114,0,0,"IZQP",0
17,"17191",166,145,144,2,1,"IZQP",0
25,"25220",994,822,816,3,6,"IZQP",0
43,"43042",2198,1820,1816,8,4,"IZQP",0
8,"8203",2472,1884,1873,4,11,"IZQP",2
8,"8072",10699,8226,8193,45,33,"IZQP",4
43,"43056",806,616,613,5,3,"IZQP",0
25,"25044",178,145,144,6,1,"IZQP",0
25,"25004",575,470,467,2,3,"IZQP",0
8,"8261",2378,1821,1815,14,6,"IZQP",2
25,"25035",366,306,302,2,4,"IZQP",0
17,"17065",324,254,253,0,1,"IZQP",0
17,"17123",345,304,303,4,1,"IZQP",0
8,"8016",1812,1454,1448,6,6,"IZQP",0
8,"8230",7666,6202,6168,30,34,"IZQP",1
8,"8291",4919,3865,3854,28,11,"IZQP",7
43,"43020",2276,1831,1819,12,12,"IZQP",0
17,"17090",544,469,468,0,1,"IZQP",0
8,"8231",21132,15940,15880,75,60,"IZQP",4
25,"25062",695,578,573,3,5,"IZQP",1
17,"17151",185,150,150,1,0,"IZQP",0
25,"25197",141,109,108,0,1,"IZQP",0
25,"25911",424,332,331,1,1,"IZQP",1
8,"8301",49135,38575,38398,272,177,"IZQP",23
43,"43073",84,68,67,0,1,"IZQP",0
30,"30005",30193,22648,22419,136,229,"IZQP",21
17,"17080",144,124,124,2,0,"IZQP",0
8,"8246",1672,1412,1406,7,6,"IZQP",0
17,"17019",1784,1472,1462,3,10,"IZQP",0
8,"8118",17542,14101,14059,56,42,"IZQP",6
17,"17110",1329,1064,1054,5,10,"IZQP",1
8,"8057",61,50,50,0,0,"IZQP",0
43,"43049",727,589,584,2,5,"IZQP",0
25,"25115",801,638,637,4,1,"IZQP",1
8,"8039",402,334,334,2,0,"IZQP",0
8,"8073",62572,48770,48527,255,243,"IZQP",44
25,"25092",127,101,99,1,2,"IZQP",0
25,"25156",784,608,605,4,3,"IZQP",1
25,"25191",321,248,244,3,4,"IZQP",0
8,"8212",491,406,402,1,4,"IZQP",0
25,"25224",126,98,98,0,0,"IZQP",0
25,"25125",389,303,300,1,3,"IZQP",0
43,"43139",1999,1552,1539,10,13,"IZQP",0
8,"8273",2353,1944,1934,9,10,"IZQP",0
17,"17175",564,381,381,1,0,"IZQP",0
8,"8126",8865,7125,7098,33,27,"IZQP",1
43,"43122",111,98,97,0,1,"IZQP",0
30,"30010",6857,5533,5457,38,76,"IZQP",3
17,"17134",223,189,189,1,0,"IZQP",0
43,"43125",890,700,698,12,2,"IZQP",0
17,"17157",124,107,107,0,0,"IZQP",0
17,"17233",2328,1924,1912,6,12,"IZQP",2
8,"8216",25,19,19,0,0,"IZQP",0
25,"25136",96,79,79,2,0,"IZQP",0
17,"17004",533,445,441,3,4,"IZQP",0
8,"8048",569,442,442,2,0,"IZQP",0
8,"8053",2865,2105,2098,17,7,"IZQP",1
8,"8237",1662,1334,1327,7,7,"IZQP",0
8,"8119",6838,5352,5326,31,26,"IZQP",2
25,"25104",122,91,91,0,0,"IZQP",0
25,"25052",1562,1273,1264,3,9,"IZQP",0
8,"8304",816,686,678,1,8,"IZQP",0
8,"8088",12248,9945,9904,57,41,"IZQP",2
17,"17197",131,113,113,1,0,"IZQP",0
17,"17092",3467,2660,2633,17,27,"IZQP",1
8,"8142",139,126,126,1,0,"IZQP",0
17,"17101",562,415,413,2,2,"IZQP",1
17,"17215",2227,1936,1925,12,11,"IZQP",0
8,"8008",179,139,138,0,1,"IZQP",0
8,"8235",3829,3176,3167,14,9,"IZQP",1
17,"17036",2643,2076,2071,12,5,"IZQP",0
25,"25240",1385,1116,1110,10,6,"IZQP",0
25,"25161",343,243,243,0,0,"IZQP",0
17,"17087",222,177,176,0,1,"IZQP",0
8,"8182",2892,2217,2204,18,13,"IZQP",0
8,"8125",25485,19719,19627,101,92,"IZQP",15
8,"8086",14017,10746,10677,89,69,"IZQP",14
8,"8025",1535,1221,1214,7,7,"IZQP",1
8,"8207",2014,1736,1730,9,6,"IZQP",1
8,"8308",137,118,118,0,0,"IZQP",0
43,"43035",235,205,203,7,2,"IZQP",0
17,"17111",958,772,771,3,1,"IZQP",0
17,"17093",922,716,715,2,1,"IZQP",3
8,"8071",241,200,200,0,0,"IZQP",0
17,"17163",2824,2358,2351,13,7,"IZQP",0
8,"8022",12219,9089,9038,42,51,"IZQP",49
25,"25032",67,53,53,0,0,"IZQP",0
17,"17028",297,238,237,1,1,"IZQP",0
43,"43138",2648,1926,1896,8,30,"IZQP",1
43,"43146",41,35,35,0,0,"IZQP",0
17,"17085",291,248,246,0,2,"IZQP",0
8,"8228",288,239,239,2,0,"IZQP",0
17,"17199",6955,5328,5308,23,20,"IZQP",3
8,"8106",7469,5816,5795,34,21,"IZQP",2
17,"17035",550,460,460,3,0,"IZQP",0
17,"17209",615,519,517,2,2,"IZQP",0
8,"8067",5728,4535,4513,21,22,"IZQP",2
17,"17048",6251,4565,4537,20,28,"IZQP",2
17,"17119",73,58,58,2,0,"IZQP",0
25,"25021",2541,1891,1882,14,9,"IZQP",1
43,"43014",14357,10596,10542,60,54,"IZQP",6
30,"30902",8225,5797,5715,22,82,"IZQP",9
8,"8292",1062,835,831,3,4,"IZQP",0
8,"8070",266,232,232,0,0,"IZQP",0
8,"8263",21151,16360,16269,116,91,"IZQP",19
43,"43153",11092,8327,8291,34,36,"IZQP",2
8,"8298",26980,20900,20817,91,83,"IZQP",21
43,"43177",284,243,242,0,1,"IZQP",0
25,"25132",143,118,118,0,0,"IZQP",0
8,"8011",1745,1414,1407,10,7,"IZQP",0
17,"17069",364,286,284,2,2,"IZQP",0
30,"30036",15256,10884,10703,56,181,"IZQP",7
25,"25254",711,576,571,5,5,"IZQP",0
25,"25165",276,221,219,1,2,"IZQP",0
17,"17077",567,434,434,2,0,"IZQP",0
17,"17194",78,62,62,0,0,"IZQP",0
8,"8215",2589,2044,2034,19,10,"IZQP",0
17,"17067",697,581,578,4,3,"IZQP",0
30,"30030",320172,249965,247884,1497,2081,"IZQP",201
25,"25225",541,427,420,4,7,"IZQP",0
43,"43124",472,379,373,1,6,"IZQP",0
25,"25133",686,528,527,2,1,"IZQP",0
8,"8100",2092,1792,1782,16,10,"IZQP",0
25,"25006",317,246,245,3,1,"IZQP",0
17,"17172",457,352,349,1,3,"IZQP",0
25,"25075",131,102,102,0,0,"IZQP",0
17,"17232",149,117,116,0,1,"IZQP",0
25,"25123",189,151,151,0,0,"IZQP",0
8,"8020",5172,4337,4327,26,10,"IZQP",0
30,"30014",1585,1226,1202,3,24,"IZQP",0
43,"43090",1169,749,742,2,7,"IZQP",2
25,"25901",287,209,207,1,2,"IZQP",0
25,"25137",8686,6327,6296,46,31,"IZQP",2
43,"43037",17902,12787,12695,63,92,"IZQP",6
8,"8093",24,20,20,0,0,"IZQP",0
43,"43904",2861,2083,2058,27,25,"IZQP",0
8,"8145",2701,2156,2144,7,12,"IZQP",0
25,"25088",95,85,83,0,2,"IZQP",0
25,"25216",241,199,199,2,0,"IZQP",0
43,"43022",1435,1130,1123,8,7,"IZQP",0
17,"17226",895,673,669,3,4,"IZQP",1
25,"25008",1088,867,857,7,10,"IZQP",0
43,"43065",382,308,304,1,4,"IZQP",0
25,"25036",184,144,143,0,1,"IZQP",0
25,"25134",603,492,490,1,2,"IZQP",0
25,"25233",285,231,229,2,2,"IZQP",0
17,"17083",2961,2321,2300,12,21,"IZQP",0
25,"25211",672,513,512,6,1,"IZQP",0
25,"25056",213,163,163,3,0,"IZQP",0
43,"43009",1391,1086,1078,3,8,"IZQP",0
8,"8135",6735,5445,5421,36,24,"IZQP",0
25,"25234",4201,3087,3072,13,15,"IZQP",2
17,"17032",1742,1235,1224,6,11,"IZQP",0
43,"43148",90763,69756,69423,299,333,"IZQP",51
25,"25015",335,262,260,8,2,"IZQP",0
17,"17136",195,156,155,0,1,"IZQP",0
8,"8042",2362,1910,1904,7,6,"IZQP",0
8,"8091",5413,4301,4283,20,18,"IZQP",1
8,"8293",228,187,187,1,0,"IZQP",0
8,"8132",361,281,281,2,0,"IZQP",0
8,"8218",8104,6419,6389,34,30,"IZQP",3
25,"25157",162,137,137,4,0,"IZQP",1
25,"25023",4527,3621,3601,23,20,"IZQP",4
8,"8012",1721,1340,1331,8,9,"IZQP",0
17,"17901",983,790,789,3,1,"IZQP",0
43,"43108",1778,1374,1365,6,9,"IZQP",2
25,"25057",214,162,161,0,1,"IZQP",0
17,"17137",3467,2925,2912,15,13,"IZQP",0
43,"43002",1875,1367,1348,11,19,"IZQP",5
8,"8037",1930,1618,1610,10,8,"IZQP",4
43,"43173",99,80,78,0,2,"IZQP",0
25,"25170",261,230,228,4,2,"IZQP",0
25,"25913",86,77,77,0,0,"IZQP",0
8,"8268",971,746,737,3,9,"IZQP",0
17,"17128",316,255,252,1,3,"IZQP",0
17,"17060",408,311,311,1,0,"IZQP",0
43,"43161",17113,12944,12881,64,63,"IZQP",6
8,"8058",1787,1357,1340,5,17,"IZQP",2
17,"17173",182,156,156,0,0,"IZQP",0
43,"43168",84,65,65,1,0,"IZQP",0
17,"17039",1740,1385,1380,8,5,"IZQP",1
8,"8251",5127,3972,3940,17,32,"IZQP",3
43,"43060",2684,2158,2152,8,6,"IZQP",0
17,"17046",710,574,571,3,3,"IZQP",1
17,"17105",247,194,194,1,0,"IZQP",0
17,"17148",1531,1165,1153,4,12,"IZQP",2
17,"17086",1745,1223,1210,7,13,"IZQP",2
17,"17095",19938,13998,13918,69,80,"IZQP",12
43,"43076",460,378,377,2,1,"IZQP",0
25,"25030",123,90,90,1,0,"IZQP",0
43,"43068",483,367,365,5,2,"IZQP",0
8,"8163",19497,14616,14548,67,68,"IZQP",5
43,"43118",425,357,356,0,1,"IZQP",0
17,"17007",1752,1430,1422,2,8,"IZQP",0
43,"43110",251,184,184,1,0,"IZQP",0
30,"30039",20191,14552,14380,96,172,"IZQP",23
8,"8192",5679,4605,4589,20,16,"IZQP",6
17,"17078",336,252,251,3,1,"IZQP",0
25,"25069",425,329,327,1,2,"IZQP",0
8,"8149",984,770,768,3,2,"IZQP",1
43,"43159",81,63,62,0,1,"IZQP",0
43,"43902",2743,1996,1980,16,16,"IZQP",2
8,"8015",156003,117736,117183,704,553,"IZQP",102
8,"8236",1557,1204,1202,2,2,"IZQP",0
17,"17180",8500,6462,6431,28,31,"IZQP",2
17,"17208",976,772,768,5,4,"IZQP",0
25,"25001",139,104,103,1,1,"IZQP",0
25,"25061",80,59,58,0,1,"IZQP",0
8,"8130",108,89,86,2,3,"IZQP",0
8,"8253",128,113,113,0,0,"IZQP",0
8,"8043",3378,2579,2569,20,10,"IZQP",0
8,"8227",2410,1882,1877,10,5,"IZQP",0
8,"8306",527,390,388,2,2,"IZQP",0
17,"17034",7205,5337,5291,16,46,"IZQP",2
25,"25905",369,308,307,1,1,"IZQP",0
43,"43149",684,533,533,4,0,"IZQP",0
8,"8105",9724,7557,7505,49,52,"IZQP",6
17,"17002",564,491,488,3,3,"IZQP",0
8,"8162",2124,1659,1651,7,8,"IZQP",2
17,"17052",134,104,104,1,0,"IZQP",0
43,"43084",521,424,423,2,1,"IZQP",0
25,"25086",521,414,411,2,3,"IZQP",0
8,"8027",720,592,588,3,4,"IZQP",0
17,"17038",380,312,308,3,4,"IZQP",0
25,"25140",773,573,571,5,2,"IZQP",0
17,"17079",65381,50872,50631,242,241,"IZQP",19
43,"43062",259,223,220,2,3,"IZQP",0
17,"17230",499,397,393,0,4,"IZQP",0
25,"25012",2342,1748,1739,10,9,"IZQP",1
25,"25111",113,90,89,0,1,"IZQP",0
8,"8122",1716,1260,1254,8,6,"IZQP",0
8,"8229",521,435,433,3,2,"IZQP",0
25,"25033",1121,899,890,5,9,"IZQP",0
17,"17089",5695,4211,4194,13,17,"IZQP",2
8,"8036",163,134,133,0,1,"IZQP",0
8,"8905",2308,1943,1938,7,5,"IZQP",1
43,"43041",228,179,177,3,2,"IZQP",0
8,"8284",12482,8959,8887,41,72,"IZQP",6
43,"43102",463,384,379,2,5,"IZQP",0
25,"25238",205,163,163,2,0,"IZQP",1
17,"17182",272,220,220,3,0,"IZQP",1
8,"8097",1080,891,880,2,11,"IZQP",0
25,"25196",112,94,93,0,1,"IZQP",0
25,"25210",1079,867,853,4,14,"IZQP",0
17,"17001",580,459,454,3,5,"IZQP",1
25,"25112",268,214,212,2,2,"IZQP",0
30,"30027",49767,39111,38724,245,387,"IZQP",41
17,"17192",146,121,120,0,1,"IZQP",1
8,"8150",251,211,211,0,0,"IZQP",0
8,"8204",3115,2548,2534,22,14,"IZQP",1
25,"25179",171,134,134,1,0,"IZQP",0
8,"8133",128,98,98,5,0,"IZQP",0
17,"17211",831,694,691,1,3,"IZQP",0
8,"8139",177,156,156,0,0,"IZQP",0
43,"43133",5605,4202,4168,21,34,"IZQP",3
8,"8069",3280,2691,2680,17,11,"IZQP",2
8,"8084",1167,941,936,6,5,"IZQP",0
25,"25148",219,168,168,1,0,"IZQP",0
8,"8254",1753,1485,1482,3,3,"IZQP",1
17,"17170",180,147,147,2,0,"IZQP",0
17,"17141",6072,4251,4221,14,30,"IZQP",5
8,"8901",240,203,201,1,2,"IZQP",0
25,"25135",1000,773,769,2,4,"IZQP",0
17,"17041",218,166,165,3,1,"IZQP",0
43,"43098",354,291,291,1,0,"IZQP",0
8,"8064",1920,1516,1506,6,10,"IZQP",1
8,"8134",842,649,646,3,3,"IZQP",0
25,"25190",257,215,215,0,0,"IZQP",0
25,"25902",542,449,439,3,10,"IZQP",0
30,"30029",12055,9003,8882,58,121,"IZQP",6
25,"25912",843,685,684,4,1,"IZQP",2
8,"8223",1886,1434,1425,4,9,"IZQP",1
25,"25046",407,349,347,1,2,"IZQP",0
25,"25249",176,139,138,1,1,"IZQP",0
17,"17203",165,135,135,0,0,"IZQP",1
17,"17023",27144,20301,20146,120,155,"IZQP",12
8,"8252",24729,19751,19642,125,109,"IZQP",13
8,"8305",27533,21656,21539,96,117,"IZQP",10
17,"17214",723,584,580,7,4,"IZQP",0
25,"25150",165,136,133,0,3,"IZQP",0
17,"17125",131,98,97,1,1,"IZQP",0
8,"8267",6748,5389,5362,28,27,"IZQP",2
17,"17210",580,449,445,2,4,"IZQP",0
8,"8065",1180,967,964,4,3,"IZQP",1
30,"30040",705,600,596,1,4,"IZQP",0
17,"17013",2774,2180,2173,15,7,"IZQP",0
8,"8275",248,223,222,1,1,"IZQP",0
43,"43083",144,116,113,1,3,"IZQP",0
8,"8903",197,177,176,0,1,"IZQP",0
25,"25204",1191,936,930,5,6,"IZQP",1
17,"17160",14733,10833,10766,43,67,"IZQP",8
43,"43027",164,137,137,0,0,"IZQP",0
25,"25058",4358,3269,3254,7,15,"IZQP",1
17,"17186",3824,3115,3098,15,17,"IZQP",4
17,"17098",303,245,245,2,0,"IZQP",1
25,"25038",1482,1111,1094,11,17,"IZQP",0
8,"8271",67,57,57,0,0,"IZQP",1
43,"43021",345,270,269,3,1,"IZQP",0
8,"8222",1819,1484,1476,11,8,"IZQP",2
25,"25089",97,72,71,1,1,"IZQP",0
25,"25189",2164,1591,1583,11,8,"IZQP",1
43,"43117",143,114,113,0,1,"IZQP",0
8,"8208",5760,4660,4643,25,17,"IZQP",1
25,"25217",10819,8163,8120,64,43,"IZQP",5
43,"43109",2704,1937,1922,16,15,"IZQP",0
25,"25019",4646,3224,3199,22,25,"IZQP",3
25,"25181",175,136,135,0,1,"IZQP",0
8,"8277",171,150,150,0,0,"IZQP",0
17,"17206",155,118,115,0,3,"IZQP",0
8,"8200",62161,48645,48330,261,315,"IZQP",33
43,"43052",934,765,756,2,9,"IZQP",0
8,"8191",5270,4176,4162,19,14,"IZQP",1
43,"43028",2766,2007,1988,7,19,"IZQP",0
30,"30013",7467,5621,5553,26,68,"IZQP",3
43,"43044",3949,3060,3032,31,28,"IZQP",0
43,"43140",2438,1847,1837,16,10,"IZQP",0
8,"8169",48284,37528,37326,218,202,"IZQP",49
25,"25020",274,221,221,2,0,"IZQP",0
43,"43072",93,74,74,0,0,"IZQP",0
17,"17149",364,314,314,0,0,"IZQP",0
43,"43004",6274,4744,4691,39,53,"IZQP",2
25,"25904",162,147,147,3,0,"IZQP",0
30,"30024",60183,45738,45317,290,421,"IZQP",67
43,"43069",178,146,146,0,0,"IZQP",0
8,"8009",9480,7649,7620,35,29,"IZQP",1
8,"8077",34578,27617,27501,134,116,"IZQP",21
8,"8129",484,406,405,3,1,"IZQP",0
8,"8156",11155,8956,8923,60,33,"IZQP",7
17,"17047",4968,3447,3429,22,18,"IZQP",2
8,"8256",691,571,568,3,3,"IZQP",0
8,"8210",4584,3455,3435,23,20,"IZQP",1
25,"25242",689,539,531,0,8,"IZQP",0
43,"43046",90,73,73,1,0,"IZQP",0
43,"43019",1336,1020,1008,4,12,"IZQP",0
25,"25110",2731,2121,2106,14,15,"IZQP",1
43,"43011",1079,912,909,1,3,"IZQP",0
30,"30018",8326,6544,6438,25,106,"IZQP",6
25,"25029",1607,1270,1265,6,5,"IZQP",0
8,"8225",94,81,81,1,0,"IZQP",0
30,"30001",4539,3615,3567,16,48,"IZQP",1
8,"8078",219,176,172,1,4,"IZQP",0
8,"8288",1676,1196,1182,6,14,"IZQP",1
8,"8202",12843,10074,10025,57,49,"IZQP",7
8,"8002",220,184,183,2,1,"IZQP",0
25,"25002",467,357,356,2,1,"IZQP",0
30,"30025",5001,3951,3898,27,53,"IZQP",2
8,"8131",741,585,585,4,0,"IZQP",2
25,"25099",1291,981,978,2,3,"IZQP",0
17,"17029",199,160,157,1,3,"IZQP",0
43,"43088",2026,1565,1562,9,3,"IZQP",0
25,"25034",2288,1733,1719,9,14,"IZQP",2
8,"8281",4840,4009,3998,23,11,"IZQP",2
25,"25152",144,106,106,1,0,"IZQP",0
43,"43006",676,531,525,4,6,"IZQP",1
25,"25185",679,493,491,6,2,"IZQP",0
8,"8068",6878,5456,5437,25,19,"IZQP",4
17,"17207",2411,2006,1992,8,14,"IZQP",0
25,"25114",95,79,79,0,0,"IZQP",0
43,"43132",363,292,291,2,1,"IZQP",0
8,"8098",2409,1916,1912,9,4,"IZQP",5
8,"8264",4535,3623,3613,13,10,"IZQP",2
8,"8158",3108,2458,2453,13,5,"IZQP",0
43,"43130",177,145,145,0,0,"IZQP",0
8,"8282",6711,5696,5677,27,19,"IZQP",0
43,"43031",1446,1180,1178,7,2,"IZQP",0
8,"8167",6048,4833,4822,48,11,"IZQP",1
25,"25003",3721,2828,2815,19,13,"IZQP",2
17,"17021",122,98,98,0,0,"IZQP",0
8,"8276",233,180,180,0,0,"IZQP",0
17,"17005",460,336,331,0,5,"IZQP",0
43,"43034",468,393,393,0,0,"IZQP",0
43,"43016",3445,2628,2608,11,20,"IZQP",0
8,"8124",37130,29069,28915,146,154,"IZQP",24
17,"17088",578,468,468,1,0,"IZQP",0
8,"8168",394,287,287,1,0,"IZQP",0
30,"30004",1126,884,876,5,8,"IZQP",0
43,"43059",250,214,214,1,0,"IZQP",0
17,"17218",570,468,465,5,3,"IZQP",0
8,"8052",139,111,110,0,1,"IZQP",0
43,"43120",421,302,297,2,5,"IZQP",0
43,"43040",326,278,276,0,2,"IZQP",0
25,"25247",147,100,100,2,0,"IZQP",0
17,"17135",395,309,307,0,2,"IZQP",1
25,"25145",76,66,66,1,0,"IZQP",0
25,"25177",358,270,268,1,2,"IZQP",0
25,"25113",1116,912,908,8,4,"IZQP",2
8,"8116",558,459,459,0,0,"IZQP",0
43,"43901",8750,6057,6004,43,53,"IZQP",1
17,"17114",23269,17558,17474,91,84,"IZQP",9
25,"25248",880,714,713,4,1,"IZQP",2
8,"8082",1143,868,861,4,7,"IZQP",1
8,"8188",115,95,95,0,0,"IZQP",0
17,"17185",2275,1777,1768,7,9,"IZQP",3
8,"8302",9373,7001,6934,61,67,"IZQP",7
8,"8266",43383,35117,34994,178,123,"IZQP",22
43,"43164",306,228,228,0,0,"IZQP",0
17,"17037",114,98,98,6,0,"IZQP",0
25,"25041",528,399,396,4,3,"IZQP",0
8,"8243",156,139,139,0,0,"IZQP",0
43,"43066",155,121,121,1,0,"IZQP",0
17,"17064",326,263,261,2,2,"IZQP",1
8,"8109",208,184,183,0,1,"IZQP",0
8,"8152",116,94,94,0,0,"IZQP",0
8,"8258",813,661,657,6,4,"IZQP",0
25,"25228",3115,2468,2459,19,9,"IZQP",14
17,"17102",548,439,435,3,4,"IZQP",0
43,"43903",2333,1717,1700,11,17,"IZQP",0
25,"25050",3269,2457,2446,23,11,"IZQP",0
17,"17130",322,268,268,0,0,"IZQP",0
25,"25253",145,122,121,0,1,"IZQP",0
25,"25205",562,451,447,7,4,"IZQP",1
17,"17094",1068,772,766,1,6,"IZQP",1
25,"25048",1632,1274,1264,7,10,"IZQP",0
25,"25158",1606,1291,1277,5,14,"IZQP",0
8,"8190",258,216,215,1,1,"IZQP",0
17,"17228",285,229,229,1,0,"IZQP",1
8,"8187",153380,120687,120090,637,597,"IZQP",72
25,"25222",66,57,57,0,0,"IZQP",0
17,"17082",436,341,339,0,2,"IZQP",0
25,"25016",2083,1590,1587,8,3,"IZQP",0
17,"17187",625,530,529,4,1,"IZQP",0
8,"8136",11614,9159,9079,84,80,"IZQP",10
43,"43158",77,61,61,1,0,"IZQP",0
17,"17138",845,650,646,0,4,"IZQP",0
43,"43093",3884,2956,2933,14,23,"IZQP",3
30,"30042",2180,1727,1703,6,24,"IZQP",1
8,"8076",16497,12734,12667,82,67,"IZQP",11
8,"8041",10692,7805,7732,48,73,"IZQP",7
8,"8128",577,454,451,0,3,"IZQP",0
25,"25226",242,184,183,4,1,"IZQP",1
25,"25094",139,116,116,0,0,"IZQP",0
8,"8094",1586,1310,1306,10,4,"IZQP",0
8,"8017",2827,2192,2182,16,10,"IZQP",1
43,"43134",273,224,223,5,1,"IZQP",0
25,"25105",103,89,88,1,1,"IZQP",0
25,"25060",69,49,49,1,0,"IZQP",0
8,"8197",7896,6197,6174,28,23,"IZQP",2
8,"8232",1786,1444,1434,9,10,"IZQP",1
8,"8054",9155,7468,7428,43,40,"IZQP",1
30,"30003",25046,17860,17668,99,192,"IZQP",8
25,"25082",295,229,229,2,0,"IZQP",0
43,"43175",537,426,419,5,7,"IZQP",0
43,"43077",455,342,339,2,3,"IZQP",0
43,"43045",146,128,127,0,1,"IZQP",0
17,"17121",229,184,184,1,0,"IZQP",0
8,"8104",653,516,516,2,0,"IZQP",0
25,"25130",183,142,140,0,2,"IZQP",0
8,"8179",611,496,493,2,3,"IZQP",1
43,"43010",337,286,284,2,2,"IZQP",0
43,"43157",345,303,303,0,0,"IZQP",0
17,"17227",139,106,106,0,0,"IZQP",0
25,"25085",141,118,117,2,1,"IZQP",0
43,"43135",341,283,280,4,3,"IZQP",0
8,"8087",149,135,133,0,2,"IZQP",0
8,"8001",9079,7383,7341,40,42,"IZQP",4
8,"8101",174954,129953,129198,680,755,"IZQP",123
8,"8181",8061,6442,6402,28,40,"IZQP",0
17,"17044",6930,5514,5493,26,21,"IZQP",5
17,"17126",318,279,279,0,0,"IZQP",0
8,"8193",984,792,790,5,2,"IZQP",1
43,"43086",5263,4046,4021,17,25,"IZQP",0
25,"25098",232,172,170,2,2,"IZQP",0
25,"25073",546,420,418,2,2,"IZQP",0
8,"8245",77805,57956,57666,313,290,"IZQP",46
17,"17220",805,673,665,2,8,"IZQP",1
43,"43104",1762,1410,1401,5,9,"IZQP",0
43,"43136",10463,7789,7749,36,40,"IZQP",5
43,"43112",250,204,204,1,0,"IZQP",0
8,"8061",1590,1236,1233,8,3,"IZQP",2
8,"8079",334,284,282,0,2,"IZQP",0
8,"8255",137,105,105,1,0,"IZQP",0
17,"17020",3671,3021,3006,11,15,"IZQP",0
17,"17200",623,512,510,1,2,"IZQP",0
43,"43038",21861,16504,16406,112,98,"IZQP",4
17,"17124",1599,1258,1254,6,4,"IZQP",1
17,"17061",183,148,148,0,0,"IZQP",1
25,"25120",92704,68713,68361,445,352,"IZQP",40
8,"8120",7048,5892,5881,49,11,"IZQP",0
25,"25155",618,493,489,2,4,"IZQP",0
25,"25100",184,145,144,1,1,"IZQP",0
43,"43007",640,510,509,0,1,"IZQP",1
8,"8089",34019,26317,26191,170,126,"IZQP",16
8,"8123",19489,16197,16135,58,62,"IZQP",10
25,"25166",172,137,136,1,1,"IZQP",0
17,"17155",14861,10307,10234,52,73,"IZQP",3
43,"43023",214,186,186,1,0,"IZQP",0
43,"43137",1905,1515,1499,15,16,"IZQP",1
8,"8244",6041,4994,4970,33,24,"IZQP",2
8,"8209",6896,5269,5244,25,25,"IZQP",3
8,"8279",155280,121081,120515,802,566,"IZQP",59
25,"25169",167,118,117,0,1,"IZQP",0
8,"8177",39,31,31,0,0,"IZQP",0
8,"8004",209,194,191,0,3,"IZQP",0
17,"17012",1171,916,914,10,2,"IZQP",0
25,"25167",226,185,185,2,0,"IZQP",0
17,"17190",838,681,677,0,4,"IZQP",0
43,"43070",238,194,193,1,1,"IZQP",0
17,"17109",698,558,553,1,5,"IZQP",0
43,"43176",746,588,586,7,2,"IZQP",0
8,"8213",6547,5270,5245,23,25,"IZQP",2
25,"25143",84,72,71,0,1,"IZQP",0
43,"43032",466,379,379,1,0,"IZQP",0
25,"25202",108,75,75,0,0,"IZQP",0
43,"43123",71092,53689,53369,241,320,"IZQP",20
17,"17212",142,117,117,2,0,"IZQP",0
8,"8029",3560,3027,3019,13,8,"IZQP",1
43,"43147",521,446,442,4,4,"IZQP",0
17,"17066",27323,18373,18269,98,104,"IZQP",14
17,"17026",543,450,449,4,1,"IZQP",0
8,"8047",3737,2903,2876,16,27,"IZQP",3
8,"8151",448,378,377,2,1,"IZQP",0
25,"25077",440,331,330,1,1,"IZQP",0
25,"25168",488,408,407,6,1,"IZQP",1
25,"25102",661,517,511,8,6,"IZQP",0
25,"25206",250,189,188,2,1,"IZQP",0
43,"43017",116,98,98,1,0,"IZQP",0
17,"17234",179,147,146,2,1,"IZQP",0
43,"43115",128,112,111,1,1,"IZQP",0
25,"25031",57,39,39,0,0,"IZQP",0
17,"17168",379,332,329,0,3,"IZQP",1
8,"8143",2719,2121,2109,10,12,"IZQP",3
17,"17033",5587,4157,4130,13,27,"IZQP",4
17,"17166",547,460,459,2,1,"IZQP",2
25,"25078",1001,807,805,5,2,"IZQP",1
17,"17018",494,405,402,1,3,"IZQP",0
8,"8095",67,53,52,0,1,"IZQP",0
8,"8112",12935,9822,9765,74,57,"IZQP",5
8,"8062",1004,829,826,11,3,"IZQP",0
43,"43119",838,630,628,4,2,"IZQP",2
17,"17097",199,172,170,1,2,"IZQP",0
25,"25072",5874,4468,4450,24,18,"IZQP",3
8,"8250",7182,5461,5421,38,40,"IZQP",1
8,"8198",4640,3713,3691,23,22,"IZQP",1
8,"8259",6904,5626,5601,27,25,"IZQP",1
25,"25007",1392,1089,1083,4,6,"IZQP",0
17,"17116",354,283,282,0,1,"IZQP",1
25,"25239",595,367,366,3,1,"IZQP",2
8,"8038",1525,1228,1220,2,8,"IZQP",2
25,"25064",98,88,88,0,0,"IZQP",0
17,"17015",12819,10133,10078,38,55,"IZQP",8
8,"8040",11004,8468,8431,24,37,"IZQP",124
25,"25193",767,614,606,6,8,"IZQP",0
8,"8127",2240,1694,1683,13,11,"IZQP",1
8,"8110",13592,10111,10058,50,53,"IZQP",7
8,"8044",4136,3193,3175,11,18,"IZQP",3
17,"17076",122,101,100,1,1,"IZQP",0
8,"8024",357,301,298,1,3,"IZQP",1
8,"8289",4457,3605,3594,20,11,"IZQP",1
8,"8157",8547,6949,6918,39,31,"IZQP",11
25,"25138",547,440,436,1,4,"IZQP",0
43,"43174",144,128,127,0,1,"IZQP",0
8,"8032",2087,1607,1598,9,9,"IZQP",0
8,"8154",701,587,586,5,1,"IZQP",0
17,"17216",155,127,124,0,3,"IZQP",0
17,"17063",173,157,156,2,1,"IZQP",0
25,"25251",713,562,558,4,4,"IZQP",0
25,"25081",287,221,220,2,1,"IZQP",0
25,"25194",415,325,325,3,0,"IZQP",0
43,"43047",4209,2878,2856,23,22,"IZQP",3
17,"17201",143,120,120,0,0,"IZQP",0
25,"25218",86,79,79,0,0,"IZQP",0
8,"8018",2551,1998,1984,6,14,"IZQP",0
43,"43036",865,605,602,1,3,"IZQP",0
8,"8138",4432,3435,3413,10,22,"IZQP",1
8,"8115",3825,2994,2975,12,19,"IZQP",2
8,"8141",4573,3611,3595,26,16,"IZQP",3
17,"17008",3594,2763,2741,16,22,"IZQP",0
43,"43094",2120,1659,1646,9,13,"IZQP",1
43,"43061",38,28,28,0,0,"IZQP",0
8,"8170",442,338,338,0,0,"IZQP",0
17,"17217",353,312,311,1,1,"IZQP",0
8,"8270",18837,14541,14497,66,44,"IZQP",7
43,"43111",2098,1496,1483,8,13,"IZQP",2
8,"8201",447,327,324,5,3,"IZQP",0
17,"17009",4051,3263,3248,14,15,"IZQP",3
25,"25042",208,160,160,1,0,"IZQP",0
8,"8303",256,215,213,1,2,"IZQP",0
43,"43165",572,492,492,1,0,"IZQP",0
25,"25219",149,118,118,1,0,"IZQP",0
8,"8148",2334,1803,1794,6,9,"IZQP",1
8,"8026",193,161,161,1,0,"IZQP",0
17,"17132",1333,1088,1080,9,8,"IZQP",0
43,"43160",1322,1051,1045,0,6,"IZQP",1
8,"8090",137,113,113,2,0,"IZQP",0
8,"8280",95,78,78,1,0,"IZQP",0
17,"17049",3204,2634,2615,9,19,"IZQP",1
17,"17164",3932,3078,3054,8,24,"IZQP",5
8,"8199",651,542,542,4,0,"IZQP",0
25,"25164",357,264,261,4,3,"IZQP",0
43,"43071",891,713,706,6,7,"IZQP",0
25,"25131",402,321,320,1,1,"IZQP",0
43,"43099",286,234,234,0,0,"IZQP",0
43,"43907",4359,3370,3346,22,24,"IZQP",3
8,"8050",136,115,114,0,1,"IZQP",0
25,"25212",224,195,195,2,0,"IZQP",0
8,"8108",5192,4204,4189,26,15,"IZQP",2
30,"30015",19372,14430,14283,91,147,"IZQP",6
8,"8021",61,47,45,0,2,"IZQP",0
17,"17096",164,113,113,1,0,"IZQP",0
8,"8019",1117818,875679,872180,4327,3499,"IZQP",503
43,"43089",281,209,208,0,1,"IZQP",0
25,"25255",395,321,318,2,3,"IZQP",0
8,"8238",14851,12472,12428,50,44,"IZQP",2
17,"17146",3127,2404,2381,11,23,"IZQP",1
17,"17165",634,516,512,3,4,"IZQP",0
8,"8103",640,507,505,4,2,"IZQP",0
17,"17081",248,192,190,0,2,"IZQP",0
8,"8220",2411,2119,2115,13,4,"IZQP",0
8,"8146",1358,1086,1079,2,7,"IZQP",0
43,"43029",314,253,252,0,1,"IZQP",0
17,"17014",63,51,50,0,1,"IZQP",0
8,"8189",122,106,106,0,0,"IZQP",0
8,"8221",12699,10571,10537,53,34,"IZQP",7
30,"30017",11477,8952,8844,62,108,"IZQP",7
8,"8239",460,380,378,2,2,"IZQP",0
25,"25076",134,94,93,0,1,"IZQP",0
25,"25011",5260,3908,3871,30,37,"IZQP",5
8,"8035",12871,9574,9538,31,36,"IZQP",3
8,"8274",4674,3710,3698,12,12,"IZQP",1
25,"25055",163,130,129,0,1,"IZQP",0
25,"25154",118,94,94,0,0,"IZQP",0
8,"8178",451,389,388,3,1,"IZQP",0
17,"17222",105,95,95,1,0,"IZQP",0
17,"17176",123,110,110,1,0,"IZQP",1
30,"30008",14450,10832,10675,60,157,"IZQP",11
43,"43057",38,31,31,1,0,"IZQP",0
25,"25070",811,677,675,4,2,"IZQP",1
25,"25022",107,88,88,0,0,"IZQP",0
8,"8033",13218,10480,10435,50,45,"IZQP",1
8,"8904",10514,7733,7697,38,36,"IZQP",6
8,"8283",6113,4832,4813,33,19,"IZQP",0
17,"17188",169,139,138,1,1,"IZQP",0
8,"8111",215,200,199,4,1,"IZQP",0
30,"30032",2851,2256,2218,14,38,"IZQP",2
25,"25049",155,113,111,0,2,"IZQP",0
25,"25009",605,505,491,5,14,"IZQP",0
8,"8099",753,565,561,2,4,"IZQP",0
8,"8137",274,232,229,0,3,"IZQP",0
8,"8290",1534,1289,1284,9,5,"IZQP",1
25,"25906",210,157,155,0,2,"IZQP",0
25,"25171",2127,1639,1630,8,9,"IZQP",1
17,"17054",347,271,271,0,0,"IZQP",0
8,"8206",737,625,624,3,1,"IZQP",0
8,"8028",1088,783,780,2,3,"IZQP",0
25,"25207",6430,4899,4867,41,32,"IZQP",3
25,"25153",192,152,150,1,2,"IZQP",2
17,"17107",269,221,219,2,2,"IZQP",0
43,"43085",235,198,194,0,4,"IZQP",0
17,"17010",327,264,263,2,1,"IZQP",0
8,"8051",18437,14951,14887,85,64,"IZQP",3
25,"25151",736,592,584,1,8,"IZQP",0
8,"8147",17282,13644,13560,94,84,"IZQP",14
43,"43051",9092,6577,6502,26,75,"IZQP",2
43,"43100",3489,2820,2816,15,4,"IZQP",1
17,"17225",207,161,161,0,0,"IZQP",0
17,"17055",143,126,125,0,1,"IZQP",0
43,"43067",528,450,445,1,5,"IZQP",0
8,"8248",5616,4378,4365,32,13,"IZQP",3
17,"17103",5084,3575,3543,13,32,"IZQP",12
43,"43141",105,86,86,0,0,"IZQP",0
17,"17150",1426,1199,1192,8,7,"IZQP",1
17,"17025",1170,972,967,6,5,"IZQP",1
17,"17147",7959,6164,6130,45,34,"IZQP",7
25,"25173",1649,1278,1262,5,16,"IZQP",0
8,"8272",165,133,133,0,0,"IZQP",1
25,"25119",2245,1798,1792,10,6,"IZQP",0
43,"43144",1236,1025,1021,8,4,"IZQP",0
8,"8081",353,299,297,2,2,"IZQP",0
8,"8260",18400,14471,14406,87,65,"IZQP",11
17,"17167",2609,2122,2102,14,20,"IZQP",0
30,"30022",17056,12158,11954,126,204,"IZQP",19
25,"25223",911,732,723,6,9,"IZQP",0
8,"8205",61279,51629,51497,360,132,"IZQP",19
17,"17145",1432,1113,1103,7,10,"IZQP",2
43,"43003",350,266,264,3,2,"IZQP",0
43,"43074",1812,1419,1412,4,7,"IZQP",0
17,"17129",144,120,120,1,0,"IZQP",0
43,"43169",450,396,396,3,0,"IZQP",0
25,"25025",1378,996,983,8,13,"IZQP",0
8,"8080",39,30,30,0,0,"IZQP",0
25,"25087",56,49,49,0,0,"IZQP",0
17,"17221",4152,3260,3247,11,13,"IZQP",3
25,"25172",1779,1407,1405,3,2,"IZQP",4
25,"25103",136,103,102,2,1,"IZQP",0
25,"25221",117,92,92,0,0,"IZQP",0
43,"43091",123,93,93,1,0,"IZQP",0
17,"17100",195,157,154,0,3,"IZQP",0
43,"43039",105,85,85,0,0,"IZQP",0
8,"8287",1057,877,871,7,6,"IZQP",0
17,"17027",2866,2375,2364,8,11,"IZQP",2
25,"25215",505,299,299,4,0,"IZQP",0
8,"8241",69,56,56,0,0,"IZQP",0
43,"43906",2103,1595,1587,14,8,"IZQP",0
30,"30034",1075,852,831,4,21,"IZQP",0
8,"8164",934,784,776,1,8,"IZQP",1
43,"43078",843,653,644,4,9,"IZQP",0
25,"25010",196,156,155,2,1,"IZQP",0
17,"17903",889,726,721,4,5,"IZQP",0
25,"25183",535,419,416,4,3,"IZQP",0
8,"8010",4207,3327,3304,13,23,"IZQP",1
43,"43048",763,614,609,7,5,"IZQP",0
17,"17058",170,139,139,0,0,"IZQP",0
25,"25024",352,273,272,0,1,"IZQP",0
25,"25192",724,564,558,4,6,"IZQP",0
8,"8159",14323,11399,11359,57,40,"IZQP",9
25,"25243",3730,2637,2606,20,31,"IZQP",2
43,"43171",14705,11002,10956,62,46,"IZQP",1
25,"25017",232,184,181,0,3,"IZQP",0
30,"30035",19268,14248,14103,92,145,"IZQP",8
8,"8085",976,812,811,2,1,"IZQP",0
43,"43166",1628,1292,1285,3,7,"IZQP",0
43,"43101",145,122,122,1,0,"IZQP",0
43,"43126",1211,1005,999,4,6,"IZQP",0
8,"8234",3373,2742,2734,25,8,"IZQP",0
8,"8269",2712,2258,2250,19,8,"IZQP",0
8,"8295",11184,8566,8529,43,37,"IZQP",2
8,"8005",6380,5122,5106,18,16,"IZQP",0
8,"8030",5209,4318,4305,16,13,"IZQP",2
8,"8226",926,811,807,1,4,"IZQP",0
43,"43905",14941,10510,10446,40,64,"IZQP",5
30,"30002",9735,7319,7227,33,92,"IZQP",4
17,"17106",143,124,123,0,1,"IZQP",0
17,"17162",156,114,111,1,3,"IZQP",0
17,"17198",433,332,329,0,3,"IZQP",0
17,"17213",5535,3998,3985,20,13,"IZQP",5
17,"17140",639,539,527,4,12,"IZQP",0
43,"43033",768,609,607,3,2,"IZQP",0
43,"43025",590,476,472,0,4,"IZQP",0
25,"25074",180,157,155,2,2,"IZQP",1
17,"17118",12916,9521,9460,37,61,"IZQP",6
25,"25907",497,389,386,2,3,"IZQP",0
43,"43152",434,357,356,0,1,"IZQP",0
17,"17224",302,233,231,2,2,"IZQP",2
43,"43113",397,325,323,2,2,"IZQP",0
43,"43026",765,614,613,3,1,"IZQP",0
17,"17144",210,171,170,0,1,"IZQP",0
25,"25101",543,454,449,1,5,"IZQP",0
25,"25051",1510,1176,1172,6,4,"IZQP",1
17,"17153",188,162,162,0,0,"IZQP",0
17,"17183",255,216,216,0,0,"IZQP",0
17,"17196",242,198,198,1,0,"IZQP",0
8,"8046",13478,10989,10939,67,50,"IZQP",2
8,"8144",713,565,563,5,2,"IZQP",0
25,"25910",91,70,67,2,3,"IZQP",0
17,"17202",3813,2876,2851,8,25,"IZQP",5
8,"8055",541,443,442,2,1,"IZQP",0
43,"43142",1083,850,842,8,8,"IZQP",0
8,"8113",52518,39750,39592,198,158,"IZQP",16
25,"25014",249,203,200,2,3,"IZQP",0
25,"25174",390,324,324,0,0,"IZQP",0
8,"8286",2919,2210,2199,15,11,"IZQP",2
25,"25128",127,87,87,0,0,"IZQP",0
17,"17177",567,459,457,2,2,"IZQP",2
17,"17040",551,465,459,4,6,"IZQP",0
17,"17070",110,94,94,0,0,"IZQP",0
17,"17158",468,337,336,1,1,"IZQP",0
25,"25149",1378,1108,1102,3,6,"IZQP",3
8,"8278",4893,4034,4018,17,16,"IZQP",0
25,"25142",365,300,299,2,1,"IZQP",0
25,"25200",323,253,252,0,1,"IZQP",0
8,"8307",49310,38223,38022,162,201,"IZQP",38
43,"43107",383,308,308,1,0,"IZQP",0
8,"8045",71,52,49,0,3,"IZQP",0
43,"43154",126,111,111,0,0,"IZQP",0
25,"25201",110,89,89,0,0,"IZQP",0
17,"17205",211,184,184,1,0,"IZQP",0
25,"25230",1555,1221,1208,8,13,"IZQP",0
17,"17143",144,115,115,0,0,"IZQP",1
25,"25186",207,174,173,7,1,"IZQP",0
25,"25097",84,72,72,1,0,"IZQP",0
43,"43143",51,45,44,0,1,"IZQP",0
17,"17189",1476,1278,1275,2,3,"IZQP",0
8,"8083",1672,1478,1471,7,7,"IZQP",1
17,"17169",2497,2047,2042,8,5,"IZQP",0
8,"8294",2063,1644,1643,10,1,"IZQP",1
43,"43092",7235,5200,5174,21,26,"IZQP",5
25,"25250",330,261,258,1,3,"IZQP",0
8,"8075",4059,3127,3119,14,8,"IZQP",3
8,"8117",2480,2055,2050,16,5,"IZQP",1
8,"8299",377,318,317,0,1,"IZQP",0
43,"43013",4392,3341,3321,14,20,"IZQP",1
43,"43054",2792,2145,2134,21,11,"IZQP",1
43,"43095",2564,1995,1984,14,11,"IZQP",0
17,"17068",246,194,193,0,1,"IZQP",0
8,"8257",103,86,86,1,0,"IZQP",0
43,"43128",905,751,747,4,4,"IZQP",0
17,"17193",4312,3202,3179,15,23,"IZQP",4
17,"17161",1018,859,855,1,4,"IZQP",0
17,"17003",102,75,75,0,0,"IZQP",1
43,"43105",156,132,132,3,0,"IZQP",0
17,"17075",334,282,281,5,1,"IZQP",0
25,"25109",214,179,176,3,3,"IZQP",0
8,"8183",4563,3628,3613,9,15,"IZQP",2
43,"43063",536,401,397,1,4,"IZQP",0
43,"43178",1421,1118,1113,7,5,"IZQP",0
43,"43001",694,543,543,5,0,"IZQP",0
17,"17154",99,84,83,0,1,"IZQP",1
17,"17006",1186,880,878,10,2,"IZQP",1
25,"25067",706,537,532,4,5,"IZQP",1
43,"43053",188,153,149,0,4,"IZQP",0
8,"8059",344,292,290,2,2,"IZQP",0
17,"17050",674,585,582,5,3,"IZQP",0
30,"30033",10363,8115,7979,54,136,"IZQP",17
30,"30028",6400,4364,4289,30,75,"IZQP",3
17,"17159",626,487,483,1,4,"IZQP",0
43,"43015",119,101,101,0,0,"IZQP",0
17,"17051",207,174,173,3,1,"IZQP",0
8,"8196",19444,15361,15263,90,98,"IZQP",12
8,"8114",18648,14251,14170,69,81,"IZQP",5
8,"8155",6960,5427,5390,39,37,"IZQP",4
17,"17057",968,826,822,1,4,"IZQP",1
25,"25118",327,241,239,2,2,"IZQP",1
8,"8034",784,648,646,1,2,"IZQP",0
8,"8224",878,697,695,1,2,"IZQP",0
43,"43103",905,746,740,8,6,"IZQP",1
43,"43005",3643,2765,2749,22,16,"IZQP",2
43,"43114",375,306,305,0,1,"IZQP",0
30,"30041",13970,9796,9682,80,114,"IZQP",11
43,"43155",22619,16724,16624,101,100,"IZQP",5
8,"8166",962,753,745,7,8,"IZQP",1
25,"25180",228,176,174,1,2,"IZQP",0
43,"43163",26013,18942,18796,89,146,"IZQP",20
17,"17112",194,154,152,2,2,"IZQP",0
25,"25176",307,262,259,1,3,"IZQP",0
17,"17204",596,461,460,2,1,"IZQP",1
43,"43106",793,656,651,2,5,"IZQP",0
25,"25063",95,61,61,0,0,"IZQP",0
8,"8013",1280,1040,1031,5,9,"IZQP",0
8,"8296",1843,1520,1514,10,6,"IZQP",1
25,"25045",54,31,31,5,0,"IZQP",0
30,"30901",10529,8488,8375,37,113,"IZQP",9
25,"25175",176,135,135,1,0,"IZQP",0
17,"17073",1939,1695,1693,7,2,"IZQP",0
25,"25079",285,228,227,0,1,"IZQP",0
43,"43043",3289,2624,2613,14,11,"IZQP",2
25,"25043",801,613,606,1,7,"IZQP",0
30,"30012",9069,7397,7266,53,131,"IZQP",2
43,"43129",4611,3528,3495,21,33,"IZQP",0
25,"25071",42,32,31,0,1,"IZQP",0
17,"17043",167,135,134,0,1,"IZQP",0
43,"43121",591,463,462,0,1,"IZQP",0
25,"25139",491,390,388,3,2,"IZQP",1
30,"30006",829,731,727,4,4,"IZQP",0
43,"43127",759,630,626,3,4,"IZQP",0
8,"8060",135,111,109,0,2,"IZQP",0
43,"43079",356,306,305,1,1,"IZQP",0
17,"17133",1273,1048,1043,7,5,"IZQP",1
8,"8219",15629,12910,12865,58,45,"IZQP",41
8,"8262",6919,5090,5060,33,30,"IZQP",6
43,"43012",3647,3028,3019,15,9,"IZQP",0
43,"43055",1988,1631,1622,7,9,"IZQP",0
25,"25163",236,181,179,3,2,"IZQP",0
30,"30023",3875,3107,3068,20,39,"IZQP",1
25,"25252",557,424,422,4,2,"IZQP",0
8,"8217",25355,20935,20855,110,80,"IZQP",17
43,"43058",96,77,77,0,0,"IZQP",0
43,"43081",633,532,531,7,1,"IZQP",0
25,"25121",635,436,429,1,7,"IZQP",1
30,"30021",9441,6664,6591,32,73,"IZQP",4
30,"30037",19254,14416,14217,67,199,"IZQP",11
25,"25053",1092,879,873,8,6,"IZQP",0
25,"25208",333,252,249,0,3,"IZQP",0
8,"8023",6915,5339,5299,26,40,"IZQP",3
25,"25244",362,296,294,2,2,"IZQP",0
17,"17071",1128,978,978,3,0,"IZQP",0
8,"8121",87292,67638,67328,362,310,"IZQP",50
17,"17171",172,143,141,0,2,"IZQP",0
8,"8066",1463,1185,1181,9,4,"IZQP",1
43,"43018",385,335,334,3,1,"IZQP",0
43,"43024",1556,1154,1137,3,17,"IZQP",0
8,"8092",3714,2912,2889,8,23,"IZQP",1
43,"43151",109,98,98,0,0,"IZQP",0
8,"8107",11900,9303,9187,43,116,"IZQP",10
43,"43167",384,334,333,2,1,"IZQP",0
8,"8297",135,111,111,1,0,"IZQP",0
25,"25127",214,172,172,0,0,"IZQP",0
17,"17195",342,296,295,3,1,"IZQP",0
30,"30011",4695,3665,3610,16,55,"IZQP",11
30,"30038",15674,11755,11675,59,80,"IZQP",8
25,"25209",1550,1192,1172,4,20,"IZQP",1
17,"17022",7008,5386,5354,22,32,"IZQP",4
8,"8007",6775,5447,5419,21,28,"IZQP",2
17,"17091",398,310,305,2,5,"IZQP",0
8,"8174",392,330,330,4,0,"IZQP",0
17,"17178",1056,804,798,3,6,"IZQP",0
43,"43008",307,202,200,1,2,"IZQP",0
17,"17902",1306,1076,1074,3,2,"IZQP",0
8,"8153",559,460,458,2,2,"IZQP",0
17,"17062",5978,4358,4334,26,24,"IZQP",5
25,"25232",1356,1066,1061,2,5,"IZQP",0
18,"18912",1367,990,984,5,6,"""JF""",0
18,"18126",1450,1115,1087,11,28,"""JF""",0
18,"18112",110,80,76,0,4,"""JF""",0
18,"18093",2756,1902,1885,8,17,"""JF""",2
18,"18111",2849,2193,2160,24,33,"""JF""",8
18,"18178",671,535,532,0,3,"""JF""",0
18,"18074",264,207,205,0,2,"""JF""",0
18,"18170",324,225,224,1,1,"""JF""",0
18,"18005",362,268,265,0,3,"""JF""",0
18,"18185",542,454,453,2,1,"""JF""",0
18,"18030",567,448,442,4,6,"""JF""",0
18,"18107",924,694,680,3,14,"""JF""",0
18,"18103",722,556,555,3,1,"""JF""",1
18,"18023",15645,11708,11561,91,147,"""JF""",17
18,"18914",1657,1315,1278,5,37,"""JF""",1
18,"18022",13804,9877,9714,92,163,"""JF""",32
18,"18002",526,400,400,0,0,"""JF""",0
18,"18085",701,465,460,1,5,"""JF""",1
18,"18001",230,173,170,1,3,"""JF""",2
18,"18132",3124,2575,2548,17,27,"""JF""",2
18,"18079",3469,2667,2623,16,44,"""JF""",2
18,"18116",2853,2265,2233,15,32,"""JF""",2
18,"18915",731,539,532,1,7,"""JF""",0
18,"18153",8796,6686,6594,59,92,"""JF""",11
18,"18034",486,376,374,4,2,"""JF""",0
18,"18187",512,388,387,0,1,"""JF""",0
18,"18146",937,690,682,6,8,"""JF""",0
18,"18114",591,443,437,2,6,"""JF""",0
18,"18120",257,219,217,1,2,"""JF""",0
18,"18194",2045,1394,1370,11,24,"""JF""",2
18,"18911",7869,5871,5765,49,106,"""JF""",11
18,"18136",1782,1382,1359,12,23,"""JF""",0
18,"18140",42374,29390,29025,221,365,"""JF""",56
18,"18064",366,307,306,0,1,"""JF""",0
18,"18086",339,291,289,0,2,"""JF""",0
18,"18038",1047,810,787,4,23,"""JF""",1
18,"18138",2482,1698,1668,20,30,"""JF""",3
18,"18902",755,611,595,1,16,"""JF""",0
18,"18167",1850,1330,1317,17,13,"""JF""",0
18,"18905",15550,11394,11230,132,164,"""JF""",25
18,"18908",784,599,581,0,18,"""JF""",0
18,"18007",741,533,527,6,6,"""JF""",1
18,"18096",344,265,265,2,0,"""JF""",0
18,"18042",418,344,340,7,4,"""JF""",2
18,"18117",507,402,396,5,6,"""JF""",1
18,"18133",2109,1632,1618,12,14,"""JF""",2
18,"18141",384,269,264,0,5,"""JF""",0
18,"18157",1148,914,898,8,16,"""JF""",3
18,"18901",488,335,329,2,6,"""JF""",1
18,"18181",202,150,148,0,2,"""JF""",0
18,"18137",1002,776,773,0,3,"""JF""",1
18,"18173",8972,6594,6459,58,135,"""JF""",9
18,"18068",1606,1293,1277,11,16,"""JF""",4
18,"18045",1060,748,737,10,11,"""JF""",1
18,"18148",803,652,648,0,4,"""JF""",0
18,"18175",11786,8883,8730,58,153,"""JF""",14
18,"18162",929,730,719,4,11,"""JF""",1
18,"18143",949,757,740,5,17,"""JF""",2
18,"18051",1090,800,795,13,5,"""JF""",0
18,"18165",4251,3113,3073,20,40,"""JF""",4
18,"18015",425,333,333,0,0,"""JF""",0
18,"18011",4376,3286,3248,18,38,"""JF""",6
18,"18062",11041,8531,8355,71,176,"""JF""",21
18,"18087",182514,141305,139588,865,1717,"""JF""",277
18,"18056",3418,2523,2478,22,45,"""JF""",0
18,"18161",251,222,220,1,2,"""JF""",0
18,"18182",1917,1391,1381,7,10,"""JF""",2
18,"18066",2108,1537,1525,9,12,"""JF""",1
18,"18048",2462,1873,1832,16,41,"""JF""",3
18,"18101",9410,7280,7181,72,99,"""JF""",13
18,"18147",3644,2492,2441,18,51,"""JF""",2
18,"18040",226,146,145,0,1,"""JF""",0
18,"18018",554,457,451,0,6,"""JF""",1
18,"18134",6069,4431,4345,30,86,"""JF""",9
18,"18904",743,555,545,1,10,"""JF""",0
18,"18089",14540,10725,10583,65,142,"""JF""",16
18,"18036",3970,3197,3149,26,48,"""JF""",2
18,"18077",471,372,366,5,6,"""JF""",1
18,"18188",1648,1295,1276,4,19,"""JF""",0
18,"18149",5401,4290,4212,28,78,"""JF""",6
18,"18076",790,607,604,1,3,"""JF""",0
18,"18057",5540,4306,4246,30,60,"""JF""",6
18,"18100",7981,5900,5769,44,131,"""JF""",5
18,"18012",2143,1651,1634,8,17,"""JF""",2
18,"18061",1000,827,822,1,5,"""JF""",0
18,"18180",627,442,435,4,7,"""JF""",1
18,"18109",599,452,448,3,4,"""JF""",1
18,"18189",772,619,611,4,8,"""JF""",1
18,"18017",18148,12712,12523,96,189,"""JF""",14
18,"18044",164,113,112,0,1,"""JF""",0
18,"18006",4087,3109,3042,28,67,"""JF""",2
18,"18163",315,246,241,1,5,"""JF""",2
18,"18084",4458,3467,3417,17,50,"""JF""",6
18,"18151",259,194,193,3,1,"""JF""",0
18,"18171",2111,1679,1638,8,41,"""JF""",0
18,"18032",242,180,178,2,2,"""JF""",0
18,"18150",6903,5149,5063,42,86,"""JF""",3
18,"18144",803,650,640,2,10,"""JF""",0
18,"18027",2604,1902,1887,6,15,"""JF""",5
18,"18176",241,182,180,0,2,"""JF""",0
18,"18135",4434,3169,3105,23,64,"""JF""",2
18,"18053",1561,1102,1099,3,3,"""JF""",1
18,"18123",288,219,219,2,0,"""JF""",0
18,"18054",838,649,648,8,1,"""JF""",0
18,"18037",528,435,426,2,9,"""JF""",0
18,"18043",130,93,93,0,0,"""JF""",0
18,"18124",359,269,267,0,2,"""JF""",0
18,"18039",3382,2517,2490,20,27,"""JF""",2
18,"18033",279,221,220,1,1,"""JF""",0
18,"18071",5612,4271,4184,29,87,"""JF""",12
18,"18010",532,420,416,2,4,"""JF""",0
18,"18016",308,232,231,5,1,"""JF""",0
18,"18050",1670,1231,1213,9,18,"""JF""",2
18,"18159",999,828,824,1,4,"""JF""",0
18,"18003",14413,11095,10883,92,212,"""JF""",19
18,"18127",16822,12735,12537,106,198,"""JF""",31
18,"18119",1712,1352,1317,11,35,"""JF""",7
18,"18078",710,561,554,4,7,"""JF""",0
18,"18192",1466,1171,1156,1,15,"""JF""",0
18,"18004",687,521,515,4,6,"""JF""",0
18,"18916",1778,1249,1236,9,13,"""JF""",4
18,"18177",373,253,252,1,1,"""JF""",0
18,"18105",3822,2688,2650,12,38,"""JF""",4
18,"18906",911,722,716,4,6,"""JF""",0
18,"18088",1530,1152,1142,0,10,"""JF""",0
18,"18020",501,365,358,2,7,"""JF""",0
18,"18059",4253,3166,3123,22,43,"""JF""",2
18,"18082",827,587,577,5,10,"""JF""",0
18,"18021",17869,13238,13004,110,234,"""JF""",27
18,"18083",228,189,188,1,1,"""JF""",0
18,"18164",1794,1225,1205,9,20,"""JF""",0
18,"18193",14802,11165,10973,110,192,"""JF""",24
18,"18024",831,682,667,6,15,"""JF""",2
18,"18070",289,224,222,3,2,"""JF""",0
18,"18099",1581,1279,1245,5,34,"""JF""",3
18,"18065",591,482,468,4,14,"""JF""",0
18,"18183",624,442,441,1,1,"""JF""",1
18,"18069",497,374,366,4,8,"""JF""",0
18,"18028",907,766,756,0,10,"""JF""",1
18,"18067",681,511,507,3,4,"""JF""",0
18,"18179",503,346,343,3,3,"""JF""",0
18,"18049",596,485,481,0,4,"""JF""",3
18,"18102",8227,6100,5969,32,131,"""JF""",10
18,"18106",415,300,295,0,5,"""JF""",1
18,"18035",1190,965,952,4,13,"""JF""",0
18,"18121",130,104,103,3,1,"""JF""",1
18,"18013",4152,3168,3103,16,65,"""JF""",3
18,"18145",10869,8532,8405,69,127,"""JF""",15
18,"18910",730,491,487,0,4,"""JF""",0
18,"18158",8010,5524,5449,23,75,"""JF""",6
18,"18029",1813,1183,1169,9,14,"""JF""",0
18,"18046",1753,1206,1185,1,21,"""JF""",2
18,"18154",975,701,699,3,2,"""JF""",1
18,"18913",781,590,577,5,13,"""JF""",1
18,"18094",2304,1845,1798,16,47,"""JF""",0
18,"18128",342,274,272,1,2,"""JF""",0
18,"18909",539,432,426,1,6,"""JF""",0
18,"18168",781,613,604,6,9,"""JF""",1
18,"18184",2170,1688,1656,3,32,"""JF""",2
18,"18115",2650,1988,1975,20,13,"""JF""",1
18,"18108",826,677,669,3,8,"""JF""",1
18,"18014",6898,5262,5162,43,100,"""JF""",10
18,"18097",995,708,702,4,6,"""JF""",0
18,"18047",6074,4437,4353,33,84,"""JF""",8
18,"18095",2002,1566,1537,11,29,"""JF""",1
18,"18174",434,362,357,0,5,"""JF""",0
18,"18063",1217,712,702,6,10,"""JF""",0
18,"18072",664,481,473,0,8,"""JF""",1
18,"18122",16001,11761,11556,110,205,"""JF""",10
18,"18152",906,692,686,1,6,"""JF""",0
18,"18025",279,214,212,0,2,"""JF""",0
18,"18098",5994,4293,4247,29,46,"""JF""",1
18,"18907",1774,1426,1415,10,11,"""JF""",2
18,"18903",851,644,636,1,8,"""JF""",0
25,"25006",317,246,245,3,1,"JxCAT-JUNTS",41
25,"25206",250,189,188,2,1,"JxCAT-JUNTS",62
25,"25096",888,663,661,2,2,"JxCAT-JUNTS",198
8,"8207",2014,1736,1730,9,6,"JxCAT-JUNTS",459
43,"43050",2634,1881,1868,13,13,"JxCAT-JUNTS",159
43,"43044",3949,3060,3032,31,28,"JxCAT-JUNTS",208
25,"25037",366,286,284,3,2,"JxCAT-JUNTS",92
25,"25015",335,262,260,8,2,"JxCAT-JUNTS",65
43,"43102",463,384,379,2,5,"JxCAT-JUNTS",52
25,"25105",103,89,88,1,1,"JxCAT-JUNTS",31
43,"43172",337,261,257,2,4,"JxCAT-JUNTS",43
17,"17129",144,120,120,1,0,"JxCAT-JUNTS",28
43,"43135",341,283,280,4,3,"JxCAT-JUNTS",84
8,"8209",6896,5269,5244,25,25,"JxCAT-JUNTS",460
43,"43074",1812,1419,1412,4,7,"JxCAT-JUNTS",276
8,"8296",1843,1520,1514,10,6,"JxCAT-JUNTS",271
8,"8031",2336,1886,1882,11,4,"JxCAT-JUNTS",406
8,"8285",10321,8169,8120,52,49,"JxCAT-JUNTS",1959
8,"8074",11054,8273,8235,34,38,"JxCAT-JUNTS",530
25,"25251",713,562,558,4,4,"JxCAT-JUNTS",130
17,"17093",922,716,715,2,1,"JxCAT-JUNTS",145
8,"8008",179,139,138,0,1,"JxCAT-JUNTS",35
17,"17121",229,184,184,1,0,"JxCAT-JUNTS",73
43,"43154",126,111,111,0,0,"JxCAT-JUNTS",19
25,"25127",214,172,172,0,0,"JxCAT-JUNTS",42
17,"17136",195,156,155,0,1,"JxCAT-JUNTS",38
8,"8252",24729,19751,19642,125,109,"JxCAT-JUNTS",564
43,"43067",528,450,445,1,5,"JxCAT-JUNTS",81
25,"25027",977,765,763,4,2,"JxCAT-JUNTS",234
43,"43002",1875,1367,1348,11,19,"JxCAT-JUNTS",133
8,"8278",4893,4034,4018,17,16,"JxCAT-JUNTS",1268
17,"17175",564,381,381,1,0,"JxCAT-JUNTS",34
8,"8076",16497,12734,12667,82,67,"JxCAT-JUNTS",994
8,"8269",2712,2258,2250,19,8,"JxCAT-JUNTS",546
8,"8903",197,177,176,0,1,"JxCAT-JUNTS",64
43,"43012",3647,3028,3019,15,9,"JxCAT-JUNTS",399
8,"8135",6735,5445,5421,36,24,"JxCAT-JUNTS",322
17,"17901",983,790,789,3,1,"JxCAT-JUNTS",206
25,"25081",287,221,220,2,1,"JxCAT-JUNTS",59
17,"17061",183,148,148,0,0,"JxCAT-JUNTS",47
8,"8096",43555,34070,33871,194,199,"JxCAT-JUNTS",4089
43,"43177",284,243,242,0,1,"JxCAT-JUNTS",51
25,"25254",711,576,571,5,5,"JxCAT-JUNTS",134
43,"43030",482,373,372,2,1,"JxCAT-JUNTS",57
43,"43042",2198,1820,1816,8,4,"JxCAT-JUNTS",320
43,"43080",227,195,195,0,0,"JxCAT-JUNTS",60
8,"8243",156,139,139,0,0,"JxCAT-JUNTS",54
8,"8080",39,30,30,0,0,"JxCAT-JUNTS",6
25,"25129",159,115,115,2,0,"JxCAT-JUNTS",36
43,"43091",123,93,93,1,0,"JxCAT-JUNTS",7
25,"25156",784,608,605,4,3,"JxCAT-JUNTS",154
25,"25093",629,489,487,4,2,"JxCAT-JUNTS",146
17,"17125",131,98,97,1,1,"JxCAT-JUNTS",36
8,"8152",116,94,94,0,0,"JxCAT-JUNTS",32
43,"43108",1778,1374,1365,6,9,"JxCAT-JUNTS",326
8,"8083",1672,1478,1471,7,7,"JxCAT-JUNTS",513
43,"43066",155,121,121,1,0,"JxCAT-JUNTS",18
17,"17126",318,279,279,0,0,"JxCAT-JUNTS",96
8,"8075",4059,3127,3119,14,8,"JxCAT-JUNTS",353
17,"17185",2275,1777,1768,7,9,"JxCAT-JUNTS",560
25,"25220",994,822,816,3,6,"JxCAT-JUNTS",390
8,"8195",76,69,69,0,0,"JxCAT-JUNTS",35
8,"8065",1180,967,964,4,3,"JxCAT-JUNTS",282
43,"43118",425,357,356,0,1,"JxCAT-JUNTS",67
8,"8169",48284,37528,37326,218,202,"JxCAT-JUNTS",1392
17,"17009",4051,3263,3248,14,15,"JxCAT-JUNTS",934
43,"43025",590,476,472,0,4,"JxCAT-JUNTS",34
25,"25111",113,90,89,0,1,"JxCAT-JUNTS",43
17,"17184",1264,1068,1060,5,8,"JxCAT-JUNTS",357
17,"17005",460,336,331,0,5,"JxCAT-JUNTS",70
8,"8070",266,232,232,0,0,"JxCAT-JUNTS",67
8,"8140",4778,3756,3737,19,19,"JxCAT-JUNTS",697
8,"8221",12699,10571,10537,53,34,"JxCAT-JUNTS",1558
25,"25123",189,151,151,0,0,"JxCAT-JUNTS",48
25,"25062",695,578,573,3,5,"JxCAT-JUNTS",147
8,"8191",5270,4176,4162,19,14,"JxCAT-JUNTS",658
17,"17148",1531,1165,1153,4,12,"JxCAT-JUNTS",308
8,"8022",12219,9089,9038,42,51,"JxCAT-JUNTS",2166
8,"8084",1167,941,936,6,5,"JxCAT-JUNTS",191
43,"43028",2766,2007,1988,7,19,"JxCAT-JUNTS",285
25,"25145",76,66,66,1,0,"JxCAT-JUNTS",26
8,"8035",12871,9574,9538,31,36,"JxCAT-JUNTS",1564
8,"8118",17542,14101,14059,56,42,"JxCAT-JUNTS",1977
8,"8241",69,56,56,0,0,"JxCAT-JUNTS",16
8,"8089",34019,26317,26191,170,126,"JxCAT-JUNTS",1445
17,"17110",1329,1064,1054,5,10,"JxCAT-JUNTS",205
17,"17163",2824,2358,2351,13,7,"JxCAT-JUNTS",855
43,"43018",385,335,334,3,1,"JxCAT-JUNTS",121
43,"43056",806,616,613,5,3,"JxCAT-JUNTS",96
43,"43039",105,85,85,0,0,"JxCAT-JUNTS",16
17,"17168",379,332,329,0,3,"JxCAT-JUNTS",99
43,"43079",356,306,305,1,1,"JxCAT-JUNTS",71
25,"25137",8686,6327,6296,46,31,"JxCAT-JUNTS",1521
25,"25104",122,91,91,0,0,"JxCAT-JUNTS",32
8,"8233",1846,1485,1478,8,7,"JxCAT-JUNTS",419
8,"8227",2410,1882,1877,10,5,"JxCAT-JUNTS",374
8,"8032",2087,1607,1598,9,9,"JxCAT-JUNTS",278
8,"8016",1812,1454,1448,6,6,"JxCAT-JUNTS",274
8,"8123",19489,16197,16135,58,62,"JxCAT-JUNTS",1787
17,"17227",139,106,106,0,0,"JxCAT-JUNTS",23
25,"25150",165,136,133,0,3,"JxCAT-JUNTS",59
8,"8302",9373,7001,6934,61,67,"JxCAT-JUNTS",280
8,"8232",1786,1444,1434,9,10,"JxCAT-JUNTS",289
17,"17064",326,263,261,2,2,"JxCAT-JUNTS",62
43,"43052",934,765,756,2,9,"JxCAT-JUNTS",115
43,"43001",694,543,543,5,0,"JxCAT-JUNTS",112
25,"25110",2731,2121,2106,14,15,"JxCAT-JUNTS",492
25,"25012",2342,1748,1739,10,9,"JxCAT-JUNTS",266
8,"8280",95,78,78,1,0,"JxCAT-JUNTS",31
8,"8131",741,585,585,4,0,"JxCAT-JUNTS",134
8,"8202",12843,10074,10025,57,49,"JxCAT-JUNTS",1869
8,"8307",49310,38223,38022,162,201,"JxCAT-JUNTS",3814
8,"8264",4535,3623,3613,13,10,"JxCAT-JUNTS",699
25,"25157",162,137,137,4,0,"JxCAT-JUNTS",47
25,"25064",98,88,88,0,0,"JxCAT-JUNTS",31
17,"17081",248,192,190,0,2,"JxCAT-JUNTS",68
17,"17204",596,461,460,2,1,"JxCAT-JUNTS",111
8,"8242",222,180,180,0,0,"JxCAT-JUNTS",49
43,"43023",214,186,186,1,0,"JxCAT-JUNTS",23
25,"25023",4527,3621,3601,23,20,"JxCAT-JUNTS",742
25,"25031",57,39,39,0,0,"JxCAT-JUNTS",2
25,"25057",214,162,161,0,1,"JxCAT-JUNTS",11
43,"43092",7235,5200,5174,21,26,"JxCAT-JUNTS",634
8,"8259",6904,5626,5601,27,25,"JxCAT-JUNTS",1098
25,"25913",86,77,77,0,0,"JxCAT-JUNTS",19
25,"25089",97,72,71,1,1,"JxCAT-JUNTS",15
25,"25002",467,357,356,2,1,"JxCAT-JUNTS",83
8,"8079",334,284,282,0,2,"JxCAT-JUNTS",72
17,"17117",14471,10565,10504,52,61,"JxCAT-JUNTS",1729
8,"8137",274,232,229,0,3,"JxCAT-JUNTS",76
8,"8226",926,811,807,1,4,"JxCAT-JUNTS",177
8,"8092",3714,2912,2889,8,23,"JxCAT-JUNTS",688
43,"43026",765,614,613,3,1,"JxCAT-JUNTS",129
8,"8190",258,216,215,1,1,"JxCAT-JUNTS",41
25,"25239",595,367,366,3,1,"JxCAT-JUNTS",79
43,"43032",466,379,379,1,0,"JxCAT-JUNTS",96
8,"8133",128,98,98,5,0,"JxCAT-JUNTS",36
17,"17199",6955,5328,5308,23,20,"JxCAT-JUNTS",1221
43,"43034",468,393,393,0,0,"JxCAT-JUNTS",77
17,"17024",285,228,227,0,1,"JxCAT-JUNTS",79
25,"25087",56,49,49,0,0,"JxCAT-JUNTS",19
8,"8057",61,50,50,0,0,"JxCAT-JUNTS",14
8,"8189",122,106,106,0,0,"JxCAT-JUNTS",43
43,"43149",684,533,533,4,0,"JxCAT-JUNTS",78
17,"17003",102,75,75,0,0,"JxCAT-JUNTS",26
25,"25102",661,517,511,8,6,"JxCAT-JUNTS",142
8,"8056",42727,33215,33054,220,161,"JxCAT-JUNTS",1920
25,"25036",184,144,143,0,1,"JxCAT-JUNTS",20
25,"25911",424,332,331,1,1,"JxCAT-JUNTS",97
8,"8266",43383,35117,34994,178,123,"JxCAT-JUNTS",2383
17,"17213",5535,3998,3985,20,13,"JxCAT-JUNTS",907
17,"17223",800,623,616,5,7,"JxCAT-JUNTS",110
43,"43009",1391,1086,1078,3,8,"JxCAT-JUNTS",194
8,"8125",25485,19719,19627,101,92,"JxCAT-JUNTS",1031
43,"43068",483,367,365,5,2,"JxCAT-JUNTS",24
17,"17142",2673,2250,2241,14,9,"JxCAT-JUNTS",504
25,"25141",152,118,118,1,0,"JxCAT-JUNTS",38
25,"25046",407,349,347,1,2,"JxCAT-JUNTS",70
25,"25234",4201,3087,3072,13,15,"JxCAT-JUNTS",736
8,"8206",737,625,624,3,1,"JxCAT-JUNTS",139
8,"8091",5413,4301,4283,20,18,"JxCAT-JUNTS",429
43,"43036",865,605,602,1,3,"JxCAT-JUNTS",103
8,"8100",2092,1792,1782,16,10,"JxCAT-JUNTS",623
43,"43165",572,492,492,1,0,"JxCAT-JUNTS",126
8,"8109",208,184,183,0,1,"JxCAT-JUNTS",46
17,"17146",3127,2404,2381,11,23,"JxCAT-JUNTS",318
25,"25035",366,306,302,2,4,"JxCAT-JUNTS",82
8,"8006",11774,9039,8981,33,58,"JxCAT-JUNTS",1611
8,"8246",1672,1412,1406,7,6,"JxCAT-JUNTS",422
25,"25112",268,214,212,2,2,"JxCAT-JUNTS",64
25,"25250",330,261,258,1,3,"JxCAT-JUNTS",66
43,"43010",337,286,284,2,2,"JxCAT-JUNTS",83
17,"17215",2227,1936,1925,12,11,"JxCAT-JUNTS",388
25,"25169",167,118,117,0,1,"JxCAT-JUNTS",28
8,"8110",13592,10111,10058,50,53,"JxCAT-JUNTS",1110
25,"25058",4358,3269,3254,7,15,"JxCAT-JUNTS",907
8,"8101",174954,129953,129198,680,755,"JxCAT-JUNTS",4428
8,"8268",971,746,737,3,9,"JxCAT-JUNTS",132
25,"25048",1632,1274,1264,7,10,"JxCAT-JUNTS",309
17,"17048",6251,4565,4537,20,28,"JxCAT-JUNTS",897
43,"43122",111,98,97,0,1,"JxCAT-JUNTS",11
25,"25021",2541,1891,1882,14,9,"JxCAT-JUNTS",371
17,"17228",285,229,229,1,0,"JxCAT-JUNTS",62
17,"17049",3204,2634,2615,9,19,"JxCAT-JUNTS",565
8,"8061",1590,1236,1233,8,3,"JxCAT-JUNTS",154
43,"43099",286,234,234,0,0,"JxCAT-JUNTS",80
25,"25209",1550,1192,1172,4,20,"JxCAT-JUNTS",290
17,"17190",838,681,677,0,4,"JxCAT-JUNTS",196
8,"8041",10692,7805,7732,48,73,"JxCAT-JUNTS",436
8,"8289",4457,3605,3594,20,11,"JxCAT-JUNTS",398
43,"43104",1762,1410,1401,5,9,"JxCAT-JUNTS",238
8,"8148",2334,1803,1794,6,9,"JxCAT-JUNTS",110
25,"25049",155,113,111,0,2,"JxCAT-JUNTS",33
8,"8071",241,200,200,0,0,"JxCAT-JUNTS",36
25,"25248",880,714,713,4,1,"JxCAT-JUNTS",240
8,"8249",272,248,248,2,0,"JxCAT-JUNTS",72
17,"17095",19938,13998,13918,69,80,"JxCAT-JUNTS",1586
8,"8146",1358,1086,1079,2,7,"JxCAT-JUNTS",74
43,"43905",14941,10510,10446,40,64,"JxCAT-JUNTS",795
8,"8160",316,252,247,2,5,"JxCAT-JUNTS",83
43,"43107",383,308,308,1,0,"JxCAT-JUNTS",34
43,"43164",306,228,228,0,0,"JxCAT-JUNTS",20
8,"8267",6748,5389,5362,28,27,"JxCAT-JUNTS",563
25,"25179",171,134,134,1,0,"JxCAT-JUNTS",43
17,"17152",11026,7610,7564,70,46,"JxCAT-JUNTS",993
25,"25238",205,163,163,2,0,"JxCAT-JUNTS",60
8,"8143",2719,2121,2109,10,12,"JxCAT-JUNTS",281
8,"8028",1088,783,780,2,3,"JxCAT-JUNTS",45
25,"25232",1356,1066,1061,2,5,"JxCAT-JUNTS",286
25,"25044",178,145,144,6,1,"JxCAT-JUNTS",52
8,"8250",7182,5461,5421,38,40,"JxCAT-JUNTS",247
8,"8177",39,31,31,0,0,"JxCAT-JUNTS",6
8,"8034",784,648,646,1,2,"JxCAT-JUNTS",172
8,"8192",5679,4605,4589,20,16,"JxCAT-JUNTS",926
8,"8069",3280,2691,2680,17,11,"JxCAT-JUNTS",331
17,"17025",1170,972,967,6,5,"JxCAT-JUNTS",305
25,"25016",2083,1590,1587,8,3,"JxCAT-JUNTS",368
25,"25052",1562,1273,1264,3,9,"JxCAT-JUNTS",301
17,"17019",1784,1472,1462,3,10,"JxCAT-JUNTS",553
17,"17138",845,650,646,0,4,"JxCAT-JUNTS",68
17,"17167",2609,2122,2102,14,20,"JxCAT-JUNTS",618
43,"43013",4392,3341,3321,14,20,"JxCAT-JUNTS",586
25,"25164",357,264,261,4,3,"JxCAT-JUNTS",100
43,"43006",676,531,525,4,6,"JxCAT-JUNTS",54
8,"8240",9453,7807,7776,21,31,"JxCAT-JUNTS",1223
25,"25005",274,202,202,2,0,"JxCAT-JUNTS",59
8,"8088",12248,9945,9904,57,41,"JxCAT-JUNTS",1831
25,"25073",546,420,418,2,2,"JxCAT-JUNTS",101
8,"8116",558,459,459,0,0,"JxCAT-JUNTS",151
17,"17042",408,313,311,0,2,"JxCAT-JUNTS",92
25,"25122",1925,1505,1497,23,8,"JxCAT-JUNTS",364
17,"17114",23269,17558,17474,91,84,"JxCAT-JUNTS",4880
17,"17006",1186,880,878,10,2,"JxCAT-JUNTS",203
17,"17158",468,337,336,1,1,"JxCAT-JUNTS",52
43,"43907",4359,3370,3346,22,24,"JxCAT-JUNTS",184
8,"8122",1716,1260,1254,8,6,"JxCAT-JUNTS",161
43,"43137",1905,1515,1499,15,16,"JxCAT-JUNTS",179
25,"25909",140,108,107,2,1,"JxCAT-JUNTS",36
8,"8305",27533,21656,21539,96,117,"JxCAT-JUNTS",3443
17,"17106",143,124,123,0,1,"JxCAT-JUNTS",36
25,"25182",1043,842,839,9,3,"JxCAT-JUNTS",147
17,"17115",278,226,222,2,4,"JxCAT-JUNTS",53
17,"17033",5587,4157,4130,13,27,"JxCAT-JUNTS",820
25,"25038",1482,1111,1094,11,17,"JxCAT-JUNTS",321
8,"8039",402,334,334,2,0,"JxCAT-JUNTS",80
17,"17028",297,238,237,1,1,"JxCAT-JUNTS",101
17,"17011",651,544,544,4,0,"JxCAT-JUNTS",186
17,"17165",634,516,512,3,4,"JxCAT-JUNTS",171
8,"8179",611,496,493,2,3,"JxCAT-JUNTS",60
25,"25904",162,147,147,3,0,"JxCAT-JUNTS",55
25,"25210",1079,867,853,4,14,"JxCAT-JUNTS",234
17,"17034",7205,5337,5291,16,46,"JxCAT-JUNTS",1056
25,"25166",172,137,136,1,1,"JxCAT-JUNTS",42
25,"25222",66,57,57,0,0,"JxCAT-JUNTS",26
8,"8098",2409,1916,1912,9,4,"JxCAT-JUNTS",286
43,"43144",1236,1025,1021,8,4,"JxCAT-JUNTS",138
25,"25140",773,573,571,5,2,"JxCAT-JUNTS",137
8,"8093",24,20,20,0,0,"JxCAT-JUNTS",2
43,"43051",9092,6577,6502,26,75,"JxCAT-JUNTS",304
25,"25098",232,172,170,2,2,"JxCAT-JUNTS",54
17,"17209",615,519,517,2,2,"JxCAT-JUNTS",106
43,"43059",250,214,214,1,0,"JxCAT-JUNTS",62
25,"25223",911,732,723,6,9,"JxCAT-JUNTS",222
43,"43123",71092,53689,53369,241,320,"JxCAT-JUNTS",6034
8,"8166",962,753,745,7,8,"JxCAT-JUNTS",202
8,"8113",52518,39750,39592,198,158,"JxCAT-JUNTS",7391
8,"8214",6966,5648,5633,21,15,"JxCAT-JUNTS",981
8,"8108",5192,4204,4189,26,15,"JxCAT-JUNTS",422
17,"17120",820,604,598,3,6,"JxCAT-JUNTS",149
43,"43062",259,223,220,2,3,"JxCAT-JUNTS",36
8,"8223",1886,1434,1425,4,9,"JxCAT-JUNTS",275
17,"17026",543,450,449,4,1,"JxCAT-JUNTS",154
17,"17181",3467,2664,2648,10,16,"JxCAT-JUNTS",501
8,"8002",220,184,183,2,1,"JxCAT-JUNTS",60
43,"43082",351,303,297,1,6,"JxCAT-JUNTS",89
8,"8047",3737,2903,2876,16,27,"JxCAT-JUNTS",450
25,"25068",531,402,399,6,3,"JxCAT-JUNTS",152
43,"43148",90763,69756,69423,299,333,"JxCAT-JUNTS",5898
25,"25126",284,233,232,1,1,"JxCAT-JUNTS",42
43,"43156",3956,2993,2965,23,28,"JxCAT-JUNTS",381
8,"8293",228,187,187,1,0,"JxCAT-JUNTS",46
17,"17902",1306,1076,1074,3,2,"JxCAT-JUNTS",343
25,"25020",274,221,221,2,0,"JxCAT-JUNTS",60
8,"8003",7183,5761,5742,39,19,"JxCAT-JUNTS",1017
25,"25003",3721,2828,2815,19,13,"JxCAT-JUNTS",687
43,"43015",119,101,101,0,0,"JxCAT-JUNTS",24
17,"17074",532,436,426,2,10,"JxCAT-JUNTS",71
25,"25221",117,92,92,0,0,"JxCAT-JUNTS",20
25,"25075",131,102,102,0,0,"JxCAT-JUNTS",35
25,"25013",2108,1570,1557,12,13,"JxCAT-JUNTS",218
17,"17137",3467,2925,2912,15,13,"JxCAT-JUNTS",863
8,"8303",256,215,213,1,2,"JxCAT-JUNTS",50
8,"8144",713,565,563,5,2,"JxCAT-JUNTS",128
25,"25249",176,139,138,1,1,"JxCAT-JUNTS",33
43,"43100",3489,2820,2816,15,4,"JxCAT-JUNTS",249
17,"17195",342,296,295,3,1,"JxCAT-JUNTS",90
8,"8215",2589,2044,2034,19,10,"JxCAT-JUNTS",551
25,"25905",369,308,307,1,1,"JxCAT-JUNTS",81
43,"43046",90,73,73,1,0,"JxCAT-JUNTS",16
17,"17055",143,126,125,0,1,"JxCAT-JUNTS",38
43,"43011",1079,912,909,1,3,"JxCAT-JUNTS",196
17,"17109",698,558,553,1,5,"JxCAT-JUNTS",179
8,"8156",11155,8956,8923,60,33,"JxCAT-JUNTS",963
25,"25042",208,160,160,1,0,"JxCAT-JUNTS",68
43,"43090",1169,749,742,2,7,"JxCAT-JUNTS",38
8,"8038",1525,1228,1220,2,8,"JxCAT-JUNTS",243
8,"8251",5127,3972,3940,17,32,"JxCAT-JUNTS",353
25,"25017",232,184,181,0,3,"JxCAT-JUNTS",56
43,"43098",354,291,291,1,0,"JxCAT-JUNTS",92
43,"43049",727,589,584,2,5,"JxCAT-JUNTS",130
17,"17080",144,124,124,2,0,"JxCAT-JUNTS",29
43,"43047",4209,2878,2856,23,22,"JxCAT-JUNTS",205
8,"8222",1819,1484,1476,11,8,"JxCAT-JUNTS",219
25,"25155",618,493,489,2,4,"JxCAT-JUNTS",142
17,"17016",719,584,581,1,3,"JxCAT-JUNTS",169
8,"8059",344,292,290,2,2,"JxCAT-JUNTS",69
8,"8120",7048,5892,5881,49,11,"JxCAT-JUNTS",2028
17,"17188",169,139,138,1,1,"JxCAT-JUNTS",55
8,"8050",136,115,114,0,1,"JxCAT-JUNTS",49
17,"17086",1745,1223,1210,7,13,"JxCAT-JUNTS",131
25,"25139",491,390,388,3,2,"JxCAT-JUNTS",83
43,"43115",128,112,111,1,1,"JxCAT-JUNTS",36
17,"17004",533,445,441,3,4,"JxCAT-JUNTS",117
8,"8276",233,180,180,0,0,"JxCAT-JUNTS",40
8,"8048",569,442,442,2,0,"JxCAT-JUNTS",109
25,"25903",229,189,188,0,1,"JxCAT-JUNTS",51
17,"17180",8500,6462,6431,28,31,"JxCAT-JUNTS",1849
43,"43116",463,381,379,2,2,"JxCAT-JUNTS",92
43,"43121",591,463,462,0,1,"JxCAT-JUNTS",109
17,"17027",2866,2375,2364,8,11,"JxCAT-JUNTS",530
25,"25001",139,104,103,1,1,"JxCAT-JUNTS",28
8,"8162",2124,1659,1651,7,8,"JxCAT-JUNTS",164
25,"25072",5874,4468,4450,24,18,"JxCAT-JUNTS",951
25,"25183",535,419,416,4,3,"JxCAT-JUNTS",111
17,"17018",494,405,402,1,3,"JxCAT-JUNTS",106
25,"25121",635,436,429,1,7,"JxCAT-JUNTS",34
17,"17047",4968,3447,3429,22,18,"JxCAT-JUNTS",573
17,"17186",3824,3115,3098,15,17,"JxCAT-JUNTS",529
25,"25225",541,427,420,4,7,"JxCAT-JUNTS",139
43,"43176",746,588,586,7,2,"JxCAT-JUNTS",147
25,"25152",144,106,106,1,0,"JxCAT-JUNTS",40
8,"8046",13478,10989,10939,67,50,"JxCAT-JUNTS",1496
25,"25180",228,176,174,1,2,"JxCAT-JUNTS",69
17,"17173",182,156,156,0,0,"JxCAT-JUNTS",40
17,"17150",1426,1199,1192,8,7,"JxCAT-JUNTS",431
8,"8304",816,686,678,1,8,"JxCAT-JUNTS",147
8,"8062",1004,829,826,11,3,"JxCAT-JUNTS",157
17,"17170",180,147,147,2,0,"JxCAT-JUNTS",41
25,"25908",221,159,158,1,1,"JxCAT-JUNTS",41
43,"43120",421,302,297,2,5,"JxCAT-JUNTS",33
43,"43902",2743,1996,1980,16,16,"JxCAT-JUNTS",196
17,"17073",1939,1695,1693,7,2,"JxCAT-JUNTS",602
8,"8102",28794,22420,22317,92,103,"JxCAT-JUNTS",4078
8,"8261",2378,1821,1815,14,6,"JxCAT-JUNTS",200
43,"43071",891,713,706,6,7,"JxCAT-JUNTS",171
25,"25231",494,410,408,2,2,"JxCAT-JUNTS",102
25,"25063",95,61,61,0,0,"JxCAT-JUNTS",7
8,"8106",7469,5816,5795,34,21,"JxCAT-JUNTS",637
8,"8229",521,435,433,3,2,"JxCAT-JUNTS",137
25,"25099",1291,981,978,2,3,"JxCAT-JUNTS",309
17,"17030",650,479,477,4,2,"JxCAT-JUNTS",103
43,"43061",38,28,28,0,0,"JxCAT-JUNTS",15
43,"43159",81,63,62,0,1,"JxCAT-JUNTS",29
17,"17075",334,282,281,5,1,"JxCAT-JUNTS",50
8,"8149",984,770,768,3,2,"JxCAT-JUNTS",223
8,"8010",4207,3327,3304,13,23,"JxCAT-JUNTS",598
8,"8238",14851,12472,12428,50,44,"JxCAT-JUNTS",1725
8,"8230",7666,6202,6168,30,34,"JxCAT-JUNTS",887
17,"17155",14861,10307,10234,52,73,"JxCAT-JUNTS",1666
8,"8132",361,281,281,2,0,"JxCAT-JUNTS",108
17,"17100",195,157,154,0,3,"JxCAT-JUNTS",70
43,"43055",1988,1631,1622,7,9,"JxCAT-JUNTS",367
43,"43170",878,706,704,7,2,"JxCAT-JUNTS",146
8,"8196",19444,15361,15263,90,98,"JxCAT-JUNTS",450
17,"17123",345,304,303,4,1,"JxCAT-JUNTS",145
8,"8185",197,172,171,2,1,"JxCAT-JUNTS",35
25,"25100",184,145,144,1,1,"JxCAT-JUNTS",54
8,"8201",447,327,324,5,3,"JxCAT-JUNTS",104
17,"17116",354,283,282,0,1,"JxCAT-JUNTS",81
17,"17196",242,198,198,1,0,"JxCAT-JUNTS",37
43,"43904",2861,2083,2058,27,25,"JxCAT-JUNTS",279
8,"8198",4640,3713,3691,23,22,"JxCAT-JUNTS",621
25,"25033",1121,899,890,5,9,"JxCAT-JUNTS",213
43,"43133",5605,4202,4168,21,34,"JxCAT-JUNTS",500
8,"8292",1062,835,831,3,4,"JxCAT-JUNTS",121
8,"8228",288,239,239,2,0,"JxCAT-JUNTS",46
17,"17082",436,341,339,0,2,"JxCAT-JUNTS",95
17,"17112",194,154,152,2,2,"JxCAT-JUNTS",45
43,"43073",84,68,67,0,1,"JxCAT-JUNTS",28
8,"8134",842,649,646,3,3,"JxCAT-JUNTS",105
8,"8052",139,111,110,0,1,"JxCAT-JUNTS",54
8,"8211",33731,27698,27561,126,137,"JxCAT-JUNTS",1689
25,"25086",521,414,411,2,3,"JxCAT-JUNTS",97
25,"25185",679,493,491,6,2,"JxCAT-JUNTS",116
8,"8257",103,86,86,1,0,"JxCAT-JUNTS",34
8,"8099",753,565,561,2,4,"JxCAT-JUNTS",118
25,"25092",127,101,99,1,2,"JxCAT-JUNTS",29
17,"17203",165,135,135,0,0,"JxCAT-JUNTS",30
8,"8021",61,47,45,0,2,"JxCAT-JUNTS",11
25,"25168",488,408,407,6,1,"JxCAT-JUNTS",122
43,"43140",2438,1847,1837,16,10,"JxCAT-JUNTS",121
8,"8005",6380,5122,5106,18,16,"JxCAT-JUNTS",1036
25,"25120",92704,68713,68361,445,352,"JxCAT-JUNTS",9460
8,"8244",6041,4994,4970,33,24,"JxCAT-JUNTS",314
17,"17013",2774,2180,2173,15,7,"JxCAT-JUNTS",395
8,"8256",691,571,568,3,3,"JxCAT-JUNTS",79
25,"25203",8798,6279,6231,26,48,"JxCAT-JUNTS",1119
17,"17084",231,181,180,1,1,"JxCAT-JUNTS",53
8,"8104",653,516,516,2,0,"JxCAT-JUNTS",142
8,"8273",2353,1944,1934,9,10,"JxCAT-JUNTS",478
25,"25032",67,53,53,0,0,"JxCAT-JUNTS",12
17,"17149",364,314,314,0,0,"JxCAT-JUNTS",119
25,"25115",801,638,637,4,1,"JxCAT-JUNTS",231
43,"43157",345,303,303,0,0,"JxCAT-JUNTS",86
25,"25146",221,172,170,3,2,"JxCAT-JUNTS",67
17,"17103",5084,3575,3543,13,32,"JxCAT-JUNTS",485
8,"8294",2063,1644,1643,10,1,"JxCAT-JUNTS",301
25,"25069",425,329,327,1,2,"JxCAT-JUNTS",90
25,"25204",1191,936,930,5,6,"JxCAT-JUNTS",227
43,"43125",890,700,698,12,2,"JxCAT-JUNTS",60
43,"43160",1322,1051,1045,0,6,"JxCAT-JUNTS",118
25,"25228",3115,2468,2459,19,9,"JxCAT-JUNTS",572
25,"25076",134,94,93,0,1,"JxCAT-JUNTS",36
25,"25148",219,168,168,1,0,"JxCAT-JUNTS",62
43,"43114",375,306,305,0,1,"JxCAT-JUNTS",65
43,"43158",77,61,61,1,0,"JxCAT-JUNTS",28
43,"43174",144,128,127,0,1,"JxCAT-JUNTS",23
17,"17044",6930,5514,5493,26,21,"JxCAT-JUNTS",1552
17,"17105",247,194,194,1,0,"JxCAT-JUNTS",47
8,"8029",3560,3027,3019,13,8,"JxCAT-JUNTS",617
8,"8142",139,126,126,1,0,"JxCAT-JUNTS",44
25,"25125",389,303,300,1,3,"JxCAT-JUNTS",88
17,"17023",27144,20301,20146,120,155,"JxCAT-JUNTS",1999
43,"43003",350,266,264,3,2,"JxCAT-JUNTS",37
25,"25906",210,157,155,0,2,"JxCAT-JUNTS",37
8,"8068",6878,5456,5437,25,19,"JxCAT-JUNTS",445
8,"8295",11184,8566,8529,43,37,"JxCAT-JUNTS",618
25,"25008",1088,867,857,7,10,"JxCAT-JUNTS",220
8,"8058",1787,1357,1340,5,17,"JxCAT-JUNTS",138
8,"8217",25355,20935,20855,110,80,"JxCAT-JUNTS",1189
17,"17001",580,459,454,3,5,"JxCAT-JUNTS",88
8,"8290",1534,1289,1284,9,5,"JxCAT-JUNTS",272
8,"8284",12482,8959,8887,41,72,"JxCAT-JUNTS",1219
8,"8042",2362,1910,1904,7,6,"JxCAT-JUNTS",182
25,"25224",126,98,98,0,0,"JxCAT-JUNTS",26
17,"17067",697,581,578,4,3,"JxCAT-JUNTS",183
17,"17096",164,113,113,1,0,"JxCAT-JUNTS",40
8,"8054",9155,7468,7428,43,40,"JxCAT-JUNTS",536
17,"17102",548,439,435,3,4,"JxCAT-JUNTS",107
8,"8063",467,406,405,3,1,"JxCAT-JUNTS",95
17,"17192",146,121,120,0,1,"JxCAT-JUNTS",47
8,"8183",4563,3628,3613,9,15,"JxCAT-JUNTS",937
25,"25060",69,49,49,1,0,"JxCAT-JUNTS",15
43,"43078",843,653,644,4,9,"JxCAT-JUNTS",149
8,"8112",12935,9822,9765,74,57,"JxCAT-JUNTS",2089
8,"8306",527,390,388,2,2,"JxCAT-JUNTS",50
17,"17078",336,252,251,3,1,"JxCAT-JUNTS",96
43,"43045",146,128,127,0,1,"JxCAT-JUNTS",36
17,"17151",185,150,150,1,0,"JxCAT-JUNTS",32
8,"8007",6775,5447,5419,21,28,"JxCAT-JUNTS",1098
17,"17147",7959,6164,6130,45,34,"JxCAT-JUNTS",1482
8,"8153",559,460,458,2,2,"JxCAT-JUNTS",102
8,"8066",1463,1185,1181,9,4,"JxCAT-JUNTS",117
43,"43136",10463,7789,7749,36,40,"JxCAT-JUNTS",935
25,"25173",1649,1278,1262,5,16,"JxCAT-JUNTS",159
17,"17060",408,311,311,1,0,"JxCAT-JUNTS",53
43,"43038",21861,16504,16406,112,98,"JxCAT-JUNTS",1715
17,"17161",1018,859,855,1,4,"JxCAT-JUNTS",253
8,"8298",26980,20900,20817,91,83,"JxCAT-JUNTS",5737
17,"17069",364,286,284,2,2,"JxCAT-JUNTS",82
17,"17089",5695,4211,4194,13,17,"JxCAT-JUNTS",1067
25,"25011",5260,3908,3871,30,37,"JxCAT-JUNTS",695
8,"8094",1586,1310,1306,10,4,"JxCAT-JUNTS",259
8,"8011",1745,1414,1407,10,7,"JxCAT-JUNTS",357
17,"17200",623,512,510,1,2,"JxCAT-JUNTS",130
8,"8194",25674,17691,17585,115,106,"JxCAT-JUNTS",540
17,"17098",303,245,245,2,0,"JxCAT-JUNTS",62
8,"8105",9724,7557,7505,49,52,"JxCAT-JUNTS",188
8,"8263",21151,16360,16269,116,91,"JxCAT-JUNTS",445
8,"8203",2472,1884,1873,4,11,"JxCAT-JUNTS",285
25,"25025",1378,996,983,8,13,"JxCAT-JUNTS",111
8,"8212",491,406,402,1,4,"JxCAT-JUNTS",147
43,"43060",2684,2158,2152,8,6,"JxCAT-JUNTS",274
17,"17134",223,189,189,1,0,"JxCAT-JUNTS",49
8,"8019",1117818,875679,872180,4327,3499,"JxCAT-JUNTS",94750
8,"8291",4919,3865,3854,28,11,"JxCAT-JUNTS",321
8,"8167",6048,4833,4822,48,11,"JxCAT-JUNTS",188
43,"43175",537,426,419,5,7,"JxCAT-JUNTS",97
8,"8009",9480,7649,7620,35,29,"JxCAT-JUNTS",1242
17,"17178",1056,804,798,3,6,"JxCAT-JUNTS",218
8,"8129",484,406,405,3,1,"JxCAT-JUNTS",96
8,"8271",67,57,57,0,0,"JxCAT-JUNTS",11
43,"43031",1446,1180,1178,7,2,"JxCAT-JUNTS",336
25,"25910",91,70,67,2,3,"JxCAT-JUNTS",29
8,"8308",137,118,118,0,0,"JxCAT-JUNTS",64
8,"8204",3115,2548,2534,22,14,"JxCAT-JUNTS",287
43,"43040",326,278,276,0,2,"JxCAT-JUNTS",59
25,"25154",118,94,94,0,0,"JxCAT-JUNTS",39
8,"8072",10699,8226,8193,45,33,"JxCAT-JUNTS",789
25,"25253",145,122,121,0,1,"JxCAT-JUNTS",32
8,"8262",6919,5090,5060,33,30,"JxCAT-JUNTS",592
25,"25208",333,252,249,0,3,"JxCAT-JUNTS",43
43,"43029",314,253,252,0,1,"JxCAT-JUNTS",50
25,"25088",95,85,83,0,2,"JxCAT-JUNTS",43
25,"25176",307,262,259,1,3,"JxCAT-JUNTS",87
25,"25202",108,75,75,0,0,"JxCAT-JUNTS",13
25,"25134",603,492,490,1,2,"JxCAT-JUNTS",137
17,"17101",562,415,413,2,2,"JxCAT-JUNTS",65
25,"25114",95,79,79,0,0,"JxCAT-JUNTS",44
8,"8055",541,443,442,2,1,"JxCAT-JUNTS",87
43,"43033",768,609,607,3,2,"JxCAT-JUNTS",90
17,"17154",99,84,83,0,1,"JxCAT-JUNTS",8
17,"17029",199,160,157,1,3,"JxCAT-JUNTS",40
17,"17124",1599,1258,1254,6,4,"JxCAT-JUNTS",333
8,"8178",451,389,388,3,1,"JxCAT-JUNTS",93
8,"8258",813,661,657,6,4,"JxCAT-JUNTS",165
8,"8014",2000,1578,1567,5,11,"JxCAT-JUNTS",251
43,"43065",382,308,304,1,4,"JxCAT-JUNTS",77
8,"8082",1143,868,861,4,7,"JxCAT-JUNTS",88
8,"8151",448,378,377,2,1,"JxCAT-JUNTS",163
25,"25200",323,253,252,0,1,"JxCAT-JUNTS",55
8,"8176",161,132,131,2,1,"JxCAT-JUNTS",46
8,"8279",155280,121081,120515,802,566,"JxCAT-JUNTS",10516
8,"8197",7896,6197,6174,28,23,"JxCAT-JUNTS",1000
43,"43041",228,179,177,3,2,"JxCAT-JUNTS",22
25,"25136",96,79,79,2,0,"JxCAT-JUNTS",30
17,"17054",347,271,271,0,0,"JxCAT-JUNTS",66
17,"17232",149,117,116,0,1,"JxCAT-JUNTS",30
8,"8114",18648,14251,14170,69,81,"JxCAT-JUNTS",1018
17,"17201",143,120,120,0,0,"JxCAT-JUNTS",40
43,"43072",93,74,74,0,0,"JxCAT-JUNTS",15
17,"17008",3594,2763,2741,16,22,"JxCAT-JUNTS",981
25,"25097",84,72,72,1,0,"JxCAT-JUNTS",10
17,"17214",723,584,580,7,4,"JxCAT-JUNTS",145
8,"8015",156003,117736,117183,704,553,"JxCAT-JUNTS",6406
25,"25103",136,103,102,2,1,"JxCAT-JUNTS",27
17,"17065",324,254,253,0,1,"JxCAT-JUNTS",105
8,"8161",11625,8521,8470,44,51,"JxCAT-JUNTS",708
25,"25082",295,229,229,2,0,"JxCAT-JUNTS",47
25,"25170",261,230,228,4,2,"JxCAT-JUNTS",87
8,"8023",6915,5339,5299,26,40,"JxCAT-JUNTS",584
25,"25056",213,163,163,3,0,"JxCAT-JUNTS",60
8,"8187",153380,120687,120090,637,597,"JxCAT-JUNTS",11086
43,"43141",105,86,86,0,0,"JxCAT-JUNTS",23
25,"25119",2245,1798,1792,10,6,"JxCAT-JUNTS",505
8,"8136",11614,9159,9079,84,80,"JxCAT-JUNTS",385
8,"8171",2066,1607,1597,7,10,"JxCAT-JUNTS",549
8,"8277",171,150,150,0,0,"JxCAT-JUNTS",51
43,"43084",521,424,423,2,1,"JxCAT-JUNTS",61
25,"25181",175,136,135,0,1,"JxCAT-JUNTS",52
17,"17077",567,434,434,2,0,"JxCAT-JUNTS",111
43,"43901",8750,6057,6004,43,53,"JxCAT-JUNTS",1007
25,"25161",343,243,243,0,0,"JxCAT-JUNTS",57
25,"25149",1378,1108,1102,3,6,"JxCAT-JUNTS",352
25,"25040",10614,7791,7734,58,57,"JxCAT-JUNTS",1422
8,"8024",357,301,298,1,3,"JxCAT-JUNTS",82
43,"43110",251,184,184,1,0,"JxCAT-JUNTS",36
25,"25165",276,221,219,1,2,"JxCAT-JUNTS",70
8,"8157",8547,6949,6918,39,31,"JxCAT-JUNTS",392
43,"43124",472,379,373,1,6,"JxCAT-JUNTS",85
43,"43017",116,98,98,1,0,"JxCAT-JUNTS",23
8,"8012",1721,1340,1331,8,9,"JxCAT-JUNTS",354
8,"8905",2308,1943,1938,7,5,"JxCAT-JUNTS",285
43,"43020",2276,1831,1819,12,12,"JxCAT-JUNTS",198
25,"25252",557,424,422,4,2,"JxCAT-JUNTS",137
17,"17197",131,113,113,1,0,"JxCAT-JUNTS",33
8,"8126",8865,7125,7098,33,27,"JxCAT-JUNTS",565
25,"25227",664,517,517,1,0,"JxCAT-JUNTS",162
25,"25191",321,248,244,3,4,"JxCAT-JUNTS",70
25,"25163",236,181,179,3,2,"JxCAT-JUNTS",56
8,"8299",377,318,317,0,1,"JxCAT-JUNTS",78
25,"25130",183,142,140,0,2,"JxCAT-JUNTS",44
25,"25907",497,389,386,2,3,"JxCAT-JUNTS",94
17,"17068",246,194,193,0,1,"JxCAT-JUNTS",75
17,"17198",433,332,329,0,3,"JxCAT-JUNTS",72
8,"8147",17282,13644,13560,94,84,"JxCAT-JUNTS",1155
25,"25010",196,156,155,2,1,"JxCAT-JUNTS",42
17,"17031",182,130,129,0,1,"JxCAT-JUNTS",32
8,"8086",14017,10746,10677,89,69,"JxCAT-JUNTS",1009
17,"17119",73,58,58,2,0,"JxCAT-JUNTS",10
25,"25118",327,241,239,2,2,"JxCAT-JUNTS",72
43,"43083",144,116,113,1,3,"JxCAT-JUNTS",29
8,"8254",1753,1485,1482,3,3,"JxCAT-JUNTS",446
43,"43095",2564,1995,1984,14,11,"JxCAT-JUNTS",263
25,"25151",736,592,584,1,8,"JxCAT-JUNTS",189
8,"8245",77805,57956,57666,313,290,"JxCAT-JUNTS",1222
17,"17079",65381,50872,50631,242,241,"JxCAT-JUNTS",12098
43,"43112",250,204,204,1,0,"JxCAT-JUNTS",45
8,"8087",149,135,133,0,2,"JxCAT-JUNTS",35
25,"25197",141,109,108,0,1,"JxCAT-JUNTS",25
43,"43054",2792,2145,2134,21,11,"JxCAT-JUNTS",433
43,"43024",1556,1154,1137,3,17,"JxCAT-JUNTS",92
43,"43131",4772,3432,3401,18,31,"JxCAT-JUNTS",224
25,"25132",143,118,118,0,0,"JxCAT-JUNTS",37
43,"43161",17113,12944,12881,64,63,"JxCAT-JUNTS",2429
43,"43014",14357,10596,10542,60,54,"JxCAT-JUNTS",1083
25,"25009",605,505,491,5,14,"JxCAT-JUNTS",133
17,"17145",1432,1113,1103,7,10,"JxCAT-JUNTS",321
17,"17234",179,147,146,2,1,"JxCAT-JUNTS",15
8,"8027",720,592,588,3,4,"JxCAT-JUNTS",123
43,"43063",536,401,397,1,4,"JxCAT-JUNTS",85
8,"8158",3108,2458,2453,13,5,"JxCAT-JUNTS",279
43,"43097",399,341,341,1,0,"JxCAT-JUNTS",79
17,"17221",4152,3260,3247,11,13,"JxCAT-JUNTS",474
17,"17143",144,115,115,0,0,"JxCAT-JUNTS",32
8,"8025",1535,1221,1214,7,7,"JxCAT-JUNTS",138
17,"17182",272,220,220,3,0,"JxCAT-JUNTS",16
17,"17159",626,487,483,1,4,"JxCAT-JUNTS",132
8,"8220",2411,2119,2115,13,4,"JxCAT-JUNTS",776
43,"43152",434,357,356,0,1,"JxCAT-JUNTS",94
8,"8253",128,113,113,0,0,"JxCAT-JUNTS",41
43,"43094",2120,1659,1646,9,13,"JxCAT-JUNTS",291
8,"8224",878,697,695,1,2,"JxCAT-JUNTS",117
25,"25133",686,528,527,2,1,"JxCAT-JUNTS",175
17,"17183",255,216,216,0,0,"JxCAT-JUNTS",82
43,"43146",41,35,35,0,0,"JxCAT-JUNTS",11
43,"43132",363,292,291,2,1,"JxCAT-JUNTS",69
8,"8213",6547,5270,5245,23,25,"JxCAT-JUNTS",1014
43,"43171",14705,11002,10956,62,46,"JxCAT-JUNTS",645
43,"43128",905,751,747,4,4,"JxCAT-JUNTS",112
8,"8043",3378,2579,2569,20,10,"JxCAT-JUNTS",238
25,"25045",54,31,31,5,0,"JxCAT-JUNTS",2
43,"43008",307,202,200,1,2,"JxCAT-JUNTS",24
8,"8124",37130,29069,28915,146,154,"JxCAT-JUNTS",1523
17,"17193",4312,3202,3179,15,23,"JxCAT-JUNTS",598
8,"8081",353,299,297,2,2,"JxCAT-JUNTS",107
25,"25067",706,537,532,4,5,"JxCAT-JUNTS",132
17,"17144",210,171,170,0,1,"JxCAT-JUNTS",61
17,"17063",173,157,156,2,1,"JxCAT-JUNTS",41
8,"8188",115,95,95,0,0,"JxCAT-JUNTS",33
25,"25077",440,331,330,1,1,"JxCAT-JUNTS",82
17,"17056",1766,1438,1433,9,5,"JxCAT-JUNTS",569
17,"17046",710,574,571,3,3,"JxCAT-JUNTS",147
25,"25902",542,449,439,3,10,"JxCAT-JUNTS",121
8,"8205",61279,51629,51497,360,132,"JxCAT-JUNTS",8615
17,"17083",2961,2321,2300,12,21,"JxCAT-JUNTS",418
25,"25230",1555,1221,1208,8,13,"JxCAT-JUNTS",245
25,"25022",107,88,88,0,0,"JxCAT-JUNTS",30
17,"17020",3671,3021,3006,11,15,"JxCAT-JUNTS",976
25,"25039",261,216,216,1,0,"JxCAT-JUNTS",53
25,"25912",843,685,684,4,1,"JxCAT-JUNTS",75
17,"17210",580,449,445,2,4,"JxCAT-JUNTS",125
25,"25217",10819,8163,8120,64,43,"JxCAT-JUNTS",1880
17,"17174",162,132,132,4,0,"JxCAT-JUNTS",35
25,"25212",224,195,195,2,0,"JxCAT-JUNTS",58
43,"43178",1421,1118,1113,7,5,"JxCAT-JUNTS",186
8,"8117",2480,2055,2050,16,5,"JxCAT-JUNTS",527
25,"25186",207,174,173,7,1,"JxCAT-JUNTS",64
25,"25172",1779,1407,1405,3,2,"JxCAT-JUNTS",395
43,"43113",397,325,323,2,2,"JxCAT-JUNTS",83
25,"25053",1092,879,873,8,6,"JxCAT-JUNTS",235
17,"17097",199,172,170,1,2,"JxCAT-JUNTS",46
17,"17130",322,268,268,0,0,"JxCAT-JUNTS",96
43,"43903",2333,1717,1700,11,17,"JxCAT-JUNTS",233
25,"25078",1001,807,805,5,2,"JxCAT-JUNTS",173
25,"25215",505,299,299,4,0,"JxCAT-JUNTS",49
43,"43037",17902,12787,12695,63,92,"JxCAT-JUNTS",1057
8,"8164",934,784,776,1,8,"JxCAT-JUNTS",169
17,"17157",124,107,107,0,0,"JxCAT-JUNTS",39
17,"17094",1068,772,766,1,6,"JxCAT-JUNTS",210
8,"8168",394,287,287,1,0,"JxCAT-JUNTS",66
17,"17205",211,184,184,1,0,"JxCAT-JUNTS",77
25,"25079",285,228,227,0,1,"JxCAT-JUNTS",91
8,"8225",94,81,81,1,0,"JxCAT-JUNTS",40
43,"43035",235,205,203,7,2,"JxCAT-JUNTS",46
8,"8119",6838,5352,5326,31,26,"JxCAT-JUNTS",385
17,"17085",291,248,246,0,2,"JxCAT-JUNTS",61
25,"25226",242,184,183,4,1,"JxCAT-JUNTS",35
17,"17015",12819,10133,10078,38,55,"JxCAT-JUNTS",3077
43,"43019",1336,1020,1008,4,12,"JxCAT-JUNTS",124
17,"17206",155,118,115,0,3,"JxCAT-JUNTS",37
8,"8193",984,792,790,5,2,"JxCAT-JUNTS",117
25,"25177",358,270,268,1,2,"JxCAT-JUNTS",58
43,"43166",1628,1292,1285,3,7,"JxCAT-JUNTS",158
25,"25158",1606,1291,1277,5,14,"JxCAT-JUNTS",367
17,"17187",625,530,529,4,1,"JxCAT-JUNTS",137
25,"25190",257,215,215,0,0,"JxCAT-JUNTS",32
8,"8172",20417,16196,16144,88,52,"JxCAT-JUNTS",1609
8,"8163",19497,14616,14548,67,68,"JxCAT-JUNTS",1181
43,"43101",145,122,122,1,0,"JxCAT-JUNTS",34
43,"43076",460,378,377,2,1,"JxCAT-JUNTS",85
17,"17052",134,104,104,1,0,"JxCAT-JUNTS",30
25,"25034",2288,1733,1719,9,14,"JxCAT-JUNTS",526
25,"25041",528,399,396,4,3,"JxCAT-JUNTS",87
25,"25240",1385,1116,1110,10,6,"JxCAT-JUNTS",261
17,"17194",78,62,62,0,0,"JxCAT-JUNTS",21
43,"43077",455,342,339,2,3,"JxCAT-JUNTS",20
17,"17007",1752,1430,1422,2,8,"JxCAT-JUNTS",686
25,"25175",176,135,135,1,0,"JxCAT-JUNTS",32
43,"43151",109,98,98,0,0,"JxCAT-JUNTS",18
8,"8297",135,111,111,1,0,"JxCAT-JUNTS",44
25,"25242",689,539,531,0,8,"JxCAT-JUNTS",156
17,"17037",114,98,98,6,0,"JxCAT-JUNTS",42
17,"17217",353,312,311,1,1,"JxCAT-JUNTS",86
17,"17169",2497,2047,2042,8,5,"JxCAT-JUNTS",437
8,"8282",6711,5696,5677,27,19,"JxCAT-JUNTS",899
25,"25196",112,94,93,0,1,"JxCAT-JUNTS",28
8,"8237",1662,1334,1327,7,7,"JxCAT-JUNTS",392
8,"8180",27072,21218,21100,126,118,"JxCAT-JUNTS",791
8,"8078",219,176,172,1,4,"JxCAT-JUNTS",55
43,"43021",345,270,269,3,1,"JxCAT-JUNTS",61
25,"25051",1510,1176,1172,6,4,"JxCAT-JUNTS",295
8,"8265",1590,1339,1334,6,5,"JxCAT-JUNTS",349
25,"25189",2164,1591,1583,11,8,"JxCAT-JUNTS",320
8,"8175",3368,2496,2486,16,10,"JxCAT-JUNTS",559
43,"43022",1435,1130,1123,8,7,"JxCAT-JUNTS",144
43,"43070",238,194,193,1,1,"JxCAT-JUNTS",35
8,"8030",5209,4318,4305,16,13,"JxCAT-JUNTS",853
17,"17220",805,673,665,2,8,"JxCAT-JUNTS",247
25,"25167",226,185,185,2,0,"JxCAT-JUNTS",63
17,"17076",122,101,100,1,1,"JxCAT-JUNTS",28
25,"25059",813,621,612,3,9,"JxCAT-JUNTS",43
17,"17012",1171,916,914,10,2,"JxCAT-JUNTS",143
43,"43145",4209,3409,3391,9,18,"JxCAT-JUNTS",620
17,"17226",895,673,669,3,4,"JxCAT-JUNTS",101
25,"25174",390,324,324,0,0,"JxCAT-JUNTS",94
8,"8085",976,812,811,2,1,"JxCAT-JUNTS",243
43,"43150",1238,1034,1026,6,8,"JxCAT-JUNTS",243
25,"25047",972,784,781,8,3,"JxCAT-JUNTS",202
8,"8040",11004,8468,8431,24,37,"JxCAT-JUNTS",1098
43,"43169",450,396,396,3,0,"JxCAT-JUNTS",62
25,"25153",192,152,150,1,2,"JxCAT-JUNTS",28
17,"17090",544,469,468,0,1,"JxCAT-JUNTS",182
25,"25218",86,79,79,0,0,"JxCAT-JUNTS",31
8,"8115",3825,2994,2975,12,19,"JxCAT-JUNTS",262
17,"17070",110,94,94,0,0,"JxCAT-JUNTS",30
25,"25194",415,325,325,3,0,"JxCAT-JUNTS",118
43,"43162",4418,3467,3453,20,14,"JxCAT-JUNTS",456
17,"17010",327,264,263,2,1,"JxCAT-JUNTS",94
25,"25255",395,321,318,2,3,"JxCAT-JUNTS",88
8,"8095",67,53,52,0,1,"JxCAT-JUNTS",14
8,"8159",14323,11399,11359,57,40,"JxCAT-JUNTS",806
17,"17164",3932,3078,3054,8,24,"JxCAT-JUNTS",898
8,"8020",5172,4337,4327,26,10,"JxCAT-JUNTS",607
8,"8170",442,338,338,0,0,"JxCAT-JUNTS",120
8,"8121",87292,67638,67328,362,310,"JxCAT-JUNTS",6438
25,"25901",287,209,207,1,2,"JxCAT-JUNTS",48
17,"17002",564,491,488,3,3,"JxCAT-JUNTS",171
25,"25131",402,321,320,1,1,"JxCAT-JUNTS",54
17,"17022",7008,5386,5354,22,32,"JxCAT-JUNTS",1093
17,"17233",2328,1924,1912,6,12,"JxCAT-JUNTS",638
17,"17058",170,139,139,0,0,"JxCAT-JUNTS",46
43,"43109",2704,1937,1922,16,15,"JxCAT-JUNTS",126
8,"8218",8104,6419,6389,34,30,"JxCAT-JUNTS",837
25,"25050",3269,2457,2446,23,11,"JxCAT-JUNTS",583
25,"25135",1000,773,769,2,4,"JxCAT-JUNTS",244
8,"8234",3373,2742,2734,25,8,"JxCAT-JUNTS",326
8,"8107",11900,9303,9187,43,116,"JxCAT-JUNTS",566
8,"8260",18400,14471,14406,87,65,"JxCAT-JUNTS",732
8,"8013",1280,1040,1031,5,9,"JxCAT-JUNTS",279
8,"8004",209,194,191,0,3,"JxCAT-JUNTS",77
17,"17036",2643,2076,2071,12,5,"JxCAT-JUNTS",510
43,"43139",1999,1552,1539,10,13,"JxCAT-JUNTS",438
8,"8044",4136,3193,3175,11,18,"JxCAT-JUNTS",390
8,"8154",701,587,586,5,1,"JxCAT-JUNTS",107
8,"8017",2827,2192,2182,16,10,"JxCAT-JUNTS",429
17,"17222",105,95,95,1,0,"JxCAT-JUNTS",28
43,"43043",3289,2624,2613,14,11,"JxCAT-JUNTS",253
8,"8051",18437,14951,14887,85,64,"JxCAT-JUNTS",1699
43,"43075",86,71,69,0,2,"JxCAT-JUNTS",14
8,"8235",3829,3176,3167,14,9,"JxCAT-JUNTS",782
25,"25071",42,32,31,0,1,"JxCAT-JUNTS",9
8,"8097",1080,891,880,2,11,"JxCAT-JUNTS",188
25,"25138",547,440,436,1,4,"JxCAT-JUNTS",102
25,"25019",4646,3224,3199,22,25,"JxCAT-JUNTS",536
17,"17021",122,98,98,0,0,"JxCAT-JUNTS",22
8,"8033",13218,10480,10435,50,45,"JxCAT-JUNTS",1344
43,"43143",51,45,44,0,1,"JxCAT-JUNTS",20
8,"8111",215,200,199,4,1,"JxCAT-JUNTS",102
17,"17172",457,352,349,1,3,"JxCAT-JUNTS",114
17,"17099",78,59,59,0,0,"JxCAT-JUNTS",19
8,"8128",577,454,451,0,3,"JxCAT-JUNTS",102
25,"25070",811,677,675,4,2,"JxCAT-JUNTS",188
8,"8060",135,111,109,0,2,"JxCAT-JUNTS",44
43,"43089",281,209,208,0,1,"JxCAT-JUNTS",30
25,"25219",149,118,118,1,0,"JxCAT-JUNTS",20
43,"43053",188,153,149,0,4,"JxCAT-JUNTS",32
43,"43173",99,80,78,0,2,"JxCAT-JUNTS",19
17,"17166",547,460,459,2,1,"JxCAT-JUNTS",160
17,"17132",1333,1088,1080,9,8,"JxCAT-JUNTS",298
8,"8139",177,156,156,0,0,"JxCAT-JUNTS",38
25,"25024",352,273,272,0,1,"JxCAT-JUNTS",85
43,"43086",5263,4046,4021,17,25,"JxCAT-JUNTS",824
8,"8210",4584,3455,3435,23,20,"JxCAT-JUNTS",635
25,"25061",80,59,58,0,1,"JxCAT-JUNTS",20
43,"43069",178,146,146,0,0,"JxCAT-JUNTS",28
25,"25244",362,296,294,2,2,"JxCAT-JUNTS",57
8,"8067",5728,4535,4513,21,22,"JxCAT-JUNTS",930
17,"17218",570,468,465,5,3,"JxCAT-JUNTS",182
8,"8145",2701,2156,2144,7,12,"JxCAT-JUNTS",381
25,"25128",127,87,87,0,0,"JxCAT-JUNTS",17
17,"17216",155,127,124,0,3,"JxCAT-JUNTS",44
43,"43126",1211,1005,999,4,6,"JxCAT-JUNTS",167
8,"8902",3937,3176,3164,17,12,"JxCAT-JUNTS",479
43,"43096",98,82,82,0,0,"JxCAT-JUNTS",19
17,"17128",316,255,252,1,3,"JxCAT-JUNTS",58
43,"43088",2026,1565,1562,9,3,"JxCAT-JUNTS",264
8,"8073",62572,48770,48527,255,243,"JxCAT-JUNTS",1474
43,"43016",3445,2628,2608,11,20,"JxCAT-JUNTS",298
17,"17087",222,177,176,0,1,"JxCAT-JUNTS",53
8,"8053",2865,2105,2098,17,7,"JxCAT-JUNTS",283
25,"25142",365,300,299,2,1,"JxCAT-JUNTS",74
8,"8200",62161,48645,48330,261,315,"JxCAT-JUNTS",1811
17,"17171",172,143,141,0,2,"JxCAT-JUNTS",35
17,"17050",674,585,582,5,3,"JxCAT-JUNTS",164
17,"17207",2411,2006,1992,8,14,"JxCAT-JUNTS",748
8,"8036",163,134,133,0,1,"JxCAT-JUNTS",45
43,"43129",4611,3528,3495,21,33,"JxCAT-JUNTS",854
43,"43004",6274,4744,4691,39,53,"JxCAT-JUNTS",478
43,"43163",26013,18942,18796,89,146,"JxCAT-JUNTS",1606
25,"25074",180,157,155,2,2,"JxCAT-JUNTS",33
17,"17208",976,772,768,5,4,"JxCAT-JUNTS",264
17,"17141",6072,4251,4221,14,30,"JxCAT-JUNTS",699
17,"17014",63,51,50,0,1,"JxCAT-JUNTS",11
17,"17043",167,135,134,0,1,"JxCAT-JUNTS",40
8,"8236",1557,1204,1202,2,2,"JxCAT-JUNTS",197
25,"25055",163,130,129,0,1,"JxCAT-JUNTS",50
43,"43103",905,746,740,8,6,"JxCAT-JUNTS",67
43,"43005",3643,2765,2749,22,16,"JxCAT-JUNTS",441
8,"8090",137,113,113,2,0,"JxCAT-JUNTS",40
8,"8064",1920,1516,1506,6,10,"JxCAT-JUNTS",345
43,"43906",2103,1595,1587,14,8,"JxCAT-JUNTS",407
17,"17903",889,726,721,4,5,"JxCAT-JUNTS",223
17,"17041",218,166,165,3,1,"JxCAT-JUNTS",24
17,"17135",395,309,307,0,2,"JxCAT-JUNTS",42
25,"25207",6430,4899,4867,41,32,"JxCAT-JUNTS",1151
17,"17092",3467,2660,2633,17,27,"JxCAT-JUNTS",441
43,"43057",38,31,31,1,0,"JxCAT-JUNTS",10
8,"8275",248,223,222,1,1,"JxCAT-JUNTS",89
25,"25243",3730,2637,2606,20,31,"JxCAT-JUNTS",240
8,"8301",49135,38575,38398,272,177,"JxCAT-JUNTS",1172
17,"17066",27323,18373,18269,98,104,"JxCAT-JUNTS",2665
8,"8181",8061,6442,6402,28,40,"JxCAT-JUNTS",829
43,"43142",1083,850,842,8,8,"JxCAT-JUNTS",204
25,"25171",2127,1639,1630,8,9,"JxCAT-JUNTS",367
17,"17111",958,772,771,3,1,"JxCAT-JUNTS",218
43,"43153",11092,8327,8291,34,36,"JxCAT-JUNTS",812
43,"43007",640,510,509,0,1,"JxCAT-JUNTS",122
25,"25205",562,451,447,7,4,"JxCAT-JUNTS",108
17,"17224",302,233,231,2,2,"JxCAT-JUNTS",90
8,"8281",4840,4009,3998,23,11,"JxCAT-JUNTS",799
43,"43134",273,224,223,5,1,"JxCAT-JUNTS",43
17,"17191",166,145,144,2,1,"JxCAT-JUNTS",58
17,"17160",14733,10833,10766,43,67,"JxCAT-JUNTS",1881
8,"8247",980,832,828,3,4,"JxCAT-JUNTS",252
8,"8255",137,105,105,1,0,"JxCAT-JUNTS",47
8,"8018",2551,1998,1984,6,14,"JxCAT-JUNTS",354
25,"25245",430,346,342,1,4,"JxCAT-JUNTS",40
8,"8901",240,203,201,1,2,"JxCAT-JUNTS",74
8,"8288",1676,1196,1182,6,14,"JxCAT-JUNTS",166
43,"43168",84,65,65,1,0,"JxCAT-JUNTS",18
17,"17139",1394,1163,1154,3,9,"JxCAT-JUNTS",408
17,"17091",398,310,305,2,5,"JxCAT-JUNTS",121
17,"17118",12916,9521,9460,37,61,"JxCAT-JUNTS",1724
8,"8026",193,161,161,1,0,"JxCAT-JUNTS",67
17,"17140",639,539,527,4,12,"JxCAT-JUNTS",190
8,"8231",21132,15940,15880,75,60,"JxCAT-JUNTS",1193
25,"25124",157,114,114,0,0,"JxCAT-JUNTS",37
17,"17211",831,694,691,1,3,"JxCAT-JUNTS",235
25,"25007",1392,1089,1083,4,6,"JxCAT-JUNTS",181
8,"8130",108,89,86,2,3,"JxCAT-JUNTS",24
17,"17035",550,460,460,3,0,"JxCAT-JUNTS",172
8,"8216",25,19,19,0,0,"JxCAT-JUNTS",3
8,"8239",460,380,378,2,2,"JxCAT-JUNTS",85
43,"43064",2017,1569,1558,9,11,"JxCAT-JUNTS",352
25,"25109",214,179,176,3,3,"JxCAT-JUNTS",83
17,"17225",207,161,161,0,0,"JxCAT-JUNTS",40
8,"8199",651,542,542,4,0,"JxCAT-JUNTS",141
8,"8904",10514,7733,7697,38,36,"JxCAT-JUNTS",85
8,"8272",165,133,133,0,0,"JxCAT-JUNTS",39
8,"8208",5760,4660,4643,25,17,"JxCAT-JUNTS",356
17,"17212",142,117,117,2,0,"JxCAT-JUNTS",42
43,"43093",3884,2956,2933,14,23,"JxCAT-JUNTS",519
43,"43117",143,114,113,0,1,"JxCAT-JUNTS",36
17,"17153",188,162,162,0,0,"JxCAT-JUNTS",48
43,"43105",156,132,132,3,0,"JxCAT-JUNTS",28
43,"43048",763,614,609,7,5,"JxCAT-JUNTS",78
8,"8300",5892,4912,4880,24,32,"JxCAT-JUNTS",480
43,"43147",521,446,442,4,4,"JxCAT-JUNTS",126
17,"17189",1476,1278,1275,2,3,"JxCAT-JUNTS",527
8,"8182",2892,2217,2204,18,13,"JxCAT-JUNTS",143
25,"25043",801,613,606,1,7,"JxCAT-JUNTS",124
17,"17107",269,221,219,2,2,"JxCAT-JUNTS",77
8,"8287",1057,877,871,7,6,"JxCAT-JUNTS",212
25,"25085",141,118,117,2,1,"JxCAT-JUNTS",33
8,"8001",9079,7383,7341,40,42,"JxCAT-JUNTS",281
25,"25004",575,470,467,2,3,"JxCAT-JUNTS",148
43,"43027",164,137,137,0,0,"JxCAT-JUNTS",60
8,"8219",15629,12910,12865,58,45,"JxCAT-JUNTS",2029
8,"8286",2919,2210,2199,15,11,"JxCAT-JUNTS",217
17,"17038",380,312,308,3,4,"JxCAT-JUNTS",91
17,"17039",1740,1385,1380,8,5,"JxCAT-JUNTS",419
43,"43106",793,656,651,2,5,"JxCAT-JUNTS",114
8,"8184",54876,41661,41447,248,214,"JxCAT-JUNTS",2047
43,"43058",96,77,77,0,0,"JxCAT-JUNTS",22
25,"25233",285,231,229,2,2,"JxCAT-JUNTS",57
25,"25216",241,199,199,2,0,"JxCAT-JUNTS",52
25,"25101",543,454,449,1,5,"JxCAT-JUNTS",145
17,"17177",567,459,457,2,2,"JxCAT-JUNTS",155
17,"17032",1742,1235,1224,6,11,"JxCAT-JUNTS",321
25,"25192",724,564,558,4,6,"JxCAT-JUNTS",125
8,"8049",1320,981,977,5,4,"JxCAT-JUNTS",275
8,"8077",34578,27617,27501,134,116,"JxCAT-JUNTS",1589
17,"17230",499,397,393,0,4,"JxCAT-JUNTS",88
8,"8138",4432,3435,3413,10,22,"JxCAT-JUNTS",617
43,"43119",838,630,628,4,2,"JxCAT-JUNTS",91
25,"25094",139,116,116,0,0,"JxCAT-JUNTS",43
25,"25193",767,614,606,6,8,"JxCAT-JUNTS",205
43,"43167",384,334,333,2,1,"JxCAT-JUNTS",69
17,"17057",968,826,822,1,4,"JxCAT-JUNTS",229
8,"8045",71,52,49,0,3,"JxCAT-JUNTS",18
25,"25247",147,100,100,2,0,"JxCAT-JUNTS",6
8,"8141",4573,3611,3595,26,16,"JxCAT-JUNTS",732
17,"17040",551,465,459,4,6,"JxCAT-JUNTS",169
8,"8150",251,211,211,0,0,"JxCAT-JUNTS",69
17,"17088",578,468,468,1,0,"JxCAT-JUNTS",108
43,"43111",2098,1496,1483,8,13,"JxCAT-JUNTS",117
8,"8165",1664,1315,1311,9,4,"JxCAT-JUNTS",219
25,"25030",123,90,90,1,0,"JxCAT-JUNTS",27
17,"17176",123,110,110,1,0,"JxCAT-JUNTS",17
25,"25113",1116,912,908,8,4,"JxCAT-JUNTS",237
8,"8274",4674,3710,3698,12,12,"JxCAT-JUNTS",448
8,"8037",1930,1618,1610,10,8,"JxCAT-JUNTS",512
17,"17133",1273,1048,1043,7,5,"JxCAT-JUNTS",498
17,"17162",156,114,111,1,3,"JxCAT-JUNTS",36
25,"25014",249,203,200,2,3,"JxCAT-JUNTS",56
43,"43127",759,630,626,3,4,"JxCAT-JUNTS",143
8,"8155",6960,5427,5390,39,37,"JxCAT-JUNTS",483
8,"8174",392,330,330,4,0,"JxCAT-JUNTS",79
25,"25143",84,72,71,0,1,"JxCAT-JUNTS",24
17,"17071",1128,978,978,3,0,"JxCAT-JUNTS",319
8,"8283",6113,4832,4813,33,19,"JxCAT-JUNTS",1198
43,"43138",2648,1926,1896,8,30,"JxCAT-JUNTS",255
25,"25029",1607,1270,1265,6,5,"JxCAT-JUNTS",326
8,"8103",640,507,505,4,2,"JxCAT-JUNTS",86
43,"43081",633,532,531,7,1,"JxCAT-JUNTS",110
8,"8127",2240,1694,1683,13,11,"JxCAT-JUNTS",216
43,"43155",22619,16724,16624,101,100,"JxCAT-JUNTS",2733
43,"43085",235,198,194,0,4,"JxCAT-JUNTS",43
25,"25211",672,513,512,6,1,"JxCAT-JUNTS",102
8,"8270",18837,14541,14497,66,44,"JxCAT-JUNTS",1719
8,"8248",5616,4378,4365,32,13,"JxCAT-JUNTS",588
17,"17202",3813,2876,2851,8,25,"JxCAT-JUNTS",541
17,"17062",5978,4358,4334,26,24,"JxCAT-JUNTS",950
17,"17051",207,174,173,3,1,"JxCAT-JUNTS",61
43,"43130",177,145,145,0,0,"JxCAT-JUNTS",30
25,"25201",110,89,89,0,0,"JxCAT-JUNTS",22
44,"44052",74,50,49,0,1,"+MAS+",0
44,"44025",5825,4337,4197,50,140,"+MAS+",1
44,"44112",408,303,293,2,10,"+MAS+",0
44,"44195",84,66,65,1,1,"+MAS+",0
44,"44229",143,110,108,4,2,"+MAS+",0
44,"44262",143,115,112,0,3,"+MAS+",0
44,"44033",244,174,172,0,2,"+MAS+",0
44,"44128",59,46,45,0,1,"+MAS+",0
44,"44043",88,67,65,1,2,"+MAS+",0
44,"44236",59,44,44,0,0,"+MAS+",0
44,"44106",153,115,111,2,4,"+MAS+",0
44,"44172",295,220,218,4,2,"+MAS+",1
44,"44206",103,83,82,0,1,"+MAS+",0
44,"44121",53,38,38,2,0,"+MAS+",0
44,"44099",649,457,450,2,7,"+MAS+",0
44,"44077",74,55,54,0,1,"+MAS+",0
44,"44133",15,12,12,0,0,"+MAS+",0
44,"44039",202,166,165,3,1,"+MAS+",0
44,"44165",173,136,135,2,1,"+MAS+",0
44,"44123",99,69,69,1,0,"+MAS+",0
44,"44179",325,233,231,7,2,"+MAS+",0
44,"44007",152,120,117,0,3,"+MAS+",1
44,"44115",102,96,95,0,1,"+MAS+",0
44,"44260",138,91,90,1,1,"+MAS+",0
44,"44102",27,22,22,0,0,"+MAS+",0
44,"44177",101,75,75,1,0,"+MAS+",0
44,"44116",76,62,62,0,0,"+MAS+",0
44,"44024",28,25,24,0,1,"+MAS+",0
44,"44153",1749,1264,1243,11,21,"+MAS+",0
44,"44040",191,164,158,2,6,"+MAS+",0
44,"44199",39,39,38,5,1,"+MAS+",0
44,"44218",31,25,25,2,0,"+MAS+",0
44,"44196",125,96,95,2,1,"+MAS+",0
44,"44132",58,47,47,0,0,"+MAS+",0
44,"44237",368,299,293,2,6,"+MAS+",0
44,"44154",248,200,195,2,5,"+MAS+",0
44,"44114",238,188,184,1,4,"+MAS+",1
44,"44213",65,46,46,0,0,"+MAS+",0
44,"44046",43,32,32,0,0,"+MAS+",0
44,"44159",37,32,32,1,0,"+MAS+",0
44,"44226",124,87,83,2,4,"+MAS+",0
44,"44003",17,14,14,0,0,"+MAS+",0
44,"44029",579,466,457,3,9,"+MAS+",0
44,"44234",70,57,57,1,0,"+MAS+",0
44,"44055",77,58,56,0,2,"+MAS+",0
44,"44245",245,176,171,1,5,"+MAS+",0
44,"44225",103,82,81,0,1,"+MAS+",0
44,"44063",65,55,55,1,0,"+MAS+",0
44,"44143",394,327,327,2,0,"+MAS+",0
44,"44197",50,35,35,0,0,"+MAS+",0
44,"44044",83,65,64,2,1,"+MAS+",0
44,"44125",65,50,50,0,0,"+MAS+",0
44,"44191",722,567,561,7,6,"+MAS+",0
44,"44150",26,21,21,0,0,"+MAS+",0
44,"44031",82,52,52,1,0,"+MAS+",0
44,"44090",66,49,49,0,0,"+MAS+",0
44,"44261",722,584,578,8,6,"+MAS+",0
44,"44217",31,25,25,0,0,"+MAS+",1
44,"44222",122,102,102,1,0,"+MAS+",0
44,"44087",68,56,54,0,2,"+MAS+",0
44,"44163",114,92,92,0,0,"+MAS+",0
44,"44249",46,37,37,1,0,"+MAS+",0
44,"44009",799,621,611,7,10,"+MAS+",0
44,"44019",68,42,42,0,0,"+MAS+",1
44,"44042",114,84,84,0,0,"+MAS+",0
44,"44061",75,66,65,2,1,"+MAS+",0
44,"44230",152,112,111,1,1,"+MAS+",1
44,"44059",550,446,437,7,9,"+MAS+",0
44,"44220",113,92,89,0,3,"+MAS+",0
44,"44016",436,334,331,1,3,"+MAS+",0
44,"44252",75,56,56,1,0,"+MAS+",0
44,"44178",53,39,39,0,0,"+MAS+",0
44,"44204",27,22,22,0,0,"+MAS+",0
44,"44215",168,121,120,1,1,"+MAS+",0
44,"44120",219,158,152,1,6,"+MAS+",1
44,"44265",181,153,148,1,5,"+MAS+",0
44,"44135",102,85,85,0,0,"+MAS+",0
44,"44146",170,148,146,3,2,"+MAS+",0
44,"44028",171,140,138,1,2,"+MAS+",0
44,"44258",53,44,44,0,0,"+MAS+",0
44,"44142",28,21,21,0,0,"+MAS+",0
44,"44093",79,73,73,4,0,"+MAS+",0
44,"44130",27,24,24,0,0,"+MAS+",0
44,"44138",118,90,89,2,1,"+MAS+",0
44,"44103",123,101,100,1,1,"+MAS+",0
44,"44065",57,37,36,0,1,"+MAS+",0
44,"44001",65,51,50,0,1,"+MAS+",0
44,"44189",48,36,36,0,0,"+MAS+",0
44,"44110",37,33,33,0,0,"+MAS+",0
44,"44126",317,226,222,1,4,"+MAS+",1
44,"44267",71,53,52,0,1,"+MAS+",0
44,"44149",100,74,73,0,1,"+MAS+",1
44,"44239",22,19,19,0,0,"+MAS+",0
44,"44192",349,288,284,1,4,"+MAS+",0
44,"44034",126,97,97,2,0,"+MAS+",0
44,"44144",325,249,247,1,2,"+MAS+",0
44,"44012",310,240,238,5,2,"+MAS+",0
44,"44223",73,58,58,0,0,"+MAS+",0
44,"44216",26922,20603,20279,204,324,"+MAS+",12
44,"44014",2499,2015,1963,25,52,"+MAS+",3
44,"44164",20,18,18,0,0,"+MAS+",0
44,"44256",34,32,32,1,0,"+MAS+",0
44,"44054",94,79,79,0,0,"+MAS+",0
44,"44018",16,16,16,0,0,"+MAS+",0
44,"44209",815,606,592,2,14,"+MAS+",0
44,"44111",78,64,64,1,0,"+MAS+",0
44,"44151",182,139,138,1,1,"+MAS+",0
44,"44002",46,42,42,0,0,"+MAS+",0
44,"44035",105,86,84,1,2,"+MAS+",0
44,"44174",409,306,300,3,6,"+MAS+",0
44,"44013",11250,8525,8420,95,105,"+MAS+",5
44,"44152",67,48,48,2,0,"+MAS+",1
44,"44066",87,66,65,0,1,"+MAS+",0
44,"44023",18,14,14,0,0,"+MAS+",0
44,"44205",634,444,426,9,18,"+MAS+",0
44,"44268",32,30,30,0,0,"+MAS+",0
44,"44129",36,29,29,0,0,"+MAS+",0
44,"44008",1565,1158,1138,8,20,"+MAS+",1
44,"44211",35,24,24,0,0,"+MAS+",0
44,"44045",368,302,298,8,4,"+MAS+",0
44,"44105",69,54,54,1,0,"+MAS+",0
44,"44171",182,130,128,0,2,"+MAS+",0
44,"44122",1284,995,984,15,11,"+MAS+",0
44,"44076",2110,1725,1691,22,34,"+MAS+",0
44,"44026",95,76,75,2,1,"+MAS+",0
44,"44113",72,51,50,0,1,"+MAS+",1
44,"44231",36,33,32,0,1,"+MAS+",0
44,"44020",22,18,18,0,0,"+MAS+",0
44,"44148",76,64,63,0,1,"+MAS+",0
44,"44131",27,22,22,0,0,"+MAS+",0
44,"44050",3115,2333,2299,27,34,"+MAS+",0
44,"44047",229,125,124,2,1,"+MAS+",0
44,"44056",457,352,341,4,11,"+MAS+",0
44,"44064",63,49,48,0,1,"+MAS+",0
44,"44053",105,81,81,0,0,"+MAS+",1
44,"44089",52,44,44,0,0,"+MAS+",0
44,"44224",21,15,15,0,0,"+MAS+",0
44,"44080",284,214,212,1,2,"+MAS+",1
44,"44175",113,84,82,1,2,"+MAS+",0
44,"44169",310,250,245,4,5,"+MAS+",0
44,"44041",58,48,44,1,4,"+MAS+",0
44,"44198",181,151,145,1,6,"+MAS+",1
44,"44011",48,32,32,1,0,"+MAS+",0
44,"44092",70,56,55,1,1,"+MAS+",0
44,"44062",31,24,23,1,1,"+MAS+",0
44,"44207",130,101,101,1,0,"+MAS+",0
44,"44227",72,61,61,0,0,"+MAS+",0
44,"44145",972,741,732,11,9,"+MAS+",0
44,"44246",1590,1173,1150,11,23,"+MAS+",0
44,"44266",102,89,86,1,3,"+MAS+",0
44,"44004",379,312,310,5,2,"+MAS+",0
44,"44173",102,85,80,0,5,"+MAS+",0
44,"44187",193,155,151,1,4,"+MAS+",0
44,"44210",743,600,594,8,6,"+MAS+",0
44,"44088",23,21,21,0,0,"+MAS+",0
44,"44183",63,43,43,0,0,"+MAS+",0
44,"44049",796,592,578,9,14,"+MAS+",0
44,"44219",173,142,136,1,6,"+MAS+",0
44,"44108",300,228,224,5,4,"+MAS+",0
44,"44161",430,320,316,1,4,"+MAS+",0
44,"44075",326,275,263,0,12,"+MAS+",0
44,"44117",319,263,256,5,7,"+MAS+",1
44,"44051",2588,2034,1997,26,37,"+MAS+",0
44,"44193",69,57,56,1,1,"+MAS+",0
44,"44124",73,58,57,0,1,"+MAS+",0
44,"44176",153,124,124,0,0,"+MAS+",0
44,"44021",104,86,85,2,1,"+MAS+",1
44,"44067",108,82,78,0,4,"+MAS+",0
44,"44243",27,24,23,0,1,"+MAS+",0
44,"44238",2294,1763,1743,10,20,"+MAS+",0
44,"44228",99,83,83,0,0,"+MAS+",0
44,"44109",102,71,70,1,1,"+MAS+",0
44,"44147",398,293,286,3,7,"+MAS+",0
44,"44084",55,45,45,0,0,"+MAS+",0
44,"44201",478,417,412,3,5,"+MAS+",0
44,"44036",23,20,20,0,0,"+MAS+",0
44,"44155",1056,830,813,9,17,"+MAS+",2
44,"44208",26,22,22,0,0,"+MAS+",0
44,"44032",17,13,13,0,0,"+MAS+",0
44,"44251",242,197,187,0,10,"+MAS+",0
44,"44184",38,28,26,0,2,"+MAS+",0
44,"44005",46,31,31,1,0,"+MAS+",0
44,"44168",184,137,136,4,1,"+MAS+",0
44,"44027",149,120,119,0,1,"+MAS+",0
44,"44240",149,121,121,0,0,"+MAS+",0
44,"44022",463,342,326,6,16,"+MAS+",0
44,"44017",272,221,219,0,2,"+MAS+",0
44,"44194",104,80,80,1,0,"+MAS+",0
44,"44181",66,58,57,0,1,"+MAS+",0
44,"44107",205,159,158,0,1,"+MAS+",0
44,"44101",51,43,42,1,1,"+MAS+",0
44,"44158",1166,921,904,7,17,"+MAS+",1
44,"44241",506,416,407,1,9,"+MAS+",0
44,"44157",64,38,38,1,0,"+MAS+",0
44,"44235",89,67,66,2,1,"+MAS+",0
44,"44070",55,45,45,0,0,"+MAS+",0
44,"44247",287,216,215,6,1,"+MAS+",0
44,"44127",57,45,45,0,0,"+MAS+",0
44,"44160",440,311,306,2,5,"+MAS+",0
44,"44086",421,332,327,3,5,"+MAS+",0
44,"44167",39,30,30,0,0,"+MAS+",0
44,"44048",53,47,47,0,0,"+MAS+",0
44,"44094",123,112,112,0,0,"+MAS+",0
44,"44071",585,449,447,6,2,"+MAS+",1
44,"44119",119,83,82,0,1,"+MAS+",2
44,"44156",46,36,33,1,3,"+MAS+",0
44,"44085",49,31,31,0,0,"+MAS+",0
44,"44182",198,172,171,2,1,"+MAS+",0
44,"44203",9,9,9,0,0,"+MAS+",0
44,"44263",377,296,285,3,11,"+MAS+",0
44,"44185",93,73,72,1,1,"+MAS+",0
44,"44212",41,32,32,0,0,"+MAS+",0
44,"44097",126,91,90,2,1,"+MAS+",0
44,"44100",175,142,141,2,1,"+MAS+",0
44,"44082",89,72,69,0,3,"+MAS+",0
44,"44060",37,28,28,0,0,"+MAS+",0
44,"44190",65,45,43,0,2,"+MAS+",0
44,"44038",98,83,80,0,3,"+MAS+",0
44,"44221",384,320,315,2,5,"+MAS+",0
44,"44257",154,110,109,1,1,"+MAS+",0
44,"44137",188,148,146,0,2,"+MAS+",0
44,"44118",158,126,122,1,4,"+MAS+",0
44,"44250",19,15,15,0,0,"+MAS+",0
44,"44136",51,43,43,1,0,"+MAS+",0
44,"44006",223,171,169,2,2,"+MAS+",0
44,"44010",184,137,137,1,0,"+MAS+",0
44,"44074",444,353,346,3,7,"+MAS+",0
44,"44068",643,518,511,9,7,"+MAS+",0
44,"44200",39,25,25,0,0,"+MAS+",0
44,"44180",72,61,61,0,0,"+MAS+",0
44,"44096",153,120,112,1,8,"+MAS+",0
44,"44037",449,334,331,1,3,"+MAS+",0
44,"44244",68,48,48,4,0,"+MAS+",0
44,"44264",248,175,171,0,4,"+MAS+",0
44,"44232",368,284,273,2,11,"+MAS+",0
44,"44141",127,100,100,0,0,"+MAS+",2
31,"31054",454,322,318,4,4,"NA+",47
31,"31013",626,427,422,5,5,"NA+",104
31,"31216",3871,2861,2832,32,29,"NA+",844
31,"31221",1235,944,938,11,6,"NA+",165
31,"31044",294,243,242,5,1,"NA+",34
31,"31175",64,50,50,0,0,"NA+",18
31,"31085",502,401,399,5,2,"NA+",38
31,"31243",302,241,237,5,4,"NA+",58
31,"31239",281,215,212,7,3,"NA+",58
31,"31127",135,96,96,0,0,"NA+",27
31,"31059",183,145,143,0,2,"NA+",28
31,"31117",589,420,419,5,1,"NA+",12
31,"31265",78,52,47,1,5,"NA+",9
31,"31028",220,147,147,0,0,"NA+",26
31,"31071",15,13,13,0,0,"NA+",5
31,"31116",58,45,43,2,2,"NA+",22
31,"31010",5728,4211,4153,30,58,"NA+",477
31,"31001",80,63,63,0,0,"NA+",16
31,"31197",65,56,56,0,0,"NA+",9
31,"31195",171,125,125,2,0,"NA+",15
31,"31061",48,46,46,0,0,"NA+",27
31,"31122",4946,3915,3882,59,33,"NA+",879
31,"31252",83,57,57,0,0,"NA+",16
31,"31236",1318,958,950,8,8,"NA+",266
31,"31245",77,60,59,4,1,"NA+",22
31,"31230",95,79,79,0,0,"NA+",25
31,"31040",173,139,139,1,0,"NA+",46
31,"31222",58,38,38,3,0,"NA+",2
31,"31264",177,107,105,2,2,"NA+",16
31,"31089",228,187,184,0,3,"NA+",79
31,"31144",763,504,503,1,1,"NA+",65
31,"31088",5675,4331,4285,59,46,"NA+",1278
31,"31189",1127,781,775,10,6,"NA+",75
31,"31257",903,690,679,6,11,"NA+",170
31,"31077",5407,4148,4081,39,67,"NA+",1648
31,"31073",296,218,217,3,1,"NA+",19
31,"31062",1075,870,861,10,9,"NA+",303
31,"31204",36,27,27,1,0,"NA+",14
31,"31250",2748,1995,1982,21,13,"NA+",222
31,"31217",334,233,225,3,8,"NA+",86
31,"31234",149,115,114,0,1,"NA+",46
31,"31018",422,317,312,4,5,"NA+",87
31,"31254",1920,1457,1435,8,22,"NA+",493
31,"31002",433,324,324,4,0,"NA+",102
31,"31168",241,203,199,2,4,"NA+",81
31,"31190",45,41,41,4,0,"NA+",11
31,"31130",322,237,235,7,2,"NA+",47
31,"31105",1478,1203,1189,21,14,"NA+",483
31,"31009",672,510,503,4,7,"NA+",114
31,"31113",127,84,83,1,1,"NA+",23
31,"31176",2930,2204,2134,33,70,"NA+",678
31,"31253",119,106,105,0,1,"NA+",6
31,"31075",118,96,95,2,1,"NA+",30
31,"31159",1105,880,871,3,9,"NA+",252
31,"31166",250,184,184,2,0,"NA+",93
31,"31169",2205,1597,1568,17,29,"NA+",523
31,"31047",236,181,179,5,2,"NA+",64
31,"31196",31,28,28,0,0,"NA+",8
31,"31157",3470,2507,2473,32,34,"NA+",809
31,"31232",25574,19124,18913,236,211,"NA+",6988
31,"31226",574,380,377,3,3,"NA+",27
31,"31064",1387,1174,1163,9,11,"NA+",446
31,"31103",39,27,27,0,0,"NA+",17
31,"31076",2520,2110,2094,21,16,"NA+",992
31,"31035",50,34,32,0,2,"NA+",7
31,"31041",1659,1245,1228,23,17,"NA+",334
31,"31251",3152,2437,2402,12,35,"NA+",720
31,"31016",7752,6114,6064,47,50,"NA+",799
31,"31053",503,375,370,4,5,"NA+",109
31,"31082",623,433,433,3,0,"NA+",48
31,"31087",181,136,135,6,1,"NA+",13
31,"31228",494,383,382,0,1,"NA+",107
31,"31206",2082,1610,1589,15,21,"NA+",436
31,"31123",617,392,388,3,4,"NA+",73
31,"31080",490,393,390,2,3,"NA+",102
31,"31081",334,259,256,7,3,"NA+",32
31,"31131",907,719,712,8,7,"NA+",260
31,"31072",5320,4046,3958,40,88,"NA+",1485
31,"31205",420,312,310,7,2,"NA+",90
31,"31202",4345,3132,3085,36,47,"NA+",1235
31,"31143",93,58,52,0,6,"NA+",18
31,"31114",374,291,286,4,5,"NA+",66
31,"31210",186,156,156,1,0,"NA+",46
31,"31012",771,571,564,5,7,"NA+",146
31,"31092",685,514,511,6,3,"NA+",114
31,"31069",830,639,638,3,1,"NA+",232
31,"31024",99,54,54,1,0,"NA+",2
31,"31152",1270,937,929,19,8,"NA+",310
31,"31905",2968,2253,2236,21,17,"NA+",556
31,"31904",1561,1139,1130,7,9,"NA+",203
31,"31901",15510,12225,12133,114,92,"NA+",3302
31,"31184",65,48,46,0,2,"NA+",16
31,"31194",326,251,250,1,1,"NA+",54
31,"31212",129,102,102,6,0,"NA+",47
31,"31161",345,286,279,4,7,"NA+",48
31,"31017",370,288,286,3,2,"NA+",74
31,"31162",48,34,33,1,1,"NA+",5
31,"31188",296,200,197,0,3,"NA+",43
31,"31057",1741,1365,1344,12,21,"NA+",570
31,"31261",237,174,173,3,1,"NA+",59
31,"31136",452,337,333,5,4,"NA+",54
31,"31095",72,61,60,0,1,"NA+",6
31,"31174",107,70,70,0,0,"NA+",25
31,"31014",266,195,195,4,0,"NA+",70
31,"31050",6002,4111,4061,58,50,"NA+",749
31,"31241",125,100,100,2,0,"NA+",42
31,"31246",128,105,101,3,4,"NA+",26
31,"31129",384,260,259,0,1,"NA+",11
31,"31036",895,665,659,8,6,"NA+",176
31,"31091",327,224,224,1,0,"NA+",9
31,"31132",148,121,121,2,0,"NA+",53
31,"31006",1877,1453,1436,16,17,"NA+",484
31,"31163",2002,1507,1475,14,32,"NA+",513
31,"31199",141,96,94,0,2,"NA+",20
31,"31908",1064,810,803,2,7,"NA+",101
31,"31086",13640,11040,10966,116,74,"NA+",3374
31,"31101",1412,1097,1087,11,10,"NA+",303
31,"31007",126,101,95,3,6,"NA+",38
31,"31094",105,78,76,0,2,"NA+",33
31,"31102",136,75,75,2,0,"NA+",12
31,"31022",483,349,345,3,4,"NA+",20
31,"31183",713,569,555,6,14,"NA+",180
31,"31115",160,116,116,3,0,"NA+",17
31,"31178",472,354,348,3,6,"NA+",90
31,"31098",1962,1562,1544,14,18,"NA+",426
31,"31033",46,29,28,0,1,"NA+",7
31,"31066",812,636,628,10,8,"NA+",240
31,"31179",483,348,344,2,4,"NA+",135
31,"31192",157,133,130,1,3,"NA+",36
31,"31215",4669,3580,3508,35,72,"NA+",1161
31,"31256",96,64,64,0,0,"NA+",6
31,"31208",2562,2067,2036,16,31,"NA+",542
31,"31023",7609,6371,6319,70,52,"NA+",2212
31,"31051",234,183,182,2,1,"NA+",50
31,"31156",239,191,191,1,0,"NA+",31
31,"31043",32,24,24,0,0,"NA+",11
31,"31067",1896,1418,1397,17,21,"NA+",384
31,"31060",14185,10582,10485,103,97,"NA+",2347
31,"31079",67,60,60,0,0,"NA+",27
31,"31149",2271,1645,1628,9,17,"NA+",135
31,"31140",115,83,83,2,0,"NA+",21
31,"31055",263,199,197,3,2,"NA+",13
31,"31031",220,158,157,1,1,"NA+",14
31,"31154",211,125,124,2,1,"NA+",27
31,"31052",103,79,78,0,1,"NA+",32
31,"31160",105,87,86,1,1,"NA+",32
31,"31170",45,37,36,2,1,"NA+",4
31,"31260",1249,904,901,15,3,"NA+",281
31,"31255",103,87,84,0,3,"NA+",38
31,"31019",1808,1392,1378,18,14,"NA+",212
31,"31200",748,555,546,5,9,"NA+",108
31,"31037",90,72,72,0,0,"NA+",3
31,"31213",100,69,68,0,1,"NA+",2
31,"31259",476,347,346,0,1,"NA+",29
31,"31150",199,140,139,2,1,"NA+",28
31,"31025",763,562,557,6,5,"NA+",117
31,"31038",1336,992,981,8,11,"NA+",341
31,"31030",135,105,105,3,0,"NA+",18
31,"31238",115,101,100,2,1,"NA+",19
31,"31198",37,32,32,0,0,"NA+",2
31,"31165",2763,2121,2091,21,30,"NA+",702
31,"31011",709,515,511,4,4,"NA+",165
31,"31137",198,106,103,3,3,"NA+",22
31,"31142",1390,994,982,8,12,"NA+",342
31,"31214",87,66,64,0,2,"NA+",13
31,"31097",10521,7602,7550,76,52,"NA+",2446
31,"31220",742,620,615,2,5,"NA+",257
31,"31139",155,105,105,0,0,"NA+",36
31,"31084",1948,1483,1472,9,11,"NA+",128
31,"31229",38,36,36,2,0,"NA+",13
31,"31104",1751,1306,1280,1,26,"NA+",360
31,"31171",669,516,502,3,14,"NA+",106
31,"31219",81,60,59,1,1,"NA+",21
31,"31008",63,51,49,1,2,"NA+",25
31,"31119",36,26,25,0,1,"NA+",7
31,"31034",31,27,26,0,1,"NA+",6
31,"31173",846,686,674,5,12,"NA+",287
31,"31902",4649,3620,3598,34,22,"NA+",951
31,"31121",65,51,51,0,0,"NA+",17
31,"31045",509,395,390,5,5,"NA+",95
31,"31068",2816,2194,2136,17,58,"NA+",729
31,"31231",108,73,70,1,3,"NA+",24
31,"31203",30,22,22,1,0,"NA+",7
31,"31182",30,28,28,1,0,"NA+",7
31,"31106",718,585,581,3,4,"NA+",216
31,"31111",91,69,69,1,0,"NA+",7
31,"31063",83,63,60,2,3,"NA+",29
31,"31107",1680,1330,1312,16,18,"NA+",723
31,"31164",545,438,433,6,5,"NA+",159
31,"31074",390,310,307,5,3,"NA+",58
31,"31209",147,116,116,0,0,"NA+",25
31,"31032",1678,1285,1269,25,16,"NA+",402
31,"31096",101,85,84,3,1,"NA+",31
31,"31046",53,39,39,0,0,"NA+",27
31,"31903",6862,4962,4915,31,47,"NA+",872
31,"31177",251,172,168,1,4,"NA+",46
31,"31125",274,211,207,7,4,"NA+",66
31,"31048",160,133,132,2,1,"NA+",71
31,"31185",470,335,332,6,3,"NA+",92
31,"31237",186,151,149,1,2,"NA+",58
31,"31248",270,158,154,6,4,"NA+",39
31,"31083",50,41,41,1,0,"NA+",9
31,"31100",256,181,178,1,3,"NA+",67
31,"31224",875,684,677,10,7,"NA+",279
31,"31134",175,130,128,1,2,"NA+",37
31,"31093",275,212,206,0,6,"NA+",34
31,"31124",207,151,150,2,1,"NA+",67
31,"31247",147,117,115,0,2,"NA+",32
31,"31148",92,67,65,4,2,"NA+",12
31,"31153",2173,1591,1580,10,11,"NA+",119
31,"31244",156,95,94,5,1,"NA+",15
31,"31020",433,273,272,1,1,"NA+",11
31,"31211",17,13,13,1,0,"NA+",7
31,"31109",1664,1290,1283,10,7,"NA+",385
31,"31042",2695,2071,2043,21,28,"NA+",725
31,"31155",241,181,180,3,1,"NA+",46
31,"31078",2419,1924,1899,18,25,"NA+",656
31,"31181",134,94,93,1,1,"NA+",26
31,"31172",365,287,275,4,12,"NA+",106
31,"31005",281,202,201,5,1,"NA+",71
31,"31207",285,209,206,1,3,"NA+",49
31,"31049",679,512,505,2,7,"NA+",65
31,"31191",3018,2365,2337,22,28,"NA+",686
31,"31907",11205,9216,9140,121,76,"NA+",2418
31,"31026",132,116,112,0,4,"NA+",41
31,"31146",29,25,25,1,0,"NA+",15
31,"31120",383,264,260,3,4,"NA+",73
31,"31058",202,163,160,2,3,"NA+",42
31,"31112",93,71,70,0,1,"NA+",14
31,"31118",158,120,116,2,4,"NA+",21
31,"31029",916,661,647,7,14,"NA+",245
31,"31110",84,72,72,3,0,"NA+",12
31,"31128",341,255,250,3,5,"NA+",51
31,"31158",248,182,177,2,5,"NA+",50
31,"31065",1859,1383,1366,16,17,"NA+",495
31,"31151",57,42,42,1,0,"NA+",14
31,"31201",151084,115375,114510,1072,865,"NA+",37032
31,"31138",954,699,698,8,1,"NA+",45
31,"31133",35,28,28,0,0,"NA+",2
31,"31090",141,86,86,0,0,"NA+",9
31,"31167",831,651,636,3,15,"NA+",200
31,"31145",161,131,129,1,2,"NA+",77
31,"31056",185,141,134,3,7,"NA+",44
31,"31187",101,68,68,1,0,"NA+",4
31,"31258",7879,6189,6140,57,49,"NA+",1122
31,"31906",2683,2040,2023,28,17,"NA+",487
31,"31021",60,47,47,3,0,"NA+",9
31,"31039",92,72,70,1,2,"NA+",15
31,"31240",513,385,385,6,0,"NA+",26
31,"31233",93,72,70,1,2,"NA+",28
31,"31015",1990,1533,1508,17,25,"NA+",535
31,"31193",1438,1129,1123,13,6,"NA+",268
31,"31004",32,26,26,0,0,"NA+",11
31,"31099",49,43,43,0,0,"NA+",14
31,"31135",112,76,75,2,1,"NA+",40
31,"31249",1823,1381,1373,21,8,"NA+",443
31,"31235",157,121,118,0,3,"NA+",24
31,"31141",107,76,74,0,2,"NA+",28
31,"31223",959,718,711,8,7,"NA+",181
31,"31027",814,623,610,8,13,"NA+",38
31,"31227",8111,6198,6129,69,69,"NA+",1315
31,"31070",2628,1930,1881,16,49,"NA+",575
31,"31126",351,255,254,2,1,"NA+",32
31,"31225",35,29,29,1,0,"NA+",4
31,"31003",117,97,97,1,0,"NA+",16
31,"31147",106,88,86,3,2,"NA+",37
31,"31186",288,220,216,1,4,"NA+",49
31,"31263",231,154,154,0,0,"NA+",8
31,"31262",234,201,199,2,2,"NA+",45
31,"31242",264,194,194,2,0,"NA+",72
31,"31108",1829,1460,1437,16,23,"NA+",593
31,"31180",197,155,154,2,1,"NA+",54
35,"35010",3797,2601,2572,9,29,"NCa",117
35,"35025",1773,1247,1235,9,12,"NCa",99
35,"35009",20109,15017,14803,78,214,"NCa",3279
35,"35022",51302,33009,32566,198,443,"NCa",3826
35,"35008",6207,4733,4654,42,79,"NCa",193
35,"35001",4571,3523,3463,8,60,"NCa",166
35,"35005",1017,751,743,1,8,"NCa",112
35,"35002",24129,16979,16736,116,243,"NCa",1694
35,"35030",9949,6611,6462,65,149,"NCa",542
35,"35027",10499,7651,7530,57,121,"NCa",545
35,"35018",13056,8699,8618,73,81,"NCa",263
35,"35021",15014,10909,10792,71,117,"NCa",553
35,"35032",3348,2585,2542,20,43,"NCa",160
35,"35031",7412,5593,5519,41,74,"NCa",656
35,"35034",8396,4599,4546,55,53,"NCa",96
35,"35020",5933,4140,4088,14,52,"NCa",706
35,"35014",11908,7101,6947,63,154,"NCa",280
35,"35015",10728,6233,6108,54,125,"NCa",374
35,"35004",41728,23957,23683,219,274,"NCa",834
35,"35019",32841,21136,20850,125,286,"NCa",1600
35,"35017",27216,17531,17102,133,429,"NCa",842
35,"35012",10765,6327,6270,32,57,"NCa",301
35,"35007",518,405,401,0,4,"NCa",103
35,"35028",10044,6188,6105,52,83,"NCa",165
35,"35003",5582,3441,3391,26,50,"NCa",197
35,"35029",4357,2869,2832,32,37,"NCa",88
35,"35026",82764,55647,54846,499,801,"NCa",4033
35,"35013",6584,5067,4974,49,93,"NCa",196
35,"35011",24705,17099,16823,129,276,"NCa",1066
35,"35023",11694,8785,8607,67,178,"NCa",1538
35,"35016",300503,203470,201240,1598,2230,"NCa",9586
35,"35033",6403,4565,4502,34,63,"NCa",403
35,"35024",14243,9496,9394,65,102,"NCa",342
35,"35006",31309,23434,23019,221,415,"NCa",1238
4,"4064",2879,2196,2179,12,17,"PACMA",14
46,"46183",6028,4620,4534,29,86,"PACMA",52
12,"12901",3357,2693,2675,19,18,"PACMA",28
5,"5078",100,87,86,0,1,"PACMA",0
21,"21018",1719,1167,1139,9,28,"PACMA",3
19,"19218",45,34,34,1,0,"PACMA",0
19,"19217",42,38,38,0,0,"PACMA",0
37,"37074",140,107,106,1,1,"PACMA",1
28,"28902",523,418,415,2,3,"PACMA",4
19,"19259",28,24,24,0,0,"PACMA",0
9,"9034",292,239,238,2,1,"PACMA",0
22,"22239",88,71,71,0,0,"PACMA",0
29,"29053",1694,1263,1245,18,18,"PACMA",16
20,"20045",46866,33932,33700,191,232,"PACMA",344
39,"39086",362,273,268,1,5,"PACMA",0
22,"22173",218,162,160,1,2,"PACMA",2
24,"24087",586,469,460,4,9,"PACMA",1
5,"5176",223,173,166,2,7,"PACMA",2
11,"11036",687,457,447,7,10,"PACMA",5
25,"25171",2127,1639,1630,8,9,"PACMA",9
23,"23054",376,296,289,1,7,"PACMA",1
39,"39096",670,523,518,2,5,"PACMA",0
31,"31023",7609,6371,6319,70,52,"PACMA",69
45,"45164",172,143,143,1,0,"PACMA",0
6,"6117",1401,1089,1067,6,22,"PACMA",6
9,"9074",834,697,694,8,3,"PACMA",7
18,"18018",554,457,451,0,6,"PACMA",7
24,"24121",616,491,484,4,7,"PACMA",1
26,"26018",10441,8400,8311,64,89,"PACMA",55
44,"44043",88,67,65,1,2,"PACMA",0
20,"20012",148,113,112,0,1,"PACMA",0
50,"50011",116,100,99,0,1,"PACMA",2
28,"28180",5317,4266,4222,26,44,"PACMA",27
32,"32059",1703,1248,1228,12,20,"PACMA",8
9,"9064",305,251,249,3,2,"PACMA",3
2,"2064",374,318,315,3,3,"PACMA",2
9,"9458",484,408,401,5,7,"PACMA",4
6,"6142",259,214,208,1,6,"PACMA",1
19,"19305",135,104,103,3,1,"PACMA",0
29,"29069",86694,58863,58127,561,736,"PACMA",1063
16,"16082",271,207,206,3,1,"PACMA",0
18,"18914",1657,1315,1278,5,37,"PACMA",11
9,"9098",477,372,360,4,12,"PACMA",1
10,"10154",177,134,133,1,1,"PACMA",1
43,"43003",350,266,264,3,2,"PACMA",4
42,"42142",45,35,35,0,0,"PACMA",0
42,"42158",94,78,78,0,0,"PACMA",0
24,"24205",981,744,732,8,12,"PACMA",1
24,"24176",299,243,238,3,5,"PACMA",1
42,"42021",68,44,44,2,0,"PACMA",0
44,"44183",63,43,43,0,0,"PACMA",0
44,"44218",31,25,25,2,0,"PACMA",1
15,"15007",3179,2333,2304,22,29,"PACMA",14
28,"28150",3187,2640,2604,20,36,"PACMA",27
14,"14020",338,240,233,2,7,"PACMA",0
45,"45200",4478,3666,3565,35,101,"PACMA",16
15,"15003",1701,1234,1210,10,24,"PACMA",3
36,"36060",30432,22488,22196,199,292,"PACMA",279
43,"43028",2766,2007,1988,7,19,"PACMA",59
37,"37028",137,111,107,1,4,"PACMA",0
19,"19221",35,26,26,0,0,"PACMA",0
34,"34167",110,88,88,0,0,"PACMA",1
46,"46063",1783,1368,1345,9,23,"PACMA",13
50,"50048",33,25,25,0,0,"PACMA",0
22,"22244",46,37,37,2,0,"PACMA",0
16,"16073",188,159,155,0,4,"PACMA",0
29,"29024",372,265,250,3,15,"PACMA",0
10,"10178",729,567,559,4,8,"PACMA",2
25,"25094",139,116,116,0,0,"PACMA",2
25,"25077",440,331,330,1,1,"PACMA",3
19,"19191",13,12,12,0,0,"PACMA",0
7,"7004",4033,2898,2860,28,38,"PACMA",30
42,"42196",8,6,6,0,0,"PACMA",0
28,"28009",14500,11656,11564,62,92,"PACMA",207
9,"9318",58,37,37,0,0,"PACMA",0
42,"42119",145,90,89,6,1,"PACMA",0
41,"41034",23480,16510,16250,230,260,"PACMA",222
40,"40165",74,56,54,1,2,"PACMA",0
10,"10180",4168,2735,2680,18,55,"PACMA",12
44,"44090",66,49,49,0,0,"PACMA",0
26,"26024",210,171,169,1,2,"PACMA",0
9,"9026",371,305,303,2,2,"PACMA",5
10,"10129",348,263,250,0,13,"PACMA",1
29,"29057",341,236,233,0,3,"PACMA",3
46,"46088",150,129,127,0,2,"PACMA",1
25,"25073",546,420,418,2,2,"PACMA",4
30,"30013",7467,5621,5553,26,68,"PACMA",41
28,"28183",1124,857,842,4,15,"PACMA",23
5,"5077",158,133,131,1,2,"PACMA",0
22,"22083",445,379,372,5,7,"PACMA",0
47,"47071",398,345,341,2,4,"PACMA",2
19,"19058",7375,6122,6061,34,61,"PACMA",86
28,"28015",20440,17084,16953,103,131,"PACMA",255
25,"25148",219,168,168,1,0,"PACMA",0
2,"2071",1058,912,906,2,6,"PACMA",2
29,"29008",15183,10716,10555,93,161,"PACMA",149
3,"3121",21787,15670,15453,81,217,"PACMA",264
43,"43076",460,378,377,2,1,"PACMA",7
34,"34024",25,17,16,1,1,"PACMA",0
24,"24098",1149,882,863,7,19,"PACMA",9
31,"31154",211,125,124,2,1,"PACMA",0
42,"42038",34,27,27,1,0,"PACMA",0
39,"39035",9169,7135,7045,40,90,"PACMA",50
44,"44093",79,73,73,4,0,"PACMA",0
49,"49135",588,409,405,0,4,"PACMA",8
6,"6128",4415,3345,3288,34,57,"PACMA",12
20,"20062",945,727,726,3,1,"PACMA",8
50,"50186",37,28,28,0,0,"PACMA",1
46,"46142",761,580,565,4,15,"PACMA",3
50,"50117",125,100,100,3,0,"PACMA",0
31,"31198",37,32,32,0,0,"PACMA",0
44,"44215",168,121,120,1,1,"PACMA",0
47,"47077",237,187,183,2,4,"PACMA",1
25,"25049",155,113,111,0,2,"PACMA",0
12,"12051",448,324,319,2,5,"PACMA",0
37,"37126",30,26,26,0,0,"PACMA",0
31,"31078",2419,1924,1899,18,25,"PACMA",13
28,"28013",41563,32024,31693,194,331,"PACMA",446
49,"49141",296,220,218,0,2,"PACMA",2
18,"18111",2849,2193,2160,24,33,"PACMA",25
32,"32060",765,577,567,2,10,"PACMA",5
4,"4020",286,218,217,1,1,"PACMA",1
9,"9138",87,74,72,2,2,"PACMA",0
10,"10051",433,338,332,0,6,"PACMA",0
25,"25129",159,115,115,2,0,"PACMA",1
12,"12082",9573,7672,7570,55,102,"PACMA",98
6,"6006",4494,3395,3325,24,70,"PACMA",16
46,"46166",8202,6482,6399,39,83,"PACMA",97
27,"27066",12633,9139,8911,84,228,"PACMA",93
34,"34036",238,199,198,1,1,"PACMA",2
46,"46093",2134,1700,1687,8,13,"PACMA",17
42,"42049",109,73,72,1,1,"PACMA",0
5,"5012",121,100,97,0,3,"PACMA",0
28,"28170",2487,1840,1810,10,30,"PACMA",17
40,"40005",25,21,21,0,0,"PACMA",0
48,"48066",347,291,291,0,0,"PACMA",2
46,"46044",4198,3399,3337,13,62,"PACMA",30
6,"6099",1162,833,813,6,20,"PACMA",2
26,"26146",86,69,69,1,0,"PACMA",0
43,"43142",1083,850,842,8,8,"PACMA",8
22,"22018",308,234,232,2,2,"PACMA",0
43,"43035",235,205,203,7,2,"PACMA",2
7,"7017",882,652,646,6,6,"PACMA",15
42,"42027",73,63,63,0,0,"PACMA",0
1,"1016",421,236,229,3,7,"PACMA",0
34,"34028",134,110,107,3,3,"PACMA",0
12,"12117",3545,2770,2698,11,72,"PACMA",26
37,"37003",107,82,82,1,0,"PACMA",0
18,"18050",1670,1231,1213,9,18,"PACMA",14
24,"24150",224,176,174,2,2,"PACMA",6
37,"37360",215,158,153,3,5,"PACMA",2
16,"16150",94,75,75,1,0,"PACMA",0
6,"6007",1433,1078,1071,5,7,"PACMA",4
22,"22234",745,587,578,11,9,"PACMA",4
47,"47131",165,127,127,3,0,"PACMA",0
45,"45186",2945,2319,2280,11,39,"PACMA",9
35,"35013",6584,5067,4974,49,93,"PACMA",47
46,"46244",59626,44018,43679,342,339,"PACMA",683
37,"37071",76,67,67,0,0,"PACMA",0
12,"12131",59,50,50,0,0,"PACMA",0
46,"46079",313,252,248,1,4,"PACMA",2
9,"9409",110,87,87,0,0,"PACMA",0
3,"3139",23061,16378,16178,128,200,"PACMA",271
44,"44033",244,174,172,0,2,"PACMA",1
50,"50173",149,107,105,0,2,"PACMA",0
32,"32088",1610,1040,1019,11,21,"PACMA",6
50,"50065",55,43,43,1,0,"PACMA",0
25,"25232",1356,1066,1061,2,5,"PACMA",6
48,"48004",326,261,260,3,1,"PACMA",1
26,"26078",86,71,70,1,1,"PACMA",0
12,"12057",578,485,473,3,12,"PACMA",2
30,"30901",10529,8488,8375,37,113,"PACMA",109
40,"40115",156,131,130,4,1,"PACMA",0
50,"50089",8584,6951,6912,34,39,"PACMA",92
25,"25017",232,184,181,0,3,"PACMA",1
47,"47217",1973,1569,1541,19,28,"PACMA",10
5,"5005",171,142,142,2,0,"PACMA",1
44,"44025",5825,4337,4197,50,140,"PACMA",31
22,"22053",786,573,567,3,6,"PACMA",3
31,"31211",17,13,13,1,0,"PACMA",0
50,"50182",3675,2846,2810,36,36,"PACMA",49
7,"7010",5070,3815,3777,47,38,"PACMA",76
15,"15014",3836,2739,2698,38,41,"PACMA",23
16,"16003",133,111,110,1,1,"PACMA",2
45,"45007",665,549,533,0,16,"PACMA",0
46,"46138",360,305,303,2,2,"PACMA",1
42,"42008",56,41,41,0,0,"PACMA",0
4,"4050",751,522,519,1,3,"PACMA",5
25,"25105",103,89,88,1,1,"PACMA",0
26,"26002",827,643,639,5,4,"PACMA",2
6,"6088",12505,9311,9140,93,171,"PACMA",78
19,"19054",167,144,141,2,3,"PACMA",1
3,"3090",17881,13593,13437,108,156,"PACMA",193
9,"9442",370,305,301,5,4,"PACMA",1
18,"18012",2143,1651,1634,8,17,"PACMA",4
50,"50068",1947,1402,1389,11,13,"PACMA",7
28,"28085",4141,3337,3296,13,41,"PACMA",34
46,"46001",783,612,607,4,5,"PACMA",2
50,"50066",2835,2199,2177,19,22,"PACMA",46
37,"37341",48,36,36,0,0,"PACMA",0
44,"44103",123,101,100,1,1,"PACMA",0
7,"7042",10785,7256,7191,60,65,"PACMA",108
46,"46150",1797,1275,1257,9,18,"PACMA",12
9,"9095",112,70,68,1,2,"PACMA",0
46,"46076",591,497,487,0,10,"PACMA",2
44,"44190",65,45,43,0,2,"PACMA",1
38,"38047",1756,1276,1259,6,17,"PACMA",15
37,"37136",633,448,434,8,14,"PACMA",0
18,"18046",1753,1206,1185,1,21,"PACMA",12
26,"26171",156,131,127,0,4,"PACMA",0
44,"44117",319,263,256,5,7,"PACMA",0
12,"12053",2030,1656,1636,10,20,"PACMA",10
12,"12084",17723,13501,13281,118,220,"PACMA",120
28,"28143",77,62,62,0,0,"PACMA",0
16,"16130",536,445,444,0,1,"PACMA",5
28,"28002",3281,2481,2455,24,26,"PACMA",39
19,"19303",40,35,35,0,0,"PACMA",0
50,"50289",51,40,38,1,2,"PACMA",0
45,"45046",2369,1860,1832,5,28,"PACMA",7
38,"38028",22035,15684,15522,86,162,"PACMA",260
13,"13051",336,272,271,1,1,"PACMA",1
3,"3054",336,277,272,2,5,"PACMA",5
5,"5058",72,52,52,0,0,"PACMA",0
23,"23005",29940,19587,19330,191,257,"PACMA",198
40,"40041",967,773,764,9,9,"PACMA",3
36,"36902",5052,3813,3724,21,89,"PACMA",35
22,"22129",163,117,116,0,1,"PACMA",1
9,"9431",120,98,98,3,0,"PACMA",1
48,"48903",1807,1471,1462,6,9,"PACMA",7
45,"45195",2072,1615,1583,4,32,"PACMA",10
50,"50131",210,157,156,0,1,"PACMA",2
9,"9230",33,28,28,0,0,"PACMA",0
18,"18152",906,692,686,1,6,"PACMA",0
4,"4055",366,315,314,3,1,"PACMA",1
44,"44128",59,46,45,0,1,"PACMA",0
5,"5180",82,61,60,0,1,"PACMA",0
45,"45069",1817,1460,1438,4,22,"PACMA",6
19,"19074",65,60,60,0,0,"PACMA",0
42,"42193",16,7,7,0,0,"PACMA",0
31,"31075",118,96,95,2,1,"PACMA",1
44,"44077",74,55,54,0,1,"PACMA",0
29,"29904",417,337,335,2,2,"PACMA",2
31,"31238",115,101,100,2,1,"PACMA",0
37,"37165",31,22,21,0,1,"PACMA",0
10,"10901",1177,818,805,1,13,"PACMA",10
2,"2074",5891,4435,4375,41,60,"PACMA",50
27,"27007",2756,2148,2084,29,64,"PACMA",4
22,"22199",6926,5113,5051,44,62,"PACMA",41
18,"18024",831,682,667,6,15,"PACMA",3
15,"15083",1036,784,768,7,16,"PACMA",2
47,"47177",100,80,79,0,1,"PACMA",0
42,"42185",25,20,20,0,0,"PACMA",0
37,"37346",252,214,213,3,1,"PACMA",0
3,"3099",42876,32576,32172,192,404,"PACMA",361
37,"37355",162,137,135,0,2,"PACMA",0
10,"10045",970,739,735,6,4,"PACMA",1
9,"9067",407,285,278,2,7,"PACMA",1
19,"19151",1083,785,770,5,15,"PACMA",4
45,"45020",1239,987,973,4,14,"PACMA",4
42,"42015",32,23,23,1,0,"PACMA",0
44,"44197",50,35,35,0,0,"PACMA",0
44,"44105",69,54,54,1,0,"PACMA",0
20,"20061",4392,3278,3264,11,14,"PACMA",16
45,"45036",634,490,482,0,8,"PACMA",1
9,"9416",60,44,44,0,0,"PACMA",3
42,"42191",180,129,129,1,0,"PACMA",0
6,"6127",2809,2285,2258,13,27,"PACMA",11
46,"46078",28394,20928,20748,156,180,"PACMA",367
19,"19117",1611,1279,1257,7,22,"PACMA",19
4,"4095",690,508,502,2,6,"PACMA",0
18,"18192",1466,1171,1156,1,15,"PACMA",2
18,"18180",627,442,435,4,7,"PACMA",1
19,"19017",57,50,49,0,1,"PACMA",2
5,"5267",107,71,70,3,1,"PACMA",0
4,"4018",252,215,213,1,2,"PACMA",2
20,"20029",4272,3257,3239,18,18,"PACMA",17
6,"6022",2634,2156,2112,7,44,"PACMA",13
25,"25146",221,172,170,3,2,"PACMA",2
24,"24080",207,162,161,0,1,"PACMA",0
25,"25136",96,79,79,2,0,"PACMA",0
29,"29014",222,151,150,6,1,"PACMA",2
5,"5153",87,65,65,1,0,"PACMA",0
4,"4033",125,98,95,0,3,"PACMA",1
31,"31264",177,107,105,2,2,"PACMA",0
33,"33066",42882,30942,30529,401,413,"PACMA",364
22,"22025",1035,764,755,24,9,"PACMA",5
19,"19193",23,20,20,0,0,"PACMA",1
16,"16063",113,86,83,0,3,"PACMA",0
38,"38014",1341,991,981,6,10,"PACMA",11
22,"22250",344,271,264,6,7,"PACMA",5
37,"37132",325,232,231,0,1,"PACMA",1
33,"33030",873,678,671,1,7,"PACMA",4
40,"40181",4166,3405,3337,21,68,"PACMA",14
45,"45009",464,303,301,2,2,"PACMA",2
43,"43037",17902,12787,12695,63,92,"PACMA",250
6,"6079",644,492,487,3,5,"PACMA",0
37,"37191",104,65,65,1,0,"PACMA",0
43,"43165",572,492,492,1,0,"PACMA",1
25,"25089",97,72,71,1,1,"PACMA",1
44,"44006",223,171,169,2,2,"PACMA",0
19,"19181",55,47,46,1,1,"PACMA",1
10,"10123",575,470,465,2,5,"PACMA",3
46,"46239",453,372,366,2,6,"PACMA",4
48,"48093",888,720,715,2,5,"PACMA",6
47,"47172",135,119,119,0,0,"PACMA",2
9,"9460",167,149,149,5,0,"PACMA",0
5,"5022",1571,1295,1282,5,13,"PACMA",4
4,"4075",5427,3989,3961,15,28,"PACMA",38
37,"37045",28,19,18,0,1,"PACMA",0
12,"12085",5079,3504,3459,13,45,"PACMA",47
37,"37118",120,93,90,2,3,"PACMA",0
37,"37192",355,234,227,5,7,"PACMA",2
40,"40194",39191,31175,30785,250,390,"PACMA",218
25,"25181",175,136,135,0,1,"PACMA",2
37,"37306",242,184,181,2,3,"PACMA",0
31,"31240",513,385,385,6,0,"PACMA",1
39,"39025",8703,6954,6854,39,100,"PACMA",39
12,"12044",452,403,400,4,3,"PACMA",2
47,"47016",70,62,61,0,1,"PACMA",0
43,"43082",351,303,297,1,6,"PACMA",0
20,"20009",11343,8168,8106,46,62,"PACMA",77
24,"24001",168,105,104,0,1,"PACMA",0
45,"45131",264,226,225,0,1,"PACMA",0
47,"47064",37,32,29,0,3,"PACMA",0
4,"4060",407,308,304,1,4,"PACMA",0
18,"18051",1090,800,795,13,5,"PACMA",5
22,"22122",65,58,58,3,0,"PACMA",0
12,"12112",110,97,96,1,1,"PACMA",0
39,"39016",23868,19029,18839,108,190,"PACMA",163
44,"44136",51,43,43,1,0,"PACMA",0
3,"3080",1328,1077,1064,4,13,"PACMA",10
6,"6001",659,539,534,7,5,"PACMA",0
7,"7054",22958,14097,13908,123,189,"PACMA",305
18,"18112",110,80,76,0,4,"PACMA",0
3,"3027",172,156,153,0,3,"PACMA",1
25,"25062",695,578,573,3,5,"PACMA",3
22,"22102",181,153,151,1,2,"PACMA",1
2,"2046",1132,975,953,10,22,"PACMA",8
45,"45133",2808,2233,2187,14,46,"PACMA",9
37,"37267",182,153,150,1,3,"PACMA",0
50,"50076",75,64,63,0,1,"PACMA",2
13,"13072",729,542,531,3,11,"PACMA",1
4,"4062",4460,3466,3425,12,41,"PACMA",23
41,"41046",3006,2464,2427,13,37,"PACMA",25
27,"27053",501,384,373,1,11,"PACMA",0
9,"9467",60,46,46,0,0,"PACMA",0
4,"4103",1439,1120,1108,16,12,"PACMA",8
40,"40091",108,93,93,1,0,"PACMA",2
48,"48080",9946,7574,7499,46,75,"PACMA",56
37,"37160",606,431,418,6,13,"PACMA",1
10,"10106",127,108,106,0,2,"PACMA",0
42,"42024",86,66,66,3,0,"PACMA",0
12,"12026",835,656,639,4,17,"PACMA",0
3,"3072",348,297,295,2,2,"PACMA",3
19,"19127",90,63,63,0,0,"PACMA",0
37,"37025",244,209,206,0,3,"PACMA",0
28,"28119",2245,1839,1821,10,18,"PACMA",17
41,"41082",3359,2760,2718,11,42,"PACMA",12
29,"29081",261,212,210,2,2,"PACMA",0
4,"4072",314,245,240,0,5,"PACMA",1
1,"1022",761,577,569,5,8,"PACMA",4
18,"18035",1190,965,952,4,13,"PACMA",2
37,"37124",196,153,153,2,0,"PACMA",2
3,"3086",166,143,143,1,0,"PACMA",4
50,"50206",453,371,370,5,1,"PACMA",3
49,"49117",437,340,335,1,5,"PACMA",0
16,"16018",381,313,312,2,1,"PACMA",3
16,"16133",4387,3607,3544,38,63,"PACMA",31
21,"21035",9726,6628,6520,78,108,"PACMA",58
10,"10104",5151,3862,3782,22,80,"PACMA",26
3,"3113",4342,3194,3154,23,40,"PACMA",35
6,"6090",824,602,578,4,24,"PACMA",3
38,"38001",20907,12323,12197,70,126,"PACMA",213
2,"2086",2426,1738,1728,8,10,"PACMA",2
43,"43083",144,116,113,1,3,"PACMA",1
18,"18173",8972,6594,6459,58,135,"PACMA",85
47,"47231",4458,3677,3651,47,26,"PACMA",47
10,"10041",1025,840,825,6,15,"PACMA",0
9,"9123",43,39,38,0,1,"PACMA",0
31,"31245",77,60,59,4,1,"PACMA",0
12,"12050",1230,987,972,10,15,"PACMA",7
25,"25024",352,273,272,0,1,"PACMA",1
25,"25190",257,215,215,0,0,"PACMA",2
49,"49233",85,58,58,0,0,"PACMA",0
25,"25223",911,732,723,6,9,"PACMA",7
7,"7062",7902,4889,4828,58,61,"PACMA",58
31,"31086",13640,11040,10966,116,74,"PACMA",128
45,"45031",2824,2104,2068,20,36,"PACMA",28
10,"10028",82,60,59,0,1,"PACMA",0
42,"42149",387,311,308,3,3,"PACMA",1
9,"9255",84,70,70,1,0,"PACMA",1
41,"41053",21618,16549,16150,194,399,"PACMA",164
13,"13098",1983,1537,1485,22,52,"PACMA",16
46,"46240",206,175,169,2,6,"PACMA",0
47,"47081",41,36,36,0,0,"PACMA",0
37,"37193",365,277,276,3,1,"PACMA",2
13,"13089",1609,1336,1299,10,37,"PACMA",1
4,"4096",281,239,237,1,2,"PACMA",0
31,"31265",78,52,47,1,5,"PACMA",0
10,"10148",32986,23987,23589,201,398,"PACMA",263
28,"28179",1450,1115,1100,3,15,"PACMA",18
37,"37377",218,181,176,2,5,"PACMA",0
9,"9363",922,733,725,3,8,"PACMA",6
7,"7038",2025,1581,1556,14,25,"PACMA",12
44,"44232",368,284,273,2,11,"PACMA",0
18,"18048",2462,1873,1832,16,41,"PACMA",25
50,"50056",405,332,330,4,2,"PACMA",3
3,"3077",1374,1131,1114,9,17,"PACMA",20
34,"34141",176,154,152,0,2,"PACMA",0
25,"25104",122,91,91,0,0,"PACMA",2
2,"2083",209,183,183,0,0,"PACMA",0
5,"5140",106,91,89,0,2,"PACMA",0
25,"25110",2731,2121,2106,14,15,"PACMA",19
34,"34004",5533,4345,4286,41,59,"PACMA",37
45,"45138",1055,889,874,5,15,"PACMA",8
15,"15004",4873,3689,3623,31,66,"PACMA",23
45,"45108",482,385,382,0,3,"PACMA",1
38,"38015",4067,2951,2926,22,25,"PACMA",18
24,"24027",1219,913,886,8,27,"PACMA",9
50,"50167",215,181,179,1,2,"PACMA",0
18,"18910",730,491,487,0,4,"PACMA",2
31,"31171",669,516,502,3,14,"PACMA",2
49,"49101",147,99,96,0,3,"PACMA",0
7,"7032",20888,14257,14096,108,161,"PACMA",227
12,"12033",1951,1528,1506,10,22,"PACMA",11
10,"10073",721,553,546,4,7,"PACMA",3
22,"22069",418,337,334,5,3,"PACMA",1
29,"29072",3277,2628,2592,16,36,"PACMA",31
5,"5089",455,354,340,1,14,"PACMA",1
44,"44228",99,83,83,0,0,"PACMA",0
18,"18067",681,511,507,3,4,"PACMA",0
34,"34077",381,301,293,2,8,"PACMA",1
25,"25161",343,243,243,0,0,"PACMA",0
5,"5168",3500,2774,2730,25,44,"PACMA",20
40,"40053",83,62,62,1,0,"PACMA",0
5,"5113",62,49,49,0,0,"PACMA",0
25,"25109",214,179,176,3,3,"PACMA",2
41,"41016",7767,5937,5829,56,108,"PACMA",83
1,"1003",1179,908,903,6,5,"PACMA",3
20,"20002",355,258,257,8,1,"PACMA",0
44,"44264",248,175,171,0,4,"PACMA",0
47,"47153",104,76,75,0,1,"PACMA",0
46,"46069",157,130,129,0,1,"PACMA",1
18,"18099",1581,1279,1245,5,34,"PACMA",12
47,"47088",105,90,90,0,0,"PACMA",0
47,"47030",941,759,740,3,19,"PACMA",3
42,"42168",108,85,85,1,0,"PACMA",1
25,"25219",149,118,118,1,0,"PACMA",0
26,"26144",188,161,160,1,1,"PACMA",0
15,"15028",1393,1076,1063,8,13,"PACMA",11
2,"2062",386,287,285,4,2,"PACMA",0
6,"6024",1133,963,941,5,22,"PACMA",4
5,"5061",261,214,208,0,6,"PACMA",1
15,"15077",8155,5554,5433,59,121,"PACMA",21
12,"12042",574,486,479,8,7,"PACMA",3
12,"12025",121,102,99,0,3,"PACMA",0
37,"37203",146,113,112,0,1,"PACMA",0
26,"26141",100,73,73,0,0,"PACMA",0
42,"42171",114,80,79,0,1,"PACMA",0
39,"39008",13900,10895,10767,81,128,"PACMA",107
44,"44097",126,91,90,2,1,"PACMA",0
13,"13093",3930,2960,2906,34,54,"PACMA",17
6,"6002",4314,3181,3086,44,95,"PACMA",25
37,"37284",314,241,237,2,4,"PACMA",0
49,"49064",483,319,317,1,2,"PACMA",0
3,"3051",344,312,307,2,5,"PACMA",1
22,"22040",144,124,120,1,4,"PACMA",0
16,"16191",858,707,701,8,6,"PACMA",0
5,"5054",1203,946,927,5,19,"PACMA",7
24,"24033",205,146,146,3,0,"PACMA",0
32,"32018",1179,950,936,3,14,"PACMA",1
44,"44010",184,137,137,1,0,"PACMA",0
5,"5055",540,448,445,1,3,"PACMA",5
26,"26019",350,270,256,3,14,"PACMA",4
16,"16056",453,323,321,1,2,"PACMA",1
1,"1039",195,157,153,0,4,"PACMA",1
5,"5152",655,537,534,3,3,"PACMA",0
25,"25082",295,229,229,2,0,"PACMA",1
5,"5010",145,119,118,1,1,"PACMA",0
37,"37081",871,725,717,4,8,"PACMA",3
50,"50266",121,85,80,0,5,"PACMA",1
42,"42076",201,157,151,0,6,"PACMA",0
40,"40206",162,132,128,2,4,"PACMA",2
24,"24030",4201,3080,3024,25,56,"PACMA",20
24,"24190",146,109,109,1,0,"PACMA",0
49,"49147",249,197,196,1,1,"PACMA",0
37,"37286",203,147,142,2,5,"PACMA",3
32,"32029",436,340,337,1,3,"PACMA",0
12,"12039",792,688,680,3,8,"PACMA",1
26,"26041",114,84,84,0,0,"PACMA",0
31,"31901",15510,12225,12133,114,92,"PACMA",106
18,"18065",591,482,468,4,14,"PACMA",6
49,"49228",55,47,47,0,0,"PACMA",0
22,"22174",462,381,377,0,4,"PACMA",1
47,"47178",166,144,143,4,1,"PACMA",2
16,"16266",358,281,279,3,2,"PACMA",0
48,"48049",545,448,448,0,0,"PACMA",3
38,"38011",21563,15380,15214,69,166,"PACMA",313
26,"26046",1571,1185,1157,18,28,"PACMA",3
46,"46097",958,764,756,6,8,"PACMA",7
13,"13066",2604,2182,2146,6,36,"PACMA",20
1,"1031",1163,948,928,6,20,"PACMA",8
9,"9329",117,90,89,8,1,"PACMA",2
32,"32021",874,616,615,4,1,"PACMA",3
6,"6116",1512,1158,1144,3,14,"PACMA",4
31,"31208",2562,2067,2036,16,31,"PACMA",17
19,"19239",91,64,63,1,1,"PACMA",0
19,"19195",37,29,28,2,1,"PACMA",0
42,"42177",64,55,54,6,1,"PACMA",0
16,"16011",23,18,18,0,0,"PACMA",0
48,"48023",580,493,489,0,4,"PACMA",2
5,"5215",159,126,124,0,2,"PACMA",1
2,"2080",499,409,400,0,9,"PACMA",1
25,"25037",366,286,284,3,2,"PACMA",1
5,"5100",267,217,212,1,5,"PACMA",0
10,"10115",3488,2878,2816,15,62,"PACMA",20
30,"30043",25401,20378,19992,131,386,"PACMA",257
34,"34073",180,149,145,2,4,"PACMA",2
42,"42029",131,98,97,2,1,"PACMA",0
10,"10111",1306,1006,994,12,12,"PACMA",4
6,"6107",1570,1117,1106,9,11,"PACMA",3
35,"35007",518,405,401,0,4,"PACMA",1
3,"3042",1462,1025,1008,3,17,"PACMA",16
46,"46065",1576,1246,1228,6,18,"PACMA",15
46,"46259",462,395,394,2,1,"PACMA",4
39,"39022",969,740,732,2,8,"PACMA",1
18,"18042",418,344,340,7,4,"PACMA",0
28,"28031",2140,1642,1614,11,28,"PACMA",11
24,"24040",412,322,320,2,2,"PACMA",2
25,"25151",736,592,584,1,8,"PACMA",9
49,"49181",335,227,224,2,3,"PACMA",2
48,"48018",867,605,603,3,2,"PACMA",2
19,"19120",108,90,90,1,0,"PACMA",1
11,"11010",6351,4472,4385,140,87,"PACMA",35
41,"41036",3917,2944,2885,27,59,"PACMA",32
25,"25216",241,199,199,2,0,"PACMA",3
5,"5110",706,550,546,4,4,"PACMA",1
31,"31206",2082,1610,1589,15,21,"PACMA",28
22,"22032",107,74,74,2,0,"PACMA",1
15,"15024",4346,3210,3151,19,59,"PACMA",23
34,"34033",17,15,15,0,0,"PACMA",0
4,"4009",151,126,124,3,2,"PACMA",0
44,"44080",284,214,212,1,2,"PACMA",1
4,"4074",2887,2062,2038,16,24,"PACMA",26
15,"15046",6163,4625,4497,49,128,"PACMA",32
37,"37368",17,15,11,0,4,"PACMA",0
10,"10088",196,139,138,0,1,"PACMA",0
1,"1901",2474,1655,1631,13,24,"PACMA",30
37,"37168",407,305,300,0,5,"PACMA",0
37,"37060",280,224,224,0,0,"PACMA",3
5,"5103",66,48,48,0,0,"PACMA",0
12,"12075",107,89,87,0,2,"PACMA",0
39,"39052",18957,15123,14985,106,138,"PACMA",152
44,"44238",2294,1763,1743,10,20,"PACMA",8
2,"2011",578,461,459,2,2,"PACMA",2
18,"18078",710,561,554,4,7,"PACMA",5
37,"37369",125,95,93,0,2,"PACMA",2
16,"16004",227,193,191,0,2,"PACMA",0
25,"25207",6430,4899,4867,41,32,"PACMA",31
22,"22158",11951,8877,8801,69,76,"PACMA",87
26,"26052",148,113,113,1,0,"PACMA",0
12,"12130",420,345,341,0,4,"PACMA",0
38,"38016",1178,654,648,6,6,"PACMA",6
3,"3119",17223,13244,13116,75,128,"PACMA",187
12,"12073",132,110,107,1,3,"PACMA",2
20,"20053",4848,3479,3451,27,28,"PACMA",31
31,"31106",718,585,581,3,4,"PACMA",8
37,"37245",335,240,240,5,0,"PACMA",0
22,"22022",543,441,433,4,8,"PACMA",6
12,"12045",328,275,271,2,4,"PACMA",0
14,"14033",1265,994,985,9,9,"PACMA",12
46,"46080",985,799,788,5,11,"PACMA",2
34,"34159",370,247,244,5,3,"PACMA",0
27,"27001",2209,1290,1251,25,39,"PACMA",6
18,"18069",497,374,366,4,8,"PACMA",2
9,"9003",184,143,142,2,1,"PACMA",1
40,"40905",128,101,100,4,1,"PACMA",0
38,"38018",4455,3242,3198,24,44,"PACMA",26
2,"2014",350,285,280,1,5,"PACMA",0
19,"19279",51,44,44,0,0,"PACMA",0
39,"39073",10200,8230,8150,65,80,"PACMA",80
26,"26132",106,87,87,0,0,"PACMA",3
46,"46125",846,681,675,1,6,"PACMA",2
26,"26067",20,19,19,0,0,"PACMA",0
47,"47084",1101,880,871,7,9,"PACMA",1
47,"47062",157,134,134,0,0,"PACMA",1
6,"6102",1019,852,842,2,10,"PACMA",2
37,"37036",57,42,41,0,1,"PACMA",0
2,"2015",1433,1234,1214,7,20,"PACMA",6
37,"37184",290,199,195,0,4,"PACMA",0
40,"40118",47,38,37,2,1,"PACMA",1
44,"44020",22,18,18,0,0,"PACMA",0
19,"19162",67,50,48,0,2,"PACMA",2
24,"24008",9025,6803,6702,79,101,"PACMA",35
31,"31137",198,106,103,3,3,"PACMA",0
40,"40128",122,95,93,2,2,"PACMA",1
29,"29076",2335,1661,1614,11,47,"PACMA",26
9,"9480",109,87,85,1,2,"PACMA",1
18,"18020",501,365,358,2,7,"PACMA",0
28,"28169",1553,1280,1273,15,7,"PACMA",20
19,"19032",146,102,101,2,1,"PACMA",0
44,"44018",16,16,16,0,0,"PACMA",0
19,"19057",72,59,58,0,1,"PACMA",1
6,"6045",476,368,362,3,6,"PACMA",1
42,"42121",55,42,42,0,0,"PACMA",0
46,"46106",1466,1156,1142,3,14,"PACMA",10
19,"19047",55,47,47,0,0,"PACMA",1
18,"18188",1648,1295,1276,4,19,"PACMA",5
10,"10202",588,469,459,0,10,"PACMA",4
19,"19192",1759,1367,1360,3,7,"PACMA",6
19,"19237",40,33,33,0,0,"PACMA",0
40,"40138",2127,1729,1696,18,33,"PACMA",6
50,"50126",2262,1736,1708,20,28,"PACMA",7
19,"19089",25,19,19,1,0,"PACMA",0
37,"37367",185,150,148,4,2,"PACMA",0
28,"28022",36550,31559,31436,207,123,"PACMA",302
15,"15058",28606,22203,22022,261,181,"PACMA",240
47,"47198",66,47,47,0,0,"PACMA",0
46,"46229",911,755,752,5,3,"PACMA",4
18,"18168",781,613,604,6,9,"PACMA",4
50,"50123",436,344,338,1,6,"PACMA",6
4,"4094",209,156,154,0,2,"PACMA",0
16,"16081",49,42,42,0,0,"PACMA",2
47,"47045",734,601,590,5,11,"PACMA",0
19,"19166",152,125,122,0,3,"PACMA",2
49,"49174",130,93,91,0,2,"PACMA",0
34,"34057",462,345,330,3,15,"PACMA",2
26,"26010",85,68,68,1,0,"PACMA",0
22,"22006",272,206,201,2,5,"PACMA",2
33,"33055",1492,1156,1121,6,35,"PACMA",7
34,"34011",386,326,321,2,5,"PACMA",1
46,"46118",3670,2930,2894,25,36,"PACMA",33
25,"25145",76,66,66,1,0,"PACMA",0
39,"39030",1895,1374,1358,6,16,"PACMA",12
28,"28010",10538,8708,8635,54,73,"PACMA",127
6,"6018",740,543,536,5,7,"PACMA",1
26,"26112",223,177,174,0,3,"PACMA",0
29,"29073",1645,1200,1185,13,15,"PACMA",16
5,"5064",102,83,81,2,2,"PACMA",0
16,"16044",43,31,30,0,1,"PACMA",1
4,"4048",1496,1109,1102,4,7,"PACMA",3
9,"9071",40,32,32,0,0,"PACMA",0
12,"12071",1267,1021,1006,11,15,"PACMA",8
37,"37052",278,201,199,2,2,"PACMA",0
41,"41004",57465,41004,40321,571,683,"PACMA",790
34,"34059",402,326,320,3,6,"PACMA",1
27,"27017",961,667,654,1,13,"PACMA",4
33,"33026",8270,5540,5474,69,66,"PACMA",38
50,"50075",72,59,59,1,0,"PACMA",0
24,"24014",7180,5189,5097,46,92,"PACMA",26
44,"44065",57,37,36,0,1,"PACMA",0
30,"30021",9441,6664,6591,32,73,"PACMA",47
37,"37023",1586,1316,1298,12,18,"PACMA",10
37,"37145",244,187,185,3,2,"PACMA",0
19,"19293",1905,1513,1499,10,14,"PACMA",37
32,"32026",2659,1988,1957,26,31,"PACMA",15
24,"24162",1772,1382,1369,22,13,"PACMA",13
42,"42115",95,77,77,1,0,"PACMA",0
3,"3131",179,147,139,0,8,"PACMA",1
43,"43059",250,214,214,1,0,"PACMA",2
5,"5230",65,58,58,4,0,"PACMA",1
50,"50106",127,97,96,0,1,"PACMA",1
37,"37073",620,481,471,6,10,"PACMA",4
50,"50077",206,158,157,1,1,"PACMA",1
12,"12141",92,81,81,0,0,"PACMA",1
19,"19901",36,32,32,0,0,"PACMA",0
35,"35003",5582,3441,3391,26,50,"PACMA",38
46,"46091",115,99,99,0,0,"PACMA",0
35,"35022",51302,33009,32566,198,443,"PACMA",533
6,"6054",5454,4329,4190,46,139,"PACMA",18
32,"32034",1074,855,846,1,9,"PACMA",5
13,"13042",888,699,686,2,13,"PACMA",1
24,"24095",307,237,235,0,2,"PACMA",3
24,"24056",2762,2062,2013,24,49,"PACMA",11
41,"41047",10411,8348,8242,84,106,"PACMA",80
9,"9412",765,564,558,7,6,"PACMA",3
47,"47176",202,138,138,1,0,"PACMA",0
15,"15068",4849,3435,3392,55,43,"PACMA",23
2,"2020",431,359,356,3,3,"PACMA",3
1,"1049",132,100,100,1,0,"PACMA",1
28,"28182",198,169,169,1,0,"PACMA",0
15,"15002",24007,18075,17857,216,218,"PACMA",256
25,"25047",972,784,781,8,3,"PACMA",2
9,"9029",144,120,118,3,2,"PACMA",2
18,"18087",182514,141305,139588,865,1717,"PACMA",1618
24,"24902",335,266,263,1,3,"PACMA",0
42,"42212",62,48,47,1,1,"PACMA",0
10,"10198",1071,945,924,3,21,"PACMA",3
47,"47102",264,217,211,1,6,"PACMA",2
15,"15038",2123,1441,1413,25,28,"PACMA",5
44,"44157",64,38,38,1,0,"PACMA",0
18,"18094",2304,1845,1798,16,47,"PACMA",14
12,"12094",875,694,682,2,12,"PACMA",7
27,"27059",2055,1508,1471,13,37,"PACMA",4
43,"43051",9092,6577,6502,26,75,"PACMA",129
44,"44123",99,69,69,1,0,"PACMA",1
34,"34022",1019,856,849,8,7,"PACMA",3
16,"16153",936,786,768,7,18,"PACMA",2
37,"37078",788,670,658,6,12,"PACMA",3
9,"9304",192,164,161,2,3,"PACMA",1
18,"18185",542,454,453,2,1,"PACMA",7
19,"19145",41,38,38,0,0,"PACMA",0
42,"42124",58,41,41,0,0,"PACMA",0
41,"41087",10496,7661,7477,57,184,"PACMA",90
15,"15008",5631,4320,4267,64,53,"PACMA",51
2,"2075",1718,1470,1448,4,22,"PACMA",6
28,"28046",4776,3944,3912,22,32,"PACMA",67
11,"11015",64073,43152,42713,710,439,"PACMA",827
7,"7014",7778,4724,4669,50,55,"PACMA",82
40,"40162",387,286,278,3,8,"PACMA",0
29,"29031",1559,1139,1113,13,26,"PACMA",12
34,"34216",60,46,46,0,0,"PACMA",0
3,"3011",8014,5870,5810,38,60,"PACMA",96
32,"32009",10590,7661,7574,68,87,"PACMA",55
11,"11040",398,348,342,4,6,"PACMA",1
25,"25022",107,88,88,0,0,"PACMA",1
40,"40152",748,637,620,6,17,"PACMA",3
29,"29032",6657,5314,5190,30,124,"PACMA",37
1,"1053",592,376,373,2,3,"PACMA",3
15,"15037",4031,2700,2677,13,23,"PACMA",21
39,"39031",1245,990,983,5,7,"PACMA",6
16,"16030",22,19,19,1,0,"PACMA",0
45,"45115",2586,2158,2114,8,44,"PACMA",12
12,"12076",76,64,64,1,0,"PACMA",1
37,"37090",66,51,51,1,0,"PACMA",0
31,"31124",207,151,150,2,1,"PACMA",4
25,"25044",178,145,144,6,1,"PACMA",0
21,"21059",220,184,180,0,4,"PACMA",0
46,"46126",5574,4565,4528,25,37,"PACMA",51
22,"22087",58,47,47,0,0,"PACMA",0
16,"16079",26,17,17,0,0,"PACMA",0
6,"6126",2142,1619,1594,9,25,"PACMA",5
50,"50070",49,28,28,0,0,"PACMA",0
20,"20013",5430,4144,4119,19,25,"PACMA",15
49,"49022",280,243,241,1,2,"PACMA",0
12,"12088",57,54,54,0,0,"PACMA",0
31,"31207",285,209,206,1,3,"PACMA",2
22,"22215",128,91,91,1,0,"PACMA",1
25,"25233",285,231,229,2,2,"PACMA",3
16,"16121",233,183,179,0,4,"PACMA",1
24,"24158",296,226,220,2,6,"PACMA",0
48,"48063",356,277,274,2,3,"PACMA",2
38,"38035",10384,6657,6596,50,61,"PACMA",105
19,"19266",229,194,192,1,2,"PACMA",2
29,"29091",9407,6859,6719,63,140,"PACMA",88
49,"49027",126,88,88,0,0,"PACMA",0
29,"29034",467,374,373,1,1,"PACMA",4
38,"38005",5666,3795,3761,24,34,"PACMA",35
37,"37351",269,234,233,6,1,"PACMA",0
46,"46067",1744,1451,1432,4,19,"PACMA",14
43,"43163",26013,18942,18796,89,146,"PACMA",365
19,"19267",21,17,17,1,0,"PACMA",0
45,"45078",1328,1152,1133,6,19,"PACMA",9
9,"9311",59,47,46,0,1,"PACMA",0
43,"43065",382,308,304,1,4,"PACMA",0
28,"28050",4367,3411,3384,14,27,"PACMA",55
25,"25114",95,79,79,0,0,"PACMA",1
31,"31181",134,94,93,1,1,"PACMA",0
19,"19213",70,53,52,0,1,"PACMA",0
39,"39040",4267,3428,3385,24,43,"PACMA",19
46,"46082",4958,3801,3759,21,42,"PACMA",42
42,"42159",40,36,35,0,1,"PACMA",0
13,"13095",72,60,60,1,0,"PACMA",0
4,"4028",202,183,181,0,2,"PACMA",1
10,"10026",656,515,507,8,8,"PACMA",1
43,"43164",306,228,228,0,0,"PACMA",3
9,"9257",86,74,71,0,3,"PACMA",0
20,"20080",7709,5629,5588,28,41,"PACMA",37
20,"20049",4159,3024,3004,11,20,"PACMA",23
32,"32041",759,510,502,2,8,"PACMA",1
50,"50232",160,116,114,2,2,"PACMA",1
5,"5242",686,588,585,11,3,"PACMA",2
37,"37354",5467,3960,3910,31,50,"PACMA",27
19,"19198",17,17,17,0,0,"PACMA",1
3,"3120",2421,1823,1786,9,37,"PACMA",18
10,"10030",472,323,318,1,5,"PACMA",1
43,"43092",7235,5200,5174,21,26,"PACMA",107
47,"47089",132,116,115,1,1,"PACMA",0
49,"49030",80,66,62,0,4,"PACMA",0
25,"25225",541,427,420,4,7,"PACMA",3
49,"49275",51218,38135,37628,388,507,"PACMA",264
29,"29004",295,233,226,0,7,"PACMA",3
49,"49191",266,216,214,1,2,"PACMA",0
50,"50204",2394,1876,1855,21,21,"PACMA",10
29,"29037",215,179,179,0,0,"PACMA",0
5,"5243",81,63,62,1,1,"PACMA",1
22,"22170",668,529,520,4,9,"PACMA",5
10,"10032",1596,1263,1243,5,20,"PACMA",4
43,"43166",1628,1292,1285,3,7,"PACMA",19
19,"19091",23,19,19,0,0,"PACMA",0
37,"37305",218,180,178,3,2,"PACMA",1
50,"50148",290,229,227,2,2,"PACMA",1
27,"27060",2463,1695,1669,12,26,"PACMA",10
46,"46132",2196,1877,1853,10,24,"PACMA",15
22,"22020",119,91,87,1,4,"PACMA",0
50,"50177",276,226,223,0,3,"PACMA",1
50,"50087",29,18,18,0,0,"PACMA",0
37,"37281",39,34,33,0,1,"PACMA",0
31,"31091",327,224,224,1,0,"PACMA",0
15,"15078",78678,60510,59882,621,628,"PACMA",588
5,"5201",499,414,407,2,7,"PACMA",2
5,"5046",39,37,37,0,0,"PACMA",0
20,"20019",9912,7226,7195,51,31,"PACMA",42
44,"44260",138,91,90,1,1,"PACMA",0
25,"25027",977,765,763,4,2,"PACMA",4
29,"29018",1996,1523,1481,11,42,"PACMA",11
18,"18150",6903,5149,5063,42,86,"PACMA",50
50,"50159",641,527,526,8,1,"PACMA",1
15,"15016",4569,3171,3146,18,25,"PACMA",18
50,"50178",276,193,193,4,0,"PACMA",1
50,"50088",282,233,227,2,6,"PACMA",0
18,"18912",1367,990,984,5,6,"PACMA",4
9,"9051",163,134,133,1,1,"PACMA",0
43,"43135",341,283,280,4,3,"PACMA",2
31,"31215",4669,3580,3508,35,72,"PACMA",43
47,"47187",75,54,53,0,1,"PACMA",0
18,"18176",241,182,180,0,2,"PACMA",0
37,"37207",325,260,258,1,2,"PACMA",1
9,"9378",29,21,20,0,1,"PACMA",0
15,"15080",1640,1177,1150,9,27,"PACMA",2
44,"44068",643,518,511,9,7,"PACMA",6
50,"50119",872,684,680,4,4,"PACMA",5
40,"40139",258,207,202,0,5,"PACMA",2
34,"34081",60,48,48,0,0,"PACMA",0
34,"34129",170,134,132,2,2,"PACMA",1
12,"12098",533,446,440,4,6,"PACMA",1
44,"44252",75,56,56,1,0,"PACMA",0
12,"12069",53,45,44,1,1,"PACMA",0
46,"46003",953,828,811,5,17,"PACMA",7
4,"4054",352,280,278,2,2,"PACMA",3
3,"3021",5578,4720,4626,35,94,"PACMA",37
10,"10037",76855,60447,59702,451,745,"PACMA",614
38,"38042",3781,2799,2774,11,25,"PACMA",18
34,"34082",80,68,68,0,0,"PACMA",0
43,"43169",450,396,396,3,0,"PACMA",3
20,"20025",1116,835,830,2,5,"PACMA",5
37,"37012",145,116,114,0,2,"PACMA",0
25,"25152",144,106,106,1,0,"PACMA",1
9,"9086",661,521,518,5,3,"PACMA",3
3,"3079",18403,14632,14382,114,250,"PACMA",222
45,"45901",780,593,587,3,6,"PACMA",7
42,"42105",46,37,37,1,0,"PACMA",0
47,"47060",231,198,195,4,3,"PACMA",1
6,"6033",1269,1026,1010,4,16,"PACMA",2
43,"43072",93,74,74,0,0,"PACMA",0
18,"18071",5612,4271,4184,29,87,"PACMA",43
41,"41023",7975,5918,5812,51,106,"PACMA",42
42,"42217",34,26,26,0,0,"PACMA",0
48,"48052",1567,1309,1300,4,9,"PACMA",8
47,"47181",165,143,143,0,0,"PACMA",0
22,"22193",269,220,217,2,3,"PACMA",2
40,"40106",183,153,151,2,2,"PACMA",0
49,"49258",110,93,92,0,1,"PACMA",0
5,"5109",441,363,356,5,7,"PACMA",0
42,"42052",17,15,15,0,0,"PACMA",0
6,"6083",46489,34360,33989,270,371,"PACMA",343
9,"9473",87,76,73,0,3,"PACMA",0
47,"47086",3823,3090,3046,24,44,"PACMA",8
46,"46249",9159,7113,7012,73,101,"PACMA",61
12,"12110",219,168,166,1,2,"PACMA",0
10,"10027",76,66,66,0,0,"PACMA",0
25,"25036",184,144,143,0,1,"PACMA",0
15,"15052",4104,2928,2878,30,50,"PACMA",26
43,"43147",521,446,442,4,4,"PACMA",2
24,"24077",215,178,178,0,0,"PACMA",0
12,"12101",356,297,289,2,8,"PACMA",2
23,"23071",1720,1348,1330,6,18,"PACMA",7
30,"30028",6400,4364,4289,30,75,"PACMA",23
24,"24198",547,402,399,4,3,"PACMA",0
37,"37016",574,464,455,3,9,"PACMA",1
37,"37364",757,549,536,7,13,"PACMA",1
19,"19333",105,74,73,1,1,"PACMA",0
49,"49004",111,77,77,4,0,"PACMA",1
1,"1032",500,372,362,1,10,"PACMA",1
26,"26071",8662,6409,6288,52,121,"PACMA",71
25,"25168",488,408,407,6,1,"PACMA",2
42,"42130",51,46,45,0,1,"PACMA",0
13,"13068",1037,802,783,2,19,"PACMA",1
6,"6051",1543,1206,1188,3,18,"PACMA",2
4,"4007",731,570,569,0,1,"PACMA",6
40,"40012",238,178,175,4,3,"PACMA",0
25,"25063",95,61,61,0,0,"PACMA",1
31,"31029",916,661,647,7,14,"PACMA",2
6,"6052",3969,3043,2970,21,73,"PACMA",22
40,"40180",277,231,224,3,7,"PACMA",0
19,"19285",20,18,18,0,0,"PACMA",0
20,"20060",88,75,75,0,0,"PACMA",0
47,"47037",163,134,128,2,6,"PACMA",0
9,"9169",97,86,85,0,1,"PACMA",1
9,"9061",148,129,129,0,0,"PACMA",0
3,"3026",1316,1040,1024,5,16,"PACMA",6
46,"46201",62,47,47,0,0,"PACMA",0
37,"37072",145,136,134,3,2,"PACMA",0
40,"40157",43,33,33,2,0,"PACMA",2
13,"13024",891,636,628,2,8,"PACMA",0
20,"20030",21198,15734,15654,100,80,"PACMA",97
12,"12074",761,659,645,7,14,"PACMA",2
37,"37019",140,118,117,1,1,"PACMA",0
44,"44145",972,741,732,11,9,"PACMA",4
16,"16251",1809,1469,1443,11,26,"PACMA",9
22,"22236",236,207,203,2,4,"PACMA",1
45,"45142",7800,6245,6143,67,102,"PACMA",68
47,"47133",2776,2317,2292,28,25,"PACMA",29
50,"50067",13788,10562,10413,107,149,"PACMA",73
1,"1036",14772,10850,10746,69,104,"PACMA",91
38,"38038",164468,112475,111577,728,898,"PACMA",2574
49,"49088",82,59,59,0,0,"PACMA",0
3,"3058",4967,4031,3967,24,64,"PACMA",31
4,"4087",156,117,116,1,1,"PACMA",0
37,"37204",255,197,195,0,2,"PACMA",0
19,"19244",74,54,54,0,0,"PACMA",0
25,"25138",547,440,436,1,4,"PACMA",3
37,"37332",70,53,53,0,0,"PACMA",0
14,"14071",884,641,634,2,7,"PACMA",4
22,"22111",146,115,115,1,0,"PACMA",3
19,"19156",933,756,745,1,11,"PACMA",2
44,"44082",89,72,69,0,3,"PACMA",0
10,"10047",937,772,760,3,12,"PACMA",5
45,"45099",3635,2741,2684,23,57,"PACMA",42
44,"44209",815,606,592,2,14,"PACMA",4
23,"23072",1885,1485,1468,5,17,"PACMA",0
2,"2044",1049,746,737,5,9,"PACMA",1
23,"23905",1840,1358,1341,9,17,"PACMA",10
34,"34001",39,32,32,3,0,"PACMA",0
2,"2049",796,582,574,1,8,"PACMA",1
46,"46143",4230,3255,3200,20,55,"PACMA",53
18,"18103",722,556,555,3,1,"PACMA",3
3,"3049",12143,9418,9302,47,116,"PACMA",82
13,"13014",481,400,395,1,5,"PACMA",0
46,"46052",508,436,426,3,10,"PACMA",0
36,"36020",2184,1621,1599,13,22,"PACMA",4
16,"16258",172,128,128,2,0,"PACMA",0
25,"25163",236,181,179,3,2,"PACMA",0
3,"3030",563,474,466,2,8,"PACMA",4
19,"19247",142,118,117,2,1,"PACMA",0
42,"42090",88,69,68,2,1,"PACMA",0
5,"5065",459,393,382,1,11,"PACMA",2
37,"37221",394,299,299,2,0,"PACMA",0
5,"5144",66,51,51,0,0,"PACMA",0
19,"19008",37,32,32,1,0,"PACMA",3
41,"41039",31500,23692,23345,234,347,"PACMA",252
9,"9160",80,64,64,1,0,"PACMA",0
50,"50120",55,43,43,2,0,"PACMA",0
29,"29098",1235,953,935,12,18,"PACMA",3
38,"38032",13536,9924,9867,63,57,"PACMA",177
12,"12037",17,17,17,1,0,"PACMA",0
50,"50189",678,544,534,5,10,"PACMA",3
49,"49197",162,129,123,2,6,"PACMA",3
21,"21021",12469,8238,8097,76,141,"PACMA",90
3,"3031",41857,28648,28362,163,286,"PACMA",449
10,"10214",217,175,175,1,0,"PACMA",0
37,"37109",177,149,149,3,0,"PACMA",0
6,"6157",397,296,292,1,4,"PACMA",0
9,"9177",1127,883,877,6,6,"PACMA",3
22,"22115",347,262,261,1,1,"PACMA",0
9,"9068",24,18,18,0,0,"PACMA",0
12,"12127",67,50,50,1,0,"PACMA",0
37,"37373",700,522,514,0,8,"PACMA",2
38,"38023",125528,88323,87456,598,867,"PACMA",1851
9,"9125",552,424,421,3,3,"PACMA",3
21,"21006",3329,2307,2262,20,45,"PACMA",22
37,"37021",69,52,51,1,1,"PACMA",0
16,"16113",3067,2416,2383,15,33,"PACMA",22
49,"49108",454,325,322,2,3,"PACMA",2
19,"19080",65,51,51,0,0,"PACMA",0
43,"43129",4611,3528,3495,21,33,"PACMA",44
10,"10161",82,50,50,1,0,"PACMA",0
5,"5029",99,69,69,0,0,"PACMA",0
9,"9347",135,108,108,0,0,"PACMA",0
48,"48001",5885,4359,4334,35,25,"PACMA",53
42,"42081",136,95,93,0,2,"PACMA",0
29,"29044",757,540,533,7,7,"PACMA",0
10,"10040",434,321,314,1,7,"PACMA",0
6,"6082",393,314,305,5,9,"PACMA",1
23,"23903",3499,2738,2714,7,24,"PACMA",11
40,"40024",827,657,645,4,12,"PACMA",1
22,"22233",80,50,50,0,0,"PACMA",0
12,"12028",12955,10391,10301,68,90,"PACMA",142
44,"44012",310,240,238,5,2,"PACMA",4
10,"10109",1730,1208,1181,12,27,"PACMA",4
19,"19048",19,13,13,0,0,"PACMA",0
12,"12017",148,120,116,0,4,"PACMA",0
26,"26123",124,112,110,0,2,"PACMA",0
10,"10054",524,435,422,1,13,"PACMA",2
9,"9181",277,220,219,2,1,"PACMA",0
24,"24090",326,213,213,2,0,"PACMA",2
27,"27046",1448,1074,1063,7,11,"PACMA",6
2,"2055",1057,770,755,6,15,"PACMA",3
1,"1047",967,686,673,8,13,"PACMA",7
40,"40121",249,196,193,4,3,"PACMA",0
26,"26164",51,37,37,1,0,"PACMA",0
3,"3034",1391,1107,1090,7,17,"PACMA",16
15,"15001",4689,3422,3362,52,60,"PACMA",25
26,"26124",776,635,624,5,11,"PACMA",2
37,"37340",142,101,101,0,0,"PACMA",0
25,"25177",358,270,268,1,2,"PACMA",0
49,"49175",205,150,149,2,1,"PACMA",0
42,"42069",1491,1073,1048,20,25,"PACMA",6
10,"10219",1212,814,806,8,8,"PACMA",1
18,"18122",16001,11761,11556,110,205,"PACMA",105
29,"29077",214,158,156,1,2,"PACMA",0
39,"39028",3870,3131,3094,19,37,"PACMA",25
10,"10016",327,260,259,1,1,"PACMA",4
25,"25179",171,134,134,1,0,"PACMA",1
45,"45018",551,399,397,3,2,"PACMA",2
42,"42151",38,31,30,0,1,"PACMA",0
22,"22007",756,576,571,5,5,"PACMA",2
19,"19169",33,26,25,0,1,"PACMA",0
42,"42017",131,104,104,2,0,"PACMA",0
37,"37229",139,110,106,2,4,"PACMA",0
42,"42152",67,47,46,0,1,"PACMA",3
44,"44184",38,28,26,0,2,"PACMA",1
26,"26074",107,97,96,2,1,"PACMA",0
37,"37087",910,755,747,3,8,"PACMA",11
24,"24015",2209,1714,1672,19,42,"PACMA",6
22,"22209",159,139,136,5,3,"PACMA",2
50,"50222",1570,1126,1105,17,21,"PACMA",4
34,"34060",135,111,110,0,1,"PACMA",0
6,"6131",1063,880,874,5,6,"PACMA",1
37,"37343",66,50,48,1,2,"PACMA",0
10,"10018",1630,1149,1112,12,37,"PACMA",2
6,"6098",534,421,411,8,10,"PACMA",0
44,"44185",93,73,72,1,1,"PACMA",0
40,"40192",133,104,102,2,2,"PACMA",0
10,"10141",289,224,223,0,1,"PACMA",0
13,"13086",162,139,136,1,3,"PACMA",0
1,"1006",176,127,127,2,0,"PACMA",3
9,"9078",37,31,31,0,0,"PACMA",0
36,"36059",4663,3196,3115,31,81,"PACMA",20
3,"3028",964,804,795,6,9,"PACMA",5
18,"18161",251,222,220,1,2,"PACMA",3
27,"27050",2842,2100,2072,19,28,"PACMA",12
9,"9033",81,69,68,1,1,"PACMA",0
34,"34062",150,108,107,1,1,"PACMA",0
27,"27019",8189,6148,6039,94,109,"PACMA",65
31,"31159",1105,880,871,3,9,"PACMA",5
10,"10142",840,641,639,5,2,"PACMA",3
43,"43036",865,605,602,1,3,"PACMA",16
50,"50281",68,55,52,0,3,"PACMA",0
16,"16123",66,43,43,0,0,"PACMA",0
15,"15902",4522,3220,3159,47,61,"PACMA",31
44,"44094",123,112,112,0,0,"PACMA",2
22,"22126",87,66,66,0,0,"PACMA",0
27,"27051",8012,5936,5832,70,104,"PACMA",59
37,"37381",139,97,95,1,2,"PACMA",1
10,"10048",204,156,154,0,2,"PACMA",0
42,"42139",21,15,15,1,0,"PACMA",0
26,"26077",17,17,17,0,0,"PACMA",0
26,"26104",11,9,9,0,0,"PACMA",0
47,"47210",402,300,289,2,11,"PACMA",0
3,"3134",141,119,117,0,2,"PACMA",1
31,"31201",151084,115375,114510,1072,865,"PACMA",944
34,"34214",178,141,141,1,0,"PACMA",2
9,"9358",248,186,179,1,7,"PACMA",1
28,"28120",1209,991,974,3,17,"PACMA",5
42,"42022",206,161,161,1,0,"PACMA",0
31,"31243",302,241,237,5,4,"PACMA",1
48,"48902",18971,14015,13895,101,120,"PACMA",138
28,"28153",795,566,564,5,2,"PACMA",4
31,"31121",65,51,51,0,0,"PACMA",1
21,"21902",1144,829,824,9,5,"PACMA",11
19,"19009",247,190,187,0,3,"PACMA",0
5,"5171",67,57,51,1,6,"PACMA",1
47,"47031",196,155,155,3,0,"PACMA",0
49,"49048",114,85,85,0,0,"PACMA",2
50,"50080",34,29,29,0,0,"PACMA",0
30,"30005",30193,22648,22419,136,229,"PACMA",364
16,"16103",239,203,203,0,0,"PACMA",0
21,"21057",995,631,629,3,2,"PACMA",0
47,"47052",6752,5665,5589,57,76,"PACMA",64
10,"10064",1409,1103,1072,6,31,"PACMA",4
7,"7036",27950,20870,20707,154,163,"PACMA",391
13,"13092",1715,1434,1425,1,9,"PACMA",0
16,"16007",1159,975,968,10,7,"PACMA",7
22,"22901",714,521,508,3,13,"PACMA",1
40,"40056",32,21,21,0,0,"PACMA",1
31,"31001",80,63,63,0,0,"PACMA",1
33,"33062",388,250,245,9,5,"PACMA",1
3,"3002",3631,2841,2801,16,40,"PACMA",39
24,"24057",1306,1018,997,7,21,"PACMA",9
50,"50108",52,43,42,0,1,"PACMA",0
43,"43170",878,706,704,7,2,"PACMA",3
3,"3022",137,122,119,0,3,"PACMA",0
6,"6092",555,428,419,3,9,"PACMA",1
36,"36033",12244,9553,9358,80,195,"PACMA",100
44,"44256",34,32,32,1,0,"PACMA",0
31,"31246",128,105,101,3,4,"PACMA",2
29,"29066",346,266,266,2,0,"PACMA",3
43,"43039",105,85,85,0,0,"PACMA",0
18,"18133",2109,1632,1618,12,14,"PACMA",12
15,"15041",9581,7223,7082,96,141,"PACMA",64
46,"46025",2455,2002,1981,6,21,"PACMA",30
19,"19282",143,114,114,1,0,"PACMA",0
50,"50102",820,653,642,9,11,"PACMA",2
9,"9024",150,116,114,0,2,"PACMA",0
2,"2017",777,588,584,0,4,"PACMA",0
46,"46158",1040,805,796,4,9,"PACMA",6
50,"50258",53,33,33,3,0,"PACMA",0
19,"19314",45,38,38,1,0,"PACMA",0
24,"24037",337,234,234,1,0,"PACMA",0
4,"4057",1260,970,953,10,17,"PACMA",5
16,"16134",4383,3544,3491,34,53,"PACMA",23
45,"45030",478,368,364,3,4,"PACMA",0
18,"18029",1813,1183,1169,9,14,"PACMA",6
7,"7006",5332,3769,3722,25,47,"PACMA",33
45,"45123",3160,2434,2392,16,42,"PACMA",42
5,"5045",80,65,65,0,0,"PACMA",0
50,"50143",546,409,401,5,8,"PACMA",1
9,"9143",27,18,18,0,0,"PACMA",0
50,"50201",444,357,354,1,3,"PACMA",2
5,"5163",1705,1360,1345,4,15,"PACMA",4
6,"6106",413,267,263,3,4,"PACMA",0
12,"12092",126,108,106,1,2,"PACMA",0
2,"2067",1129,866,852,4,14,"PACMA",6
5,"5240",3323,2389,2346,16,43,"PACMA",20
19,"19036",248,213,210,1,3,"PACMA",0
47,"47215",48,44,44,0,0,"PACMA",0
22,"22107",100,68,67,0,1,"PACMA",2
1,"1061",152,129,129,2,0,"PACMA",2
45,"45079",349,272,272,1,0,"PACMA",0
22,"22163",419,363,361,1,2,"PACMA",5
6,"6040",987,747,739,6,8,"PACMA",6
31,"31209",147,116,116,0,0,"PACMA",1
10,"10070",669,516,513,1,3,"PACMA",2
29,"29036",611,448,444,3,4,"PACMA",1
6,"6008",613,540,532,0,8,"PACMA",0
22,"22054",1617,1196,1183,15,13,"PACMA",15
2,"2069",11414,9019,8883,54,136,"PACMA",41
50,"50057",1332,1001,986,10,15,"PACMA",3
45,"45033",298,224,221,1,3,"PACMA",0
44,"44005",46,31,31,1,0,"PACMA",0
40,"40097",125,96,95,1,1,"PACMA",0
42,"42118",21,13,13,1,0,"PACMA",0
12,"12052",539,453,439,5,14,"PACMA",0
12,"12001",1033,834,825,8,9,"PACMA",2
42,"42164",1589,1201,1172,10,29,"PACMA",4
10,"10031",164,136,135,0,1,"PACMA",0
40,"40168",28,22,22,0,0,"PACMA",0
15,"15076",2514,1709,1683,19,26,"PACMA",10
19,"19270",25,21,21,0,0,"PACMA",0
46,"46222",394,325,324,1,1,"PACMA",6
29,"29038",18683,12820,12666,168,154,"PACMA",240
42,"42165",419,288,285,8,3,"PACMA",0
19,"19321",34,29,29,0,0,"PACMA",0
31,"31130",322,237,235,7,2,"PACMA",0
50,"50058",63,54,53,2,1,"PACMA",0
5,"5167",225,181,175,1,6,"PACMA",0
7,"7043",3430,2465,2438,24,27,"PACMA",22
24,"24107",214,170,170,2,0,"PACMA",0
20,"20081",7655,5629,5601,22,28,"PACMA",27
50,"50233",104,82,82,0,0,"PACMA",1
25,"25226",242,184,183,4,1,"PACMA",1
3,"3111",5565,4183,4149,29,34,"PACMA",33
26,"26180",223,182,177,3,5,"PACMA",2
13,"13012",382,279,277,2,2,"PACMA",1
19,"19272",65,58,56,1,2,"PACMA",0
20,"20052",1070,833,827,2,6,"PACMA",2
32,"32043",2512,1805,1789,16,16,"PACMA",9
24,"24901",860,642,630,7,12,"PACMA",2
10,"10075",236,186,182,1,4,"PACMA",3
44,"44004",379,312,310,5,2,"PACMA",2
43,"43118",425,357,356,0,1,"PACMA",3
39,"39099",3149,2562,2540,22,22,"PACMA",16
50,"50059",754,599,589,6,10,"PACMA",0
31,"31133",35,28,28,0,0,"PACMA",0
26,"26143",242,190,189,0,1,"PACMA",2
50,"50078",231,173,171,0,2,"PACMA",1
40,"40205",229,185,180,1,5,"PACMA",0
37,"37219",165,101,97,2,4,"PACMA",0
22,"22141",114,86,85,0,1,"PACMA",0
19,"19042",21,19,18,1,1,"PACMA",0
23,"23099",4822,3687,3633,28,54,"PACMA",31
44,"44199",39,39,38,5,1,"PACMA",0
31,"31012",771,571,564,5,7,"PACMA",3
48,"48912",2331,1843,1833,7,10,"PACMA",16
45,"45086",493,373,368,0,5,"PACMA",9
47,"47092",102,86,85,0,1,"PACMA",0
42,"42213",25,16,16,0,0,"PACMA",0
16,"16145",425,362,357,8,5,"PACMA",5
25,"25196",112,94,93,0,1,"PACMA",0
50,"50061",193,173,169,1,4,"PACMA",2
26,"26105",2211,1744,1723,19,21,"PACMA",10
18,"18116",2853,2265,2233,15,32,"PACMA",13
31,"31216",3871,2861,2832,32,29,"PACMA",31
12,"12089",4546,3353,3304,12,49,"PACMA",43
23,"23035",1103,903,882,6,21,"PACMA",11
24,"24060",574,371,369,1,2,"PACMA",2
16,"16091",64,46,46,1,0,"PACMA",0
28,"28163",429,361,345,4,16,"PACMA",10
39,"39101",236,173,171,1,2,"PACMA",0
45,"45180",2834,2269,2239,11,30,"PACMA",22
23,"23002",17399,13575,13341,97,234,"PACMA",109
9,"9104",47,39,39,0,0,"PACMA",0
22,"22143",197,134,132,1,2,"PACMA",0
4,"4041",330,248,247,1,1,"PACMA",1
5,"5172",116,95,93,0,2,"PACMA",1
9,"9432",174,145,137,0,8,"PACMA",1
40,"40208",720,592,585,4,7,"PACMA",1
18,"18061",1000,827,822,1,5,"PACMA",2
31,"31051",234,183,182,2,1,"PACMA",1
5,"5251",56,39,39,0,0,"PACMA",0
13,"13033",1560,1278,1262,9,16,"PACMA",3
47,"47105",175,152,149,1,3,"PACMA",1
37,"37001",172,133,133,0,0,"PACMA",0
46,"46197",1926,1473,1455,9,18,"PACMA",33
5,"5095",236,193,191,0,2,"PACMA",2
29,"29100",2378,1711,1686,22,25,"PACMA",10
19,"19099",289,217,214,0,3,"PACMA",4
24,"24034",3457,2627,2588,31,39,"PACMA",36
4,"4080",199,158,157,0,1,"PACMA",1
26,"26148",150,128,124,1,4,"PACMA",0
5,"5015",68,48,48,1,0,"PACMA",0
2,"2078",899,705,691,3,14,"PACMA",10
46,"46167",345,255,255,0,0,"PACMA",3
25,"25201",110,89,89,0,0,"PACMA",1
28,"28134",63352,51185,50776,336,409,"PACMA",712
46,"46036",558,391,379,2,12,"PACMA",1
50,"50285",650,466,462,7,4,"PACMA",9
43,"43171",14705,11002,10956,62,46,"PACMA",222
31,"31112",93,71,70,0,1,"PACMA",0
9,"9251",365,278,277,0,1,"PACMA",4
22,"22195",234,193,192,0,1,"PACMA",3
46,"46168",1982,1543,1522,5,21,"PACMA",15
2,"2043",1173,975,962,1,13,"PACMA",2
9,"9058",395,325,317,1,8,"PACMA",6
16,"16023",507,401,398,2,3,"PACMA",2
14,"14007",15042,10970,10758,86,212,"PACMA",83
18,"18039",3382,2517,2490,20,27,"PACMA",20
39,"39020",23931,17782,17566,126,216,"PACMA",238
37,"37251",107,79,79,1,0,"PACMA",1
26,"26110",150,128,124,1,4,"PACMA",0
28,"28167",8608,7086,7015,48,71,"PACMA",126
28,"28168",1329,976,969,3,7,"PACMA",17
2,"2007",1013,820,813,6,7,"PACMA",3
29,"29013",1602,1262,1238,12,24,"PACMA",12
12,"12129",1801,1382,1356,17,26,"PACMA",5
44,"44205",634,444,426,9,18,"PACMA",1
47,"47066",1407,1131,1122,11,9,"PACMA",13
24,"24117",412,336,335,0,1,"PACMA",0
9,"9112",104,76,76,1,0,"PACMA",2
12,"12009",17859,13054,12911,98,143,"PACMA",159
20,"20059",8867,6792,6759,21,33,"PACMA",21
5,"5018",24,18,17,0,1,"PACMA",0
32,"32050",2280,1788,1775,19,13,"PACMA",6
41,"41035",1060,803,788,8,15,"PACMA",0
16,"16152",32,28,28,1,0,"PACMA",0
46,"46170",3408,2769,2720,16,49,"PACMA",18
7,"7053",1164,956,948,4,8,"PACMA",13
22,"22029",119,103,103,0,0,"PACMA",0
47,"47226",149,124,123,0,1,"PACMA",0
25,"25103",136,103,102,2,1,"PACMA",0
19,"19197",27,22,22,0,0,"PACMA",0
47,"47099",155,135,133,0,2,"PACMA",2
44,"44044",83,65,64,2,1,"PACMA",0
18,"18077",471,372,366,5,6,"PACMA",0
14,"14040",3755,3047,3006,21,41,"PACMA",20
9,"9170",209,164,159,0,5,"PACMA",0
4,"4085",371,305,303,2,2,"PACMA",0
13,"13025",296,260,256,1,4,"PACMA",0
9,"9115",91,71,66,2,5,"PACMA",0
1,"1034",150,111,111,2,0,"PACMA",0
29,"29071",979,718,712,14,6,"PACMA",11
12,"12132",484,415,412,4,3,"PACMA",0
50,"50156",209,174,171,1,3,"PACMA",1
36,"36049",7019,5414,5283,48,131,"PACMA",61
46,"46050",186,157,154,1,3,"PACMA",1
24,"24120",311,209,209,0,0,"PACMA",0
49,"49007",365,271,265,7,6,"PACMA",0
29,"29016",263,217,217,0,0,"PACMA",0
43,"43150",1238,1034,1026,6,8,"PACMA",6
43,"43101",145,122,122,1,0,"PACMA",0
29,"29050",398,274,269,2,5,"PACMA",2
14,"14011",572,498,495,5,3,"PACMA",0
43,"43126",1211,1005,999,4,6,"PACMA",12
15,"15025",1000,639,631,6,8,"PACMA",4
20,"20001",257,174,172,1,2,"PACMA",0
44,"44017",272,221,219,0,2,"PACMA",0
2,"2084",305,221,215,1,6,"PACMA",0
25,"25009",605,505,491,5,14,"PACMA",3
1,"1037",585,426,425,1,1,"PACMA",4
19,"19200",64,56,56,0,0,"PACMA",2
47,"47196",28,24,24,0,0,"PACMA",0
18,"18044",164,113,112,0,1,"PACMA",1
40,"40007",68,58,58,0,0,"PACMA",0
45,"45054",3831,2980,2944,11,36,"PACMA",11
44,"44116",76,62,62,0,0,"PACMA",0
47,"47070",30,26,25,0,1,"PACMA",0
47,"47166",251,196,189,3,7,"PACMA",2
46,"46133",472,374,374,2,0,"PACMA",3
43,"43004",6274,4744,4691,39,53,"PACMA",27
3,"3059",20590,15909,15766,96,143,"PACMA",193
20,"20033",854,675,671,5,4,"PACMA",4
1,"1041",152,107,103,2,4,"PACMA",3
9,"9395",122,95,94,0,1,"PACMA",2
26,"26157",282,233,232,1,1,"PACMA",1
48,"48028",691,576,573,1,3,"PACMA",2
28,"28173",519,417,412,4,5,"PACMA",3
42,"42048",60,50,50,0,0,"PACMA",0
41,"41067",7227,5367,5271,56,96,"PACMA",63
46,"46174",949,789,770,4,19,"PACMA",7
44,"44019",68,42,42,0,0,"PACMA",0
31,"31148",92,67,65,4,2,"PACMA",2
2,"2002",435,358,352,2,6,"PACMA",0
24,"24154",955,702,691,3,11,"PACMA",0
50,"50179",264,231,228,0,3,"PACMA",0
14,"14014",2509,2071,2030,7,41,"PACMA",9
25,"25164",357,264,261,4,3,"PACMA",2
22,"22142",94,80,80,2,0,"PACMA",0
10,"10010",2213,1499,1470,6,29,"PACMA",6
25,"25141",152,118,118,1,0,"PACMA",2
27,"27012",1276,776,768,9,8,"PACMA",0
43,"43054",2792,2145,2134,21,11,"PACMA",17
3,"3061",1054,830,816,3,14,"PACMA",10
49,"49093",280,239,238,2,1,"PACMA",0
43,"43128",905,751,747,4,4,"PACMA",12
1,"1043",2337,1669,1656,18,13,"PACMA",11
37,"37147",172,130,127,3,3,"PACMA",0
15,"15029",5403,3682,3622,62,60,"PACMA",20
5,"5067",74,61,60,0,1,"PACMA",0
10,"10052",166,124,123,0,1,"PACMA",2
6,"6026",815,661,653,5,8,"PACMA",0
25,"25909",140,108,107,2,1,"PACMA",0
13,"13018",766,644,634,0,10,"PACMA",2
49,"49200",936,744,726,10,18,"PACMA",2
19,"19208",41,34,34,0,0,"PACMA",0
29,"29054",42393,30327,30108,218,219,"PACMA",538
28,"28007",126831,103108,102202,710,906,"PACMA",1401
50,"50132",771,589,576,2,13,"PACMA",11
12,"12080",1900,1604,1575,10,29,"PACMA",7
25,"25112",268,214,212,2,2,"PACMA",0
24,"24127",268,204,201,3,3,"PACMA",1
19,"19209",41,35,34,0,1,"PACMA",0
19,"19163",60,46,44,0,2,"PACMA",2
42,"42189",53,44,42,0,2,"PACMA",1
31,"31152",1270,937,929,19,8,"PACMA",3
9,"9127",52,45,45,1,0,"PACMA",2
38,"38024",15310,10234,10088,82,146,"PACMA",191
18,"18120",257,219,217,1,2,"PACMA",4
22,"22052",885,708,702,6,6,"PACMA",3
2,"2006",561,482,480,2,2,"PACMA",1
31,"31234",149,115,114,0,1,"PACMA",0
46,"46087",109,98,98,1,0,"PACMA",1
37,"37027",235,188,184,2,4,"PACMA",1
9,"9450",25,17,17,0,0,"PACMA",0
30,"30038",15674,11755,11675,59,80,"PACMA",138
40,"40223",228,181,181,0,0,"PACMA",2
37,"37150",36,31,31,0,0,"PACMA",0
32,"32002",2022,1510,1485,8,25,"PACMA",16
16,"16038",28,21,21,0,0,"PACMA",0
10,"10055",696,527,512,1,15,"PACMA",4
27,"27015",4020,2809,2730,33,79,"PACMA",11
43,"43033",768,609,607,3,2,"PACMA",7
5,"5072",94,86,85,1,1,"PACMA",0
49,"49016",229,189,187,2,2,"PACMA",1
3,"3004",599,465,458,4,7,"PACMA",2
20,"20008",704,455,449,6,6,"PACMA",1
3,"3065",169399,128218,127256,967,962,"PACMA",1771
28,"28147",990,779,769,2,10,"PACMA",12
6,"6062",576,435,430,0,5,"PACMA",0
6,"6029",1183,946,935,12,11,"PACMA",3
5,"5073",289,239,238,0,1,"PACMA",1
9,"9130",66,55,52,0,3,"PACMA",0
43,"43902",2743,1996,1980,16,16,"PACMA",4
49,"49017",259,196,195,0,1,"PACMA",1
3,"3005",7903,6247,6195,37,52,"PACMA",85
16,"16165",55,49,48,1,1,"PACMA",1
44,"44024",28,25,24,0,1,"PACMA",0
3,"3097",996,833,816,4,17,"PACMA",1
6,"6129",573,455,451,2,4,"PACMA",0
10,"10099",559,412,401,3,11,"PACMA",1
47,"47173",885,708,704,7,4,"PACMA",5
1,"1004",1356,1007,998,3,9,"PACMA",3
46,"46120",1183,958,936,3,22,"PACMA",5
49,"49177",260,165,162,2,3,"PACMA",1
9,"9353",76,64,63,2,1,"PACMA",0
43,"43133",5605,4202,4168,21,34,"PACMA",44
37,"37378",99,69,67,2,2,"PACMA",0
26,"26167",50,38,38,1,0,"PACMA",0
42,"42100",31,27,27,0,0,"PACMA",0
50,"50166",236,200,198,1,2,"PACMA",0
19,"19170",189,116,116,0,0,"PACMA",0
20,"20010",1528,1156,1151,5,5,"PACMA",8
47,"47174",270,215,208,2,7,"PACMA",5
40,"40016",54,43,43,1,0,"PACMA",0
26,"26050",130,97,97,0,0,"PACMA",2
24,"24134",3294,2540,2479,25,61,"PACMA",12
31,"31036",895,665,659,8,6,"PACMA",2
29,"29083",2062,1607,1574,9,33,"PACMA",6
43,"43109",2704,1937,1922,16,15,"PACMA",51
28,"28043",6166,4404,4320,30,84,"PACMA",51
47,"47208",56,37,37,0,0,"PACMA",0
5,"5116",96,77,75,0,2,"PACMA",0
42,"42195",92,53,53,1,0,"PACMA",0
39,"39005",1406,1127,1110,12,17,"PACMA",18
19,"19021",976,744,724,5,20,"PACMA",8
37,"37344",235,171,168,1,3,"PACMA",0
6,"6903",2027,1607,1594,16,13,"PACMA",12
18,"18124",359,269,267,0,2,"PACMA",2
4,"4063",1063,847,835,5,12,"PACMA",3
25,"25218",86,79,79,0,0,"PACMA",0
32,"32090",738,530,525,3,5,"PACMA",0
43,"43110",251,184,184,1,0,"PACMA",1
29,"29085",138,100,98,0,2,"PACMA",1
50,"50168",27,20,20,0,0,"PACMA",0
6,"6132",829,598,593,0,5,"PACMA",3
2,"2060",1280,1039,1020,5,19,"PACMA",7
6,"6034",167,115,115,1,0,"PACMA",0
6,"6100",852,681,677,3,4,"PACMA",1
9,"9120",38,32,31,2,1,"PACMA",0
37,"37309",37,27,27,0,0,"PACMA",0
24,"24177",472,330,326,3,4,"PACMA",3
24,"24058",195,127,125,1,2,"PACMA",0
30,"30014",1585,1226,1202,3,24,"PACMA",23
4,"4101",4375,3161,3112,34,49,"PACMA",31
16,"16005",232,175,172,0,3,"PACMA",0
44,"44220",113,92,89,0,3,"PACMA",0
16,"16171",1749,1449,1422,6,27,"PACMA",1
50,"50079",227,182,178,1,4,"PACMA",1
31,"31039",92,72,70,1,2,"PACMA",0
40,"40019",29,26,26,0,0,"PACMA",0
19,"19076",19,18,18,0,0,"PACMA",0
40,"40089",214,176,170,1,6,"PACMA",1
37,"37371",258,176,175,0,1,"PACMA",0
12,"12046",182,161,161,1,0,"PACMA",2
47,"47158",858,672,663,8,9,"PACMA",1
20,"20075",4346,3158,3134,19,24,"PACMA",10
6,"6058",1980,1519,1493,13,26,"PACMA",8
22,"22160",212,171,170,3,1,"PACMA",1
6,"6135",1096,915,902,3,13,"PACMA",5
23,"23091",679,575,571,3,4,"PACMA",0
24,"24020",434,302,299,1,3,"PACMA",2
10,"10105",2476,1798,1760,21,38,"PACMA",7
26,"26172",25,23,23,0,0,"PACMA",2
49,"49024",637,465,461,2,4,"PACMA",0
29,"29087",371,266,263,2,3,"PACMA",1
34,"34023",5098,4016,3973,48,43,"PACMA",24
24,"24223",2540,1971,1929,37,42,"PACMA",5
1,"1057",243,202,199,0,3,"PACMA",3
4,"4067",520,387,379,1,8,"PACMA",1
10,"10094",228,180,180,0,0,"PACMA",0
19,"19309",21,18,17,0,1,"PACMA",0
40,"40119",166,133,132,1,1,"PACMA",0
2,"2052",466,394,394,3,0,"PACMA",4
49,"49013",229,176,175,4,1,"PACMA",1
22,"22220",150,120,117,0,3,"PACMA",0
43,"43113",397,325,323,2,2,"PACMA",1
16,"16008",83,65,65,0,0,"PACMA",0
16,"16048",409,331,330,1,1,"PACMA",2
6,"6136",1510,1189,1160,7,29,"PACMA",5
19,"19222",96,73,72,2,1,"PACMA",0
37,"37161",121,88,88,0,0,"PACMA",0
40,"40199",101,79,78,0,1,"PACMA",0
24,"24022",306,227,224,1,3,"PACMA",2
37,"37162",209,156,153,1,3,"PACMA",0
50,"50172",178,134,131,3,3,"PACMA",0
22,"22177",97,81,81,1,0,"PACMA",1
44,"44120",219,158,152,1,6,"PACMA",1
48,"48073",6837,4950,4921,33,29,"PACMA",20
41,"41097",3135,2355,2308,11,47,"PACMA",7
19,"19298",55,47,47,0,0,"PACMA",0
42,"42148",9,9,9,0,0,"PACMA",0
13,"13005",23187,18379,18119,174,260,"PACMA",158
3,"3105",5471,4099,4003,14,96,"PACMA",39
1,"1059",189037,133121,131768,792,1353,"PACMA",1473
45,"45076",564,389,388,2,1,"PACMA",2
5,"5084",69,46,46,0,0,"PACMA",0
9,"9419",67,53,52,0,1,"PACMA",0
44,"44224",21,15,15,0,0,"PACMA",0
50,"50083",84,70,68,0,2,"PACMA",0
24,"24103",264,162,161,1,1,"PACMA",0
48,"48012",2071,1685,1674,7,11,"PACMA",11
13,"13006",572,437,430,5,7,"PACMA",1
46,"46261",1709,1367,1340,14,27,"PACMA",14
39,"39011",1575,1249,1242,3,7,"PACMA",10
31,"31167",831,651,636,3,15,"PACMA",3
31,"31249",1823,1381,1373,21,8,"PACMA",4
32,"32012",716,497,487,7,10,"PACMA",1
42,"42028",76,65,65,1,0,"PACMA",0
26,"26177",301,250,246,2,4,"PACMA",1
50,"50259",84,58,58,0,0,"PACMA",0
18,"18908",784,599,581,0,18,"PACMA",2
38,"38006",41302,23632,23415,133,217,"PACMA",450
49,"49029",614,497,488,9,9,"PACMA",1
19,"19318",23,18,18,0,0,"PACMA",0
46,"46099",772,620,614,1,6,"PACMA",7
33,"33005",1376,929,916,14,13,"PACMA",4
18,"18170",324,225,224,1,1,"PACMA",1
46,"46160",1907,1508,1485,5,23,"PACMA",17
9,"9148",79,63,63,5,0,"PACMA",1
29,"29093",2164,1704,1678,4,26,"PACMA",7
45,"45080",3,3,3,0,0,"PACMA",0
49,"49151",593,453,444,5,9,"PACMA",1
16,"16903",996,816,806,9,10,"PACMA",2
24,"24105",1498,1188,1177,18,11,"PACMA",13
3,"3140",26027,19805,19438,230,367,"PACMA",249
3,"3046",1619,1213,1190,17,23,"PACMA",34
28,"28021",576,387,386,3,1,"PACMA",6
9,"9424",34,24,24,0,0,"PACMA",0
24,"24149",146,123,123,0,0,"PACMA",0
45,"45035",293,228,223,1,5,"PACMA",7
40,"40904",341,302,300,4,2,"PACMA",2
50,"50085",183,136,136,1,0,"PACMA",0
37,"37044",450,342,335,6,7,"PACMA",1
37,"37166",199,146,144,0,2,"PACMA",0
9,"9151",445,358,354,3,4,"PACMA",2
13,"13010",881,680,666,4,14,"PACMA",3
29,"29094",59350,42199,41749,419,450,"PACMA",814
5,"5088",29,23,23,0,0,"PACMA",0
28,"28094",959,736,729,6,7,"PACMA",18
40,"40135",269,224,221,1,3,"PACMA",0
15,"15045",3629,2263,2237,9,26,"PACMA",7
47,"47090",2435,1956,1921,12,35,"PACMA",11
33,"33068",1047,624,620,8,4,"PACMA",3
9,"9100",58,46,46,0,0,"PACMA",0
43,"43044",3949,3060,3032,31,28,"PACMA",24
10,"10156",100,78,78,0,0,"PACMA",0
42,"42032",142,120,120,0,0,"PACMA",0
49,"49032",287,224,222,0,2,"PACMA",0
42,"42211",81,74,73,2,1,"PACMA",2
32,"32015",830,543,541,4,2,"PACMA",3
19,"19092",395,317,309,1,8,"PACMA",0
16,"16187",55,43,43,0,0,"PACMA",0
50,"50118",2110,1622,1605,19,17,"PACMA",7
12,"12034",1400,1108,1080,7,28,"PACMA",10
9,"9428",103,86,86,0,0,"PACMA",0
37,"37357",258,0,0,0,0,"PACMA",0
12,"12124",1840,1477,1460,8,17,"PACMA",9
29,"29040",1936,1419,1395,7,24,"PACMA",17
18,"18175",11786,8883,8730,58,153,"PACMA",75
20,"20022",854,621,621,7,0,"PACMA",3
37,"37282",194,148,146,1,2,"PACMA",1
10,"10117",243,156,154,1,2,"PACMA",0
22,"22059",1139,867,855,10,12,"PACMA",12
3,"3112",637,526,520,0,6,"PACMA",2
9,"9159",61,52,51,0,1,"PACMA",0
44,"44038",98,83,80,0,3,"PACMA",1
23,"23034",2490,2033,1999,15,34,"PACMA",4
19,"19188",43,34,33,0,1,"PACMA",0
34,"34127",80,64,64,1,0,"PACMA",0
5,"5131",95,72,71,0,1,"PACMA",1
11,"11014",17141,11836,11705,214,131,"PACMA",155
25,"25228",3115,2468,2459,19,9,"PACMA",16
4,"4077",302,275,275,1,0,"PACMA",0
44,"44230",152,112,111,1,1,"PACMA",1
9,"9054",89,69,68,1,1,"PACMA",0
44,"44070",55,45,45,0,0,"PACMA",0
37,"37092",1889,1459,1447,16,12,"PACMA",15
37,"37195",37,29,29,1,0,"PACMA",0
18,"18904",743,555,545,1,10,"PACMA",4
37,"37050",67,54,54,0,0,"PACMA",0
39,"39045",351,280,277,1,3,"PACMA",0
29,"29009",1441,1097,1073,8,24,"PACMA",7
31,"31054",454,322,318,4,4,"PACMA",1
47,"47189",151,126,123,0,3,"PACMA",1
34,"34038",268,198,197,0,1,"PACMA",1
4,"4079",54086,38415,38134,239,281,"PACMA",514
43,"43145",4209,3409,3391,9,18,"PACMA",37
38,"38012",2310,1705,1687,6,18,"PACMA",17
42,"42172",28,25,25,1,0,"PACMA",0
10,"10079",858,694,684,1,10,"PACMA",1
46,"46186",19529,15294,15125,69,169,"PACMA",219
27,"27064",1503,1078,1039,12,39,"PACMA",16
42,"42037",29,19,18,0,1,"PACMA",0
20,"20905",153,124,124,1,0,"PACMA",0
49,"49037",177,146,143,1,3,"PACMA",3
37,"37051",80,59,58,0,1,"PACMA",0
40,"40176",375,325,322,6,3,"PACMA",1
16,"16246",452,348,340,1,8,"PACMA",1
2,"2040",563,516,513,3,3,"PACMA",2
37,"37097",44,29,29,0,0,"PACMA",0
5,"5014",5291,4096,4044,29,52,"PACMA",45
45,"45090",368,287,286,1,1,"PACMA",0
44,"44041",58,48,44,1,4,"PACMA",1
1,"1030",143,118,117,1,1,"PACMA",0
6,"6048",824,714,702,2,12,"PACMA",0
32,"32019",11512,8281,8161,96,120,"PACMA",66
34,"34039",62,49,49,0,0,"PACMA",1
33,"33073",8186,5090,5023,65,67,"PACMA",15
44,"44268",32,30,30,0,0,"PACMA",0
33,"33063",374,284,283,3,1,"PACMA",1
4,"4030",1066,783,776,5,7,"PACMA",10
15,"15042",2955,2057,2002,16,55,"PACMA",16
29,"29067",430670,312817,309994,2768,2823,"PACMA",6649
49,"49002",58,49,43,0,6,"PACMA",0
28,"28102",891,681,666,4,15,"PACMA",8
49,"49122",778,586,573,6,13,"PACMA",4
40,"40211",69,58,58,1,0,"PACMA",0
34,"34181",422,324,321,3,3,"PACMA",4
47,"47191",115,85,84,0,1,"PACMA",0
4,"4082",277,198,196,1,2,"PACMA",1
47,"47097",307,258,256,4,2,"PACMA",0
22,"22064",162,121,121,0,0,"PACMA",2
9,"9011",73,50,49,0,1,"PACMA",1
26,"26150",100,83,83,0,0,"PACMA",0
46,"46169",32294,24909,24676,157,233,"PACMA",404
19,"19049",9,8,8,0,0,"PACMA",0
19,"19332",85,70,70,1,0,"PACMA",1
41,"41090",3507,2766,2694,15,72,"PACMA",12
4,"4083",1740,1342,1326,4,16,"PACMA",9
49,"49040",112,97,97,0,0,"PACMA",0
40,"40144",18,16,16,0,0,"PACMA",0
43,"43001",694,543,543,5,0,"PACMA",5
50,"50183",319,242,241,4,1,"PACMA",1
3,"3025",1292,1009,991,7,18,"PACMA",11
19,"19152",550,413,405,3,8,"PACMA",1
24,"24039",1954,1563,1552,28,11,"PACMA",6
37,"37017",222,177,177,1,0,"PACMA",1
16,"16066",2298,1932,1885,17,47,"PACMA",17
22,"22066",748,576,567,6,9,"PACMA",5
16,"16196",602,522,510,3,12,"PACMA",3
26,"26152",27,23,23,1,0,"PACMA",0
2,"2008",1123,857,842,9,15,"PACMA",0
49,"49042",230,179,174,1,5,"PACMA",0
25,"25038",1482,1111,1094,11,17,"PACMA",5
43,"43124",472,379,373,1,6,"PACMA",3
11,"11022",48682,28113,27794,294,319,"PACMA",676
31,"31102",136,75,75,2,0,"PACMA",0
33,"33016",18904,14376,14235,168,141,"PACMA",148
16,"16197",66,45,45,0,0,"PACMA",0
19,"19004",59,52,52,0,0,"PACMA",0
16,"16198",1299,1044,1027,11,17,"PACMA",5
10,"10004",690,529,517,8,12,"PACMA",1
45,"45096",987,829,813,3,16,"PACMA",3
49,"49165",55,53,50,0,3,"PACMA",0
15,"15055",4485,3097,3057,39,40,"PACMA",44
22,"22068",65,46,44,1,2,"PACMA",1
22,"22035",226,174,174,0,0,"PACMA",1
26,"26114",74,62,60,0,2,"PACMA",0
13,"13026",415,342,340,1,2,"PACMA",0
25,"25239",595,367,366,3,1,"PACMA",3
9,"9063",214,185,184,0,1,"PACMA",2
9,"9017",90,72,70,2,2,"PACMA",0
25,"25206",250,189,188,2,1,"PACMA",1
37,"37179",196,172,169,0,3,"PACMA",0
16,"16199",28,23,23,1,0,"PACMA",0
46,"46020",3792,3028,2973,11,55,"PACMA",25
38,"38019",13758,8870,8776,46,94,"PACMA",79
37,"37292",94,76,73,1,3,"PACMA",0
9,"9173",129,102,102,0,0,"PACMA",0
25,"25240",1385,1116,1110,10,6,"PACMA",5
15,"15057",12051,8814,8660,89,154,"PACMA",92
31,"31186",288,220,216,1,4,"PACMA",3
28,"28003",170,148,148,1,0,"PACMA",2
13,"13073",497,394,390,1,4,"PACMA",0
16,"16071",20,18,18,0,0,"PACMA",0
9,"9174",781,625,608,3,17,"PACMA",2
25,"25242",689,539,531,0,8,"PACMA",3
24,"24043",122,71,69,0,2,"PACMA",0
2,"2012",1825,1541,1509,8,32,"PACMA",5
31,"31187",101,68,68,1,0,"PACMA",0
38,"38020",15899,11057,10924,90,133,"PACMA",160
21,"21043",1857,1465,1424,7,41,"PACMA",10
18,"18184",2170,1688,1656,3,32,"PACMA",21
5,"5024",198,142,139,2,3,"PACMA",0
49,"49129",821,628,616,5,12,"PACMA",1
29,"29074",781,606,597,2,9,"PACMA",6
19,"19246",42,30,30,0,0,"PACMA",0
34,"34192",82,68,68,0,0,"PACMA",0
19,"19111",162,142,142,0,0,"PACMA",1
5,"5221",323,249,244,1,5,"PACMA",0
9,"9176",59,50,47,2,3,"PACMA",1
49,"49169",34,28,26,0,2,"PACMA",0
28,"28035",1394,1057,1043,3,14,"PACMA",13
12,"12078",333,238,235,1,3,"PACMA",2
10,"10131",12808,9377,9254,67,123,"PACMA",68
12,"12068",41,26,25,1,1,"PACMA",0
21,"21032",1801,1401,1378,8,23,"PACMA",5
46,"46195",1982,1562,1554,2,8,"PACMA",26
25,"25042",208,160,160,1,0,"PACMA",0
4,"4090",312,253,249,0,4,"PACMA",0
46,"46206",557,461,455,6,6,"PACMA",5
13,"13031",2471,2044,2020,15,24,"PACMA",18
29,"29020",3280,2531,2485,23,46,"PACMA",28
37,"37372",134,104,104,0,0,"PACMA",0
31,"31907",11205,9216,9140,121,76,"PACMA",96
49,"49050",504,351,351,3,0,"PACMA",1
15,"15060",5843,4360,4281,65,79,"PACMA",39
31,"31149",2271,1645,1628,9,17,"PACMA",1
50,"50100",306,238,235,3,3,"PACMA",0
18,"18083",228,189,188,1,1,"PACMA",0
19,"19060",157,128,125,0,3,"PACMA",2
45,"45196",1387,1099,1084,6,15,"PACMA",5
46,"46237",7148,5537,5472,36,65,"PACMA",87
6,"6125",1679,1348,1324,5,24,"PACMA",4
31,"31069",830,639,638,3,1,"PACMA",3
24,"24168",439,365,360,3,5,"PACMA",1
45,"45059",1696,1442,1415,4,27,"PACMA",10
44,"44050",3115,2333,2299,27,34,"PACMA",7
40,"40221",48,42,42,0,0,"PACMA",0
41,"41041",9760,7835,7646,44,189,"PACMA",61
36,"36024",16395,12372,12165,102,207,"PACMA",100
26,"26081",15,14,14,1,0,"PACMA",0
47,"47013",90,80,78,4,2,"PACMA",0
37,"37186",96,79,79,0,0,"PACMA",0
3,"3127",351,290,277,2,13,"PACMA",2
20,"20036",13192,9864,9806,67,58,"PACMA",70
37,"37299",229,175,168,0,7,"PACMA",0
42,"42190",92,74,73,1,1,"PACMA",0
49,"49039",327,255,246,6,9,"PACMA",1
23,"23049",1747,1321,1305,11,16,"PACMA",4
49,"49054",849,641,629,5,12,"PACMA",4
1,"1001",2005,1438,1419,4,19,"PACMA",18
30,"30008",14450,10832,10675,60,157,"PACMA",135
46,"46117",500,407,399,1,8,"PACMA",5
24,"24170",1839,1417,1391,7,26,"PACMA",8
10,"10014",1829,1448,1419,12,29,"PACMA",6
29,"29023",2290,1569,1550,3,19,"PACMA",33
6,"6160",3019,2252,2209,10,43,"PACMA",10
37,"37069",971,721,704,2,17,"PACMA",6
47,"47204",235,182,178,0,4,"PACMA",1
29,"29080",6895,5005,4934,59,71,"PACMA",89
19,"19299",102,78,78,1,0,"PACMA",0
41,"41071",5598,3993,3915,34,78,"PACMA",26
2,"2019",2368,2009,1975,5,34,"PACMA",7
46,"46209",1901,1517,1500,5,17,"PACMA",19
13,"13037",790,633,620,3,13,"PACMA",2
32,"32030",944,690,685,7,5,"PACMA",1
37,"37376",2164,1606,1581,15,25,"PACMA",2
34,"34152",125,104,101,0,3,"PACMA",0
4,"4059",1025,742,731,3,11,"PACMA",4
3,"3035",632,529,525,2,4,"PACMA",2
18,"18193",14802,11165,10973,110,192,"PACMA",175
6,"6162",2895,2289,2254,11,35,"PACMA",7
15,"15033",2422,1887,1866,13,21,"PACMA",11
16,"16213",34,29,28,0,1,"PACMA",0
47,"47110",438,352,347,4,5,"PACMA",1
11,"11032",54469,33144,32810,461,334,"PACMA",401
13,"13038",1604,1251,1216,14,35,"PACMA",5
24,"24053",406,279,276,6,3,"PACMA",0
29,"29025",41515,29572,29311,221,261,"PACMA",647
38,"38027",5545,3937,3896,22,41,"PACMA",57
50,"50105",279,216,213,4,3,"PACMA",1
37,"37152",402,308,302,1,6,"PACMA",3
46,"46241",389,318,313,4,5,"PACMA",3
5,"5902",293,246,242,1,4,"PACMA",2
46,"46180",651,525,519,0,6,"PACMA",10
22,"22080",264,208,202,2,6,"PACMA",2
23,"23052",1108,949,931,8,18,"PACMA",3
6,"6064",850,658,647,2,11,"PACMA",1
45,"45111",53,43,41,0,2,"PACMA",1
37,"37117",1553,1245,1230,14,15,"PACMA",17
42,"42194",146,111,111,0,0,"PACMA",0
40,"40158",15,13,13,1,0,"PACMA",0
24,"24054",417,318,311,0,7,"PACMA",1
20,"20040",15753,11440,11364,69,76,"PACMA",87
25,"25250",330,261,258,1,3,"PACMA",1
22,"22081",243,187,186,0,1,"PACMA",0
34,"34061",96,77,77,2,0,"PACMA",0
49,"49178",747,574,564,4,10,"PACMA",7
37,"37155",68,52,52,0,0,"PACMA",0
37,"37380",56,46,45,1,1,"PACMA",0
5,"5155",46,36,36,0,0,"PACMA",0
26,"26128",96,74,74,1,0,"PACMA",3
41,"41091",539730,412509,408312,3804,4197,"PACMA",5985
9,"9355",87,69,67,1,2,"PACMA",0
34,"34211",175,160,160,0,0,"PACMA",0
31,"31199",141,96,94,0,2,"PACMA",0
18,"18022",13804,9877,9714,92,163,"PACMA",136
9,"9134",220,155,151,1,4,"PACMA",3
36,"36029",16086,12196,12005,126,191,"PACMA",141
46,"46213",15504,11420,11232,124,188,"PACMA",123
40,"40159",132,101,101,0,0,"PACMA",0
9,"9135",40,34,34,0,0,"PACMA",1
9,"9191",33,24,24,0,0,"PACMA",0
22,"22214",118,98,97,1,1,"PACMA",0
6,"6066",1725,1297,1286,9,11,"PACMA",3
10,"10102",503,407,403,3,4,"PACMA",2
39,"39034",257,167,162,2,5,"PACMA",0
44,"44125",65,50,50,0,0,"PACMA",0
50,"50298",5427,4373,4323,30,50,"PACMA",38
16,"16088",101,85,85,1,0,"PACMA",0
49,"49062",105,69,69,1,0,"PACMA",0
14,"14053",5925,4442,4348,75,94,"PACMA",41
37,"37077",252,216,213,2,3,"PACMA",0
18,"18057",5540,4306,4246,30,60,"PACMA",54
50,"50169",336,261,259,2,2,"PACMA",1
18,"18903",851,644,636,1,8,"PACMA",1
2,"2025",7355,5864,5693,30,171,"PACMA",106
11,"11038",13613,10879,10676,101,203,"PACMA",124
3,"3040",258,223,217,1,6,"PACMA",0
46,"46215",1397,1104,1093,12,11,"PACMA",8
50,"50022",504,396,386,11,10,"PACMA",2
49,"49143",194,141,135,2,6,"PACMA",0
48,"48039",256,218,217,1,1,"PACMA",1
29,"29063",303,243,239,1,4,"PACMA",1
37,"37259",36,29,29,0,0,"PACMA",0
7,"7058",2857,2258,2233,18,25,"PACMA",35
16,"16033",1644,1345,1320,11,25,"PACMA",14
24,"24099",155,121,121,1,0,"PACMA",0
9,"9037",106,97,97,0,0,"PACMA",3
18,"18059",4253,3166,3123,22,43,"PACMA",43
50,"50110",336,268,266,1,2,"PACMA",0
39,"39064",1341,1103,1094,5,9,"PACMA",8
3,"3041",6093,4444,4398,13,46,"PACMA",35
5,"5120",32,25,25,1,0,"PACMA",0
13,"13047",5780,4553,4461,32,92,"PACMA",34
45,"45119",3485,2478,2430,21,48,"PACMA",46
30,"30015",19372,14430,14283,91,147,"PACMA",111
15,"15071",7805,5476,5401,62,75,"PACMA",50
41,"41095",39970,27911,27583,389,328,"PACMA",368
22,"22218",40,32,31,1,1,"PACMA",0
26,"26173",6,6,6,0,0,"PACMA",0
5,"5121",262,201,199,0,2,"PACMA",3
18,"18096",344,265,265,2,0,"PACMA",0
2,"2028",118,99,98,4,1,"PACMA",0
6,"6103",4753,3656,3598,35,58,"PACMA",30
38,"38003",1510,1058,1047,4,11,"PACMA",7
31,"31164",545,438,433,6,5,"PACMA",1
46,"46217",893,733,723,6,10,"PACMA",9
31,"31205",420,312,310,7,2,"PACMA",2
4,"4901",494,381,378,0,3,"PACMA",2
5,"5122",119,90,88,1,2,"PACMA",0
3,"3136",410,329,323,3,6,"PACMA",1
46,"46096",257,220,217,0,3,"PACMA",6
21,"21023",2051,1356,1332,5,24,"PACMA",12
40,"40901",414,331,328,8,3,"PACMA",2
50,"50200",475,416,407,4,9,"PACMA",2
20,"20016",1524,997,997,1,0,"PACMA",9
26,"26135",153,123,123,1,0,"PACMA",0
42,"42064",85,71,71,0,0,"PACMA",1
29,"29033",1089,776,761,2,15,"PACMA",6
27,"27024",1451,1122,1102,5,20,"PACMA",7
47,"47024",232,189,188,0,1,"PACMA",0
4,"4903",4308,3102,3075,17,27,"PACMA",10
25,"25055",163,130,129,0,1,"PACMA",0
18,"18098",5994,4293,4247,29,46,"PACMA",17
49,"49187",1202,930,921,8,9,"PACMA",2
24,"24063",355,261,261,2,0,"PACMA",0
3,"3044",4557,3650,3600,17,50,"PACMA",31
9,"9199",94,72,70,0,2,"PACMA",0
19,"19224",102,91,90,1,1,"PACMA",0
31,"31045",509,395,390,5,5,"PACMA",5
19,"19132",93,72,72,0,0,"PACMA",0
10,"10150",331,277,272,6,5,"PACMA",1
46,"46219",122,105,104,0,1,"PACMA",0
30,"30019",25846,18755,18517,172,238,"PACMA",221
24,"24146",251,206,204,1,2,"PACMA",0
19,"19133",81,70,70,0,0,"PACMA",0
48,"48074",3273,2480,2460,14,20,"PACMA",10
37,"37315",86,68,67,0,1,"PACMA",0
19,"19087",17,14,14,0,0,"PACMA",0
50,"50084",66,47,47,0,0,"PACMA",0
2,"2032",265,208,203,3,5,"PACMA",1
13,"13053",14075,10930,10798,98,132,"PACMA",131
44,"44034",126,97,97,2,0,"PACMA",0
34,"34222",109,81,79,1,2,"PACMA",0
46,"46220",48968,35430,34964,306,466,"PACMA",444
12,"12093",165,128,126,0,2,"PACMA",1
19,"19269",94,75,75,0,0,"PACMA",0
10,"10152",446,354,350,2,4,"PACMA",0
25,"25156",784,608,605,4,3,"PACMA",3
22,"22090",85,66,66,1,0,"PACMA",0
15,"15075",12785,9638,9519,121,119,"PACMA",108
47,"47122",2016,1655,1617,15,38,"PACMA",8
31,"31169",2205,1597,1568,17,29,"PACMA",7
37,"37128",242,187,184,1,3,"PACMA",0
46,"46130",857,680,669,6,11,"PACMA",7
33,"33036",11335,8356,8243,92,113,"PACMA",73
5,"5126",62,53,52,0,1,"PACMA",0
49,"49190",50,45,45,1,0,"PACMA",0
49,"49152",483,327,322,2,5,"PACMA",0
37,"37202",989,838,828,7,10,"PACMA",7
45,"45127",764,582,577,3,5,"PACMA",16
20,"20050",270,186,183,3,3,"PACMA",0
41,"41027",3966,2830,2784,32,46,"PACMA",29
2,"2034",1324,1088,1083,10,5,"PACMA",6
37,"37088",199,151,149,1,2,"PACMA",0
5,"5127",608,499,496,0,3,"PACMA",2
32,"32042",1505,1097,1091,12,6,"PACMA",3
9,"9373",406,284,268,3,16,"PACMA",2
31,"31090",141,86,86,0,0,"PACMA",0
14,"14061",688,567,556,2,11,"PACMA",0
19,"19138",223,176,172,4,4,"PACMA",1
47,"47028",30,17,17,0,0,"PACMA",0
24,"24028",365,297,290,2,7,"PACMA",2
22,"22058",191,157,157,3,0,"PACMA",3
9,"9259",227,198,197,2,1,"PACMA",1
6,"6043",686,553,544,6,9,"PACMA",2
46,"46223",7781,6057,5995,42,62,"PACMA",90
37,"37089",62,51,50,0,1,"PACMA",1
18,"18911",7869,5871,5765,49,106,"PACMA",90
49,"49192",124,102,102,2,0,"PACMA",0
5,"5129",116,82,76,1,6,"PACMA",0
45,"45084",2121,1708,1676,16,32,"PACMA",13
44,"44135",102,85,85,0,0,"PACMA",2
33,"33069",3419,2557,2533,32,24,"PACMA",20
19,"19187",42,36,36,0,0,"PACMA",0
2,"2073",4844,3828,3772,28,56,"PACMA",14
22,"22096",320,274,272,2,2,"PACMA",3
19,"19277",16,13,13,0,0,"PACMA",0
46,"46224",154,124,124,2,0,"PACMA",2
50,"50291",93,78,77,1,1,"PACMA",0
10,"10034",336,269,267,0,2,"PACMA",1
47,"47125",51,46,45,0,1,"PACMA",0
36,"36041",13621,10098,9939,97,159,"PACMA",109
25,"25907",497,389,386,2,3,"PACMA",9
49,"49193",435,303,287,1,16,"PACMA",1
49,"49194",340,236,233,3,3,"PACMA",1
11,"11013",2332,1747,1713,16,34,"PACMA",13
9,"9001",30,27,27,0,0,"PACMA",0
42,"42034",44,36,36,1,0,"PACMA",0
25,"25061",80,59,58,0,1,"PACMA",0
43,"43021",345,270,269,3,1,"PACMA",2
20,"20054",459,313,312,1,1,"PACMA",1
40,"40068",22,21,21,0,0,"PACMA",0
37,"37049",127,89,89,0,0,"PACMA",0
47,"47188",99,77,77,0,0,"PACMA",0
20,"20014",1156,772,765,4,7,"PACMA",6
28,"28087",3259,2643,2623,16,20,"PACMA",22
34,"34229",58,42,40,1,2,"PACMA",0
25,"25908",221,159,158,1,1,"PACMA",1
46,"46043",135,119,116,1,3,"PACMA",2
24,"24071",967,755,741,7,14,"PACMA",7
49,"49080",630,499,493,4,6,"PACMA",3
12,"12005",8052,6056,5935,50,121,"PACMA",52
10,"10159",317,241,240,0,1,"PACMA",0
49,"49199",241,174,171,4,3,"PACMA",0
45,"45134",1609,1305,1291,6,14,"PACMA",5
47,"47221",100,84,83,1,1,"PACMA",0
15,"15081",982,755,741,11,14,"PACMA",6
40,"40070",148,110,107,1,3,"PACMA",1
12,"12038",156,110,109,1,1,"PACMA",0
6,"6114",127,109,108,0,1,"PACMA",0
37,"37013",107,73,72,0,1,"PACMA",1
27,"27003",1772,1271,1241,6,30,"PACMA",11
12,"12006",174,149,149,2,0,"PACMA",1
10,"10038",83,70,69,0,1,"PACMA",0
22,"22062",154,115,115,1,0,"PACMA",2
42,"42080",150,116,116,1,0,"PACMA",0
50,"50181",1000,770,754,7,16,"PACMA",6
38,"38013",3019,2023,1991,12,32,"PACMA",14
47,"47095",41,36,34,2,2,"PACMA",1
30,"30027",49767,39111,38724,245,387,"PACMA",621
44,"44074",444,353,346,3,7,"PACMA",2
18,"18178",671,535,532,0,3,"PACMA",3
37,"37324",335,276,274,1,2,"PACMA",2
47,"47223",152,123,120,2,3,"PACMA",0
24,"24196",1918,1446,1422,9,24,"PACMA",5
47,"47129",855,715,696,3,19,"PACMA",2
50,"50152",1368,1061,1043,6,18,"PACMA",2
38,"38045",3549,2149,2109,6,40,"PACMA",39
34,"34133",105,88,86,1,2,"PACMA",0
9,"9908",427,294,290,6,4,"PACMA",3
50,"50092",300,234,230,1,4,"PACMA",1
6,"6050",4042,3246,3163,27,83,"PACMA",14
47,"47065",817,658,653,2,5,"PACMA",1
4,"4081",346,272,271,2,1,"PACMA",0
20,"20027",2758,1980,1958,19,22,"PACMA",9
47,"47224",97,74,74,0,0,"PACMA",2
9,"9219",27153,20116,19831,215,285,"PACMA",230
32,"32048",864,550,544,1,6,"PACMA",0
40,"40072",224,198,194,3,4,"PACMA",3
18,"18006",4087,3109,3042,28,67,"PACMA",15
5,"5016",6354,5090,5005,40,85,"PACMA",34
37,"37213",83,65,64,0,1,"PACMA",2
45,"45048",355,277,271,1,6,"PACMA",0
9,"9330",1480,1180,1161,8,19,"PACMA",1
50,"50268",42,33,32,1,1,"PACMA",0
6,"6084",1065,904,890,8,14,"PACMA",5
18,"18109",599,452,448,3,4,"PACMA",7
38,"38046",9271,7297,7212,53,85,"PACMA",68
31,"31223",959,718,711,8,7,"PACMA",17
40,"40179",626,540,529,2,11,"PACMA",2
24,"24199",405,302,297,3,5,"PACMA",2
49,"49203",287,229,223,2,6,"PACMA",0
31,"31020",433,273,272,1,1,"PACMA",1
47,"47036",205,162,157,1,5,"PACMA",0
6,"6151",1054,791,778,2,13,"PACMA",2
48,"48085",10637,8270,8223,54,47,"PACMA",94
22,"22235",88,72,72,1,0,"PACMA",0
39,"39078",1406,1101,1090,7,11,"PACMA",6
3,"3056",8629,6838,6737,38,101,"PACMA",74
49,"49086",111,94,93,1,1,"PACMA",0
27,"27038",923,688,677,12,11,"PACMA",3
29,"29047",1103,909,898,2,11,"PACMA",5
47,"47194",292,245,243,1,2,"PACMA",0
10,"10003",540,388,386,4,2,"PACMA",1
40,"40145",1105,906,899,2,7,"PACMA",3
50,"50094",1518,1172,1155,20,17,"PACMA",12
37,"37057",209,165,162,2,3,"PACMA",0
6,"6119",681,551,547,1,4,"PACMA",1
16,"16067",119,96,93,2,3,"PACMA",0
43,"43173",99,80,78,0,2,"PACMA",0
28,"28062",288,243,236,0,7,"PACMA",4
38,"38048",3957,2889,2842,12,47,"PACMA",35
9,"9390",569,464,459,5,5,"PACMA",0
15,"15086",2785,2015,1987,14,28,"PACMA",18
19,"19155",66,56,56,0,0,"PACMA",1
5,"5021",1871,1469,1440,15,29,"PACMA",4
10,"10087",1606,1239,1223,5,16,"PACMA",4
29,"29049",2926,2197,2165,9,32,"PACMA",17
49,"49206",794,584,570,7,14,"PACMA",1
42,"42007",109,89,89,1,0,"PACMA",0
27,"27040",3035,2285,2234,19,51,"PACMA",4
24,"24042",61,47,47,1,0,"PACMA",0
30,"30032",2851,2256,2218,14,38,"PACMA",12
47,"47228",439,353,352,1,1,"PACMA",2
43,"43174",144,128,127,0,1,"PACMA",1
2,"2047",107,89,88,1,1,"PACMA",0
39,"39080",3505,2735,2701,8,34,"PACMA",28
40,"40182",173,126,124,1,2,"PACMA",0
9,"9392",49,41,41,0,0,"PACMA",0
30,"30033",10363,8115,7979,54,136,"PACMA",95
24,"24083",1005,800,791,7,9,"PACMA",5
42,"42088",60,53,53,0,0,"PACMA",0
50,"50157",286,226,220,0,6,"PACMA",1
26,"26115",23,21,19,0,2,"PACMA",0
45,"45145",2613,1950,1921,13,29,"PACMA",26
29,"29051",41793,29275,28764,249,511,"PACMA",496
5,"5023",175,158,155,2,3,"PACMA",1
6,"6089",608,524,519,3,5,"PACMA",0
12,"12012",2613,2217,2180,6,37,"PACMA",9
19,"19290",851,581,577,5,4,"PACMA",14
40,"40149",486,383,376,3,7,"PACMA",2
44,"44084",55,45,45,0,0,"PACMA",0
9,"9175",119,93,93,0,0,"PACMA",1
31,"31229",38,36,36,2,0,"PACMA",0
27,"27010",4402,3015,2940,49,75,"PACMA",14
37,"37182",78,57,57,0,0,"PACMA",0
25,"25072",5874,4468,4450,24,18,"PACMA",43
22,"22113",470,369,369,2,0,"PACMA",1
12,"12107",351,312,306,1,6,"PACMA",0
25,"25173",1649,1278,1262,5,16,"PACMA",15
15,"15090",1125,811,800,7,11,"PACMA",3
10,"10049",3758,3167,3086,19,81,"PACMA",21
4,"4012",187,163,162,1,1,"PACMA",4
46,"46235",21270,15754,15592,101,162,"PACMA",180
50,"50041",17,14,14,0,0,"PACMA",0
27,"27032",3194,2268,2223,20,45,"PACMA",10
45,"45132",2376,1915,1908,13,7,"PACMA",17
47,"47199",71,59,59,3,0,"PACMA",0
13,"13076",461,377,369,0,8,"PACMA",0
21,"21045",227,181,178,1,3,"PACMA",1
5,"5106",28,22,22,0,0,"PACMA",0
25,"25244",362,296,294,2,2,"PACMA",1
19,"19161",211,165,163,2,2,"PACMA",3
32,"32027",1000,762,747,5,15,"PACMA",3
19,"19113",446,352,342,3,10,"PACMA",6
20,"20065",2943,2145,2124,11,21,"PACMA",10
22,"22245",306,266,263,0,3,"PACMA",1
13,"13077",3399,2447,2380,30,67,"PACMA",20
5,"5026",187,163,159,1,4,"PACMA",0
39,"39083",1074,786,777,4,9,"PACMA",5
32,"32028",1550,1176,1171,10,5,"PACMA",3
27,"27013",3684,2997,2935,26,62,"PACMA",36
47,"47074",141,122,122,2,0,"PACMA",0
9,"9400",310,250,247,4,3,"PACMA",0
30,"30036",15256,10884,10703,56,181,"PACMA",157
19,"19011",236,181,181,0,0,"PACMA",2
31,"31232",25574,19124,18913,236,211,"PACMA",250
24,"24088",995,813,802,12,11,"PACMA",2
12,"12109",653,544,533,3,11,"PACMA",11
14,"14901",915,795,782,8,13,"PACMA",1
9,"9231",59,43,43,1,0,"PACMA",0
22,"22246",71,50,50,0,0,"PACMA",0
32,"32057",514,367,365,5,2,"PACMA",2
31,"31233",93,72,70,1,2,"PACMA",2
34,"34202",28,20,20,1,0,"PACMA",0
29,"29055",1880,1493,1470,15,23,"PACMA",22
50,"50219",4283,3274,3213,53,61,"PACMA",70
7,"7028",920,686,676,8,10,"PACMA",7
20,"20037",103,77,77,0,0,"PACMA",0
41,"41014",2486,1939,1878,6,61,"PACMA",4
2,"2054",383,314,309,1,5,"PACMA",3
47,"47076",17721,14605,14438,134,167,"PACMA",144
14,"14047",1629,1300,1285,18,15,"PACMA",9
29,"29056",1061,783,772,4,11,"PACMA",4
25,"25176",307,262,259,1,3,"PACMA",1
6,"6094",1459,1017,1008,8,9,"PACMA",3
32,"32058",5225,3915,3857,35,58,"PACMA",38
36,"36055",13551,9908,9682,105,226,"PACMA",113
41,"41043",667,475,453,3,22,"PACMA",0
43,"43106",793,656,651,2,5,"PACMA",2
33,"33054",1611,1145,1124,8,21,"PACMA",6
31,"31235",157,121,118,0,3,"PACMA",1
23,"23016",384,316,311,0,5,"PACMA",0
22,"22207",121,78,78,1,0,"PACMA",0
46,"46057",474,319,313,1,6,"PACMA",8
5,"5151",80,64,64,1,0,"PACMA",0
34,"34102",202,173,171,2,2,"PACMA",1
40,"40190",48,40,39,0,1,"PACMA",0
9,"9236",35,29,29,1,0,"PACMA",0
34,"34206",814,668,660,13,8,"PACMA",1
30,"30039",20191,14552,14380,96,172,"PACMA",205
20,"20069",147441,111102,110598,762,504,"PACMA",1037
48,"48094",3125,2407,2388,12,19,"PACMA",12
9,"9075",103,87,87,1,0,"PACMA",2
44,"44089",52,44,44,0,0,"PACMA",0
45,"45155",319,261,253,1,8,"PACMA",1
50,"50221",32,22,22,0,0,"PACMA",0
24,"24215",152,125,124,1,1,"PACMA",0
27,"27048",2019,1499,1467,23,32,"PACMA",4
2,"2057",1960,1522,1489,15,33,"PACMA",10
19,"19301",37,31,31,0,0,"PACMA",0
13,"13084",841,683,673,6,10,"PACMA",2
16,"16270",156,124,124,1,0,"PACMA",0
45,"45156",3338,2805,2750,9,55,"PACMA",12
1,"1051",3558,2448,2433,14,15,"PACMA",14
10,"10140",1082,868,855,8,13,"PACMA",2
2,"2021",1014,836,827,5,9,"PACMA",5
37,"37230",214,176,176,0,0,"PACMA",0
47,"47144",75,63,63,1,0,"PACMA",0
6,"6097",2283,1803,1762,10,41,"PACMA",3
16,"16271",595,513,511,2,2,"PACMA",1
39,"39060",6693,5459,5394,29,65,"PACMA",34
33,"33057",1538,1129,1097,14,32,"PACMA",8
9,"9077",30,22,22,0,0,"PACMA",0
16,"16272",199,162,161,1,1,"PACMA",0
12,"12113",87,65,64,0,1,"PACMA",0
39,"39004",1483,1181,1163,4,18,"PACMA",1
22,"22009",585,439,435,4,4,"PACMA",2
22,"22008",155,127,125,0,2,"PACMA",0
32,"32061",1070,862,855,8,7,"PACMA",1
20,"20071",15036,11090,11025,59,65,"PACMA",59
16,"16002",195,166,164,1,2,"PACMA",1
46,"46182",1310,988,977,5,11,"PACMA",26
40,"40124",234,175,168,3,7,"PACMA",2
31,"31117",589,420,419,5,1,"PACMA",2
16,"16126",729,622,616,5,6,"PACMA",3
39,"39089",134,99,98,0,1,"PACMA",1
34,"34107",73,54,54,2,0,"PACMA",0
3,"3038",335,275,267,1,8,"PACMA",2
31,"31077",5407,4148,4081,39,67,"PACMA",45
3,"3068",42,40,40,3,0,"PACMA",0
46,"46152",87,69,69,0,0,"PACMA",0
16,"16274",103,86,85,0,1,"PACMA",0
13,"13043",209,167,167,1,0,"PACMA",1
10,"10183",958,748,735,3,13,"PACMA",1
42,"42155",142,92,92,0,0,"PACMA",1
45,"45160",1095,913,905,2,8,"PACMA",7
48,"48007",385,281,279,1,2,"PACMA",0
24,"24219",492,374,371,5,3,"PACMA",4
28,"28014",34047,26858,26575,178,283,"PACMA",372
22,"22012",102,81,80,1,1,"PACMA",0
39,"39006",1721,1332,1315,3,17,"PACMA",7
1,"1009",1265,920,914,6,6,"PACMA",10
40,"40088",268,200,200,0,0,"PACMA",2
25,"25182",1043,842,839,9,3,"PACMA",17
44,"44251",242,197,187,0,10,"PACMA",0
5,"5118",68,44,43,0,1,"PACMA",0
43,"43906",2103,1595,1587,14,8,"PACMA",5
22,"22127",529,434,432,4,2,"PACMA",3
24,"24097",204,155,155,7,0,"PACMA",0
24,"24221",750,563,553,6,10,"PACMA",2
47,"47147",102,85,85,0,0,"PACMA",0
46,"46245",528,430,426,2,4,"PACMA",5
5,"5158",345,279,274,2,5,"PACMA",0
1,"1010",2315,1789,1770,14,19,"PACMA",6
47,"47051",321,274,272,1,2,"PACMA",2
7,"7024",7294,4213,4160,44,53,"PACMA",87
49,"49255",396,324,323,3,1,"PACMA",0
40,"40161",35,28,26,0,2,"PACMA",0
19,"19126",1687,1306,1285,9,21,"PACMA",33
9,"9084",167,132,127,4,5,"PACMA",1
24,"24179",299,239,238,3,1,"PACMA",0
49,"49105",136,105,103,1,2,"PACMA",0
19,"19308",60,57,57,1,0,"PACMA",0
24,"24222",14431,11296,11135,117,161,"PACMA",129
43,"43112",250,204,204,1,0,"PACMA",0
19,"19176",230,184,183,0,1,"PACMA",1
32,"32065",630,478,474,5,4,"PACMA",6
25,"25086",521,414,411,2,3,"PACMA",2
37,"37348",100,79,79,0,0,"PACMA",0
35,"35006",31309,23434,23019,221,415,"PACMA",354
10,"10065",200,149,149,0,0,"PACMA",1
16,"16132",34,26,26,0,0,"PACMA",0
28,"28078",40,37,37,0,0,"PACMA",0
18,"18132",3124,2575,2548,17,27,"PACMA",11
12,"12118",76,64,63,0,1,"PACMA",0
9,"9139",98,82,82,2,0,"PACMA",1
44,"44192",349,288,284,1,4,"PACMA",0
43,"43015",119,101,101,0,0,"PACMA",1
37,"37237",304,238,234,0,4,"PACMA",1
31,"31002",433,324,324,4,0,"PACMA",1
10,"10188",478,387,379,0,8,"PACMA",5
26,"26134",83,70,67,0,3,"PACMA",1
3,"3073",222,200,196,3,4,"PACMA",2
2,"2029",3327,2586,2556,15,30,"PACMA",26
45,"45028",3628,2916,2863,16,53,"PACMA",20
26,"26174",132,116,116,5,0,"PACMA",0
10,"10108",203,131,130,1,1,"PACMA",1
37,"37038",751,607,592,4,15,"PACMA",3
19,"19223",101,66,66,1,0,"PACMA",0
14,"14057",6139,5054,4964,51,90,"PACMA",33
27,"27056",1206,896,880,9,16,"PACMA",7
24,"24102",608,457,448,3,9,"PACMA",2
46,"46066",1285,1058,1043,6,15,"PACMA",11
6,"6005",1691,1246,1225,15,21,"PACMA",7
37,"37125",227,171,169,0,2,"PACMA",0
10,"10190",521,372,361,2,11,"PACMA",4
31,"31248",270,158,154,6,4,"PACMA",0
22,"22016",566,423,420,4,3,"PACMA",8
31,"31126",351,255,254,2,1,"PACMA",0
26,"26136",92,80,80,3,0,"PACMA",1
37,"37239",206,184,181,3,3,"PACMA",1
2,"2031",541,432,425,0,7,"PACMA",1
1,"1017",816,579,574,2,5,"PACMA",6
40,"40094",364,284,279,1,5,"PACMA",4
31,"31005",281,202,201,5,1,"PACMA",7
27,"27057",11097,7917,7735,88,182,"PACMA",36
44,"44101",51,43,42,1,1,"PACMA",1
45,"45169",186,135,134,0,1,"PACMA",1
9,"9421",242,197,196,2,1,"PACMA",3
5,"5164",17,12,12,0,0,"PACMA",0
9,"9045",274,199,196,1,3,"PACMA",0
26,"26138",4545,3433,3374,27,59,"PACMA",7
40,"40095",464,379,369,2,10,"PACMA",0
42,"42163",46,37,37,0,0,"PACMA",0
32,"32068",1419,998,987,4,11,"PACMA",6
19,"19037",132,114,112,0,2,"PACMA",1
18,"18030",567,448,442,4,6,"PACMA",4
37,"37353",122,95,95,1,0,"PACMA",0
16,"16902",127,101,101,0,0,"PACMA",0
3,"3076",8736,6571,6467,40,104,"PACMA",71
41,"41054",713,596,588,4,8,"PACMA",4
16,"16139",324,249,249,2,0,"PACMA",0
18,"18136",1782,1382,1359,12,23,"PACMA",2
24,"24185",452,339,332,3,7,"PACMA",0
5,"5165",370,293,285,4,8,"PACMA",2
35,"35010",3797,2601,2572,9,29,"PACMA",20
19,"19038",22,19,19,0,0,"PACMA",0
24,"24106",218,164,162,0,2,"PACMA",2
22,"22225",2610,1867,1843,15,24,"PACMA",16
49,"49113",166,139,139,1,0,"PACMA",1
16,"16904",451,386,383,3,3,"PACMA",8
6,"6009",228,190,187,2,3,"PACMA",1
37,"37129",252,206,202,2,4,"PACMA",2
24,"24230",410,312,309,5,3,"PACMA",0
48,"48015",33109,24697,24475,161,222,"PACMA",249
16,"16014",563,444,443,4,1,"PACMA",0
40,"40099",52,46,44,0,2,"PACMA",0
47,"47058",202,154,153,3,1,"PACMA",2
19,"19185",27,19,19,0,0,"PACMA",0
31,"31009",672,510,503,4,7,"PACMA",3
18,"18137",1002,776,773,0,3,"PACMA",0
50,"50147",751,564,559,3,5,"PACMA",3
13,"13904",504,394,376,6,18,"PACMA",2
40,"40906",2131,1830,1814,10,16,"PACMA",22
2,"2035",1946,1592,1576,15,16,"PACMA",18
26,"26142",784,651,641,5,10,"PACMA",10
16,"16016",216,175,174,3,1,"PACMA",9
45,"45037",1535,1121,1105,7,16,"PACMA",10
49,"49115",169,137,136,0,1,"PACMA",2
26,"26027",143,101,98,1,3,"PACMA",0
19,"19041",167,133,129,1,4,"PACMA",1
37,"37205",217,177,174,0,3,"PACMA",0
2,"2072",1525,1146,1112,4,34,"PACMA",4
18,"18174",434,362,357,0,5,"PACMA",5
19,"19324",160,128,123,1,5,"PACMA",1
10,"10197",108,84,84,0,0,"PACMA",0
48,"48911",388,323,322,3,1,"PACMA",2
42,"42033",50,45,44,1,1,"PACMA",0
45,"45039",208,176,176,0,0,"PACMA",4
14,"14002",10859,8215,8078,93,137,"PACMA",57
9,"9429",55,41,41,0,0,"PACMA",0
32,"32072",3687,2715,2682,22,33,"PACMA",14
16,"16017",340,281,271,2,10,"PACMA",1
6,"6111",493,374,370,2,4,"PACMA",0
50,"50149",33,25,25,1,0,"PACMA",0
24,"24110",1154,895,880,5,15,"PACMA",5
37,"37170",1370,1009,990,10,19,"PACMA",0
16,"16908",163,135,133,0,2,"PACMA",2
46,"46073",1077,867,862,10,5,"PACMA",1
45,"45177",2023,1693,1651,11,42,"PACMA",5
44,"44008",1565,1158,1138,8,20,"PACMA",4
12,"12097",65,54,54,1,0,"PACMA",0
30,"30025",5001,3951,3898,27,53,"PACMA",39
2,"2026",832,682,673,6,9,"PACMA",2
44,"44108",300,228,224,5,4,"PACMA",2
19,"19326",2343,1789,1768,9,21,"PACMA",40
37,"37011",99,75,73,0,2,"PACMA",0
18,"18036",3970,3197,3149,26,48,"PACMA",40
44,"44009",799,621,611,7,10,"PACMA",3
27,"27063",1715,1236,1198,10,38,"PACMA",7
14,"14004",1981,1522,1509,8,13,"PACMA",8
19,"19190",2302,1788,1767,13,21,"PACMA",11
6,"6014",6535,4757,4679,36,78,"PACMA",17
35,"35015",10728,6233,6108,54,125,"PACMA",99
19,"19327",397,333,332,0,1,"PACMA",0
23,"23901",1139,946,934,3,12,"PACMA",0
25,"25200",323,253,252,0,1,"PACMA",0
19,"19046",22148,17383,17137,125,246,"PACMA",305
29,"29010",1632,1372,1319,4,53,"PACMA",4
44,"44231",36,33,32,0,1,"PACMA",0
44,"44071",585,449,447,6,2,"PACMA",2
22,"22024",222,179,177,1,2,"PACMA",1
39,"39018",4272,3533,3476,17,57,"PACMA",36
41,"41903",6769,5018,4919,73,99,"PACMA",87
26,"26108",290,241,237,0,4,"PACMA",0
50,"50033",65,50,50,1,0,"PACMA",2
13,"13064",1836,1455,1446,18,9,"PACMA",24
34,"34232",735,595,584,8,11,"PACMA",3
22,"22144",257,207,204,1,3,"PACMA",1
18,"18038",1047,810,787,4,23,"PACMA",1
6,"6115",1243,898,876,3,22,"PACMA",8
19,"19330",67,60,60,0,0,"PACMA",1
9,"9269",29,25,23,1,2,"PACMA",0
40,"40001",706,597,590,7,7,"PACMA",0
49,"49243",109,86,83,0,3,"PACMA",0
12,"12100",1281,1118,1102,5,16,"PACMA",7
46,"46046",884,654,643,3,11,"PACMA",10
50,"50210",36,29,29,0,0,"PACMA",0
6,"6149",10203,8194,8051,72,143,"PACMA",50
9,"9166",98,77,77,1,0,"PACMA",0
36,"36045",24478,18627,18327,157,300,"PACMA",230
47,"47004",1136,950,939,5,11,"PACMA",0
10,"10082",1810,1495,1476,9,19,"PACMA",12
39,"39076",3483,2770,2734,21,36,"PACMA",21
47,"47161",3945,3370,3344,20,26,"PACMA",22
45,"45184",201,133,132,0,1,"PACMA",4
31,"31018",422,317,312,4,5,"PACMA",4
50,"50153",922,705,704,6,1,"PACMA",6
7,"7051",5414,3610,3575,37,35,"PACMA",40
18,"18145",10869,8532,8405,69,127,"PACMA",126
40,"40002",34,30,30,0,0,"PACMA",0
49,"49123",532,406,402,2,4,"PACMA",2
10,"10205",1965,1344,1300,8,44,"PACMA",11
39,"39021",467,392,385,2,7,"PACMA",0
16,"16151",64,52,52,0,0,"PACMA",0
9,"9272",259,197,195,2,2,"PACMA",0
26,"26035",16,14,13,0,1,"PACMA",0
18,"18146",937,690,682,6,8,"PACMA",4
49,"49245",253,183,182,2,1,"PACMA",3
3,"3085",269,243,237,0,6,"PACMA",0
4,"4047",2230,1806,1785,8,21,"PACMA",11
5,"5138",289,224,223,2,1,"PACMA",0
46,"46139",4512,3612,3567,25,45,"PACMA",28
10,"10043",754,578,572,3,6,"PACMA",2
5,"5177",139,117,117,0,0,"PACMA",0
9,"9113",460,369,364,3,5,"PACMA",1
25,"25102",661,517,511,8,6,"PACMA",0
19,"19196",90,77,70,1,7,"PACMA",0
49,"49124",237,169,166,1,3,"PACMA",0
27,"27902",7150,5067,4953,74,114,"PACMA",77
10,"10085",319,240,236,1,4,"PACMA",1
47,"47067",153,119,119,3,0,"PACMA",0
43,"43050",2634,1881,1868,13,13,"PACMA",37
18,"18076",790,607,604,1,3,"PACMA",1
5,"5019",44838,36021,35637,287,384,"PACMA",297
50,"50125",345,264,261,3,3,"PACMA",0
9,"9334",48,37,35,0,2,"PACMA",1
31,"31021",60,47,47,3,0,"PACMA",0
16,"16027",701,540,531,2,9,"PACMA",3
21,"21003",677,505,489,3,16,"PACMA",1
9,"9114",76,63,63,0,0,"PACMA",0
9,"9440",80,66,66,0,0,"PACMA",0
14,"14010",4001,3106,3068,15,38,"PACMA",31
25,"25007",1392,1089,1083,4,6,"PACMA",25
10,"10086",303,249,244,3,5,"PACMA",0
25,"25170",261,230,228,4,2,"PACMA",1
21,"21004",1593,1114,1085,16,29,"PACMA",15
34,"34137",24,23,22,2,1,"PACMA",0
3,"3089",9497,6952,6794,55,158,"PACMA",80
20,"20031",183,125,125,2,0,"PACMA",0
19,"19005",91,63,63,0,0,"PACMA",0
46,"46172",5412,3878,3832,18,46,"PACMA",67
12,"12043",560,460,450,2,10,"PACMA",2
32,"32080",286,223,220,1,3,"PACMA",1
40,"40006",22,18,18,0,0,"PACMA",0
26,"26039",38,34,34,0,0,"PACMA",0
40,"40111",52,44,44,0,0,"PACMA",1
43,"43052",934,765,756,2,9,"PACMA",7
50,"50243",311,252,247,1,5,"PACMA",0
22,"22036",88,76,75,0,1,"PACMA",0
49,"49128",533,428,424,7,4,"PACMA",2
40,"40112",2772,2255,2223,21,32,"PACMA",25
37,"37256",195,152,150,0,2,"PACMA",0
7,"7056",5245,3883,3841,32,42,"PACMA",58
31,"31146",29,25,25,1,0,"PACMA",0
46,"46173",1319,1084,1062,6,22,"PACMA",12
31,"31903",6862,4962,4915,31,47,"PACMA",87
5,"5063",31,27,27,0,0,"PACMA",0
25,"25010",196,156,155,2,1,"PACMA",5
42,"42046",46,35,33,2,2,"PACMA",0
5,"5260",97,81,80,1,1,"PACMA",0
16,"16203",10167,7720,7591,49,129,"PACMA",70
47,"47230",288,236,233,1,3,"PACMA",0
3,"3060",106,84,84,0,0,"PACMA",1
49,"49009",389,305,304,2,1,"PACMA",1
22,"22037",112,96,96,0,0,"PACMA",0
9,"9445",43,36,34,1,2,"PACMA",0
24,"24123",716,514,507,2,7,"PACMA",0
37,"37022",245,200,196,2,4,"PACMA",0
9,"9281",135,104,102,1,2,"PACMA",0
48,"48029",8613,6697,6642,52,55,"PACMA",77
31,"31905",2968,2253,2236,21,17,"PACMA",47
45,"45194",65,49,48,0,1,"PACMA",0
10,"10078",370,289,278,4,11,"PACMA",0
43,"43030",482,373,372,2,1,"PACMA",7
45,"45057",224,188,184,0,4,"PACMA",0
25,"25011",5260,3908,3871,30,37,"PACMA",37
44,"44210",743,600,594,8,6,"PACMA",1
47,"47138",219,182,177,1,5,"PACMA",0
37,"37222",86,64,62,0,2,"PACMA",0
32,"32083",821,592,587,7,5,"PACMA",6
40,"40185",815,624,618,4,6,"PACMA",3
44,"44180",72,61,61,0,0,"PACMA",0
44,"44118",158,126,122,1,4,"PACMA",0
25,"25209",1550,1192,1172,4,20,"PACMA",10
3,"3001",345,285,282,1,3,"PACMA",1
12,"12136",2606,2262,2223,17,39,"PACMA",13
16,"16034",155,124,122,1,2,"PACMA",0
3,"3062",221,182,180,1,2,"PACMA",3
18,"18047",6074,4437,4353,33,84,"PACMA",67
35,"35025",1773,1247,1235,9,12,"PACMA",4
15,"15030",199972,151737,150397,1576,1340,"PACMA",1750
50,"50162",137,112,110,2,2,"PACMA",1
42,"42188",43,35,34,1,1,"PACMA",0
9,"9288",88,73,71,1,2,"PACMA",1
14,"14015",2067,1575,1551,16,24,"PACMA",9
44,"44212",41,32,32,0,0,"PACMA",0
31,"31908",1064,810,803,2,7,"PACMA",6
37,"37148",404,321,315,2,6,"PACMA",3
37,"37374",1147,946,923,4,23,"PACMA",4
5,"5069",74,63,62,0,1,"PACMA",0
10,"10175",1361,1031,997,8,34,"PACMA",3
48,"48031",308,236,236,0,0,"PACMA",2
35,"35026",82764,55647,54846,499,801,"PACMA",879
14,"14016",1283,1005,994,4,11,"PACMA",3
26,"26162",112,95,94,0,1,"PACMA",0
50,"50133",100,82,82,2,0,"PACMA",0
48,"48032",5773,4504,4476,5,28,"PACMA",27
18,"18085",701,465,460,1,5,"PACMA",2
7,"7061",9564,6678,6583,67,95,"PACMA",95
25,"25113",1116,912,908,8,4,"PACMA",4
28,"28177",10722,9093,9029,64,64,"PACMA",119
9,"9128",78,63,61,1,2,"PACMA",2
44,"44022",463,342,326,6,16,"PACMA",6
15,"15032",3413,2487,2414,28,73,"PACMA",9
28,"28080",49801,41938,41705,248,233,"PACMA",436
18,"18157",1148,914,898,8,16,"PACMA",6
49,"49134",166,111,111,2,0,"PACMA",0
16,"16162",39,31,30,0,1,"PACMA",0
37,"37226",150,119,119,2,0,"PACMA",1
9,"9073",963,799,787,7,12,"PACMA",5
26,"26163",124,106,104,1,2,"PACMA",0
37,"37263",338,251,246,0,5,"PACMA",0
31,"31032",1678,1285,1269,25,16,"PACMA",13
40,"40014",56,44,43,2,1,"PACMA",1
3,"3096",5779,4433,4352,30,81,"PACMA",55
1,"1002",8035,6227,6159,17,68,"PACMA",47
25,"25015",335,262,260,8,2,"PACMA",4
5,"5188",41,36,34,0,2,"PACMA",0
12,"12139",302,219,217,3,2,"PACMA",1
9,"9294",102,86,85,0,1,"PACMA",2
10,"10098",381,310,309,1,1,"PACMA",0
18,"18158",8010,5524,5449,23,75,"PACMA",39
34,"34154",76,59,58,0,1,"PACMA",0
25,"25215",505,299,299,4,0,"PACMA",2
26,"26165",337,289,284,0,5,"PACMA",0
50,"50250",56,45,45,0,0,"PACMA",0
34,"34015",39,32,31,0,1,"PACMA",0
19,"19067",69,53,50,1,3,"PACMA",0
14,"14019",6408,5163,5086,58,77,"PACMA",35
37,"37265",208,184,181,1,3,"PACMA",1
16,"16001",64,51,51,0,0,"PACMA",0
40,"40084",53,40,39,0,1,"PACMA",0
18,"18159",999,828,824,1,4,"PACMA",3
39,"39032",1426,1156,1141,8,15,"PACMA",6
28,"28011",420,315,311,1,4,"PACMA",7
49,"49018",288,225,222,1,3,"PACMA",0
49,"49262",370,287,286,1,1,"PACMA",2
37,"37154",129,106,102,3,4,"PACMA",0
7,"7065",2302,1633,1603,10,30,"PACMA",21
35,"35030",9949,6611,6462,65,149,"PACMA",61
19,"19071",8155,6327,6242,35,85,"PACMA",113
32,"32005",827,628,622,4,6,"PACMA",0
4,"4061",622,501,494,4,7,"PACMA",0
37,"37379",173,152,152,0,0,"PACMA",1
22,"22046",714,592,587,13,5,"PACMA",0
34,"34156",50,43,43,0,0,"PACMA",0
47,"47145",586,446,440,2,6,"PACMA",1
37,"37231",239,204,203,6,1,"PACMA",0
21,"21053",3287,2375,2322,17,53,"PACMA",15
47,"47080",35,23,21,0,2,"PACMA",0
6,"6032",78,65,64,0,1,"PACMA",1
19,"19216",130,100,99,1,1,"PACMA",0
49,"49020",261,215,210,2,5,"PACMA",0
10,"10182",124,91,90,0,1,"PACMA",0
12,"12114",194,161,160,2,1,"PACMA",0
37,"37268",108,72,70,0,2,"PACMA",0
40,"40018",75,60,60,0,0,"PACMA",0
34,"34157",2364,1881,1846,13,35,"PACMA",8
12,"12142",145,123,121,1,2,"PACMA",0
46,"46255",3209,2415,2381,18,34,"PACMA",34
44,"44219",173,142,136,1,6,"PACMA",0
18,"18056",3418,2523,2478,22,45,"PACMA",19
12,"12055",106,85,83,2,2,"PACMA",0
14,"14022",3886,3080,3043,18,37,"PACMA",18
32,"32062",766,582,579,1,3,"PACMA",1
1,"1054",1013,729,726,2,3,"PACMA",7
18,"18127",16822,12735,12537,106,198,"PACMA",175
37,"37345",150,134,133,0,1,"PACMA",3
40,"40054",107,91,88,0,3,"PACMA",1
1,"1055",840,608,602,10,6,"PACMA",5
9,"9082",36,34,34,0,0,"PACMA",0
37,"37158",233,168,166,0,2,"PACMA",1
40,"40126",67,53,51,0,2,"PACMA",0
18,"18163",315,246,241,1,5,"PACMA",1
46,"46184",26453,21076,20810,172,266,"PACMA",291
9,"9464",33,27,27,0,0,"PACMA",1
31,"31161",345,286,279,4,7,"PACMA",3
47,"47082",810,679,668,8,11,"PACMA",1
25,"25121",635,436,429,1,7,"PACMA",2
23,"23024",12224,9586,9329,46,257,"PACMA",104
14,"14023",2007,1734,1711,9,23,"PACMA",5
24,"24124",346,231,226,2,5,"PACMA",0
1,"1011",215,179,175,3,4,"PACMA",0
12,"12902",2248,1678,1653,7,25,"PACMA",21
40,"40231",98,80,80,2,0,"PACMA",0
46,"46185",364,315,310,1,5,"PACMA",2
18,"18164",1794,1225,1205,9,20,"PACMA",4
16,"16046",223,162,161,1,1,"PACMA",0
19,"19078",50,38,37,0,1,"PACMA",0
50,"50255",197,162,160,2,2,"PACMA",2
16,"16173",190,141,141,0,0,"PACMA",0
5,"5081",37,29,29,0,0,"PACMA",0
44,"44029",579,466,457,3,9,"PACMA",4
39,"39036",971,794,787,5,7,"PACMA",4
38,"38002",972,678,640,3,38,"PACMA",10
13,"13002",1419,1021,995,5,26,"PACMA",3
45,"45073",287,226,225,1,1,"PACMA",0
33,"33001",1504,875,864,15,11,"PACMA",2
28,"28088",286,193,193,2,0,"PACMA",0
25,"25123",189,151,151,0,0,"PACMA",0
9,"9471",142,113,112,3,1,"PACMA",4
42,"42201",23,20,20,0,0,"PACMA",0
18,"18165",4251,3113,3073,20,40,"PACMA",63
19,"19310",7,6,6,0,0,"PACMA",0
10,"10107",1030,840,828,5,12,"PACMA",0
26,"26056",403,334,328,2,6,"PACMA",3
41,"41079",9293,7137,6979,80,158,"PACMA",82
45,"45075",124,93,90,0,3,"PACMA",3
36,"36001",2401,1739,1715,19,24,"PACMA",12
26,"26020",454,347,337,4,10,"PACMA",0
28,"28017",1280,1017,1012,9,5,"PACMA",21
44,"44223",73,58,58,0,0,"PACMA",0
14,"14026",2014,1502,1474,10,28,"PACMA",6
32,"32038",399,274,271,3,3,"PACMA",6
9,"9198",100,80,79,0,1,"PACMA",0
25,"25088",95,85,83,0,2,"PACMA",0
49,"49026",201,163,162,0,1,"PACMA",1
29,"29090",1653,1215,1200,8,15,"PACMA",6
24,"24144",639,469,462,2,7,"PACMA",2
41,"41080",1240,940,913,11,27,"PACMA",4
49,"49270",137,111,111,0,0,"PACMA",1
32,"32011",918,526,521,6,5,"PACMA",3
31,"31044",294,243,242,5,1,"PACMA",1
4,"4069",4757,3633,3588,25,45,"PACMA",22
16,"16176",31,22,22,0,0,"PACMA",0
33,"33003",612,373,369,6,4,"PACMA",0
24,"24145",618,443,435,3,8,"PACMA",1
20,"20078",1145,882,879,4,3,"PACMA",4
26,"26176",53,48,48,0,0,"PACMA",0
26,"26175",47,40,40,2,0,"PACMA",0
25,"25125",389,303,300,1,3,"PACMA",2
1,"1060",201,174,166,1,8,"PACMA",1
3,"3014",238879,176118,174768,1105,1350,"PACMA",2616
3,"3106",564,485,479,4,6,"PACMA",5
5,"5200",40,27,26,0,1,"PACMA",0
20,"20018",11218,8145,8109,41,36,"PACMA",29
40,"40132",46,32,31,1,1,"PACMA",0
24,"24025",289,234,226,4,8,"PACMA",0
37,"37276",126,101,101,0,0,"PACMA",0
40,"40026",113,106,105,2,1,"PACMA",1
13,"13007",1233,1005,967,11,38,"PACMA",3
14,"14028",307,258,257,0,1,"PACMA",1
21,"21026",253,189,183,1,6,"PACMA",1
12,"12063",44,37,37,1,0,"PACMA",0
16,"16181",57,46,46,1,0,"PACMA",0
19,"19226",41,32,32,0,0,"PACMA",2
19,"19088",95,82,82,2,0,"PACMA",1
49,"49273",166,111,110,0,1,"PACMA",0
46,"46262",213,170,165,1,5,"PACMA",0
34,"34169",381,314,309,6,5,"PACMA",0
37,"37042",41,32,31,1,1,"PACMA",0
48,"48014",1242,915,910,4,5,"PACMA",13
5,"5087",149,112,111,1,1,"PACMA",0
45,"45081",19138,15010,14829,110,181,"PACMA",274
13,"13009",1397,1145,1123,4,22,"PACMA",3
42,"42070",32,24,24,0,0,"PACMA",0
41,"41083",1128,865,859,6,6,"PACMA",3
28,"28093",2142,1751,1728,9,23,"PACMA",21
40,"40028",105,96,96,1,0,"PACMA",0
46,"46263",239,204,200,3,4,"PACMA",0
34,"34171",941,702,688,9,14,"PACMA",3
44,"44132",58,47,47,0,0,"PACMA",0
25,"25029",1607,1270,1265,6,5,"PACMA",8
16,"16186",412,358,354,1,4,"PACMA",5
50,"50176",222,161,156,3,5,"PACMA",1
26,"26062",86,74,72,1,2,"PACMA",0
1,"1063",1830,1363,1353,4,10,"PACMA",10
14,"14030",7797,6116,6036,54,80,"PACMA",49
25,"25128",127,87,87,0,0,"PACMA",2
3,"3017",379,321,311,1,10,"PACMA",2
41,"41084",2815,2177,2111,3,66,"PACMA",14
5,"5206",29,21,20,1,1,"PACMA",0
40,"40100",263,219,215,1,4,"PACMA",0
28,"28160",8629,6922,6856,34,66,"PACMA",113
45,"45083",551,470,465,5,5,"PACMA",2
18,"18066",2108,1537,1525,9,12,"PACMA",4
40,"40136",106,82,81,0,1,"PACMA",1
19,"19230",548,437,430,1,7,"PACMA",17
31,"31172",365,287,275,4,12,"PACMA",4
6,"6143",3370,2635,2589,23,46,"PACMA",11
6,"6011",24665,18486,18253,178,233,"PACMA",195
16,"16188",77,56,56,0,0,"PACMA",0
37,"37131",171,138,137,0,1,"PACMA",0
10,"10116",3728,2849,2776,27,73,"PACMA",13
37,"37009",196,142,141,1,1,"PACMA",0
45,"45085",1511,1141,1128,9,13,"PACMA",9
40,"40030",428,357,350,3,7,"PACMA",1
37,"37047",228,93,92,1,1,"PACMA",0
18,"18068",1606,1293,1277,11,16,"PACMA",14
5,"5208",38,31,31,0,0,"PACMA",0
43,"43069",178,146,146,0,0,"PACMA",1
38,"38010",3974,2814,2777,20,37,"PACMA",26
24,"24031",210,180,176,0,4,"PACMA",1
16,"16058",97,73,73,0,0,"PACMA",0
5,"5092",146,118,116,0,2,"PACMA",0
2,"2001",695,567,559,3,8,"PACMA",0
7,"7046",16718,10573,10469,94,104,"PACMA",214
36,"36009",4445,3081,2997,26,84,"PACMA",30
3,"3020",95,84,84,2,0,"PACMA",3
20,"20023",446,299,299,1,0,"PACMA",3
10,"10118",281,242,242,2,0,"PACMA",1
28,"28097",125,100,100,0,0,"PACMA",0
34,"34037",276,224,223,2,1,"PACMA",0
9,"9323",59,41,41,2,0,"PACMA",0
34,"34177",176,154,152,2,2,"PACMA",1
16,"16060",722,571,560,3,11,"PACMA",0
41,"41086",16209,11006,10881,116,125,"PACMA",207
32,"32017",1202,821,815,6,6,"PACMA",0
14,"14034",304,246,239,1,7,"PACMA",1
25,"25033",1121,899,890,5,9,"PACMA",7
43,"43144",1236,1025,1021,8,4,"PACMA",22
21,"21033",561,428,427,4,1,"PACMA",2
24,"24155",442,374,371,6,3,"PACMA",2
18,"18177",373,253,252,1,1,"PACMA",2
33,"33011",10659,6448,6332,119,116,"PACMA",17
45,"45088",2332,1724,1695,16,29,"PACMA",35
31,"31177",251,172,168,1,4,"PACMA",2
19,"19045",127,107,107,1,0,"PACMA",0
18,"18143",949,757,740,5,17,"PACMA",15
50,"50237",102,81,81,3,0,"PACMA",0
9,"9267",113,102,101,2,1,"PACMA",0
25,"25231",494,410,408,2,2,"PACMA",4
29,"29099",969,757,735,5,22,"PACMA",7
28,"28027",1200,920,906,4,14,"PACMA",2
47,"47190",95,81,81,1,0,"PACMA",0
49,"49158",203,163,155,0,8,"PACMA",0
26,"26068",79,62,62,1,0,"PACMA",0
7,"7049",1480,1092,1075,10,17,"PACMA",13
20,"20026",204,182,159,3,23,"PACMA",0
9,"9327",29,22,22,0,0,"PACMA",0
11,"11017",3194,2265,2221,38,44,"PACMA",14
31,"31057",1741,1365,1344,12,21,"PACMA",5
13,"13019",5095,3758,3717,25,41,"PACMA",26
27,"27004",1149,741,722,2,19,"PACMA",0
28,"28028",1820,1493,1483,8,10,"PACMA",22
39,"39019",2229,1785,1751,15,34,"PACMA",11
3,"3084",497,429,429,4,0,"PACMA",4
25,"25166",172,137,136,1,1,"PACMA",0
40,"40107",92,76,74,0,2,"PACMA",0
37,"37015",205,131,130,2,1,"PACMA",1
5,"5175",149,122,119,1,3,"PACMA",1
43,"43048",763,614,609,7,5,"PACMA",4
46,"46107",1849,1501,1480,5,21,"PACMA",23
22,"22027",306,230,225,3,5,"PACMA",1
3,"3116",1159,901,884,3,17,"PACMA",14
33,"33013",429,320,316,1,4,"PACMA",1
26,"26109",73,66,66,0,0,"PACMA",0
48,"48053",904,738,728,5,10,"PACMA",4
39,"39048",1765,1429,1420,4,9,"PACMA",9
27,"27005",2551,1908,1868,26,40,"PACMA",19
47,"47192",94,82,81,2,1,"PACMA",0
44,"44234",70,57,57,1,0,"PACMA",0
10,"10001",283,233,232,3,1,"PACMA",0
44,"44042",114,84,84,0,0,"PACMA",0
47,"47005",502,420,414,2,6,"PACMA",3
42,"42083",26,22,22,0,0,"PACMA",0
36,"36016",1064,707,696,7,11,"PACMA",0
21,"21037",459,363,357,4,6,"PACMA",0
28,"28030",1815,1438,1395,10,43,"PACMA",19
37,"37288",276,225,224,5,1,"PACMA",4
19,"19105",2540,2013,1988,13,25,"PACMA",22
10,"10124",858,710,701,3,9,"PACMA",1
40,"40004",445,348,341,0,7,"PACMA",0
21,"21002",15922,11918,11773,119,145,"PACMA",199
37,"37289",218,159,158,0,1,"PACMA",0
14,"14039",2575,2037,1990,14,47,"PACMA",21
13,"13023",8950,6359,6271,76,88,"PACMA",33
46,"46200",1848,1560,1539,6,21,"PACMA",13
19,"19241",35,24,23,2,1,"PACMA",0
49,"49041",414,309,307,4,2,"PACMA",1
24,"24161",295,223,219,0,4,"PACMA",3
5,"5101",277,224,222,0,2,"PACMA",2
49,"49164",139,103,102,2,1,"PACMA",1
5,"5060",109,88,88,0,0,"PACMA",1
15,"15023",6318,4501,4436,40,65,"PACMA",23
49,"49006",142,111,111,1,0,"PACMA",0
44,"44144",325,249,247,1,2,"PACMA",2
46,"46019",8948,7150,7067,40,83,"PACMA",81
11,"11021",4926,3592,3486,50,106,"PACMA",25
46,"46110",21317,15839,15699,89,140,"PACMA",300
36,"36018",3073,2184,2144,9,40,"PACMA",9
50,"50095",12136,9020,8928,99,92,"PACMA",54
22,"22200",239,181,178,0,3,"PACMA",1
50,"50185",136,103,102,0,1,"PACMA",0
45,"45189",616,506,498,2,8,"PACMA",10
4,"4086",1643,1226,1209,6,17,"PACMA",2
19,"19243",36,32,31,0,1,"PACMA",1
23,"23042",317,234,232,1,2,"PACMA",2
10,"10168",320,209,202,1,7,"PACMA",0
34,"34189",53,39,39,1,0,"PACMA",0
40,"40146",238,205,202,0,3,"PACMA",0
25,"25039",261,216,216,1,0,"PACMA",2
47,"47100",119,104,102,2,2,"PACMA",0
27,"27009",2022,1514,1488,17,26,"PACMA",6
28,"28033",4082,3172,3140,13,32,"PACMA",51
37,"37180",68,39,39,1,0,"PACMA",0
9,"9337",114,93,93,0,0,"PACMA",0
22,"22201",266,192,192,2,0,"PACMA",2
45,"45098",2110,1675,1652,6,23,"PACMA",9
46,"46203",3544,2851,2810,21,41,"PACMA",36
44,"44046",43,32,32,0,0,"PACMA",0
37,"37181",264,185,184,1,1,"PACMA",0
28,"28109",1622,1205,1192,3,13,"PACMA",26
41,"41010",4573,3407,3345,27,62,"PACMA",67
20,"20032",8681,6491,6429,22,62,"PACMA",44
28,"28034",370,284,280,0,4,"PACMA",1
47,"47197",867,721,717,2,4,"PACMA",0
44,"44239",22,19,19,0,0,"PACMA",0
22,"22072",194,141,140,0,1,"PACMA",1
24,"24165",327,236,233,1,3,"PACMA",0
10,"10008",1291,1015,997,16,18,"PACMA",3
10,"10171",355,261,255,0,6,"PACMA",2
18,"18045",1060,748,737,10,11,"PACMA",3
10,"10090",494,364,357,6,7,"PACMA",3
47,"47010",14572,12316,12186,102,130,"PACMA",139
49,"49168",93,74,74,0,0,"PACMA",0
43,"43078",843,653,644,4,9,"PACMA",2
31,"31188",296,200,197,0,3,"PACMA",3
13,"13030",120,97,96,0,1,"PACMA",0
11,"11026",4695,3656,3564,18,92,"PACMA",24
31,"31066",812,636,628,10,8,"PACMA",5
44,"44148",76,64,63,0,1,"PACMA",0
36,"36021",12099,9105,8974,85,131,"PACMA",110
48,"48059",400,329,325,0,4,"PACMA",1
31,"31906",2683,2040,2023,28,17,"PACMA",29
43,"43006",676,531,525,4,6,"PACMA",9
42,"42092",62,42,41,1,1,"PACMA",1
37,"37183",386,296,294,4,2,"PACMA",1
19,"19112",53,41,40,1,1,"PACMA",0
31,"31068",2816,2194,2136,17,58,"PACMA",14
3,"3124",460,401,390,2,11,"PACMA",4
1,"1042",907,723,721,4,2,"PACMA",5
5,"5066",439,373,367,2,6,"PACMA",3
24,"24046",899,678,663,7,15,"PACMA",4
39,"39055",1075,836,829,8,7,"PACMA",4
10,"10133",1154,971,955,3,16,"PACMA",1
12,"12079",419,346,336,2,10,"PACMA",0
43,"43153",11092,8327,8291,34,36,"PACMA",142
4,"4091",326,267,266,3,1,"PACMA",1
12,"12048",249,181,175,2,6,"PACMA",0
46,"46115",352,261,260,0,1,"PACMA",0
30,"30006",829,731,727,4,4,"PACMA",6
50,"50190",675,565,553,5,12,"PACMA",1
25,"25245",430,346,342,1,4,"PACMA",1
28,"28037",1578,1196,1180,5,16,"PACMA",10
44,"44243",27,24,23,0,1,"PACMA",0
43,"43080",227,195,195,0,0,"PACMA",1
46,"46116",13608,10792,10731,76,61,"PACMA",179
50,"50101",832,625,614,1,11,"PACMA",7
19,"19250",15,13,13,0,0,"PACMA",0
9,"9179",38,32,32,0,0,"PACMA",0
19,"19115",32,23,23,0,0,"PACMA",0
42,"42094",603,484,475,10,9,"PACMA",2
30,"30007",6484,4774,4727,25,47,"PACMA",69
13,"13034",58768,46017,45585,385,432,"PACMA",458
22,"22206",182,145,145,0,0,"PACMA",0
9,"9289",1379,1002,994,9,8,"PACMA",4
49,"49173",344,220,216,1,4,"PACMA",0
27,"27014",3162,2181,2139,17,42,"PACMA",11
37,"37068",340,256,256,3,0,"PACMA",0
19,"19251",39,31,31,0,0,"PACMA",0
24,"24050",105,88,87,3,1,"PACMA",0
9,"9180",133,104,99,1,5,"PACMA",0
31,"31071",15,13,13,0,0,"PACMA",0
16,"16211",322,233,229,0,4,"PACMA",1
45,"45107",3423,2806,2770,18,36,"PACMA",45
9,"9025",108,73,72,0,1,"PACMA",2
34,"34204",52,41,41,1,0,"PACMA",0
47,"47015",176,136,135,0,1,"PACMA",0
31,"31153",2173,1591,1580,10,11,"PACMA",4
49,"49015",201,157,155,0,2,"PACMA",0
9,"9350",430,340,339,9,1,"PACMA",1
50,"50017",1779,1386,1373,14,13,"PACMA",14
50,"50277",49,37,37,3,0,"PACMA",0
47,"47109",171,130,130,1,0,"PACMA",1
11,"11031",76294,54123,53583,589,540,"PACMA",1141
16,"16039",367,263,262,2,1,"PACMA",2
21,"21050",12522,8425,8312,84,113,"PACMA",75
5,"5112",95,66,64,2,2,"PACMA",0
25,"25046",407,349,347,1,2,"PACMA",2
37,"37302",262,182,181,2,1,"PACMA",0
38,"38026",33514,26298,26076,191,222,"PACMA",320
46,"46210",344,265,258,2,7,"PACMA",3
46,"46119",752,627,614,8,13,"PACMA",11
9,"9351",62,51,50,1,1,"PACMA",1
49,"49056",288,232,230,2,2,"PACMA",0
33,"33025",8996,6369,6309,81,60,"PACMA",42
19,"19255",72,51,51,0,0,"PACMA",1
46,"46028",388,324,319,1,5,"PACMA",0
11,"11033",21702,14645,14436,190,209,"PACMA",223
44,"44153",1749,1264,1243,11,21,"PACMA",4
21,"21014",4065,3192,3148,22,44,"PACMA",12
7,"7064",5528,3793,3765,23,28,"PACMA",60
43,"43010",337,286,284,2,2,"PACMA",0
47,"47206",78,64,64,0,0,"PACMA",0
46,"46211",1837,1490,1462,11,28,"PACMA",28
31,"31197",65,56,56,0,0,"PACMA",0
14,"14050",2352,1840,1801,11,39,"PACMA",16
36,"36028",4069,3012,2960,27,52,"PACMA",25
37,"37303",181,137,137,1,0,"PACMA",1
18,"18088",1530,1152,1142,0,10,"PACMA",5
45,"45112",1841,1250,1220,7,30,"PACMA",5
33,"33027",769,505,497,14,8,"PACMA",3
28,"28117",98,89,87,2,2,"PACMA",2
49,"49058",298,244,242,1,2,"PACMA",0
16,"16085",135,109,109,1,0,"PACMA",2
50,"50195",53,42,41,0,1,"PACMA",0
27,"27018",3232,2114,2089,24,25,"PACMA",10
9,"9133",38,33,33,0,0,"PACMA",0
24,"24016",507,314,311,2,3,"PACMA",0
9,"9242",66,53,53,1,0,"PACMA",0
47,"47018",36,31,29,0,2,"PACMA",0
20,"20041",234,156,151,2,5,"PACMA",0
41,"41018",9410,6987,6882,52,105,"PACMA",72
4,"4099",4931,3781,3719,24,62,"PACMA",20
6,"6065",298,258,255,1,3,"PACMA",0
18,"18901",488,335,329,2,6,"PACMA",1
10,"10019",1416,1120,1094,3,26,"PACMA",0
43,"43011",1079,912,909,1,3,"PACMA",10
21,"21054",8157,6002,5869,60,133,"PACMA",40
5,"5232",106,87,84,1,3,"PACMA",1
48,"48067",1134,877,872,5,5,"PACMA",5
29,"29028",1224,875,858,4,17,"PACMA",3
26,"26089",111800,87863,86778,700,1085,"PACMA",734
16,"16087",226,191,184,3,7,"PACMA",0
50,"50196",102,83,81,2,2,"PACMA",0
35,"35032",3348,2585,2542,20,43,"PACMA",24
50,"50224",65,54,54,1,0,"PACMA",0
26,"26170",427,343,338,2,5,"PACMA",0
41,"41076",2143,1419,1403,14,16,"PACMA",7
50,"50139",322,257,256,0,1,"PACMA",0
46,"46123",1948,1469,1446,5,23,"PACMA",27
41,"41020",12992,8679,8524,117,155,"PACMA",51
26,"26091",147,132,131,1,1,"PACMA",0
48,"48069",13094,10021,9954,49,67,"PACMA",76
43,"43159",81,63,62,0,1,"PACMA",0
45,"45116",680,547,537,4,10,"PACMA",5
19,"19261",32,24,24,0,0,"PACMA",0
16,"16219",81,64,63,0,1,"PACMA",0
19,"19125",40,28,28,0,0,"PACMA",0
22,"22084",555,438,433,5,5,"PACMA",7
25,"25051",1510,1176,1172,6,4,"PACMA",14
24,"24178",72,65,65,1,0,"PACMA",0
25,"25183",535,419,416,4,3,"PACMA",6
25,"25254",711,576,571,5,5,"PACMA",2
44,"44059",550,446,437,7,9,"PACMA",2
7,"7003",12374,7550,7442,51,108,"PACMA",136
10,"10023",791,619,614,1,5,"PACMA",1
50,"50283",69,53,52,3,1,"PACMA",1
40,"40055",32,26,25,0,1,"PACMA",0
20,"20044",364,263,262,0,1,"PACMA",3
31,"31081",334,259,256,7,3,"PACMA",0
9,"9361",112,94,94,1,0,"PACMA",2
9,"9195",55,45,45,1,0,"PACMA",1
47,"47116",403,321,320,3,1,"PACMA",1
45,"45118",2088,1562,1540,11,22,"PACMA",23
31,"31082",623,433,433,3,0,"PACMA",2
26,"26093",48,38,38,0,0,"PACMA",0
2,"2027",283,239,238,3,1,"PACMA",4
26,"26094",69,56,56,0,0,"PACMA",0
49,"49065",1073,789,777,3,12,"PACMA",4
21,"21058",2556,1732,1709,21,23,"PACMA",6
24,"24180",1101,844,833,8,11,"PACMA",8
9,"9362",205,177,177,3,0,"PACMA",0
42,"42110",55,43,43,0,0,"PACMA",0
45,"45074",401,335,326,3,9,"PACMA",0
31,"31083",50,41,41,1,0,"PACMA",2
50,"50284",132,105,104,1,1,"PACMA",0
40,"40057",1405,1176,1163,10,13,"PACMA",6
10,"10025",379,328,317,3,11,"PACMA",1
16,"16228",176,150,150,1,0,"PACMA",0
28,"28048",504,399,392,6,7,"PACMA",6
30,"30017",11477,8952,8844,62,108,"PACMA",89
20,"20046",1248,918,909,11,9,"PACMA",8
24,"24062",130,90,90,2,0,"PACMA",0
43,"43138",2648,1926,1896,8,30,"PACMA",15
39,"39038",1506,1093,1076,2,17,"PACMA",9
32,"32010",360,276,273,3,3,"PACMA",1
46,"46218",1031,907,885,6,22,"PACMA",11
19,"19130",61365,49363,48747,383,616,"PACMA",464
9,"9365",27,19,19,1,0,"PACMA",0
23,"23059",5728,4259,4187,18,72,"PACMA",40
39,"39066",877,711,705,5,6,"PACMA",5
9,"9041",26,26,26,1,0,"PACMA",0
40,"40058",309,277,271,0,6,"PACMA",0
36,"36035",14571,11096,10917,105,179,"PACMA",116
6,"6072",2225,1777,1752,20,25,"PACMA",8
9,"9043",186,128,128,1,0,"PACMA",0
37,"37314",82,72,68,0,4,"PACMA",0
37,"37163",32,27,27,0,0,"PACMA",0
22,"22221",90,58,56,0,2,"PACMA",0
29,"29035",1505,1151,1133,6,18,"PACMA",2
43,"43090",1169,749,742,2,7,"PACMA",21
47,"47025",114,98,98,0,0,"PACMA",0
33,"33034",10043,6765,6671,69,94,"PACMA",47
46,"46128",1581,1324,1287,2,37,"PACMA",10
39,"39067",759,582,575,3,7,"PACMA",2
9,"9200",58,40,40,0,0,"PACMA",0
3,"3045",213,178,173,4,5,"PACMA",0
22,"22222",517,407,398,5,9,"PACMA",4
15,"15074",3919,2865,2808,33,57,"PACMA",29
5,"5125",56,47,43,0,4,"PACMA",0
7,"7008",6047,4570,4513,31,57,"PACMA",53
5,"5001",179,153,152,2,1,"PACMA",0
40,"40166",253,214,213,1,1,"PACMA",2
41,"41099",3968,2666,2642,23,24,"PACMA",32
43,"43017",116,98,98,1,0,"PACMA",1
37,"37316",716,576,565,4,11,"PACMA",1
28,"28051",1640,1301,1292,9,9,"PACMA",27
30,"30020",6431,4991,4940,19,51,"PACMA",25
24,"24065",2175,1695,1660,18,35,"PACMA",17
13,"13054",4914,3946,3890,31,56,"PACMA",20
18,"18909",539,432,426,1,6,"PACMA",0
42,"42207",47,41,41,0,0,"PACMA",0
42,"42117",133,109,106,0,3,"PACMA",0
36,"36037",2554,1839,1793,6,46,"PACMA",26
13,"13055",615,475,465,5,10,"PACMA",0
28,"28126",47,35,35,0,0,"PACMA",2
48,"48075",2067,1591,1565,11,26,"PACMA",6
9,"9372",204,176,175,1,1,"PACMA",2
50,"50028",77,59,58,1,1,"PACMA",1
41,"41100",967,765,727,8,38,"PACMA",5
25,"25058",4358,3269,3254,7,15,"PACMA",23
3,"3047",9711,6910,6791,36,119,"PACMA",110
16,"16098",520,441,439,6,2,"PACMA",5
13,"13056",11657,9236,9142,85,94,"PACMA",99
33,"33037",33247,23529,23210,297,319,"PACMA",272
28,"28127",66441,56199,55932,327,267,"PACMA",678
19,"19271",41,26,26,0,0,"PACMA",0
44,"44165",173,136,135,2,1,"PACMA",0
18,"18101",9410,7280,7181,72,99,"PACMA",106
46,"46131",49504,37495,37064,259,431,"PACMA",677
25,"25158",1606,1291,1277,5,14,"PACMA",11
39,"39070",123,101,99,0,2,"PACMA",1
43,"43068",483,367,365,5,2,"PACMA",0
28,"28095",1677,1310,1293,4,17,"PACMA",25
22,"22226",771,598,591,6,7,"PACMA",6
22,"22095",65,57,56,1,1,"PACMA",0
16,"16099",184,126,121,0,5,"PACMA",1
45,"45129",109,84,83,0,1,"PACMA",0
10,"10155",1082,825,819,4,6,"PACMA",0
18,"18001",230,173,170,1,3,"PACMA",0
50,"50002",125,96,91,1,5,"PACMA",0
9,"9375",42,38,38,0,0,"PACMA",1
31,"31213",100,69,68,0,1,"PACMA",0
9,"9050",52,36,36,0,0,"PACMA",0
7,"7045",1300,1038,1030,6,8,"PACMA",15
37,"37206",91,66,63,1,3,"PACMA",0
32,"32044",809,625,617,2,8,"PACMA",7
10,"10157",245,185,185,1,0,"PACMA",1
34,"34079",1715,1421,1402,10,19,"PACMA",22
45,"45130",302,241,235,2,6,"PACMA",0
5,"5130",94,86,86,0,0,"PACMA",0
10,"10035",1806,1320,1282,12,38,"PACMA",5
16,"16242",308,266,263,2,3,"PACMA",1
3,"3904",1420,1112,1095,5,17,"PACMA",13
46,"46042",3348,2825,2774,11,51,"PACMA",15
39,"39072",324,206,204,4,2,"PACMA",1
41,"41001",1565,1224,1213,8,11,"PACMA",7
3,"3050",19334,14377,14253,71,124,"PACMA",214
37,"37091",164,108,108,3,0,"PACMA",0
12,"12004",4177,3225,3187,13,38,"PACMA",34
18,"18002",526,400,400,0,0,"PACMA",1
9,"9052",29,17,17,1,0,"PACMA",0
14,"14064",300,231,227,6,4,"PACMA",0
50,"50292",129,113,113,1,0,"PACMA",0
46,"46225",348,279,273,2,6,"PACMA",6
43,"43095",2564,1995,1984,14,11,"PACMA",36
18,"18105",3822,2688,2650,12,38,"PACMA",24
36,"36042",18072,13314,13091,130,223,"PACMA",151
40,"40174",324,254,250,2,4,"PACMA",1
28,"28056",914,715,703,4,12,"PACMA",10
4,"4001",1014,768,763,9,5,"PACMA",12
28,"28131",13432,10500,10387,81,113,"PACMA",147
21,"21069",1667,1214,1198,13,16,"PACMA",5
31,"31095",72,61,60,0,1,"PACMA",1
9,"9380",73,53,53,0,0,"PACMA",0
26,"26106",76,66,65,0,1,"PACMA",0
30,"30026",16252,11142,10977,65,165,"PACMA",131
29,"29043",2474,1764,1720,25,44,"PACMA",20
13,"13063",3652,2692,2649,32,43,"PACMA",10
46,"46105",16132,11703,11582,64,121,"PACMA",127
12,"12070",499,434,430,3,4,"PACMA",1
28,"28057",1549,1246,1239,5,7,"PACMA",34
6,"6081",1042,825,811,4,14,"PACMA",1
7,"7015",21976,14458,14297,205,161,"PACMA",251
25,"25165",276,221,219,1,2,"PACMA",0
34,"34083",1664,1244,1229,10,15,"PACMA",7
9,"9216",374,283,281,2,2,"PACMA",4
23,"23037",520,431,425,6,6,"PACMA",3
28,"28133",6116,4581,4486,22,95,"PACMA",73
21,"21071",211,155,152,3,3,"PACMA",0
39,"39075",136968,104358,103487,690,871,"PACMA",923
22,"22232",87,66,65,2,1,"PACMA",0
43,"43023",214,186,186,1,0,"PACMA",1
31,"31220",742,620,615,2,5,"PACMA",4
9,"9057",148,120,116,0,4,"PACMA",0
32,"32047",1746,1272,1252,6,20,"PACMA",10
20,"20057",194,143,143,0,0,"PACMA",0
26,"26033",163,143,142,3,1,"PACMA",1
9,"9218",347,277,271,0,6,"PACMA",1
41,"41033",4965,3634,3580,27,54,"PACMA",26
45,"45092",223,204,204,1,0,"PACMA",0
46,"46198",871,707,693,4,14,"PACMA",27
50,"50295",49,46,46,0,0,"PACMA",0
43,"43073",84,68,67,0,1,"PACMA",3
31,"31099",49,43,43,0,0,"PACMA",1
43,"43098",354,291,291,1,0,"PACMA",4
25,"25202",108,75,75,0,0,"PACMA",5
47,"47034",72,57,57,1,0,"PACMA",1
9,"9386",55,49,49,0,0,"PACMA",0
37,"37212",101,85,83,0,2,"PACMA",0
32,"32049",689,468,462,3,6,"PACMA",1
37,"37327",179,154,150,0,4,"PACMA",1
42,"42129",678,540,539,1,1,"PACMA",2
40,"40178",90,63,63,1,0,"PACMA",0
20,"20058",739,555,551,4,4,"PACMA",4
47,"47225",74,61,60,0,1,"PACMA",1
34,"34087",122,105,105,0,0,"PACMA",0
50,"50211",237,177,173,0,4,"PACMA",0
40,"40073",385,339,335,6,4,"PACMA",0
45,"45139",145,118,117,1,1,"PACMA",1
10,"10042",88,59,59,0,0,"PACMA",0
44,"44174",409,306,300,3,6,"PACMA",0
34,"34046",44,31,31,0,0,"PACMA",0
24,"24079",872,671,665,4,6,"PACMA",3
16,"16249",1938,1544,1529,13,15,"PACMA",5
25,"25912",843,685,684,4,1,"PACMA",5
33,"33045",4382,3214,3156,23,58,"PACMA",22
16,"16110",91,80,80,0,0,"PACMA",0
5,"5139",66,59,59,0,0,"PACMA",0
13,"13069",618,488,469,3,19,"PACMA",2
37,"37101",142,119,117,0,2,"PACMA",0
37,"37102",379,297,291,3,6,"PACMA",0
18,"18181",202,150,148,0,2,"PACMA",0
31,"31061",48,46,46,0,0,"PACMA",0
34,"34185",68,53,51,1,2,"PACMA",2
13,"13070",766,620,604,6,16,"PACMA",0
21,"21076",2142,1573,1551,24,22,"PACMA",8
23,"23073",4389,3400,3363,13,37,"PACMA",23
14,"14070",1284,988,969,5,19,"PACMA",0
22,"22110",707,531,528,2,3,"PACMA",4
30,"30031",500,435,433,3,2,"PACMA",4
26,"26001",198,171,165,1,6,"PACMA",0
50,"50038",1405,1112,1099,13,13,"PACMA",8
4,"4008",464,386,383,4,3,"PACMA",2
37,"37216",294,248,247,2,1,"PACMA",0
46,"46232",872,714,706,3,8,"PACMA",4
44,"44176",153,124,124,0,0,"PACMA",0
37,"37331",188,130,130,1,0,"PACMA",0
40,"40075",153,128,127,0,1,"PACMA",0
33,"33047",1074,841,835,12,6,"PACMA",5
16,"16253",308,250,249,2,1,"PACMA",0
23,"23074",2971,2410,2378,8,32,"PACMA",16
9,"9391",361,286,283,3,3,"PACMA",1
4,"4010",580,445,434,2,11,"PACMA",4
5,"5259",106,87,87,0,0,"PACMA",0
28,"28138",63,49,49,0,0,"PACMA",0
9,"9225",81,62,62,0,0,"PACMA",0
10,"10046",187,154,152,0,2,"PACMA",0
45,"45144",740,605,598,7,7,"PACMA",3
46,"46233",3781,2901,2847,22,54,"PACMA",41
37,"37218",48,29,29,0,0,"PACMA",0
22,"22242",63,47,45,1,2,"PACMA",0
19,"19006",757,556,548,7,8,"PACMA",4
36,"36050",7650,5616,5506,48,110,"PACMA",47
47,"47135",82,69,67,1,2,"PACMA",0
31,"31228",494,383,382,0,1,"PACMA",5
21,"21079",687,503,500,5,3,"PACMA",3
12,"12105",816,639,625,5,14,"PACMA",1
37,"37333",202,138,137,4,1,"PACMA",0
18,"18115",2650,1988,1975,20,13,"PACMA",16
9,"9227",113,93,91,0,2,"PACMA",1
44,"44147",398,293,286,3,7,"PACMA",7
5,"5105",336,272,266,2,6,"PACMA",0
16,"16072",133,96,95,1,1,"PACMA",0
42,"42009",77,69,69,2,0,"PACMA",0
50,"50040",86,71,71,0,0,"PACMA",1
33,"33050",558,381,375,2,6,"PACMA",0
24,"24086",266,211,210,0,1,"PACMA",2
2,"2050",90,75,75,0,0,"PACMA",0
28,"28065",130679,106997,105975,762,1022,"PACMA",1518
50,"50216",240,189,181,3,8,"PACMA",0
22,"22243",39,28,28,0,0,"PACMA",0
37,"37334",73,49,49,0,0,"PACMA",0
49,"49210",448,372,370,3,2,"PACMA",3
5,"5262",323,254,254,0,0,"PACMA",0
22,"22001",214,162,162,0,0,"PACMA",0
16,"16116",77,59,59,0,0,"PACMA",0
43,"43104",1762,1410,1401,5,9,"PACMA",12
43,"43177",284,243,242,0,1,"PACMA",3
10,"10173",558,445,439,0,6,"PACMA",4
5,"5222",152,111,109,0,2,"PACMA",0
46,"46023",328,277,269,1,8,"PACMA",8
9,"9343",93,73,72,1,1,"PACMA",0
45,"45149",539,448,440,0,8,"PACMA",2
18,"18015",425,333,333,0,0,"PACMA",1
46,"46054",11390,8717,8604,52,113,"PACMA",145
31,"31109",1664,1290,1283,10,7,"PACMA",10
27,"27044",2719,1848,1797,29,51,"PACMA",7
49,"49094",213,138,138,0,0,"PACMA",1
5,"5224",100,91,90,1,1,"PACMA",0
23,"23079",3639,2859,2818,20,41,"PACMA",9
46,"46146",1641,1314,1281,11,33,"PACMA",17
24,"24210",527,387,386,0,1,"PACMA",0
34,"34099",52,45,41,0,4,"PACMA",0
5,"5147",147,119,117,0,2,"PACMA",2
4,"4015",118,97,97,2,0,"PACMA",2
45,"45013",1671,1320,1298,4,22,"PACMA",5
47,"47139",1004,790,776,2,14,"PACMA",1
16,"16119",179,128,128,0,0,"PACMA",0
19,"19013",114,99,99,0,0,"PACMA",0
49,"49216",147,122,114,0,8,"PACMA",0
24,"24211",263,219,214,3,5,"PACMA",1
26,"26121",30,21,21,1,0,"PACMA",0
9,"9403",103,90,89,0,1,"PACMA",0
25,"25075",131,102,102,0,0,"PACMA",1
13,"13080",321,246,246,1,0,"PACMA",0
5,"5225",353,300,297,2,3,"PACMA",1
37,"37225",99,90,86,1,4,"PACMA",0
45,"45014",4020,2910,2854,22,56,"PACMA",30
26,"26122",116,98,97,0,1,"PACMA",0
25,"25076",134,94,93,0,1,"PACMA",0
4,"4017",1276,907,900,4,7,"PACMA",4
18,"18017",18148,12712,12523,96,189,"PACMA",163
13,"13081",590,449,440,0,9,"PACMA",2
37,"37338",78,66,64,0,2,"PACMA",0
5,"5266",102,79,78,0,1,"PACMA",0
37,"37339",308,227,226,0,1,"PACMA",1
47,"47141",118,103,102,0,1,"PACMA",0
34,"34101",45,39,38,0,1,"PACMA",1
46,"46148",1509,1208,1195,7,13,"PACMA",21
22,"22004",124,90,88,1,2,"PACMA",0
49,"49221",234,138,130,1,8,"PACMA",1
22,"22119",1256,963,954,5,9,"PACMA",2
19,"19167",129,104,102,0,2,"PACMA",0
39,"39002",3414,2630,2578,23,52,"PACMA",11
47,"47142",124,94,92,0,2,"PACMA",0
12,"12111",334,283,279,4,4,"PACMA",1
50,"50134",118,91,89,0,2,"PACMA",0
36,"36056",4961,3719,3635,30,84,"PACMA",27
12,"12018",283,242,235,0,7,"PACMA",0
2,"2056",1643,1330,1308,4,22,"PACMA",9
13,"13083",2392,1772,1714,13,58,"PACMA",7
31,"31114",374,291,286,4,5,"PACMA",2
46,"46058",1734,1349,1325,9,24,"PACMA",5
23,"23084",907,685,670,0,15,"PACMA",0
10,"10056",532,434,428,3,6,"PACMA",1
31,"31237",186,151,149,1,2,"PACMA",0
47,"47143",110,78,78,1,0,"PACMA",0
3,"3066",41802,31046,30696,285,350,"PACMA",466
12,"12020",120,107,107,0,0,"PACMA",0
31,"31115",160,116,116,3,0,"PACMA",0
5,"5035",96,78,78,0,0,"PACMA",0
41,"41045",5854,4287,4200,58,87,"PACMA",56
22,"22249",118,93,93,2,0,"PACMA",0
35,"35001",4571,3523,3463,8,60,"PACMA",35
50,"50046",167,134,130,3,4,"PACMA",0
28,"28072",6088,5001,4961,23,40,"PACMA",75
24,"24216",671,504,502,3,2,"PACMA",1
5,"5154",34,25,25,1,0,"PACMA",0
24,"24094",1326,982,966,4,16,"PACMA",8
23,"23085",2182,1733,1717,7,16,"PACMA",11
29,"29060",671,511,506,1,5,"PACMA",0
46,"46151",757,586,579,0,7,"PACMA",10
19,"19019",14,10,10,0,0,"PACMA",0
12,"12021",4377,3528,3473,23,55,"PACMA",33
43,"43904",2861,2083,2058,27,25,"PACMA",11
50,"50047",43,32,31,1,1,"PACMA",0
5,"5903",138,94,92,0,2,"PACMA",0
44,"44187",193,155,151,1,4,"PACMA",0
46,"46060",9287,7184,7110,40,74,"PACMA",98
32,"32089",1220,872,857,15,15,"PACMA",2
25,"25081",287,221,220,2,1,"PACMA",5
10,"10059",325,234,232,1,2,"PACMA",0
33,"33058",1664,1205,1176,5,29,"PACMA",4
42,"42019",511,384,378,7,6,"PACMA",0
7,"7033",28373,17884,17684,201,200,"PACMA",264
5,"5904",112,81,81,3,0,"PACMA",2
24,"24218",444,343,341,6,2,"PACMA",3
4,"4022",357,261,261,0,0,"PACMA",1
28,"28151",3251,2483,2450,11,33,"PACMA",30
45,"45159",85,75,74,0,1,"PACMA",0
33,"33059",4403,3007,2942,42,65,"PACMA",14
19,"19172",50,35,35,1,0,"PACMA",0
46,"46061",343,285,280,4,5,"PACMA",6
31,"31118",158,120,116,2,4,"PACMA",1
48,"48901",5151,4042,4012,22,30,"PACMA",35
22,"22011",97,78,75,2,3,"PACMA",0
31,"31038",1336,992,981,8,11,"PACMA",1
46,"46062",4572,3571,3510,20,61,"PACMA",38
37,"37194",237,182,181,0,1,"PACMA",0
34,"34020",51,38,38,0,0,"PACMA",1
19,"19173",51,47,47,0,0,"PACMA",2
43,"43111",2098,1496,1483,8,13,"PACMA",32
10,"10184",740,607,597,5,10,"PACMA",1
45,"45161",15266,11185,11023,69,162,"PACMA",222
16,"16129",90,78,77,0,1,"PACMA",0
37,"37120",97,83,81,1,2,"PACMA",0
10,"10185",573,463,460,3,3,"PACMA",2
9,"9414",181,148,146,0,2,"PACMA",0
28,"28152",16839,14205,14151,87,54,"PACMA",196
35,"35005",1017,751,743,1,8,"PACMA",3
34,"34110",82,66,65,0,1,"PACMA",0
9,"9083",27,24,23,0,1,"PACMA",0
4,"4026",55,46,45,1,1,"PACMA",0
19,"19174",91,69,69,0,0,"PACMA",0
33,"33061",350,201,200,2,1,"PACMA",1
26,"26131",34,34,34,1,0,"PACMA",1
37,"37122",203,174,174,1,0,"PACMA",0
45,"45025",1219,926,913,5,13,"PACMA",18
50,"50227",110,74,73,2,1,"PACMA",0
5,"5159",228,160,159,2,1,"PACMA",1
16,"16276",21,18,18,1,0,"PACMA",1
31,"31122",4946,3915,3882,59,33,"PACMA",35
47,"47148",423,342,339,2,3,"PACMA",1
37,"37347",464,368,359,2,9,"PACMA",3
16,"16277",109,82,82,0,0,"PACMA",0
34,"34112",39,30,30,0,0,"PACMA",0
50,"50140",157,108,108,0,0,"PACMA",0
48,"48010",474,368,368,0,0,"PACMA",1
39,"39093",302,256,256,2,0,"PACMA",2
4,"4027",226,147,147,1,0,"PACMA",4
45,"45027",327,276,273,0,3,"PACMA",0
22,"22014",233,185,182,3,3,"PACMA",1
28,"28155",485,414,409,0,5,"PACMA",0
23,"23092",27662,21206,20981,170,225,"PACMA",218
34,"34113",40,37,37,0,0,"PACMA",1
18,"18027",2604,1902,1887,6,15,"PACMA",20
16,"16278",63,51,51,0,0,"PACMA",0
6,"6004",1549,1276,1257,6,19,"PACMA",8
22,"22015",300,232,226,5,6,"PACMA",0
44,"44001",65,51,50,0,1,"PACMA",0
40,"40092",113,86,84,2,2,"PACMA",0
15,"15009",10615,8066,7919,93,147,"PACMA",74
9,"9250",259,215,214,1,1,"PACMA",6
47,"47150",259,206,202,0,4,"PACMA",0
18,"18906",911,722,716,4,6,"PACMA",1
31,"31084",1948,1483,1472,9,11,"PACMA",5
12,"12091",176,131,130,0,1,"PACMA",1
6,"6104",656,530,524,6,6,"PACMA",4
42,"42026",22,20,20,0,0,"PACMA",0
32,"32066",551,399,396,1,3,"PACMA",0
22,"22131",83,65,65,0,0,"PACMA",1
24,"24225",992,762,751,5,11,"PACMA",6
39,"39094",841,676,670,3,6,"PACMA",4
19,"19179",76,66,64,1,2,"PACMA",0
13,"13096",7533,5766,5696,43,70,"PACMA",38
50,"50054",56,48,47,0,1,"PACMA",0
40,"40200",38,32,31,0,1,"PACMA",0
47,"47151",28,22,22,0,0,"PACMA",1
15,"15011",15481,11249,11037,105,212,"PACMA",137
22,"22904",761,581,566,2,15,"PACMA",4
41,"41052",3027,2357,2288,14,69,"PACMA",23
23,"23094",3729,3111,3077,16,34,"PACMA",15
13,"13097",2205,1764,1742,6,22,"PACMA",8
24,"24226",193,136,134,2,2,"PACMA",0
40,"40201",43,39,37,0,2,"PACMA",0
22,"22133",108,85,83,1,2,"PACMA",0
33,"33065",1084,761,746,18,15,"PACMA",5
43,"43041",228,179,177,3,2,"PACMA",0
31,"31127",135,96,96,0,0,"PACMA",0
25,"25092",127,101,99,1,2,"PACMA",3
3,"3075",149,125,125,0,0,"PACMA",3
18,"18135",4434,3169,3105,23,64,"PACMA",26
43,"43115",128,112,111,1,1,"PACMA",1
43,"43116",463,381,379,2,2,"PACMA",4
47,"47057",273,204,200,0,4,"PACMA",1
22,"22135",174,132,132,5,0,"PACMA",0
16,"16012",77,65,65,0,0,"PACMA",0
27,"27058",3322,2551,2512,22,39,"PACMA",11
31,"31128",341,255,250,3,5,"PACMA",1
44,"44102",27,22,22,0,0,"PACMA",0
28,"28159",594,493,491,5,2,"PACMA",8
37,"37005",67,48,48,2,0,"PACMA",0
31,"31129",384,260,259,0,1,"PACMA",1
16,"16013",26,21,20,0,1,"PACMA",0
42,"42030",89,72,72,0,0,"PACMA",0
15,"15013",6299,4549,4486,45,63,"PACMA",61
40,"40203",958,801,788,6,13,"PACMA",8
45,"45034",1291,1066,1039,7,27,"PACMA",2
23,"23096",2571,2099,2063,9,36,"PACMA",9
4,"4034",165,107,106,1,1,"PACMA",1
1,"1019",148,121,121,0,0,"PACMA",0
22,"22019",175,151,151,0,0,"PACMA",2
9,"9258",171,142,141,2,1,"PACMA",0
37,"37007",399,311,306,3,5,"PACMA",1
10,"10072",835,632,625,3,7,"PACMA",3
49,"49114",40,33,32,1,1,"PACMA",0
45,"45173",9729,7664,7558,46,106,"PACMA",55
10,"10195",7557,5790,5691,38,99,"PACMA",40
48,"48016",5437,4282,4248,21,34,"PACMA",46
9,"9425",476,366,362,1,4,"PACMA",0
26,"26026",1265,1061,1049,2,12,"PACMA",6
16,"16141",130,105,105,0,0,"PACMA",1
42,"42031",26,19,19,1,0,"PACMA",0
16,"16015",351,251,250,4,1,"PACMA",0
34,"34124",63,58,58,0,0,"PACMA",0
35,"35012",10765,6327,6270,32,57,"PACMA",88
19,"19186",78,67,67,0,0,"PACMA",0
44,"44007",152,120,117,0,3,"PACMA",0
19,"19323",34,29,29,0,0,"PACMA",0
15,"15015",2883,2079,2049,21,30,"PACMA",19
28,"28161",51559,41390,40922,255,468,"PACMA",701
50,"50234",242,194,187,3,7,"PACMA",0
31,"31010",5728,4211,4153,30,58,"PACMA",29
4,"4036",223,188,186,1,2,"PACMA",3
9,"9427",1364,1002,972,13,30,"PACMA",11
31,"31132",148,121,121,2,0,"PACMA",1
28,"28162",2771,2264,2243,6,21,"PACMA",34
25,"25194",415,325,325,3,0,"PACMA",2
45,"45038",3505,2749,2705,16,44,"PACMA",53
5,"5169",219,176,173,1,3,"PACMA",0
9,"9262",158,137,136,1,1,"PACMA",1
16,"16906",71,52,52,1,0,"PACMA",0
31,"31011",709,515,511,4,4,"PACMA",1
22,"22909",301,233,231,4,2,"PACMA",0
4,"4037",1221,975,960,8,15,"PACMA",2
27,"27062",584,467,466,3,1,"PACMA",0
49,"49239",617,437,420,7,17,"PACMA",1
6,"6012",3233,2515,2492,15,23,"PACMA",9
19,"19043",99,87,84,2,3,"PACMA",0
5,"5170",50,38,38,0,0,"PACMA",0
4,"4038",3110,2235,2203,23,32,"PACMA",20
37,"37010",923,739,735,2,4,"PACMA",0
12,"12036",546,428,420,9,8,"PACMA",1
5,"5053",80,57,57,2,0,"PACMA",0
47,"47061",243,203,197,3,6,"PACMA",0
1,"1023",262,210,206,3,4,"PACMA",1
41,"41058",17860,12850,12598,152,252,"PACMA",176
12,"12126",24347,19023,18749,152,274,"PACMA",180
42,"42035",741,537,523,7,14,"PACMA",2
7,"7047",2371,1775,1747,13,28,"PACMA",17
43,"43120",421,302,297,2,5,"PACMA",3
39,"39017",553,416,409,0,7,"PACMA",1
16,"16019",185,147,147,0,0,"PACMA",1
1,"1027",430,295,293,2,2,"PACMA",5
40,"40104",284,229,224,2,5,"PACMA",2
16,"16910",78,54,54,1,0,"PACMA",0
37,"37248",152,125,121,1,4,"PACMA",1
18,"18037",528,435,426,2,9,"PACMA",9
3,"3082",12936,9025,8931,57,94,"PACMA",121
1,"1028",1068,774,772,7,2,"PACMA",13
37,"37135",1163,934,924,8,10,"PACMA",1
44,"44201",478,417,412,3,5,"PACMA",3
45,"45181",2337,1846,1818,7,28,"PACMA",5
42,"42173",29702,22141,21776,301,365,"PACMA",138
3,"3083",5487,3993,3934,28,59,"PACMA",49
46,"46045",1243,1033,1018,3,15,"PACMA",10
9,"9108",432,332,326,1,6,"PACMA",6
43,"43121",591,463,462,0,1,"PACMA",0
43,"43047",4209,2878,2856,23,22,"PACMA",54
25,"25100",184,145,144,1,1,"PACMA",2
9,"9433",58,51,50,1,1,"PACMA",1
4,"4044",1533,1190,1176,8,14,"PACMA",14
34,"34131",58,51,51,0,0,"PACMA",0
45,"45045",1331,1001,990,2,11,"PACMA",11
37,"37014",1153,414,411,4,3,"PACMA",0
44,"44267",71,53,52,0,1,"PACMA",0
14,"14067",3870,3057,2998,24,59,"PACMA",24
9,"9270",159,119,117,4,2,"PACMA",1
18,"18005",362,268,265,0,3,"PACMA",1
5,"5135",398,324,320,2,4,"PACMA",0
23,"23004",421,356,355,2,1,"PACMA",3
25,"25004",575,470,467,2,3,"PACMA",3
12,"12128",1362,1099,1076,9,23,"PACMA",9
49,"49121",368,269,266,1,3,"PACMA",1
9,"9010",32,27,27,1,0,"PACMA",0
44,"44111",78,64,64,1,0,"PACMA",0
6,"6017",257,211,210,1,1,"PACMA",0
25,"25101",543,454,449,1,5,"PACMA",5
43,"43049",727,589,584,2,5,"PACMA",2
43,"43123",71092,53689,53369,241,320,"PACMA",979
50,"50064",438,368,362,1,6,"PACMA",0
42,"42041",31,23,23,1,0,"PACMA",1
31,"31140",115,83,83,2,0,"PACMA",0
16,"16024",123,96,95,0,1,"PACMA",0
34,"34134",40,31,31,1,0,"PACMA",0
40,"40108",110,91,90,0,1,"PACMA",0
4,"4046",848,653,649,5,4,"PACMA",4
25,"25203",8798,6279,6231,26,48,"PACMA",70
27,"27901",2275,1542,1531,27,11,"PACMA",6
1,"1033",656,533,525,1,8,"PACMA",3
34,"34088",264,211,207,1,4,"PACMA",4
22,"22151",88,66,65,0,1,"PACMA",0
37,"37253",133,107,103,0,4,"PACMA",0
37,"37139",187,162,157,2,5,"PACMA",0
44,"44112",408,303,293,2,10,"PACMA",1
2,"2081",18331,14219,13987,108,232,"PACMA",104
44,"44014",2499,2015,1963,25,52,"PACMA",19
48,"48024",999,813,811,2,2,"PACMA",3
45,"45187",3976,3365,3308,24,57,"PACMA",18
41,"41063",2713,1988,1944,17,44,"PACMA",18
49,"49247",417,301,294,0,7,"PACMA",1
50,"50009",97,72,71,1,1,"PACMA",0
25,"25204",1191,936,930,5,6,"PACMA",4
42,"42132",135,114,113,1,1,"PACMA",0
48,"48025",860,694,694,3,0,"PACMA",6
34,"34136",149,105,102,0,3,"PACMA",1
24,"24119",695,515,501,8,14,"PACMA",1
14,"14009",2669,1863,1844,19,19,"PACMA",11
29,"29070",43090,30294,29928,243,366,"PACMA",791
37,"37254",175,141,140,1,1,"PACMA",0
26,"26037",131,99,98,1,1,"PACMA",0
9,"9441",92,81,81,1,0,"PACMA",2
6,"6020",1739,1420,1387,5,33,"PACMA",5
19,"19052",21,16,16,0,0,"PACMA",0
2,"2082",95,83,83,0,0,"PACMA",0
47,"47164",350,290,286,2,4,"PACMA",0
49,"49126",273,161,160,1,1,"PACMA",0
18,"18043",130,93,93,0,0,"PACMA",2
5,"5062",166,136,133,0,3,"PACMA",0
47,"47165",6822,5456,5296,62,160,"PACMA",19
6,"6120",3373,2757,2719,10,38,"PACMA",17
39,"39023",6523,5205,5144,22,61,"PACMA",39
44,"44208",26,22,22,0,0,"PACMA",0
31,"31144",763,504,503,1,1,"PACMA",0
49,"49008",431,293,289,2,4,"PACMA",0
46,"46081",9993,7972,7882,51,90,"PACMA",107
47,"47069",118,96,92,1,4,"PACMA",0
31,"31145",161,131,129,1,2,"PACMA",0
9,"9117",71,55,53,0,2,"PACMA",0
16,"16155",488,411,408,3,3,"PACMA",0
34,"34139",160,119,118,0,1,"PACMA",1
4,"4051",406,343,339,1,4,"PACMA",0
28,"28172",9751,7994,7928,38,66,"PACMA",173
49,"49127",2430,1835,1799,30,36,"PACMA",17
37,"37257",49,40,40,1,0,"PACMA",0
19,"19055",44,34,34,1,0,"PACMA",0
45,"45191",521,449,446,0,3,"PACMA",0
26,"26040",63,51,50,0,1,"PACMA",1
24,"24005",345,255,250,2,5,"PACMA",1
16,"16031",36,25,25,0,0,"PACMA",0
49,"49091",248,185,183,4,2,"PACMA",1
38,"38051",7326,5418,5352,27,66,"PACMA",51
49,"49251",161,125,124,0,1,"PACMA",1
34,"34140",96,69,69,1,0,"PACMA",1
45,"45055",998,844,828,4,16,"PACMA",0
6,"6122",6562,4837,4723,43,114,"PACMA",34
34,"34003",150,122,120,2,2,"PACMA",0
50,"50160",2150,1652,1619,14,33,"PACMA",8
4,"4053",12500,9437,9298,56,139,"PACMA",62
19,"19202",17,13,13,0,0,"PACMA",0
37,"37370",308,256,254,2,2,"PACMA",0
26,"26158",246,207,206,2,1,"PACMA",1
2,"2901",2185,1633,1613,9,20,"PACMA",2
25,"25208",333,252,249,0,3,"PACMA",0
50,"50245",76,58,58,0,0,"PACMA",0
24,"24006",487,393,387,3,6,"PACMA",4
6,"6123",4512,3358,3266,28,92,"PACMA",28
41,"41068",13936,10692,10530,73,162,"PACMA",78
28,"28144",6423,5274,5222,35,52,"PACMA",80
9,"9229",183,136,136,2,0,"PACMA",0
19,"19059",74,53,46,0,7,"PACMA",0
9,"9447",43,40,40,0,0,"PACMA",0
10,"10213",534,447,441,5,6,"PACMA",0
46,"46175",428,367,354,3,13,"PACMA",4
44,"44211",35,24,24,0,0,"PACMA",0
26,"26160",732,578,574,4,4,"PACMA",5
34,"34146",53,47,46,0,1,"PACMA",0
45,"45058",352,270,269,5,1,"PACMA",3
9,"9124",1432,1078,1054,7,24,"PACMA",6
24,"24125",421,298,289,2,9,"PACMA",0
25,"25210",1079,867,853,4,14,"PACMA",0
46,"46176",2045,1450,1434,12,16,"PACMA",35
50,"50072",195,164,161,3,3,"PACMA",2
26,"26161",8,7,7,0,0,"PACMA",0
49,"49012",73,45,45,0,0,"PACMA",0
34,"34147",160,125,124,1,1,"PACMA",0
3,"3094",9626,7206,7138,42,68,"PACMA",153
37,"37026",175,148,148,2,0,"PACMA",0
21,"21010",14976,9475,9352,145,123,"PACMA",145
12,"12049",421,339,329,2,10,"PACMA",3
24,"24009",278,154,151,2,3,"PACMA",0
46,"46086",80,69,69,0,0,"PACMA",0
49,"49133",291,213,211,0,2,"PACMA",0
46,"46177",4778,3767,3711,17,56,"PACMA",57
16,"16035",238,190,188,0,2,"PACMA",2
1,"1044",231,171,166,0,5,"PACMA",1
22,"22042",117,96,95,1,1,"PACMA",0
45,"45198",1790,1488,1464,5,24,"PACMA",7
50,"50073",2117,1735,1706,13,29,"PACMA",5
39,"39029",636,512,512,5,0,"PACMA",2
43,"43130",177,145,145,0,0,"PACMA",0
28,"28176",13836,11415,11326,64,89,"PACMA",174
50,"50248",502,390,377,6,13,"PACMA",1
3,"3003",455,395,388,0,7,"PACMA",3
44,"44213",65,46,46,0,0,"PACMA",0
50,"50249",284,229,227,1,2,"PACMA",0
25,"25014",249,203,200,2,3,"PACMA",0
4,"4058",342,256,256,0,0,"PACMA",2
10,"10096",3326,2553,2501,14,52,"PACMA",19
40,"40013",56,47,47,0,0,"PACMA",0
19,"19066",50,43,43,0,0,"PACMA",0
43,"43131",4772,3432,3401,18,31,"PACMA",62
10,"10218",1083,810,796,3,14,"PACMA",2
42,"42054",19,15,15,0,0,"PACMA",0
46,"46179",2116,1723,1678,18,45,"PACMA",10
22,"22043",93,68,67,1,1,"PACMA",1
9,"9451",238,211,207,2,4,"PACMA",1
45,"45063",380,294,289,0,5,"PACMA",0
42,"42192",38,26,26,1,0,"PACMA",0
50,"50074",6166,4547,4444,33,103,"PACMA",42
24,"24012",285,204,202,2,2,"PACMA",0
42,"42055",165,124,122,2,2,"PACMA",0
19,"19212",674,528,519,2,9,"PACMA",0
37,"37029",193,139,133,1,6,"PACMA",0
14,"14018",3611,2802,2741,25,61,"PACMA",27
40,"40122",525,442,434,2,8,"PACMA",11
45,"45064",3998,3166,3117,17,49,"PACMA",28
31,"31155",241,181,180,3,1,"PACMA",3
9,"9455",43,37,36,0,1,"PACMA",0
6,"6030",169,147,146,1,1,"PACMA",0
47,"47078",159,135,131,0,4,"PACMA",0
25,"25115",801,638,637,4,1,"PACMA",6
31,"31156",239,191,191,1,0,"PACMA",1
19,"19214",72,56,55,0,1,"PACMA",0
18,"18053",1561,1102,1099,3,3,"PACMA",5
43,"43132",363,292,291,2,1,"PACMA",2
15,"15034",2724,1832,1811,8,21,"PACMA",8
5,"5190",53,47,47,1,0,"PACMA",0
37,"37266",70,58,56,0,2,"PACMA",0
10,"10100",783,584,566,7,18,"PACMA",5
31,"31157",3470,2507,2473,32,34,"PACMA",27
25,"25118",327,241,239,2,2,"PACMA",1
21,"21016",993,770,744,6,26,"PACMA",4
41,"41074",2998,2364,2322,17,42,"PACMA",13
40,"40228",494,397,391,5,6,"PACMA",1
9,"9132",171,136,130,1,6,"PACMA",1
42,"42057",147,95,93,3,2,"PACMA",0
19,"19073",16,13,13,0,0,"PACMA",0
22,"22125",39429,29988,29612,337,376,"PACMA",275
15,"15035",11208,8175,8068,105,107,"PACMA",103
1,"1052",268,188,187,1,1,"PACMA",2
5,"5076",473,417,413,7,4,"PACMA",5
25,"25217",10819,8163,8120,64,43,"PACMA",73
41,"41075",10279,7543,7370,96,173,"PACMA",72
37,"37032",549,431,430,3,1,"PACMA",2
35,"35031",7412,5593,5519,41,74,"PACMA",48
24,"24017",538,427,424,2,3,"PACMA",5
40,"40125",75,61,61,2,0,"PACMA",0
34,"34019",110,92,91,2,1,"PACMA",0
50,"50253",382,318,315,2,3,"PACMA",1
43,"43134",273,224,223,5,1,"PACMA",5
16,"16043",88,71,71,1,0,"PACMA",0
3,"3008",159,127,126,0,1,"PACMA",0
37,"37156",4276,2621,2572,27,49,"PACMA",16
31,"31200",748,555,546,5,9,"PACMA",4
12,"12024",133,117,117,0,0,"PACMA",0
19,"19075",61,44,43,0,1,"PACMA",0
39,"39090",772,619,609,1,10,"PACMA",4
9,"9244",45,35,35,0,0,"PACMA",0
32,"32091",1703,1312,1306,4,6,"PACMA",4
44,"44027",149,120,119,0,1,"PACMA",1
31,"31160",105,87,86,1,1,"PACMA",0
29,"29086",774,537,532,1,5,"PACMA",4
6,"6134",530,337,331,3,6,"PACMA",3
11,"11001",4342,2928,2870,32,58,"PACMA",29
26,"26053",195,161,160,3,1,"PACMA",0
49,"49142",249,175,173,0,2,"PACMA",1
5,"5194",132,111,111,0,0,"PACMA",0
42,"42107",67,48,48,0,0,"PACMA",0
46,"46002",1215,963,959,5,4,"PACMA",17
32,"32092",482,337,334,2,3,"PACMA",3
45,"45071",1802,1488,1465,0,23,"PACMA",11
16,"16172",349,278,275,3,3,"PACMA",2
24,"24141",101,78,78,0,0,"PACMA",0
37,"37159",79,68,68,0,0,"PACMA",0
46,"46257",5428,4237,4190,23,47,"PACMA",59
49,"49267",97,73,68,1,5,"PACMA",0
25,"25021",2541,1891,1882,14,9,"PACMA",19
11,"11002",4200,3287,3257,5,30,"PACMA",14
46,"46094",20691,15841,15672,88,169,"PACMA",216
40,"40127",35,28,28,0,0,"PACMA",1
6,"6036",4958,3785,3728,22,57,"PACMA",14
19,"19079",8,7,7,1,0,"PACMA",0
28,"28016",78,62,61,1,1,"PACMA",1
42,"42062",20,14,13,0,1,"PACMA",0
16,"16047",214,175,174,4,1,"PACMA",1
24,"24021",1602,1211,1194,7,17,"PACMA",7
26,"26055",39,35,35,1,0,"PACMA",0
15,"15040",2675,2011,1979,20,32,"PACMA",10
43,"43137",1905,1515,1499,15,16,"PACMA",29
31,"31163",2002,1507,1475,14,32,"PACMA",13
24,"24142",24730,18823,18504,201,319,"PACMA",214
46,"46095",578,467,458,1,9,"PACMA",6
9,"9308",62,48,48,0,0,"PACMA",0
40,"40129",164,129,128,2,1,"PACMA",0
21,"21022",186,132,129,0,3,"PACMA",1
13,"13003",449,346,343,0,3,"PACMA",1
22,"22051",91,78,78,1,0,"PACMA",0
12,"12059",228,191,188,0,3,"PACMA",0
50,"50081",491,390,384,5,6,"PACMA",2
46,"46187",1304,991,982,8,9,"PACMA",13
40,"40022",193,162,159,2,3,"PACMA",0
42,"42202",20,12,11,0,1,"PACMA",0
9,"9472",52,45,44,0,1,"PACMA",0
33,"33002",9474,6779,6662,74,117,"PACMA",42
31,"31125",274,211,207,7,4,"PACMA",3
6,"6038",790,583,574,4,9,"PACMA",1
26,"26057",51,47,47,1,0,"PACMA",0
23,"23027",716,524,518,2,6,"PACMA",1
37,"37274",118473,91137,90221,811,916,"PACMA",653
50,"50082",84,63,63,0,0,"PACMA",0
38,"38004",4490,3242,3202,18,40,"PACMA",47
21,"21024",466,355,341,4,14,"PACMA",3
24,"24023",262,208,206,3,2,"PACMA",1
16,"16049",144,111,108,1,3,"PACMA",1
49,"49148",264,146,136,1,10,"PACMA",2
42,"42205",85,64,62,0,2,"PACMA",0
4,"4070",1545,1192,1182,7,10,"PACMA",7
31,"31166",250,184,184,2,0,"PACMA",1
45,"45077",562,442,437,0,5,"PACMA",5
49,"49149",365,285,282,2,3,"PACMA",1
37,"37275",101,69,67,0,2,"PACMA",0
33,"33004",65515,48686,48245,511,441,"PACMA",600
36,"36003",10038,7747,7632,79,115,"PACMA",72
49,"49028",105,94,93,1,1,"PACMA",3
12,"12061",380,277,274,2,3,"PACMA",3
16,"16177",82,64,63,0,1,"PACMA",2
41,"41081",29840,22819,22465,228,354,"PACMA",322
18,"18064",366,307,306,0,1,"PACMA",0
31,"31168",241,203,199,2,4,"PACMA",1
4,"4071",363,303,301,2,2,"PACMA",2
34,"34029",659,557,551,5,6,"PACMA",1
46,"46098",2403,1807,1772,8,35,"PACMA",15
43,"43140",2438,1847,1837,16,10,"PACMA",39
46,"46190",50023,37273,36976,250,297,"PACMA",645
50,"50174",83,58,58,0,0,"PACMA",0
36,"36004",10123,7396,7273,93,123,"PACMA",91
3,"3107",2769,2011,1986,10,25,"PACMA",27
10,"10112",1518,1168,1151,4,17,"PACMA",7
44,"44225",103,82,81,0,1,"PACMA",0
19,"19227",73,55,53,0,2,"PACMA",0
9,"9149",34,27,27,0,0,"PACMA",0
43,"43067",528,450,445,1,5,"PACMA",1
6,"6041",457,381,374,5,7,"PACMA",2
44,"44226",124,87,83,2,4,"PACMA",0
47,"47184",541,447,441,0,6,"PACMA",1
42,"42208",20,16,16,0,0,"PACMA",0
22,"22055",310,258,255,2,3,"PACMA",0
1,"1062",315,236,229,2,7,"PACMA",4
12,"12064",80,75,73,1,2,"PACMA",0
25,"25127",214,172,172,0,0,"PACMA",1
43,"43141",105,86,86,0,0,"PACMA",0
4,"4073",336,243,243,0,0,"PACMA",0
9,"9483",189,153,150,1,3,"PACMA",0
22,"22057",364,286,284,3,2,"PACMA",2
19,"19228",29,22,22,0,0,"PACMA",0
47,"47185",87,77,77,0,0,"PACMA",0
19,"19090",90,73,72,1,1,"PACMA",0
19,"19229",57,52,52,0,0,"PACMA",1
44,"44036",23,20,20,0,0,"PACMA",0
37,"37167",177,159,158,3,1,"PACMA",1
10,"10114",962,754,737,2,17,"PACMA",3
42,"42073",73,58,57,0,1,"PACMA",0
38,"38008",5658,4126,4056,19,70,"PACMA",55
16,"16055",679,478,477,4,1,"PACMA",2
46,"46101",816,696,687,3,9,"PACMA",2
33,"33007",1398,960,951,9,9,"PACMA",4
9,"9152",248,197,195,0,2,"PACMA",0
24,"24151",445,334,328,3,6,"PACMA",1
29,"29095",3304,2536,2470,22,66,"PACMA",24
5,"5207",645,543,540,3,3,"PACMA",5
49,"49154",109,64,63,0,1,"PACMA",0
46,"46102",19635,15330,15207,95,123,"PACMA",237
23,"23032",523,443,439,1,4,"PACMA",1
37,"37046",10749,8133,7989,84,144,"PACMA",56
32,"32016",724,543,535,3,8,"PACMA",1
43,"43143",51,45,44,0,1,"PACMA",0
4,"4076",1221,951,933,8,18,"PACMA",4
29,"29007",28584,21525,21318,202,207,"PACMA",450
5,"5090",77,70,69,0,1,"PACMA",0
19,"19231",10,7,7,0,0,"PACMA",0
26,"26064",2337,1764,1724,14,40,"PACMA",5
24,"24152",447,301,296,1,5,"PACMA",4
12,"12067",523,423,416,1,7,"PACMA",1
9,"9902",446,345,341,0,4,"PACMA",6
46,"46904",805,643,628,13,15,"PACMA",9
39,"39044",3868,3019,2985,8,34,"PACMA",39
50,"50263",176,119,116,0,3,"PACMA",0
29,"29097",4168,3086,3009,37,77,"PACMA",32
41,"41002",1427,1057,1024,5,33,"PACMA",8
26,"26065",58,49,47,0,2,"PACMA",0
22,"22060",1172,906,901,13,5,"PACMA",11
9,"9903",3139,2379,2352,27,27,"PACMA",22
28,"28025",404,314,305,3,9,"PACMA",0
47,"47093",797,628,615,6,13,"PACMA",1
26,"26066",259,216,212,3,4,"PACMA",3
19,"19096",101,81,79,1,2,"PACMA",2
45,"45087",8198,6375,6281,36,94,"PACMA",50
3,"3114",1581,1263,1237,9,26,"PACMA",8
24,"24032",102,84,83,0,1,"PACMA",1
4,"4078",1110,819,814,2,5,"PACMA",6
9,"9325",177,117,117,2,0,"PACMA",0
6,"6046",1250,1010,995,7,15,"PACMA",2
28,"28099",1923,1490,1475,7,15,"PACMA",20
43,"43071",891,713,706,6,7,"PACMA",1
49,"49036",508,361,355,6,6,"PACMA",0
50,"50090",134,108,108,0,0,"PACMA",0
2,"2003",133957,105024,104115,786,909,"PACMA",1204
18,"18070",289,224,222,3,2,"PACMA",3
9,"9007",55,37,37,0,0,"PACMA",0
6,"6147",338,262,258,2,4,"PACMA",2
31,"31055",263,199,197,3,2,"PACMA",0
15,"15050",1748,1038,1027,15,11,"PACMA",2
9,"9905",389,308,303,2,5,"PACMA",6
11,"11016",15051,10188,10042,131,146,"PACMA",183
40,"40034",75,63,62,1,1,"PACMA",0
24,"24156",220,146,144,2,2,"PACMA",0
44,"44040",191,164,158,2,6,"PACMA",1
3,"3115",255,222,221,2,1,"PACMA",2
9,"9906",1200,975,958,8,17,"PACMA",12
9,"9009",158,139,137,4,2,"PACMA",2
19,"19235",98,82,81,0,1,"PACMA",0
34,"34179",26,20,19,0,1,"PACMA",0
44,"44141",127,100,100,0,0,"PACMA",0
10,"10121",7914,5924,5809,36,115,"PACMA",41
29,"29011",2871,1955,1926,11,29,"PACMA",15
46,"46015",7477,5857,5808,33,49,"PACMA",60
50,"50063",61,54,54,0,0,"PACMA",1
44,"44203",9,9,9,0,0,"PACMA",2
21,"21072",10227,7947,7739,98,208,"PACMA",66
43,"43122",111,98,97,0,1,"PACMA",1
19,"19331",2643,2043,2009,11,34,"PACMA",19
11,"11018",1446,1126,1100,6,26,"PACMA",6
21,"21036",203,147,143,0,4,"PACMA",0
40,"40142",52,42,40,0,2,"PACMA",0
42,"42082",7,7,7,0,0,"PACMA",0
31,"31221",1235,944,938,11,6,"PACMA",10
43,"43024",1556,1154,1137,3,17,"PACMA",23
28,"28029",562,459,456,2,3,"PACMA",8
5,"5097",476,332,327,0,5,"PACMA",1
42,"42219",40,33,32,1,1,"PACMA",0
37,"37055",118,96,95,0,1,"PACMA",0
40,"40143",83,73,73,2,0,"PACMA",0
44,"44142",28,21,21,0,0,"PACMA",0
23,"23040",1443,1164,1149,3,15,"PACMA",10
34,"34182",753,609,604,6,5,"PACMA",7
33,"33014",8771,6425,6368,51,57,"PACMA",63
50,"50093",83,66,66,1,0,"PACMA",2
34,"34045",73,67,65,0,2,"PACMA",0
48,"48054",24938,19329,19197,124,132,"PACMA",211
13,"13022",332,264,256,1,8,"PACMA",2
47,"47098",556,480,475,4,5,"PACMA",5
24,"24159",1746,1393,1368,6,25,"PACMA",9
9,"9168",272,222,216,3,6,"PACMA",1
50,"50008",5185,3753,3711,35,42,"PACMA",39
43,"43148",90763,69756,69423,299,333,"PACMA",1163
37,"37056",40,33,33,0,0,"PACMA",0
23,"23041",491,383,382,0,1,"PACMA",2
48,"48055",2596,2023,2005,12,18,"PACMA",13
33,"33015",1428,1003,993,7,10,"PACMA",4
4,"4084",341,258,255,0,3,"PACMA",1
9,"9332",140,103,102,0,1,"PACMA",0
21,"21039",299,226,223,7,3,"PACMA",0
34,"34089",140,119,114,2,5,"PACMA",0
26,"26072",285,252,247,1,5,"PACMA",1
44,"44206",103,83,82,0,1,"PACMA",1
9,"9014",192,143,142,0,1,"PACMA",0
29,"29015",32064,23769,23461,213,308,"PACMA",306
43,"43075",86,71,69,0,2,"PACMA",0
43,"43002",1875,1367,1348,11,19,"PACMA",29
10,"10126",1470,1114,1104,7,10,"PACMA",6
37,"37178",99,82,82,0,0,"PACMA",0
2,"2009",19456,15229,15007,152,222,"PACMA",177
19,"19242",77,67,67,0,0,"PACMA",2
34,"34186",47,41,41,0,0,"PACMA",0
2,"2010",1798,1494,1469,6,25,"PACMA",5
42,"42086",33,21,19,0,2,"PACMA",0
5,"5217",54,44,43,0,1,"PACMA",1
6,"6053",590,461,444,7,17,"PACMA",1
34,"34048",63,54,53,2,1,"PACMA",0
42,"42087",51,45,44,1,1,"PACMA",0
23,"23043",518,398,397,0,1,"PACMA",1
41,"41009",1167,820,805,4,15,"PACMA",3
24,"24041",527,371,364,4,7,"PACMA",2
50,"50096",36,22,22,0,0,"PACMA",0
32,"32024",4835,3484,3439,23,45,"PACMA",22
6,"6154",2799,2075,2022,15,53,"PACMA",7
25,"25040",10614,7791,7734,58,57,"PACMA",70
16,"16070",28,26,26,1,0,"PACMA",0
11,"11023",9372,7032,6950,94,82,"PACMA",75
9,"9018",24647,18982,18715,184,267,"PACMA",152
49,"49044",78,64,64,1,0,"PACMA",0
43,"43077",455,342,339,2,3,"PACMA",0
19,"19109",33,30,30,1,0,"PACMA",0
29,"29017",6428,4943,4871,32,72,"PACMA",40
37,"37293",106,75,74,0,1,"PACMA",0
19,"19245",1145,904,880,8,24,"PACMA",9
5,"5219",37,30,30,0,0,"PACMA",0
10,"10007",630,513,507,4,6,"PACMA",0
3,"3122",43704,31952,31681,218,271,"PACMA",621
5,"5220",363,312,308,5,4,"PACMA",3
23,"23044",4719,3817,3749,18,68,"PACMA",29
50,"50187",56,43,43,0,0,"PACMA",0
47,"47167",242,212,210,0,2,"PACMA",0
33,"33019",2882,1981,1939,8,42,"PACMA",11
12,"12077",4790,3594,3565,39,29,"PACMA",25
14,"14043",7408,5721,5619,76,102,"PACMA",27
2,"2013",135,113,110,0,3,"PACMA",0
43,"43152",434,357,356,0,1,"PACMA",2
42,"42089",57,48,48,1,0,"PACMA",0
22,"22074",275,223,221,10,2,"PACMA",3
10,"10009",263,196,193,2,3,"PACMA",0
44,"44240",149,121,121,0,0,"PACMA",0
24,"24044",152,116,114,0,2,"PACMA",1
34,"34052",167,144,143,2,1,"PACMA",0
29,"29019",864,687,679,7,8,"PACMA",0
18,"18082",827,587,577,5,10,"PACMA",0
24,"24166",1359,1038,1011,11,27,"PACMA",8
11,"11027",68637,48919,48441,519,478,"PACMA",768
46,"46114",574,457,452,1,5,"PACMA",8
37,"37063",60,45,45,1,0,"PACMA",0
15,"15059",10255,7423,7262,122,161,"PACMA",52
6,"6025",5096,3981,3904,28,77,"PACMA",33
47,"47104",2836,2339,2267,23,72,"PACMA",8
22,"22204",1119,836,832,9,4,"PACMA",9
39,"39054",4528,3614,3575,23,39,"PACMA",41
24,"24167",716,516,505,4,11,"PACMA",5
45,"45103",362,306,299,0,7,"PACMA",1
13,"13032",1084,842,831,9,11,"PACMA",6
34,"34053",200,176,171,5,5,"PACMA",1
48,"48060",3620,2615,2606,13,9,"PACMA",7
41,"41013",4807,3480,3425,30,55,"PACMA",14
29,"29021",159,121,120,0,1,"PACMA",2
20,"20035",484,384,384,2,0,"PACMA",1
37,"37298",172,126,125,0,1,"PACMA",0
26,"26080",453,385,383,2,2,"PACMA",2
39,"39056",2268,1847,1830,7,17,"PACMA",18
42,"42093",35,29,29,2,0,"PACMA",0
10,"10012",564,469,464,1,5,"PACMA",3
37,"37067",3254,2742,2714,29,28,"PACMA",27
10,"10134",553,396,392,2,4,"PACMA",0
44,"44150",26,21,21,0,0,"PACMA",0
16,"16078",41517,31810,31486,340,324,"PACMA",268
48,"48062",293,247,245,0,2,"PACMA",0
19,"19114",33,25,25,1,0,"PACMA",0
47,"47203",58,48,48,0,0,"PACMA",0
10,"10013",266,203,202,2,1,"PACMA",1
14,"14046",4443,3550,3486,38,64,"PACMA",30
15,"15061",5199,3694,3601,40,93,"PACMA",23
42,"42095",1857,1498,1473,21,25,"PACMA",14
43,"43154",126,111,111,0,0,"PACMA",1
44,"44244",68,48,48,4,0,"PACMA",0
6,"6060",5723,4401,4323,31,78,"PACMA",15
39,"39057",2367,1831,1796,14,35,"PACMA",17
34,"34056",1949,1537,1511,7,26,"PACMA",6
9,"9348",133,105,104,0,1,"PACMA",0
44,"44088",23,21,21,0,0,"PACMA",0
3,"3128",4295,3007,2982,24,25,"PACMA",39
43,"43008",307,202,200,1,2,"PACMA",0
6,"6061",1084,915,905,8,10,"PACMA",1
19,"19252",60,49,47,0,2,"PACMA",0
38,"38025",7088,5166,5089,39,77,"PACMA",72
24,"24171",349,201,198,4,3,"PACMA",0
24,"24051",394,290,283,3,7,"PACMA",2
18,"18086",339,291,289,0,2,"PACMA",1
42,"42096",251,164,160,3,4,"PACMA",1
39,"39058",800,574,573,1,1,"PACMA",1
28,"28070",113,94,94,2,0,"PACMA",1
6,"6161",288,226,222,1,4,"PACMA",1
20,"20038",380,296,295,0,1,"PACMA",0
19,"19254",43,36,36,0,0,"PACMA",0
37,"37070",528,422,417,2,5,"PACMA",3
40,"40156",281,223,222,1,1,"PACMA",0
20,"20039",2144,1704,1692,11,12,"PACMA",7
42,"42097",14,7,7,0,0,"PACMA",0
15,"15064",2127,1608,1577,29,31,"PACMA",17
44,"44246",1590,1173,1150,11,23,"PACMA",12
36,"36026",19924,14342,14132,171,210,"PACMA",151
19,"19119",75,68,66,2,2,"PACMA",0
50,"50018",893,705,696,3,9,"PACMA",0
31,"31195",171,125,125,2,0,"PACMA",0
37,"37189",114,88,88,2,0,"PACMA",0
6,"6063",2938,2299,2264,11,35,"PACMA",10
3,"3130",43,23,23,0,0,"PACMA",0
18,"18194",2045,1394,1370,11,24,"PACMA",4
13,"13039",14212,10929,10761,107,168,"PACMA",83
36,"36027",4380,3262,3206,26,56,"PACMA",28
4,"4097",242,184,184,0,0,"PACMA",2
44,"44053",105,81,81,0,0,"PACMA",0
26,"26086",15,15,15,0,0,"PACMA",0
42,"42098",9,8,8,0,0,"PACMA",0
15,"15065",7151,5281,5165,63,116,"PACMA",43
49,"49057",105,85,81,2,4,"PACMA",0
29,"29026",1010,747,736,3,11,"PACMA",8
19,"19257",3283,2448,2424,21,24,"PACMA",17
47,"47112",2570,2098,2075,13,23,"PACMA",7
3,"3037",341,289,284,1,5,"PACMA",2
43,"43157",345,303,303,0,0,"PACMA",0
24,"24055",676,513,508,6,5,"PACMA",4
46,"46212",1590,1209,1192,4,17,"PACMA",8
18,"18089",14540,10725,10583,65,142,"PACMA",76
39,"39033",540,430,423,1,7,"PACMA",2
2,"2023",515,442,435,1,7,"PACMA",1
44,"44249",46,37,37,1,0,"PACMA",0
9,"9354",33,29,29,2,0,"PACMA",0
16,"16217",94,77,77,0,0,"PACMA",0
30,"30012",9069,7397,7266,53,131,"PACMA",73
45,"45113",1797,1300,1281,6,19,"PACMA",8
38,"38029",1493,839,823,5,16,"PACMA",8
42,"42103",554,448,442,2,6,"PACMA",0
16,"16218",187,149,148,2,1,"PACMA",0
49,"49179",346,233,232,0,1,"PACMA",3
50,"50107",988,837,828,11,9,"PACMA",5
46,"46122",2730,2103,2071,19,32,"PACMA",32
5,"5117",193,169,167,0,2,"PACMA",0
49,"49061",145,111,108,0,3,"PACMA",0
41,"41019",4895,3518,3462,36,56,"PACMA",35
24,"24096",108,69,69,0,0,"PACMA",1
46,"46092",263,182,179,1,3,"PACMA",1
46,"46153",435,364,356,1,8,"PACMA",0
16,"16170",653,514,500,3,14,"PACMA",7
37,"37382",164,135,134,0,1,"PACMA",0
43,"43012",3647,3028,3019,15,9,"PACMA",55
25,"25150",165,136,133,0,3,"PACMA",1
50,"50282",57,47,45,0,2,"PACMA",1
9,"9035",284,213,210,1,3,"PACMA",0
42,"42106",14,12,12,0,0,"PACMA",0
28,"28045",35264,27864,27597,180,267,"PACMA",413
46,"46032",5692,4518,4476,22,42,"PACMA",70
36,"36061",8617,6498,6391,59,107,"PACMA",61
10,"10062",393,339,334,0,5,"PACMA",0
27,"27052",862,645,640,4,5,"PACMA",1
13,"13045",616,482,479,4,3,"PACMA",1
27,"27021",1649,1080,1048,14,32,"PACMA",9
5,"5234",46,43,43,0,0,"PACMA",0
15,"15070",8797,6312,6173,108,139,"PACMA",44
24,"24059",821,575,572,3,3,"PACMA",0
49,"49183",93,73,71,2,2,"PACMA",0
9,"9036",37,33,32,3,1,"PACMA",0
43,"43013",4392,3341,3321,14,20,"PACMA",35
46,"46124",785,680,675,5,5,"PACMA",9
23,"23056",3062,2332,2281,13,51,"PACMA",15
19,"19262",123,98,97,0,1,"PACMA",0
34,"34068",29,24,23,0,1,"PACMA",0
18,"18095",2002,1566,1537,11,29,"PACMA",20
3,"3135",192,157,155,0,2,"PACMA",0
37,"37196",72,56,53,0,3,"PACMA",0
22,"22085",96,82,81,0,1,"PACMA",0
10,"10024",675,518,505,4,13,"PACMA",2
19,"19263",22,13,12,0,1,"PACMA",0
46,"46216",5252,4291,4263,23,28,"PACMA",62
23,"23057",732,613,611,4,2,"PACMA",4
47,"47022",59,56,54,1,2,"PACMA",0
25,"25153",192,152,150,1,2,"PACMA",1
43,"43161",17113,12944,12881,64,63,"PACMA",179
50,"50111",183,144,142,2,2,"PACMA",0
47,"47117",286,240,235,0,5,"PACMA",3
24,"24061",1736,1350,1328,10,22,"PACMA",19
12,"12090",104,85,83,1,2,"PACMA",0
10,"10147",1283,1038,1007,4,31,"PACMA",4
50,"50199",325,238,232,3,6,"PACMA",3
41,"41096",6134,4926,4845,44,81,"PACMA",51
42,"42111",279,209,208,3,1,"PACMA",0
19,"19264",34,28,28,0,0,"PACMA",0
27,"27023",2470,1833,1797,20,36,"PACMA",6
45,"45120",121,96,96,0,0,"PACMA",0
9,"9039",56,44,44,0,0,"PACMA",0
49,"49066",449,319,314,4,5,"PACMA",2
44,"44032",17,13,13,0,0,"PACMA",0
19,"19265",135,107,107,1,0,"PACMA",0
3,"3043",2899,2466,2434,21,32,"PACMA",16
38,"38034",3998,3033,2993,19,40,"PACMA",22
25,"25154",118,94,94,0,0,"PACMA",0
37,"37082",745,546,536,2,10,"PACMA",1
28,"28124",59,52,52,0,0,"PACMA",0
31,"31085",502,401,399,5,2,"PACMA",1
6,"6071",238,197,193,0,4,"PACMA",1
37,"37083",176,160,156,1,4,"PACMA",0
18,"18907",1774,1426,1415,10,11,"PACMA",3
30,"30018",8326,6544,6438,25,106,"PACMA",78
5,"5239",231,177,174,1,3,"PACMA",0
46,"46127",2740,2174,2147,11,27,"PACMA",19
47,"47119",87,66,65,1,1,"PACMA",0
22,"22088",143,111,111,1,0,"PACMA",1
49,"49068",435,287,286,1,1,"PACMA",0
27,"27025",2743,2191,2138,31,53,"PACMA",15
41,"41024",22737,15687,15398,167,289,"PACMA",212
25,"25155",618,493,489,2,4,"PACMA",1
16,"16095",81,69,68,1,1,"PACMA",0
46,"46037",1109,927,918,4,9,"PACMA",11
34,"34221",170,138,136,2,2,"PACMA",1
13,"13052",6313,4844,4762,38,82,"PACMA",35
10,"10151",198,161,157,2,4,"PACMA",0
27,"27026",2315,1620,1599,17,21,"PACMA",5
19,"19134",30,24,24,0,0,"PACMA",0
45,"45125",2263,1871,1842,10,29,"PACMA",12
50,"50202",131,90,88,1,2,"PACMA",0
42,"42116",42,30,30,1,0,"PACMA",0
14,"14059",687,571,563,7,8,"PACMA",3
22,"22223",74,63,63,1,0,"PACMA",0
23,"23061",7691,5636,5531,51,105,"PACMA",39
6,"6074",4755,3719,3638,27,81,"PACMA",37
9,"9202",22,22,22,2,0,"PACMA",0
44,"44261",722,584,578,8,6,"PACMA",0
50,"50203",1057,849,837,9,12,"PACMA",11
31,"31088",5675,4331,4285,59,46,"PACMA",73
39,"39069",1928,1650,1627,9,23,"PACMA",11
24,"24066",449,329,324,3,5,"PACMA",2
5,"5241",3041,2242,2204,24,38,"PACMA",22
5,"5002",1890,1497,1468,8,29,"PACMA",18
34,"34223",205,160,157,1,3,"PACMA",1
34,"34074",683,545,540,4,5,"PACMA",3
50,"50116",170,132,131,0,1,"PACMA",0
40,"40170",1307,1066,1054,7,12,"PACMA",6
9,"9046",24,19,19,0,0,"PACMA",0
44,"44164",20,18,18,0,0,"PACMA",1
22,"22094",98,72,71,2,1,"PACMA",0
44,"44262",143,115,112,0,3,"PACMA",0
9,"9047",54,46,45,0,1,"PACMA",0
19,"19136",12,12,12,0,0,"PACMA",0
14,"14060",3694,2878,2798,26,80,"PACMA",22
48,"48909",202,172,172,2,0,"PACMA",1
36,"36038",66806,50974,50429,507,545,"PACMA",590
28,"28128",445,352,352,2,0,"PACMA",6
36,"36039",15610,11844,11592,103,252,"PACMA",175
9,"9208",179,130,127,1,3,"PACMA",1
44,"44066",87,66,65,0,1,"PACMA",0
24,"24189",5816,4434,4382,49,52,"PACMA",52
31,"31212",129,102,102,6,0,"PACMA",1
13,"13057",1105,934,919,3,15,"PACMA",3
43,"43093",3884,2956,2933,14,23,"PACMA",34
5,"5244",41,32,32,0,0,"PACMA",0
37,"37318",199,152,152,1,0,"PACMA",1
47,"47218",979,757,745,5,12,"PACMA",3
9,"9209",4419,3407,3338,37,69,"PACMA",26
24,"24069",39,27,27,0,0,"PACMA",0
5,"5008",208,168,163,1,5,"PACMA",1
28,"28129",8578,6925,6853,45,72,"PACMA",113
3,"3903",2577,1996,1973,11,23,"PACMA",33
13,"13058",4050,3188,3128,24,60,"PACMA",19
5,"5245",348,295,290,3,5,"PACMA",4
12,"12003",943,745,731,6,14,"PACMA",4
43,"43020",2276,1831,1819,12,12,"PACMA",31
22,"22227",199,155,154,1,1,"PACMA",2
9,"9211",1362,1065,1050,16,15,"PACMA",7
23,"23065",1550,1199,1186,4,13,"PACMA",2
34,"34228",76,62,62,0,0,"PACMA",1
43,"43094",2120,1659,1646,9,13,"PACMA",13
22,"22228",529,421,417,3,4,"PACMA",7
31,"31214",87,66,64,0,2,"PACMA",0
32,"32045",2360,1712,1689,18,23,"PACMA",7
30,"30024",60183,45738,45317,290,421,"PACMA",388
38,"38041",6970,5288,5258,38,30,"PACMA",69
2,"2038",266,217,216,1,1,"PACMA",0
15,"15079",1466,1076,1052,11,24,"PACMA",6
41,"41030",500,419,410,6,9,"PACMA",5
28,"28130",28508,23566,23305,179,261,"PACMA",415
10,"10036",306,240,237,2,3,"PACMA",0
37,"37321",149,121,121,0,0,"PACMA",0
22,"22229",108,80,80,2,0,"PACMA",0
13,"13061",5639,4119,4071,56,48,"PACMA",41
46,"46134",2380,1836,1825,5,11,"PACMA",40
9,"9214",641,454,445,5,9,"PACMA",2
6,"6113",2677,2117,2076,13,41,"PACMA",15
37,"37133",101,84,80,0,4,"PACMA",0
37,"37247",173,144,143,1,1,"PACMA",1
50,"50293",392,295,293,6,2,"PACMA",1
6,"6080",1890,1482,1467,18,15,"PACMA",9
24,"24073",442,328,324,2,4,"PACMA",5
37,"37096",203,162,160,1,2,"PACMA",0
38,"38043",19265,14000,13856,115,144,"PACMA",262
46,"46135",9827,7928,7883,44,45,"PACMA",98
31,"31096",101,85,84,3,1,"PACMA",0
46,"46227",888,708,693,6,15,"PACMA",8
5,"5133",67,48,48,0,0,"PACMA",0
5,"5249",96,69,69,0,0,"PACMA",1
37,"37323",476,380,377,7,3,"PACMA",0
19,"19147",45,36,36,0,0,"PACMA",0
34,"34231",217,184,178,0,6,"PACMA",0
41,"41031",1215,866,848,3,18,"PACMA",2
9,"9382",30,24,23,0,1,"PACMA",0
28,"28132",12068,9067,8954,63,113,"PACMA",195
37,"37209",410,288,283,3,5,"PACMA",4
24,"24074",96,73,73,0,0,"PACMA",0
46,"46136",2619,2030,2003,24,27,"PACMA",30
40,"40177",140,114,113,1,1,"PACMA",0
10,"10039",402,302,301,0,1,"PACMA",0
50,"50034",787,568,556,3,12,"PACMA",4
41,"41032",3843,3018,2944,17,74,"PACMA",19
22,"22105",101,82,82,4,0,"PACMA",0
43,"43097",399,341,341,1,0,"PACMA",2
12,"12007",731,649,642,8,7,"PACMA",3
31,"31017",370,288,286,3,2,"PACMA",0
41,"41904",1792,1171,1162,16,9,"PACMA",8
37,"37174",983,788,768,0,20,"PACMA",0
49,"49083",50,41,41,1,0,"PACMA",0
37,"37099",61,46,46,1,0,"PACMA",0
47,"47130",99,76,76,2,0,"PACMA",0
19,"19283",32,26,26,0,0,"PACMA",0
37,"37137",99,65,65,0,0,"PACMA",0
50,"50239",63,47,47,0,0,"PACMA",0
45,"45137",1567,1155,1139,11,16,"PACMA",5
41,"41061",2144,1763,1712,7,51,"PACMA",5
14,"14068",516,405,400,1,5,"PACMA",1
4,"4005",533,448,442,0,6,"PACMA",1
22,"22106",20,15,15,0,0,"PACMA",0
21,"21073",1891,1191,1156,17,35,"PACMA",4
13,"13067",342,298,295,0,3,"PACMA",1
10,"10164",720,474,461,3,13,"PACMA",2
5,"5017",86,74,73,0,1,"PACMA",1
19,"19284",10,9,9,1,0,"PACMA",0
31,"31222",58,38,38,3,0,"PACMA",0
45,"45001",1837,1371,1340,12,31,"PACMA",9
29,"29046",2540,1896,1855,13,41,"PACMA",17
3,"3055",5247,4042,3991,24,51,"PACMA",56
21,"21074",2698,1979,1945,15,34,"PACMA",12
46,"46230",14084,10694,10599,67,95,"PACMA",143
45,"45002",2608,1840,1821,7,19,"PACMA",12
9,"9060",128,111,111,1,0,"PACMA",2
14,"14069",7376,5511,5398,47,113,"PACMA",12
30,"30029",12055,9003,8882,58,121,"PACMA",94
15,"15085",3220,2284,2239,23,45,"PACMA",12
16,"16109",41,33,33,3,0,"PACMA",0
12,"12102",521,442,434,2,8,"PACMA",9
16,"16250",65,41,41,0,0,"PACMA",0
50,"50212",32,29,29,1,0,"PACMA",0
6,"6118",157,125,125,1,0,"PACMA",0
9,"9223",43,39,39,1,0,"PACMA",0
42,"42085",178,133,133,3,0,"PACMA",0
24,"24201",1039,775,765,5,10,"PACMA",4
9,"9062",40,39,39,0,0,"PACMA",0
6,"6085",3410,2719,2663,28,56,"PACMA",17
46,"46140",377,312,312,2,0,"PACMA",2
10,"10044",1404,1092,1077,7,15,"PACMA",3
26,"26113",31,30,30,0,0,"PACMA",0
47,"47132",39,33,33,0,0,"PACMA",0
5,"5257",135,104,104,0,0,"PACMA",1
3,"3057",177,148,147,0,1,"PACMA",1
24,"24081",122,91,88,0,3,"PACMA",0
29,"29048",1370,1149,1135,10,14,"PACMA",2
49,"49087",483,322,320,2,2,"PACMA",0
46,"46141",437,367,360,5,7,"PACMA",2
27,"27039",4430,3437,3353,53,84,"PACMA",22
6,"6086",1174,869,862,4,7,"PACMA",1
24,"24082",860,690,678,12,12,"PACMA",5
42,"42134",2652,2028,1989,17,39,"PACMA",11
38,"38049",2683,1781,1743,18,38,"PACMA",18
34,"34092",260,210,206,0,4,"PACMA",3
45,"45143",1190,940,925,3,15,"PACMA",10
31,"31226",574,380,377,3,3,"PACMA",1
28,"28063",254,203,202,2,1,"PACMA",5
12,"12104",6814,5486,5406,35,80,"PACMA",39
10,"10169",494,405,395,1,10,"PACMA",0
28,"28140",3139,2547,2523,12,24,"PACMA",52
35,"35021",15014,10909,10792,71,117,"PACMA",131
49,"49090",193,153,151,0,2,"PACMA",2
18,"18114",591,443,437,2,6,"PACMA",1
50,"50039",467,366,364,3,2,"PACMA",3
9,"9065",138,118,117,1,1,"PACMA",1
49,"49207",217,151,148,4,3,"PACMA",0
27,"27041",2238,1640,1615,10,25,"PACMA",10
50,"50129",213,151,149,5,2,"PACMA",0
19,"19157",56,40,37,0,3,"PACMA",0
10,"10170",239,180,179,1,1,"PACMA",2
38,"38050",2436,1564,1529,12,35,"PACMA",6
18,"18013",4152,3168,3103,16,65,"PACMA",9
16,"16115",47,35,35,0,0,"PACMA",0
30,"30003",25046,17860,17668,99,192,"PACMA",188
24,"24206",1611,1286,1268,7,18,"PACMA",5
12,"12106",1163,980,951,7,29,"PACMA",11
42,"42140",14,13,12,0,1,"PACMA",0
19,"19159",87,77,76,0,1,"PACMA",0
31,"31107",1680,1330,1312,16,18,"PACMA",5
26,"26005",2480,1687,1661,5,26,"PACMA",12
19,"19291",1131,875,864,1,11,"PACMA",12
40,"40184",248,205,203,0,2,"PACMA",2
49,"49092",116,87,86,0,1,"PACMA",0
43,"43029",314,253,252,0,1,"PACMA",3
46,"46053",537,459,457,2,2,"PACMA",6
22,"22114",124,86,82,1,4,"PACMA",0
46,"46144",628,511,505,1,6,"PACMA",5
31,"31230",95,79,79,0,0,"PACMA",0
50,"50130",362,252,249,1,3,"PACMA",1
16,"16259",27,22,21,0,1,"PACMA",0
10,"10050",1015,831,823,2,8,"PACMA",3
31,"31231",108,73,70,1,3,"PACMA",1
21,"21044",17955,11674,11479,136,195,"PACMA",147
45,"45011",275,241,238,2,3,"PACMA",0
4,"4014",149,109,108,0,1,"PACMA",1
27,"27043",1219,814,797,6,17,"PACMA",0
25,"25174",390,324,324,0,0,"PACMA",2
46,"46145",22099,16685,16499,128,186,"PACMA",295
32,"32055",1230,908,889,5,19,"PACMA",6
16,"16118",1350,1126,1093,6,33,"PACMA",10
19,"19010",9,10,10,0,0,"PACMA",0
45,"45012",631,516,509,2,7,"PACMA",0
15,"15091",1103,773,758,16,15,"PACMA",7
18,"18117",507,402,396,5,6,"PACMA",0
42,"42012",29,23,23,0,0,"PACMA",0
34,"34246",69,53,53,0,0,"PACMA",0
5,"5264",57,40,38,1,2,"PACMA",1
5,"5027",260,217,211,3,6,"PACMA",1
40,"40186",34,29,29,0,0,"PACMA",0
26,"26008",1822,1436,1420,14,16,"PACMA",5
28,"28145",2640,2014,1987,11,27,"PACMA",36
23,"23080",1721,1370,1355,8,15,"PACMA",18
13,"13079",12265,9441,9218,123,223,"PACMA",66
44,"44181",66,58,57,0,1,"PACMA",0
27,"27045",944,700,698,13,2,"PACMA",0
42,"42145",134,108,108,0,0,"PACMA",0
22,"22116",1369,1025,1003,8,22,"PACMA",4
46,"46056",175,156,156,3,0,"PACMA",1
37,"37224",189,168,165,0,3,"PACMA",0
37,"37112",152,104,103,0,1,"PACMA",0
45,"45152",547,448,442,1,6,"PACMA",6
6,"6093",4345,3356,3281,18,75,"PACMA",16
28,"28146",1792,1308,1293,8,15,"PACMA",1
49,"49096",157,129,123,2,6,"PACMA",0
22,"22117",2414,1798,1784,18,14,"PACMA",24
14,"14902",1121,928,900,7,28,"PACMA",9
1,"1046",631,464,461,0,3,"PACMA",6
5,"5149",100,82,79,0,3,"PACMA",0
43,"43901",8750,6057,6004,43,53,"PACMA",34
45,"45153",1560,1243,1230,4,13,"PACMA",9
37,"37149",61,56,54,1,2,"PACMA",0
43,"43032",466,379,379,1,0,"PACMA",0
15,"15901",3359,2237,2205,35,32,"PACMA",14
40,"40189",479,392,380,2,12,"PACMA",1
37,"37114",78,64,59,0,5,"PACMA",0
22,"22248",104,83,82,0,1,"PACMA",1
21,"21013",10570,7195,7089,73,106,"PACMA",99
20,"20068",188,142,142,1,0,"PACMA",0
7,"7029",4366,3270,3229,25,41,"PACMA",43
9,"9238",941,573,567,8,6,"PACMA",2
34,"34103",97,84,81,0,3,"PACMA",0
34,"34904",300,220,220,0,0,"PACMA",2
6,"6095",9511,7338,7152,116,186,"PACMA",52
46,"46149",344,260,256,2,4,"PACMA",2
48,"48003",14444,11233,11162,43,71,"PACMA",92
31,"31236",1318,958,950,8,8,"PACMA",7
49,"49222",370,284,282,2,2,"PACMA",0
26,"26011",7229,5355,5277,64,78,"PACMA",38
24,"24092",745,606,601,6,5,"PACMA",2
36,"36057",238171,181891,180030,1636,1861,"PACMA",2578
30,"30040",705,600,596,1,4,"PACMA",6
29,"29058",1538,1079,1062,5,17,"PACMA",6
9,"9239",47,39,39,0,0,"PACMA",0
9,"9076",24,17,17,1,0,"PACMA",0
9,"9408",42,33,33,0,0,"PACMA",0
48,"48095",2326,1691,1680,11,11,"PACMA",10
26,"26125",2663,2042,2011,32,31,"PACMA",10
29,"29059",2643,2086,2042,8,44,"PACMA",13
22,"22124",182,148,148,1,0,"PACMA",1
19,"19302",52,43,41,1,2,"PACMA",1
37,"37342",255,200,199,1,1,"PACMA",2
45,"45019",7545,5831,5740,52,91,"PACMA",67
47,"47048",175,148,148,0,0,"PACMA",0
36,"36058",4942,3470,3402,37,68,"PACMA",30
31,"31116",58,45,43,2,2,"PACMA",0
13,"13085",2287,1911,1885,13,26,"PACMA",3
10,"10058",993,739,723,4,16,"PACMA",5
45,"45157",2261,1627,1603,8,24,"PACMA",18
30,"30042",2180,1727,1703,6,24,"PACMA",22
25,"25180",228,176,174,1,2,"PACMA",1
50,"50137",964,790,781,9,9,"PACMA",1
48,"48006",309,265,265,0,0,"PACMA",2
19,"19020",46,35,34,1,1,"PACMA",2
13,"13087",23207,17321,17032,202,289,"PACMA",192
19,"19304",220,177,175,1,2,"PACMA",5
42,"42154",99,81,81,1,0,"PACMA",0
40,"40193",221,163,161,5,2,"PACMA",1
46,"46243",124,105,104,0,1,"PACMA",2
28,"28073",12751,9940,9838,63,102,"PACMA",169
45,"45021",2605,1987,1950,23,37,"PACMA",21
29,"29061",1033,840,821,5,19,"PACMA",9
12,"12022",328,273,269,1,4,"PACMA",1
18,"18023",15645,11708,11561,91,147,"PACMA",108
10,"10060",935,670,658,4,12,"PACMA",5
9,"9079",48,42,42,1,0,"PACMA",0
10,"10061",1598,1126,1114,5,12,"PACMA",7
32,"32006",1434,1033,1019,8,14,"PACMA",5
5,"5038",113,89,88,0,1,"PACMA",0
22,"22047",241,213,212,2,1,"PACMA",1
12,"12115",208,170,167,1,3,"PACMA",1
32,"32035",1370,881,872,5,9,"PACMA",2
50,"50050",86,65,65,1,0,"PACMA",0
49,"49103",394,343,339,3,4,"PACMA",0
41,"41048",2198,1561,1512,22,49,"PACMA",7
5,"5905",222,165,164,1,1,"PACMA",1
9,"9413",408,313,310,2,3,"PACMA",5
5,"5039",48,47,47,0,0,"PACMA",0
37,"37233",56,46,46,2,0,"PACMA",4
22,"22048",12593,9614,9528,82,86,"PACMA",92
46,"46256",7211,5263,5209,27,54,"PACMA",95
10,"10103",426,330,327,0,3,"PACMA",2
50,"50051",800,615,608,3,7,"PACMA",2
19,"19024",8525,6587,6485,33,102,"PACMA",127
48,"48008",615,454,448,4,6,"PACMA",3
39,"39007",393,300,298,1,2,"PACMA",2
19,"19307",26,23,23,0,0,"PACMA",0
37,"37121",556,448,444,3,4,"PACMA",4
37,"37234",317,224,222,1,2,"PACMA",0
2,"2063",1375,1067,1047,1,20,"PACMA",8
13,"13091",544,485,476,4,9,"PACMA",2
5,"5041",995,776,767,3,9,"PACMA",5
19,"19175",30,19,19,1,0,"PACMA",0
46,"46155",993,785,772,2,13,"PACMA",8
29,"29064",437,319,315,2,4,"PACMA",0
48,"48009",772,628,622,2,6,"PACMA",4
30,"30902",8225,5797,5715,22,82,"PACMA",85
45,"45026",218,177,172,0,5,"PACMA",1
19,"19027",131,98,96,0,2,"PACMA",0
34,"34161",22,17,16,0,1,"PACMA",0
9,"9085",472,371,365,3,6,"PACMA",3
48,"48904",3542,2832,2811,27,21,"PACMA",34
49,"49107",116,82,81,1,1,"PACMA",0
50,"50228",250,217,214,3,3,"PACMA",1
40,"40198",24,20,20,0,0,"PACMA",0
39,"39009",3307,2545,2526,11,19,"PACMA",22
25,"25087",56,49,49,0,0,"PACMA",0
47,"47053",126,100,97,0,3,"PACMA",2
37,"37236",127,90,86,0,4,"PACMA",0
19,"19031",10,8,8,0,0,"PACMA",0
37,"37123",162,122,117,3,5,"PACMA",0
29,"29065",194,150,150,0,0,"PACMA",0
24,"24224",574,435,427,3,8,"PACMA",4
50,"50141",109,90,90,1,0,"PACMA",0
10,"10066",161,141,137,0,4,"PACMA",3
20,"20076",7025,5263,5237,31,26,"PACMA",27
1,"1014",366,283,277,7,6,"PACMA",2
49,"49109",562,445,444,5,1,"PACMA",0
4,"4902",45395,31127,30881,251,246,"PACMA",321
12,"12119",137,107,104,1,3,"PACMA",2
37,"37002",126,81,81,0,0,"PACMA",0
19,"19311",87,71,71,2,0,"PACMA",0
10,"10067",10245,7850,7701,80,149,"PACMA",35
10,"10189",2527,1958,1907,12,51,"PACMA",5
16,"16009",54,49,49,0,0,"PACMA",0
19,"19033",48,42,41,0,1,"PACMA",0
9,"9090",50,45,45,2,0,"PACMA",0
50,"50230",1134,853,846,6,7,"PACMA",3
15,"15010",1819,1194,1181,16,13,"PACMA",6
42,"42161",135,104,104,0,0,"PACMA",0
43,"43040",326,278,276,0,2,"PACMA",1
16,"16135",118,86,85,0,1,"PACMA",0
9,"9091",701,545,533,5,12,"PACMA",0
48,"48906",753,611,608,1,3,"PACMA",2
32,"32067",1193,827,818,10,9,"PACMA",5
49,"49232",84,71,70,0,1,"PACMA",0
45,"45168",62790,50868,50335,359,533,"PACMA",514
15,"15043",4978,3631,3572,39,59,"PACMA",38
34,"34120",63965,50687,50117,471,570,"PACMA",449
26,"26023",435,351,347,5,4,"PACMA",3
48,"48013",79423,59100,58630,458,470,"PACMA",595
4,"4031",2249,1778,1773,2,5,"PACMA",12
44,"44194",104,80,80,1,0,"PACMA",0
31,"31250",2748,1995,1982,21,13,"PACMA",11
46,"46068",345,308,307,4,1,"PACMA",1
20,"20079",18142,14055,13971,75,84,"PACMA",77
9,"9093",162,138,137,1,1,"PACMA",2
49,"49111",121,100,100,3,0,"PACMA",1
49,"49234",399,339,333,2,6,"PACMA",0
1,"1018",1408,998,993,6,5,"PACMA",6
12,"12031",3942,2976,2931,24,45,"PACMA",21
31,"31007",126,101,95,3,6,"PACMA",2
48,"48908",249,214,213,0,1,"PACMA",1
44,"44195",84,66,65,1,1,"PACMA",1
5,"5047",4118,3334,3248,25,86,"PACMA",14
10,"10071",124,85,84,0,1,"PACMA",0
19,"19319",4583,3640,3585,24,55,"PACMA",73
22,"22906",174,137,134,5,3,"PACMA",3
49,"49112",118,78,78,2,0,"PACMA",0
6,"6108",2249,1726,1684,22,42,"PACMA",16
26,"26025",89,77,77,0,0,"PACMA",1
22,"22136",749,579,576,5,3,"PACMA",1
45,"45172",641,504,496,4,8,"PACMA",0
31,"31252",83,57,57,0,0,"PACMA",0
24,"24229",388,312,307,2,5,"PACMA",0
5,"5048",106,98,94,1,4,"PACMA",1
25,"25093",629,489,487,4,2,"PACMA",3
25,"25192",724,564,558,4,6,"PACMA",4
37,"37006",117,81,81,2,0,"PACMA",0
35,"35011",24705,17099,16823,129,276,"PACMA",274
46,"46070",17700,13558,13437,115,121,"PACMA",193
36,"36006",11468,8959,8782,66,177,"PACMA",74
43,"43043",3289,2624,2613,14,11,"PACMA",37
19,"19322",26,21,21,1,0,"PACMA",0
47,"47155",3410,2694,2660,21,34,"PACMA",57
39,"39014",901,709,704,5,5,"PACMA",4
5,"5049",410,310,305,3,5,"PACMA",1
37,"37008",4222,3431,3393,19,38,"PACMA",22
6,"6010",1075,859,846,8,13,"PACMA",1
4,"4035",8433,6246,6196,33,50,"PACMA",42
14,"14001",3443,2724,2675,24,49,"PACMA",15
22,"22908",188,133,131,0,2,"PACMA",0
42,"42166",57,49,49,0,0,"PACMA",0
10,"10196",294,231,231,2,0,"PACMA",3
24,"24108",348,268,265,2,3,"PACMA",2
27,"27061",1016,784,763,9,21,"PACMA",2
20,"20902",14229,10567,10495,53,72,"PACMA",110
39,"39015",824,646,644,2,2,"PACMA",2
9,"9101",74,57,57,0,0,"PACMA",0
49,"49238",268,222,216,2,6,"PACMA",0
9,"9261",449,343,342,5,1,"PACMA",0
46,"46072",3542,3008,2961,33,47,"PACMA",34
5,"5052",87,77,77,0,0,"PACMA",0
49,"49116",360,255,248,5,7,"PACMA",2
41,"41057",253,189,188,0,1,"PACMA",0
43,"43119",838,630,628,4,2,"PACMA",17
31,"31256",96,64,64,0,0,"PACMA",0
25,"25001",139,104,103,1,1,"PACMA",0
47,"47157",495,428,426,3,2,"PACMA",4
44,"44107",205,159,158,0,1,"PACMA",0
15,"15048",5048,3791,3730,38,61,"PACMA",36
25,"25097",84,72,72,1,0,"PACMA",0
49,"49240",185,141,136,0,5,"PACMA",0
31,"31257",903,690,679,6,11,"PACMA",13
15,"15017",19860,14930,14706,204,224,"PACMA",212
50,"50060",170,137,135,2,2,"PACMA",2
10,"10077",637,501,499,3,2,"PACMA",2
12,"12125",222,189,187,0,2,"PACMA",1
49,"49118",194,151,151,1,0,"PACMA",2
50,"50150",621,451,450,2,1,"PACMA",3
37,"37359",163,122,117,0,5,"PACMA",0
28,"28026",6703,5422,5367,21,55,"PACMA",86
6,"6146",1048,837,819,4,18,"PACMA",2
9,"9904",468,371,369,3,2,"PACMA",4
32,"32073",1281,941,932,9,9,"PACMA",2
46,"46074",2678,2158,2135,13,23,"PACMA",31
22,"22023",389,313,305,6,8,"PACMA",1
25,"25197",141,109,108,0,1,"PACMA",0
31,"31258",7879,6189,6140,57,49,"PACMA",75
48,"48020",272959,203643,202331,1472,1312,"PACMA",1992
34,"34130",198,165,161,2,4,"PACMA",0
31,"31136",452,337,333,5,4,"PACMA",1
2,"2076",318,256,250,1,6,"PACMA",2
50,"50151",603,490,489,3,1,"PACMA",0
16,"16020",9,5,5,0,0,"PACMA",0
32,"32074",993,737,734,4,3,"PACMA",9
4,"4043",511,423,421,3,2,"PACMA",0
10,"10080",360,256,246,0,10,"PACMA",0
31,"31259",476,347,346,0,1,"PACMA",1
26,"26032",45,37,37,1,0,"PACMA",0
9,"9268",88,71,71,0,0,"PACMA",0
26,"26147",34,30,29,0,1,"PACMA",0
47,"47160",392,317,314,2,3,"PACMA",1
42,"42174",179,132,128,1,4,"PACMA",2
49,"49120",53,39,39,0,0,"PACMA",1
27,"27065",12076,8393,8183,128,210,"PACMA",41
23,"23003",8644,6604,6523,36,81,"PACMA",55
41,"41060",15100,11304,11105,113,199,"PACMA",102
34,"34132",107,84,83,0,1,"PACMA",0
5,"5174",65,53,52,1,1,"PACMA",1
34,"34084",155,127,126,1,1,"PACMA",0
31,"31261",237,174,173,3,1,"PACMA",0
34,"34233",128,118,117,2,1,"PACMA",0
16,"16149",154,130,130,2,0,"PACMA",0
5,"5057",2401,1949,1917,19,32,"PACMA",11
26,"26149",45,36,36,0,0,"PACMA",0
32,"32076",1974,1492,1472,17,20,"PACMA",8
3,"3023",1379,1216,1199,6,17,"PACMA",9
42,"42218",75,52,51,0,1,"PACMA",2
19,"19150",126,102,100,0,2,"PACMA",0
5,"5253",78,62,60,0,2,"PACMA",1
49,"49244",49,32,32,1,0,"PACMA",0
40,"40212",27,22,20,0,2,"PACMA",0
42,"42175",21,15,15,0,0,"PACMA",0
37,"37138",219,180,176,1,4,"PACMA",1
23,"23904",2604,1727,1701,7,26,"PACMA",1
45,"45047",2668,1922,1882,11,40,"PACMA",44
32,"32077",1104,820,815,10,5,"PACMA",5
10,"10204",419,342,339,4,3,"PACMA",5
29,"29068",7716,5347,5230,58,117,"PACMA",76
50,"50154",116,98,98,0,0,"PACMA",1
5,"5059",92,63,63,0,0,"PACMA",0
25,"25005",274,202,202,2,0,"PACMA",0
42,"42176",27,22,22,2,0,"PACMA",0
31,"31141",107,76,74,0,2,"PACMA",0
40,"40003",121,91,89,1,2,"PACMA",0
10,"10084",1294,899,869,5,30,"PACMA",5
19,"19334",44,37,37,0,0,"PACMA",0
34,"34135",399,320,315,4,5,"PACMA",3
10,"10206",201,146,144,1,2,"PACMA",1
33,"33076",12147,8532,8452,104,80,"PACMA",81
6,"6019",2012,1539,1495,14,44,"PACMA",7
12,"12041",100,76,75,0,1,"PACMA",0
31,"31142",1390,994,982,8,12,"PACMA",5
44,"44236",59,44,44,0,0,"PACMA",0
27,"27006",2458,1713,1666,27,47,"PACMA",7
44,"44113",72,51,50,0,1,"PACMA",0
50,"50155",90,70,69,0,1,"PACMA",0
18,"18147",3644,2492,2441,18,51,"PACMA",11
24,"24118",104,66,66,0,0,"PACMA",0
37,"37018",110,86,85,1,1,"PACMA",0
10,"10207",464,349,340,3,9,"PACMA",0
42,"42043",3838,2897,2855,18,42,"PACMA",21
37,"37366",41,30,30,0,0,"PACMA",0
9,"9275",166,130,130,2,0,"PACMA",0
22,"22155",65,54,54,0,0,"PACMA",0
19,"19335",56,45,43,0,2,"PACMA",0
23,"23008",1434,1155,1133,6,22,"PACMA",4
32,"32079",1287,1016,1006,6,10,"PACMA",4
31,"31022",483,349,345,3,4,"PACMA",0
42,"42181",391,319,317,0,2,"PACMA",0
26,"26153",10,9,9,0,0,"PACMA",0
40,"40215",83,69,69,0,0,"PACMA",0
46,"46171",16429,12527,12373,61,154,"PACMA",189
19,"19199",19,17,16,0,1,"PACMA",0
28,"28171",4382,3202,3134,11,68,"PACMA",22
7,"7055",7897,5264,5176,47,88,"PACMA",56
49,"49249",63,52,52,1,0,"PACMA",0
6,"6121",3268,2558,2531,26,27,"PACMA",10
45,"45053",7834,6440,6333,46,107,"PACMA",31
49,"49167",179,140,136,2,4,"PACMA",0
21,"21005",15697,9910,9778,72,132,"PACMA",109
37,"37143",375,308,306,2,2,"PACMA",2
18,"18149",5401,4290,4212,28,78,"PACMA",52
48,"48027",22668,17326,17224,95,102,"PACMA",102
10,"10210",492,362,358,3,4,"PACMA",2
43,"43151",109,98,98,0,0,"PACMA",1
46,"46021",23977,18032,17879,125,153,"PACMA",260
47,"47101",1644,1354,1337,9,17,"PACMA",2
10,"10211",447,345,343,2,2,"PACMA",2
9,"9279",167,131,128,2,3,"PACMA",2
4,"4052",12767,9352,9269,90,83,"PACMA",128
7,"7023",3757,2777,2735,43,42,"PACMA",38
24,"24122",1319,983,969,3,14,"PACMA",3
40,"40218",84,62,62,0,0,"PACMA",0
25,"25139",491,390,388,3,2,"PACMA",2
25,"25041",528,399,396,4,3,"PACMA",4
23,"23011",2134,1649,1614,11,35,"PACMA",8
40,"40113",408,339,335,6,4,"PACMA",2
28,"28005",136050,108267,107316,772,951,"PACMA",1617
20,"20003",551,401,399,2,2,"PACMA",3
16,"16157",190,163,161,1,2,"PACMA",2
14,"14013",16604,12618,12388,155,230,"PACMA",171
5,"5182",731,494,490,6,4,"PACMA",1
19,"19203",29,25,25,0,0,"PACMA",1
16,"16032",277,224,223,1,1,"PACMA",0
49,"49130",158,131,131,5,0,"PACMA",1
31,"31027",814,623,610,8,13,"PACMA",2
34,"34143",157,125,120,1,5,"PACMA",0
19,"19204",149,112,112,1,0,"PACMA",1
30,"30035",19268,14248,14103,92,145,"PACMA",225
50,"50071",127,89,88,0,1,"PACMA",0
42,"42050",27,21,21,1,0,"PACMA",0
50,"50161",103,80,80,0,0,"PACMA",0
46,"46084",1503,1225,1195,1,30,"PACMA",21
21,"21008",2613,1803,1777,6,26,"PACMA",10
6,"6124",1656,1323,1296,5,27,"PACMA",4
10,"10092",266,216,211,18,5,"PACMA",1
21,"21009",835,575,557,0,18,"PACMA",8
3,"3093",19713,15195,14988,108,207,"PACMA",275
41,"41069",29569,21075,20657,361,418,"PACMA",243
26,"26043",349,272,268,2,4,"PACMA",1
5,"5184",240,207,204,1,3,"PACMA",1
39,"39027",3066,2511,2467,15,44,"PACMA",17
20,"20005",1267,884,882,2,2,"PACMA",6
19,"19061",53,45,45,0,0,"PACMA",0
10,"10215",413,305,301,2,4,"PACMA",3
47,"47075",4775,3849,3784,38,65,"PACMA",12
23,"23014",2552,2056,2020,11,36,"PACMA",20
9,"9448",201,161,161,1,0,"PACMA",0
44,"44021",104,86,85,2,1,"PACMA",0
45,"45060",158,118,118,0,0,"PACMA",2
18,"18153",8796,6686,6594,59,92,"PACMA",96
31,"31030",135,105,105,3,0,"PACMA",0
16,"16160",60,44,43,1,1,"PACMA",0
21,"21011",3473,2543,2513,14,30,"PACMA",10
32,"32085",10634,7655,7551,66,104,"PACMA",52
28,"28008",1961,1477,1456,6,21,"PACMA",25
15,"15031",23779,17963,17787,213,176,"PACMA",186
24,"24129",111,91,91,1,0,"PACMA",0
6,"6027",645,572,568,0,4,"PACMA",4
40,"40222",163,143,142,1,1,"PACMA",0
5,"5070",30,28,28,0,0,"PACMA",0
44,"44051",2588,2034,1997,26,37,"PACMA",22
19,"19210",18,18,17,0,1,"PACMA",0
32,"32001",5105,3760,3715,37,45,"PACMA",28
25,"25211",672,513,512,6,1,"PACMA",1
25,"25247",147,100,100,2,0,"PACMA",0
24,"24130",418,331,326,0,5,"PACMA",1
5,"5187",1728,1394,1364,7,30,"PACMA",7
34,"34151",147,99,97,1,2,"PACMA",0
5,"5227",340,237,234,0,3,"PACMA",0
43,"43057",38,31,31,1,0,"PACMA",0
35,"35027",10499,7651,7530,57,121,"PACMA",73
14,"14048",1189,948,933,5,15,"PACMA",6
48,"48033",204,160,159,1,1,"PACMA",1
24,"24131",677,468,463,1,5,"PACMA",1
22,"22165",452,360,356,1,4,"PACMA",3
14,"14017",10945,8514,8386,90,128,"PACMA",81
50,"50192",233,189,183,0,6,"PACMA",0
22,"22167",473,392,384,4,8,"PACMA",1
10,"10097",106,88,85,3,3,"PACMA",0
40,"40224",19,16,16,0,0,"PACMA",0
32,"32003",889,667,654,3,13,"PACMA",6
44,"44023",18,14,14,0,0,"PACMA",0
34,"34012",340,271,265,2,6,"PACMA",1
44,"44122",1284,995,984,15,11,"PACMA",2
40,"40015",24,24,24,1,0,"PACMA",0
45,"45202",3982,3094,3055,8,39,"PACMA",29
26,"26048",22,22,22,0,0,"PACMA",0
5,"5074",665,571,565,2,6,"PACMA",1
19,"19070",67,53,51,0,2,"PACMA",0
16,"16040",85,72,72,1,0,"PACMA",1
44,"44217",31,25,25,0,0,"PACMA",0
12,"12140",1140,936,922,7,14,"PACMA",4
9,"9131",480,412,402,2,10,"PACMA",2
6,"6130",186,159,154,0,5,"PACMA",0
3,"3006",494,413,409,1,4,"PACMA",2
37,"37030",81,68,65,0,3,"PACMA",0
46,"46181",16908,12749,12597,82,152,"PACMA",182
21,"21015",654,363,359,8,4,"PACMA",4
5,"5075",99,79,79,1,0,"PACMA",0
49,"49138",208,159,154,2,5,"PACMA",0
40,"40225",1098,902,882,4,20,"PACMA",5
6,"6031",461,316,301,1,15,"PACMA",1
45,"45204",634,500,497,1,3,"PACMA",6
37,"37031",336,261,258,3,3,"PACMA",0
9,"9456",137,104,104,0,0,"PACMA",0
3,"3007",169,145,141,0,4,"PACMA",2
18,"18054",838,649,648,8,1,"PACMA",5
16,"16042",1108,948,938,3,10,"PACMA",3
10,"10101",179,140,138,2,2,"PACMA",1
5,"5192",93,81,78,0,3,"PACMA",0
19,"19215",144,121,119,0,2,"PACMA",0
46,"46254",943,751,734,4,17,"PACMA",1
29,"29084",27218,19648,19352,173,296,"PACMA",195
42,"42058",102,84,84,0,0,"PACMA",1
20,"20011",1633,1297,1287,2,10,"PACMA",3
40,"40229",28,24,24,0,0,"PACMA",0
22,"22172",520,412,407,3,5,"PACMA",0
18,"18162",929,730,719,4,11,"PACMA",5
45,"45068",171,142,142,0,0,"PACMA",3
48,"48037",684,537,531,4,6,"PACMA",3
42,"42059",20,13,13,0,0,"PACMA",0
26,"26015",180,145,142,1,3,"PACMA",0
41,"41092",7679,5668,5568,61,100,"PACMA",46
31,"31241",125,100,100,2,0,"PACMA",0
37,"37269",430,331,325,2,6,"PACMA",1
47,"47146",278,232,230,3,2,"PACMA",2
37,"37157",78,64,64,0,0,"PACMA",0
9,"9463",250,203,201,6,2,"PACMA",3
12,"12056",257,218,216,1,2,"PACMA",0
34,"34158",286,194,194,0,0,"PACMA",3
3,"3101",4911,3827,3772,20,55,"PACMA",32
3,"3009",46121,36093,35720,235,373,"PACMA",558
40,"40230",95,70,67,0,3,"PACMA",0
20,"20043",1734,1254,1248,5,6,"PACMA",5
19,"19306",22,19,19,0,0,"PACMA",0
5,"5157",235,175,174,2,1,"PACMA",0
13,"13090",1023,814,796,5,18,"PACMA",2
12,"12116",67,57,57,0,0,"PACMA",0
29,"29030",774,660,657,3,3,"PACMA",6
37,"37270",183,143,140,1,3,"PACMA",0
24,"24019",341,279,272,0,7,"PACMA",0
22,"22049",74,63,63,0,0,"PACMA",1
42,"42061",272,207,204,2,3,"PACMA",1
44,"44221",384,320,315,2,5,"PACMA",1
5,"5080",44,31,29,0,2,"PACMA",0
42,"42198",19,15,15,0,0,"PACMA",0
43,"43136",10463,7789,7749,36,40,"PACMA",44
42,"42200",76,54,53,0,1,"PACMA",0
45,"45072",661,525,517,3,8,"PACMA",3
50,"50170",364,286,279,1,7,"PACMA",0
19,"19220",2536,1833,1813,9,20,"PACMA",64
44,"44127",57,45,45,0,0,"PACMA",0
25,"25220",994,822,816,3,6,"PACMA",5
10,"10146",1513,1128,1104,6,24,"PACMA",2
41,"41078",2459,1910,1895,24,15,"PACMA",4
47,"47179",373,275,273,1,2,"PACMA",0
22,"22175",184,139,137,1,2,"PACMA",2
46,"46258",2636,2100,2079,9,21,"PACMA",15
44,"44222",122,102,102,1,0,"PACMA",0
29,"29088",2694,2019,1951,31,68,"PACMA",15
12,"12058",64,56,56,0,0,"PACMA",1
49,"49146",274,213,209,1,4,"PACMA",0
25,"25023",4527,3621,3601,23,20,"PACMA",34
37,"37037",107,86,86,0,0,"PACMA",0
37,"37273",88,67,67,0,0,"PACMA",0
44,"44031",82,52,52,1,0,"PACMA",0
24,"24143",495,388,380,2,8,"PACMA",2
50,"50171",96,78,78,1,0,"PACMA",0
6,"6137",933,730,723,5,7,"PACMA",2
40,"40234",376,307,299,2,8,"PACMA",1
6,"6037",1668,1137,1125,6,12,"PACMA",6
1,"1058",1403,958,951,4,7,"PACMA",11
44,"44129",36,29,29,0,0,"PACMA",0
46,"46005",23013,17487,17286,112,201,"PACMA",253
5,"5083",141,104,103,2,1,"PACMA",0
47,"47085",16381,12697,12540,129,157,"PACMA",88
37,"37039",282,222,222,1,0,"PACMA",0
5,"5198",71,51,51,0,0,"PACMA",0
9,"9141",602,501,493,4,8,"PACMA",1
34,"34165",59,51,50,1,1,"PACMA",2
9,"9310",15,14,13,1,1,"PACMA",0
46,"46188",693,591,585,3,6,"PACMA",14
25,"25124",157,114,114,0,0,"PACMA",2
14,"14027",7876,6227,6103,81,124,"PACMA",64
46,"46006",4468,3731,3683,22,48,"PACMA",35
3,"3013",1070,882,869,3,13,"PACMA",7
28,"28019",1269,990,981,4,9,"PACMA",17
5,"5199",37,31,31,0,0,"PACMA",0
42,"42065",23,18,18,2,0,"PACMA",0
37,"37200",196,145,145,0,0,"PACMA",0
26,"26058",143,116,115,2,1,"PACMA",0
47,"47055",192,157,154,1,3,"PACMA",0
40,"40902",117,96,96,1,0,"PACMA",0
9,"9144",44,37,37,2,0,"PACMA",0
46,"46189",473,412,408,2,4,"PACMA",8
37,"37041",73,55,55,0,0,"PACMA",0
6,"6139",502,429,421,5,8,"PACMA",0
28,"28020",169,110,109,0,1,"PACMA",0
25,"25224",126,98,98,0,0,"PACMA",1
42,"42206",8,4,4,0,0,"PACMA",0
9,"9312",89,75,74,2,1,"PACMA",3
26,"26059",1122,861,841,7,20,"PACMA",0
26,"26060",75,60,60,1,0,"PACMA",1
43,"43066",155,121,121,1,0,"PACMA",1
28,"28092",153428,121511,120211,807,1300,"PACMA",1977
22,"22181",88,60,59,1,1,"PACMA",0
37,"37201",237,188,187,1,1,"PACMA",1
13,"13008",427,304,302,0,2,"PACMA",1
5,"5086",76,64,61,0,3,"PACMA",0
16,"16052",537,429,429,2,0,"PACMA",2
23,"23030",1208,1022,1011,6,11,"PACMA",1
50,"50260",32,28,28,0,0,"PACMA",0
6,"6140",611,515,506,1,9,"PACMA",1
37,"37278",789,618,613,8,5,"PACMA",13
3,"3016",91,77,77,1,0,"PACMA",0
39,"39041",1767,1437,1417,18,20,"PACMA",8
6,"6141",1688,1308,1291,16,17,"PACMA",4
32,"32013",2017,1388,1380,5,8,"PACMA",17
10,"10113",2258,1695,1657,6,38,"PACMA",6
44,"44035",105,86,84,1,2,"PACMA",0
20,"20020",113,67,67,0,0,"PACMA",0
32,"32014",1045,775,769,5,6,"PACMA",3
18,"18171",2111,1679,1638,8,41,"PACMA",10
46,"46191",1949,1541,1505,7,36,"PACMA",15
34,"34032",37,34,34,1,0,"PACMA",0
16,"16238",464,387,383,2,4,"PACMA",0
46,"46902",356,300,296,8,4,"PACMA",3
23,"23031",765,659,647,4,12,"PACMA",6
6,"6042",981,714,705,4,9,"PACMA",4
40,"40029",24,21,21,0,0,"PACMA",0
45,"45082",1143,976,967,7,9,"PACMA",4
46,"46010",950,727,718,6,9,"PACMA",7
9,"9316",108,89,89,0,0,"PACMA",0
14,"14031",566,453,446,2,7,"PACMA",0
9,"9485",56,50,50,2,0,"PACMA",1
27,"27029",1427,1068,1047,13,21,"PACMA",7
21,"21029",1509,1183,1160,14,23,"PACMA",3
37,"37280",71,41,40,0,1,"PACMA",0
9,"9154",124,101,101,3,0,"PACMA",0
11,"11012",97629,73036,72347,715,689,"PACMA",1608
46,"46193",8964,7206,7156,27,50,"PACMA",110
47,"47091",74,64,63,1,1,"PACMA",0
15,"15047",2269,1531,1497,25,34,"PACMA",7
49,"49033",666,515,508,1,7,"PACMA",1
3,"3018",12439,9387,9283,50,104,"PACMA",115
37,"37169",176,138,137,1,1,"PACMA",0
22,"22187",294,244,243,2,1,"PACMA",4
1,"1902",730,551,545,6,6,"PACMA",13
44,"44037",449,334,331,1,3,"PACMA",3
34,"34175",87,67,66,0,1,"PACMA",0
34,"34035",100,84,82,1,2,"PACMA",0
6,"6144",512,422,416,1,6,"PACMA",0
24,"24153",233,187,183,1,4,"PACMA",3
19,"19095",11,10,10,1,0,"PACMA",0
25,"25130",183,142,140,0,2,"PACMA",2
43,"43168",84,65,65,1,0,"PACMA",1
50,"50003",119,95,95,1,0,"PACMA",0
49,"49156",230,189,182,0,7,"PACMA",1
6,"6145",899,744,723,1,21,"PACMA",0
13,"13015",5226,4010,3959,20,51,"PACMA",8
40,"40032",378,287,278,1,9,"PACMA",0
50,"50264",147,122,120,0,2,"PACMA",1
5,"5093",353,275,269,0,6,"PACMA",4
16,"16243",379,323,318,5,5,"PACMA",1
33,"33010",1724,1211,1202,15,9,"PACMA",8
43,"43070",238,194,193,1,1,"PACMA",7
23,"23066",4299,3603,3545,13,58,"PACMA",17
43,"43046",90,73,73,1,0,"PACMA",5
16,"16146",87,68,68,0,0,"PACMA",1
25,"25230",1555,1221,1208,8,13,"PACMA",7
44,"44039",202,166,165,3,1,"PACMA",0
49,"49157",192,153,149,0,4,"PACMA",1
20,"20024",391,274,274,1,0,"PACMA",1
37,"37172",853,601,590,4,11,"PACMA",0
5,"5094",132,109,108,1,1,"PACMA",0
27,"27002",1546,1136,1103,9,33,"PACMA",12
41,"41003",2371,1801,1760,8,41,"PACMA",18
40,"40033",67,57,57,1,0,"PACMA",0
39,"39046",1343,1002,988,8,14,"PACMA",6
46,"46196",140,115,114,0,1,"PACMA",0
42,"42216",26,20,20,1,0,"PACMA",0
48,"48051",216,157,157,0,0,"PACMA",2
6,"6047",837,677,669,6,8,"PACMA",0
46,"46014",3130,2488,2462,7,26,"PACMA",24
21,"21034",1159,863,845,4,18,"PACMA",12
22,"22190",122,89,89,0,0,"PACMA",1
5,"5211",430,364,357,6,7,"PACMA",1
14,"14036",3676,2850,2766,40,84,"PACMA",25
2,"2004",606,504,499,5,5,"PACMA",1
25,"25035",366,306,302,2,4,"PACMA",2
26,"26069",230,187,186,0,1,"PACMA",1
50,"50006",908,705,689,3,16,"PACMA",7
16,"16062",25,21,21,0,0,"PACMA",0
37,"37173",1420,1077,1058,13,19,"PACMA",2
34,"34041",84,73,72,3,1,"PACMA",0
9,"9109",1066,686,650,11,36,"PACMA",23
2,"2005",545,443,436,5,7,"PACMA",0
22,"22149",308,247,246,3,1,"PACMA",1
26,"26070",155,133,132,0,1,"PACMA",0
45,"45091",374,275,274,1,1,"PACMA",2
49,"49160",43,29,26,0,3,"PACMA",0
37,"37287",309,215,214,3,1,"PACMA",0
49,"49201",285,243,243,7,0,"PACMA",0
24,"24197",736,556,552,7,4,"PACMA",4
24,"24115",53267,39733,39172,433,561,"PACMA",379
46,"46137",242,200,200,3,0,"PACMA",3
25,"25134",603,492,490,1,2,"PACMA",2
12,"12072",1082,901,889,15,12,"PACMA",6
13,"13021",417,343,343,0,0,"PACMA",1
37,"37175",404,321,319,8,2,"PACMA",2
34,"34042",292,244,243,3,1,"PACMA",5
50,"50007",49,34,34,0,0,"PACMA",0
31,"31059",183,145,143,0,2,"PACMA",0
46,"46199",5842,4451,4414,23,37,"PACMA",60
16,"16065",372,306,305,2,1,"PACMA",0
49,"49162",175,134,131,1,3,"PACMA",0
45,"45093",154,124,123,0,1,"PACMA",0
37,"37176",130,103,103,1,0,"PACMA",1
20,"20028",2258,1579,1574,9,5,"PACMA",7
11,"11020",166423,117732,116448,1427,1284,"PACMA",1884
18,"18074",264,207,205,0,2,"PACMA",0
32,"32022",1238,924,916,5,8,"PACMA",5
31,"31060",14185,10582,10485,103,97,"PACMA",118
39,"39049",306,209,208,4,1,"PACMA",2
50,"50184",90,79,79,0,0,"PACMA",0
47,"47006",186,153,149,1,4,"PACMA",2
15,"15054",31802,22002,21676,368,326,"PACMA",304
7,"7019",164,124,124,0,0,"PACMA",1
46,"46018",567,483,479,3,4,"PACMA",2
31,"31101",1412,1097,1087,11,10,"PACMA",20
42,"42004",2294,1807,1767,22,40,"PACMA",5
41,"41007",12438,9009,8775,135,234,"PACMA",99
19,"19106",76,57,57,0,0,"PACMA",0
5,"5216",213,166,165,0,1,"PACMA",0
37,"37290",134,113,112,0,1,"PACMA",2
38,"38017",30646,18576,18373,100,203,"PACMA",387
47,"47007",4036,3261,3217,25,44,"PACMA",46
25,"25238",205,163,163,2,0,"PACMA",0
19,"19286",742,610,603,4,7,"PACMA",5
22,"22067",71,52,52,0,0,"PACMA",1
37,"37058",56,41,41,0,0,"PACMA",0
19,"19107",315,273,270,2,3,"PACMA",0
6,"6153",20240,15464,15210,134,254,"PACMA",94
16,"16068",127,104,104,4,0,"PACMA",0
31,"31062",1075,870,861,10,9,"PACMA",8
10,"10127",4706,3508,3423,23,85,"PACMA",31
44,"44045",368,302,298,8,4,"PACMA",1
37,"37291",269,212,209,2,3,"PACMA",0
46,"46202",17660,13782,13645,93,137,"PACMA",217
5,"5102",1681,1358,1329,4,29,"PACMA",3
47,"47195",430,335,320,2,15,"PACMA",7
9,"9172",168,132,132,1,0,"PACMA",1
31,"31064",1387,1174,1163,9,11,"PACMA",7
19,"19108",102,92,89,0,3,"PACMA",2
30,"30001",4539,3615,3567,16,48,"PACMA",27
50,"50271",248,197,189,2,8,"PACMA",0
13,"13027",3223,2343,2309,22,34,"PACMA",18
6,"6087",2030,1592,1571,16,21,"PACMA",6
26,"26075",321,266,265,0,1,"PACMA",2
10,"10006",1230,1006,995,8,11,"PACMA",1
34,"34049",329,251,247,5,4,"PACMA",1
34,"34190",49,36,36,3,0,"PACMA",0
5,"5104",33,24,23,0,1,"PACMA",0
24,"24164",362,221,220,1,1,"PACMA",0
50,"50128",27,24,24,0,0,"PACMA",0
40,"40183",116,103,103,0,0,"PACMA",0
25,"25172",1779,1407,1405,3,2,"PACMA",8
44,"44047",229,125,124,2,1,"PACMA",3
9,"9338",231,193,189,2,4,"PACMA",1
13,"13028",10273,8434,8273,42,161,"PACMA",64
37,"37294",11787,9201,9083,76,118,"PACMA",85
13,"13029",90,77,77,0,0,"PACMA",0
22,"22202",145,127,126,0,1,"PACMA",2
6,"6155",1825,1316,1292,21,24,"PACMA",9
13,"13074",944,826,813,1,13,"PACMA",0
30,"30034",1075,852,831,4,21,"PACMA",5
43,"43005",3643,2765,2749,22,16,"PACMA",33
25,"25243",3730,2637,2606,20,31,"PACMA",38
23,"23045",2057,1519,1507,7,12,"PACMA",3
41,"41011",15454,11892,11591,160,301,"PACMA",69
50,"50188",27,24,24,0,0,"PACMA",0
50,"50273",32,24,24,0,0,"PACMA",0
44,"44048",53,47,47,0,0,"PACMA",0
37,"37296",298,241,239,2,2,"PACMA",0
50,"50099",3042,2299,2265,20,34,"PACMA",15
31,"31067",1896,1418,1397,17,21,"PACMA",6
19,"19248",76,56,56,0,0,"PACMA",0
14,"14044",1620,1279,1264,12,15,"PACMA",6
50,"50013",200,166,166,3,0,"PACMA",0
47,"47011",557,478,476,5,2,"PACMA",0
40,"40044",139,105,103,2,2,"PACMA",0
20,"20034",3154,2336,2315,20,21,"PACMA",26
31,"31189",1127,781,775,10,6,"PACMA",3
28,"28111",622,492,487,1,5,"PACMA",3
40,"40151",43,32,32,0,0,"PACMA",0
44,"44241",506,416,407,1,9,"PACMA",1
38,"38022",18629,12903,12759,84,144,"PACMA",144
40,"40045",120,92,92,1,0,"PACMA",2
31,"31190",45,41,41,4,0,"PACMA",0
50,"50014",119,85,85,0,0,"PACMA",0
45,"45104",421,340,335,1,5,"PACMA",2
10,"10011",532,439,435,3,4,"PACMA",1
34,"34201",171,139,139,0,0,"PACMA",1
16,"16074",28,23,23,0,0,"PACMA",0
25,"25142",365,300,299,2,1,"PACMA",2
3,"3125",336,259,257,1,2,"PACMA",2
22,"22205",459,347,345,1,2,"PACMA",3
6,"6158",13362,10282,10112,73,170,"PACMA",94
40,"40046",82,69,69,1,0,"PACMA",0
31,"31070",2628,1930,1881,16,49,"PACMA",17
23,"23048",820,644,636,1,8,"PACMA",3
21,"21047",1869,1242,1206,8,36,"PACMA",12
7,"7027",22047,14986,14853,139,133,"PACMA",224
46,"46207",6686,5220,5137,36,83,"PACMA",91
45,"45151",546,434,431,0,3,"PACMA",1
49,"49172",481,316,310,2,6,"PACMA",0
24,"24169",2809,2165,2146,18,19,"PACMA",4
6,"6159",2339,1577,1507,25,70,"PACMA",7
50,"50191",445,341,337,2,4,"PACMA",2
16,"16209",111,97,97,0,0,"PACMA",1
45,"45106",7395,5971,5861,40,110,"PACMA",31
40,"40047",32,25,25,0,0,"PACMA",1
18,"18189",772,619,611,4,8,"PACMA",1
45,"45015",662,506,500,2,6,"PACMA",6
42,"42014",60,44,44,1,0,"PACMA",0
12,"12081",602,488,481,0,7,"PACMA",4
43,"43155",22619,16724,16624,101,100,"PACMA",167
9,"9406",246,203,200,4,3,"PACMA",3
37,"37300",547,392,391,5,1,"PACMA",4
36,"36025",2137,1387,1381,7,6,"PACMA",12
13,"13036",766,626,617,0,9,"PACMA",5
49,"49220",139,110,104,2,6,"PACMA",0
21,"21049",3282,2294,2214,21,80,"PACMA",39
34,"34205",55,44,44,0,0,"PACMA",2
27,"27047",1525,1026,1008,5,18,"PACMA",12
18,"18121",130,104,103,3,1,"PACMA",0
28,"28115",62352,53136,52912,268,224,"PACMA",465
46,"46027",932,769,755,1,14,"PACMA",4
10,"10138",540,422,415,3,7,"PACMA",0
28,"28040",16648,11709,11551,66,158,"PACMA",192
27,"27016",6973,5139,5064,66,75,"PACMA",40
9,"9182",76,65,64,0,1,"PACMA",0
44,"44052",74,50,49,0,1,"PACMA",0
32,"32031",1014,764,756,5,8,"PACMA",2
47,"47205",355,263,258,3,5,"PACMA",0
45,"45017",260,218,213,1,5,"PACMA",1
28,"28071",64,56,54,0,2,"PACMA",0
39,"39003",258,205,202,3,3,"PACMA",0
43,"43108",1778,1374,1365,6,9,"PACMA",24
16,"16083",45,29,28,0,1,"PACMA",0
14,"14049",16282,12515,12301,121,214,"PACMA",143
28,"28041",4788,4012,3973,23,39,"PACMA",80
39,"39059",7577,5978,5916,47,62,"PACMA",44
32,"32032",7932,5956,5831,55,125,"PACMA",33
25,"25249",176,139,138,1,1,"PACMA",0
40,"40051",34,33,31,0,2,"PACMA",0
30,"30010",6857,5533,5457,38,76,"PACMA",90
31,"31196",31,28,28,0,0,"PACMA",0
34,"34106",113,101,101,0,0,"PACMA",1
50,"50194",81,59,59,1,0,"PACMA",0
5,"5114",1264,1061,1030,3,31,"PACMA",0
6,"6901",2117,1686,1655,17,31,"PACMA",12
47,"47207",260,213,211,2,2,"PACMA",0
16,"16216",278,243,240,0,3,"PACMA",0
13,"13040",841,690,666,2,24,"PACMA",7
22,"22212",70,56,56,0,0,"PACMA",0
15,"15066",4008,2931,2886,30,45,"PACMA",12
13,"13041",249,179,171,2,8,"PACMA",0
25,"25149",1378,1108,1102,3,6,"PACMA",8
2,"2022",344,252,252,1,0,"PACMA",1
19,"19122",81,64,64,1,0,"PACMA",0
15,"15067",7953,6004,5925,51,79,"PACMA",54
22,"22213",2923,2261,2221,24,40,"PACMA",17
46,"46030",796,653,633,7,20,"PACMA",2
39,"39061",3488,2833,2798,18,35,"PACMA",29
9,"9190",86,68,67,0,1,"PACMA",2
40,"40087",87,70,70,0,0,"PACMA",0
43,"43084",521,424,423,2,1,"PACMA",4
3,"3132",515,417,414,4,3,"PACMA",5
47,"47019",91,74,73,0,1,"PACMA",0
20,"20042",3172,2247,2231,9,16,"PACMA",11
16,"16086",881,751,747,3,4,"PACMA",1
18,"18902",755,611,595,1,16,"PACMA",1
31,"31037",90,72,72,0,0,"PACMA",0
20,"20072",4752,3445,3412,24,33,"PACMA",32
28,"28074",140580,113723,112489,776,1234,"PACMA",1556
4,"4100",9266,6046,5988,49,58,"PACMA",72
35,"35004",41728,23957,23683,219,274,"PACMA",410
47,"47114",3911,2864,2807,28,57,"PACMA",16
13,"13044",2569,1984,1951,12,33,"PACMA",8
10,"10143",141,118,113,1,5,"PACMA",0
18,"18093",2756,1902,1885,8,17,"PACMA",5
3,"3039",89,70,70,0,0,"PACMA",0
25,"25252",557,424,422,4,2,"PACMA",2
5,"5233",226,198,197,0,1,"PACMA",0
31,"31242",264,194,194,2,0,"PACMA",2
43,"43061",38,28,28,0,0,"PACMA",0
37,"37034",75,66,66,0,0,"PACMA",1
28,"28086",5390,3992,3936,26,56,"PACMA",65
23,"23088",6020,4779,4703,56,76,"PACMA",39
3,"3070",2106,1554,1528,9,26,"PACMA",21
31,"31202",4345,3132,3085,36,47,"PACMA",27
10,"10145",125,106,104,1,2,"PACMA",1
34,"34067",129,87,87,0,0,"PACMA",0
9,"9360",25,22,22,0,0,"PACMA",0
25,"25253",145,122,121,0,1,"PACMA",1
42,"42108",10,7,7,0,0,"PACMA",0
32,"32036",1261,954,938,9,16,"PACMA",3
16,"16089",377,308,308,1,0,"PACMA",0
46,"46033",196,169,168,3,1,"PACMA",1
22,"22217",372,296,290,5,6,"PACMA",0
41,"41021",21397,15585,15334,201,251,"PACMA",266
6,"6069",3005,2172,2133,24,39,"PACMA",8
28,"28121",205,166,165,1,1,"PACMA",0
50,"50023",208,165,164,2,1,"PACMA",0
32,"32008",8572,6301,6216,65,85,"PACMA",77
32,"32037",681,534,523,6,11,"PACMA",3
14,"14055",18446,13919,13711,148,208,"PACMA",118
31,"31203",30,22,22,1,0,"PACMA",0
41,"41050",5180,4217,4149,34,68,"PACMA",26
25,"25255",395,321,318,2,3,"PACMA",1
9,"9196",135,108,107,0,1,"PACMA",0
16,"16092",154,113,112,0,1,"PACMA",0
43,"43088",2026,1565,1562,9,3,"PACMA",29
13,"13048",506,388,384,3,4,"PACMA",1
18,"18905",15550,11394,11230,132,164,"PACMA",206
39,"39065",232,190,189,5,1,"PACMA",0
14,"14056",23513,17065,16684,147,381,"PACMA",177
44,"44061",75,66,65,2,1,"PACMA",0
11,"11041",9858,6916,6763,70,153,"PACMA",73
6,"6070",7686,6083,5948,44,135,"PACMA",19
45,"45166",1564,1298,1279,6,19,"PACMA",8
23,"23058",8817,6964,6873,48,91,"PACMA",62
7,"7005",6975,4824,4775,43,49,"PACMA",83
45,"45121",7273,5362,5291,27,71,"PACMA",51
49,"49185",156,126,120,1,6,"PACMA",0
13,"13049",747,566,553,4,13,"PACMA",2
40,"40164",185,136,134,3,2,"PACMA",0
16,"16093",57,47,47,0,0,"PACMA",0
16,"16231",50,40,40,0,0,"PACMA",0
5,"5123",103,85,85,1,0,"PACMA",1
50,"50025",4516,3417,3364,35,53,"PACMA",16
45,"45167",1385,1143,1130,2,13,"PACMA",9
34,"34220",149,133,132,0,1,"PACMA",0
25,"25901",287,209,207,1,2,"PACMA",5
26,"26096",260,221,212,2,9,"PACMA",2
21,"21060",12235,8053,7929,93,124,"PACMA",128
24,"24182",411,302,295,4,7,"PACMA",2
37,"37199",129,97,97,0,0,"PACMA",0
9,"9366",75,60,60,2,0,"PACMA",0
21,"21061",5089,3358,3290,42,68,"PACMA",28
49,"49110",345,222,220,2,2,"PACMA",0
24,"24183",752,549,543,8,6,"PACMA",4
48,"48043",4539,3566,3556,22,10,"PACMA",38
5,"5124",92,71,70,1,1,"PACMA",0
23,"23060",19153,14444,14281,87,163,"PACMA",109
40,"40059",108,90,89,0,1,"PACMA",0
11,"11901",5698,4167,4080,81,87,"PACMA",29
44,"44163",114,92,92,0,0,"PACMA",2
6,"6073",700,506,492,11,14,"PACMA",6
49,"49188",110,87,86,0,1,"PACMA",1
10,"10029",380,320,315,1,5,"PACMA",1
9,"9201",28,20,19,0,1,"PACMA",0
24,"24184",183,121,119,0,2,"PACMA",0
39,"39068",649,515,509,7,6,"PACMA",5
40,"40060",68,46,46,0,0,"PACMA",0
50,"50288",3444,2689,2668,24,21,"PACMA",28
33,"33035",11226,8326,8252,112,74,"PACMA",89
19,"19183",71,61,59,0,2,"PACMA",0
16,"16096",280,239,234,3,5,"PACMA",1
16,"16237",98,83,83,0,0,"PACMA",0
19,"19135",93,76,72,0,4,"PACMA",0
21,"21063",2620,2037,1992,11,45,"PACMA",9
11,"11903",1791,1234,1211,16,23,"PACMA",12
16,"16097",139,121,120,1,1,"PACMA",0
25,"25157",162,137,137,4,0,"PACMA",0
9,"9206",55,47,47,1,0,"PACMA",1
26,"26100",56,46,46,0,0,"PACMA",0
43,"43018",385,335,334,3,1,"PACMA",3
7,"7009",741,554,544,4,10,"PACMA",5
49,"49071",715,500,499,3,1,"PACMA",1
24,"24187",845,641,630,6,11,"PACMA",6
37,"37317",288,240,238,2,2,"PACMA",0
28,"28052",3949,2890,2818,8,72,"PACMA",34
34,"34224",42,30,29,0,1,"PACMA",0
31,"31089",228,187,184,0,3,"PACMA",1
18,"18100",7981,5900,5769,44,131,"PACMA",51
47,"47154",146,122,118,2,4,"PACMA",1
34,"34123",1637,1376,1354,8,22,"PACMA",5
19,"19040",57,40,40,0,0,"PACMA",0
46,"46040",995,807,794,7,13,"PACMA",9
21,"21065",255,178,173,2,5,"PACMA",1
12,"12095",950,763,756,9,7,"PACMA",3
29,"29039",2728,2084,2050,14,34,"PACMA",22
26,"26102",6057,4672,4579,37,93,"PACMA",23
5,"5007",110,81,80,2,1,"PACMA",0
1,"1020",320,239,238,1,1,"PACMA",2
24,"24068",443,343,336,1,7,"PACMA",0
24,"24188",3820,3107,3056,33,51,"PACMA",14
40,"40063",6944,5479,5352,39,127,"PACMA",24
44,"44167",39,30,30,0,0,"PACMA",0
50,"50205",74,58,57,0,1,"PACMA",0
7,"7011",28642,19567,19396,147,171,"PACMA",343
39,"39071",422,318,316,0,2,"PACMA",0
40,"40172",45,37,37,0,0,"PACMA",0
40,"40065",469,376,373,1,3,"PACMA",3
19,"19274",950,753,741,7,12,"PACMA",10
6,"6078",506,415,410,1,5,"PACMA",5
21,"21067",402,300,299,2,1,"PACMA",0
33,"33039",1641,1251,1243,6,8,"PACMA",5
25,"25060",69,49,49,1,0,"PACMA",1
27,"27030",3134,2209,2162,27,47,"PACMA",14
37,"37320",88,67,67,1,0,"PACMA",0
35,"35014",11908,7101,6947,63,154,"PACMA",108
9,"9377",629,494,488,4,6,"PACMA",5
24,"24109",876,635,619,3,16,"PACMA",4
28,"28055",907,671,666,5,5,"PACMA",4
19,"19325",144,87,87,1,0,"PACMA",0
19,"19143",1754,1422,1402,11,20,"PACMA",9
16,"16101",139,123,122,0,1,"PACMA",1
7,"7013",7231,5372,5253,43,119,"PACMA",60
48,"48079",395,313,312,2,1,"PACMA",3
49,"49079",103,91,79,1,12,"PACMA",0
41,"41901",2703,2242,2201,29,41,"PACMA",10
16,"16102",1163,951,943,16,8,"PACMA",2
19,"19044",284,226,223,1,3,"PACMA",1
31,"31094",105,78,76,0,2,"PACMA",0
44,"44265",181,153,148,1,5,"PACMA",0
9,"9103",200,179,179,1,0,"PACMA",0
5,"5209",75,58,57,0,1,"PACMA",0
37,"37283",119,96,96,0,0,"PACMA",0
18,"18141",384,269,264,0,5,"PACMA",0
46,"46165",7298,5744,5697,38,47,"PACMA",90
50,"50032",242,179,176,1,3,"PACMA",2
43,"43022",1435,1130,1123,8,7,"PACMA",3
24,"24193",365,286,285,0,1,"PACMA",4
34,"34230",17,13,13,0,0,"PACMA",0
9,"9055",48,34,34,1,0,"PACMA",0
49,"49081",1322,1051,1030,11,21,"PACMA",4
44,"44171",182,130,128,0,2,"PACMA",3
10,"10160",237,189,183,3,6,"PACMA",2
9,"9381",33,25,25,0,0,"PACMA",0
24,"24194",266,199,199,1,0,"PACMA",0
12,"12099",586,449,434,3,15,"PACMA",3
48,"48081",1883,1532,1518,3,14,"PACMA",10
18,"18004",687,521,515,4,6,"PACMA",0
19,"19280",3611,2805,2767,25,38,"PACMA",53
23,"23902",2229,1843,1820,7,23,"PACMA",9
25,"25099",1291,981,978,2,3,"PACMA",8
3,"3052",967,805,790,4,15,"PACMA",11
45,"45135",4173,3402,3349,18,53,"PACMA",19
9,"9217",349,268,266,5,2,"PACMA",2
16,"16104",55,46,46,0,0,"PACMA",0
45,"45136",5825,4314,4260,22,54,"PACMA",32
24,"24076",1286,998,981,8,17,"PACMA",15
3,"3053",7469,5950,5865,26,85,"PACMA",87
37,"37098",304,214,210,0,4,"PACMA",1
50,"50209",2747,1993,1975,29,18,"PACMA",31
18,"18915",731,539,532,1,7,"PACMA",4
37,"37250",332,232,231,1,1,"PACMA",0
40,"40071",43,37,31,0,6,"PACMA",0
18,"18916",1778,1249,1236,9,13,"PACMA",16
13,"13065",2813,1993,1971,13,22,"PACMA",6
42,"42128",46,41,41,0,0,"PACMA",0
4,"4045",1704,1355,1326,12,29,"PACMA",7
6,"6016",2943,2283,2247,24,36,"PACMA",3
46,"46016",1075,887,880,8,7,"PACMA",3
31,"31138",954,699,698,8,1,"PACMA",5
12,"12040",118683,91285,90499,666,786,"PACMA",1066
27,"27035",180,127,123,0,4,"PACMA",0
34,"34234",68,59,57,0,2,"PACMA",0
49,"49202",172,125,124,2,1,"PACMA",0
50,"50296",382,288,272,1,16,"PACMA",3
9,"9387",111,91,89,0,2,"PACMA",0
28,"28135",985,762,756,1,6,"PACMA",10
44,"44075",326,275,263,0,12,"PACMA",0
43,"43025",590,476,472,0,4,"PACMA",1
16,"16108",43,40,39,1,1,"PACMA",0
9,"9220",70,59,58,0,1,"PACMA",0
5,"5254",181,155,153,0,2,"PACMA",0
9,"9059",136704,109424,108039,1134,1385,"PACMA",1004
31,"31100",256,181,178,1,3,"PACMA",1
37,"37214",116,87,87,4,0,"PACMA",0
27,"27037",1017,759,748,10,11,"PACMA",2
49,"49085",918,673,660,5,13,"PACMA",2
28,"28136",680,569,563,0,6,"PACMA",3
39,"39077",236,175,173,0,2,"PACMA",0
45,"45140",1089,887,870,5,17,"PACMA",3
16,"16026",93,70,68,1,2,"PACMA",0
31,"31224",875,684,677,10,7,"PACMA",3
40,"40109",72,59,54,1,5,"PACMA",0
39,"39050",255,188,184,2,4,"PACMA",1
43,"43100",3489,2820,2816,15,4,"PACMA",54
46,"46231",2401,1780,1770,8,10,"PACMA",35
25,"25913",86,77,77,0,0,"PACMA",0
45,"45141",849,677,665,4,12,"PACMA",4
19,"19003",29,28,28,2,0,"PACMA",1
34,"34238",305,261,260,2,1,"PACMA",0
7,"7020",3692,2833,2808,42,25,"PACMA",37
18,"18148",803,652,648,0,4,"PACMA",5
43,"43026",765,614,613,3,1,"PACMA",4
49,"49205",367,286,282,5,4,"PACMA",0
31,"31143",93,58,52,0,6,"PACMA",0
41,"41064",5611,3763,3667,47,96,"PACMA",24
19,"19154",59,48,47,0,1,"PACMA",0
31,"31103",39,27,27,0,0,"PACMA",0
32,"32051",1407,1158,1153,12,5,"PACMA",8
50,"50213",93,76,75,0,1,"PACMA",0
9,"9224",159,135,132,0,3,"PACMA",0
13,"13071",38130,27060,26802,237,258,"PACMA",252
16,"16112",1468,1108,1096,6,12,"PACMA",6
32,"32052",1819,1399,1379,15,20,"PACMA",9
50,"50214",18,10,10,0,0,"PACMA",0
44,"44114",238,188,184,1,4,"PACMA",0
31,"31104",1751,1306,1280,1,26,"PACMA",10
48,"48087",432,357,356,0,1,"PACMA",0
7,"7022",11615,8055,7934,91,121,"PACMA",75
16,"16254",203,168,166,1,2,"PACMA",2
10,"10209",265,184,184,2,0,"PACMA",0
18,"18183",624,442,441,1,1,"PACMA",3
30,"30002",9735,7319,7227,33,92,"PACMA",81
26,"26003",389,329,328,1,1,"PACMA",2
19,"19289",23,19,19,0,0,"PACMA",0
5,"5142",90,83,81,0,2,"PACMA",0
37,"37106",249,173,173,1,0,"PACMA",0
14,"14042",18727,15069,14837,201,232,"PACMA",172
6,"6055",1998,1552,1523,9,29,"PACMA",4
4,"4088",2435,1708,1693,6,15,"PACMA",14
16,"16255",136,108,108,0,0,"PACMA",0
4,"4011",2757,2171,2136,11,35,"PACMA",21
39,"39081",437,356,347,2,9,"PACMA",0
26,"26004",66,54,54,0,0,"PACMA",0
47,"47040",61,45,44,0,1,"PACMA",0
47,"47229",231,174,168,0,6,"PACMA",1
45,"45146",101,86,85,0,1,"PACMA",1
12,"12134",135,102,100,0,2,"PACMA",1
46,"46204",6657,5262,5204,27,58,"PACMA",44
29,"29052",222,156,153,2,3,"PACMA",3
24,"24207",278,242,235,0,7,"PACMA",1
37,"37107",10483,7732,7633,78,99,"PACMA",42
32,"32054",86475,64472,63712,676,760,"PACMA",694
43,"43103",905,746,740,8,6,"PACMA",26
5,"5261",33,26,26,0,0,"PACMA",0
19,"19160",905,618,613,3,5,"PACMA",15
40,"40078",151,123,122,2,1,"PACMA",1
20,"20064",12436,8730,8652,59,78,"PACMA",100
24,"24209",2609,1880,1857,13,23,"PACMA",14
42,"42010",21,18,16,0,2,"PACMA",0
28,"28066",7515,6105,6039,40,66,"PACMA",92
41,"41040",11111,8768,8679,76,89,"PACMA",135
34,"34096",50,44,44,0,0,"PACMA",1
16,"16117",1022,822,809,6,13,"PACMA",1
39,"39082",1622,1261,1252,16,9,"PACMA",5
44,"44085",49,31,31,0,0,"PACMA",0
40,"40079",226,179,175,1,4,"PACMA",0
7,"7025",446,363,362,4,1,"PACMA",6
16,"16263",966,763,755,2,8,"PACMA",3
50,"50042",16,16,16,0,0,"PACMA",0
7,"7059",3035,2257,2226,13,31,"PACMA",26
26,"26007",481,391,383,0,8,"PACMA",3
44,"44086",421,332,327,3,5,"PACMA",1
22,"22002",106,95,94,0,1,"PACMA",0
28,"28067",4361,3548,3509,14,39,"PACMA",44
37,"37223",112,78,76,0,2,"PACMA",0
48,"48091",1090,862,857,9,5,"PACMA",7
9,"9070",33,28,25,0,3,"PACMA",0
7,"7026",30991,19827,19602,161,225,"PACMA",404
19,"19296",27,24,24,0,0,"PACMA",1
31,"31110",84,72,72,3,0,"PACMA",1
44,"44087",68,56,54,0,2,"PACMA",0
20,"20066",439,327,326,0,1,"PACMA",0
45,"45150",414,326,320,2,6,"PACMA",1
34,"34901",1071,854,847,4,7,"PACMA",2
41,"41070",6397,4987,4921,55,66,"PACMA",84
30,"30037",19254,14416,14217,67,199,"PACMA",168
12,"12137",37,27,27,0,0,"PACMA",1
5,"5148",23,17,17,0,0,"PACMA",0
49,"49219",7221,5301,5186,62,115,"PACMA",28
31,"31111",91,69,69,1,0,"PACMA",0
38,"38901",1456,1024,1010,9,14,"PACMA",12
5,"5265",79,59,59,0,0,"PACMA",0
39,"39001",2065,1669,1643,16,26,"PACMA",9
44,"44182",198,172,171,2,1,"PACMA",0
34,"34902",123,98,98,4,0,"PACMA",1
31,"31031",220,158,157,1,1,"PACMA",1
10,"10095",314,260,255,2,5,"PACMA",0
40,"40082",106,83,81,0,2,"PACMA",0
19,"19015",84,74,73,0,1,"PACMA",1
3,"3095",4740,3702,3657,23,45,"PACMA",53
19,"19065",114,92,91,0,1,"PACMA",0
21,"21012",286,238,233,4,5,"PACMA",1
34,"34903",183,128,128,1,0,"PACMA",0
49,"49259",79,62,61,0,1,"PACMA",0
39,"39085",6964,5489,5445,28,44,"PACMA",50
10,"10177",1695,1358,1323,9,35,"PACMA",9
40,"40048",35,29,29,0,0,"PACMA",0
49,"49055",95,83,83,1,0,"PACMA",0
24,"24213",170,140,139,0,1,"PACMA",1
16,"16122",249,197,196,3,1,"PACMA",0
45,"45016",4442,3621,3583,21,38,"PACMA",52
19,"19118",10,10,10,1,0,"PACMA",0
42,"42016",20,13,13,0,0,"PACMA",0
13,"13082",25882,17928,17721,101,207,"PACMA",193
50,"50045",1198,957,951,3,6,"PACMA",1
43,"43107",383,308,308,1,0,"PACMA",6
7,"7030",1590,1234,1202,8,32,"PACMA",6
9,"9407",27,23,23,0,0,"PACMA",0
28,"28082",6063,4939,4889,46,50,"PACMA",68
9,"9454",42,37,36,0,1,"PACMA",1
48,"48034",12639,9519,9443,77,76,"PACMA",71
41,"41044",7698,5967,5898,59,69,"PACMA",94
26,"26012",33,28,26,0,2,"PACMA",1
24,"24093",338,239,232,3,7,"PACMA",1
20,"20070",1083,831,823,2,8,"PACMA",2
6,"6096",207,168,167,1,1,"PACMA",2
39,"39087",41381,32335,31995,194,340,"PACMA",289
49,"49261",1505,1168,1149,8,19,"PACMA",9
47,"47047",202,164,161,3,3,"PACMA",0
50,"50136",534,416,405,2,11,"PACMA",0
42,"42018",131,102,102,1,0,"PACMA",0
24,"24133",356,267,267,4,0,"PACMA",0
30,"30041",13970,9796,9682,80,114,"PACMA",176
37,"37116",69,51,51,0,0,"PACMA",1
5,"5036",116,100,100,0,0,"PACMA",0
27,"27049",1342,934,921,11,13,"PACMA",5
5,"5191",124,105,105,0,0,"PACMA",0
4,"4021",180,146,143,0,3,"PACMA",1
40,"40123",141,108,104,1,4,"PACMA",1
50,"50223",916,751,745,13,6,"PACMA",1
10,"10181",680,548,542,2,6,"PACMA",2
45,"45158",2546,2026,2001,9,25,"PACMA",17
48,"48097",1316,979,976,4,3,"PACMA",19
42,"42153",12,10,10,1,0,"PACMA",0
23,"23019",1479,1209,1183,3,26,"PACMA",2
34,"34018",205,181,177,2,4,"PACMA",1
26,"26014",447,313,309,2,4,"PACMA",0
47,"47049",91,66,64,0,2,"PACMA",0
14,"14021",260397,195951,193914,2025,2037,"PACMA",2595
9,"9301",648,545,536,7,9,"PACMA",8
42,"42020",4186,3027,2988,28,39,"PACMA",12
15,"15005",25263,17634,17347,257,287,"PACMA",272
9,"9411",154,118,118,0,0,"PACMA",3
49,"49264",540,372,369,1,3,"PACMA",1
16,"16128",51,44,44,0,0,"PACMA",0
5,"5156",234,153,151,0,2,"PACMA",7
28,"28044",6193,5040,4991,31,49,"PACMA",69
25,"25119",2245,1798,1792,10,6,"PACMA",11
34,"34213",52,42,42,0,0,"PACMA",0
49,"49102",183,136,135,2,1,"PACMA",0
25,"25120",92704,68713,68361,445,352,"PACMA",816
4,"4023",120,95,95,2,0,"PACMA",1
28,"28075",5952,4797,4758,25,39,"PACMA",107
7,"7034",1064,906,900,6,6,"PACMA",4
45,"45023",2248,1799,1784,16,15,"PACMA",22
49,"49021",14258,10333,10206,102,127,"PACMA",53
45,"45024",1043,832,821,5,11,"PACMA",2
9,"9246",609,449,441,2,8,"PACMA",1
21,"21019",584,441,425,10,16,"PACMA",1
47,"47209",34,25,25,0,0,"PACMA",0
26,"26016",28,24,23,0,1,"PACMA",0
33,"33060",14132,9960,9794,135,166,"PACMA",80
2,"2061",618,504,500,7,4,"PACMA",3
16,"16275",12,12,12,0,0,"PACMA",0
44,"44096",153,120,112,1,8,"PACMA",2
40,"40195",813,630,623,5,7,"PACMA",1
6,"6101",442,359,354,2,5,"PACMA",1
10,"10063",161,141,141,1,0,"PACMA",2
50,"50901",140,108,108,0,0,"PACMA",1
16,"16006",110,99,98,1,1,"PACMA",0
23,"23090",1219,1014,1004,5,10,"PACMA",8
40,"40196",32,28,28,1,0,"PACMA",0
5,"5040",64,51,51,1,0,"PACMA",0
41,"41049",9493,7463,7312,78,151,"PACMA",54
16,"16131",127,90,90,1,0,"PACMA",1
18,"18025",279,214,212,0,2,"PACMA",0
43,"43907",4359,3370,3346,22,24,"PACMA",71
46,"46246",1042,860,838,2,22,"PACMA",3
11,"11039",9945,6824,6726,111,98,"PACMA",79
22,"22050",93,79,79,2,0,"PACMA",0
9,"9307",112,87,86,0,1,"PACMA",0
31,"31041",1659,1245,1228,23,17,"PACMA",15
5,"5196",57,45,42,0,3,"PACMA",0
46,"46064",525,427,424,4,3,"PACMA",5
27,"27054",1145,907,890,5,17,"PACMA",3
10,"10187",430,316,311,0,5,"PACMA",2
1,"1013",703,491,487,2,4,"PACMA",3
6,"6003",766,625,610,3,15,"PACMA",2
31,"31123",617,392,388,3,4,"PACMA",6
9,"9249",50,39,39,0,0,"PACMA",0
5,"5161",550,444,434,2,10,"PACMA",6
12,"12027",17473,12829,12683,90,146,"PACMA",172
23,"23026",3450,2625,2573,17,52,"PACMA",10
31,"31043",32,24,24,0,0,"PACMA",0
46,"46156",2024,1642,1628,7,14,"PACMA",17
13,"13094",290,227,227,1,0,"PACMA",0
48,"48011",9652,7293,7251,37,42,"PACMA",82
18,"18028",907,766,756,0,10,"PACMA",4
16,"16279",174,125,125,0,0,"PACMA",0
46,"46157",2960,2329,2296,12,33,"PACMA",22
46,"46248",4886,3672,3613,25,59,"PACMA",35
50,"50903",2238,1750,1732,11,18,"PACMA",24
22,"22130",10128,7355,7294,61,61,"PACMA",53
27,"27055",1197,857,851,2,6,"PACMA",1
19,"19082",99,76,75,0,1,"PACMA",1
6,"6105",604,406,400,2,6,"PACMA",2
44,"44193",69,57,56,1,1,"PACMA",0
44,"44002",46,42,42,0,0,"PACMA",0
19,"19034",23,23,22,0,1,"PACMA",0
33,"33064",250,175,174,0,1,"PACMA",0
37,"37238",106,88,87,1,1,"PACMA",1
39,"39095",2240,1809,1778,12,31,"PACMA",6
18,"18134",6069,4431,4345,30,86,"PACMA",56
44,"44130",27,24,24,0,0,"PACMA",0
14,"14058",7859,5854,5745,51,109,"PACMA",41
50,"50114",132,111,111,1,0,"PACMA",0
11,"11007",18020,11346,11152,176,194,"PACMA",149
7,"7040",288348,192799,191053,1586,1746,"PACMA",3616
42,"42162",2325,1721,1699,16,22,"PACMA",8
12,"12029",673,566,556,3,10,"PACMA",3
16,"16137",37,27,25,0,2,"PACMA",0
35,"35009",20109,15017,14803,78,214,"PACMA",138
48,"48907",340,283,281,1,2,"PACMA",1
2,"2068",324,274,273,0,1,"PACMA",1
15,"15012",3611,2695,2616,36,79,"PACMA",22
24,"24227",1548,1148,1128,5,20,"PACMA",12
45,"45170",199,154,150,1,4,"PACMA",2
26,"26139",55,43,43,0,0,"PACMA",0
4,"4032",5698,4168,4138,20,30,"PACMA",25
40,"40202",55,38,38,0,0,"PACMA",0
26,"26099",1216,993,973,14,20,"PACMA",0
39,"39012",6737,5391,5314,52,77,"PACMA",40
7,"7041",2097,1662,1634,20,28,"PACMA",12
9,"9256",333,260,256,2,4,"PACMA",1
29,"29092",579,434,426,5,8,"PACMA",3
31,"31251",3152,2437,2402,12,35,"PACMA",28
44,"44196",125,96,95,2,1,"PACMA",1
45,"45171",1326,1032,1013,6,19,"PACMA",7
10,"10193",1412,1158,1145,4,13,"PACMA",8
31,"31048",160,133,132,2,1,"PACMA",0
9,"9094",51,46,45,0,1,"PACMA",0
12,"12122",767,655,646,3,9,"PACMA",0
19,"19184",62,45,45,0,0,"PACMA",0
5,"5166",160,128,123,1,5,"PACMA",0
2,"2070",384,318,318,2,0,"PACMA",4
19,"19039",59,56,55,1,1,"PACMA",1
41,"41055",14804,10863,10720,79,143,"PACMA",81
18,"18032",242,180,178,2,2,"PACMA",1
44,"44227",72,61,61,0,0,"PACMA",0
50,"50086",178,121,119,2,2,"PACMA",1
42,"42071",163,111,108,2,3,"PACMA",1
49,"49031",145,107,103,0,4,"PACMA",0
3,"3078",474,372,371,2,1,"PACMA",1
23,"23097",6356,4509,4462,17,47,"PACMA",26
31,"31131",907,719,712,8,7,"PACMA",13
22,"22907",1444,1149,1137,12,12,"PACMA",4
22,"22137",1015,741,733,9,8,"PACMA",2
46,"46162",1177,954,938,4,16,"PACMA",9
25,"25059",813,621,612,3,9,"PACMA",7
23,"23098",838,721,715,2,6,"PACMA",6
34,"34125",79,59,58,0,1,"PACMA",1
16,"16142",120,95,95,0,0,"PACMA",0
5,"5051",162,135,131,0,4,"PACMA",1
20,"20901",1412,1034,1030,2,4,"PACMA",10
46,"46071",470,382,366,0,16,"PACMA",3
37,"37356",87,66,66,0,0,"PACMA",0
40,"40101",923,737,728,8,9,"PACMA",6
37,"37244",128,99,97,1,2,"PACMA",0
42,"42167",236,183,182,3,1,"PACMA",0
46,"46163",1856,1522,1501,4,21,"PACMA",24
18,"18034",486,376,374,4,2,"PACMA",1
22,"22139",78,60,60,0,0,"PACMA",0
50,"50235",2412,1826,1807,22,19,"PACMA",20
28,"28024",168,146,145,1,1,"PACMA",0
43,"43045",146,128,127,0,1,"PACMA",0
47,"47186",244448,197042,195276,1561,1766,"PACMA",1619
16,"16143",15,10,10,1,0,"PACMA",0
9,"9321",1597,1293,1280,4,13,"PACMA",7
18,"18140",42374,29390,29025,221,365,"PACMA",399
16,"16189",262,220,220,1,0,"PACMA",1
33,"33009",869,595,591,5,4,"PACMA",3
49,"49155",80,66,65,1,1,"PACMA",0
40,"40103",146,125,123,0,2,"PACMA",2
26,"26145",237,207,204,0,3,"PACMA",0
6,"6112",383,334,334,1,0,"PACMA",2
39,"39100",849,650,644,9,6,"PACMA",5
46,"46164",12073,8987,8836,63,151,"PACMA",106
26,"26029",36,29,28,0,1,"PACMA",0
48,"48019",3461,2647,2633,12,14,"PACMA",16
47,"47001",52,47,46,0,1,"PACMA",1
10,"10158",337,269,267,0,2,"PACMA",0
6,"6013",265,227,221,0,6,"PACMA",1
19,"19097",14,13,13,0,0,"PACMA",0
46,"46104",1891,1515,1481,17,34,"PACMA",12
26,"26030",17,17,17,0,0,"PACMA",0
25,"25098",232,172,170,2,2,"PACMA",1
10,"10200",341,262,261,0,1,"PACMA",0
16,"16147",56,32,32,0,0,"PACMA",0
20,"20904",89,50,49,0,1,"PACMA",0
26,"26031",98,89,87,0,2,"PACMA",1
25,"25002",467,357,356,2,1,"PACMA",3
7,"7048",18412,11528,11412,112,116,"PACMA",254
49,"49241",240,199,199,1,0,"PACMA",1
42,"42036",40,34,33,2,1,"PACMA",0
50,"50180",106,84,84,1,0,"PACMA",0
25,"25003",3721,2828,2815,19,13,"PACMA",24
45,"45043",783,670,664,6,6,"PACMA",2
9,"9163",578,490,481,5,9,"PACMA",1
19,"19329",59,49,49,0,0,"PACMA",3
47,"47063",89,71,71,0,0,"PACMA",0
50,"50062",1863,1441,1416,9,25,"PACMA",18
48,"48915",347,259,259,4,0,"PACMA",0
48,"48021",1336,990,983,4,7,"PACMA",5
50,"50238",86,66,66,2,0,"PACMA",2
24,"24114",2893,2017,1989,17,28,"PACMA",15
16,"16148",546,481,479,1,2,"PACMA",0
10,"10081",184,142,140,4,2,"PACMA",1
2,"2077",54,45,44,0,1,"PACMA",0
23,"23038",3785,3182,3162,16,20,"PACMA",35
20,"20906",130,99,98,1,1,"PACMA",1
44,"44204",27,22,22,0,0,"PACMA",0
15,"15020",3593,2491,2469,18,22,"PACMA",20
48,"48022",2316,1645,1631,11,14,"PACMA",6
37,"37054",238,200,196,3,4,"PACMA",2
24,"24036",272,181,179,4,2,"PACMA",0
25,"25067",706,537,532,4,5,"PACMA",4
32,"32020",2460,1899,1876,6,23,"PACMA",2
16,"16107",98,76,75,1,1,"PACMA",1
48,"48083",6946,5238,5201,35,37,"PACMA",52
46,"46077",7344,5873,5761,49,112,"PACMA",42
33,"33074",3376,2345,2311,41,34,"PACMA",9
35,"35018",13056,8699,8618,73,81,"PACMA",153
2,"2079",2823,2303,2253,22,50,"PACMA",16
22,"22028",362,284,282,5,2,"PACMA",0
19,"19194",94,76,76,0,0,"PACMA",3
22,"22150",461,368,362,1,6,"PACMA",2
9,"9110",77,57,57,0,0,"PACMA",0
46,"46108",426,346,342,1,4,"PACMA",4
9,"9388",33,28,28,0,0,"PACMA",0
37,"37365",166,132,131,1,1,"PACMA",0
9,"9438",561,485,473,6,12,"PACMA",4
35,"35019",32841,21136,20850,125,286,"PACMA",334
19,"19051",61,54,54,0,0,"PACMA",0
21,"21001",610,480,461,3,19,"PACMA",1
45,"45049",423,340,335,1,5,"PACMA",0
14,"14008",2785,1942,1910,15,32,"PACMA",9
26,"26151",411,353,351,3,2,"PACMA",1
50,"50241",595,434,423,3,11,"PACMA",2
42,"42131",52,37,37,0,0,"PACMA",0
9,"9389",64,50,50,0,0,"PACMA",1
45,"45095",660,528,519,3,9,"PACMA",0
9,"9274",1045,875,867,8,8,"PACMA",4
26,"26036",17013,12543,12354,95,189,"PACMA",99
49,"49005",128,87,85,1,2,"PACMA",0
45,"45188",2762,2144,2098,14,46,"PACMA",29
3,"3088",5810,4380,4313,31,67,"PACMA",69
37,"37140",642,422,418,2,4,"PACMA",2
37,"37330",318,255,248,2,7,"PACMA",3
42,"42178",101,75,75,0,0,"PACMA",0
43,"43125",890,700,698,12,2,"PACMA",5
40,"40214",196,167,163,1,4,"PACMA",1
9,"9016",84,55,54,0,1,"PACMA",4
23,"23007",3026,2317,2301,13,16,"PACMA",24
10,"10208",121,94,94,2,0,"PACMA",0
42,"42006",152,115,112,2,3,"PACMA",2
45,"45051",1634,1336,1290,9,46,"PACMA",11
26,"26038",81,61,61,0,0,"PACMA",0
16,"16154",4752,3798,3732,37,66,"PACMA",33
44,"44016",436,334,331,1,3,"PACMA",0
25,"25008",1088,867,857,7,10,"PACMA",3
45,"45052",3134,2670,2652,23,18,"PACMA",44
21,"21041",112810,77371,76488,900,883,"PACMA",1231
42,"42045",276,212,209,2,3,"PACMA",0
33,"33078",126,87,85,0,2,"PACMA",0
37,"37020",425,341,339,4,2,"PACMA",8
37,"37255",42,31,31,2,0,"PACMA",0
36,"36019",1463,1041,1030,14,11,"PACMA",5
34,"34241",18,17,14,4,3,"PACMA",0
5,"5218",105,82,81,0,1,"PACMA",0
41,"41066",1310,1027,1010,1,17,"PACMA",2
9,"9277",107,92,89,0,3,"PACMA",0
9,"9443",152,115,112,0,3,"PACMA",0
26,"26155",149,119,119,0,0,"PACMA",0
46,"46051",8384,6550,6452,24,98,"PACMA",70
50,"50098",162,121,120,3,1,"PACMA",1
43,"43175",537,426,419,5,7,"PACMA",3
19,"19110",56,47,47,0,0,"PACMA",1
32,"32081",2035,1592,1565,14,27,"PACMA",21
50,"50272",13174,10143,10042,103,101,"PACMA",128
10,"10089",1328,1014,982,20,32,"PACMA",7
31,"31904",1561,1139,1130,7,9,"PACMA",0
50,"50069",67,44,44,0,0,"PACMA",0
15,"15027",1555,1227,1204,18,23,"PACMA",12
46,"46113",2527,1906,1892,12,14,"PACMA",36
41,"41038",102179,76348,75425,819,923,"PACMA",1436
40,"40043",1791,1472,1447,9,25,"PACMA",3
31,"31147",106,88,86,3,2,"PACMA",0
32,"32082",1178,880,872,12,8,"PACMA",2
10,"10212",1645,1283,1238,7,45,"PACMA",7
7,"7057",7404,5117,5028,50,89,"PACMA",67
28,"28004",6564,4798,4767,26,31,"PACMA",52
3,"3091",241,201,196,0,5,"PACMA",5
16,"16204",241,198,196,1,2,"PACMA",1
39,"39026",1720,1322,1312,5,10,"PACMA",7
3,"3092",6688,5444,5370,36,74,"PACMA",71
16,"16158",511,428,417,4,11,"PACMA",0
9,"9446",12,8,8,0,0,"PACMA",0
40,"40219",565,451,432,2,19,"PACMA",2
37,"37146",102,86,86,1,0,"PACMA",0
37,"37024",88,69,69,0,0,"PACMA",0
28,"28174",1840,1363,1349,10,14,"PACMA",18
49,"49131",238,182,178,0,4,"PACMA",1
23,"23012",4018,2835,2804,15,31,"PACMA",6
20,"20004",227,156,154,4,2,"PACMA",0
28,"28036",2675,2135,2093,17,42,"PACMA",42
40,"40009",40,34,34,0,0,"PACMA",0
43,"43079",356,306,305,1,1,"PACMA",3
37,"37260",139,109,109,0,0,"PACMA",0
22,"22162",129,99,99,0,0,"PACMA",0
40,"40220",62,48,48,0,0,"PACMA",3
31,"31150",199,140,139,2,1,"PACMA",1
47,"47169",61,53,53,0,0,"PACMA",0
48,"48061",799,636,636,2,0,"PACMA",5
49,"49132",313,252,249,0,3,"PACMA",0
40,"40010",111,95,94,0,1,"PACMA",0
34,"34006",79,73,70,3,3,"PACMA",0
46,"46085",11075,8106,8011,54,95,"PACMA",110
6,"6059",1759,1300,1285,12,15,"PACMA",4
28,"28175",935,775,767,3,8,"PACMA",15
22,"22041",152,121,119,2,2,"PACMA",1
50,"50247",842,621,616,7,5,"PACMA",6
45,"45105",380,284,275,2,9,"PACMA",2
31,"31151",57,42,42,1,0,"PACMA",0
47,"47044",323,282,279,1,3,"PACMA",3
47,"47170",43,34,32,0,2,"PACMA",0
7,"7060",2665,1976,1964,14,12,"PACMA",24
47,"47106",44,35,35,0,0,"PACMA",0
34,"34009",30,26,26,0,0,"PACMA",0
23,"23015",1332,1066,1048,4,18,"PACMA",3
50,"50163",3787,3041,3022,31,19,"PACMA",27
49,"49014",116,89,88,2,1,"PACMA",0
10,"10217",521,436,432,0,4,"PACMA",1
33,"33023",3271,2448,2397,35,51,"PACMA",10
37,"37113",409,330,329,3,1,"PACMA",2
45,"45061",2485,1850,1822,7,28,"PACMA",8
32,"32086",2563,1699,1686,19,13,"PACMA",9
26,"26082",100,85,85,0,0,"PACMA",0
50,"50016",44,31,31,0,0,"PACMA",0
31,"31193",1438,1129,1123,13,6,"PACMA",13
24,"24011",189,122,121,1,1,"PACMA",0
31,"31072",5320,4046,3958,40,88,"PACMA",36
25,"25143",84,72,71,0,1,"PACMA",0
35,"35028",10044,6188,6105,52,83,"PACMA",91
23,"23082",1875,1402,1389,7,13,"PACMA",3
31,"31113",127,84,83,1,1,"PACMA",0
33,"33024",225188,169937,168490,1483,1447,"PACMA",2173
16,"16163",60,50,50,0,0,"PACMA",0
32,"32087",1675,1313,1288,18,25,"PACMA",4
24,"24214",634,473,471,3,2,"PACMA",2
26,"26084",7187,5620,5558,36,62,"PACMA",74
37,"37264",55,42,42,0,0,"PACMA",0
45,"45201",3620,2465,2419,10,46,"PACMA",40
5,"5189",396,325,321,1,4,"PACMA",2
46,"46251",2442,2017,1976,9,41,"PACMA",13
49,"49260",700,558,548,8,10,"PACMA",2
40,"40049",40,30,29,0,1,"PACMA",0
50,"50278",177,137,137,2,0,"PACMA",0
37,"37115",110,81,81,2,0,"PACMA",0
30,"30009",12689,10036,9909,50,127,"PACMA",122
31,"31033",46,29,28,0,1,"PACMA",0
28,"28083",9665,7794,7737,56,57,"PACMA",149
46,"46089",2170,1692,1672,6,20,"PACMA",27
23,"23018",2268,1738,1722,8,16,"PACMA",5
22,"22044",234,184,183,3,1,"PACMA",2
37,"37190",193,144,144,1,0,"PACMA",0
25,"25016",2083,1590,1587,8,3,"PACMA",8
31,"31034",31,27,26,0,1,"PACMA",0
43,"43058",96,77,77,0,0,"PACMA",1
34,"34104",233,190,189,1,1,"PACMA",0
34,"34155",120,104,103,0,1,"PACMA",1
26,"26049",153,115,115,1,0,"PACMA",1
16,"16041",339,271,267,2,4,"PACMA",1
31,"31035",50,34,32,0,2,"PACMA",1
31,"31076",2520,2110,2094,21,16,"PACMA",16
28,"28084",16103,12519,12378,82,141,"PACMA",233
5,"5115",516,397,395,3,2,"PACMA",2
4,"4098",1455,1097,1087,9,10,"PACMA",8
24,"24174",469,360,354,5,6,"PACMA",2
34,"34017",889,743,738,6,5,"PACMA",4
26,"26087",170,136,135,3,1,"PACMA",1
40,"40017",84,74,71,2,3,"PACMA",0
22,"22082",285,230,226,2,4,"PACMA",0
44,"44155",1056,830,813,9,17,"PACMA",4
32,"32033",676,480,468,4,12,"PACMA",1
28,"28012",918,727,711,6,16,"PACMA",14
49,"49225",127,81,81,0,0,"PACMA",0
6,"6902",1663,1273,1252,4,21,"PACMA",2
16,"16169",51,36,32,0,4,"PACMA",0
23,"23020",1524,1363,1348,12,15,"PACMA",6
25,"25019",4646,3224,3199,22,25,"PACMA",25
15,"15036",56248,40194,39764,508,430,"PACMA",426
43,"43060",2684,2158,2152,8,6,"PACMA",13
37,"37033",92,69,69,2,0,"PACMA",2
44,"44189",48,36,36,0,0,"PACMA",0
50,"50138",47,42,42,1,0,"PACMA",0
18,"18126",1450,1115,1087,11,28,"PACMA",11
34,"34063",87,77,77,1,0,"PACMA",0
2,"2024",3374,2657,2613,23,44,"PACMA",26
19,"19260",38,33,31,1,2,"PACMA",0
49,"49265",120,93,92,1,1,"PACMA",0
9,"9303",75,67,67,0,0,"PACMA",0
10,"10905",632,491,485,4,6,"PACMA",5
25,"25050",3269,2457,2446,23,11,"PACMA",13
42,"42060",29,20,19,0,1,"PACMA",0
24,"24139",2087,1558,1540,20,18,"PACMA",8
3,"3133",41499,26593,26308,151,285,"PACMA",442
39,"39091",1885,1512,1503,6,9,"PACMA",3
19,"19124",380,271,268,0,3,"PACMA",1
50,"50254",174,123,122,0,1,"PACMA",1
15,"15006",5169,3527,3436,32,91,"PACMA",11
34,"34109",63,42,41,0,1,"PACMA",0
7,"7002",6612,4721,4672,43,49,"PACMA",55
44,"44126",317,226,222,1,4,"PACMA",0
3,"3010",336,295,280,0,15,"PACMA",3
49,"49266",70,51,49,2,2,"PACMA",0
44,"44028",171,140,138,1,2,"PACMA",0
34,"34160",134,114,112,0,2,"PACMA",2
37,"37271",351,286,280,0,6,"PACMA",1
5,"5195",206,157,157,0,0,"PACMA",0
31,"31040",173,139,139,1,0,"PACMA",0
9,"9306",98,82,81,1,1,"PACMA",0
43,"43062",259,223,220,2,3,"PACMA",1
35,"35034",8396,4599,4546,55,53,"PACMA",106
47,"47083",83,66,65,1,1,"PACMA",2
49,"49145",210,133,131,1,2,"PACMA",0
49,"49229",113,88,87,0,1,"PACMA",2
25,"25052",1562,1273,1264,3,9,"PACMA",4
37,"37310",172,125,124,3,1,"PACMA",0
33,"33031",33854,23523,23143,307,380,"PACMA",240
37,"37272",133,106,106,1,0,"PACMA",0
25,"25122",1925,1505,1497,23,8,"PACMA",7
40,"40021",19,18,18,0,0,"PACMA",1
5,"5236",106,77,77,0,0,"PACMA",0
25,"25221",117,92,92,0,0,"PACMA",1
44,"44060",37,28,28,0,0,"PACMA",0
50,"50256",74,46,45,0,1,"PACMA",0
20,"20015",1237,975,967,8,8,"PACMA",3
49,"49025",159,126,124,0,2,"PACMA",0
46,"46004",1919,1641,1616,14,25,"PACMA",18
43,"43063",536,401,397,1,4,"PACMA",1
38,"38033",3594,2512,2467,11,45,"PACMA",15
34,"34025",53,37,37,2,0,"PACMA",0
42,"42063",47,31,28,0,3,"PACMA",0
5,"5082",495,399,394,1,5,"PACMA",2
28,"28123",61103,52177,51832,338,345,"PACMA",745
3,"3137",657,484,480,5,4,"PACMA",4
18,"18167",1850,1330,1317,17,13,"PACMA",10
16,"16175",5079,4279,4207,40,72,"PACMA",15
48,"48041",686,581,579,2,2,"PACMA",4
48,"48042",1365,1136,1130,7,6,"PACMA",9
28,"28090",9128,7590,7516,54,74,"PACMA",102
28,"28903",35344,30490,30287,201,203,"PACMA",370
42,"42113",521,382,380,3,2,"PACMA",0
50,"50257",163,136,134,1,2,"PACMA",0
46,"46260",2647,2136,2113,8,23,"PACMA",27
25,"25222",66,57,57,0,0,"PACMA",0
29,"29001",4199,3380,3341,20,39,"PACMA",22
42,"42204",54,45,43,2,2,"PACMA",0
16,"16050",220,182,179,1,3,"PACMA",0
18,"18063",1217,712,702,6,10,"PACMA",1
9,"9476",60,50,50,0,0,"PACMA",0
3,"3138",3183,2390,2359,16,31,"PACMA",24
26,"26022",187,153,148,0,5,"PACMA",1
44,"44258",53,44,44,0,0,"PACMA",0
20,"20048",184,120,120,2,0,"PACMA",1
24,"24024",638,463,452,8,11,"PACMA",1
49,"49271",181,147,144,1,3,"PACMA",0
23,"23029",806,651,637,0,14,"PACMA",0
47,"47182",1335,1034,1022,6,12,"PACMA",5
25,"25025",1378,996,983,8,13,"PACMA",19
21,"21025",3898,2765,2705,39,60,"PACMA",16
46,"46007",12284,9370,9265,65,105,"PACMA",136
11,"11008",17840,12434,12236,181,198,"PACMA",208
37,"37040",382,319,316,1,3,"PACMA",1
34,"34168",45,39,39,0,0,"PACMA",0
31,"31046",53,39,39,0,0,"PACMA",1
5,"5085",30,27,27,0,0,"PACMA",2
37,"37164",238,194,193,4,1,"PACMA",1
23,"23095",8591,6634,6571,27,63,"PACMA",34
43,"43091",123,93,93,1,0,"PACMA",2
44,"44131",27,22,22,0,0,"PACMA",1
40,"40903",77,63,62,0,1,"PACMA",0
37,"37086",104,88,88,0,0,"PACMA",0
38,"38007",1625,1124,1104,2,20,"PACMA",12
34,"34031",26,24,24,0,0,"PACMA",0
31,"31047",236,181,179,5,2,"PACMA",0
9,"9314",92,75,74,1,1,"PACMA",0
46,"46221",345,294,294,0,0,"PACMA",3
5,"5204",583,486,482,4,4,"PACMA",2
16,"16185",35,29,29,0,0,"PACMA",0
21,"21027",50,40,39,0,1,"PACMA",0
36,"36005",8122,5895,5776,65,119,"PACMA",51
46,"46008",2624,2036,1996,9,40,"PACMA",32
31,"31049",679,512,505,2,7,"PACMA",1
3,"3110",312,271,269,1,2,"PACMA",2
22,"22184",168,142,139,2,3,"PACMA",0
6,"6075",475,379,369,2,10,"PACMA",3
21,"21064",6641,4689,4597,66,92,"PACMA",37
16,"16140",19,16,16,0,0,"PACMA",0
48,"48076",284,226,224,1,2,"PACMA",0
48,"48046",12644,9809,9744,46,65,"PACMA",44
37,"37279",726,570,562,6,8,"PACMA",6
42,"42209",135,107,100,5,7,"PACMA",0
44,"44133",15,12,12,0,0,"PACMA",0
12,"12065",171,150,147,0,3,"PACMA",1
50,"50290",358,272,266,6,6,"PACMA",0
49,"49153",151,110,108,0,2,"PACMA",0
6,"6109",3843,3228,3106,26,122,"PACMA",7
3,"3048",4971,3808,3739,19,69,"PACMA",51
44,"44067",108,82,78,0,4,"PACMA",0
29,"29006",665,491,483,5,8,"PACMA",1
25,"25030",123,90,90,1,0,"PACMA",1
20,"20021",186,112,112,0,0,"PACMA",1
39,"39043",1523,1246,1220,10,26,"PACMA",9
46,"46041",327,251,250,2,1,"PACMA",1
14,"14062",963,753,745,4,8,"PACMA",0
13,"13013",7050,5475,5371,39,104,"PACMA",31
21,"21030",1879,1523,1504,14,19,"PACMA",15
23,"23033",1319,1076,1057,8,19,"PACMA",4
36,"36008",21884,16428,16170,165,258,"PACMA",222
46,"46011",7523,5320,5235,28,85,"PACMA",69
25,"25031",57,39,39,0,0,"PACMA",0
13,"13059",196,169,168,0,1,"PACMA",2
34,"34227",72,63,61,4,2,"PACMA",0
16,"16057",64,53,53,0,0,"PACMA",1
21,"21031",1172,807,764,5,43,"PACMA",2
9,"9901",340,256,255,1,1,"PACMA",4
34,"34176",127,106,104,2,2,"PACMA",0
34,"34126",254,220,219,3,1,"PACMA",1
49,"49078",142,113,113,1,0,"PACMA",0
2,"2037",22952,16040,15815,101,225,"PACMA",164
31,"31053",503,375,370,4,5,"PACMA",3
46,"46012",929,727,707,3,20,"PACMA",16
44,"44229",143,110,108,4,2,"PACMA",0
42,"42078",1005,769,756,6,13,"PACMA",2
19,"19189",115,93,92,0,1,"PACMA",0
48,"48913",1224,977,967,6,10,"PACMA",9
18,"18913",781,590,577,5,13,"PACMA",8
25,"25032",67,53,53,0,0,"PACMA",1
50,"50207",93,68,67,2,1,"PACMA",0
9,"9266",103,85,85,0,0,"PACMA",0
40,"40207",800,662,652,6,10,"PACMA",14
31,"31135",112,76,75,2,1,"PACMA",1
49,"49035",222,195,195,2,0,"PACMA",0
50,"50004",478,380,376,2,4,"PACMA",1
15,"15049",1091,805,796,8,9,"PACMA",1
46,"46013",17712,14181,14075,88,106,"PACMA",228
19,"19234",45,32,32,0,0,"PACMA",0
25,"25131",402,321,320,1,1,"PACMA",2
40,"40140",79,58,58,0,0,"PACMA",0
25,"25132",143,118,118,0,0,"PACMA",2
48,"48050",187,153,149,0,4,"PACMA",0
13,"13017",247,189,188,2,1,"PACMA",0
14,"14035",5817,4373,4314,44,59,"PACMA",17
37,"37285",366,273,272,1,1,"PACMA",0
16,"16245",400,329,318,0,11,"PACMA",5
10,"10120",156,110,108,0,2,"PACMA",3
45,"45089",1432,1159,1134,5,25,"PACMA",5
23,"23067",2421,1909,1873,13,36,"PACMA",13
19,"19098",18,18,17,0,1,"PACMA",0
47,"47003",204,171,168,4,3,"PACMA",0
33,"33012",5105,3601,3566,46,35,"PACMA",26
50,"50005",239,204,201,2,3,"PACMA",0
31,"31178",472,354,348,3,6,"PACMA",2
50,"50091",40,35,35,0,0,"PACMA",0
23,"23069",5262,4395,4329,15,66,"PACMA",30
31,"31056",185,141,134,3,7,"PACMA",3
49,"49038",94,68,68,1,0,"PACMA",0
49,"49159",269,214,213,1,1,"PACMA",2
15,"15051",4562,3302,3249,36,53,"PACMA",41
48,"48082",37396,27913,27694,172,219,"PACMA",238
22,"22063",159,133,132,2,1,"PACMA",0
29,"29901",44578,31840,31537,286,303,"PACMA",687
13,"13020",4729,3461,3416,34,45,"PACMA",32
41,"41089",6629,4904,4814,48,90,"PACMA",69
31,"31098",1962,1562,1544,14,18,"PACMA",14
4,"4004",400,320,315,2,5,"PACMA",1
28,"28101",229,183,182,2,1,"PACMA",5
34,"34086",99,92,90,2,2,"PACMA",1
47,"47096",126,106,105,0,1,"PACMA",0
19,"19102",92,80,80,0,0,"PACMA",0
41,"41005",9250,6925,6809,69,116,"PACMA",83
19,"19103",251,218,216,1,2,"PACMA",0
31,"31058",202,163,160,2,3,"PACMA",0
16,"16195",458,368,364,3,4,"PACMA",2
29,"29012",9718,7243,7123,47,120,"PACMA",73
3,"3024",3948,3210,3164,14,46,"PACMA",25
44,"44143",394,327,327,2,0,"PACMA",3
28,"28104",15318,12897,12797,87,100,"PACMA",179
15,"15053",7548,5364,5309,44,55,"PACMA",40
42,"42003",66,55,55,0,0,"PACMA",0
49,"49084",268,226,223,9,3,"PACMA",1
19,"19104",18,16,16,0,0,"PACMA",0
10,"10002",359,284,279,2,5,"PACMA",2
24,"24160",645,481,475,1,6,"PACMA",6
42,"42084",20,16,16,0,0,"PACMA",0
25,"25135",1000,773,769,2,4,"PACMA",7
14,"14038",32692,24015,23679,213,336,"PACMA",302
50,"50269",279,189,186,1,3,"PACMA",2
46,"46109",6174,4763,4639,30,124,"PACMA",36
37,"37177",265,209,208,0,1,"PACMA",1
21,"21075",335,256,249,0,7,"PACMA",1
15,"15022",5574,3846,3798,41,48,"PACMA",28
19,"19002",57,45,45,0,0,"PACMA",0
28,"28106",78429,59182,58471,417,711,"PACMA",1244
25,"25169",167,118,117,0,1,"PACMA",0
10,"10125",862,655,639,4,16,"PACMA",2
26,"26073",94,72,68,0,4,"PACMA",0
36,"36017",17419,12867,12610,120,257,"PACMA",98
40,"40039",180,147,144,1,3,"PACMA",0
25,"25069",425,329,327,1,2,"PACMA",0
10,"10167",307,238,237,1,1,"PACMA",0
45,"45004",552,434,434,4,0,"PACMA",4
41,"41008",1040,840,822,4,18,"PACMA",5
24,"24202",7559,5449,5363,63,86,"PACMA",35
33,"33077",1118,772,761,4,11,"PACMA",1
43,"43149",684,533,533,4,0,"PACMA",1
6,"6152",1285,952,935,4,17,"PACMA",3
40,"40110",316,254,253,2,1,"PACMA",2
21,"21040",3181,2303,2227,21,76,"PACMA",41
50,"50270",38,32,30,1,2,"PACMA",0
31,"31184",65,48,46,0,2,"PACMA",0
28,"28107",442,336,325,3,11,"PACMA",4
31,"31063",83,63,60,2,3,"PACMA",0
48,"48056",989,791,785,4,6,"PACMA",10
37,"37217",59,48,46,1,2,"PACMA",1
31,"31185",470,335,332,6,3,"PACMA",0
46,"46111",11326,8603,8492,55,111,"PACMA",133
47,"47008",22,15,15,0,0,"PACMA",0
33,"33017",2997,2096,2058,29,38,"PACMA",6
42,"42135",70,46,45,0,1,"PACMA",0
48,"48026",1139,920,913,4,7,"PACMA",8
5,"5141",95,82,82,0,0,"PACMA",0
15,"15056",5648,4033,3979,39,54,"PACMA",26
21,"21042",15579,8742,8579,138,163,"PACMA",162
33,"33018",2819,2072,2044,28,28,"PACMA",10
26,"26076",116,93,91,0,2,"PACMA",0
23,"23009",12808,10348,10233,66,115,"PACMA",63
26,"26154",10,10,10,1,0,"PACMA",0
48,"48057",5745,4391,4376,13,15,"PACMA",12
33,"33049",6044,4152,4079,56,73,"PACMA",32
48,"48058",946,724,715,3,9,"PACMA",0
40,"40077",932,747,730,9,17,"PACMA",16
31,"31065",1859,1383,1366,16,17,"PACMA",7
16,"16202",741,573,568,4,5,"PACMA",2
9,"9339",126,105,105,1,0,"PACMA",0
9,"9019",144,113,109,1,4,"PACMA",1
49,"49208",364,260,255,5,5,"PACMA",1
45,"45192",2412,2103,2068,7,35,"PACMA",5
36,"36051",14315,10396,10223,70,173,"PACMA",127
11,"11025",4388,3092,3045,30,47,"PACMA",20
9,"9340",76,56,56,1,0,"PACMA",0
45,"45101",3709,3052,3002,14,50,"PACMA",13
33,"33020",13000,9476,9338,108,138,"PACMA",110
3,"3123",7576,5900,5814,36,86,"PACMA",63
25,"25140",773,573,571,5,2,"PACMA",1
12,"12013",137,113,113,0,0,"PACMA",2
37,"37062",77,65,63,0,2,"PACMA",1
4,"4089",694,516,510,1,6,"PACMA",6
30,"30004",1126,884,876,5,8,"PACMA",3
41,"41012",3368,2416,2361,23,55,"PACMA",32
9,"9021",51,36,35,1,1,"PACMA",3
46,"46205",14233,11274,11145,55,129,"PACMA",139
34,"34196",88,74,74,4,0,"PACMA",1
4,"4013",143321,101501,100814,750,687,"PACMA",1338
36,"36052",7234,5292,5151,44,141,"PACMA",26
22,"22075",119,87,87,1,0,"PACMA",2
47,"47042",50,41,39,0,2,"PACMA",0
5,"5107",55,43,43,2,0,"PACMA",0
2,"2051",1665,1253,1222,6,31,"PACMA",4
37,"37065",271,187,184,0,3,"PACMA",0
37,"37297",401,319,315,2,4,"PACMA",0
14,"14045",3013,2508,2468,13,40,"PACMA",13
44,"44149",100,74,73,0,1,"PACMA",0
3,"3032",99,87,87,0,0,"PACMA",0
47,"47043",309,276,273,1,3,"PACMA",0
23,"23047",1579,1260,1247,13,13,"PACMA",15
49,"49171",610,477,473,8,4,"PACMA",2
22,"22076",288,228,226,1,2,"PACMA",0
33,"33022",813,555,543,6,12,"PACMA",8
25,"25175",176,135,135,1,0,"PACMA",0
47,"47200",71,62,62,0,0,"PACMA",1
19,"19249",28,28,28,0,0,"PACMA",0
43,"43007",640,510,509,0,1,"PACMA",7
48,"48092",869,676,674,9,2,"PACMA",6
42,"42013",37,29,29,0,0,"PACMA",0
36,"36054",11074,8032,7873,77,159,"PACMA",82
28,"28113",36716,29939,29607,224,332,"PACMA",539
40,"40081",119,96,95,2,1,"PACMA",0
11,"11029",5423,3161,3105,55,56,"PACMA",12
29,"29022",171,144,143,0,1,"PACMA",3
4,"4093",1919,1346,1326,10,20,"PACMA",9
21,"21048",313,243,237,4,6,"PACMA",2
40,"40154",23,20,20,0,0,"PACMA",0
23,"23081",1483,1137,1109,7,28,"PACMA",7
34,"34010",553,454,449,3,5,"PACMA",0
26,"26009",391,317,314,2,3,"PACMA",0
20,"20067",30618,21972,21854,138,118,"PACMA",244
50,"50044",222,161,161,3,0,"PACMA",3
18,"18154",975,701,699,3,2,"PACMA",0
46,"46178",4943,3684,3641,21,43,"PACMA",68
40,"40155",3835,3165,3121,43,44,"PACMA",42
49,"49097",74,43,43,0,0,"PACMA",0
24,"24091",585,433,423,1,10,"PACMA",1
50,"50104",326,264,259,4,5,"PACMA",3
28,"28114",143,104,104,0,0,"PACMA",0
31,"31194",326,251,250,1,1,"PACMA",1
34,"34072",143,130,128,1,2,"PACMA",0
5,"5033",170,146,145,0,1,"PACMA",1
9,"9129",89,75,75,0,0,"PACMA",1
9,"9292",75,62,62,2,0,"PACMA",1
50,"50220",43,37,37,0,0,"PACMA",0
5,"5228",167,124,124,0,0,"PACMA",0
3,"3129",1218,994,982,5,12,"PACMA",11
43,"43156",3956,2993,2965,23,28,"PACMA",22
9,"9027",48,41,39,0,2,"PACMA",0
28,"28148",88647,70218,69546,570,672,"PACMA",1126
22,"22208",194,159,156,1,3,"PACMA",1
9,"9295",54,38,38,0,0,"PACMA",0
13,"13901",864,687,673,1,14,"PACMA",1
50,"50135",88,74,74,3,0,"PACMA",1
31,"31074",390,310,307,5,3,"PACMA",2
49,"49176",610,426,426,4,0,"PACMA",1
16,"16215",237,157,153,1,4,"PACMA",0
21,"21051",221,180,177,1,3,"PACMA",2
40,"40191",204,166,165,1,1,"PACMA",3
48,"48065",3303,2541,2524,15,17,"PACMA",16
44,"44247",287,216,215,6,1,"PACMA",0
28,"28116",759,621,618,7,3,"PACMA",10
42,"42056",28,25,24,0,1,"PACMA",0
35,"35002",24129,16979,16736,116,243,"PACMA",248
26,"26126",29,29,29,1,0,"PACMA",0
47,"47017",198,162,160,1,2,"PACMA",2
11,"11034",2331,1708,1670,17,38,"PACMA",5
49,"49223",716,552,548,0,4,"PACMA",0
34,"34210",103,90,90,1,0,"PACMA",0
39,"39088",59,51,51,0,0,"PACMA",0
9,"9298",75,62,62,1,0,"PACMA",0
9,"9189",126,102,96,0,6,"PACMA",0
19,"19121",264,219,217,0,2,"PACMA",0
23,"23086",11442,8618,8431,80,187,"PACMA",97
44,"44055",77,58,56,0,2,"PACMA",0
31,"31158",248,182,177,2,5,"PACMA",0
46,"46090",1633,1413,1392,5,21,"PACMA",15
47,"47175",6704,5296,5222,52,74,"PACMA",61
24,"24175",1831,1433,1412,17,21,"PACMA",17
49,"49019",228,170,164,0,6,"PACMA",1
7,"7901",594,454,446,6,8,"PACMA",0
21,"21017",2325,1450,1419,22,31,"PACMA",5
47,"47113",142,117,117,1,0,"PACMA",0
45,"45114",560,441,436,0,5,"PACMA",1
44,"44026",95,76,75,2,1,"PACMA",0
14,"14052",9080,5999,5909,63,90,"PACMA",50
1,"1008",802,576,570,3,6,"PACMA",8
24,"24136",496,375,371,2,4,"PACMA",1
5,"5037",219,143,142,2,1,"PACMA",0
22,"22252",118,100,99,0,1,"PACMA",0
31,"31119",36,26,25,0,1,"PACMA",0
34,"34108",502,424,415,6,9,"PACMA",3
47,"47050",3898,3084,3047,36,37,"PACMA",32
33,"33029",323,172,170,2,2,"PACMA",0
49,"49180",138,95,95,0,0,"PACMA",0
29,"29029",380,294,287,2,7,"PACMA",5
45,"45070",1406,1201,1188,4,13,"PACMA",2
21,"21055",7218,5328,5215,41,113,"PACMA",57
36,"36030",3946,2847,2810,26,37,"PACMA",13
50,"50225",1532,1072,1064,10,8,"PACMA",5
24,"24018",174,141,139,0,2,"PACMA",1
22,"22253",57,48,47,0,1,"PACMA",0
20,"20073",4698,3530,3515,29,15,"PACMA",26
48,"48038",1158,891,891,2,0,"PACMA",3
31,"31120",383,264,260,3,4,"PACMA",3
26,"26130",201,164,163,0,1,"PACMA",0
38,"38031",29154,22871,22598,143,273,"PACMA",353
23,"23055",46343,33603,33225,243,378,"PACMA",334
43,"43086",5263,4046,4021,17,25,"PACMA",36
43,"43160",1322,1051,1045,0,6,"PACMA",16
36,"36031",562,455,450,2,5,"PACMA",8
6,"6068",431,324,317,4,7,"PACMA",1
9,"9194",1969,1526,1511,14,15,"PACMA",3
45,"45163",8340,6486,6363,38,123,"PACMA",38
5,"5235",139,106,101,0,5,"PACMA",1
44,"44158",1166,921,904,7,17,"PACMA",4
43,"43014",14357,10596,10542,60,54,"PACMA",70
50,"50198",49,43,43,1,0,"PACMA",2
47,"47211",48,43,43,1,0,"PACMA",0
22,"22013",275,218,217,6,1,"PACMA",4
14,"14024",1859,1461,1418,10,43,"PACMA",16
36,"36032",3537,2676,2626,16,50,"PACMA",11
48,"48070",528,392,390,2,2,"PACMA",0
27,"27033",598,423,415,1,8,"PACMA",3
28,"28154",5525,4283,4222,24,61,"PACMA",70
50,"50052",85,64,64,0,0,"PACMA",0
7,"7037",3357,2142,2120,16,22,"PACMA",34
28,"28122",570,457,448,3,9,"PACMA",15
25,"25186",207,174,173,7,1,"PACMA",0
16,"16227",108,85,85,1,0,"PACMA",0
33,"33032",11086,8028,7849,129,179,"PACMA",64
19,"19129",27,25,25,0,0,"PACMA",0
31,"31204",36,27,27,1,0,"PACMA",1
47,"47212",358,312,311,3,1,"PACMA",2
46,"46247",961,695,687,3,8,"PACMA",5
50,"50024",556,427,426,6,1,"PACMA",1
4,"4068",174,134,134,0,0,"PACMA",1
50,"50229",65,57,56,0,1,"PACMA",0
19,"19081",27,19,19,0,0,"PACMA",0
42,"42025",1134,824,813,6,11,"PACMA",0
44,"44160",440,311,306,2,5,"PACMA",0
5,"5237",155,131,129,1,2,"PACMA",0
20,"20047",462,337,335,2,2,"PACMA",1
37,"37313",534,413,411,1,2,"PACMA",0
10,"10149",434,308,304,2,4,"PACMA",3
11,"11042",1155,870,852,7,18,"PACMA",8
11,"11005",4520,3212,3128,23,84,"PACMA",16
34,"34116",55,45,45,0,0,"PACMA",0
16,"16094",120,89,88,0,1,"PACMA",0
44,"44257",154,110,109,1,1,"PACMA",0
2,"2030",2978,2357,2315,13,42,"PACMA",13
34,"34071",161,138,138,0,0,"PACMA",0
49,"49186",235,181,178,4,3,"PACMA",0
50,"50026",421,340,328,4,12,"PACMA",2
25,"25902",542,449,439,3,10,"PACMA",2
31,"31004",32,26,26,0,0,"PACMA",0
28,"28049",57902,47976,47561,329,415,"PACMA",750
16,"16248",862,730,720,10,10,"PACMA",7
16,"16234",23,16,16,0,0,"PACMA",0
50,"50286",75,58,55,0,3,"PACMA",0
31,"31262",234,201,199,2,2,"PACMA",3
44,"44161",430,320,316,1,4,"PACMA",1
7,"7007",414,326,324,2,2,"PACMA",6
44,"44063",65,55,55,1,0,"PACMA",1
4,"4904",1879,1328,1322,4,6,"PACMA",13
50,"50287",252,200,196,7,4,"PACMA",0
45,"45124",2069,1757,1718,14,39,"PACMA",16
25,"25903",229,189,188,0,1,"PACMA",2
11,"11902",3656,2427,2383,29,44,"PACMA",17
21,"21062",1386,893,885,15,8,"PACMA",2
50,"50115",3275,2399,2355,32,44,"PACMA",13
50,"50027",224,170,165,1,5,"PACMA",0
36,"36036",2556,1953,1914,14,39,"PACMA",26
34,"34236",147,111,111,0,0,"PACMA",0
46,"46038",307,243,241,0,2,"PACMA",1
47,"47121",521,429,422,5,7,"PACMA",0
9,"9423",28,26,26,0,0,"PACMA",1
15,"15044",1209,889,876,4,13,"PACMA",5
40,"40061",65,50,48,2,2,"PACMA",0
38,"38037",12803,8628,8517,48,111,"PACMA",136
31,"31210",186,156,156,1,0,"PACMA",1
50,"50146",190,152,149,0,3,"PACMA",2
2,"2033",1870,1503,1463,11,40,"PACMA",16
47,"47216",114,102,98,0,4,"PACMA",0
26,"26101",34,27,27,0,0,"PACMA",1
39,"39097",679,437,435,2,2,"PACMA",1
46,"46039",2121,1730,1698,19,32,"PACMA",25
26,"26140",239,199,194,1,5,"PACMA",1
47,"47123",461,391,390,3,1,"PACMA",2
3,"3901",1109,827,820,5,7,"PACMA",25
31,"31008",63,51,49,1,2,"PACMA",0
39,"39013",535,434,431,1,3,"PACMA",1
27,"27028",78798,58316,57546,629,770,"PACMA",583
36,"36048",5244,3859,3786,33,73,"PACMA",41
48,"48086",2015,1504,1486,6,18,"PACMA",8
37,"37243",90,71,70,0,1,"PACMA",0
49,"49236",70,55,55,0,0,"PACMA",0
23,"23063",3764,2812,2781,22,31,"PACMA",8
45,"45128",2552,1874,1839,9,35,"PACMA",20
43,"43117",143,114,113,0,1,"PACMA",0
50,"50029",604,475,467,7,8,"PACMA",2
40,"40171",39,29,29,1,0,"PACMA",0
39,"39098",1379,1154,1144,7,10,"PACMA",1
41,"41056",3694,3044,3009,36,35,"PACMA",40
3,"3902",10578,7654,7530,56,124,"PACMA",95
9,"9374",90,79,78,1,1,"PACMA",1
16,"16240",100,77,76,0,1,"PACMA",1
26,"26103",827,655,645,3,10,"PACMA",8
31,"31254",1920,1457,1435,8,22,"PACMA",12
31,"31255",103,87,84,0,3,"PACMA",0
28,"28054",11891,9476,9395,64,81,"PACMA",124
21,"21066",495,401,396,4,5,"PACMA",1
47,"47219",40,38,34,0,4,"PACMA",0
7,"7012",1909,1358,1343,15,15,"PACMA",5
2,"2036",95,75,75,0,0,"PACMA",0
38,"38040",5446,3513,3462,13,51,"PACMA",37
14,"14032",393,328,321,2,7,"PACMA",1
31,"31052",103,79,78,0,1,"PACMA",0
28,"28023",5090,4252,4212,31,40,"PACMA",54
26,"26028",139,120,117,1,3,"PACMA",0
35,"35023",11694,8785,8607,67,178,"PACMA",90
45,"45176",3841,2992,2952,16,40,"PACMA",66
40,"40031",540,429,424,6,5,"PACMA",4
10,"10076",793,597,585,4,12,"PACMA",1
26,"26183",66,50,50,0,0,"PACMA",2
14,"14063",1000,767,757,4,10,"PACMA",3
5,"5246",52,39,39,0,0,"PACMA",0
27,"27031",15212,10826,10649,125,177,"PACMA",108
13,"13060",272,219,214,4,5,"PACMA",0
29,"29041",3599,2570,2532,22,38,"PACMA",34
24,"24070",3941,3007,2947,27,60,"PACMA",28
20,"20903",4803,3514,3481,24,33,"PACMA",38
47,"47220",154,119,119,1,0,"PACMA",0
9,"9430",22,20,20,0,0,"PACMA",0
45,"45179",495,383,382,3,1,"PACMA",0
12,"12014",167,131,127,1,4,"PACMA",0
31,"31175",64,50,50,0,0,"PACMA",1
22,"22188",76,60,59,1,1,"PACMA",0
23,"23101",352,273,271,0,2,"PACMA",0
18,"18003",14413,11095,10883,92,212,"PACMA",143
33,"33041",7112,5251,5194,63,57,"PACMA",59
44,"44169",310,250,245,4,5,"PACMA",0
36,"36043",4682,3345,3303,17,42,"PACMA",36
5,"5132",881,634,626,2,8,"PACMA",5
34,"34199",1159,910,880,7,30,"PACMA",7
29,"29042",14447,10383,10199,98,184,"PACMA",134
22,"22103",676,520,517,6,3,"PACMA",12
50,"50208",1748,1360,1344,11,16,"PACMA",4
37,"37208",69,52,51,0,1,"PACMA",0
45,"45042",183,141,137,0,4,"PACMA",1
31,"31217",334,233,225,3,8,"PACMA",1
44,"44266",102,89,86,1,3,"PACMA",0
44,"44109",102,71,70,1,1,"PACMA",0
9,"9105",97,81,76,1,5,"PACMA",0
10,"10201",179,157,156,1,1,"PACMA",0
47,"47033",204,167,167,2,0,"PACMA",0
19,"19148",42,35,33,0,2,"PACMA",0
31,"31097",10521,7602,7550,76,52,"PACMA",57
31,"31016",7752,6114,6064,47,50,"PACMA",58
50,"50122",67,55,54,0,1,"PACMA",1
25,"25064",98,88,88,0,0,"PACMA",0
37,"37211",212,164,163,1,1,"PACMA",1
5,"5252",58,38,38,0,0,"PACMA",0
9,"9434",1280,1089,1077,12,12,"PACMA",10
16,"16022",78,70,70,0,0,"PACMA",1
46,"46228",2417,1953,1913,13,40,"PACMA",29
16,"16247",63,53,53,1,0,"PACMA",0
33,"33043",658,462,455,4,7,"PACMA",2
37,"37362",4729,3769,3720,36,49,"PACMA",34
39,"39047",1976,1564,1538,8,26,"PACMA",15
2,"2042",818,631,620,1,11,"PACMA",3
31,"31179",483,348,344,2,4,"PACMA",2
37,"37325",90,70,70,0,0,"PACMA",1
10,"10136",285,223,223,1,0,"PACMA",2
26,"26034",612,509,497,5,12,"PACMA",3
42,"42001",251,186,186,2,0,"PACMA",2
12,"12008",224,197,194,1,3,"PACMA",2
19,"19211",356,301,300,0,1,"PACMA",5
15,"15084",3059,2236,2217,20,19,"PACMA",5
5,"5136",84,64,64,2,0,"PACMA",0
9,"9235",140,105,102,0,3,"PACMA",0
37,"37328",164,127,127,4,0,"PACMA",0
25,"25068",531,402,399,6,3,"PACMA",2
50,"50240",965,720,702,9,18,"PACMA",3
47,"47035",902,715,707,5,8,"PACMA",1
43,"43172",337,261,257,2,4,"PACMA",1
10,"10165",253,212,210,1,2,"PACMA",0
19,"19001",41,33,33,0,0,"PACMA",0
47,"47193",1609,1347,1332,9,15,"PACMA",14
44,"44076",2110,1725,1691,22,34,"PACMA",3
9,"9439",1054,867,851,8,16,"PACMA",17
46,"46048",3509,2758,2720,11,38,"PACMA",26
44,"44245",245,176,171,1,5,"PACMA",2
18,"18040",226,146,145,0,1,"PACMA",1
10,"10166",313,211,202,0,9,"PACMA",2
42,"42042",49,42,42,1,0,"PACMA",1
19,"19153",22,22,22,0,0,"PACMA",0
9,"9221",492,413,409,0,4,"PACMA",4
12,"12010",237,203,198,1,5,"PACMA",1
36,"36047",2287,1601,1585,14,16,"PACMA",0
50,"50037",127,93,93,0,0,"PACMA",2
2,"2045",3617,3020,2969,38,51,"PACMA",26
49,"49125",1401,1031,1010,7,21,"PACMA",12
5,"5178",345,287,283,1,4,"PACMA",0
34,"34237",573,479,472,4,7,"PACMA",1
46,"46049",268,231,228,1,3,"PACMA",2
35,"35020",5933,4140,4088,14,52,"PACMA",34
31,"31225",35,29,29,1,0,"PACMA",0
47,"47068",30,23,23,0,0,"PACMA",0
12,"12103",90,75,70,1,5,"PACMA",0
24,"24002",233,183,183,1,0,"PACMA",2
5,"5258",107,96,96,2,0,"PACMA",1
21,"21052",4429,2951,2891,19,60,"PACMA",32
26,"26013",323,258,256,1,2,"PACMA",6
21,"21077",1725,1307,1286,10,21,"PACMA",7
12,"12011",4582,3511,3431,27,80,"PACMA",50
19,"19288",22,21,21,1,0,"PACMA",0
31,"31902",4649,3620,3598,34,22,"PACMA",49
22,"22156",296,246,242,3,4,"PACMA",4
43,"43027",164,137,137,0,0,"PACMA",1
45,"45006",1326,983,972,6,11,"PACMA",4
37,"37104",25,18,18,0,0,"PACMA",1
44,"44207",130,101,101,1,0,"PACMA",1
24,"24203",95,72,72,0,0,"PACMA",2
28,"28181",20669,17314,17205,101,109,"PACMA",237
44,"44124",73,58,57,0,1,"PACMA",0
44,"44177",101,75,75,1,0,"PACMA",0
9,"9226",56,47,47,0,0,"PACMA",0
21,"21078",2646,1926,1895,14,31,"PACMA",9
47,"47134",148,127,126,6,1,"PACMA",0
41,"41037",3192,2505,2479,15,26,"PACMA",5
32,"32025",1013,773,761,7,12,"PACMA",6
40,"40148",228,185,180,0,5,"PACMA",2
2,"2048",1178,989,967,7,22,"PACMA",8
31,"31105",1478,1203,1189,21,14,"PACMA",1
44,"44178",53,39,39,0,0,"PACMA",0
46,"46234",327,264,263,5,1,"PACMA",4
19,"19007",435,328,319,1,9,"PACMA",0
28,"28141",6246,4943,4890,44,53,"PACMA",99
32,"32063",1819,1313,1287,6,26,"PACMA",7
45,"45100",179,150,148,1,2,"PACMA",2
18,"18079",3469,2667,2623,16,44,"PACMA",30
49,"49209",474,338,334,4,4,"PACMA",0
48,"48089",3463,2746,2732,10,14,"PACMA",34
9,"9228",157,136,136,0,0,"PACMA",0
14,"14073",2772,2124,2069,18,55,"PACMA",2
27,"27042",1648,1247,1233,21,14,"PACMA",2
34,"34094",61,44,44,0,0,"PACMA",0
22,"22203",76,61,61,0,0,"PACMA",0
9,"9396",153,125,124,0,1,"PACMA",2
26,"26118",72,63,60,1,3,"PACMA",0
34,"34243",320,260,258,1,2,"PACMA",0
10,"10091",350,293,291,1,2,"PACMA",0
28,"28901",868,653,639,6,14,"PACMA",6
46,"46236",937,764,755,5,9,"PACMA",8
9,"9398",74,59,58,1,1,"PACMA",0
29,"29075",12890,9033,8949,73,84,"PACMA",136
26,"26042",799,605,596,5,9,"PACMA",6
48,"48090",6016,4700,4639,24,61,"PACMA",23
9,"9283",44,33,33,0,0,"PACMA",1
34,"34098",783,614,605,3,9,"PACMA",10
23,"23046",2331,1953,1926,3,27,"PACMA",13
33,"33071",563,413,407,2,6,"PACMA",3
5,"5145",47,27,27,1,0,"PACMA",0
36,"36053",5784,4407,4327,28,80,"PACMA",34
13,"13078",8936,6820,6733,46,87,"PACMA",36
37,"37336",52,46,45,3,1,"PACMA",0
16,"16159",209,147,144,0,3,"PACMA",0
33,"33052",704,520,513,5,7,"PACMA",1
32,"32056",1520,1125,1116,6,9,"PACMA",4
38,"38053",3763,2628,2588,21,40,"PACMA",22
40,"40080",48,39,39,0,0,"PACMA",1
49,"49256",242,204,202,4,2,"PACMA",0
25,"25074",180,157,155,2,2,"PACMA",0
50,"50043",246,172,170,2,2,"PACMA",2
39,"39084",874,718,712,4,6,"PACMA",5
42,"42051",15,10,10,0,0,"PACMA",0
5,"5185",90,71,70,0,1,"PACMA",1
37,"37337",139,114,114,0,0,"PACMA",0
10,"10216",1522,1195,1167,9,28,"PACMA",9
18,"18119",1712,1352,1317,11,35,"PACMA",8
31,"31192",157,133,130,1,3,"PACMA",5
10,"10053",279,226,224,5,2,"PACMA",0
46,"46238",13105,9717,9610,57,107,"PACMA",134
46,"46147",17133,12260,12120,59,140,"PACMA",166
22,"22003",132,114,114,0,0,"PACMA",3
19,"19165",41,36,36,0,0,"PACMA",0
20,"20006",254,169,169,0,0,"PACMA",1
3,"3033",102,87,85,0,2,"PACMA",2
37,"37375",673,583,573,4,10,"PACMA",0
46,"46250",581614,454786,451184,2675,3602,"PACMA",6587
24,"24010",8268,5968,5847,66,121,"PACMA",37
16,"16280",165,130,128,3,2,"PACMA",0
2,"2018",796,693,682,5,11,"PACMA",1
6,"6028",4109,3613,3538,17,75,"PACMA",12
45,"45062",1074,888,867,4,21,"PACMA",6
24,"24116",390,283,279,1,4,"PACMA",0
19,"19116",12,9,9,1,0,"PACMA",0
15,"15021",5244,3884,3806,70,78,"PACMA",33
28,"28091",5474,4027,3977,26,50,"PACMA",50
10,"10191",523,406,398,3,8,"PACMA",4
22,"22078",438,326,323,3,3,"PACMA",5
12,"12120",161,138,138,0,0,"PACMA",0
50,"50055",3627,2627,2571,41,56,"PACMA",24
26,"26083",354,295,291,1,4,"PACMA",3
45,"45154",1479,1163,1149,5,14,"PACMA",23
41,"41015",5401,3984,3889,50,95,"PACMA",35
5,"5034",14,12,12,0,0,"PACMA",0
49,"49098",204,157,153,2,4,"PACMA",0
16,"16269",393,322,317,3,5,"PACMA",2
43,"43009",1391,1086,1078,3,8,"PACMA",11
31,"31073",296,218,217,3,1,"PACMA",2
9,"9422",32,27,26,2,1,"PACMA",1
16,"16236",865,669,665,2,4,"PACMA",1
37,"37241",164,129,127,0,2,"PACMA",0
4,"4019",232,181,179,0,2,"PACMA",0
19,"19168",266,211,206,4,5,"PACMA",0
10,"10057",126,97,96,2,1,"PACMA",0
7,"7031",24784,16683,16527,160,156,"PACMA",295
23,"23017",1480,1227,1202,6,25,"PACMA",4
22,"22045",73,57,56,0,1,"PACMA",2
50,"50165",1783,1359,1330,20,29,"PACMA",5
33,"33056",4877,3469,3420,30,49,"PACMA",34
5,"5229",82,67,67,1,0,"PACMA",1
45,"45203",2713,2092,2053,16,39,"PACMA",33
16,"16166",239,176,174,3,2,"PACMA",4
43,"43034",468,393,393,0,0,"PACMA",6
2,"2058",313,218,214,1,4,"PACMA",0
47,"47079",54,48,48,0,0,"PACMA",0
45,"45066",7770,6064,5962,21,102,"PACMA",51
49,"49137",170,138,134,0,4,"PACMA",0
13,"13903",493,412,406,1,6,"PACMA",1
18,"18182",1917,1391,1381,7,10,"PACMA",1
16,"16125",1599,1314,1295,9,19,"PACMA",13
49,"49224",169,117,115,0,2,"PACMA",1
25,"25048",1632,1274,1264,7,10,"PACMA",11
26,"26088",41,38,38,0,0,"PACMA",0
9,"9032",103,72,72,0,0,"PACMA",0
19,"19171",5302,4297,4238,24,59,"PACMA",54
28,"28118",61,52,51,0,1,"PACMA",0
29,"29027",2309,1716,1692,18,24,"PACMA",21
45,"45067",2289,1860,1820,17,40,"PACMA",15
26,"26168",5515,4130,4077,36,53,"PACMA",60
7,"7044",8791,6335,6196,66,139,"PACMA",72
45,"45174",296,253,250,3,3,"PACMA",0
45,"45205",7342,5347,5275,30,72,"PACMA",77
9,"9302",98,75,73,0,2,"PACMA",0
37,"37232",378,322,321,1,1,"PACMA",0
10,"10904",722,549,543,7,6,"PACMA",1
50,"50297",502835,394653,391387,3269,3266,"PACMA",4178
9,"9243",73,57,55,0,2,"PACMA",1
33,"33028",1158,635,630,6,5,"PACMA",1
9,"9356",43,36,36,0,0,"PACMA",0
38,"38030",1945,1430,1420,6,10,"PACMA",7
37,"37119",95,78,77,0,1,"PACMA",0
26,"26129",936,770,759,1,11,"PACMA",2
7,"7001",3628,2792,2753,18,39,"PACMA",35
42,"42197",68,56,56,0,0,"PACMA",0
48,"48047",149,115,115,1,0,"PACMA",0
25,"25020",274,221,221,2,0,"PACMA",0
37,"37307",148,110,107,2,3,"PACMA",1
32,"32007",1412,1011,1001,9,10,"PACMA",2
23,"23021",517,446,440,0,6,"PACMA",1
9,"9213",270,196,196,1,0,"PACMA",0
31,"31174",107,70,70,0,0,"PACMA",1
4,"4024",3225,2558,2534,23,24,"PACMA",30
14,"14003",1258,989,968,12,21,"PACMA",4
19,"19023",127,98,96,0,2,"PACMA",1
35,"35033",6403,4565,4502,34,63,"PACMA",45
46,"46154",797,645,630,1,15,"PACMA",12
42,"42157",10,10,10,0,0,"PACMA",0
20,"20074",11503,8767,8720,26,47,"PACMA",28
32,"32064",480,348,346,2,2,"PACMA",4
31,"31134",175,130,128,1,2,"PACMA",1
37,"37235",219,170,166,4,4,"PACMA",0
36,"36901",4152,3400,3338,15,62,"PACMA",32
9,"9415",275,206,204,0,2,"PACMA",0
31,"31244",156,95,94,5,1,"PACMA",0
3,"3071",3988,3125,3088,28,37,"PACMA",25
49,"49023",909,682,674,5,8,"PACMA",1
13,"13046",693,558,547,0,11,"PACMA",3
45,"45041",3897,2959,2904,28,55,"PACMA",44
33,"33051",6811,4879,4809,63,70,"PACMA",32
47,"47159",831,703,693,0,10,"PACMA",1
11,"11003",1240,898,876,7,22,"PACMA",5
23,"23025",2727,2125,2090,8,35,"PACMA",9
48,"48040",1309,979,973,5,6,"PACMA",9
24,"24100",754,602,598,7,4,"PACMA",5
14,"14025",2857,2482,2436,14,46,"PACMA",13
47,"47149",45,39,39,1,0,"PACMA",2
44,"44099",649,457,450,2,7,"PACMA",4
49,"49230",82,67,66,0,1,"PACMA",0
9,"9417",42,32,32,0,0,"PACMA",0
50,"50902",79,69,69,0,0,"PACMA",0
39,"39037",2019,1572,1560,2,12,"PACMA",11
32,"32075",4382,3546,3489,35,57,"PACMA",28
34,"34163",46,40,40,1,0,"PACMA",0
3,"3012",1133,910,897,7,13,"PACMA",7
11,"11004",89545,60056,59323,741,733,"PACMA",1084
26,"26095",95,78,78,1,0,"PACMA",0
2,"2066",223,172,169,1,3,"PACMA",0
39,"39010",610,518,512,1,6,"PACMA",3
35,"35008",6207,4733,4654,42,79,"PACMA",70
37,"37350",404,310,307,0,3,"PACMA",2
31,"31247",147,117,115,0,2,"PACMA",0
3,"3074",1750,1433,1427,3,6,"PACMA",20
15,"15073",21760,14900,14630,181,270,"PACMA",197
34,"34027",1046,791,783,13,8,"PACMA",7
5,"5162",75,58,58,0,0,"PACMA",0
5,"5044",250,189,189,1,0,"PACMA",2
44,"44100",175,142,141,2,1,"PACMA",0
28,"28156",1084,885,880,6,5,"PACMA",21
6,"6148",957,762,746,12,16,"PACMA",8
49,"49067",336,236,232,0,4,"PACMA",0
10,"10068",711,576,556,2,20,"PACMA",7
39,"39039",546,431,428,0,3,"PACMA",1
15,"15062",5652,3803,3728,25,75,"PACMA",37
49,"49003",869,627,624,3,3,"PACMA",5
48,"48002",7777,6034,5981,48,53,"PACMA",49
9,"9437",270,227,224,2,3,"PACMA",2
14,"14037",3182,2388,2319,22,69,"PACMA",17
23,"23028",6131,4696,4635,24,61,"PACMA",56
45,"45185",7600,6094,5999,19,95,"PACMA",33
37,"37100",77,60,59,1,1,"PACMA",0
19,"19182",39,32,32,0,0,"PACMA",0
25,"25191",321,248,244,3,4,"PACMA",1
28,"28158",678,547,540,1,7,"PACMA",8
24,"24104",245,173,172,1,1,"PACMA",0
10,"10069",785,609,596,2,13,"PACMA",1
12,"12121",1044,941,915,4,26,"PACMA",3
37,"37127",200,145,145,1,0,"PACMA",1
37,"37240",939,694,686,3,8,"PACMA",4
25,"25006",317,246,245,3,1,"PACMA",0
40,"40213",95,83,80,1,3,"PACMA",0
44,"44013",11250,8525,8420,95,105,"PACMA",66
22,"22905",287,226,224,2,2,"PACMA",3
44,"44064",63,49,48,0,1,"PACMA",0
24,"24148",1616,1252,1237,11,15,"PACMA",13
3,"3109",2976,2375,2345,11,30,"PACMA",21
34,"34122",86,68,66,0,2,"PACMA",0
29,"29003",922,740,727,3,13,"PACMA",5
22,"22182",233,178,174,1,4,"PACMA",0
26,"26178",71,57,56,1,1,"PACMA",0
34,"34170",51,35,35,0,0,"PACMA",0
10,"10194",524,440,435,4,5,"PACMA",2
40,"40134",697,560,548,7,12,"PACMA",5
26,"26179",41,33,32,0,1,"PACMA",0
33,"33067",747,608,596,9,12,"PACMA",2
24,"24067",606,375,371,2,4,"PACMA",2
23,"23062",1418,1206,1190,5,16,"PACMA",1
41,"41017",15712,12048,11896,118,152,"PACMA",191
25,"25079",285,228,227,0,1,"PACMA",1
49,"49248",174,142,139,2,3,"PACMA",0
50,"50261",205,171,167,1,4,"PACMA",0
29,"29005",4499,3202,3171,37,31,"PACMA",40
37,"37130",178,150,150,2,0,"PACMA",0
46,"46161",1472,1200,1172,7,28,"PACMA",13
13,"13011",4506,3111,3044,29,67,"PACMA",22
12,"12123",43,35,34,1,1,"PACMA",0
43,"43019",1336,1020,1008,4,12,"PACMA",1
47,"47124",388,322,319,2,3,"PACMA",1
42,"42120",132,89,87,0,2,"PACMA",0
49,"49263",45,37,37,0,0,"PACMA",0
43,"43158",77,61,61,1,0,"PACMA",1
32,"32071",1378,963,954,7,9,"PACMA",3
1,"1021",469,333,330,1,3,"PACMA",1
11,"11011",1736,1285,1249,7,36,"PACMA",7
18,"18102",8227,6100,5969,32,131,"PACMA",46
47,"47156",150,128,128,2,0,"PACMA",0
45,"45175",614,512,504,3,8,"PACMA",0
42,"42075",78,60,60,1,0,"PACMA",0
6,"6044",29204,21778,21492,203,286,"PACMA",180
6,"6110",137,106,105,0,1,"PACMA",0
29,"29096",2756,2061,2018,21,43,"PACMA",15
48,"48048",543,421,419,1,2,"PACMA",4
47,"47029",50,43,43,1,0,"PACMA",0
9,"9444",63,43,43,2,0,"PACMA",2
31,"31025",763,562,557,6,5,"PACMA",7
39,"39053",213,146,145,2,1,"PACMA",0
28,"28096",19809,15584,15392,118,192,"PACMA",243
37,"37144",338,275,273,1,2,"PACMA",0
46,"46103",1338,1056,1042,5,14,"PACMA",7
49,"49047",100,72,72,0,0,"PACMA",1
6,"6023",4170,3088,3045,18,43,"PACMA",13
34,"34080",5291,3802,3728,35,74,"PACMA",25
49,"49010",348,301,295,6,6,"PACMA",3
37,"37246",5155,4153,4107,33,46,"PACMA",28
19,"19232",58,49,49,0,0,"PACMA",0
33,"33040",4566,3205,3150,50,55,"PACMA",38
9,"9265",47,38,36,2,2,"PACMA",0
45,"45040",1276,842,828,4,14,"PACMA",7
45,"45102",3585,2724,2676,20,48,"PACMA",17
47,"47073",116,91,89,0,2,"PACMA",0
24,"24112",299,226,223,1,3,"PACMA",0
10,"10199",159,123,123,1,0,"PACMA",0
10,"10119",574,458,455,0,3,"PACMA",4
19,"19233",82,72,72,1,0,"PACMA",6
5,"5210",79,57,57,0,0,"PACMA",1
15,"15018",1087,771,761,8,10,"PACMA",3
10,"10132",365,276,271,2,5,"PACMA",0
37,"37171",397,297,292,1,5,"PACMA",1
37,"37335",389,308,301,3,7,"PACMA",0
41,"41059",35105,27781,27472,261,309,"PACMA",479
49,"49119",222,181,180,0,1,"PACMA",0
31,"31014",266,195,195,4,0,"PACMA",1
34,"34178",119,105,104,0,1,"PACMA",1
22,"22061",6583,5027,4973,51,54,"PACMA",33
44,"44138",118,90,89,2,1,"PACMA",1
40,"40105",44,39,38,0,1,"PACMA",0
9,"9326",154,129,127,4,2,"PACMA",0
28,"28100",4409,3425,3382,20,43,"PACMA",79
24,"24113",351,277,272,2,5,"PACMA",0
28,"28165",1910,1443,1430,11,13,"PACMA",6
9,"9346",89,69,68,1,1,"PACMA",1
40,"40210",98,70,70,0,0,"PACMA",0
6,"6015",117934,87081,86114,785,967,"PACMA",957
15,"15082",15381,11803,11642,133,161,"PACMA",135
37,"37249",38,28,28,0,0,"PACMA",0
33,"33042",4243,3137,3103,36,34,"PACMA",31
45,"45182",987,815,800,7,15,"PACMA",3
42,"42127",38,27,27,1,0,"PACMA",0
6,"6049",974,732,712,7,20,"PACMA",4
25,"25133",686,528,527,2,1,"PACMA",3
28,"28166",347,287,286,1,1,"PACMA",0
31,"31260",1249,904,901,15,3,"PACMA",2
44,"44110",37,33,33,0,0,"PACMA",0
18,"18179",503,346,343,3,3,"PACMA",0
18,"18108",826,677,669,3,8,"PACMA",4
34,"34180",64,55,55,2,0,"PACMA",1
10,"10163",339,275,269,0,6,"PACMA",0
28,"28069",56,47,45,2,2,"PACMA",0
3,"3064",5004,3782,3736,20,46,"PACMA",36
29,"29045",1681,1263,1242,9,21,"PACMA",37
37,"37363",107,81,80,0,1,"PACMA",0
32,"32039",1142,895,890,7,5,"PACMA",1
43,"43081",633,532,531,7,1,"PACMA",10
50,"50267",573,440,434,7,6,"PACMA",0
16,"16194",220,181,173,1,8,"PACMA",0
5,"5226",65,52,52,0,0,"PACMA",0
31,"31019",1808,1392,1378,18,14,"PACMA",12
16,"16064",651,575,569,4,6,"PACMA",8
40,"40131",50,47,47,0,0,"PACMA",0
40,"40025",128,109,106,1,3,"PACMA",0
24,"24078",336,259,255,0,4,"PACMA",1
6,"6150",780,637,635,2,2,"PACMA",1
47,"47162",68,55,55,0,0,"PACMA",1
48,"48084",21858,15943,15796,116,147,"PACMA",174
31,"31263",231,154,154,0,0,"PACMA",0
25,"25234",4201,3087,3072,13,15,"PACMA",26
9,"9013",44,37,37,0,0,"PACMA",0
37,"37277",77,56,56,0,0,"PACMA",0
48,"48044",62054,49055,48840,373,215,"PACMA",399
24,"24228",626,432,426,3,6,"PACMA",2
23,"23006",4582,3607,3543,32,64,"PACMA",16
7,"7052",4816,3276,3258,39,18,"PACMA",55
46,"46252",128,106,106,2,0,"PACMA",1
32,"32004",1671,907,899,7,8,"PACMA",1
26,"26166",147,136,136,2,0,"PACMA",1
28,"28001",80,64,64,0,0,"PACMA",0
47,"47163",280,238,232,2,6,"PACMA",0
45,"45050",489,381,363,3,18,"PACMA",4
49,"49204",57,42,42,0,0,"PACMA",0
30,"30030",320172,249965,247884,1497,2081,"PACMA",3549
45,"45003",550,435,431,4,4,"PACMA",6
37,"37141",152,120,119,2,1,"PACMA",1
43,"43903",2333,1717,1700,11,17,"PACMA",6
10,"10902",735,537,521,2,16,"PACMA",1
31,"31183",713,569,555,6,14,"PACMA",6
4,"4049",5603,4104,4054,27,50,"PACMA",34
50,"50019",64,48,47,0,1,"PACMA",1
34,"34076",545,475,473,2,2,"PACMA",1
49,"49075",134,118,114,1,4,"PACMA",0
28,"28042",1266,1020,1010,2,10,"PACMA",21
42,"42044",53,41,39,0,2,"PACMA",0
19,"19053",1929,1472,1458,9,14,"PACMA",9
37,"37142",566,446,444,6,2,"PACMA",4
37,"37059",117,106,100,0,6,"PACMA",0
27,"27008",1345,965,946,17,19,"PACMA",2
25,"25137",8686,6327,6296,46,31,"PACMA",62
5,"5179",199,181,175,0,6,"PACMA",1
6,"6021",908,708,698,9,10,"PACMA",1
12,"12002",115,99,97,0,2,"PACMA",0
38,"38039",11112,8233,8161,54,72,"PACMA",146
34,"34174",178,150,149,2,1,"PACMA",1
9,"9119",45,26,26,0,0,"PACMA",0
24,"24004",494,408,403,7,5,"PACMA",4
40,"40216",774,670,665,11,5,"PACMA",3
22,"22157",183,136,134,1,2,"PACMA",1
44,"44115",102,96,95,0,1,"PACMA",0
42,"42183",106,83,83,1,0,"PACMA",0
34,"34093",81,70,70,0,0,"PACMA",0
49,"49046",242,178,175,0,3,"PACMA",0
46,"46112",542,460,454,0,6,"PACMA",1
7,"7902",1091,776,743,10,33,"PACMA",8
19,"19201",60,45,45,0,0,"PACMA",0
29,"29062",651,576,567,4,9,"PACMA",2
6,"6067",1915,1393,1370,7,23,"PACMA",7
9,"9136",173,130,128,0,2,"PACMA",1
34,"34242",93,66,64,1,2,"PACMA",0
49,"49227",313,255,254,1,1,"PACMA",1
37,"37061",207,160,160,0,0,"PACMA",0
43,"43085",235,198,194,0,4,"PACMA",1
9,"9102",33,26,25,0,1,"PACMA",0
46,"46083",15374,11259,11096,56,163,"PACMA",225
50,"50031",139,97,90,0,7,"PACMA",0
9,"9280",27,22,22,0,0,"PACMA",0
40,"40008",45,37,37,0,0,"PACMA",0
38,"38021",1599,1079,1057,8,22,"PACMA",20
9,"9122",88,64,64,0,0,"PACMA",0
35,"35024",14243,9496,9394,65,102,"PACMA",134
18,"18151",259,194,193,3,1,"PACMA",2
37,"37035",165,134,134,0,0,"PACMA",1
49,"49063",310,246,240,2,6,"PACMA",0
12,"12135",36194,27266,26961,192,305,"PACMA",329
10,"10172",696,517,513,0,4,"PACMA",1
34,"34245",310,244,240,3,4,"PACMA",0
25,"25111",113,90,89,0,1,"PACMA",0
44,"44049",796,592,578,9,14,"PACMA",4
1,"1056",205,134,134,0,0,"PACMA",2
14,"14075",557,429,411,5,18,"PACMA",1
42,"42215",735,540,529,5,11,"PACMA",0
47,"47012",101,80,80,0,0,"PACMA",2
31,"31028",220,147,147,0,0,"PACMA",1
25,"25012",2342,1748,1739,10,9,"PACMA",27
18,"18187",512,388,387,0,1,"PACMA",2
36,"36022",9061,6640,6482,47,158,"PACMA",49
49,"49052",179,125,123,1,2,"PACMA",0
11,"11028",32791,24276,24028,279,248,"PACMA",439
10,"10093",393,313,303,4,10,"PACMA",3
31,"31191",3018,2365,2337,22,28,"PACMA",19
25,"25043",801,613,606,1,7,"PACMA",5
22,"22902",208,160,156,0,4,"PACMA",0
32,"32084",902,636,631,2,5,"PACMA",0
9,"9023",1178,982,966,14,16,"PACMA",16
36,"36023",8279,6187,6085,46,102,"PACMA",72
4,"4056",164,135,133,1,2,"PACMA",1
18,"18016",308,232,231,5,1,"PACMA",1
37,"37261",217,166,163,0,3,"PACMA",2
46,"46055",1284,1031,1021,2,10,"PACMA",26
2,"2053",2885,2313,2282,13,31,"PACMA",17
28,"28079",2374366,1872679,1859094,11998,13585,"PACMA",21960
9,"9449",92,75,74,1,1,"PACMA",0
5,"5186",1558,1255,1247,9,8,"PACMA",2
29,"29079",2335,1796,1765,7,31,"PACMA",14
25,"25045",54,31,31,5,0,"PACMA",0
15,"15093",4048,2761,2720,41,41,"PACMA",15
16,"16265",20,20,19,0,1,"PACMA",0
5,"5030",43,36,36,0,0,"PACMA",2
28,"28018",4068,3367,3344,15,23,"PACMA",35
43,"43064",2017,1569,1558,9,11,"PACMA",6
42,"42053",21,15,15,0,0,"PACMA",0
46,"46026",1202,1012,997,1,15,"PACMA",11
5,"5214",27,22,22,0,0,"PACMA",0
31,"31180",197,155,154,2,1,"PACMA",3
28,"28039",125,103,103,2,0,"PACMA",0
31,"31139",155,105,105,0,0,"PACMA",1
26,"26098",99,77,77,1,0,"PACMA",1
19,"19086",1392,1095,1083,7,12,"PACMA",5
25,"25056",213,163,163,3,0,"PACMA",1
9,"9012",92,76,75,0,1,"PACMA",2
11,"11019",1753,1353,1295,7,58,"PACMA",10
47,"47087",368,292,288,3,4,"PACMA",1
24,"24052",139,99,99,0,0,"PACMA",0
37,"37188",160,115,112,3,3,"PACMA",13
50,"50164",388,279,272,2,7,"PACMA",1
37,"37151",143,112,111,1,1,"PACMA",0
28,"28178",1134,949,935,1,14,"PACMA",12
40,"40083",72,53,51,3,2,"PACMA",0
37,"37252",101,80,79,1,1,"PACMA",0
31,"31182",30,28,28,1,0,"PACMA",0
45,"45094",367,290,288,4,2,"PACMA",5
43,"43042",2198,1820,1816,8,4,"PACMA",32
19,"19018",141,112,110,0,2,"PACMA",0
21,"21038",1076,786,771,8,15,"PACMA",8
45,"45110",1697,1339,1326,11,13,"PACMA",1
3,"3015",12807,9782,9634,63,148,"PACMA",104
12,"12083",89,73,71,1,2,"PACMA",0
19,"19256",44,32,32,0,0,"PACMA",0
24,"24173",908,679,667,3,12,"PACMA",4
41,"41073",1685,1172,1157,13,15,"PACMA",5
44,"44216",26922,20603,20279,204,324,"PACMA",129
29,"29082",34113,26248,26002,304,246,"PACMA",557
49,"49100",286,210,208,2,2,"PACMA",0
50,"50175",924,713,710,9,3,"PACMA",13
32,"32069",4256,3358,3309,39,49,"PACMA",26
9,"9030",119,90,89,1,1,"PACMA",0
47,"47111",998,806,795,6,11,"PACMA",0
32,"32070",512,307,304,8,3,"PACMA",0
37,"37304",159,105,105,0,0,"PACMA",0
9,"9241",247,192,188,2,4,"PACMA",3
25,"25070",811,677,675,4,2,"PACMA",2
46,"46029",20423,15450,15274,100,176,"PACMA",143
40,"40052",72,56,56,0,0,"PACMA",0
26,"26127",186,162,159,1,3,"PACMA",2
50,"50252",5057,3661,3613,36,48,"PACMA",12
10,"10903",796,623,614,4,9,"PACMA",4
50,"50020",802,606,600,7,6,"PACMA",2
19,"19258",84,69,66,1,3,"PACMA",0
23,"23053",9449,6379,6325,25,54,"PACMA",37
50,"50280",301,246,240,1,6,"PACMA",0
14,"14041",3115,2449,2376,45,73,"PACMA",14
48,"48036",24038,18180,18050,94,130,"PACMA",165
49,"49139",153,111,110,1,1,"PACMA",1
50,"50262",1163,930,912,15,18,"PACMA",9
36,"36007",1618,1163,1133,7,30,"PACMA",11
41,"41028",2071,1741,1713,18,28,"PACMA",29
48,"48017",13150,9546,9504,38,42,"PACMA",60
26,"26051",210,178,176,1,2,"PACMA",0
16,"16273",303,236,231,2,5,"PACMA",1
43,"43905",14941,10510,10446,40,64,"PACMA",238
19,"19022",571,443,434,7,9,"PACMA",6
23,"23087",11185,8500,8363,65,137,"PACMA",93
19,"19139",26,20,20,1,0,"PACMA",2
3,"3100",496,402,395,2,7,"PACMA",0
26,"26181",14,14,14,0,0,"PACMA",0
14,"14072",999,763,754,4,9,"PACMA",12
43,"43102",463,384,379,2,5,"PACMA",1
46,"46214",16415,12723,12610,74,113,"PACMA",225
43,"43053",188,153,149,0,4,"PACMA",0
24,"24137",1052,815,803,14,12,"PACMA",11
41,"41085",4170,3337,3270,27,67,"PACMA",51
10,"10130",1747,1352,1321,12,31,"PACMA",9
43,"43167",384,334,333,2,1,"PACMA",4
28,"28110",2003,1596,1571,7,25,"PACMA",13
46,"46194",15813,11654,11511,83,143,"PACMA",187
15,"15069",6588,4914,4830,58,84,"PACMA",60
34,"34066",57,52,48,1,4,"PACMA",0
5,"5079",68,56,56,0,0,"PACMA",0
3,"3102",7226,5600,5516,28,84,"PACMA",43
9,"9466",112,87,85,2,2,"PACMA",0
50,"50236",101,82,80,1,2,"PACMA",0
5,"5183",123,104,96,0,8,"PACMA",0
25,"25085",141,118,117,2,1,"PACMA",1
31,"31162",48,34,33,1,1,"PACMA",1
6,"6035",865,678,670,4,8,"PACMA",3
4,"4066",13488,9324,9255,73,69,"PACMA",61
26,"26054",292,235,231,2,4,"PACMA",0
40,"40020",155,125,119,4,6,"PACMA",1
9,"9006",59,37,36,1,1,"PACMA",0
47,"47032",153,121,121,1,0,"PACMA",0
37,"37322",2466,1764,1723,17,41,"PACMA",11
42,"42079",21,18,18,1,0,"PACMA",0
47,"47094",123,110,109,1,1,"PACMA",0
3,"3103",245,212,211,4,1,"PACMA",1
26,"26107",91,78,77,0,1,"PACMA",0
22,"22086",209,157,155,1,2,"PACMA",1
9,"9038",111,95,95,0,0,"PACMA",0
44,"44159",37,32,32,1,0,"PACMA",1
40,"40233",396,323,320,2,3,"PACMA",0
28,"28089",3842,3087,3048,12,39,"PACMA",29
49,"49268",368,282,279,2,3,"PACMA",0
47,"47180",57,46,46,1,0,"PACMA",0
31,"31015",1990,1533,1508,17,25,"PACMA",17
16,"16192",43,30,29,0,1,"PACMA",0
41,"41022",4269,3158,3110,16,48,"PACMA",14
9,"9140",115,88,88,2,0,"PACMA",1
49,"49269",220,163,162,1,1,"PACMA",2
22,"22176",170,136,135,0,1,"PACMA",1
50,"50113",584,505,495,3,10,"PACMA",2
9,"9309",292,224,223,3,1,"PACMA",3
43,"43162",4418,3467,3453,20,14,"PACMA",46
47,"47118",149,111,108,1,3,"PACMA",0
31,"31165",2763,2121,2091,21,30,"PACMA",9
5,"5238",739,589,586,1,3,"PACMA",2
42,"42160",247,195,194,4,1,"PACMA",1
37,"37198",203,163,162,3,1,"PACMA",0
40,"40130",128,102,96,0,6,"PACMA",1
20,"20017",8484,6294,6263,25,31,"PACMA",37
36,"36002",3076,2225,2185,19,40,"PACMA",14
34,"34149",21,18,18,0,0,"PACMA",0
18,"18049",596,485,481,0,4,"PACMA",5
25,"25189",2164,1591,1583,11,8,"PACMA",18
22,"22178",103,84,84,2,0,"PACMA",1
20,"20007",327,235,230,2,5,"PACMA",1
43,"43056",806,616,613,5,3,"PACMA",2
13,"13035",955,739,720,6,19,"PACMA",4
23,"23039",2154,1644,1605,6,39,"PACMA",10
44,"44173",102,85,80,0,5,"PACMA",0
18,"18072",664,481,473,0,8,"PACMA",1
41,"41062",2175,1763,1746,8,17,"PACMA",5
50,"50124",399,316,316,3,0,"PACMA",2
9,"9253",106,88,85,2,3,"PACMA",0
19,"19225",851,664,650,3,14,"PACMA",13
42,"42068",78,62,61,2,1,"PACMA",0
9,"9478",45,40,40,0,0,"PACMA",0
47,"47183",139,118,118,1,0,"PACMA",0
19,"19268",43,42,42,0,0,"PACMA",0
49,"49272",77,55,51,0,4,"PACMA",0
7,"7063",1420,1139,1129,10,10,"PACMA",13
41,"41025",2019,1492,1439,7,53,"PACMA",22
28,"28125",3216,2459,2444,11,15,"PACMA",49
44,"44235",89,67,66,2,1,"PACMA",0
50,"50231",257,210,207,3,3,"PACMA",0
29,"29903",493,358,354,6,4,"PACMA",5
19,"19050",15,13,13,0,0,"PACMA",0
24,"24172",415,240,237,1,3,"PACMA",2
16,"16124",1826,1482,1455,6,27,"PACMA",9
24,"24026",1099,812,799,5,13,"PACMA",5
41,"41026",4300,3561,3521,18,40,"PACMA",16
27,"27027",1806,1392,1354,18,38,"PACMA",10
10,"10153",283,204,199,0,5,"PACMA",1
31,"31170",45,37,36,2,1,"PACMA",0
25,"25904",162,147,147,3,0,"PACMA",1
37,"37329",39,36,36,0,0,"PACMA",0
50,"50251",8207,6352,6242,46,110,"PACMA",41
37,"37242",80,65,64,1,1,"PACMA",0
46,"46100",281,210,205,0,5,"PACMA",5
34,"34047",1738,1439,1420,8,19,"PACMA",5
16,"16053",391,334,327,4,7,"PACMA",2
31,"31239",281,215,212,7,3,"PACMA",2
46,"46059",1240,1038,1030,3,8,"PACMA",7
44,"44237",368,299,293,2,6,"PACMA",1
33,"33006",1480,1001,992,9,9,"PACMA",9
21,"21028",370,300,293,1,7,"PACMA",1
5,"5205",79,66,66,0,0,"PACMA",0
46,"46192",790,599,586,8,13,"PACMA",5
41,"41101",6016,4524,4480,42,44,"PACMA",31
6,"6076",824,631,620,0,11,"PACMA",3
18,"18033",279,221,220,1,1,"PACMA",1
16,"16239",118,89,88,0,1,"PACMA",0
14,"14051",1348,1064,1048,7,16,"PACMA",4
25,"25905",369,308,307,1,1,"PACMA",5
47,"47059",97,75,75,0,0,"PACMA",1
28,"28053",6840,5797,5739,32,58,"PACMA",92
10,"10128",5628,4238,4126,43,112,"PACMA",26
49,"49250",1194,954,939,8,15,"PACMA",1
47,"47009",99,84,84,0,0,"PACMA",1
10,"10033",403,306,302,6,4,"PACMA",1
38,"38009",4299,3105,3069,16,36,"PACMA",47
49,"49077",159,104,103,0,1,"PACMA",0
31,"31092",685,514,511,6,3,"PACMA",2
31,"31173",846,686,674,5,12,"PACMA",3
22,"22112",9516,7043,6956,84,87,"PACMA",51
24,"24029",695,521,520,4,1,"PACMA",2
40,"40160",93,72,72,0,0,"PACMA",0
44,"44056",457,352,341,4,11,"PACMA",2
27,"27020",3380,2764,2713,32,51,"PACMA",13
32,"32053",1363,1114,1098,14,16,"PACMA",5
5,"5193",180,156,156,2,0,"PACMA",0
6,"6133",1799,1476,1453,12,23,"PACMA",6
45,"45008",142,121,121,0,0,"PACMA",0
10,"10020",1576,1259,1225,9,34,"PACMA",4
40,"40150",61,53,53,1,0,"PACMA",0
49,"49034",417,320,317,0,3,"PACMA",0
46,"46022",15325,11197,11072,70,125,"PACMA",184
3,"3019",15465,12156,11988,80,168,"PACMA",152
19,"19278",24,24,24,0,0,"PACMA",0
45,"45193",589,512,507,6,5,"PACMA",0
33,"33070",3293,2499,2473,32,26,"PACMA",19
37,"37358",164,142,135,2,7,"PACMA",0
34,"34051",91,81,79,0,2,"PACMA",0
50,"50197",96,78,78,1,0,"PACMA",0
27,"27011",2358,1582,1558,12,24,"PACMA",5
31,"31013",626,427,422,5,5,"PACMA",0
37,"37108",99,80,78,2,2,"PACMA",0
44,"44137",188,148,146,0,2,"PACMA",0
3,"3081",1494,1163,1141,5,22,"PACMA",15
36,"36010",2828,2217,2184,15,33,"PACMA",23
23,"23077",611,483,479,0,4,"PACMA",0
47,"47168",30,29,29,0,0,"PACMA",0
24,"24007",753,569,563,4,6,"PACMA",3
13,"13062",559,478,471,1,7,"PACMA",2
18,"18106",415,300,295,0,5,"PACMA",0
19,"19146",46,41,41,1,0,"PACMA",0
24,"24047",720,531,523,2,8,"PACMA",6
4,"4002",1039,798,792,7,6,"PACMA",7
41,"41902",4600,3141,3092,48,49,"PACMA",21
39,"39074",7041,5612,5551,31,61,"PACMA",38
50,"50265",74,56,56,0,0,"PACMA",0
21,"21070",6222,4413,4322,47,91,"PACMA",17
9,"9345",117,96,95,1,1,"PACMA",0
41,"41088",512,383,377,1,6,"PACMA",6
12,"12015",114,99,98,0,1,"PACMA",0
43,"43178",1421,1118,1113,7,5,"PACMA",11
31,"31219",81,60,59,1,1,"PACMA",0
25,"25034",2288,1733,1719,9,14,"PACMA",10
5,"5056",94,83,83,0,0,"PACMA",0
2,"2041",321,253,251,3,2,"PACMA",0
50,"50294",64,49,47,0,2,"PACMA",0
16,"16193",58,51,51,2,0,"PACMA",0
18,"18107",924,694,680,3,14,"PACMA",0
16,"16106",2708,2200,2163,17,37,"PACMA",4
7,"7016",2931,2201,2178,31,23,"PACMA",45
5,"5212",197,138,136,0,2,"PACMA",0
36,"36014",1872,1373,1345,14,28,"PACMA",12
9,"9164",150,116,114,0,2,"PACMA",2
28,"28058",141251,112674,111423,778,1251,"PACMA",2130
45,"45183",2337,1743,1704,7,39,"PACMA",33
47,"47171",384,315,311,5,4,"PACMA",0
45,"45122",5516,4611,4561,28,50,"PACMA",48
47,"47214",1364,1112,1074,7,38,"PACMA",5
12,"12138",19179,14217,14006,124,211,"PACMA",235
10,"10176",347,266,261,2,5,"PACMA",2
43,"43016",3445,2628,2608,11,20,"PACMA",44
26,"26021",2752,2132,2105,10,27,"PACMA",10
16,"16036",122,98,97,1,1,"PACMA",0
33,"33053",1079,738,729,6,9,"PACMA",6
25,"25167",226,185,185,2,0,"PACMA",2
50,"50035",75,63,62,0,1,"PACMA",0
23,"23070",3808,2598,2565,34,33,"PACMA",11
40,"40035",135,111,110,0,1,"PACMA",1
3,"3117",377,320,313,1,7,"PACMA",1
33,"33044",177352,134444,133352,1391,1092,"PACMA",1435
25,"25911",424,332,331,1,1,"PACMA",1
7,"7018",379,287,286,1,1,"PACMA",12
41,"41006",2738,1971,1945,16,26,"PACMA",13
9,"9167",53,39,36,0,3,"PACMA",0
34,"34184",49,39,38,0,1,"PACMA",0
22,"22197",439,356,353,10,3,"PACMA",0
46,"46129",512,408,400,4,8,"PACMA",4
3,"3118",2426,1741,1718,8,23,"PACMA",27
16,"16025",25,21,21,0,0,"PACMA",0
22,"22089",276,216,216,2,0,"PACMA",0
9,"9273",51,46,46,3,0,"PACMA",0
41,"41098",5152,4046,3986,24,60,"PACMA",73
24,"24064",1515,1159,1141,11,18,"PACMA",3
5,"5901",253,173,171,1,2,"PACMA",3
41,"41072",4037,3256,3221,19,35,"PACMA",13
33,"33046",483,370,367,6,3,"PACMA",1
37,"37215",134,97,96,3,1,"PACMA",1
22,"22109",266,207,205,3,2,"PACMA",0
28,"28061",22564,18245,18064,117,181,"PACMA",262
44,"44175",113,84,82,1,2,"PACMA",0
40,"40074",245,219,214,5,5,"PACMA",0
48,"48035",404,334,331,2,3,"PACMA",2
13,"13902",449,362,360,2,2,"PACMA",1
10,"10017",772,595,591,3,4,"PACMA",1
40,"40086",660,570,548,3,22,"PACMA",1
9,"9410",2999,2175,2135,27,40,"PACMA",34
49,"49235",422,312,301,0,11,"PACMA",0
46,"46253",114,85,85,2,0,"PACMA",1
30,"30011",4695,3665,3610,16,55,"PACMA",48
50,"50010",66,56,55,2,1,"PACMA",0
49,"49043",265,210,208,1,2,"PACMA",1
10,"10005",530,407,384,3,23,"PACMA",1
7,"7021",230,183,178,3,5,"PACMA",3
25,"25205",562,451,447,7,4,"PACMA",7
41,"41065",22550,16215,16010,189,205,"PACMA",155
49,"49166",1192,916,899,10,17,"PACMA",10
24,"24163",4073,3269,3231,36,38,"PACMA",34
40,"40076",6537,5130,5012,22,118,"PACMA",48
34,"34240",87,65,63,3,2,"PACMA",0
44,"44146",170,148,146,3,2,"PACMA",0
48,"48077",3376,2656,2647,11,9,"PACMA",27
34,"34225",5001,4070,4021,48,49,"PACMA",43
30,"30022",17056,12158,11954,126,204,"PACMA",107
44,"44106",153,115,111,2,4,"PACMA",1
11,"11024",6583,4774,4682,40,92,"PACMA",24
42,"42182",51,42,42,1,0,"PACMA",1
33,"33048",136,87,87,1,0,"PACMA",0
28,"28108",3642,2878,2841,16,37,"PACMA",48
15,"15088",3415,2349,2323,28,26,"PACMA",11
19,"19142",249,178,177,1,1,"PACMA",7
44,"44250",19,15,15,0,0,"PACMA",0
6,"6077",321,260,256,4,4,"PACMA",0
34,"34034",115,96,95,3,1,"PACMA",2
5,"5181",46,39,39,0,0,"PACMA",0
31,"31079",67,60,60,0,0,"PACMA",0
43,"43127",759,630,626,3,4,"PACMA",13
3,"3029",244,174,167,1,7,"PACMA",2
41,"41093",19012,15637,15525,97,112,"PACMA",196
11,"11037",5644,4567,4433,34,134,"PACMA",24
50,"50215",20,18,18,0,0,"PACMA",0
47,"47137",31,23,23,0,0,"PACMA",0
23,"23076",768,653,646,3,7,"PACMA",0
42,"42184",56,42,41,1,1,"PACMA",1
21,"21007",6318,4614,4524,50,90,"PACMA",44
47,"47126",44,42,42,1,0,"PACMA",2
47,"47103",255,215,214,3,1,"PACMA",1
37,"37079",80,69,68,2,1,"PACMA",1
45,"45010",389,280,280,3,0,"PACMA",1
43,"43038",21861,16504,16406,112,98,"PACMA",253
49,"49170",98,75,75,1,0,"PACMA",0
22,"22128",192,155,154,2,1,"PACMA",3
34,"34005",792,659,645,5,14,"PACMA",1
38,"38052",1280,893,887,4,6,"PACMA",8
45,"45148",275,209,209,1,0,"PACMA",1
22,"22039",805,667,662,5,5,"PACMA",5
42,"42011",17,11,11,0,0,"PACMA",0
26,"26119",177,150,147,2,3,"PACMA",0
31,"31108",1829,1460,1437,16,23,"PACMA",14
28,"28164",3202,2553,2530,19,23,"PACMA",45
9,"9022",61,54,54,0,0,"PACMA",0
13,"13016",661,508,495,2,13,"PACMA",2
26,"26079",620,526,521,0,5,"PACMA",2
6,"6091",3668,2839,2776,26,63,"PACMA",4
19,"19294",25,19,18,0,1,"PACMA",0
50,"50217",431,346,344,0,2,"PACMA",1
12,"12108",438,382,379,4,3,"PACMA",0
34,"34069",2184,1737,1701,16,36,"PACMA",14
15,"15092",6250,4358,4297,28,61,"PACMA",26
30,"30016",152709,110165,109114,717,1051,"PACMA",2067
16,"16206",196,146,144,3,2,"PACMA",0
50,"50218",110,92,92,0,0,"PACMA",0
24,"24049",1415,1146,1134,8,12,"PACMA",9
43,"43031",1446,1180,1178,7,2,"PACMA",15
10,"10174",171,129,127,0,2,"PACMA",8
45,"45197",1894,1525,1499,6,26,"PACMA",3
19,"19297",32,27,27,0,0,"PACMA",0
26,"26044",51,44,42,0,2,"PACMA",0
16,"16264",390,338,328,2,10,"PACMA",0
49,"49053",915,726,715,5,11,"PACMA",2
28,"28038",5155,4142,4090,20,52,"PACMA",61
10,"10135",1241,995,981,5,14,"PACMA",0
22,"22077",362,301,293,3,8,"PACMA",0
24,"24089",101353,78253,77375,776,878,"PACMA",667
41,"41042",5849,4730,4692,20,38,"PACMA",34
45,"45029",188,160,159,0,1,"PACMA",1
50,"50276",119,91,91,1,0,"PACMA",0
19,"19064",64,56,56,0,0,"PACMA",0
16,"16010",137,104,101,0,3,"PACMA",0
7,"7039",4970,3557,3489,36,68,"PACMA",33
45,"45199",3107,2221,2184,8,37,"PACMA",43
20,"20907",117,88,87,0,1,"PACMA",0
22,"22251",334,269,263,4,6,"PACMA",1
46,"46242",330,279,279,0,0,"PACMA",0
29,"29902",2592,1841,1817,18,24,"PACMA",21
10,"10083",96,74,73,0,1,"PACMA",0
19,"19238",44,30,30,1,0,"PACMA",0
5,"5213",95,77,75,0,2,"PACMA",0
40,"40040",2495,1913,1895,20,18,"PACMA",10
33,"33075",253,139,135,1,4,"PACMA",0
6,"6039",1807,1506,1474,13,32,"PACMA",1
19,"19016",57,40,40,0,0,"PACMA",0
37,"37085",5002,3994,3951,40,43,"PACMA",40
48,"48064",613,494,492,1,2,"PACMA",6
34,"34058",185,161,161,1,0,"PACMA",1
45,"45109",2786,2273,2206,9,67,"PACMA",8
19,"19240",51,42,41,1,1,"PACMA",2
10,"10015",627,488,475,0,13,"PACMA",1
32,"32040",1418,1083,1075,3,8,"PACMA",5
32,"32078",1108,794,781,15,13,"PACMA",4
9,"9368",28,21,21,1,0,"PACMA",1
44,"44003",17,14,14,0,0,"PACMA",0
46,"46031",10521,7735,7607,62,128,"PACMA",86
49,"49163",215,151,148,1,3,"PACMA",0
37,"37228",325,278,273,0,5,"PACMA",0
49,"49099",98,75,74,0,1,"PACMA",0
9,"9183",47,41,41,0,0,"PACMA",0
45,"45065",261,207,205,2,2,"PACMA",0
34,"34208",47,38,38,0,0,"PACMA",0
16,"16084",50,36,32,0,4,"PACMA",0
3,"3036",86,77,75,2,2,"PACMA",0
24,"24132",615,405,404,5,1,"PACMA",7
50,"50279",73,61,60,2,1,"PACMA",0
9,"9315",393,291,286,4,5,"PACMA",7
48,"48096",6510,5247,5185,36,62,"PACMA",31
12,"12032",23649,17680,17505,118,175,"PACMA",206
22,"22168",23,21,20,0,1,"PACMA",0
9,"9184",7,5,5,0,0,"PACMA",0
18,"18123",288,219,219,2,0,"PACMA",1
44,"44092",70,56,55,1,1,"PACMA",0
44,"44154",248,200,195,2,5,"PACMA",0
2,"2059",313,252,250,3,2,"PACMA",0
5,"5025",82,70,70,0,0,"PACMA",0
27,"27022",4683,3131,3059,30,72,"PACMA",12
46,"46121",111,96,94,2,2,"PACMA",0
16,"16167",292,235,229,1,6,"PACMA",0
11,"11035",13715,9510,9385,128,125,"PACMA",144
49,"49059",88,72,71,0,1,"PACMA",0
18,"18128",342,274,272,1,2,"PACMA",2
24,"24003",608,430,418,0,12,"PACMA",1
50,"50246",38,28,28,0,0,"PACMA",0
42,"42125",75,62,62,2,0,"PACMA",0
44,"44198",181,151,145,1,6,"PACMA",0
9,"9048",1380,1070,1039,8,31,"PACMA",7
48,"48910",2802,2082,2073,3,9,"PACMA",13
39,"39042",5930,4722,4676,26,46,"PACMA",32
25,"25096",888,663,661,2,2,"PACMA",3
41,"41102",14750,10972,10677,110,295,"PACMA",118
45,"45022",393,290,288,3,2,"PACMA",1
13,"13088",589,439,429,1,10,"PACMA",2
3,"3069",3311,2356,2327,12,29,"PACMA",37
18,"18138",2482,1698,1668,20,30,"PACMA",8
48,"48914",325,286,285,0,1,"PACMA",0
39,"39062",1841,1511,1500,9,11,"PACMA",15
44,"44156",46,36,33,1,3,"PACMA",0
2,"2085",309,264,263,4,1,"PACMA",0
26,"26169",68,61,61,2,0,"PACMA",0
10,"10021",5045,3932,3840,32,92,"PACMA",34
47,"47020",272,228,225,5,3,"PACMA",0
16,"16156",82,65,65,0,0,"PACMA",1
25,"25071",42,32,31,0,1,"PACMA",0
50,"50244",191,153,150,1,3,"PACMA",0
44,"44168",184,137,136,4,1,"PACMA",0
42,"42123",158,118,118,2,0,"PACMA",0
24,"24191",108,89,89,0,0,"PACMA",2
26,"26117",2097,1680,1647,17,33,"PACMA",3
39,"39063",954,726,722,4,4,"PACMA",2
31,"31080",490,393,390,2,3,"PACMA",1
44,"44179",325,233,231,7,2,"PACMA",3
26,"26017",354,293,290,4,3,"PACMA",2
45,"45147",590,506,496,2,10,"PACMA",3
41,"41077",8631,6441,6289,46,152,"PACMA",51
37,"37187",555,437,433,0,4,"PACMA",0
34,"34091",122,103,102,4,1,"PACMA",1
16,"16225",59,40,40,0,0,"PACMA",0
9,"9247",22,18,18,0,0,"PACMA",0
13,"13001",1195,947,943,5,4,"PACMA",2
44,"44191",722,567,561,7,6,"PACMA",5
45,"45097",1044,901,890,4,11,"PACMA",2
49,"49011",212,166,165,7,1,"PACMA",0
36,"36015",4076,2903,2834,37,69,"PACMA",18
10,"10110",2224,1618,1559,5,59,"PACMA",11
44,"44200",39,25,25,0,0,"PACMA",0
2,"2039",952,798,789,9,9,"PACMA",1
37,"37134",212,156,148,0,8,"PACMA",0
28,"28047",42847,33561,33215,216,346,"PACMA",551
25,"25185",679,493,491,6,2,"PACMA",4
40,"40163",41,38,38,0,0,"PACMA",0
14,"14005",6318,4464,4380,59,84,"PACMA",41
9,"9197",137,108,107,0,1,"PACMA",1
9,"9287",199,169,168,1,1,"PACMA",1
45,"45165",62598,47784,47120,345,664,"PACMA",515
25,"25227",664,517,517,1,0,"PACMA",0
37,"37361",81,63,61,0,2,"PACMA",0
16,"16174",168,143,141,1,2,"PACMA",0
47,"47222",86,71,71,0,0,"PACMA",1
29,"29089",3161,2477,2426,19,51,"PACMA",9
31,"31042",2695,2071,2043,21,28,"PACMA",18
37,"37312",244,198,197,1,1,"PACMA",0
5,"5043",75,62,62,0,0,"PACMA",0
23,"23093",3131,2428,2380,22,48,"PACMA",19
18,"18097",995,708,702,4,6,"PACMA",3
20,"20077",5254,4083,4059,22,24,"PACMA",19
43,"43089",281,209,208,0,1,"PACMA",6
36,"36034",3319,2384,2347,16,37,"PACMA",30
6,"6138",1013,783,767,3,16,"PACMA",3
10,"10122",220,171,164,0,7,"PACMA",0
13,"13004",996,769,763,3,6,"PACMA",2
22,"22903",622,538,533,3,5,"PACMA",2
12,"12016",1550,1281,1260,11,21,"PACMA",4
4,"4016",2128,1643,1621,4,22,"PACMA",7
40,"40120",196,176,169,0,7,"PACMA",5
37,"37103",414,309,309,4,0,"PACMA",0
34,"34215",162,143,142,3,1,"PACMA",0
45,"45005",227,180,174,5,6,"PACMA",1
37,"37262",69,60,60,0,0,"PACMA",0
46,"46009",3140,2582,2536,14,46,"PACMA",22
31,"31253",119,106,105,0,1,"PACMA",0
47,"47021",72,63,63,0,0,"PACMA",1
40,"40062",57,49,49,0,0,"PACMA",1
16,"16029",102,81,81,1,0,"PACMA",0
18,"18014",6898,5262,5162,43,100,"PACMA",70
42,"42039",210,147,141,2,6,"PACMA",1
28,"28060",1565,1262,1247,5,15,"PACMA",25
9,"9044",53,49,47,1,2,"PACMA",0
25,"25057",214,162,161,0,1,"PACMA",2
31,"31006",1877,1453,1436,16,17,"PACMA",9
19,"19300",788,664,652,2,12,"PACMA",11
10,"10192",767,625,614,1,11,"PACMA",2
26,"26047",1879,1569,1549,10,20,"PACMA",4
31,"31087",181,136,135,6,1,"PACMA",0
49,"49246",217,180,177,2,3,"PACMA",1
18,"18084",4458,3467,3417,17,50,"PACMA",51
9,"9155",25,20,20,0,0,"PACMA",0
41,"41029",13483,10357,10199,120,158,"PACMA",180
46,"46903",6285,5035,4996,27,39,"PACMA",98
10,"10179",277,220,219,0,1,"PACMA",1
47,"47027",2775,2246,2222,14,24,"PACMA",31
48,"48045",5194,4138,4098,25,40,"PACMA",42
9,"9482",35,28,28,0,0,"PACMA",0
26,"26061",1552,1228,1194,14,34,"PACMA",6
49,"49189",192,132,128,1,4,"PACMA",1
10,"10203",4428,3212,3152,25,60,"PACMA",14
6,"6056",454,378,376,1,2,"PACMA",1
18,"18021",17869,13238,13004,110,234,"PACMA",222
9,"9297",313,268,267,6,1,"PACMA",3
44,"44054",94,79,79,0,0,"PACMA",0
28,"28149",6172,5089,5038,31,51,"PACMA",76
31,"31093",275,212,206,0,6,"PACMA",0
26,"26092",109,84,82,1,2,"PACMA",0
25,"25078",1001,807,805,5,2,"PACMA",6
19,"19287",136,107,105,3,2,"PACMA",0
49,"49252",304,244,241,6,3,"PACMA",1
22,"22164",43,33,31,0,2,"PACMA",2
50,"50274",66,48,47,0,1,"PACMA",0
16,"16190",4957,4006,3945,36,61,"PACMA",18
23,"23001",920,769,766,3,3,"PACMA",4
39,"39051",73,65,64,0,1,"PACMA",0
42,"42023",60,49,48,0,1,"PACMA",0
45,"45162",632,481,471,2,10,"PACMA",3
5,"5231",151,126,126,0,0,"PACMA",1
31,"31176",2930,2204,2134,33,70,"PACMA",32
20,"20051",6775,5124,5091,24,33,"PACMA",17
49,"49237",143,95,93,0,2,"PACMA",0
49,"49076",328,260,258,6,2,"PACMA",1
31,"31227",8111,6198,6129,69,69,"PACMA",50
47,"47039",166,134,134,0,0,"PACMA",1
16,"16100",640,570,565,1,5,"PACMA",2
22,"22021",1884,1465,1450,13,15,"PACMA",6
22,"22186",191,165,164,2,1,"PACMA",1
48,"48078",37991,28582,28382,202,200,"PACMA",287
34,"34121",183,155,151,1,4,"PACMA",0
34,"34055",263,214,213,3,1,"PACMA",1
2,"2016",538,405,401,4,4,"PACMA",4
19,"19281",18,17,17,3,0,"PACMA",0
49,"49226",239,207,200,3,7,"PACMA",0
23,"23075",3220,2559,2524,18,35,"PACMA",17
28,"28064",135,110,104,1,6,"PACMA",0
9,"9394",662,495,490,10,5,"PACMA",5
50,"50021",25,23,23,1,0,"PACMA",0
25,"25910",91,70,67,2,3,"PACMA",0
14,"14029",4029,3089,3039,15,50,"PACMA",8
14,"14006",1321,1155,1127,4,28,"PACMA",0
15,"15089",4324,3258,3200,33,58,"PACMA",34
5,"5143",62,51,51,0,0,"PACMA",0
21,"21068",962,562,550,14,12,"PACMA",4
24,"24084",152,113,113,0,0,"PACMA",0
9,"9418",73,58,55,2,3,"PACMA",0
22,"22247",30,21,21,0,0,"PACMA",0
6,"6057",537,442,433,1,9,"PACMA",1
22,"22254",1094,857,850,11,7,"PACMA",4
4,"4065",368,287,284,2,3,"PACMA",1
21,"21020",353,242,236,3,6,"PACMA",0
16,"16111",163,125,122,1,3,"PACMA",1
16,"16909",661,540,535,1,5,"PACMA",3
9,"9276",389,283,268,5,15,"PACMA",5
28,"28032",5042,4039,3992,23,47,"PACMA",80
15,"15039",1224,874,850,11,24,"PACMA",8
50,"50001",88,71,70,0,1,"PACMA",0
9,"9335",87,71,71,0,0,"PACMA",2
47,"47227",55,46,46,0,0,"PACMA",1
40,"40036",502,413,406,11,7,"PACMA",0
42,"42187",59,51,49,1,2,"PACMA",0
26,"26006",1825,1496,1470,8,26,"PACMA",13
49,"49214",664,519,510,2,9,"PACMA",0
14,"14065",1813,1439,1421,11,18,"PACMA",7
22,"22189",178,143,143,0,0,"PACMA",2
43,"43096",98,82,82,0,0,"PACMA",1
37,"37185",537,416,405,1,11,"PACMA",5
42,"42144",423,338,336,4,2,"PACMA",2
5,"5197",100,84,83,0,1,"PACMA",0
48,"48088",133,99,98,2,1,"PACMA",1
36,"36040",2517,1895,1853,18,42,"PACMA",10
44,"44263",377,296,285,3,11,"PACMA",1
33,"33008",1705,1285,1273,9,12,"PACMA",1
25,"25013",2108,1570,1557,12,13,"PACMA",16
5,"5134",49,41,40,0,1,"PACMA",0
4,"4003",17540,12174,12051,75,123,"PACMA",111
49,"49082",343,288,286,8,2,"PACMA",0
44,"44172",295,220,218,4,2,"PACMA",0
18,"18010",532,420,416,2,4,"PACMA",1
46,"46035",6855,5500,5422,34,78,"PACMA",73
24,"24212",1002,772,764,7,8,"PACMA",4
18,"18144",803,650,640,2,10,"PACMA",8
28,"28059",4515,3573,3542,12,31,"PACMA",39
44,"44011",48,32,32,1,0,"PACMA",1
44,"44151",182,139,138,1,1,"PACMA",3
9,"9352",107,86,86,2,0,"PACMA",0
10,"10144",920,731,723,4,8,"PACMA",2
43,"43114",375,306,305,0,1,"PACMA",0
16,"16161",52,47,47,0,0,"PACMA",0
34,"34114",198,152,152,0,0,"PACMA",0
18,"18062",11041,8531,8355,71,176,"PACMA",119
9,"9020",237,184,180,5,4,"PACMA",0
39,"39079",8861,6827,6745,47,82,"PACMA",61
47,"47041",153,119,116,2,3,"PACMA",0
45,"45056",2300,1526,1501,8,25,"PACMA",18
24,"24217",133,106,105,1,1,"PACMA",0
14,"14054",13796,11042,10799,102,243,"PACMA",53
45,"45190",458,378,365,2,13,"PACMA",1
9,"9137",180,149,147,1,2,"PACMA",0
28,"28137",1744,1385,1366,8,19,"PACMA",27
5,"5247",227,182,177,1,5,"PACMA",0
14,"14074",2237,1859,1839,8,20,"PACMA",8
50,"50036",100,80,80,0,0,"PACMA",1
26,"26111",250,209,205,2,4,"PACMA",3
46,"46017",32990,23940,23694,155,246,"PACMA",381
49,"49069",327,211,207,0,4,"PACMA",0
25,"25212",224,195,195,2,0,"PACMA",1
47,"47026",49,40,39,0,1,"PACMA",0
40,"40037",34,19,19,0,0,"PACMA",0
9,"9178",40,27,27,0,0,"PACMA",0
34,"34217",1251,1053,1042,7,11,"PACMA",8
37,"37110",103,84,82,0,2,"PACMA",0
33,"33072",1455,973,963,14,10,"PACMA",1
12,"12096",744,588,580,7,8,"PACMA",5
50,"50030",201,138,136,1,2,"PACMA",1
35,"35029",4357,2869,2832,32,37,"PACMA",35
49,"49136",312,227,220,3,7,"PACMA",0
5,"5256",112,94,92,1,2,"PACMA",1
37,"37349",103,69,68,0,1,"PACMA",0
3,"3098",518,412,400,1,12,"PACMA",11
23,"23051",2727,2060,2023,5,37,"PACMA",13
34,"34100",131,100,97,1,3,"PACMA",0
11,"11009",580,429,420,2,9,"PACMA",3
45,"45126",239,173,168,0,5,"PACMA",1
48,"48005",113,80,80,0,0,"PACMA",0
50,"50012",96,79,79,1,0,"PACMA",0
47,"47213",108,84,84,0,0,"PACMA",0
40,"40173",142,122,117,1,5,"PACMA",5
50,"50109",98,69,67,3,2,"PACMA",0
11,"11006",24522,16656,16392,220,264,"PACMA",157
33,"33033",9439,6565,6468,78,97,"PACMA",34
16,"16045",185,142,141,0,1,"PACMA",0
10,"10186",944,781,758,1,23,"PACMA",3
3,"3067",93,87,87,0,0,"PACMA",0
39,"39092",871,635,629,2,6,"PACMA",3
25,"25251",713,562,558,4,4,"PACMA",5
31,"31050",6002,4111,4061,58,50,"PACMA",23
47,"47038",101,79,79,0,0,"PACMA",0
15,"15087",5692,3883,3838,53,45,"PACMA",39
37,"37197",87,63,63,0,0,"PACMA",0
40,"40069",74,65,65,0,0,"PACMA",0
20,"20055",17378,12565,12482,55,83,"PACMA",88
9,"9317",19,19,19,1,0,"PACMA",0
5,"5128",342,274,267,1,7,"PACMA",7
31,"31024",99,54,54,1,0,"PACMA",0
16,"16905",1278,1028,1012,11,16,"PACMA",9
12,"12133",60,53,52,1,1,"PACMA",0
50,"50144",31,26,25,0,1,"PACMA",0
24,"24038",3048,2360,2315,23,45,"PACMA",10
9,"9066",54,41,40,1,1,"PACMA",0
37,"37311",207,164,162,4,2,"PACMA",0
39,"39102",2255,1711,1698,11,13,"PACMA",10
12,"12060",430,368,365,1,3,"PACMA",2
19,"19123",36,33,32,2,1,"PACMA",0
12,"12087",25,19,18,2,1,"PACMA",0
48,"48068",1528,1218,1211,5,7,"PACMA",8
9,"9369",422,328,325,8,3,"PACMA",3
38,"38044",2199,1443,1429,10,14,"PACMA",14
27,"27034",1025,647,636,4,11,"PACMA",1
34,"34218",445,352,345,2,7,"PACMA",0
6,"6156",1171,919,901,10,18,"PACMA",7
22,"22099",465,365,362,3,3,"PACMA",0
18,"18011",4376,3286,3248,18,38,"PACMA",45
24,"24181",1414,1067,1055,14,12,"PACMA",1
9,"9328",74,51,50,0,1,"PACMA",0
4,"4092",2789,2207,2173,6,34,"PACMA",14
9,"9405",129,99,97,1,2,"PACMA",0
2,"2065",443,373,370,0,3,"PACMA",1
40,"40141",833,644,627,5,17,"PACMA",0
48,"48905",2490,1911,1891,16,20,"PACMA",17
16,"16224",77,61,60,1,1,"PACMA",0
5,"5119",24,16,16,1,0,"PACMA",0
9,"9248",78,64,64,0,0,"PACMA",0
50,"50242",93,72,70,0,2,"PACMA",0
7,"7035",1596,1242,1234,13,8,"PACMA",6
37,"37319",93,67,65,1,2,"PACMA",0
5,"5263",163,121,120,0,1,"PACMA",0
41,"41094",6447,4998,4912,43,86,"PACMA",86
7,"7050",3442,2303,2275,28,28,"PACMA",25
26,"26120",1460,1130,1109,3,21,"PACMA",8
20,"20056",4075,2983,2942,12,41,"PACMA",13
47,"47056",83,71,71,0,0,"PACMA",0
48,"48030",601,490,489,0,1,"PACMA",1
33,"33021",4361,3098,3043,31,55,"PACMA",27
49,"49184",170,122,121,0,1,"PACMA",0
5,"5160",296,236,232,1,4,"PACMA",0
19,"19177",61,49,48,0,1,"PACMA",0
30,"30023",3875,3107,3068,20,39,"PACMA",38
9,"9072",320,259,258,1,1,"PACMA",4
11,"11030",22973,16087,15853,165,234,"PACMA",275
47,"47152",68,59,59,0,0,"PACMA",0
25,"25248",880,714,713,4,1,"PACMA",2
13,"13075",199,157,157,0,0,"PACMA",0
41,"41051",2311,1770,1734,5,36,"PACMA",17
44,"44119",119,83,82,0,1,"PACMA",0
43,"43055",1988,1631,1622,7,9,"PACMA",9
14,"14012",6076,4579,4489,38,90,"PACMA",35
9,"9192",55,48,47,2,1,"PACMA",0
49,"49257",310,205,202,2,3,"PACMA",1
19,"19219",9,7,7,0,0,"PACMA",0
40,"40188",83,71,71,0,0,"PACMA",1
32,"32023",1132,867,862,7,5,"PACMA",3
21,"21056",2922,2307,2228,27,79,"PACMA",18
10,"10139",95,78,77,1,1,"PACMA",0
20,"20063",8061,6042,5999,36,43,"PACMA",27
21,"21046",1714,1097,1071,13,26,"PACMA",4
28,"28112",154,137,137,1,0,"PACMA",1
9,"9232",140,110,107,0,3,"PACMA",0
28,"28068",11554,9122,9022,44,100,"PACMA",114
19,"19178",30,15,15,0,0,"PACMA",0
10,"10022",412,319,316,1,3,"PACMA",2
47,"47054",613,501,498,0,3,"PACMA",2
19,"19317",127,98,97,0,1,"PACMA",0
45,"45117",715,571,556,1,15,"PACMA",7
47,"47002",18,18,18,0,0,"PACMA",0
48,"48071",6038,4711,4674,27,37,"PACMA",40
43,"43074",1812,1419,1412,4,7,"PACMA",20
33,"33038",2234,1669,1644,16,25,"PACMA",12
26,"26045",11,11,11,0,0,"PACMA",0
35,"35017",27216,17531,17102,133,429,"PACMA",277
23,"23064",1678,1413,1404,10,9,"PACMA",3
9,"9162",132,102,102,1,0,"PACMA",0
37,"37301",79,69,67,0,2,"PACMA",0
44,"44121",53,38,38,2,0,"PACMA",0
36,"36046",4043,3157,3084,27,73,"PACMA",43
47,"47128",56,49,46,0,3,"PACMA",0
50,"50193",663,536,516,1,20,"PACMA",7
24,"24101",384,285,283,4,2,"PACMA",1
34,"34050",185,156,156,2,0,"PACMA",0
23,"23010",14241,10186,10015,68,171,"PACMA",104
40,"40093",76,68,67,0,1,"PACMA",0
9,"9215",365,267,264,1,3,"PACMA",4
37,"37352",201,159,158,0,1,"PACMA",4
50,"50053",650,505,497,4,8,"PACMA",4
35,"35016",300503,203470,201240,1598,2230,"PACMA",3667
25,"25126",284,233,232,1,1,"PACMA",3
47,"47046",125,107,104,1,3,"PACMA",1
15,"15019",26006,18323,18075,280,248,"PACMA",188
39,"39024",1815,1436,1420,14,16,"PACMA",8
47,"47115",276,231,223,1,8,"PACMA",0
37,"37258",137,99,98,1,1,"PACMA",0
28,"28076",425,354,349,3,5,"PACMA",1
4,"4102",14110,9871,9765,90,106,"PACMA",100
49,"49104",335,245,240,1,5,"PACMA",0
15,"15072",9436,6962,6860,60,102,"PACMA",70
44,"44062",31,24,23,1,1,"PACMA",0
5,"5042",141,117,116,0,1,"PACMA",0
24,"24157",2545,2028,1972,25,56,"PACMA",12
47,"47023",3057,2577,2557,21,20,"PACMA",32
9,"9056",4812,3585,3533,36,52,"PACMA",33
47,"47140",110,91,90,0,1,"PACMA",0
48,"48072",970,735,730,1,5,"PACMA",2
40,"40204",151,109,104,1,5,"PACMA",0
25,"25193",767,614,606,6,8,"PACMA",2
29,"29002",1150,851,842,4,9,"PACMA",6
44,"44152",67,48,48,2,0,"PACMA",1
25,"25906",210,157,155,0,2,"PACMA",1
5,"5013",847,708,701,0,7,"PACMA",2
43,"43176",746,588,586,7,2,"PACMA",4
46,"46208",1070,875,866,2,9,"PACMA",2
5,"5173",59,52,52,0,0,"PACMA",0
5,"5108",40,28,28,0,0,"PACMA",0
16,"16205",107,80,79,0,1,"PACMA",0
32,"32046",1098,793,782,5,11,"PACMA",7
45,"45032",444,319,313,2,6,"PACMA",1
50,"50121",277,220,218,2,2,"PACMA",1
4,"4029",8819,6149,6073,45,76,"PACMA",46
9,"9384",295,222,216,1,6,"PACMA",0
13,"13050",479,399,394,2,5,"PACMA",3
43,"43146",41,35,35,0,0,"PACMA",0
5,"5096",79,62,62,1,0,"PACMA",1
16,"16901",630,498,492,4,6,"PACMA",1
46,"46159",23051,17496,17359,104,137,"PACMA",295
50,"50142",24,18,18,0,0,"PACMA",0
47,"47014",47,43,43,1,0,"PACMA",0
3,"3104",27091,21366,21119,250,247,"PACMA",297
49,"49242",444,364,359,3,5,"PACMA",2
42,"42141",114,89,89,0,0,"PACMA",0
16,"16244",708,627,617,1,10,"PACMA",2
47,"47127",138,92,89,1,3,"PACMA",0
36,"36013",2242,1468,1452,15,16,"PACMA",13
31,"31026",132,116,112,0,4,"PACMA",0
43,"43105",156,132,132,3,0,"PACMA",2
3,"3063",27121,19869,19713,131,156,"PACMA",277
9,"9907",1507,1198,1174,16,24,"PACMA",14
50,"50015",81,61,59,1,2,"PACMA",0
46,"46075",147,136,134,2,2,"PACMA",3
36,"36044",2539,1768,1708,18,60,"PACMA",11
43,"43099",286,234,234,0,0,"PACMA",2
38,"38036",6831,4947,4829,58,118,"PACMA",70
43,"43139",1999,1552,1539,10,13,"PACMA",16
37,"37004",24,19,19,0,0,"PACMA",0
10,"10137",404,346,344,3,2,"PACMA",0
26,"26063",118,96,95,2,1,"PACMA",2
49,"49095",279,221,217,0,4,"PACMA",2
42,"42156",29,23,23,0,0,"PACMA",0
23,"23050",90596,69591,68903,460,688,"PACMA",909
46,"46024",444,339,335,1,4,"PACMA",2
22,"22079",114,89,88,1,1,"PACMA",0
34,"34070",135,101,101,1,0,"PACMA",0
46,"46034",1811,1407,1389,13,18,"PACMA",25
28,"28006",80622,64905,64483,400,422,"PACMA",883
4,"4006",7218,5002,4940,33,62,"PACMA",33
47,"47232",100,76,76,1,0,"PACMA",0
22,"22017",822,664,660,5,4,"PACMA",2
16,"16212",230,198,196,2,2,"PACMA",1
50,"50275",110,55,55,0,0,"PACMA",0
37,"37080",212,173,169,0,4,"PACMA",0
31,"31003",117,97,97,1,0,"PACMA",0
9,"9088",64,42,42,4,0,"PACMA",0
16,"16051",126,102,100,0,2,"PACMA",0
22,"22230",288,229,228,3,1,"PACMA",0
46,"46047",532,447,441,4,6,"PACMA",8
49,"49150",123,90,90,3,0,"PACMA",0
25,"25053",1092,879,873,8,6,"PACMA",4
14,"14066",5756,4396,4310,36,86,"PACMA",44
18,"18007",741,533,527,6,6,"PACMA",1
49,"49231",293,212,209,0,3,"PACMA",2
16,"16061",941,790,763,8,27,"PACMA",8
5,"5099",457,392,389,2,3,"PACMA",0
46,"46226",31,27,27,0,0,"PACMA",0
28,"28157",682,530,516,1,14,"PACMA",7
10,"10162",528,430,424,2,6,"PACMA",0
8,"8241",69,56,56,0,0,"PACMA",0
8,"8083",1672,1478,1471,7,7,"PACMA",8
8,"8267",6748,5389,5362,28,27,"PACMA",119
8,"8902",3937,3176,3164,17,12,"PACMA",58
17,"17004",533,445,441,3,4,"PACMA",7
8,"8059",344,292,290,2,2,"PACMA",4
17,"17158",468,337,336,1,1,"PACMA",6
17,"17148",1531,1165,1153,4,12,"PACMA",19
8,"8145",2701,2156,2144,7,12,"PACMA",34
17,"17203",165,135,135,0,0,"PACMA",2
17,"17093",922,716,715,2,1,"PACMA",6
8,"8027",720,592,588,3,4,"PACMA",2
8,"8030",5209,4318,4305,16,13,"PACMA",73
8,"8296",1843,1520,1514,10,6,"PACMA",24
8,"8287",1057,877,871,7,6,"PACMA",12
8,"8151",448,378,377,2,1,"PACMA",1
17,"17040",551,465,459,4,6,"PACMA",3
8,"8134",842,649,646,3,3,"PACMA",10
8,"8074",11054,8273,8235,34,38,"PACMA",167
17,"17168",379,332,329,0,3,"PACMA",5
8,"8221",12699,10571,10537,53,34,"PACMA",135
8,"8123",19489,16197,16135,58,62,"PACMA",223
17,"17139",1394,1163,1154,3,9,"PACMA",8
17,"17033",5587,4157,4130,13,27,"PACMA",80
8,"8200",62161,48645,48330,261,315,"PACMA",933
17,"17185",2275,1777,1768,7,9,"PACMA",10
8,"8211",33731,27698,27561,126,137,"PACMA",444
17,"17205",211,184,184,1,0,"PACMA",0
8,"8031",2336,1886,1882,11,4,"PACMA",18
8,"8154",701,587,586,5,1,"PACMA",11
17,"17086",1745,1223,1210,7,13,"PACMA",17
8,"8089",34019,26317,26191,170,126,"PACMA",537
17,"17046",710,574,571,3,3,"PACMA",7
17,"17188",169,139,138,1,1,"PACMA",1
8,"8189",122,106,106,0,0,"PACMA",0
8,"8217",25355,20935,20855,110,80,"PACMA",339
8,"8278",4893,4034,4018,17,16,"PACMA",37
8,"8249",272,248,248,2,0,"PACMA",1
8,"8233",1846,1485,1478,8,7,"PACMA",8
8,"8285",10321,8169,8120,52,49,"PACMA",80
8,"8006",11774,9039,8981,33,58,"PACMA",155
8,"8048",569,442,442,2,0,"PACMA",3
8,"8152",116,94,94,0,0,"PACMA",0
17,"17115",278,226,222,2,4,"PACMA",2
17,"17074",532,436,426,2,10,"PACMA",5
17,"17024",285,228,227,0,1,"PACMA",3
8,"8094",1586,1310,1306,10,4,"PACMA",21
17,"17011",651,544,544,4,0,"PACMA",2
8,"8281",4840,4009,3998,23,11,"PACMA",61
8,"8140",4778,3756,3737,19,19,"PACMA",51
17,"17061",183,148,148,0,0,"PACMA",2
17,"17155",14861,10307,10234,52,73,"PACMA",158
8,"8293",228,187,187,1,0,"PACMA",1
17,"17034",7205,5337,5291,16,46,"PACMA",83
8,"8268",971,746,737,3,9,"PACMA",13
8,"8109",208,184,183,0,1,"PACMA",2
8,"8016",1812,1454,1448,6,6,"PACMA",9
8,"8259",6904,5626,5601,27,25,"PACMA",88
8,"8054",9155,7468,7428,43,40,"PACMA",129
17,"17192",146,121,120,0,1,"PACMA",0
8,"8166",962,753,745,7,8,"PACMA",7
17,"17001",580,459,454,3,5,"PACMA",6
8,"8273",2353,1944,1934,9,10,"PACMA",30
17,"17098",303,245,245,2,0,"PACMA",2
8,"8295",11184,8566,8529,43,37,"PACMA",164
17,"17013",2774,2180,2173,15,7,"PACMA",41
8,"8180",27072,21218,21100,126,118,"PACMA",362
8,"8136",11614,9159,9079,84,80,"PACMA",167
17,"17123",345,304,303,4,1,"PACMA",1
17,"17902",1306,1076,1074,3,2,"PACMA",5
8,"8294",2063,1644,1643,10,1,"PACMA",32
17,"17025",1170,972,967,6,5,"PACMA",5
17,"17215",2227,1936,1925,12,11,"PACMA",26
8,"8063",467,406,405,3,1,"PACMA",6
8,"8175",3368,2496,2486,16,10,"PACMA",24
17,"17119",73,58,58,2,0,"PACMA",0
8,"8167",6048,4833,4822,48,11,"PACMA",107
8,"8258",813,661,657,6,4,"PACMA",2
17,"17128",316,255,252,1,3,"PACMA",5
17,"17126",318,279,279,0,0,"PACMA",0
17,"17054",347,271,271,0,0,"PACMA",2
17,"17103",5084,3575,3543,13,32,"PACMA",75
17,"17079",65381,50872,50631,242,241,"PACMA",654
8,"8128",577,454,451,0,3,"PACMA",8
8,"8047",3737,2903,2876,16,27,"PACMA",24
17,"17114",23269,17558,17474,91,84,"PACMA",170
8,"8223",1886,1434,1425,4,9,"PACMA",24
17,"17234",179,147,146,2,1,"PACMA",4
17,"17207",2411,2006,1992,8,14,"PACMA",15
8,"8137",274,232,229,0,3,"PACMA",3
17,"17083",2961,2321,2300,12,21,"PACMA",28
17,"17157",124,107,107,0,0,"PACMA",1
8,"8195",76,69,69,0,0,"PACMA",0
17,"17089",5695,4211,4194,13,17,"PACMA",50
17,"17224",302,233,231,2,2,"PACMA",1
8,"8126",8865,7125,7098,33,27,"PACMA",121
17,"17125",131,98,97,1,1,"PACMA",0
8,"8161",11625,8521,8470,44,51,"PACMA",178
17,"17014",63,51,50,0,1,"PACMA",0
17,"17084",231,181,180,1,1,"PACMA",0
8,"8299",377,318,317,0,1,"PACMA",0
17,"17134",223,189,189,1,0,"PACMA",5
8,"8247",980,832,828,3,4,"PACMA",3
17,"17177",567,459,457,2,2,"PACMA",3
8,"8169",48284,37528,37326,218,202,"PACMA",683
17,"17230",499,397,393,0,4,"PACMA",5
17,"17198",433,332,329,0,3,"PACMA",4
17,"17107",269,221,219,2,2,"PACMA",1
8,"8069",3280,2691,2680,17,11,"PACMA",40
17,"17065",324,254,253,0,1,"PACMA",1
8,"8101",174954,129953,129198,680,755,"PACMA",2101
8,"8306",527,390,388,2,2,"PACMA",10
17,"17209",615,519,517,2,2,"PACMA",4
17,"17044",6930,5514,5493,26,21,"PACMA",67
8,"8156",11155,8956,8923,60,33,"PACMA",160
8,"8084",1167,941,936,6,5,"PACMA",18
17,"17163",2824,2358,2351,13,7,"PACMA",18
8,"8080",39,30,30,0,0,"PACMA",0
8,"8179",611,496,493,2,3,"PACMA",12
8,"8058",1787,1357,1340,5,17,"PACMA",25
8,"8117",2480,2055,2050,16,5,"PACMA",14
17,"17109",698,558,553,1,5,"PACMA",8
8,"8196",19444,15361,15263,90,98,"PACMA",297
8,"8065",1180,967,964,4,3,"PACMA",14
17,"17102",548,439,435,3,4,"PACMA",2
17,"17117",14471,10565,10504,52,61,"PACMA",176
17,"17129",144,120,120,1,0,"PACMA",1
8,"8252",24729,19751,19642,125,109,"PACMA",410
17,"17181",3467,2664,2648,10,16,"PACMA",49
17,"17171",172,143,141,0,2,"PACMA",3
8,"8079",334,284,282,0,2,"PACMA",0
8,"8110",13592,10111,10058,50,53,"PACMA",178
8,"8298",26980,20900,20817,91,83,"PACMA",215
8,"8011",1745,1414,1407,10,7,"PACMA",6
17,"17197",131,113,113,1,0,"PACMA",3
17,"17136",195,156,155,0,1,"PACMA",3
17,"17175",564,381,381,1,0,"PACMA",5
17,"17232",149,117,116,0,1,"PACMA",1
8,"8158",3108,2458,2453,13,5,"PACMA",44
8,"8308",137,118,118,0,0,"PACMA",0
8,"8071",241,200,200,0,0,"PACMA",1
17,"17162",156,114,111,1,3,"PACMA",1
8,"8220",2411,2119,2115,13,4,"PACMA",5
8,"8263",21151,16360,16269,116,91,"PACMA",331
8,"8108",5192,4204,4189,26,15,"PACMA",72
8,"8067",5728,4535,4513,21,22,"PACMA",62
8,"8297",135,111,111,1,0,"PACMA",2
8,"8004",209,194,191,0,3,"PACMA",0
8,"8045",71,52,49,0,3,"PACMA",0
8,"8147",17282,13644,13560,94,84,"PACMA",252
17,"17094",1068,772,766,1,6,"PACMA",8
17,"17147",7959,6164,6130,45,34,"PACMA",73
8,"8153",559,460,458,2,2,"PACMA",7
17,"17208",976,772,768,5,4,"PACMA",8
8,"8289",4457,3605,3594,20,11,"PACMA",69
17,"17088",578,468,468,1,0,"PACMA",3
8,"8197",7896,6197,6174,28,23,"PACMA",110
8,"8242",222,180,180,0,0,"PACMA",5
8,"8262",6919,5090,5060,33,30,"PACMA",81
8,"8114",18648,14251,14170,69,81,"PACMA",234
8,"8062",1004,829,826,11,3,"PACMA",12
8,"8214",6966,5648,5633,21,15,"PACMA",75
8,"8272",165,133,133,0,0,"PACMA",0
17,"17092",3467,2660,2633,17,27,"PACMA",42
17,"17154",99,84,83,0,1,"PACMA",1
8,"8091",5413,4301,4283,20,18,"PACMA",64
8,"8148",2334,1803,1794,6,9,"PACMA",54
17,"17099",78,59,59,0,0,"PACMA",1
8,"8085",976,812,811,2,1,"PACMA",6
8,"8243",156,139,139,0,0,"PACMA",0
8,"8178",451,389,388,3,1,"PACMA",6
17,"17095",19938,13998,13918,69,80,"PACMA",254
8,"8266",43383,35117,34994,178,123,"PACMA",586
8,"8021",61,47,45,0,2,"PACMA",0
8,"8005",6380,5122,5106,18,16,"PACMA",89
8,"8024",357,301,298,1,3,"PACMA",2
17,"17146",3127,2404,2381,11,23,"PACMA",58
8,"8040",11004,8468,8431,24,37,"PACMA",132
8,"8302",9373,7001,6934,61,67,"PACMA",128
17,"17901",983,790,789,3,1,"PACMA",20
17,"17221",4152,3260,3247,11,13,"PACMA",49
8,"8185",197,172,171,2,1,"PACMA",5
17,"17010",327,264,263,2,1,"PACMA",5
8,"8097",1080,891,880,2,11,"PACMA",14
17,"17091",398,310,305,2,5,"PACMA",1
17,"17031",182,130,129,0,1,"PACMA",2
8,"8216",25,19,19,0,0,"PACMA",0
8,"8007",6775,5447,5419,21,28,"PACMA",100
8,"8224",878,697,695,1,2,"PACMA",12
8,"8250",7182,5461,5421,38,40,"PACMA",74
8,"8001",9079,7383,7341,40,42,"PACMA",168
8,"8260",18400,14471,14406,87,65,"PACMA",290
17,"17116",354,283,282,0,1,"PACMA",2
8,"8093",24,20,20,0,0,"PACMA",0
8,"8127",2240,1694,1683,13,11,"PACMA",30
8,"8171",2066,1607,1597,7,10,"PACMA",8
8,"8246",1672,1412,1406,7,6,"PACMA",12
8,"8044",4136,3193,3175,11,18,"PACMA",31
8,"8035",12871,9574,9538,31,36,"PACMA",175
8,"8096",43555,34070,33871,194,199,"PACMA",537
8,"8139",177,156,156,0,0,"PACMA",2
17,"17080",144,124,124,2,0,"PACMA",0
8,"8222",1819,1484,1476,11,8,"PACMA",17
8,"8087",149,135,133,0,2,"PACMA",1
8,"8064",1920,1516,1506,6,10,"PACMA",21
8,"8202",12843,10074,10025,57,49,"PACMA",125
17,"17101",562,415,413,2,2,"PACMA",7
8,"8208",5760,4660,4643,25,17,"PACMA",100
17,"17049",3204,2634,2615,9,19,"PACMA",22
17,"17070",110,94,94,0,0,"PACMA",2
17,"17016",719,584,581,1,3,"PACMA",3
17,"17110",1329,1064,1054,5,10,"PACMA",16
8,"8284",12482,8959,8887,41,72,"PACMA",168
17,"17152",11026,7610,7564,70,46,"PACMA",132
8,"8146",1358,1086,1079,2,7,"PACMA",19
17,"17210",580,449,445,2,4,"PACMA",7
8,"8015",156003,117736,117183,704,553,"PACMA",2247
17,"17064",326,263,261,2,2,"PACMA",1
17,"17043",167,135,134,0,1,"PACMA",3
17,"17204",596,461,460,2,1,"PACMA",4
8,"8206",737,625,624,3,1,"PACMA",4
8,"8176",161,132,131,2,1,"PACMA",0
17,"17172",457,352,349,1,3,"PACMA",7
8,"8115",3825,2994,2975,12,19,"PACMA",61
17,"17100",195,157,154,0,3,"PACMA",1
8,"8162",2124,1659,1651,7,8,"PACMA",28
8,"8193",984,792,790,5,2,"PACMA",11
17,"17130",322,268,268,0,0,"PACMA",1
8,"8174",392,330,330,4,0,"PACMA",7
17,"17018",494,405,402,1,3,"PACMA",1
8,"8092",3714,2912,2889,8,23,"PACMA",12
8,"8066",1463,1185,1181,9,4,"PACMA",21
8,"8215",2589,2044,2034,19,10,"PACMA",19
8,"8010",4207,3327,3304,13,23,"PACMA",39
8,"8061",1590,1236,1233,8,3,"PACMA",20
17,"17160",14733,10833,10766,43,67,"PACMA",172
8,"8070",266,232,232,0,0,"PACMA",0
17,"17220",805,673,665,2,8,"PACMA",5
8,"8124",37130,29069,28915,146,154,"PACMA",538
17,"17009",4051,3263,3248,14,15,"PACMA",19
17,"17223",800,623,616,5,7,"PACMA",3
8,"8053",2865,2105,2098,17,7,"PACMA",31
8,"8188",115,95,95,0,0,"PACMA",0
8,"8275",248,223,222,1,1,"PACMA",1
17,"17164",3932,3078,3054,8,24,"PACMA",28
8,"8905",2308,1943,1938,7,5,"PACMA",31
17,"17142",2673,2250,2241,14,9,"PACMA",28
17,"17026",543,450,449,4,1,"PACMA",5
8,"8102",28794,22420,22317,92,103,"PACMA",288
8,"8157",8547,6949,6918,39,31,"PACMA",116
17,"17006",1186,880,878,10,2,"PACMA",17
17,"17226",895,673,669,3,4,"PACMA",13
8,"8022",12219,9089,9038,42,51,"PACMA",79
8,"8132",361,281,281,2,0,"PACMA",3
8,"8261",2378,1821,1815,14,6,"PACMA",27
17,"17194",78,62,62,0,0,"PACMA",1
8,"8903",197,177,176,0,1,"PACMA",0
17,"17213",5535,3998,3985,20,13,"PACMA",51
8,"8112",12935,9822,9765,74,57,"PACMA",98
8,"8149",984,770,768,3,2,"PACMA",8
17,"17111",958,772,771,3,1,"PACMA",9
17,"17143",144,115,115,0,0,"PACMA",2
17,"17180",8500,6462,6431,28,31,"PACMA",99
8,"8019",1117818,875679,872180,4327,3499,"PACMA",12415
17,"17062",5978,4358,4334,26,24,"PACMA",73
17,"17071",1128,978,978,3,0,"PACMA",6
8,"8303",256,215,213,1,2,"PACMA",3
17,"17233",2328,1924,1912,6,12,"PACMA",20
8,"8213",6547,5270,5245,23,25,"PACMA",59
8,"8227",2410,1882,1877,10,5,"PACMA",30
17,"17186",3824,3115,3098,15,17,"PACMA",49
17,"17183",255,216,216,0,0,"PACMA",3
8,"8198",4640,3713,3691,23,22,"PACMA",56
8,"8075",4059,3127,3119,14,8,"PACMA",55
17,"17075",334,282,281,5,1,"PACMA",4
8,"8052",139,111,110,0,1,"PACMA",0
17,"17145",1432,1113,1103,7,10,"PACMA",18
17,"17135",395,309,307,0,2,"PACMA",3
8,"8255",137,105,105,1,0,"PACMA",0
8,"8254",1753,1485,1482,3,3,"PACMA",20
8,"8194",25674,17691,17585,115,106,"PACMA",348
8,"8292",1062,835,831,3,4,"PACMA",20
17,"17132",1333,1088,1080,9,8,"PACMA",9
8,"8184",54876,41661,41447,248,214,"PACMA",880
8,"8029",3560,3027,3019,13,8,"PACMA",53
17,"17023",27144,20301,20146,120,155,"PACMA",325
17,"17073",1939,1695,1693,7,2,"PACMA",14
17,"17120",820,604,598,3,6,"PACMA",14
8,"8237",1662,1334,1327,7,7,"PACMA",15
8,"8068",6878,5456,5437,25,19,"PACMA",113
8,"8023",6915,5339,5299,26,40,"PACMA",87
17,"17216",155,127,124,0,3,"PACMA",2
8,"8099",753,565,561,2,4,"PACMA",4
17,"17060",408,311,311,1,0,"PACMA",2
8,"8105",9724,7557,7505,49,52,"PACMA",175
17,"17036",2643,2076,2071,12,5,"PACMA",14
8,"8143",2719,2121,2109,10,12,"PACMA",44
17,"17169",2497,2047,2042,8,5,"PACMA",37
8,"8118",17542,14101,14059,56,42,"PACMA",225
8,"8100",2092,1792,1782,16,10,"PACMA",11
17,"17106",143,124,123,0,1,"PACMA",2
8,"8034",784,648,646,1,2,"PACMA",9
8,"8282",6711,5696,5677,27,19,"PACMA",72
17,"17165",634,516,512,3,4,"PACMA",4
8,"8051",18437,14951,14887,85,64,"PACMA",272
8,"8192",5679,4605,4589,20,16,"PACMA",39
17,"17137",3467,2925,2912,15,13,"PACMA",24
17,"17178",1056,804,798,3,6,"PACMA",5
8,"8245",77805,57956,57666,313,290,"PACMA",1010
8,"8279",155280,121081,120515,802,566,"PACMA",2282
17,"17005",460,336,331,0,5,"PACMA",1
8,"8113",52518,39750,39592,198,158,"PACMA",524
17,"17048",6251,4565,4537,20,28,"PACMA",88
8,"8251",5127,3972,3940,17,32,"PACMA",76
8,"8119",6838,5352,5326,31,26,"PACMA",122
8,"8078",219,176,172,1,4,"PACMA",1
17,"17174",162,132,132,4,0,"PACMA",1
8,"8046",13478,10989,10939,67,50,"PACMA",137
8,"8002",220,184,183,2,1,"PACMA",0
17,"17161",1018,859,855,1,4,"PACMA",10
17,"17003",102,75,75,0,0,"PACMA",0
8,"8056",42727,33215,33054,220,161,"PACMA",674
8,"8014",2000,1578,1567,5,11,"PACMA",29
17,"17019",1784,1472,1462,3,10,"PACMA",2
8,"8133",128,98,98,5,0,"PACMA",0
8,"8301",49135,38575,38398,272,177,"PACMA",779
8,"8235",3829,3176,3167,14,9,"PACMA",35
8,"8229",521,435,433,3,2,"PACMA",2
8,"8269",2712,2258,2250,19,8,"PACMA",24
8,"8017",2827,2192,2182,16,10,"PACMA",26
17,"17187",625,530,529,4,1,"PACMA",4
8,"8232",1786,1444,1434,9,10,"PACMA",18
8,"8290",1534,1289,1284,9,5,"PACMA",21
17,"17217",353,312,311,1,1,"PACMA",4
17,"17077",567,434,434,2,0,"PACMA",6
8,"8209",6896,5269,5244,25,25,"PACMA",103
17,"17159",626,487,483,1,4,"PACMA",8
17,"17067",697,581,578,4,3,"PACMA",10
17,"17201",143,120,120,0,0,"PACMA",1
17,"17007",1752,1430,1422,2,8,"PACMA",13
17,"17096",164,113,113,1,0,"PACMA",3
17,"17087",222,177,176,0,1,"PACMA",2
8,"8210",4584,3455,3435,23,20,"PACMA",64
17,"17057",968,826,822,1,4,"PACMA",8
17,"17029",199,160,157,1,3,"PACMA",4
8,"8218",8104,6419,6389,34,30,"PACMA",83
8,"8170",442,338,338,0,0,"PACMA",0
17,"17078",336,252,251,3,1,"PACMA",2
8,"8177",39,31,31,0,0,"PACMA",0
17,"17218",570,468,465,5,3,"PACMA",10
17,"17055",143,126,125,0,1,"PACMA",1
8,"8225",94,81,81,1,0,"PACMA",0
17,"17228",285,229,229,1,0,"PACMA",2
8,"8201",447,327,324,5,3,"PACMA",5
17,"17144",210,171,170,0,1,"PACMA",1
8,"8199",651,542,542,4,0,"PACMA",5
8,"8190",258,216,215,1,1,"PACMA",2
8,"8125",25485,19719,19627,101,92,"PACMA",393
8,"8160",316,252,247,2,5,"PACMA",1
8,"8280",95,78,78,1,0,"PACMA",0
17,"17105",247,194,194,1,0,"PACMA",3
8,"8041",10692,7805,7732,48,73,"PACMA",127
8,"8168",394,287,287,1,0,"PACMA",5
8,"8304",816,686,678,1,8,"PACMA",4
17,"17056",1766,1438,1433,9,5,"PACMA",8
17,"17032",1742,1235,1224,6,11,"PACMA",21
17,"17035",550,460,460,3,0,"PACMA",1
8,"8033",13218,10480,10435,50,45,"PACMA",172
17,"17066",27323,18373,18269,98,104,"PACMA",299
8,"8032",2087,1607,1598,9,9,"PACMA",35
8,"8236",1557,1204,1202,2,2,"PACMA",18
8,"8182",2892,2217,2204,18,13,"PACMA",38
17,"17133",1273,1048,1043,7,5,"PACMA",15
8,"8203",2472,1884,1873,4,11,"PACMA",48
17,"17030",650,479,477,4,2,"PACMA",4
8,"8226",926,811,807,1,4,"PACMA",2
8,"8039",402,334,334,2,0,"PACMA",6
8,"8230",7666,6202,6168,30,34,"PACMA",92
8,"8025",1535,1221,1214,7,7,"PACMA",18
8,"8307",49310,38223,38022,162,201,"PACMA",583
8,"8018",2551,1998,1984,6,14,"PACMA",21
17,"17021",122,98,98,0,0,"PACMA",0
8,"8305",27533,21656,21539,96,117,"PACMA",300
8,"8165",1664,1315,1311,9,4,"PACMA",21
8,"8159",14323,11399,11359,57,40,"PACMA",184
17,"17214",723,584,580,7,4,"PACMA",9
8,"8086",14017,10746,10677,89,69,"PACMA",189
17,"17047",4968,3447,3429,22,18,"PACMA",67
8,"8155",6960,5427,5390,39,37,"PACMA",124
8,"8187",153380,120687,120090,637,597,"PACMA",2094
17,"17068",246,194,193,0,1,"PACMA",1
17,"17190",838,681,677,0,4,"PACMA",7
8,"8276",233,180,180,0,0,"PACMA",5
17,"17138",845,650,646,0,4,"PACMA",9
17,"17076",122,101,100,1,1,"PACMA",4
8,"8104",653,516,516,2,0,"PACMA",9
17,"17191",166,145,144,2,1,"PACMA",0
8,"8009",9480,7649,7620,35,29,"PACMA",110
17,"17069",364,286,284,2,2,"PACMA",1
17,"17184",1264,1068,1060,5,8,"PACMA",8
8,"8131",741,585,585,4,0,"PACMA",7
8,"8219",15629,12910,12865,58,45,"PACMA",181
17,"17042",408,313,311,0,2,"PACMA",4
8,"8205",61279,51629,51497,360,132,"PACMA",715
8,"8008",179,139,138,0,1,"PACMA",3
17,"17903",889,726,721,4,5,"PACMA",6
17,"17020",3671,3021,3006,11,15,"PACMA",33
8,"8163",19497,14616,14548,67,68,"PACMA",282
8,"8036",163,134,133,0,1,"PACMA",3
8,"8098",2409,1916,1912,9,4,"PACMA",40
17,"17041",218,166,165,3,1,"PACMA",1
17,"17149",364,314,314,0,0,"PACMA",4
8,"8129",484,406,405,3,1,"PACMA",10
17,"17027",2866,2375,2364,8,11,"PACMA",27
8,"8077",34578,27617,27501,134,116,"PACMA",426
8,"8003",7183,5761,5742,39,19,"PACMA",81
8,"8042",2362,1910,1904,7,6,"PACMA",37
17,"17050",674,585,582,5,3,"PACMA",5
17,"17081",248,192,190,0,2,"PACMA",0
8,"8256",691,571,568,3,3,"PACMA",13
8,"8212",491,406,402,1,4,"PACMA",1
8,"8026",193,161,161,1,0,"PACMA",3
8,"8264",4535,3623,3613,13,10,"PACMA",57
17,"17182",272,220,220,3,0,"PACMA",7
8,"8207",2014,1736,1730,9,6,"PACMA",13
17,"17193",4312,3202,3179,15,23,"PACMA",50
17,"17170",180,147,147,2,0,"PACMA",0
8,"8277",171,150,150,0,0,"PACMA",1
17,"17124",1599,1258,1254,6,4,"PACMA",14
17,"17173",182,156,156,0,0,"PACMA",2
17,"17037",114,98,98,6,0,"PACMA",0
8,"8135",6735,5445,5421,36,24,"PACMA",109
17,"17150",1426,1199,1192,8,7,"PACMA",9
8,"8183",4563,3628,3613,9,15,"PACMA",45
8,"8106",7469,5816,5795,34,21,"PACMA",102
17,"17052",134,104,104,1,0,"PACMA",3
17,"17166",547,460,459,2,1,"PACMA",4
8,"8060",135,111,109,0,2,"PACMA",0
8,"8253",128,113,113,0,0,"PACMA",0
17,"17227",139,106,106,0,0,"PACMA",1
8,"8095",67,53,52,0,1,"PACMA",1
8,"8120",7048,5892,5881,49,11,"PACMA",81
8,"8073",62572,48770,48527,255,243,"PACMA",723
8,"8904",10514,7733,7697,38,36,"PACMA",196
8,"8240",9453,7807,7776,21,31,"PACMA",79
8,"8050",136,115,114,0,1,"PACMA",1
8,"8111",215,200,199,4,1,"PACMA",0
17,"17097",199,172,170,1,2,"PACMA",4
17,"17121",229,184,184,1,0,"PACMA",0
17,"17196",242,198,198,1,0,"PACMA",7
8,"8144",713,565,563,5,2,"PACMA",3
8,"8204",3115,2548,2534,22,14,"PACMA",40
17,"17200",623,512,510,1,2,"PACMA",7
17,"17015",12819,10133,10078,38,55,"PACMA",83
8,"8228",288,239,239,2,0,"PACMA",2
17,"17090",544,469,468,0,1,"PACMA",4
8,"8191",5270,4176,4162,19,14,"PACMA",51
17,"17051",207,174,173,3,1,"PACMA",0
8,"8164",934,784,776,1,8,"PACMA",12
8,"8028",1088,783,780,2,3,"PACMA",17
8,"8076",16497,12734,12667,82,67,"PACMA",246
17,"17008",3594,2763,2741,16,22,"PACMA",24
17,"17063",173,157,156,2,1,"PACMA",0
17,"17028",297,238,237,1,1,"PACMA",1
8,"8088",12248,9945,9904,57,41,"PACMA",113
8,"8244",6041,4994,4970,33,24,"PACMA",86
17,"17140",639,539,527,4,12,"PACMA",2
17,"17189",1476,1278,1275,2,3,"PACMA",5
8,"8234",3373,2742,2734,25,8,"PACMA",63
8,"8288",1676,1196,1182,6,14,"PACMA",24
8,"8081",353,299,297,2,2,"PACMA",11
8,"8130",108,89,86,2,3,"PACMA",0
8,"8138",4432,3435,3413,10,22,"PACMA",38
8,"8057",61,50,50,0,0,"PACMA",0
8,"8239",460,380,378,2,2,"PACMA",3
17,"17141",6072,4251,4221,14,30,"PACMA",78
8,"8043",3378,2579,2569,20,10,"PACMA",34
8,"8107",11900,9303,9187,43,116,"PACMA",206
8,"8116",558,459,459,0,0,"PACMA",3
17,"17022",7008,5386,5354,22,32,"PACMA",50
8,"8248",5616,4378,4365,32,13,"PACMA",63
8,"8270",18837,14541,14497,66,44,"PACMA",297
8,"8181",8061,6442,6402,28,40,"PACMA",126
8,"8238",14851,12472,12428,50,44,"PACMA",212
8,"8286",2919,2210,2199,15,11,"PACMA",49
17,"17176",123,110,110,1,0,"PACMA",2
8,"8103",640,507,505,4,2,"PACMA",8
17,"17225",207,161,161,0,0,"PACMA",1
17,"17039",1740,1385,1380,8,5,"PACMA",19
8,"8038",1525,1228,1220,2,8,"PACMA",18
17,"17112",194,154,152,2,2,"PACMA",4
17,"17038",380,312,308,3,4,"PACMA",4
8,"8172",20417,16196,16144,88,52,"PACMA",260
8,"8283",6113,4832,4813,33,19,"PACMA",68
17,"17195",342,296,295,3,1,"PACMA",0
17,"17118",12916,9521,9460,37,61,"PACMA",146
8,"8012",1721,1340,1331,8,9,"PACMA",12
17,"17206",155,118,115,0,3,"PACMA",0
8,"8037",1930,1618,1610,10,8,"PACMA",14
8,"8141",4573,3611,3595,26,16,"PACMA",25
8,"8265",1590,1339,1334,6,5,"PACMA",12
17,"17212",142,117,117,2,0,"PACMA",1
17,"17167",2609,2122,2102,14,20,"PACMA",14
8,"8013",1280,1040,1031,5,9,"PACMA",17
8,"8020",5172,4337,4327,26,10,"PACMA",86
8,"8274",4674,3710,3698,12,12,"PACMA",40
17,"17202",3813,2876,2851,8,25,"PACMA",39
17,"17085",291,248,246,0,2,"PACMA",8
17,"17211",831,694,691,1,3,"PACMA",6
8,"8121",87292,67638,67328,362,310,"PACMA",1161
17,"17199",6955,5328,5308,23,20,"PACMA",53
8,"8271",67,57,57,0,0,"PACMA",0
17,"17012",1171,916,914,10,2,"PACMA",10
8,"8082",1143,868,861,4,7,"PACMA",21
8,"8257",103,86,86,1,0,"PACMA",0
17,"17222",105,95,95,1,0,"PACMA",0
8,"8142",139,126,126,1,0,"PACMA",0
17,"17002",564,491,488,3,3,"PACMA",4
8,"8122",1716,1260,1254,8,6,"PACMA",24
8,"8901",240,203,201,1,2,"PACMA",1
17,"17151",185,150,150,1,0,"PACMA",2
17,"17058",170,139,139,0,0,"PACMA",1
8,"8090",137,113,113,2,0,"PACMA",1
8,"8072",10699,8226,8193,45,33,"PACMA",154
8,"8300",5892,4912,4880,24,32,"PACMA",106
8,"8150",251,211,211,0,0,"PACMA",0
17,"17082",436,341,339,0,2,"PACMA",6
8,"8055",541,443,442,2,1,"PACMA",6
17,"17153",188,162,162,0,0,"PACMA",1
8,"8049",1320,981,977,5,4,"PACMA",9
8,"8231",21132,15940,15880,75,60,"PACMA",324
8,"8291",4919,3865,3854,28,11,"PACMA",104
41,"41085",4170,3337,3270,27,67,"PACT",4
41,"41060",15100,11304,11105,113,199,"PACT",25
7,"7052",4816,3276,3258,39,18,"PACT",3
28,"28129",8578,6925,6853,45,72,"PACT",29
40,"40021",19,18,18,0,0,"PACT",0
28,"28094",959,736,729,6,7,"PACT",1
6,"6132",829,598,593,0,5,"PACT",3
7,"7021",230,183,178,3,5,"PACT",0
28,"28044",6193,5040,4991,31,49,"PACT",26
5,"5078",100,87,86,0,1,"PACT",0
5,"5120",32,25,25,1,0,"PACT",0
40,"40156",281,223,222,1,1,"PACT",0
40,"40039",180,147,144,1,3,"PACT",0
40,"40045",120,92,92,1,0,"PACT",0
40,"40219",565,451,432,2,19,"PACT",1
6,"6069",3005,2172,2133,24,39,"PACT",3
6,"6062",576,435,430,0,5,"PACT",2
5,"5014",5291,4096,4044,29,52,"PACT",7
40,"40028",105,96,96,1,0,"PACT",0
41,"41021",21397,15585,15334,201,251,"PACT",137
28,"28151",3251,2483,2450,11,33,"PACT",7
5,"5905",222,165,164,1,1,"PACT",0
7,"7025",446,363,362,4,1,"PACT",1
40,"40018",75,60,60,0,0,"PACT",0
40,"40091",108,93,93,1,0,"PACT",0
10,"10208",121,94,94,2,0,"PACT",1
41,"41083",1128,865,859,6,6,"PACT",1
10,"10167",307,238,237,1,1,"PACT",0
10,"10131",12808,9377,9254,67,123,"PACT",29
41,"41027",3966,2830,2784,32,46,"PACT",1
28,"28032",5042,4039,3992,23,47,"PACT",22
28,"28092",153428,121511,120211,807,1300,"PACT",602
5,"5204",583,486,482,4,4,"PACT",2
41,"41092",7679,5668,5568,61,100,"PACT",8
28,"28086",5390,3992,3936,26,56,"PACT",11
28,"28168",1329,976,969,3,7,"PACT",3
40,"40196",32,28,28,1,0,"PACT",0
10,"10050",1015,831,823,2,8,"PACT",0
40,"40108",110,91,90,0,1,"PACT",0
10,"10092",266,216,211,18,5,"PACT",0
40,"40151",43,32,32,0,0,"PACT",0
40,"40128",122,95,93,2,2,"PACT",0
41,"41095",39970,27911,27583,389,328,"PACT",87
28,"28101",229,183,182,2,1,"PACT",0
28,"28148",88647,70218,69546,570,672,"PACT",454
5,"5129",116,82,76,1,6,"PACT",0
10,"10106",127,108,106,0,2,"PACT",1
10,"10146",1513,1128,1104,6,24,"PACT",1
28,"28029",562,459,456,2,3,"PACT",2
5,"5176",223,173,166,2,7,"PACT",0
5,"5041",995,776,767,3,9,"PACT",0
40,"40214",196,167,163,1,4,"PACT",0
40,"40904",341,302,300,4,2,"PACT",1
28,"28107",442,336,325,3,11,"PACT",0
41,"41082",3359,2760,2718,11,42,"PACT",1
5,"5002",1890,1497,1468,8,29,"PACT",2
6,"6142",259,214,208,1,6,"PACT",0
6,"6137",933,730,723,5,7,"PACT",2
5,"5228",167,124,124,0,0,"PACT",0
28,"28019",1269,990,981,4,9,"PACT",6
5,"5219",37,30,30,0,0,"PACT",0
5,"5117",193,169,167,0,2,"PACT",0
40,"40178",90,63,63,1,0,"PACT",0
28,"28085",4141,3337,3296,13,41,"PACT",8
28,"28154",5525,4283,4222,24,61,"PACT",11
10,"10010",2213,1499,1470,6,29,"PACT",2
10,"10028",82,60,59,0,1,"PACT",0
10,"10086",303,249,244,3,5,"PACT",0
40,"40230",95,70,67,0,3,"PACT",0
40,"40079",226,179,175,1,4,"PACT",2
40,"40105",44,39,38,0,1,"PACT",0
28,"28028",1820,1493,1483,8,10,"PACT",4
33,"33043",658,462,455,4,7,"PACT",1
40,"40166",253,214,213,1,1,"PACT",0
33,"33075",253,139,135,1,4,"PACT",0
7,"7019",164,124,124,0,0,"PACT",0
5,"5214",27,22,22,0,0,"PACT",0
10,"10183",958,748,735,3,13,"PACT",3
33,"33016",18904,14376,14235,168,141,"PACT",85
41,"41019",4895,3518,3462,36,56,"PACT",6
7,"7003",12374,7550,7442,51,108,"PACT",13
5,"5175",149,122,119,1,3,"PACT",1
28,"28093",2142,1751,1728,9,23,"PACT",8
6,"6041",457,381,374,5,7,"PACT",0
28,"28023",5090,4252,4212,31,40,"PACT",17
6,"6044",29204,21778,21492,203,286,"PACT",45
40,"40122",525,442,434,2,8,"PACT",4
6,"6065",298,258,255,1,3,"PACT",1
33,"33028",1158,635,630,6,5,"PACT",3
7,"7018",379,287,286,1,1,"PACT",0
10,"10164",720,474,461,3,13,"PACT",0
5,"5102",1681,1358,1329,4,29,"PACT",6
10,"10117",243,156,154,1,2,"PACT",0
10,"10152",446,354,350,2,4,"PACT",0
40,"40074",245,219,214,5,5,"PACT",0
7,"7020",3692,2833,2808,42,25,"PACT",2
10,"10193",1412,1158,1145,4,13,"PACT",2
10,"10004",690,529,517,8,12,"PACT",0
40,"40906",2131,1830,1814,10,16,"PACT",7
10,"10115",3488,2878,2816,15,62,"PACT",7
40,"40061",65,50,48,2,2,"PACT",0
40,"40049",40,30,29,0,1,"PACT",0
10,"10084",1294,899,869,5,30,"PACT",2
28,"28046",4776,3944,3912,22,32,"PACT",38
28,"28174",1840,1363,1349,10,14,"PACT",4
5,"5217",54,44,43,0,1,"PACT",0
10,"10213",534,447,441,5,6,"PACT",0
40,"40020",155,125,119,4,6,"PACT",0
6,"6003",766,625,610,3,15,"PACT",1
6,"6135",1096,915,902,3,13,"PACT",0
41,"41068",13936,10692,10530,73,162,"PACT",19
6,"6159",2339,1577,1507,25,70,"PACT",2
40,"40097",125,96,95,1,1,"PACT",0
5,"5231",151,126,126,0,0,"PACT",0
10,"10100",783,584,566,7,18,"PACT",0
28,"28014",34047,26858,26575,178,283,"PACT",90
6,"6063",2938,2299,2264,11,35,"PACT",3
6,"6017",257,211,210,1,1,"PACT",1
5,"5241",3041,2242,2204,24,38,"PACT",5
7,"7056",5245,3883,3841,32,42,"PACT",7
40,"40903",77,63,62,0,1,"PACT",0
41,"41004",57465,41004,40321,571,683,"PACT",209
10,"10080",360,256,246,0,10,"PACT",0
28,"28901",868,653,639,6,14,"PACT",3
5,"5076",473,417,413,7,4,"PACT",2
10,"10038",83,70,69,0,1,"PACT",0
6,"6081",1042,825,811,4,14,"PACT",4
10,"10210",492,362,358,3,4,"PACT",0
6,"6053",590,461,444,7,17,"PACT",1
40,"40040",2495,1913,1895,20,18,"PACT",5
7,"7054",22958,14097,13908,123,189,"PACT",9
40,"40126",67,53,51,0,2,"PACT",0
5,"5079",68,56,56,0,0,"PACT",0
10,"10158",337,269,267,0,2,"PACT",0
28,"28052",3949,2890,2818,8,72,"PACT",9
40,"40005",25,21,21,0,0,"PACT",0
7,"7005",6975,4824,4775,43,49,"PACT",6
6,"6047",837,677,669,6,8,"PACT",2
5,"5237",155,131,129,1,2,"PACT",1
33,"33042",4243,3137,3103,36,34,"PACT",20
28,"28073",12751,9940,9838,63,102,"PACT",51
28,"28102",891,681,666,4,15,"PACT",1
5,"5097",476,332,327,0,5,"PACT",0
10,"10001",283,233,232,3,1,"PACT",2
10,"10064",1409,1103,1072,6,31,"PACT",1
33,"33013",429,320,316,1,4,"PACT",2
28,"28099",1923,1490,1475,7,15,"PACT",3
28,"28005",136050,108267,107316,772,951,"PACT",622
6,"6095",9511,7338,7152,116,186,"PACT",14
33,"33034",10043,6765,6671,69,94,"PACT",20
41,"41054",713,596,588,4,8,"PACT",1
10,"10141",289,224,223,0,1,"PACT",0
6,"6902",1663,1273,1252,4,21,"PACT",1
28,"28082",6063,4939,4889,46,50,"PACT",41
28,"28104",15318,12897,12797,87,100,"PACT",70
5,"5138",289,224,223,2,1,"PACT",2
40,"40125",75,61,61,2,0,"PACT",0
40,"40132",46,32,31,1,1,"PACT",0
28,"28051",1640,1301,1292,9,9,"PACT",10
6,"6074",4755,3719,3638,27,81,"PACT",6
6,"6022",2634,2156,2112,7,44,"PACT",0
28,"28126",47,35,35,0,0,"PACT",0
5,"5018",24,18,17,0,1,"PACT",1
28,"28115",62352,53136,52912,268,224,"PACT",175
6,"6117",1401,1089,1067,6,22,"PACT",1
33,"33015",1428,1003,993,7,10,"PACT",1
28,"28031",2140,1642,1614,11,28,"PACT",3
28,"28127",66441,56199,55932,327,267,"PACT",186
10,"10026",656,515,507,8,8,"PACT",1
6,"6141",1688,1308,1291,16,17,"PACT",2
5,"5021",1871,1469,1440,15,29,"PACT",5
5,"5134",49,41,40,0,1,"PACT",0
7,"7053",1164,956,948,4,8,"PACT",2
6,"6119",681,551,547,1,4,"PACT",0
28,"28022",36550,31559,31436,207,123,"PACT",91
40,"40026",113,106,105,2,1,"PACT",0
10,"10161",82,50,50,1,0,"PACT",0
33,"33046",483,370,367,6,3,"PACT",0
41,"41018",9410,6987,6882,52,105,"PACT",17
10,"10083",96,74,73,0,1,"PACT",0
5,"5191",124,105,105,0,0,"PACT",1
10,"10054",524,435,422,1,13,"PACT",1
41,"41074",2998,2364,2322,17,42,"PACT",2
41,"41090",3507,2766,2694,15,72,"PACT",4
28,"28043",6166,4404,4320,30,84,"PACT",28
28,"28135",985,762,756,1,6,"PACT",5
40,"40211",69,58,58,1,0,"PACT",0
5,"5196",57,45,42,0,3,"PACT",0
6,"6021",908,708,698,9,10,"PACT",0
10,"10155",1082,825,819,4,6,"PACT",2
40,"40124",234,175,168,3,7,"PACT",0
6,"6054",5454,4329,4190,46,139,"PACT",13
40,"40030",428,357,350,3,7,"PACT",0
33,"33008",1705,1285,1273,9,12,"PACT",4
7,"7033",28373,17884,17684,201,200,"PACT",20
5,"5113",62,49,49,0,0,"PACT",0
28,"28013",41563,32024,31693,194,331,"PACT",148
5,"5156",234,153,151,0,2,"PACT",0
6,"6155",1825,1316,1292,21,24,"PACT",3
40,"40168",28,22,22,0,0,"PACT",0
6,"6052",3969,3043,2970,21,73,"PACT",3
7,"7060",2665,1976,1964,14,12,"PACT",3
6,"6125",1679,1348,1324,5,24,"PACT",1
40,"40215",83,69,69,0,0,"PACT",0
10,"10215",413,305,301,2,4,"PACT",2
5,"5069",74,63,62,0,1,"PACT",0
5,"5101",277,224,222,0,2,"PACT",0
10,"10153",283,204,199,0,5,"PACT",0
40,"40142",52,42,40,0,2,"PACT",0
40,"40110",316,254,253,2,1,"PACT",0
5,"5158",345,279,274,2,5,"PACT",0
5,"5230",65,58,58,4,0,"PACT",0
5,"5242",686,588,585,11,3,"PACT",0
6,"6123",4512,3358,3266,28,92,"PACT",8
6,"6042",981,714,705,4,9,"PACT",0
5,"5177",139,117,117,0,0,"PACT",0
5,"5012",121,100,97,0,3,"PACT",0
28,"28130",28508,23566,23305,179,261,"PACT",291
7,"7032",20888,14257,14096,108,161,"PACT",24
6,"6018",740,543,536,5,7,"PACT",0
40,"40181",4166,3405,3337,21,68,"PACT",8
5,"5093",353,275,269,0,6,"PACT",3
33,"33070",3293,2499,2473,32,26,"PACT",18
5,"5066",439,373,367,2,6,"PACT",3
40,"40056",32,21,21,0,0,"PACT",0
5,"5184",240,207,204,1,3,"PACT",0
41,"41902",4600,3141,3092,48,49,"PACT",6
6,"6014",6535,4757,4679,36,78,"PACT",3
6,"6002",4314,3181,3086,44,95,"PACT",8
10,"10079",858,694,684,1,10,"PACT",1
7,"7048",18412,11528,11412,112,116,"PACT",14
10,"10011",532,439,435,3,4,"PACT",1
5,"5067",74,61,60,0,1,"PACT",2
28,"28057",1549,1246,1239,5,7,"PACT",8
6,"6143",3370,2635,2589,23,46,"PACT",0
10,"10206",201,146,144,1,2,"PACT",0
40,"40213",95,83,80,1,3,"PACT",0
5,"5244",41,32,32,0,0,"PACT",0
28,"28064",135,110,104,1,6,"PACT",0
5,"5001",179,153,152,2,1,"PACT",0
33,"33035",11226,8326,8252,112,74,"PACT",63
40,"40057",1405,1176,1163,10,13,"PACT",3
28,"28071",64,56,54,0,2,"PACT",0
5,"5125",56,47,43,0,4,"PACT",0
7,"7016",2931,2201,2178,31,23,"PACT",4
5,"5173",59,52,52,0,0,"PACT",0
10,"10112",1518,1168,1151,4,17,"PACT",1
6,"6067",1915,1393,1370,7,23,"PACT",0
10,"10108",203,131,130,1,1,"PACT",0
7,"7045",1300,1038,1030,6,8,"PACT",4
10,"10040",434,321,314,1,7,"PACT",0
40,"40210",98,70,70,0,0,"PACT",0
33,"33006",1480,1001,992,9,9,"PACT",9
5,"5087",149,112,111,1,1,"PACT",1
28,"28021",576,387,386,3,1,"PACT",2
5,"5123",103,85,85,1,0,"PACT",0
10,"10118",281,242,242,2,0,"PACT",1
41,"41036",3917,2944,2885,27,59,"PACT",4
5,"5132",881,634,626,2,8,"PACT",0
5,"5266",102,79,78,0,1,"PACT",0
10,"10217",521,436,432,0,4,"PACT",0
28,"28039",125,103,103,2,0,"PACT",0
40,"40082",106,83,81,0,2,"PACT",0
5,"5213",95,77,75,0,2,"PACT",0
41,"41049",9493,7463,7312,78,151,"PACT",22
28,"28178",1134,949,935,1,14,"PACT",4
6,"6073",700,506,492,11,14,"PACT",1
5,"5240",3323,2389,2346,16,43,"PACT",7
28,"28040",16648,11709,11551,66,158,"PACT",56
7,"7062",7902,4889,4828,58,61,"PACT",6
40,"40014",56,44,43,2,1,"PACT",0
41,"41072",4037,3256,3221,19,35,"PACT",5
40,"40121",249,196,193,4,3,"PACT",0
40,"40087",87,70,70,0,0,"PACT",0
40,"40229",28,24,24,0,0,"PACT",0
41,"41102",14750,10972,10677,110,295,"PACT",28
6,"6140",611,515,506,1,9,"PACT",1
5,"5126",62,53,52,0,1,"PACT",0
6,"6008",613,540,532,0,8,"PACT",1
40,"40022",193,162,159,2,3,"PACT",0
33,"33066",42882,30942,30529,401,413,"PACT",243
10,"10039",402,302,301,0,1,"PACT",0
10,"10107",1030,840,828,5,12,"PACT",0
28,"28061",22564,18245,18064,117,181,"PACT",76
5,"5139",66,59,59,0,0,"PACT",0
5,"5010",145,119,118,1,1,"PACT",0
40,"40177",140,114,113,1,1,"PACT",0
7,"7042",10785,7256,7191,60,65,"PACT",12
41,"41100",967,765,727,8,38,"PACT",0
6,"6009",228,190,187,2,3,"PACT",0
6,"6031",461,316,301,1,15,"PACT",0
10,"10045",970,739,735,6,4,"PACT",0
40,"40145",1105,906,899,2,7,"PACT",2
6,"6020",1739,1420,1387,5,33,"PACT",2
5,"5234",46,43,43,0,0,"PACT",0
7,"7009",741,554,544,4,10,"PACT",0
41,"41073",1685,1172,1157,13,15,"PACT",1
6,"6138",1013,783,767,3,16,"PACT",5
10,"10014",1829,1448,1419,12,29,"PACT",1
6,"6130",186,159,154,0,5,"PACT",0
28,"28118",61,52,51,0,1,"PACT",2
41,"41091",539730,412509,408312,3804,4197,"PACT",1358
40,"40052",72,56,56,0,0,"PACT",1
6,"6077",321,260,256,4,4,"PACT",0
10,"10204",419,342,339,4,3,"PACT",0
7,"7036",27950,20870,20707,154,163,"PACT",20
28,"28171",4382,3202,3134,11,68,"PACT",5
5,"5218",105,82,81,0,1,"PACT",0
7,"7011",28642,19567,19396,147,171,"PACT",67
41,"41084",2815,2177,2111,3,66,"PACT",1
10,"10088",196,139,138,0,1,"PACT",0
10,"10142",840,641,639,5,2,"PACT",1
6,"6066",1725,1297,1286,9,11,"PACT",0
5,"5099",457,392,389,2,3,"PACT",0
10,"10138",540,422,415,3,7,"PACT",2
5,"5189",396,325,321,1,4,"PACT",0
6,"6110",137,106,105,0,1,"PACT",0
28,"28034",370,284,280,0,4,"PACT",0
10,"10048",204,156,154,0,2,"PACT",1
33,"33076",12147,8532,8452,104,80,"PACT",47
6,"6147",338,262,258,2,4,"PACT",0
28,"28106",78429,59182,58471,417,711,"PACT",436
7,"7008",6047,4570,4513,31,57,"PACT",6
10,"10025",379,328,317,3,11,"PACT",0
10,"10175",1361,1031,997,8,34,"PACT",1
40,"40071",43,37,31,0,6,"PACT",1
5,"5256",112,94,92,1,2,"PACT",0
7,"7046",16718,10573,10469,94,104,"PACT",10
33,"33009",869,595,591,5,4,"PACT",1
28,"28110",2003,1596,1571,7,25,"PACT",3
10,"10062",393,339,334,0,5,"PACT",1
40,"40231",98,80,80,2,0,"PACT",0
6,"6100",852,681,677,3,4,"PACT",0
40,"40019",29,26,26,0,0,"PACT",0
10,"10044",1404,1092,1077,7,15,"PACT",0
7,"7014",7778,4724,4669,50,55,"PACT",6
41,"41077",8631,6441,6289,46,152,"PACT",9
5,"5205",79,66,66,0,0,"PACT",0
28,"28084",16103,12519,12378,82,141,"PACT",73
40,"40174",324,254,250,2,4,"PACT",0
10,"10105",2476,1798,1760,21,38,"PACT",2
40,"40162",387,286,278,3,8,"PACT",0
28,"28121",205,166,165,1,1,"PACT",1
40,"40220",62,48,48,0,0,"PACT",0
28,"28153",795,566,564,5,2,"PACT",6
6,"6055",1998,1552,1523,9,29,"PACT",0
5,"5054",1203,946,927,5,19,"PACT",2
41,"41078",2459,1910,1895,24,15,"PACT",6
33,"33020",13000,9476,9338,108,138,"PACT",77
5,"5094",132,109,108,1,1,"PACT",0
5,"5210",79,57,57,0,0,"PACT",0
5,"5027",260,217,211,3,6,"PACT",0
6,"6903",2027,1607,1594,16,13,"PACT",0
28,"28054",11891,9476,9395,64,81,"PACT",36
28,"28074",140580,113723,112489,776,1234,"PACT",718
6,"6162",2895,2289,2254,11,35,"PACT",0
10,"10125",862,655,639,4,16,"PACT",0
5,"5215",159,126,124,0,2,"PACT",0
7,"7049",1480,1092,1075,10,17,"PACT",0
6,"6096",207,168,167,1,1,"PACT",0
41,"41041",9760,7835,7646,44,189,"PACT",13
28,"28007",126831,103108,102202,710,906,"PACT",550
40,"40180",277,231,224,3,7,"PACT",0
10,"10043",754,578,572,3,6,"PACT",1
7,"7063",1420,1139,1129,10,10,"PACT",2
41,"41086",16209,11006,10881,116,125,"PACT",34
5,"5082",495,399,394,1,5,"PACT",0
5,"5252",58,38,38,0,0,"PACT",0
5,"5238",739,589,586,1,3,"PACT",4
40,"40154",23,20,20,0,0,"PACT",0
5,"5212",197,138,136,0,2,"PACT",0
33,"33023",3271,2448,2397,35,51,"PACT",10
5,"5070",30,28,28,0,0,"PACT",1
5,"5246",52,39,39,0,0,"PACT",0
40,"40901",414,331,328,8,3,"PACT",1
28,"28038",5155,4142,4090,20,52,"PACT",27
40,"40127",35,28,28,0,0,"PACT",0
28,"28124",59,52,52,0,0,"PACT",0
41,"41015",5401,3984,3889,50,95,"PACT",9
7,"7006",5332,3769,3722,25,47,"PACT",3
5,"5163",1705,1360,1345,4,15,"PACT",3
5,"5084",69,46,46,0,0,"PACT",0
40,"40059",108,90,89,0,1,"PACT",0
6,"6072",2225,1777,1752,20,25,"PACT",1
28,"28056",914,715,703,4,12,"PACT",2
40,"40072",224,198,194,3,4,"PACT",0
5,"5151",80,64,64,1,0,"PACT",0
10,"10015",627,488,475,0,13,"PACT",1
7,"7040",288348,192799,191053,1586,1746,"PACT",345
5,"5239",231,177,174,1,3,"PACT",2
41,"41024",22737,15687,15398,167,289,"PACT",38
10,"10137",404,346,344,3,2,"PACT",1
6,"6161",288,226,222,1,4,"PACT",0
5,"5197",100,84,83,0,1,"PACT",0
5,"5077",158,133,131,1,2,"PACT",0
10,"10102",503,407,403,3,4,"PACT",0
41,"41057",253,189,188,0,1,"PACT",0
5,"5060",109,88,88,0,0,"PACT",0
41,"41066",1310,1027,1010,1,17,"PACT",0
5,"5086",76,64,61,0,3,"PACT",0
5,"5047",4118,3334,3248,25,86,"PACT",5
5,"5056",94,83,83,0,0,"PACT",0
40,"40119",166,133,132,1,1,"PACT",0
10,"10077",637,501,499,3,2,"PACT",2
5,"5029",99,69,69,0,0,"PACT",0
6,"6019",2012,1539,1495,14,44,"PACT",2
5,"5114",1264,1061,1030,3,31,"PACT",1
10,"10126",1470,1114,1104,7,10,"PACT",2
10,"10018",1630,1149,1112,12,37,"PACT",6
28,"28001",80,64,64,0,0,"PACT",0
6,"6086",1174,869,862,4,7,"PACT",5
40,"40170",1307,1066,1054,7,12,"PACT",1
6,"6075",475,379,369,2,10,"PACT",0
7,"7010",5070,3815,3777,47,38,"PACT",7
40,"40134",697,560,548,7,12,"PACT",1
40,"40099",52,46,44,0,2,"PACT",1
10,"10059",325,234,232,1,2,"PACT",0
10,"10114",962,754,737,2,17,"PACT",4
5,"5088",29,23,23,0,0,"PACT",0
7,"7065",2302,1633,1603,10,30,"PACT",1
40,"40228",494,397,391,5,6,"PACT",0
5,"5154",34,25,25,1,0,"PACT",0
6,"6032",78,65,64,0,1,"PACT",0
10,"10123",575,470,465,2,5,"PACT",0
28,"28053",6840,5797,5739,32,58,"PACT",20
10,"10073",721,553,546,4,7,"PACT",1
5,"5089",455,354,340,1,14,"PACT",1
10,"10169",494,405,395,1,10,"PACT",1
40,"40006",22,18,18,0,0,"PACT",0
40,"40905",128,101,100,4,1,"PACT",0
5,"5167",225,181,175,1,6,"PACT",0
5,"5022",1571,1295,1282,5,13,"PACT",0
6,"6051",1543,1206,1188,3,18,"PACT",1
10,"10124",858,710,701,3,9,"PACT",0
5,"5059",92,63,63,0,0,"PACT",1
10,"10056",532,434,428,3,6,"PACT",0
5,"5038",113,89,88,0,1,"PACT",0
10,"10089",1328,1014,982,20,32,"PACT",0
5,"5142",90,83,81,0,2,"PACT",0
5,"5100",267,217,212,1,5,"PACT",0
7,"7064",5528,3793,3765,23,28,"PACT",8
5,"5161",550,444,434,2,10,"PACT",2
6,"6085",3410,2719,2663,28,56,"PACT",8
5,"5208",38,31,31,0,0,"PACT",1
5,"5052",87,77,77,0,0,"PACT",0
28,"28097",125,100,100,0,0,"PACT",1
5,"5169",219,176,173,1,3,"PACT",0
10,"10171",355,261,255,0,6,"PACT",0
40,"40077",932,747,730,9,17,"PACT",1
40,"40184",248,205,203,0,2,"PACT",0
28,"28015",20440,17084,16953,103,131,"PACT",56
40,"40089",214,176,170,1,6,"PACT",1
33,"33030",873,678,671,1,7,"PACT",4
6,"6145",899,744,723,1,21,"PACT",0
28,"28055",907,671,666,5,5,"PACT",0
10,"10037",76855,60447,59702,451,745,"PACT",261
5,"5171",67,57,51,1,6,"PACT",1
6,"6079",644,492,487,3,5,"PACT",0
40,"40207",800,662,652,6,10,"PACT",2
10,"10145",125,106,104,1,2,"PACT",0
5,"5247",227,182,177,1,5,"PACT",0
5,"5013",847,708,701,0,7,"PACT",0
6,"6058",1980,1519,1493,13,26,"PACT",3
5,"5026",187,163,159,1,4,"PACT",0
6,"6091",3668,2839,2776,26,63,"PACT",4
40,"40104",284,229,224,2,5,"PACT",1
5,"5106",28,22,22,0,0,"PACT",0
40,"40033",67,57,57,1,0,"PACT",0
33,"33041",7112,5251,5194,63,57,"PACT",30
10,"10160",237,189,183,3,6,"PACT",0
28,"28140",3139,2547,2523,12,24,"PACT",18
5,"5168",3500,2774,2730,25,44,"PACT",6
10,"10904",722,549,543,7,6,"PACT",0
10,"10197",108,84,84,0,0,"PACT",1
40,"40212",27,22,20,0,2,"PACT",0
6,"6029",1183,946,935,12,11,"PACT",1
6,"6016",2943,2283,2247,24,36,"PACT",1
10,"10148",32986,23987,23589,201,398,"PACT",85
28,"28902",523,418,415,2,3,"PACT",2
33,"33052",704,520,513,5,7,"PACT",0
10,"10179",277,220,219,0,1,"PACT",0
5,"5170",50,38,38,0,0,"PACT",0
41,"41051",2311,1770,1734,5,36,"PACT",36
6,"6082",393,314,305,5,9,"PACT",0
5,"5148",23,17,17,0,0,"PACT",0
40,"40001",706,597,590,7,7,"PACT",0
5,"5015",68,48,48,1,0,"PACT",0
10,"10162",528,430,424,2,6,"PACT",1
6,"6071",238,197,193,0,4,"PACT",0
41,"41089",6629,4904,4814,48,90,"PACT",8
28,"28114",143,104,104,0,0,"PACT",1
40,"40002",34,30,30,0,0,"PACT",0
28,"28058",141251,112674,111423,778,1251,"PACT",591
28,"28156",1084,885,880,6,5,"PACT",7
28,"28146",1792,1308,1293,8,15,"PACT",0
10,"10150",331,277,272,6,5,"PACT",0
33,"33044",177352,134444,133352,1391,1092,"PACT",1096
10,"10041",1025,840,825,6,15,"PACT",1
41,"41062",2175,1763,1746,8,17,"PACT",2
40,"40143",83,73,73,2,0,"PACT",0
5,"5136",84,64,64,2,0,"PACT",0
6,"6028",4109,3613,3538,17,75,"PACT",3
10,"10205",1965,1344,1300,8,44,"PACT",1
10,"10151",198,161,157,2,4,"PACT",0
5,"5085",30,27,27,0,0,"PACT",0
5,"5152",655,537,534,3,3,"PACT",2
10,"10055",696,527,512,1,15,"PACT",0
7,"7029",4366,3270,3229,25,41,"PACT",4
40,"40025",128,109,106,1,3,"PACT",2
40,"40083",72,53,51,3,2,"PACT",0
28,"28136",680,569,563,0,6,"PACT",1
7,"7015",21976,14458,14297,205,161,"PACT",33
10,"10016",327,260,259,1,1,"PACT",0
10,"10178",729,567,559,4,8,"PACT",1
28,"28109",1622,1205,1192,3,13,"PACT",2
10,"10034",336,269,267,0,2,"PACT",0
41,"41026",4300,3561,3521,18,40,"PACT",5
40,"40037",34,19,19,0,0,"PACT",0
33,"33056",4877,3469,3420,30,49,"PACT",6
40,"40084",53,40,39,0,1,"PACT",0
33,"33001",1504,875,864,15,11,"PACT",0
40,"40221",48,42,42,0,0,"PACT",0
10,"10003",540,388,386,4,2,"PACT",0
40,"40158",15,13,13,1,0,"PACT",0
33,"33077",1118,772,761,4,11,"PACT",0
6,"6152",1285,952,935,4,17,"PACT",0
5,"5165",370,293,285,4,8,"PACT",0
40,"40051",34,33,31,0,2,"PACT",0
28,"28169",1553,1280,1273,15,7,"PACT",3
10,"10085",319,240,236,1,4,"PACT",0
5,"5257",135,104,104,0,0,"PACT",0
28,"28117",98,89,87,2,2,"PACT",2
10,"10031",164,136,135,0,1,"PACT",0
40,"40123",141,108,104,1,4,"PACT",1
5,"5190",53,47,47,1,0,"PACT",0
5,"5036",116,100,100,0,0,"PACT",0
6,"6097",2283,1803,1762,10,41,"PACT",3
28,"28062",288,243,236,0,7,"PACT",3
40,"40100",263,219,215,1,4,"PACT",0
6,"6109",3843,3228,3106,26,122,"PACT",0
41,"41046",3006,2464,2427,13,37,"PACT",4
5,"5180",82,61,60,0,1,"PACT",0
28,"28108",3642,2878,2841,16,37,"PACT",9
6,"6087",2030,1592,1571,16,21,"PACT",3
40,"40216",774,670,665,11,5,"PACT",0
40,"40063",6944,5479,5352,39,127,"PACT",9
6,"6010",1075,859,846,8,13,"PACT",2
5,"5179",199,181,175,0,6,"PACT",0
6,"6120",3373,2757,2719,10,38,"PACT",3
10,"10087",1606,1239,1223,5,16,"PACT",0
6,"6033",1269,1026,1010,4,16,"PACT",0
10,"10097",106,88,85,3,3,"PACT",0
33,"33018",2819,2072,2044,28,28,"PACT",8
28,"28003",170,148,148,1,0,"PACT",0
41,"41025",2019,1492,1439,7,53,"PACT",6
10,"10121",7914,5924,5809,36,115,"PACT",13
5,"5104",33,24,23,0,1,"PACT",0
6,"6154",2799,2075,2022,15,53,"PACT",2
5,"5260",97,81,80,1,1,"PACT",0
6,"6088",12505,9311,9140,93,171,"PACT",22
7,"7030",1590,1234,1202,8,32,"PACT",1
6,"6151",1054,791,778,2,13,"PACT",1
6,"6045",476,368,362,3,6,"PACT",1
7,"7012",1909,1358,1343,15,15,"PACT",1
10,"10035",1806,1320,1282,12,38,"PACT",4
5,"5144",66,51,51,0,0,"PACT",0
10,"10008",1291,1015,997,16,18,"PACT",3
6,"6012",3233,2515,2492,15,23,"PACT",4
10,"10103",426,330,327,0,3,"PACT",0
41,"41048",2198,1561,1512,22,49,"PACT",2
5,"5105",336,272,266,2,6,"PACT",2
40,"40150",61,53,53,1,0,"PACT",0
5,"5209",75,58,57,0,1,"PACT",0
5,"5183",123,104,96,0,8,"PACT",0
10,"10212",1645,1283,1238,7,45,"PACT",2
41,"41901",2703,2242,2201,29,41,"PACT",3
40,"40115",156,131,130,4,1,"PACT",0
28,"28088",286,193,193,2,0,"PACT",0
6,"6013",265,227,221,0,6,"PACT",0
5,"5040",64,51,51,1,0,"PACT",0
41,"41012",3368,2416,2361,23,55,"PACT",6
6,"6101",442,359,354,2,5,"PACT",0
10,"10186",944,781,758,1,23,"PACT",10
10,"10200",341,262,261,0,1,"PACT",0
5,"5159",228,160,159,2,1,"PACT",0
28,"28125",3216,2459,2444,11,15,"PACT",14
7,"7047",2371,1775,1747,13,28,"PACT",1
33,"33011",10659,6448,6332,119,116,"PACT",28
33,"33021",4361,3098,3043,31,55,"PACT",19
33,"33051",6811,4879,4809,63,70,"PACT",30
10,"10060",935,670,658,4,12,"PACT",0
6,"6092",555,428,419,3,9,"PACT",0
41,"41903",6769,5018,4919,73,99,"PACT",9
5,"5192",93,81,78,0,3,"PACT",1
10,"10029",380,320,315,1,5,"PACT",1
28,"28176",13836,11415,11326,64,89,"PACT",35
6,"6026",815,661,653,5,8,"PACT",0
40,"40106",183,153,151,2,2,"PACT",0
5,"5095",236,193,191,0,2,"PACT",1
33,"33062",388,250,245,9,5,"PACT",3
41,"41032",3843,3018,2944,17,74,"PACT",9
5,"5198",71,51,51,0,0,"PACT",0
10,"10093",393,313,303,4,10,"PACT",1
10,"10188",478,387,379,0,8,"PACT",1
40,"40093",76,68,67,0,1,"PACT",1
33,"33022",813,555,543,6,12,"PACT",1
10,"10053",279,226,224,5,2,"PACT",0
10,"10095",314,260,255,2,5,"PACT",1
5,"5251",56,39,39,0,0,"PACT",0
5,"5149",100,82,79,0,3,"PACT",1
5,"5110",706,550,546,4,4,"PACT",1
10,"10136",285,223,223,1,0,"PACT",0
10,"10013",266,203,202,2,1,"PACT",0
28,"28079",2374366,1872679,1859094,11998,13585,"PACT",8966
6,"6104",656,530,524,6,6,"PACT",0
33,"33054",1611,1145,1124,8,21,"PACT",8
40,"40047",32,25,25,0,0,"PACT",0
40,"40048",35,29,29,0,0,"PACT",0
40,"40013",56,47,47,0,0,"PACT",0
33,"33024",225188,169937,168490,1483,1447,"PACT",1431
28,"28147",990,779,769,2,10,"PACT",8
5,"5124",92,71,70,1,1,"PACT",0
33,"33004",65515,48686,48245,511,441,"PACT",388
7,"7051",5414,3610,3575,37,35,"PACT",3
6,"6094",1459,1017,1008,8,9,"PACT",0
33,"33017",2997,2096,2058,29,38,"PACT",9
28,"28050",4367,3411,3384,14,27,"PACT",9
6,"6007",1433,1078,1071,5,7,"PACT",3
5,"5227",340,237,234,0,3,"PACT",0
5,"5112",95,66,64,2,2,"PACT",0
5,"5200",40,27,26,0,1,"PACT",0
10,"10042",88,59,59,0,0,"PACT",0
40,"40179",626,540,529,2,11,"PACT",2
5,"5188",41,36,34,0,2,"PACT",0
10,"10075",236,186,182,1,4,"PACT",2
6,"6040",987,747,739,6,8,"PACT",0
10,"10111",1306,1006,994,12,12,"PACT",2
6,"6129",573,455,451,2,4,"PACT",0
10,"10030",472,323,318,1,5,"PACT",3
41,"41099",3968,2666,2642,23,24,"PACT",5
7,"7041",2097,1662,1634,20,28,"PACT",1
41,"41053",21618,16549,16150,194,399,"PACT",37
10,"10057",126,97,96,2,1,"PACT",0
10,"10098",381,310,309,1,1,"PACT",0
6,"6030",169,147,146,1,1,"PACT",0
6,"6064",850,658,647,2,11,"PACT",0
5,"5019",44838,36021,35637,287,384,"PACT",188
40,"40203",958,801,788,6,13,"PACT",6
41,"41017",15712,12048,11896,118,152,"PACT",35
33,"33037",33247,23529,23210,297,319,"PACT",161
5,"5005",171,142,142,2,0,"PACT",0
5,"5127",608,499,496,0,3,"PACT",1
41,"41016",7767,5937,5829,56,108,"PACT",23
33,"33036",11335,8356,8243,92,113,"PACT",33
10,"10099",559,412,401,3,11,"PACT",0
10,"10113",2258,1695,1657,6,38,"PACT",6
5,"5166",160,128,123,1,5,"PACT",0
10,"10058",993,739,723,4,16,"PACT",0
5,"5140",106,91,89,0,2,"PACT",0
28,"28042",1266,1020,1010,2,10,"PACT",8
40,"40225",1098,902,882,4,20,"PACT",0
5,"5128",342,274,267,1,7,"PACT",1
6,"6098",534,421,411,8,10,"PACT",0
10,"10128",5628,4238,4126,43,112,"PACT",12
40,"40171",39,29,29,1,0,"PACT",0
40,"40009",40,34,34,0,0,"PACT",0
5,"5062",166,136,133,0,3,"PACT",0
40,"40053",83,62,62,1,0,"PACT",0
7,"7044",8791,6335,6196,66,139,"PACT",6
5,"5116",96,77,75,0,2,"PACT",0
7,"7901",594,454,446,6,8,"PACT",2
28,"28181",20669,17314,17205,101,109,"PACT",62
10,"10196",294,231,231,2,0,"PACT",0
41,"41075",10279,7543,7370,96,173,"PACT",15
41,"41044",7698,5967,5898,59,69,"PACT",24
6,"6121",3268,2558,2531,26,27,"PACT",0
5,"5008",208,168,163,1,5,"PACT",0
33,"33049",6044,4152,4079,56,73,"PACT",11
6,"6122",6562,4837,4723,43,114,"PACT",7
10,"10022",412,319,316,1,3,"PACT",0
5,"5092",146,118,116,0,2,"PACT",0
5,"5233",226,198,197,0,1,"PACT",0
41,"41093",19012,15637,15525,97,112,"PACT",63
40,"40065",469,376,373,1,3,"PACT",0
10,"10198",1071,945,924,3,21,"PACT",0
10,"10144",920,731,723,4,8,"PACT",0
28,"28065",130679,106997,105975,762,1022,"PACT",716
6,"6089",608,524,519,3,5,"PACT",0
10,"10211",447,345,343,2,2,"PACT",2
6,"6133",1799,1476,1453,12,23,"PACT",0
40,"40206",162,132,128,2,4,"PACT",0
6,"6057",537,442,433,1,9,"PACT",0
40,"40055",32,26,25,0,1,"PACT",0
41,"41094",6447,4998,4912,43,86,"PACT",15
6,"6134",530,337,331,3,6,"PACT",0
6,"6035",865,678,670,4,8,"PACT",1
6,"6046",1250,1010,995,7,15,"PACT",0
10,"10023",791,619,614,1,5,"PACT",1
5,"5080",44,31,29,0,2,"PACT",0
5,"5053",80,57,57,2,0,"PACT",0
10,"10132",365,276,271,2,5,"PACT",0
28,"28164",3202,2553,2530,19,23,"PACT",17
33,"33071",563,413,407,2,6,"PACT",1
5,"5262",323,254,254,0,0,"PACT",0
6,"6139",502,429,421,5,8,"PACT",0
33,"33055",1492,1156,1121,6,35,"PACT",5
10,"10172",696,517,513,0,4,"PACT",0
6,"6113",2677,2117,2076,13,41,"PACT",6
6,"6146",1048,837,819,4,18,"PACT",0
33,"33061",350,201,200,2,1,"PACT",3
28,"28132",12068,9067,8954,63,113,"PACT",36
28,"28122",570,457,448,3,9,"PACT",3
6,"6036",4958,3785,3728,22,57,"PACT",11
41,"41028",2071,1741,1713,18,28,"PACT",58
33,"33012",5105,3601,3566,46,35,"PACT",15
28,"28017",1280,1017,1012,9,5,"PACT",9
41,"41079",9293,7137,6979,80,158,"PACT",12
10,"10012",564,469,464,1,5,"PACT",0
6,"6158",13362,10282,10112,73,170,"PACT",21
40,"40176",375,325,322,6,3,"PACT",0
6,"6025",5096,3981,3904,28,77,"PACT",9
41,"41069",29569,21075,20657,361,418,"PACT",71
5,"5042",141,117,116,0,1,"PACT",1
40,"40186",34,29,29,0,0,"PACT",0
40,"40199",101,79,78,0,1,"PACT",0
40,"40164",185,136,134,3,2,"PACT",0
28,"28048",504,399,392,6,7,"PACT",4
41,"41097",3135,2355,2308,11,47,"PACT",2
6,"6038",790,583,574,4,9,"PACT",0
41,"41080",1240,940,913,11,27,"PACT",4
10,"10135",1241,995,981,5,14,"PACT",1
28,"28166",347,287,286,1,1,"PACT",0
33,"33003",612,373,369,6,4,"PACT",2
28,"28091",5474,4027,3977,26,50,"PACT",21
33,"33074",3376,2345,2311,41,34,"PACT",6
33,"33064",250,175,174,0,1,"PACT",1
10,"10190",521,372,361,2,11,"PACT",14
6,"6005",1691,1246,1225,15,21,"PACT",0
10,"10149",434,308,304,2,4,"PACT",0
41,"41052",3027,2357,2288,14,69,"PACT",2
6,"6105",604,406,400,2,6,"PACT",3
33,"33014",8771,6425,6368,51,57,"PACT",43
6,"6149",10203,8194,8051,72,143,"PACT",13
10,"10168",320,209,202,1,7,"PACT",0
10,"10182",124,91,90,0,1,"PACT",0
10,"10096",3326,2553,2501,14,52,"PACT",10
10,"10191",523,406,398,3,8,"PACT",0
6,"6006",4494,3395,3325,24,70,"PACT",6
10,"10165",253,212,210,1,2,"PACT",1
6,"6128",4415,3345,3288,34,57,"PACT",5
40,"40109",72,59,54,1,5,"PACT",0
41,"41063",2713,1988,1944,17,44,"PACT",5
40,"40131",50,47,47,0,0,"PACT",0
28,"28020",169,110,109,0,1,"PACT",0
40,"40902",117,96,96,1,0,"PACT",0
33,"33005",1376,929,916,14,13,"PACT",3
40,"40224",19,16,16,0,0,"PACT",0
5,"5034",14,12,12,0,0,"PACT",0
6,"6118",157,125,125,1,0,"PACT",0
40,"40073",385,339,335,6,4,"PACT",0
28,"28120",1209,991,974,3,17,"PACT",3
41,"41035",1060,803,788,8,15,"PACT",2
40,"40190",48,40,39,0,1,"PACT",0
33,"33025",8996,6369,6309,81,60,"PACT",49
41,"41007",12438,9009,8775,135,234,"PACT",24
5,"5216",213,166,165,0,1,"PACT",0
10,"10166",313,211,202,0,9,"PACT",0
28,"28137",1744,1385,1366,8,19,"PACT",8
10,"10207",464,349,340,3,9,"PACT",0
28,"28087",3259,2643,2623,16,20,"PACT",8
41,"41030",500,419,410,6,9,"PACT",2
10,"10071",124,85,84,0,1,"PACT",0
33,"33027",769,505,497,14,8,"PACT",3
5,"5115",516,397,395,3,2,"PACT",4
28,"28160",8629,6922,6856,34,66,"PACT",36
5,"5075",99,79,79,1,0,"PACT",0
5,"5049",410,310,305,3,5,"PACT",3
7,"7043",3430,2465,2438,24,27,"PACT",3
10,"10019",1416,1120,1094,3,26,"PACT",1
40,"40136",106,82,81,0,1,"PACT",0
10,"10903",796,623,614,4,9,"PACT",1
10,"10009",263,196,193,2,3,"PACT",0
5,"5222",152,111,109,0,2,"PACT",0
10,"10020",1576,1259,1225,9,34,"PACT",7
10,"10033",403,306,302,6,4,"PACT",0
40,"40193",221,163,161,5,2,"PACT",0
28,"28128",445,352,352,2,0,"PACT",1
5,"5904",112,81,81,3,0,"PACT",2
5,"5232",106,87,84,1,3,"PACT",0
40,"40148",228,185,180,0,5,"PACT",0
40,"40205",229,185,180,1,5,"PACT",1
5,"5063",31,27,27,0,0,"PACT",0
41,"41056",3694,3044,3009,36,35,"PACT",2
10,"10007",630,513,507,4,6,"PACT",2
41,"41047",10411,8348,8242,84,106,"PACT",32
7,"7034",1064,906,900,6,6,"PACT",2
5,"5181",46,39,39,0,0,"PACT",0
7,"7002",6612,4721,4672,43,49,"PACT",7
40,"40198",24,20,20,0,0,"PACT",0
40,"40173",142,122,117,1,5,"PACT",0
6,"6056",454,378,376,1,2,"PACT",1
41,"41020",12992,8679,8524,117,155,"PACT",7
28,"28162",2771,2264,2243,6,21,"PACT",7
33,"33059",4403,3007,2942,42,65,"PACT",9
6,"6068",431,324,317,4,7,"PACT",0
28,"28075",5952,4797,4758,25,39,"PACT",35
28,"28004",6564,4798,4767,26,31,"PACT",13
33,"33019",2882,1981,1939,8,42,"PACT",1
6,"6061",1084,915,905,8,10,"PACT",1
5,"5057",2401,1949,1917,19,32,"PACT",2
5,"5131",95,72,71,0,1,"PACT",1
5,"5065",459,393,382,1,11,"PACT",0
10,"10036",306,240,237,2,3,"PACT",2
40,"40068",22,21,21,0,0,"PACT",0
28,"28163",429,361,345,4,16,"PACT",4
10,"10078",370,289,278,4,11,"PACT",0
10,"10104",5151,3862,3782,22,80,"PACT",3
6,"6157",397,296,292,1,4,"PACT",0
5,"5107",55,43,43,2,0,"PACT",0
5,"5025",82,70,70,0,0,"PACT",0
7,"7007",414,326,324,2,2,"PACT",0
10,"10218",1083,810,796,3,14,"PACT",1
6,"6127",2809,2285,2258,13,27,"PACT",2
40,"40094",364,284,279,1,5,"PACT",1
40,"40140",79,58,58,0,0,"PACT",0
40,"40208",720,592,585,4,7,"PACT",2
5,"5249",96,69,69,0,0,"PACT",0
10,"10120",156,110,108,0,2,"PACT",0
5,"5133",67,48,48,0,0,"PACT",0
41,"41003",2371,1801,1760,8,41,"PACT",5
28,"28090",9128,7590,7516,54,74,"PACT",55
28,"28047",42847,33561,33215,216,346,"PACT",193
33,"33032",11086,8028,7849,129,179,"PACT",60
40,"40129",164,129,128,2,1,"PACT",0
6,"6004",1549,1276,1257,6,19,"PACT",0
10,"10134",553,396,392,2,4,"PACT",1
6,"6114",127,109,108,0,1,"PACT",0
5,"5901",253,173,171,1,2,"PACT",2
5,"5185",90,71,70,0,1,"PACT",0
40,"40080",48,39,39,0,0,"PACT",0
10,"10214",217,175,175,1,0,"PACT",1
28,"28155",485,414,409,0,5,"PACT",1
28,"28133",6116,4581,4486,22,95,"PACT",13
10,"10216",1522,1195,1167,9,28,"PACT",2
33,"33073",8186,5090,5023,65,67,"PACT",25
10,"10202",588,469,459,0,10,"PACT",0
5,"5096",79,62,62,1,0,"PACT",0
5,"5074",665,571,565,2,6,"PACT",1
5,"5221",323,249,244,1,5,"PACT",0
5,"5135",398,324,320,2,4,"PACT",0
5,"5016",6354,5090,5005,40,85,"PACT",15
40,"40081",119,96,95,2,1,"PACT",0
40,"40107",92,76,74,0,2,"PACT",0
6,"6083",46489,34360,33989,270,371,"PACT",83
28,"28134",63352,51185,50776,336,409,"PACT",289
41,"41904",1792,1171,1162,16,9,"PACT",0
6,"6050",4042,3246,3163,27,83,"PACT",3
28,"28080",49801,41938,41705,248,233,"PACT",149
7,"7028",920,686,676,8,10,"PACT",0
33,"33007",1398,960,951,9,9,"PACT",2
6,"6099",1162,833,813,6,20,"PACT",1
28,"28095",1677,1310,1293,4,17,"PACT",5
28,"28161",51559,41390,40922,255,468,"PACT",268
5,"5258",107,96,96,2,0,"PACT",0
28,"28157",682,530,516,1,14,"PACT",2
40,"40003",121,91,89,1,2,"PACT",0
6,"6150",780,637,635,2,2,"PACT",2
40,"40144",18,16,16,0,0,"PACT",0
28,"28070",113,94,94,2,0,"PACT",0
41,"41098",5152,4046,3986,24,60,"PACT",11
10,"10002",359,284,279,2,5,"PACT",0
10,"10110",2224,1618,1559,5,59,"PACT",1
40,"40060",68,46,46,0,0,"PACT",0
33,"33065",1084,761,746,18,15,"PACT",1
10,"10192",767,625,614,1,11,"PACT",0
10,"10070",669,516,513,1,3,"PACT",2
7,"7031",24784,16683,16527,160,156,"PACT",22
28,"28045",35264,27864,27597,180,267,"PACT",134
40,"40043",1791,1472,1447,9,25,"PACT",2
28,"28010",10538,8708,8635,54,73,"PACT",51
40,"40191",204,166,165,1,1,"PACT",1
40,"40103",146,125,123,0,2,"PACT",1
33,"33026",8270,5540,5474,69,66,"PACT",17
10,"10140",1082,868,855,8,13,"PACT",0
5,"5229",82,67,67,1,0,"PACT",0
41,"41045",5854,4287,4200,58,87,"PACT",14
40,"40004",445,348,341,0,7,"PACT",2
33,"33060",14132,9960,9794,135,166,"PACT",75
7,"7027",22047,14986,14853,139,133,"PACT",23
10,"10090",494,364,357,6,7,"PACT",0
28,"28035",1394,1057,1043,3,14,"PACT",4
5,"5902",293,246,242,1,4,"PACT",0
10,"10181",680,548,542,2,6,"PACT",0
28,"28149",6172,5089,5038,31,51,"PACT",26
10,"10902",735,537,521,2,16,"PACT",0
33,"33047",1074,841,835,12,6,"PACT",2
40,"40075",153,128,127,0,1,"PACT",0
28,"28011",420,315,311,1,4,"PACT",2
5,"5903",138,94,92,0,2,"PACT",1
5,"5145",47,27,27,1,0,"PACT",0
40,"40044",139,105,103,2,2,"PACT",0
28,"28066",7515,6105,6039,40,66,"PACT",27
40,"40165",74,56,54,1,2,"PACT",0
5,"5033",170,146,145,0,1,"PACT",0
40,"40204",151,109,104,1,5,"PACT",0
5,"5155",46,36,36,0,0,"PACT",0
40,"40062",57,49,49,0,0,"PACT",0
40,"40159",132,101,101,0,0,"PACT",0
40,"40017",84,74,71,2,3,"PACT",0
40,"40112",2772,2255,2223,21,32,"PACT",5
28,"28063",254,203,202,2,1,"PACT",0
7,"7022",11615,8055,7934,91,121,"PACT",7
5,"5259",106,87,87,0,0,"PACT",0
40,"40041",967,773,764,9,9,"PACT",1
40,"40183",116,103,103,0,0,"PACT",0
10,"10047",937,772,760,3,12,"PACT",2
5,"5023",175,158,155,2,3,"PACT",0
5,"5263",163,121,120,0,1,"PACT",0
28,"28100",4409,3425,3382,20,43,"PACT",8
28,"28182",198,169,169,1,0,"PACT",1
40,"40054",107,91,88,0,3,"PACT",1
28,"28175",935,775,767,3,8,"PACT",6
10,"10049",3758,3167,3086,19,81,"PACT",7
6,"6111",493,374,370,2,4,"PACT",15
40,"40218",84,62,62,0,0,"PACT",0
10,"10130",1747,1352,1321,12,31,"PACT",7
5,"5039",48,47,47,0,0,"PACT",0
10,"10094",228,180,180,0,0,"PACT",1
40,"40015",24,24,24,1,0,"PACT",0
5,"5186",1558,1255,1247,9,8,"PACT",0
6,"6126",2142,1619,1594,9,25,"PACT",1
40,"40195",813,630,623,5,7,"PACT",1
28,"28111",622,492,487,1,5,"PACT",3
6,"6024",1133,963,941,5,22,"PACT",0
33,"33050",558,381,375,2,6,"PACT",0
7,"7024",7294,4213,4160,44,53,"PACT",0
41,"41058",17860,12850,12598,152,252,"PACT",40
10,"10177",1695,1358,1323,9,35,"PACT",2
10,"10133",1154,971,955,3,16,"PACT",0
7,"7050",3442,2303,2275,28,28,"PACT",1
5,"5072",94,86,85,1,1,"PACT",0
6,"6039",1807,1506,1474,13,32,"PACT",2
10,"10006",1230,1006,995,8,11,"PACT",1
10,"10046",187,154,152,0,2,"PACT",0
28,"28069",56,47,45,2,2,"PACT",2
40,"40155",3835,3165,3121,43,44,"PACT",16
6,"6124",1656,1323,1296,5,27,"PACT",1
40,"40233",396,323,320,2,3,"PACT",10
28,"28078",40,37,37,0,0,"PACT",0
7,"7059",3035,2257,2226,13,31,"PACT",4
41,"41013",4807,3480,3425,30,55,"PACT",5
7,"7004",4033,2898,2860,28,38,"PACT",4
6,"6037",1668,1137,1125,6,12,"PACT",0
41,"41022",4269,3158,3110,16,48,"PACT",2
10,"10201",179,157,156,1,1,"PACT",0
6,"6048",824,714,702,2,12,"PACT",1
5,"5236",106,77,77,0,0,"PACT",0
6,"6107",1570,1117,1106,9,11,"PACT",1
40,"40202",55,38,38,0,0,"PACT",0
10,"10065",200,149,149,0,0,"PACT",0
6,"6023",4170,3088,3045,18,43,"PACT",1
33,"33039",1641,1251,1243,6,8,"PACT",7
40,"40152",748,637,620,6,17,"PACT",5
28,"28067",4361,3548,3509,14,39,"PACT",19
7,"7037",3357,2142,2120,16,22,"PACT",7
7,"7061",9564,6678,6583,67,95,"PACT",6
5,"5225",353,300,297,2,3,"PACT",0
40,"40157",43,33,33,2,0,"PACT",0
7,"7023",3757,2777,2735,43,42,"PACT",3
40,"40113",408,339,335,6,4,"PACT",3
10,"10159",317,241,240,0,1,"PACT",1
5,"5226",65,52,52,0,0,"PACT",0
10,"10067",10245,7850,7701,80,149,"PACT",19
5,"5030",43,36,36,0,0,"PACT",1
40,"40188",83,71,71,0,0,"PACT",1
28,"28177",10722,9093,9029,64,64,"PACT",33
33,"33063",374,284,283,3,1,"PACT",0
28,"28012",918,727,711,6,16,"PACT",1
7,"7039",4970,3557,3489,36,68,"PACT",5
10,"10195",7557,5790,5691,38,99,"PACT",57
33,"33068",1047,624,620,8,4,"PACT",2
6,"6043",686,553,544,6,9,"PACT",0
5,"5058",72,52,52,0,0,"PACT",1
41,"41071",5598,3993,3915,34,78,"PACT",7
5,"5037",219,143,142,2,1,"PACT",0
10,"10209",265,184,184,2,0,"PACT",0
40,"40223",228,181,181,0,0,"PACT",6
5,"5141",95,82,82,0,0,"PACT",0
40,"40095",464,379,369,2,10,"PACT",2
5,"5201",499,414,407,2,7,"PACT",2
41,"41006",2738,1971,1945,16,26,"PACT",3
6,"6106",413,267,263,3,4,"PACT",0
5,"5254",181,155,153,0,2,"PACT",0
5,"5081",37,29,29,0,0,"PACT",0
10,"10069",785,609,596,2,13,"PACT",4
41,"41010",4573,3407,3345,27,62,"PACT",11
5,"5267",107,71,70,3,1,"PACT",0
40,"40088",268,200,200,0,0,"PACT",0
41,"41038",102179,76348,75425,819,923,"PACT",279
10,"10021",5045,3932,3840,32,92,"PACT",19
28,"28027",1200,920,906,4,14,"PACT",5
5,"5157",235,175,174,2,1,"PACT",1
5,"5064",102,83,81,2,2,"PACT",0
10,"10017",772,595,591,3,4,"PACT",0
6,"6901",2117,1686,1655,17,31,"PACT",0
28,"28041",4788,4012,3973,23,39,"PACT",17
5,"5178",345,287,283,1,4,"PACT",2
5,"5143",62,51,51,0,0,"PACT",0
5,"5043",75,62,62,0,0,"PACT",0
33,"33002",9474,6779,6662,74,117,"PACT",28
5,"5199",37,31,31,0,0,"PACT",0
10,"10063",161,141,141,1,0,"PACT",0
28,"28180",5317,4266,4222,26,44,"PACT",11
10,"10180",4168,2735,2680,18,55,"PACT",7
40,"40016",54,43,43,1,0,"PACT",2
28,"28159",594,493,491,5,2,"PACT",3
33,"33067",747,608,596,9,12,"PACT",4
28,"28076",425,354,349,3,5,"PACT",3
40,"40029",24,21,21,0,0,"PACT",0
6,"6156",1171,919,901,10,18,"PACT",7
28,"28036",2675,2135,2093,17,42,"PACT",26
10,"10163",339,275,269,0,6,"PACT",1
5,"5206",29,21,20,1,1,"PACT",0
40,"40135",269,224,221,1,3,"PACT",0
6,"6160",3019,2252,2209,10,43,"PACT",2
10,"10109",1730,1208,1181,12,27,"PACT",3
6,"6076",824,631,620,0,11,"PACT",5
41,"41002",1427,1057,1024,5,33,"PACT",0
33,"33078",126,87,85,0,2,"PACT",0
6,"6131",1063,880,874,5,6,"PACT",0
7,"7055",7897,5264,5176,47,88,"PACT",4
10,"10024",675,518,505,4,13,"PACT",4
28,"28089",3842,3087,3048,12,39,"PACT",17
5,"5253",78,62,60,0,2,"PACT",0
41,"41096",6134,4926,4845,44,81,"PACT",17
6,"6136",1510,1189,1160,7,29,"PACT",4
5,"5245",348,295,290,3,5,"PACT",2
40,"40070",148,110,107,1,3,"PACT",0
5,"5121",262,201,199,0,2,"PACT",0
28,"28006",80622,64905,64483,400,422,"PACT",323
10,"10061",1598,1126,1114,5,12,"PACT",0
41,"41088",512,383,377,1,6,"PACT",0
7,"7902",1091,776,743,10,33,"PACT",0
5,"5090",77,70,69,0,1,"PACT",0
5,"5220",363,312,308,5,4,"PACT",1
6,"6144",512,422,416,1,6,"PACT",4
28,"28183",1124,857,842,4,15,"PACT",5
41,"41023",7975,5918,5812,51,106,"PACT",14
10,"10139",95,78,77,1,1,"PACT",0
10,"10905",632,491,485,4,6,"PACT",0
5,"5024",198,142,139,2,3,"PACT",0
28,"28018",4068,3367,3344,15,23,"PACT",12
33,"33010",1724,1211,1202,15,9,"PACT",9
40,"40161",35,28,26,0,2,"PACT",0
5,"5195",206,157,157,0,0,"PACT",0
10,"10185",573,463,460,3,3,"PACT",0
5,"5235",139,106,101,0,5,"PACT",0
6,"6116",1512,1158,1144,3,14,"PACT",1
40,"40058",309,277,271,0,6,"PACT",0
41,"41034",23480,16510,16250,230,260,"PACT",43
5,"5162",75,58,58,0,0,"PACT",0
28,"28150",3187,2640,2604,20,36,"PACT",7
28,"28170",2487,1840,1810,10,30,"PACT",3
10,"10127",4706,3508,3423,23,85,"PACT",16
33,"33058",1664,1205,1176,5,29,"PACT",13
5,"5243",81,63,62,1,1,"PACT",0
40,"40201",43,39,37,0,2,"PACT",0
40,"40200",38,32,31,0,1,"PACT",1
10,"10119",574,458,455,0,3,"PACT",0
28,"28026",6703,5422,5367,21,55,"PACT",22
5,"5160",296,236,232,1,4,"PACT",0
41,"41081",29840,22819,22465,228,354,"PACT",61
33,"33045",4382,3214,3156,23,58,"PACT",10
10,"10174",171,129,127,0,2,"PACT",0
5,"5108",40,28,28,0,0,"PACT",0
33,"33072",1455,973,963,14,10,"PACT",5
6,"6060",5723,4401,4323,31,78,"PACT",3
28,"28158",678,547,540,1,7,"PACT",0
10,"10219",1212,814,806,8,8,"PACT",0
5,"5073",289,239,238,0,1,"PACT",1
5,"5211",430,364,357,6,7,"PACT",0
33,"33069",3419,2557,2533,32,24,"PACT",20
5,"5118",68,44,43,0,1,"PACT",0
28,"28152",16839,14205,14151,87,54,"PACT",38
10,"10189",2527,1958,1907,12,51,"PACT",0
10,"10116",3728,2849,2776,27,73,"PACT",4
33,"33033",9439,6565,6468,78,97,"PACT",36
28,"28179",1450,1115,1100,3,15,"PACT",5
6,"6001",659,539,534,7,5,"PACT",0
41,"41042",5849,4730,4692,20,38,"PACT",9
10,"10081",184,142,140,4,2,"PACT",0
41,"41067",7227,5367,5271,56,96,"PACT",22
10,"10027",76,66,66,0,0,"PACT",0
10,"10122",220,171,164,0,7,"PACT",1
28,"28059",4515,3573,3542,12,31,"PACT",14
5,"5044",250,189,189,1,0,"PACT",0
10,"10203",4428,3212,3152,25,60,"PACT",7
28,"28072",6088,5001,4961,23,40,"PACT",15
6,"6108",2249,1726,1684,22,42,"PACT",2
40,"40111",52,44,44,0,0,"PACT",0
6,"6153",20240,15464,15210,134,254,"PACT",62
10,"10082",1810,1495,1476,9,19,"PACT",3
40,"40222",163,143,142,1,1,"PACT",1
40,"40141",833,644,627,5,17,"PACT",2
33,"33048",136,87,87,1,0,"PACT",0
40,"40024",827,657,645,4,12,"PACT",0
5,"5007",110,81,80,2,1,"PACT",0
10,"10154",177,134,133,1,1,"PACT",0
40,"40036",502,413,406,11,7,"PACT",0
6,"6084",1065,904,890,8,14,"PACT",0
10,"10101",179,140,138,2,2,"PACT",0
40,"40069",74,65,65,0,0,"PACT",1
28,"28060",1565,1262,1247,5,15,"PACT",4
6,"6102",1019,852,842,2,10,"PACT",0
28,"28016",78,62,61,1,1,"PACT",1
5,"5261",33,26,26,0,0,"PACT",0
10,"10129",348,263,250,0,13,"PACT",0
40,"40007",68,58,58,0,0,"PACT",0
10,"10170",239,180,179,1,1,"PACT",1
5,"5046",39,37,37,0,0,"PACT",0
28,"28145",2640,2014,1987,11,27,"PACT",9
40,"40010",111,95,94,0,1,"PACT",0
33,"33029",323,172,170,2,2,"PACT",0
41,"41076",2143,1419,1403,14,16,"PACT",0
10,"10066",161,141,137,0,4,"PACT",0
10,"10901",1177,818,805,1,13,"PACT",0
40,"40149",486,383,376,3,7,"PACT",1
28,"28068",11554,9122,9022,44,100,"PACT",52
10,"10051",433,338,332,0,6,"PACT",1
41,"41039",31500,23692,23345,234,347,"PACT",76
6,"6148",957,762,746,12,16,"PACT",0
40,"40032",378,287,278,1,9,"PACT",0
28,"28173",519,417,412,4,5,"PACT",0
33,"33057",1538,1129,1097,14,32,"PACT",6
40,"40192",133,104,102,2,2,"PACT",0
40,"40086",660,570,548,3,22,"PACT",0
10,"10199",159,123,123,1,0,"PACT",0
28,"28167",8608,7086,7015,48,71,"PACT",29
5,"5187",1728,1394,1364,7,30,"PACT",9
28,"28116",759,621,618,7,3,"PACT",6
5,"5122",119,90,88,1,2,"PACT",0
28,"28123",61103,52177,51832,338,345,"PACT",395
33,"33038",2234,1669,1644,16,25,"PACT",12
10,"10176",347,266,261,2,5,"PACT",2
28,"28009",14500,11656,11564,62,92,"PACT",40
5,"5045",80,65,65,0,0,"PACT",0
40,"40185",815,624,618,4,6,"PACT",0
41,"41031",1215,866,848,3,18,"PACT",1
6,"6080",1890,1482,1467,18,15,"PACT",0
28,"28030",1815,1438,1395,10,43,"PACT",9
28,"28144",6423,5274,5222,35,52,"PACT",21
41,"41050",5180,4217,4149,34,68,"PACT",11
40,"40046",82,69,69,1,0,"PACT",0
40,"40034",75,63,62,1,1,"PACT",0
7,"7001",3628,2792,2753,18,39,"PACT",4
5,"5055",540,448,445,1,3,"PACT",0
40,"40194",39191,31175,30785,250,390,"PACT",113
40,"40172",45,37,37,0,0,"PACT",0
41,"41001",1565,1224,1213,8,11,"PACT",1
10,"10157",245,185,185,1,0,"PACT",1
28,"28172",9751,7994,7928,38,66,"PACT",42
41,"41014",2486,1939,1878,6,61,"PACT",2
40,"40138",2127,1729,1696,18,33,"PACT",2
5,"5207",645,543,540,3,3,"PACT",0
5,"5224",100,91,90,1,1,"PACT",0
6,"6034",167,115,115,1,0,"PACT",0
5,"5109",441,363,356,5,7,"PACT",3
6,"6115",1243,898,876,3,22,"PACT",2
7,"7058",2857,2258,2233,18,25,"PACT",0
33,"33040",4566,3205,3150,50,55,"PACT",19
7,"7013",7231,5372,5253,43,119,"PACT",3
41,"41005",9250,6925,6809,69,116,"PACT",19
40,"40078",151,123,122,2,1,"PACT",0
41,"41064",5611,3763,3667,47,96,"PACT",6
41,"41055",14804,10863,10720,79,143,"PACT",21
7,"7017",882,652,646,6,6,"PACT",1
5,"5048",106,98,94,1,4,"PACT",0
5,"5172",116,95,93,0,2,"PACT",0
41,"41101",6016,4524,4480,42,44,"PACT",3
28,"28138",63,49,49,0,0,"PACT",0
40,"40076",6537,5130,5012,22,118,"PACT",15
41,"41065",22550,16215,16010,189,205,"PACT",32
41,"41043",667,475,453,3,22,"PACT",1
10,"10068",711,576,556,2,20,"PACT",0
5,"5017",86,74,73,0,1,"PACT",1
41,"41087",10496,7661,7477,57,184,"PACT",17
10,"10076",793,597,585,4,12,"PACT",0
28,"28024",168,146,145,1,1,"PACT",0
6,"6078",506,415,410,1,5,"PACT",0
28,"28096",19809,15584,15392,118,192,"PACT",55
5,"5130",94,86,86,0,0,"PACT",1
41,"41059",35105,27781,27472,261,309,"PACT",122
10,"10052",166,124,123,0,1,"PACT",1
28,"28113",36716,29939,29607,224,332,"PACT",187
5,"5147",147,119,117,0,2,"PACT",1
5,"5264",57,40,38,1,2,"PACT",0
40,"40160",93,72,72,0,0,"PACT",1
10,"10184",740,607,597,5,10,"PACT",4
6,"6049",974,732,712,7,20,"PACT",2
28,"28143",77,62,62,0,0,"PACT",0
10,"10194",524,440,435,4,5,"PACT",1
41,"41033",4965,3634,3580,27,54,"PACT",11
10,"10143",141,118,113,1,5,"PACT",0
6,"6093",4345,3356,3281,18,75,"PACT",5
5,"5182",731,494,490,6,4,"PACT",2
6,"6112",383,334,334,1,0,"PACT",0
40,"40120",196,176,169,0,7,"PACT",0
28,"28049",57902,47976,47561,329,415,"PACT",318
5,"5174",65,53,52,1,1,"PACT",0
5,"5153",87,65,65,1,0,"PACT",0
7,"7035",1596,1242,1234,13,8,"PACT",1
6,"6011",24665,18486,18253,178,233,"PACT",23
5,"5051",162,135,131,0,4,"PACT",1
40,"40031",540,429,424,6,5,"PACT",1
5,"5193",180,156,156,2,0,"PACT",0
40,"40130",128,102,96,0,6,"PACT",0
40,"40234",376,307,299,2,8,"PACT",0
6,"6103",4753,3656,3598,35,58,"PACT",6
41,"41037",3192,2505,2479,15,26,"PACT",1
40,"40182",173,126,124,1,2,"PACT",0
41,"41009",1167,820,805,4,15,"PACT",0
40,"40146",238,205,202,0,3,"PACT",0
40,"40189",479,392,380,2,12,"PACT",0
28,"28025",404,314,305,3,9,"PACT",3
33,"33053",1079,738,729,6,9,"PACT",6
7,"7057",7404,5117,5028,50,89,"PACT",4
5,"5119",24,16,16,1,0,"PACT",0
5,"5164",17,12,12,0,0,"PACT",0
40,"40101",923,737,728,8,9,"PACT",5
5,"5194",132,111,111,0,0,"PACT",0
10,"10156",100,78,78,0,0,"PACT",0
28,"28119",2245,1839,1821,10,18,"PACT",10
28,"28112",154,137,137,1,0,"PACT",0
7,"7026",30991,19827,19602,161,225,"PACT",26
5,"5083",141,104,103,2,1,"PACT",0
40,"40118",47,38,37,2,1,"PACT",0
28,"28083",9665,7794,7737,56,57,"PACT",36
6,"6090",824,602,578,4,24,"PACT",2
40,"40012",238,178,175,4,3,"PACT",1
28,"28903",35344,30490,30287,201,203,"PACT",130
41,"41029",13483,10357,10199,120,158,"PACT",30
40,"40163",41,38,38,0,0,"PACT",0
5,"5035",96,78,78,0,0,"PACT",0
40,"40139",258,207,202,0,5,"PACT",2
28,"28131",13432,10500,10387,81,113,"PACT",41
28,"28008",1961,1477,1456,6,21,"PACT",4
10,"10173",558,445,439,0,6,"PACT",1
40,"40035",135,111,110,0,1,"PACT",0
41,"41070",6397,4987,4921,55,66,"PACT",19
28,"28033",4082,3172,3140,13,32,"PACT",9
10,"10005",530,407,384,3,23,"PACT",0
28,"28002",3281,2481,2455,24,26,"PACT",10
10,"10032",1596,1263,1243,5,20,"PACT",2
6,"6015",117934,87081,86114,785,967,"PACT",184
6,"6027",645,572,568,0,4,"PACT",0
5,"5061",261,214,208,0,6,"PACT",4
40,"40008",45,37,37,0,0,"PACT",0
10,"10072",835,632,625,3,7,"PACT",0
28,"28141",6246,4943,4890,44,53,"PACT",22
6,"6059",1759,1300,1285,12,15,"PACT",2
6,"6070",7686,6083,5948,44,135,"PACT",11
41,"41008",1040,840,822,4,18,"PACT",1
40,"40092",113,86,84,2,2,"PACT",1
10,"10147",1283,1038,1007,4,31,"PACT",1
10,"10091",350,293,291,1,2,"PACT",2
5,"5103",66,48,48,0,0,"PACT",0
41,"41011",15454,11892,11591,160,301,"PACT",31
28,"28037",1578,1196,1180,5,16,"PACT",3
41,"41061",2144,1763,1712,7,51,"PACT",2
41,"41040",11111,8768,8679,76,89,"PACT",24
7,"7038",2025,1581,1556,14,25,"PACT",1
28,"28165",1910,1443,1430,11,13,"PACT",2
33,"33031",33854,23523,23143,307,380,"PACT",157
5,"5265",79,59,59,0,0,"PACT",1
10,"10187",430,316,311,0,5,"PACT",1
21,"21006",3329,2307,2262,20,45,"PCOE",7
41,"41090",3507,2766,2694,15,72,"PCOE",2
41,"41010",4573,3407,3345,27,62,"PCOE",7
19,"19007",435,328,319,1,9,"PCOE",1
40,"40208",720,592,585,4,7,"PCOE",1
15,"15014",3836,2739,2698,38,41,"PCOE",6
14,"14012",6076,4579,4489,38,90,"PCOE",24
40,"40113",408,339,335,6,4,"PCOE",0
21,"21069",1667,1214,1198,13,16,"PCOE",5
30,"30036",15256,10884,10703,56,181,"PCOE",12
41,"41054",713,596,588,4,8,"PCOE",0
14,"14014",2509,2071,2030,7,41,"PCOE",8
19,"19267",21,17,17,1,0,"PCOE",0
21,"21018",1719,1167,1139,9,28,"PCOE",3
30,"30003",25046,17860,17668,99,192,"PCOE",23
40,"40174",324,254,250,2,4,"PCOE",0
40,"40202",55,38,38,0,0,"PCOE",0
15,"15083",1036,784,768,7,16,"PCOE",2
40,"40210",98,70,70,0,0,"PCOE",0
30,"30005",30193,22648,22419,136,229,"PCOE",56
19,"19333",105,74,73,1,1,"PCOE",1
40,"40025",128,109,106,1,3,"PCOE",0
14,"14060",3694,2878,2798,26,80,"PCOE",10
40,"40162",387,286,278,3,8,"PCOE",0
14,"14067",3870,3057,2998,24,59,"PCOE",9
30,"30037",19254,14416,14217,67,199,"PCOE",23
19,"19113",446,352,342,3,10,"PCOE",0
19,"19110",56,47,47,0,0,"PCOE",1
14,"14038",32692,24015,23679,213,336,"PCOE",53
41,"41021",21397,15585,15334,201,251,"PCOE",22
15,"15011",15481,11249,11037,105,212,"PCOE",47
30,"30031",500,435,433,3,2,"PCOE",1
19,"19098",18,18,17,0,1,"PCOE",0
19,"19235",98,82,81,0,1,"PCOE",0
14,"14008",2785,1942,1910,15,32,"PCOE",4
19,"19290",851,581,577,5,4,"PCOE",3
41,"41032",3843,3018,2944,17,74,"PCOE",2
14,"14036",3676,2850,2766,40,84,"PCOE",9
19,"19327",397,333,332,0,1,"PCOE",0
41,"41057",253,189,188,0,1,"PCOE",0
15,"15071",7805,5476,5401,62,75,"PCOE",19
30,"30027",49767,39111,38724,245,387,"PCOE",51
40,"40188",83,71,71,0,0,"PCOE",0
40,"40142",52,42,40,0,2,"PCOE",0
19,"19238",44,30,30,1,0,"PCOE",0
40,"40073",385,339,335,6,4,"PCOE",0
40,"40010",111,95,94,0,1,"PCOE",0
19,"19102",92,80,80,0,0,"PCOE",0
40,"40099",52,46,44,0,2,"PCOE",0
15,"15008",5631,4320,4267,64,53,"PCOE",9
40,"40177",140,114,113,1,1,"PCOE",0
19,"19061",53,45,45,0,0,"PCOE",0
14,"14029",4029,3089,3039,15,50,"PCOE",9
19,"19251",39,31,31,0,0,"PCOE",0
40,"40104",284,229,224,2,5,"PCOE",0
15,"15901",3359,2237,2205,35,32,"PCOE",5
40,"40059",108,90,89,0,1,"PCOE",0
40,"40228",494,397,391,5,6,"PCOE",0
14,"14057",6139,5054,4964,51,90,"PCOE",16
19,"19217",42,38,38,0,0,"PCOE",0
19,"19157",56,40,37,0,3,"PCOE",0
40,"40122",525,442,434,2,8,"PCOE",1
19,"19237",40,33,33,0,0,"PCOE",0
19,"19187",42,36,36,0,0,"PCOE",1
40,"40165",74,56,54,1,2,"PCOE",0
19,"19322",26,21,21,1,0,"PCOE",0
41,"41049",9493,7463,7312,78,151,"PCOE",11
21,"21013",10570,7195,7089,73,106,"PCOE",28
40,"40063",6944,5479,5352,39,127,"PCOE",15
41,"41007",12438,9009,8775,135,234,"PCOE",23
19,"19245",1145,904,880,8,24,"PCOE",0
41,"41053",21618,16549,16150,194,399,"PCOE",15
19,"19249",28,28,28,0,0,"PCOE",0
40,"40115",156,131,130,4,1,"PCOE",1
19,"19282",143,114,114,1,0,"PCOE",0
21,"21009",835,575,557,0,18,"PCOE",8
21,"21035",9726,6628,6520,78,108,"PCOE",9
40,"40080",48,39,39,0,0,"PCOE",0
14,"14064",300,231,227,6,4,"PCOE",0
19,"19091",23,19,19,0,0,"PCOE",0
19,"19270",25,21,21,0,0,"PCOE",0
21,"21027",50,40,39,0,1,"PCOE",0
19,"19319",4583,3640,3585,24,55,"PCOE",7
19,"19147",45,36,36,0,0,"PCOE",0
15,"15076",2514,1709,1683,19,26,"PCOE",2
41,"41084",2815,2177,2111,3,66,"PCOE",2
21,"21038",1076,786,771,8,15,"PCOE",2
40,"40071",43,37,31,0,6,"PCOE",0
21,"21072",10227,7947,7739,98,208,"PCOE",28
19,"19097",14,13,13,0,0,"PCOE",0
19,"19099",289,217,214,0,3,"PCOE",0
40,"40199",101,79,78,0,1,"PCOE",0
19,"19185",27,19,19,0,0,"PCOE",0
41,"41017",15712,12048,11896,118,152,"PCOE",7
19,"19039",59,56,55,1,1,"PCOE",0
14,"14050",2352,1840,1801,11,39,"PCOE",3
30,"30025",5001,3951,3898,27,53,"PCOE",3
40,"40091",108,93,93,1,0,"PCOE",0
19,"19248",76,56,56,0,0,"PCOE",0
30,"30013",7467,5621,5553,26,68,"PCOE",9
40,"40030",428,357,350,3,7,"PCOE",0
19,"19227",73,55,53,0,2,"PCOE",0
41,"41003",2371,1801,1760,8,41,"PCOE",0
41,"41055",14804,10863,10720,79,143,"PCOE",9
15,"15080",1640,1177,1150,9,27,"PCOE",3
11,"11040",398,348,342,4,6,"PCOE",1
40,"40021",19,18,18,0,0,"PCOE",0
19,"19161",211,165,163,2,2,"PCOE",0
15,"15040",2675,2011,1979,20,32,"PCOE",3
14,"14039",2575,2037,1990,14,47,"PCOE",3
19,"19122",81,64,64,1,0,"PCOE",2
15,"15072",9436,6962,6860,60,102,"PCOE",16
41,"41012",3368,2416,2361,23,55,"PCOE",2
21,"21063",2620,2037,1992,11,45,"PCOE",3
15,"15081",982,755,741,11,14,"PCOE",0
40,"40097",125,96,95,1,1,"PCOE",0
14,"14017",10945,8514,8386,90,128,"PCOE",14
21,"21033",561,428,427,4,1,"PCOE",1
40,"40168",28,22,22,0,0,"PCOE",1
19,"19277",16,13,13,0,0,"PCOE",0
19,"19265",135,107,107,1,0,"PCOE",0
14,"14016",1283,1005,994,4,11,"PCOE",0
21,"21059",220,184,180,0,4,"PCOE",0
19,"19163",60,46,44,0,2,"PCOE",1
21,"21060",12235,8053,7929,93,124,"PCOE",32
40,"40053",83,62,62,1,0,"PCOE",0
11,"11037",5644,4567,4433,34,134,"PCOE",19
19,"19148",42,35,33,0,2,"PCOE",0
19,"19016",57,40,40,0,0,"PCOE",0
21,"21047",1869,1242,1206,8,36,"PCOE",6
19,"19242",77,67,67,0,0,"PCOE",0
41,"41046",3006,2464,2427,13,37,"PCOE",2
40,"40207",800,662,652,6,10,"PCOE",3
19,"19326",2343,1789,1768,9,21,"PCOE",4
30,"30014",1585,1226,1202,3,24,"PCOE",2
19,"19307",26,23,23,0,0,"PCOE",0
21,"21073",1891,1191,1156,17,35,"PCOE",5
11,"11006",24522,16656,16392,220,264,"PCOE",28
19,"19151",1083,785,770,5,15,"PCOE",3
40,"40041",967,773,764,9,9,"PCOE",3
41,"41025",2019,1492,1439,7,53,"PCOE",1
41,"41070",6397,4987,4921,55,66,"PCOE",4
41,"41047",10411,8348,8242,84,106,"PCOE",6
40,"40127",35,28,28,0,0,"PCOE",0
19,"19240",51,42,41,1,1,"PCOE",0
41,"41043",667,475,453,3,22,"PCOE",0
19,"19104",18,16,16,0,0,"PCOE",0
21,"21074",2698,1979,1945,15,34,"PCOE",8
40,"40108",110,91,90,0,1,"PCOE",0
40,"40179",626,540,529,2,11,"PCOE",2
19,"19196",90,77,70,1,7,"PCOE",0
11,"11020",166423,117732,116448,1427,1284,"PCOE",370
40,"40056",32,21,21,0,0,"PCOE",0
15,"15091",1103,773,758,16,15,"PCOE",2
14,"14021",260397,195951,193914,2025,2037,"PCOE",510
40,"40180",277,231,224,3,7,"PCOE",0
40,"40118",47,38,37,2,1,"PCOE",0
15,"15093",4048,2761,2720,41,41,"PCOE",8
19,"19080",65,51,51,0,0,"PCOE",0
19,"19330",67,60,60,0,0,"PCOE",0
40,"40074",245,219,214,5,5,"PCOE",0
14,"14070",1284,988,969,5,19,"PCOE",1
19,"19088",95,82,82,2,0,"PCOE",0
40,"40132",46,32,31,1,1,"PCOE",1
41,"41042",5849,4730,4692,20,38,"PCOE",3
30,"30029",12055,9003,8882,58,121,"PCOE",5
14,"14028",307,258,257,0,1,"PCOE",0
40,"40028",105,96,96,1,0,"PCOE",0
21,"21020",353,242,236,3,6,"PCOE",0
19,"19184",62,45,45,0,0,"PCOE",0
40,"40100",263,219,215,1,4,"PCOE",1
21,"21064",6641,4689,4597,66,92,"PCOE",7
21,"21052",4429,2951,2891,19,60,"PCOE",17
19,"19132",93,72,72,0,0,"PCOE",0
40,"40203",958,801,788,6,13,"PCOE",1
14,"14007",15042,10970,10758,86,212,"PCOE",31
21,"21028",370,300,293,1,7,"PCOE",0
40,"40040",2495,1913,1895,20,18,"PCOE",3
41,"41008",1040,840,822,4,18,"PCOE",1
40,"40178",90,63,63,1,0,"PCOE",0
40,"40149",486,383,376,3,7,"PCOE",0
19,"19055",44,34,34,1,0,"PCOE",0
40,"40204",151,109,104,1,5,"PCOE",0
11,"11011",1736,1285,1249,7,36,"PCOE",5
40,"40159",132,101,101,0,0,"PCOE",0
19,"19138",223,176,172,4,4,"PCOE",0
40,"40087",87,70,70,0,0,"PCOE",0
19,"19230",548,437,430,1,7,"PCOE",2
14,"14001",3443,2724,2675,24,49,"PCOE",5
15,"15078",78678,60510,59882,621,628,"PCOE",149
15,"15015",2883,2079,2049,21,30,"PCOE",3
30,"30023",3875,3107,3068,20,39,"PCOE",3
19,"19021",976,744,724,5,20,"PCOE",1
14,"14004",1981,1522,1509,8,13,"PCOE",4
21,"21045",227,181,178,1,3,"PCOE",0
11,"11032",54469,33144,32810,461,334,"PCOE",127
30,"30033",10363,8115,7979,54,136,"PCOE",11
19,"19153",22,22,22,0,0,"PCOE",0
40,"40037",34,19,19,0,0,"PCOE",0
21,"21075",335,256,249,0,7,"PCOE",0
40,"40043",1791,1472,1447,9,25,"PCOE",1
19,"19143",1754,1422,1402,11,20,"PCOE",1
40,"40172",45,37,37,0,0,"PCOE",1
40,"40173",142,122,117,1,5,"PCOE",1
41,"41099",3968,2666,2642,23,24,"PCOE",3
41,"41004",57465,41004,40321,571,683,"PCOE",60
21,"21066",495,401,396,4,5,"PCOE",0
40,"40903",77,63,62,0,1,"PCOE",0
14,"14072",999,763,754,4,9,"PCOE",1
40,"40062",57,49,49,0,0,"PCOE",0
30,"30021",9441,6664,6591,32,73,"PCOE",13
19,"19040",57,40,40,0,0,"PCOE",1
19,"19189",115,93,92,0,1,"PCOE",0
19,"19136",12,12,12,0,0,"PCOE",1
40,"40078",151,123,122,2,1,"PCOE",1
40,"40158",15,13,13,1,0,"PCOE",0
19,"19202",17,13,13,0,0,"PCOE",0
40,"40008",45,37,37,0,0,"PCOE",0
14,"14054",13796,11042,10799,102,243,"PCOE",26
40,"40196",32,28,28,1,0,"PCOE",0
19,"19191",13,12,12,0,0,"PCOE",0
19,"19064",64,56,56,0,0,"PCOE",0
40,"40193",221,163,161,5,2,"PCOE",1
40,"40105",44,39,38,0,1,"PCOE",0
15,"15018",1087,771,761,8,10,"PCOE",1
41,"41040",11111,8768,8679,76,89,"PCOE",6
19,"19146",46,41,41,1,0,"PCOE",0
15,"15029",5403,3682,3622,62,60,"PCOE",11
19,"19264",34,28,28,0,0,"PCOE",0
40,"40079",226,179,175,1,4,"PCOE",2
19,"19010",9,10,10,0,0,"PCOE",1
41,"41031",1215,866,848,3,18,"PCOE",2
19,"19329",59,49,49,0,0,"PCOE",0
19,"19127",90,63,63,0,0,"PCOE",0
40,"40045",120,92,92,1,0,"PCOE",0
40,"40026",113,106,105,2,1,"PCOE",1
19,"19301",37,31,31,0,0,"PCOE",0
14,"14026",2014,1502,1474,10,28,"PCOE",1
19,"19173",51,47,47,0,0,"PCOE",0
41,"41088",512,383,377,1,6,"PCOE",0
14,"14046",4443,3550,3486,38,64,"PCOE",10
14,"14015",2067,1575,1551,16,24,"PCOE",6
14,"14901",915,795,782,8,13,"PCOE",2
40,"40046",82,69,69,1,0,"PCOE",0
19,"19281",18,17,17,3,0,"PCOE",0
21,"21051",221,180,177,1,3,"PCOE",1
30,"30020",6431,4991,4940,19,51,"PCOE",7
40,"40229",28,24,24,0,0,"PCOE",0
11,"11022",48682,28113,27794,294,319,"PCOE",102
15,"15055",4485,3097,3057,39,40,"PCOE",6
21,"21032",1801,1401,1378,8,23,"PCOE",5
30,"30018",8326,6544,6438,25,106,"PCOE",10
40,"40094",364,284,279,1,5,"PCOE",2
40,"40068",22,21,21,0,0,"PCOE",0
40,"40024",827,657,645,4,12,"PCOE",1
14,"14074",2237,1859,1839,8,20,"PCOE",1
11,"11018",1446,1126,1100,6,26,"PCOE",3
15,"15074",3919,2865,2808,33,57,"PCOE",7
19,"19166",152,125,122,0,3,"PCOE",1
15,"15059",10255,7423,7262,122,161,"PCOE",33
19,"19332",85,70,70,1,0,"PCOE",0
41,"41094",6447,4998,4912,43,86,"PCOE",3
19,"19049",9,8,8,0,0,"PCOE",0
19,"19254",43,36,36,0,0,"PCOE",0
40,"40014",56,44,43,2,1,"PCOE",0
19,"19066",50,43,43,0,0,"PCOE",0
15,"15053",7548,5364,5309,44,55,"PCOE",13
40,"40223",228,181,181,0,0,"PCOE",1
19,"19212",674,528,519,2,9,"PCOE",0
19,"19050",15,13,13,0,0,"PCOE",0
21,"21001",610,480,461,3,19,"PCOE",3
30,"30019",25846,18755,18517,172,238,"PCOE",31
40,"40015",24,24,24,1,0,"PCOE",0
14,"14049",16282,12515,12301,121,214,"PCOE",40
21,"21042",15579,8742,8579,138,163,"PCOE",34
40,"40077",932,747,730,9,17,"PCOE",0
19,"19017",57,50,49,0,1,"PCOE",0
40,"40034",75,63,62,1,1,"PCOE",0
15,"15002",24007,18075,17857,216,218,"PCOE",45
40,"40191",204,166,165,1,1,"PCOE",1
14,"14059",687,571,563,7,8,"PCOE",0
19,"19038",22,19,19,0,0,"PCOE",1
40,"40145",1105,906,899,2,7,"PCOE",1
40,"40213",95,83,80,1,3,"PCOE",0
40,"40901",414,331,328,8,3,"PCOE",2
40,"40047",32,25,25,0,0,"PCOE",0
30,"30007",6484,4774,4727,25,47,"PCOE",9
19,"19130",61365,49363,48747,383,616,"PCOE",96
19,"19266",229,194,192,1,2,"PCOE",0
19,"19004",59,52,52,0,0,"PCOE",0
40,"40039",180,147,144,1,3,"PCOE",1
15,"15087",5692,3883,3838,53,45,"PCOE",15
15,"15062",5652,3803,3728,25,75,"PCOE",12
30,"30041",13970,9796,9682,80,114,"PCOE",21
15,"15004",4873,3689,3623,31,66,"PCOE",13
19,"19321",34,29,29,0,0,"PCOE",1
19,"19901",36,32,32,0,0,"PCOE",0
19,"19107",315,273,270,2,3,"PCOE",0
19,"19258",84,69,66,1,3,"PCOE",1
19,"19103",251,218,216,1,2,"PCOE",1
11,"11027",68637,48919,48441,519,478,"PCOE",189
15,"15021",5244,3884,3806,70,78,"PCOE",9
14,"14061",688,567,556,2,11,"PCOE",1
11,"11035",13715,9510,9385,128,125,"PCOE",28
19,"19272",65,58,56,1,2,"PCOE",0
14,"14011",572,498,495,5,3,"PCOE",0
19,"19200",64,56,56,0,0,"PCOE",0
19,"19231",10,7,7,0,0,"PCOE",0
41,"41028",2071,1741,1713,18,28,"PCOE",2
19,"19323",34,29,29,0,0,"PCOE",0
41,"41056",3694,3044,3009,36,35,"PCOE",1
15,"15037",4031,2700,2677,13,23,"PCOE",9
11,"11024",6583,4774,4682,40,92,"PCOE",22
15,"15057",12051,8814,8660,89,154,"PCOE",20
19,"19318",23,18,18,0,0,"PCOE",0
19,"19183",71,61,59,0,2,"PCOE",0
19,"19022",571,443,434,7,9,"PCOE",0
19,"19018",141,112,110,0,2,"PCOE",0
40,"40230",95,70,67,0,3,"PCOE",0
14,"14022",3886,3080,3043,18,37,"PCOE",4
21,"21055",7218,5328,5215,41,113,"PCOE",13
40,"40218",84,62,62,0,0,"PCOE",0
14,"14002",10859,8215,8078,93,137,"PCOE",10
41,"41901",2703,2242,2201,29,41,"PCOE",1
40,"40005",25,21,21,0,0,"PCOE",0
11,"11042",1155,870,852,7,18,"PCOE",0
40,"40150",61,53,53,1,0,"PCOE",0
19,"19243",36,32,31,0,1,"PCOE",0
19,"19096",101,81,79,1,2,"PCOE",1
11,"11014",17141,11836,11705,214,131,"PCOE",50
21,"21061",5089,3358,3290,42,68,"PCOE",19
41,"41027",3966,2830,2784,32,46,"PCOE",5
21,"21902",1144,829,824,9,5,"PCOE",4
19,"19125",40,28,28,0,0,"PCOE",0
40,"40020",155,125,119,4,6,"PCOE",0
19,"19076",19,18,18,0,0,"PCOE",0
15,"15032",3413,2487,2414,28,73,"PCOE",11
41,"41011",15454,11892,11591,160,301,"PCOE",20
40,"40151",43,32,32,0,0,"PCOE",0
30,"30902",8225,5797,5715,22,82,"PCOE",17
19,"19308",60,57,57,1,0,"PCOE",0
19,"19145",41,38,38,0,0,"PCOE",0
40,"40219",565,451,432,2,19,"PCOE",0
19,"19078",50,38,37,0,1,"PCOE",0
40,"40033",67,57,57,1,0,"PCOE",0
40,"40140",79,58,58,0,0,"PCOE",1
14,"14055",18446,13919,13711,148,208,"PCOE",20
21,"21021",12469,8238,8097,76,141,"PCOE",19
21,"21057",995,631,629,3,2,"PCOE",4
11,"11039",9945,6824,6726,111,98,"PCOE",28
41,"41059",35105,27781,27472,261,309,"PCOE",28
19,"19280",3611,2805,2767,25,38,"PCOE",9
15,"15082",15381,11803,11642,133,161,"PCOE",18
14,"14062",963,753,745,4,8,"PCOE",1
19,"19305",135,104,103,3,1,"PCOE",0
40,"40166",253,214,213,1,1,"PCOE",0
21,"21079",687,503,500,5,3,"PCOE",1
11,"11005",4520,3212,3128,23,84,"PCOE",9
40,"40221",48,42,42,0,0,"PCOE",0
21,"21022",186,132,129,0,3,"PCOE",0
41,"41079",9293,7137,6979,80,158,"PCOE",7
40,"40001",706,597,590,7,7,"PCOE",0
19,"19223",101,66,66,1,0,"PCOE",0
15,"15031",23779,17963,17787,213,176,"PCOE",51
40,"40164",185,136,134,3,2,"PCOE",0
15,"15066",4008,2931,2886,30,45,"PCOE",9
40,"40081",119,96,95,2,1,"PCOE",0
40,"40106",183,153,151,2,2,"PCOE",1
19,"19013",114,99,99,0,0,"PCOE",1
40,"40120",196,176,169,0,7,"PCOE",1
21,"21068",962,562,550,14,12,"PCOE",1
14,"14003",1258,989,968,12,21,"PCOE",2
15,"15010",1819,1194,1181,16,13,"PCOE",4
19,"19116",12,9,9,1,0,"PCOE",0
41,"41097",3135,2355,2308,11,47,"PCOE",2
21,"21024",466,355,341,4,14,"PCOE",0
19,"19303",40,35,35,0,0,"PCOE",0
40,"40082",106,83,81,0,2,"PCOE",2
19,"19179",76,66,64,1,2,"PCOE",0
19,"19194",94,76,76,0,0,"PCOE",0
19,"19086",1392,1095,1083,7,12,"PCOE",2
41,"41034",23480,16510,16250,230,260,"PCOE",20
14,"14037",3182,2388,2319,22,69,"PCOE",6
30,"30009",12689,10036,9909,50,127,"PCOE",17
19,"19182",39,32,32,0,0,"PCOE",0
19,"19181",55,47,46,1,1,"PCOE",0
19,"19299",102,78,78,1,0,"PCOE",1
19,"19152",550,413,405,3,8,"PCOE",0
15,"15022",5574,3846,3798,41,48,"PCOE",12
19,"19001",41,33,33,0,0,"PCOE",0
15,"15033",2422,1887,1866,13,21,"PCOE",6
40,"40109",72,59,54,1,5,"PCOE",0
11,"11008",17840,12434,12236,181,198,"PCOE",27
41,"41062",2175,1763,1746,8,17,"PCOE",0
41,"41063",2713,1988,1944,17,44,"PCOE",6
19,"19274",950,753,741,7,12,"PCOE",2
15,"15085",3220,2284,2239,23,45,"PCOE",3
15,"15054",31802,22002,21676,368,326,"PCOE",41
19,"19197",27,22,22,0,0,"PCOE",0
19,"19334",44,37,37,0,0,"PCOE",0
21,"21002",15922,11918,11773,119,145,"PCOE",21
41,"41045",5854,4287,4200,58,87,"PCOE",11
41,"41035",1060,803,788,8,15,"PCOE",0
40,"40157",43,33,33,2,0,"PCOE",0
21,"21011",3473,2543,2513,14,30,"PCOE",18
19,"19214",72,56,55,0,1,"PCOE",0
41,"41082",3359,2760,2718,11,42,"PCOE",2
40,"40146",238,205,202,0,3,"PCOE",0
14,"14009",2669,1863,1844,19,19,"PCOE",2
41,"41064",5611,3763,3667,47,96,"PCOE",9
30,"30008",14450,10832,10675,60,157,"PCOE",25
21,"21016",993,770,744,6,26,"PCOE",13
11,"11010",6351,4472,4385,140,87,"PCOE",14
41,"41083",1128,865,859,6,6,"PCOE",1
40,"40134",697,560,548,7,12,"PCOE",1
41,"41093",19012,15637,15525,97,112,"PCOE",15
19,"19120",108,90,90,1,0,"PCOE",0
40,"40181",4166,3405,3337,21,68,"PCOE",9
15,"15067",7953,6004,5925,51,79,"PCOE",8
15,"15068",4849,3435,3392,55,43,"PCOE",11
41,"41092",7679,5668,5568,61,100,"PCOE",8
19,"19073",16,13,13,0,0,"PCOE",0
21,"21065",255,178,173,2,5,"PCOE",0
40,"40182",173,126,124,1,2,"PCOE",0
40,"40148",228,185,180,0,5,"PCOE",1
15,"15077",8155,5554,5433,59,121,"PCOE",14
19,"19199",19,17,16,0,1,"PCOE",0
21,"21078",2646,1926,1895,14,31,"PCOE",20
40,"40101",923,737,728,8,9,"PCOE",2
19,"19186",78,67,67,0,0,"PCOE",0
14,"14052",9080,5999,5909,63,90,"PCOE",9
40,"40088",268,200,200,0,0,"PCOE",0
19,"19074",65,60,60,0,0,"PCOE",0
30,"30012",9069,7397,7266,53,131,"PCOE",6
41,"41006",2738,1971,1945,16,26,"PCOE",1
40,"40076",6537,5130,5012,22,118,"PCOE",6
40,"40065",469,376,373,1,3,"PCOE",0
19,"19006",757,556,548,7,8,"PCOE",2
41,"41019",4895,3518,3462,36,56,"PCOE",7
11,"11012",97629,73036,72347,715,689,"PCOE",199
41,"41048",2198,1561,1512,22,49,"PCOE",1
21,"21043",1857,1465,1424,7,41,"PCOE",7
19,"19095",11,10,10,1,0,"PCOE",0
14,"14063",1000,767,757,4,10,"PCOE",0
19,"19003",29,28,28,2,0,"PCOE",0
19,"19042",21,19,18,1,1,"PCOE",0
19,"19174",91,69,69,0,0,"PCOE",0
14,"14073",2772,2124,2069,18,55,"PCOE",2
21,"21056",2922,2307,2228,27,79,"PCOE",8
15,"15049",1091,805,796,8,9,"PCOE",1
19,"19233",82,72,72,1,0,"PCOE",0
41,"41077",8631,6441,6289,46,152,"PCOE",10
15,"15070",8797,6312,6173,108,139,"PCOE",14
19,"19058",7375,6122,6061,34,61,"PCOE",13
19,"19203",29,25,25,0,0,"PCOE",0
41,"41904",1792,1171,1162,16,9,"PCOE",0
19,"19311",87,71,71,2,0,"PCOE",0
41,"41005",9250,6925,6809,69,116,"PCOE",13
30,"30015",19372,14430,14283,91,147,"PCOE",24
30,"30035",19268,14248,14103,92,145,"PCOE",32
40,"40044",139,105,103,2,2,"PCOE",1
21,"21008",2613,1803,1777,6,26,"PCOE",3
40,"40128",122,95,93,2,2,"PCOE",1
40,"40212",27,22,20,0,2,"PCOE",0
19,"19045",127,107,107,1,0,"PCOE",0
19,"19204",149,112,112,1,0,"PCOE",0
19,"19234",45,32,32,0,0,"PCOE",0
19,"19027",131,98,96,0,2,"PCOE",0
19,"19263",22,13,12,0,1,"PCOE",0
40,"40185",815,624,618,4,6,"PCOE",0
14,"14025",2857,2482,2436,14,46,"PCOE",5
40,"40234",376,307,299,2,8,"PCOE",2
40,"40070",148,110,107,1,3,"PCOE",0
21,"21071",211,155,152,3,3,"PCOE",0
19,"19041",167,133,129,1,4,"PCOE",0
30,"30026",16252,11142,10977,65,165,"PCOE",21
40,"40141",833,644,627,5,17,"PCOE",1
11,"11017",3194,2265,2221,38,44,"PCOE",11
19,"19081",27,19,19,0,0,"PCOE",0
41,"41060",15100,11304,11105,113,199,"PCOE",9
14,"14066",5756,4396,4310,36,86,"PCOE",24
19,"19011",236,181,181,0,0,"PCOE",0
40,"40220",62,48,48,0,0,"PCOE",0
40,"40022",193,162,159,2,3,"PCOE",1
19,"19119",75,68,66,2,2,"PCOE",0
11,"11041",9858,6916,6763,70,153,"PCOE",34
41,"41023",7975,5918,5812,51,106,"PCOE",6
41,"41096",6134,4926,4845,44,81,"PCOE",12
19,"19129",27,25,25,0,0,"PCOE",0
15,"15073",21760,14900,14630,181,270,"PCOE",39
19,"19193",23,20,20,0,0,"PCOE",0
15,"15020",3593,2491,2469,18,22,"PCOE",10
19,"19252",60,49,47,0,2,"PCOE",0
19,"19082",99,76,75,0,1,"PCOE",0
21,"21012",286,238,233,4,5,"PCOE",0
40,"40016",54,43,43,1,0,"PCOE",0
40,"40904",341,302,300,4,2,"PCOE",0
19,"19048",19,13,13,0,0,"PCOE",0
19,"19150",126,102,100,0,2,"PCOE",0
14,"14040",3755,3047,3006,21,41,"PCOE",14
19,"19239",91,64,63,1,1,"PCOE",0
41,"41015",5401,3984,3889,50,95,"PCOE",1
40,"40036",502,413,406,11,7,"PCOE",1
40,"40215",83,69,69,0,0,"PCOE",0
19,"19300",788,664,652,2,12,"PCOE",3
15,"15064",2127,1608,1577,29,31,"PCOE",6
19,"19317",127,98,97,0,1,"PCOE",0
40,"40003",121,91,89,1,2,"PCOE",0
19,"19195",37,29,28,2,1,"PCOE",0
40,"40131",50,47,47,0,0,"PCOE",0
40,"40144",18,16,16,0,0,"PCOE",0
40,"40121",249,196,193,4,3,"PCOE",0
21,"21037",459,363,357,4,6,"PCOE",0
40,"40156",281,223,222,1,1,"PCOE",0
19,"19037",132,114,112,0,2,"PCOE",0
15,"15065",7151,5281,5165,63,116,"PCOE",16
19,"19255",72,51,51,0,0,"PCOE",0
21,"21050",12522,8425,8312,84,113,"PCOE",21
14,"14018",3611,2802,2741,25,61,"PCOE",4
19,"19269",94,75,75,0,0,"PCOE",0
21,"21014",4065,3192,3148,22,44,"PCOE",9
15,"15013",6299,4549,4486,45,63,"PCOE",8
19,"19286",742,610,603,4,7,"PCOE",2
14,"14019",6408,5163,5086,58,77,"PCOE",14
41,"41058",17860,12850,12598,152,252,"PCOE",30
41,"41001",1565,1224,1213,8,11,"PCOE",0
21,"21015",654,363,359,8,4,"PCOE",2
40,"40051",34,33,31,0,2,"PCOE",0
19,"19135",93,76,72,0,4,"PCOE",0
19,"19053",1929,1472,1458,9,14,"PCOE",6
21,"21003",677,505,489,3,16,"PCOE",3
21,"21040",3181,2303,2227,21,76,"PCOE",3
19,"19271",41,26,26,0,0,"PCOE",0
15,"15086",2785,2015,1987,14,28,"PCOE",1
40,"40123",141,108,104,1,4,"PCOE",0
11,"11002",4200,3287,3257,5,30,"PCOE",1
15,"15007",3179,2333,2304,22,29,"PCOE",8
40,"40225",1098,902,882,4,20,"PCOE",3
19,"19015",84,74,73,0,1,"PCOE",0
19,"19210",18,18,17,0,1,"PCOE",0
41,"41074",2998,2364,2322,17,42,"PCOE",3
40,"40052",72,56,56,0,0,"PCOE",0
19,"19259",28,24,24,0,0,"PCOE",0
19,"19190",2302,1788,1767,13,21,"PCOE",6
11,"11023",9372,7032,6950,94,82,"PCOE",20
19,"19216",130,100,99,1,1,"PCOE",0
19,"19288",22,21,21,1,0,"PCOE",0
41,"41101",6016,4524,4480,42,44,"PCOE",11
19,"19289",23,19,19,0,0,"PCOE",0
21,"21029",1509,1183,1160,14,23,"PCOE",9
40,"40906",2131,1830,1814,10,16,"PCOE",1
40,"40160",93,72,72,0,0,"PCOE",0
40,"40018",75,60,60,0,0,"PCOE",0
40,"40216",774,670,665,11,5,"PCOE",0
15,"15025",1000,639,631,6,8,"PCOE",3
15,"15027",1555,1227,1204,18,23,"PCOE",4
14,"14042",18727,15069,14837,201,232,"PCOE",52
19,"19139",26,20,20,1,0,"PCOE",0
11,"11036",687,457,447,7,10,"PCOE",1
19,"19075",61,44,43,0,1,"PCOE",0
19,"19142",249,178,177,1,1,"PCOE",1
41,"41085",4170,3337,3270,27,67,"PCOE",5
40,"40206",162,132,128,2,4,"PCOE",0
40,"40119",166,133,132,1,1,"PCOE",0
19,"19134",30,24,24,0,0,"PCOE",0
21,"21031",1172,807,764,5,43,"PCOE",2
15,"15048",5048,3791,3730,38,61,"PCOE",5
19,"19219",9,7,7,0,0,"PCOE",0
41,"41067",7227,5367,5271,56,96,"PCOE",6
11,"11001",4342,2928,2870,32,58,"PCOE",5
41,"41030",500,419,410,6,9,"PCOE",2
40,"40032",378,287,278,1,9,"PCOE",1
41,"41002",1427,1057,1024,5,33,"PCOE",1
40,"40161",35,28,26,0,2,"PCOE",1
19,"19314",45,38,38,1,0,"PCOE",0
14,"14027",7876,6227,6103,81,124,"PCOE",31
19,"19111",162,142,142,0,0,"PCOE",1
19,"19034",23,23,22,0,1,"PCOE",0
40,"40211",69,58,58,1,0,"PCOE",0
19,"19175",30,19,19,1,0,"PCOE",0
40,"40231",98,80,80,2,0,"PCOE",0
40,"40233",396,323,320,2,3,"PCOE",2
14,"14047",1629,1300,1285,18,15,"PCOE",3
11,"11019",1753,1353,1295,7,58,"PCOE",8
19,"19036",248,213,210,1,3,"PCOE",0
11,"11015",64073,43152,42713,710,439,"PCOE",150
40,"40092",113,86,84,2,2,"PCOE",0
15,"15043",4978,3631,3572,39,59,"PCOE",13
41,"41078",2459,1910,1895,24,15,"PCOE",1
19,"19176",230,184,183,0,1,"PCOE",0
14,"14075",557,429,411,5,18,"PCOE",0
40,"40176",375,325,322,6,3,"PCOE",0
41,"41095",39970,27911,27583,389,328,"PCOE",29
15,"15009",10615,8066,7919,93,147,"PCOE",36
40,"40163",41,38,38,0,0,"PCOE",0
14,"14035",5817,4373,4314,44,59,"PCOE",11
40,"40057",1405,1176,1163,10,13,"PCOE",1
15,"15051",4562,3302,3249,36,53,"PCOE",10
21,"21034",1159,863,845,4,18,"PCOE",3
30,"30006",829,731,727,4,4,"PCOE",0
19,"19162",67,50,48,0,2,"PCOE",0
19,"19046",22148,17383,17137,125,246,"PCOE",36
19,"19256",44,32,32,0,0,"PCOE",0
19,"19232",58,49,49,0,0,"PCOE",0
40,"40093",76,68,67,0,1,"PCOE",0
19,"19306",22,19,19,0,0,"PCOE",0
14,"14056",23513,17065,16684,147,381,"PCOE",46
19,"19115",32,23,23,0,0,"PCOE",0
40,"40012",238,178,175,4,3,"PCOE",0
19,"19047",55,47,47,0,0,"PCOE",0
40,"40035",135,111,110,0,1,"PCOE",0
14,"14006",1321,1155,1127,4,28,"PCOE",3
19,"19165",41,36,36,0,0,"PCOE",0
19,"19089",25,19,19,1,0,"PCOE",0
11,"11009",580,429,420,2,9,"PCOE",0
30,"30017",11477,8952,8844,62,108,"PCOE",11
15,"15045",3629,2263,2237,9,26,"PCOE",2
40,"40200",38,32,31,0,1,"PCOE",0
19,"19071",8155,6327,6242,35,85,"PCOE",14
41,"41061",2144,1763,1712,7,51,"PCOE",0
15,"15084",3059,2236,2217,20,19,"PCOE",6
21,"21017",2325,1450,1419,22,31,"PCOE",9
30,"30042",2180,1727,1703,6,24,"PCOE",1
19,"19020",46,35,34,1,1,"PCOE",0
40,"40095",464,379,369,2,10,"PCOE",0
40,"40083",72,53,51,3,2,"PCOE",0
40,"40075",153,128,127,0,1,"PCOE",0
19,"19133",81,70,70,0,0,"PCOE",0
19,"19285",20,18,18,0,0,"PCOE",0
11,"11901",5698,4167,4080,81,87,"PCOE",10
15,"15012",3611,2695,2616,36,79,"PCOE",5
19,"19118",10,10,10,1,0,"PCOE",0
11,"11902",3656,2427,2383,29,44,"PCOE",6
14,"14048",1189,948,933,5,15,"PCOE",4
19,"19168",266,211,206,4,5,"PCOE",5
19,"19156",933,756,745,1,11,"PCOE",3
41,"41016",7767,5937,5829,56,108,"PCOE",10
19,"19002",57,45,45,0,0,"PCOE",0
40,"40224",19,16,16,0,0,"PCOE",0
19,"19105",2540,2013,1988,13,25,"PCOE",6
19,"19241",35,24,23,2,1,"PCOE",0
30,"30040",705,600,596,1,4,"PCOE",2
19,"19261",32,24,24,0,0,"PCOE",0
41,"41051",2311,1770,1734,5,36,"PCOE",0
41,"41029",13483,10357,10199,120,158,"PCOE",8
21,"21067",402,300,299,2,1,"PCOE",4
19,"19052",21,16,16,0,0,"PCOE",1
19,"19106",76,57,57,0,0,"PCOE",1
19,"19287",136,107,105,3,2,"PCOE",0
19,"19154",59,48,47,0,1,"PCOE",0
41,"41036",3917,2944,2885,27,59,"PCOE",2
19,"19198",17,17,17,0,0,"PCOE",0
19,"19019",14,10,10,0,0,"PCOE",0
19,"19247",142,118,117,2,1,"PCOE",0
19,"19262",123,98,97,0,1,"PCOE",0
19,"19170",189,116,116,0,0,"PCOE",0
40,"40195",813,630,623,5,7,"PCOE",0
19,"19070",67,53,51,0,2,"PCOE",0
41,"41033",4965,3634,3580,27,54,"PCOE",5
19,"19108",102,92,89,0,3,"PCOE",0
41,"41091",539730,412509,408312,3804,4197,"PCOE",384
14,"14044",1620,1279,1264,12,15,"PCOE",2
19,"19112",53,41,40,1,1,"PCOE",0
30,"30039",20191,14552,14380,96,172,"PCOE",34
40,"40171",39,29,29,1,0,"PCOE",0
30,"30022",17056,12158,11954,126,204,"PCOE",26
41,"41087",10496,7661,7477,57,184,"PCOE",7
15,"15088",3415,2349,2323,28,26,"PCOE",3
40,"40111",52,44,44,0,0,"PCOE",0
19,"19109",33,30,30,1,0,"PCOE",0
40,"40125",75,61,61,2,0,"PCOE",1
21,"21041",112810,77371,76488,900,883,"PCOE",208
19,"19304",220,177,175,1,2,"PCOE",2
30,"30002",9735,7319,7227,33,92,"PCOE",13
21,"21005",15697,9910,9778,72,132,"PCOE",44
21,"21046",1714,1097,1071,13,26,"PCOE",2
40,"40007",68,58,58,0,0,"PCOE",0
19,"19201",60,45,45,0,0,"PCOE",0
40,"40138",2127,1729,1696,18,33,"PCOE",1
40,"40205",229,185,180,1,5,"PCOE",1
15,"15006",5169,3527,3436,32,91,"PCOE",6
30,"30043",25401,20378,19992,131,386,"PCOE",38
19,"19208",41,34,34,0,0,"PCOE",1
11,"11903",1791,1234,1211,16,23,"PCOE",3
19,"19324",160,128,123,1,5,"PCOE",0
15,"15016",4569,3171,3146,18,25,"PCOE",11
19,"19188",43,34,33,0,1,"PCOE",0
11,"11025",4388,3092,3045,30,47,"PCOE",11
19,"19218",45,34,34,1,0,"PCOE",1
15,"15017",19860,14930,14706,204,224,"PCOE",60
40,"40031",540,429,424,6,5,"PCOE",1
19,"19043",99,87,84,2,3,"PCOE",0
40,"40055",32,26,25,0,1,"PCOE",0
15,"15042",2955,2057,2002,16,55,"PCOE",4
40,"40002",34,30,30,0,0,"PCOE",0
19,"19160",905,618,613,3,5,"PCOE",0
19,"19033",48,42,41,0,1,"PCOE",0
15,"15044",1209,889,876,4,13,"PCOE",3
41,"41080",1240,940,913,11,27,"PCOE",1
14,"14034",304,246,239,1,7,"PCOE",0
40,"40069",74,65,65,0,0,"PCOE",0
40,"40107",92,76,74,0,2,"PCOE",0
19,"19284",10,9,9,1,0,"PCOE",1
40,"40124",234,175,168,3,7,"PCOE",0
30,"30028",6400,4364,4289,30,75,"PCOE",5
19,"19044",284,226,223,1,3,"PCOE",0
41,"41024",22737,15687,15398,167,289,"PCOE",16
19,"19211",356,301,300,0,1,"PCOE",0
41,"41098",5152,4046,3986,24,60,"PCOE",5
19,"19309",21,18,17,0,1,"PCOE",0
41,"41050",5180,4217,4149,34,68,"PCOE",14
40,"40198",24,20,20,0,0,"PCOE",0
21,"21070",6222,4413,4322,47,91,"PCOE",32
41,"41903",6769,5018,4919,73,99,"PCOE",16
11,"11016",15051,10188,10042,131,146,"PCOE",50
21,"21025",3898,2765,2705,39,60,"PCOE",6
14,"14065",1813,1439,1421,11,18,"PCOE",4
30,"30016",152709,110165,109114,717,1051,"PCOE",173
11,"11029",5423,3161,3105,55,56,"PCOE",14
19,"19222",96,73,72,2,1,"PCOE",1
40,"40129",164,129,128,2,1,"PCOE",0
15,"15092",6250,4358,4297,28,61,"PCOE",13
41,"41026",4300,3561,3521,18,40,"PCOE",5
41,"41102",14750,10972,10677,110,295,"PCOE",28
41,"41069",29569,21075,20657,361,418,"PCOE",30
19,"19060",157,128,125,0,3,"PCOE",1
15,"15079",1466,1076,1052,11,24,"PCOE",6
19,"19302",52,43,41,1,2,"PCOE",0
19,"19178",30,15,15,0,0,"PCOE",0
21,"21023",2051,1356,1332,5,24,"PCOE",4
40,"40058",309,277,271,0,6,"PCOE",0
40,"40189",479,392,380,2,12,"PCOE",2
41,"41100",967,765,727,8,38,"PCOE",2
41,"41073",1685,1172,1157,13,15,"PCOE",0
19,"19298",55,47,47,0,0,"PCOE",0
40,"40170",1307,1066,1054,7,12,"PCOE",1
21,"21044",17955,11674,11479,136,195,"PCOE",27
40,"40130",128,102,96,0,6,"PCOE",0
40,"40019",29,26,26,0,0,"PCOE",0
40,"40143",83,73,73,2,0,"PCOE",2
14,"14071",884,641,634,2,7,"PCOE",1
21,"21077",1725,1307,1286,10,21,"PCOE",3
14,"14024",1859,1461,1418,10,43,"PCOE",2
19,"19005",91,63,63,0,0,"PCOE",0
11,"11031",76294,54123,53583,589,540,"PCOE",196
19,"19155",66,56,56,0,0,"PCOE",1
14,"14031",566,453,446,2,7,"PCOE",1
30,"30032",2851,2256,2218,14,38,"PCOE",4
19,"19172",50,35,35,1,0,"PCOE",0
14,"14068",516,405,400,1,5,"PCOE",0
19,"19226",41,32,32,0,0,"PCOE",0
19,"19268",43,42,42,0,0,"PCOE",0
15,"15902",4522,3220,3159,47,61,"PCOE",9
40,"40060",68,46,46,0,0,"PCOE",0
41,"41066",1310,1027,1010,1,17,"PCOE",0
19,"19031",10,8,8,0,0,"PCOE",0
40,"40190",48,40,39,0,1,"PCOE",0
19,"19067",69,53,50,1,3,"PCOE",0
14,"14069",7376,5511,5398,47,113,"PCOE",9
30,"30030",320172,249965,247884,1497,2081,"PCOE",319
41,"41044",7698,5967,5898,59,69,"PCOE",9
40,"40054",107,91,88,0,3,"PCOE",0
40,"40186",34,29,29,0,0,"PCOE",1
21,"21054",8157,6002,5869,60,133,"PCOE",19
19,"19228",29,22,22,0,0,"PCOE",1
40,"40126",67,53,51,0,2,"PCOE",0
15,"15058",28606,22203,22022,261,181,"PCOE",45
19,"19213",70,53,52,0,1,"PCOE",0
19,"19257",3283,2448,2424,21,24,"PCOE",4
40,"40192",133,104,102,2,2,"PCOE",0
21,"21076",2142,1573,1551,24,22,"PCOE",10
14,"14030",7797,6116,6036,54,80,"PCOE",27
19,"19278",24,24,24,0,0,"PCOE",0
19,"19220",2536,1833,1813,9,20,"PCOE",7
40,"40061",65,50,48,2,2,"PCOE",0
30,"30901",10529,8488,8375,37,113,"PCOE",8
40,"40222",163,143,142,1,1,"PCOE",0
11,"11003",1240,898,876,7,22,"PCOE",4
15,"15005",25263,17634,17347,257,287,"PCOE",70
19,"19215",144,121,119,0,2,"PCOE",0
19,"19059",74,53,46,0,7,"PCOE",0
19,"19024",8525,6587,6485,33,102,"PCOE",13
21,"21048",313,243,237,4,6,"PCOE",0
19,"19283",32,26,26,0,0,"PCOE",0
30,"30001",4539,3615,3567,16,48,"PCOE",6
19,"19167",129,104,102,0,2,"PCOE",0
15,"15001",4689,3422,3362,52,60,"PCOE",13
40,"40201",43,39,37,0,2,"PCOE",0
41,"41052",3027,2357,2288,14,69,"PCOE",3
15,"15036",56248,40194,39764,508,430,"PCOE",104
21,"21010",14976,9475,9352,145,123,"PCOE",18
40,"40184",248,205,203,0,2,"PCOE",0
41,"41038",102179,76348,75425,819,923,"PCOE",118
41,"41037",3192,2505,2479,15,26,"PCOE",0
21,"21058",2556,1732,1709,21,23,"PCOE",5
40,"40902",117,96,96,1,0,"PCOE",0
11,"11028",32791,24276,24028,279,248,"PCOE",90
19,"19296",27,24,24,0,0,"PCOE",0
40,"40183",116,103,103,0,0,"PCOE",0
15,"15047",2269,1531,1497,25,34,"PCOE",5
21,"21030",1879,1523,1504,14,19,"PCOE",2
19,"19250",15,13,13,0,0,"PCOE",0
40,"40136",106,82,81,0,1,"PCOE",0
15,"15038",2123,1441,1413,25,28,"PCOE",6
19,"19054",167,144,141,2,3,"PCOE",0
40,"40194",39191,31175,30785,250,390,"PCOE",67
14,"14053",5925,4442,4348,75,94,"PCOE",14
14,"14023",2007,1734,1711,9,23,"PCOE",0
41,"41039",31500,23692,23345,234,347,"PCOE",19
19,"19159",87,77,76,0,1,"PCOE",1
19,"19124",380,271,268,0,3,"PCOE",0
15,"15028",1393,1076,1063,8,13,"PCOE",3
21,"21036",203,147,143,0,4,"PCOE",1
41,"41089",6629,4904,4814,48,90,"PCOE",2
11,"11026",4695,3656,3564,18,92,"PCOE",8
19,"19224",102,91,90,1,1,"PCOE",0
15,"15039",1224,874,850,11,24,"PCOE",2
19,"19092",395,317,309,1,8,"PCOE",1
19,"19126",1687,1306,1285,9,21,"PCOE",2
40,"40009",40,34,34,0,0,"PCOE",0
11,"11034",2331,1708,1670,17,38,"PCOE",2
14,"14902",1121,928,900,7,28,"PCOE",3
14,"14051",1348,1064,1048,7,16,"PCOE",2
41,"41018",9410,6987,6882,52,105,"PCOE",16
21,"21049",3282,2294,2214,21,80,"PCOE",21
14,"14020",338,240,233,2,7,"PCOE",0
40,"40029",24,21,21,0,0,"PCOE",0
14,"14041",3115,2449,2376,45,73,"PCOE",13
19,"19229",57,52,52,0,0,"PCOE",0
14,"14032",393,328,321,2,7,"PCOE",1
40,"40139",258,207,202,0,5,"PCOE",1
30,"30034",1075,852,831,4,21,"PCOE",2
19,"19079",8,7,7,1,0,"PCOE",0
15,"15019",26006,18323,18075,280,248,"PCOE",75
21,"21026",253,189,183,1,6,"PCOE",0
15,"15050",1748,1038,1027,15,11,"PCOE",4
19,"19114",33,25,25,1,0,"PCOE",0
40,"40152",748,637,620,6,17,"PCOE",2
19,"19192",1759,1367,1360,3,7,"PCOE",3
14,"14005",6318,4464,4380,59,84,"PCOE",11
19,"19297",32,27,27,0,0,"PCOE",0
15,"15075",12785,9638,9519,121,119,"PCOE",17
40,"40084",53,40,39,0,1,"PCOE",0
40,"40112",2772,2255,2223,21,32,"PCOE",8
41,"41065",22550,16215,16010,189,205,"PCOE",11
21,"21004",1593,1114,1085,16,29,"PCOE",9
21,"21007",6318,4614,4524,50,90,"PCOE",18
15,"15041",9581,7223,7082,96,141,"PCOE",24
40,"40110",316,254,253,2,1,"PCOE",0
41,"41014",2486,1939,1878,6,61,"PCOE",4
14,"14010",4001,3106,3068,15,38,"PCOE",10
40,"40086",660,570,548,3,22,"PCOE",2
19,"19169",33,26,25,0,1,"PCOE",1
11,"11030",22973,16087,15853,165,234,"PCOE",40
30,"30038",15674,11755,11675,59,80,"PCOE",7
15,"15030",199972,151737,150397,1576,1340,"PCOE",359
15,"15061",5199,3694,3601,40,93,"PCOE",10
40,"40048",35,29,29,0,0,"PCOE",0
21,"21062",1386,893,885,15,8,"PCOE",5
14,"14058",7859,5854,5745,51,109,"PCOE",13
19,"19087",17,14,14,0,0,"PCOE",0
41,"41902",4600,3141,3092,48,49,"PCOE",5
19,"19279",51,44,44,0,0,"PCOE",0
19,"19171",5302,4297,4238,24,59,"PCOE",11
19,"19225",851,664,650,3,14,"PCOE",1
15,"15046",6163,4625,4497,49,128,"PCOE",18
19,"19117",1611,1279,1257,7,22,"PCOE",4
41,"41075",10279,7543,7370,96,173,"PCOE",14
11,"11013",2332,1747,1713,16,34,"PCOE",0
19,"19090",90,73,72,1,1,"PCOE",0
41,"41013",4807,3480,3425,30,55,"PCOE",9
40,"40905",128,101,100,4,1,"PCOE",1
40,"40017",84,74,71,2,3,"PCOE",0
21,"21019",584,441,425,10,16,"PCOE",1
15,"15023",6318,4501,4436,40,65,"PCOE",8
19,"19221",35,26,26,0,0,"PCOE",0
19,"19177",61,49,48,0,1,"PCOE",0
40,"40049",40,30,29,0,1,"PCOE",0
41,"41072",4037,3256,3221,19,35,"PCOE",5
40,"40154",23,20,20,0,0,"PCOE",0
30,"30024",60183,45738,45317,290,421,"PCOE",60
19,"19032",146,102,101,2,1,"PCOE",1
19,"19209",41,35,34,0,1,"PCOE",0
41,"41081",29840,22819,22465,228,354,"PCOE",31
19,"19057",72,59,58,0,1,"PCOE",2
21,"21039",299,226,223,7,3,"PCOE",0
19,"19123",36,33,32,2,1,"PCOE",0
40,"40006",22,18,18,0,0,"PCOE",0
19,"19023",127,98,96,0,2,"PCOE",0
15,"15056",5648,4033,3979,39,54,"PCOE",13
41,"41086",16209,11006,10881,116,125,"PCOE",17
19,"19325",144,87,87,1,0,"PCOE",0
30,"30004",1126,884,876,5,8,"PCOE",0
15,"15090",1125,811,800,7,11,"PCOE",2
19,"19051",61,54,54,0,0,"PCOE",0
11,"11038",13613,10879,10676,101,203,"PCOE",24
19,"19008",37,32,32,1,0,"PCOE",0
40,"40072",224,198,194,3,4,"PCOE",0
15,"15052",4104,2928,2878,30,50,"PCOE",3
19,"19065",114,92,91,0,1,"PCOE",0
40,"40103",146,125,123,0,2,"PCOE",0
15,"15060",5843,4360,4281,65,79,"PCOE",11
14,"14045",3013,2508,2468,13,40,"PCOE",5
40,"40155",3835,3165,3121,43,44,"PCOE",0
40,"40135",269,224,221,1,3,"PCOE",0
11,"11007",18020,11346,11152,176,194,"PCOE",43
19,"19310",7,6,6,0,0,"PCOE",0
15,"15034",2724,1832,1811,8,21,"PCOE",10
11,"11004",89545,60056,59323,741,733,"PCOE",209
41,"41022",4269,3158,3110,16,48,"PCOE",3
40,"40214",196,167,163,1,4,"PCOE",0
19,"19331",2643,2043,2009,11,34,"PCOE",8
41,"41076",2143,1419,1403,14,16,"PCOE",6
40,"40089",214,176,170,1,6,"PCOE",1
11,"11021",4926,3592,3486,50,106,"PCOE",15
15,"15024",4346,3210,3151,19,59,"PCOE",12
40,"40004",445,348,341,0,7,"PCOE",1
19,"19244",74,54,54,0,0,"PCOE",0
15,"15035",11208,8175,8068,105,107,"PCOE",15
19,"19335",56,45,43,0,2,"PCOE",0
41,"41020",12992,8679,8524,117,155,"PCOE",6
30,"30011",4695,3665,3610,16,55,"PCOE",7
15,"15069",6588,4914,4830,58,84,"PCOE",9
41,"41009",1167,820,805,4,15,"PCOE",0
41,"41041",9760,7835,7646,44,189,"PCOE",12
19,"19009",247,190,187,0,3,"PCOE",0
14,"14033",1265,994,985,9,9,"PCOE",3
40,"40013",56,47,47,0,0,"PCOE",0
19,"19291",1131,875,864,1,11,"PCOE",1
14,"14043",7408,5721,5619,76,102,"PCOE",10
19,"19260",38,33,31,1,2,"PCOE",0
11,"11033",21702,14645,14436,190,209,"PCOE",40
41,"41068",13936,10692,10530,73,162,"PCOE",4
19,"19293",1905,1513,1499,10,14,"PCOE",5
15,"15089",4324,3258,3200,33,58,"PCOE",6
14,"14013",16604,12618,12388,155,230,"PCOE",31
19,"19294",25,19,18,0,1,"PCOE",0
21,"21053",3287,2375,2322,17,53,"PCOE",8
19,"19121",264,219,217,0,2,"PCOE",1
41,"41071",5598,3993,3915,34,78,"PCOE",5
30,"30010",6857,5533,5457,38,76,"PCOE",4
19,"19246",42,30,30,0,0,"PCOE",0
15,"15003",1701,1234,1210,10,24,"PCOE",4
41,"41008",1040,840,822,4,18,"PCPA",1
23,"23012",4018,2835,2804,15,31,"PCPA",2
4,"4014",149,109,108,0,1,"PCPA",0
14,"14037",3182,2388,2319,22,69,"PCPA",0
21,"21074",2698,1979,1945,15,34,"PCPA",1
14,"14024",1859,1461,1418,10,43,"PCPA",2
29,"29087",371,266,263,2,3,"PCPA",0
18,"18025",279,214,212,0,2,"PCPA",0
11,"11003",1240,898,876,7,22,"PCPA",0
29,"29904",417,337,335,2,2,"PCPA",0
4,"4066",13488,9324,9255,73,69,"PCPA",9
18,"18117",507,402,396,5,6,"PCPA",0
23,"23087",11185,8500,8363,65,137,"PCPA",27
23,"23017",1480,1227,1202,6,25,"PCPA",0
18,"18179",503,346,343,3,3,"PCPA",0
18,"18171",2111,1679,1638,8,41,"PCPA",1
14,"14068",516,405,400,1,5,"PCPA",1
14,"14009",2669,1863,1844,19,19,"PCPA",1
41,"41006",2738,1971,1945,16,26,"PCPA",1
4,"4083",1740,1342,1326,4,16,"PCPA",2
29,"29004",295,233,226,0,7,"PCPA",0
4,"4067",520,387,379,1,8,"PCPA",0
41,"41095",39970,27911,27583,389,328,"PCPA",12
18,"18100",7981,5900,5769,44,131,"PCPA",5
23,"23005",29940,19587,19330,191,257,"PCPA",33
41,"41089",6629,4904,4814,48,90,"PCPA",3
4,"4085",371,305,303,2,2,"PCPA",1
18,"18033",279,221,220,1,1,"PCPA",0
14,"14044",1620,1279,1264,12,15,"PCPA",1
11,"11020",166423,117732,116448,1427,1284,"PCPA",152
11,"11021",4926,3592,3486,50,106,"PCPA",7
4,"4063",1063,847,835,5,12,"PCPA",0
29,"29064",437,319,315,2,4,"PCPA",0
41,"41090",3507,2766,2694,15,72,"PCPA",1
41,"41015",5401,3984,3889,50,95,"PCPA",1
18,"18098",5994,4293,4247,29,46,"PCPA",0
18,"18126",1450,1115,1087,11,28,"PCPA",0
14,"14070",1284,988,969,5,19,"PCPA",1
23,"23090",1219,1014,1004,5,10,"PCPA",0
41,"41087",10496,7661,7477,57,184,"PCPA",7
4,"4049",5603,4104,4054,27,50,"PCPA",1
41,"41063",2713,1988,1944,17,44,"PCPA",2
23,"23062",1418,1206,1190,5,16,"PCPA",0
18,"18162",929,730,719,4,11,"PCPA",1
29,"29044",757,540,533,7,7,"PCPA",0
18,"18039",3382,2517,2490,20,27,"PCPA",0
41,"41072",4037,3256,3221,19,35,"PCPA",0
18,"18124",359,269,267,0,2,"PCPA",1
41,"41075",10279,7543,7370,96,173,"PCPA",4
18,"18128",342,274,272,1,2,"PCPA",0
4,"4058",342,256,256,0,0,"PCPA",1
29,"29094",59350,42199,41749,419,450,"PCPA",53
23,"23098",838,721,715,2,6,"PCPA",0
14,"14014",2509,2071,2030,7,41,"PCPA",4
14,"14022",3886,3080,3043,18,37,"PCPA",9
18,"18114",591,443,437,2,6,"PCPA",0
21,"21071",211,155,152,3,3,"PCPA",0
21,"21017",2325,1450,1419,22,31,"PCPA",4
14,"14065",1813,1439,1421,11,18,"PCPA",1
41,"41098",5152,4046,3986,24,60,"PCPA",0
23,"23904",2604,1727,1701,7,26,"PCPA",0
4,"4006",7218,5002,4940,33,62,"PCPA",8
18,"18158",8010,5524,5449,23,75,"PCPA",9
11,"11901",5698,4167,4080,81,87,"PCPA",2
11,"11009",580,429,420,2,9,"PCPA",2
18,"18910",730,491,487,0,4,"PCPA",0
4,"4004",400,320,315,2,5,"PCPA",0
41,"41026",4300,3561,3521,18,40,"PCPA",0
18,"18164",1794,1225,1205,9,20,"PCPA",1
41,"41004",57465,41004,40321,571,683,"PCPA",39
18,"18084",4458,3467,3417,17,50,"PCPA",3
4,"4082",277,198,196,1,2,"PCPA",1
29,"29028",1224,875,858,4,17,"PCPA",3
29,"29013",1602,1262,1238,12,24,"PCPA",3
11,"11022",48682,28113,27794,294,319,"PCPA",28
21,"21002",15922,11918,11773,119,145,"PCPA",9
4,"4038",3110,2235,2203,23,32,"PCPA",7
4,"4103",1439,1120,1108,16,12,"PCPA",4
21,"21021",12469,8238,8097,76,141,"PCPA",9
23,"23043",518,398,397,0,1,"PCPA",0
41,"41028",2071,1741,1713,18,28,"PCPA",2
23,"23092",27662,21206,20981,170,225,"PCPA",21
29,"29069",86694,58863,58127,561,736,"PCPA",59
18,"18146",937,690,682,6,8,"PCPA",1
41,"41016",7767,5937,5829,56,108,"PCPA",5
29,"29093",2164,1704,1678,4,26,"PCPA",2
18,"18006",4087,3109,3042,28,67,"PCPA",2
18,"18053",1561,1102,1099,3,3,"PCPA",1
14,"14007",15042,10970,10758,86,212,"PCPA",11
14,"14074",2237,1859,1839,8,20,"PCPA",3
18,"18136",1782,1382,1359,12,23,"PCPA",1
14,"14060",3694,2878,2798,26,80,"PCPA",8
29,"29095",3304,2536,2470,22,66,"PCPA",1
14,"14066",5756,4396,4310,36,86,"PCPA",28
18,"18037",528,435,426,2,9,"PCPA",0
18,"18181",202,150,148,0,2,"PCPA",0
21,"21063",2620,2037,1992,11,45,"PCPA",2
14,"14029",4029,3089,3039,15,50,"PCPA",6
18,"18108",826,677,669,3,8,"PCPA",0
14,"14035",5817,4373,4314,44,59,"PCPA",2
11,"11024",6583,4774,4682,40,92,"PCPA",4
29,"29085",138,100,98,0,2,"PCPA",0
4,"4022",357,261,261,0,0,"PCPA",0
14,"14027",7876,6227,6103,81,124,"PCPA",18
23,"23042",317,234,232,1,2,"PCPA",2
18,"18913",781,590,577,5,13,"PCPA",0
29,"29015",32064,23769,23461,213,308,"PCPA",16
4,"4050",751,522,519,1,3,"PCPA",0
41,"41065",22550,16215,16010,189,205,"PCPA",13
18,"18089",14540,10725,10583,65,142,"PCPA",5
41,"41056",3694,3044,3009,36,35,"PCPA",4
18,"18071",5612,4271,4184,29,87,"PCPA",3
23,"23069",5262,4395,4329,15,66,"PCPA",4
21,"21003",677,505,489,3,16,"PCPA",0
4,"4015",118,97,97,2,0,"PCPA",0
18,"18076",790,607,604,1,3,"PCPA",0
18,"18042",418,344,340,7,4,"PCPA",0
4,"4027",226,147,147,1,0,"PCPA",0
11,"11015",64073,43152,42713,710,439,"PCPA",55
23,"23030",1208,1022,1011,6,11,"PCPA",0
4,"4048",1496,1109,1102,4,7,"PCPA",4
18,"18048",2462,1873,1832,16,41,"PCPA",2
41,"41032",3843,3018,2944,17,74,"PCPA",4
29,"29088",2694,2019,1951,31,68,"PCPA",3
4,"4904",1879,1328,1322,4,6,"PCPA",1
11,"11014",17141,11836,11705,214,131,"PCPA",25
14,"14017",10945,8514,8386,90,128,"PCPA",14
23,"23015",1332,1066,1048,4,18,"PCPA",1
41,"41071",5598,3993,3915,34,78,"PCPA",7
29,"29012",9718,7243,7123,47,120,"PCPA",2
29,"29026",1010,747,736,3,11,"PCPA",1
4,"4008",464,386,383,4,3,"PCPA",1
4,"4041",330,248,247,1,1,"PCPA",1
23,"23008",1434,1155,1133,6,22,"PCPA",1
11,"11019",1753,1353,1295,7,58,"PCPA",2
4,"4035",8433,6246,6196,33,50,"PCPA",6
23,"23050",90596,69591,68903,460,688,"PCPA",52
4,"4059",1025,742,731,3,11,"PCPA",0
14,"14018",3611,2802,2741,25,61,"PCPA",8
18,"18074",264,207,205,0,2,"PCPA",0
29,"29046",2540,1896,1855,13,41,"PCPA",0
41,"41062",2175,1763,1746,8,17,"PCPA",1
29,"29092",579,434,426,5,8,"PCPA",0
41,"41012",3368,2416,2361,23,55,"PCPA",3
21,"21009",835,575,557,0,18,"PCPA",2
18,"18107",924,694,680,3,14,"PCPA",0
29,"29011",2871,1955,1926,11,29,"PCPA",0
4,"4079",54086,38415,38134,239,281,"PCPA",31
4,"4007",731,570,569,0,1,"PCPA",0
23,"23072",1885,1485,1468,5,17,"PCPA",1
21,"21075",335,256,249,0,7,"PCPA",0
14,"14069",7376,5511,5398,47,113,"PCPA",8
23,"23039",2154,1644,1605,6,39,"PCPA",0
14,"14039",2575,2037,1990,14,47,"PCPA",1
21,"21047",1869,1242,1206,8,36,"PCPA",0
18,"18094",2304,1845,1798,16,47,"PCPA",1
14,"14050",2352,1840,1801,11,39,"PCPA",3
23,"23055",46343,33603,33225,243,378,"PCPA",48
29,"29070",43090,30294,29928,243,366,"PCPA",39
29,"29076",2335,1661,1614,11,47,"PCPA",1
41,"41005",9250,6925,6809,69,116,"PCPA",6
4,"4005",533,448,442,0,6,"PCPA",1
29,"29068",7716,5347,5230,58,117,"PCPA",6
4,"4070",1545,1192,1182,7,10,"PCPA",0
29,"29045",1681,1263,1242,9,21,"PCPA",1
21,"21053",3287,2375,2322,17,53,"PCPA",3
18,"18077",471,372,366,5,6,"PCPA",0
29,"29083",2062,1607,1574,9,33,"PCPA",2
29,"29027",2309,1716,1692,18,24,"PCPA",1
21,"21012",286,238,233,4,5,"PCPA",0
4,"4001",1014,768,763,9,5,"PCPA",0
21,"21057",995,631,629,3,2,"PCPA",0
29,"29063",303,243,239,1,4,"PCPA",0
21,"21029",1509,1183,1160,14,23,"PCPA",1
23,"23901",1139,946,934,3,12,"PCPA",0
21,"21004",1593,1114,1085,16,29,"PCPA",0
23,"23019",1479,1209,1183,3,26,"PCPA",1
21,"21016",993,770,744,6,26,"PCPA",0
14,"14071",884,641,634,2,7,"PCPA",1
14,"14052",9080,5999,5909,63,90,"PCPA",12
18,"18161",251,222,220,1,2,"PCPA",0
41,"41034",23480,16510,16250,230,260,"PCPA",19
4,"4071",363,303,301,2,2,"PCPA",0
14,"14040",3755,3047,3006,21,41,"PCPA",22
11,"11041",9858,6916,6763,70,153,"PCPA",6
23,"23902",2229,1843,1820,7,23,"PCPA",1
41,"41064",5611,3763,3667,47,96,"PCPA",2
41,"41088",512,383,377,1,6,"PCPA",0
29,"29055",1880,1493,1470,15,23,"PCPA",0
23,"23014",2552,2056,2020,11,36,"PCPA",7
4,"4055",366,315,314,3,1,"PCPA",0
4,"4044",1533,1190,1176,8,14,"PCPA",0
21,"21039",299,226,223,7,3,"PCPA",1
18,"18068",1606,1293,1277,11,16,"PCPA",0
4,"4097",242,184,184,0,0,"PCPA",1
23,"23052",1108,949,931,8,18,"PCPA",0
41,"41036",3917,2944,2885,27,59,"PCPA",1
29,"29042",14447,10383,10199,98,184,"PCPA",9
11,"11002",4200,3287,3257,5,30,"PCPA",1
21,"21076",2142,1573,1551,24,22,"PCPA",2
21,"21073",1891,1191,1156,17,35,"PCPA",2
4,"4046",848,653,649,5,4,"PCPA",2
18,"18054",838,649,648,8,1,"PCPA",0
18,"18148",803,652,648,0,4,"PCPA",0
4,"4065",368,287,284,2,3,"PCPA",0
41,"41002",1427,1057,1024,5,33,"PCPA",1
29,"29020",3280,2531,2485,23,46,"PCPA",5
18,"18140",42374,29390,29025,221,365,"PCPA",11
4,"4102",14110,9871,9765,90,106,"PCPA",6
18,"18154",975,701,699,3,2,"PCPA",0
18,"18121",130,104,103,3,1,"PCPA",0
18,"18067",681,511,507,3,4,"PCPA",0
4,"4075",5427,3989,3961,15,28,"PCPA",6
4,"4099",4931,3781,3719,24,62,"PCPA",5
23,"23002",17399,13575,13341,97,234,"PCPA",11
18,"18176",241,182,180,0,2,"PCPA",0
21,"21033",561,428,427,4,1,"PCPA",0
41,"41003",2371,1801,1760,8,41,"PCPA",1
4,"4002",1039,798,792,7,6,"PCPA",2
21,"21070",6222,4413,4322,47,91,"PCPA",11
4,"4051",406,343,339,1,4,"PCPA",0
29,"29084",27218,19648,19352,173,296,"PCPA",18
18,"18902",755,611,595,1,16,"PCPA",0
41,"41099",3968,2666,2642,23,24,"PCPA",2
29,"29036",611,448,444,3,4,"PCPA",2
14,"14015",2067,1575,1551,16,24,"PCPA",4
41,"41054",713,596,588,4,8,"PCPA",0
41,"41025",2019,1492,1439,7,53,"PCPA",2
14,"14059",687,571,563,7,8,"PCPA",1
18,"18010",532,420,416,2,4,"PCPA",1
18,"18065",591,482,468,4,14,"PCPA",2
18,"18188",1648,1295,1276,4,19,"PCPA",0
18,"18915",731,539,532,1,7,"PCPA",0
29,"29022",171,144,143,0,1,"PCPA",0
41,"41079",9293,7137,6979,80,158,"PCPA",6
29,"29100",2378,1711,1686,22,25,"PCPA",1
11,"11038",13613,10879,10676,101,203,"PCPA",23
41,"41027",3966,2830,2784,32,46,"PCPA",4
29,"29048",1370,1149,1135,10,14,"PCPA",1
29,"29097",4168,3086,3009,37,77,"PCPA",3
23,"23071",1720,1348,1330,6,18,"PCPA",2
29,"29056",1061,783,772,4,11,"PCPA",0
21,"21032",1801,1401,1378,8,23,"PCPA",0
23,"23065",1550,1199,1186,4,13,"PCPA",0
4,"4030",1066,783,776,5,7,"PCPA",1
21,"21060",12235,8053,7929,93,124,"PCPA",10
41,"41024",22737,15687,15398,167,289,"PCPA",16
21,"21011",3473,2543,2513,14,30,"PCPA",0
4,"4013",143321,101501,100814,750,687,"PCPA",131
4,"4091",326,267,266,3,1,"PCPA",0
23,"23011",2134,1649,1614,11,35,"PCPA",6
11,"11032",54469,33144,32810,461,334,"PCPA",58
18,"18036",3970,3197,3149,26,48,"PCPA",1
29,"29005",4499,3202,3171,37,31,"PCPA",5
21,"21014",4065,3192,3148,22,44,"PCPA",3
4,"4047",2230,1806,1785,8,21,"PCPA",2
14,"14048",1189,948,933,5,15,"PCPA",0
4,"4018",252,215,213,1,2,"PCPA",0
11,"11902",3656,2427,2383,29,44,"PCPA",4
21,"21042",15579,8742,8579,138,163,"PCPA",8
14,"14038",32692,24015,23679,213,336,"PCPA",25
11,"11903",1791,1234,1211,16,23,"PCPA",0
23,"23006",4582,3607,3543,32,64,"PCPA",3
4,"4052",12767,9352,9269,90,83,"PCPA",6
23,"23010",14241,10186,10015,68,171,"PCPA",8
29,"29065",194,150,150,0,0,"PCPA",0
29,"29043",2474,1764,1720,25,44,"PCPA",2
41,"41060",15100,11304,11105,113,199,"PCPA",8
4,"4033",125,98,95,0,3,"PCPA",0
18,"18007",741,533,527,6,6,"PCPA",1
11,"11034",2331,1708,1670,17,38,"PCPA",2
18,"18147",3644,2492,2441,18,51,"PCPA",2
29,"29082",34113,26248,26002,304,246,"PCPA",69
29,"29037",215,179,179,0,0,"PCPA",0
18,"18184",2170,1688,1656,3,32,"PCPA",0
21,"21064",6641,4689,4597,66,92,"PCPA",6
14,"14064",300,231,227,6,4,"PCPA",0
41,"41030",500,419,410,6,9,"PCPA",0
4,"4094",209,156,154,0,2,"PCPA",0
18,"18043",130,93,93,0,0,"PCPA",0
14,"14047",1629,1300,1285,18,15,"PCPA",4
4,"4098",1455,1097,1087,9,10,"PCPA",1
14,"14010",4001,3106,3068,15,38,"PCPA",3
29,"29060",671,511,506,1,5,"PCPA",0
23,"23073",4389,3400,3363,13,37,"PCPA",2
29,"29016",263,217,217,0,0,"PCPA",0
21,"21061",5089,3358,3290,42,68,"PCPA",0
41,"41068",13936,10692,10530,73,162,"PCPA",6
18,"18014",6898,5262,5162,43,100,"PCPA",2
21,"21078",2646,1926,1895,14,31,"PCPA",7
4,"4026",55,46,45,1,1,"PCPA",0
29,"29017",6428,4943,4871,32,72,"PCPA",10
41,"41037",3192,2505,2479,15,26,"PCPA",1
21,"21005",15697,9910,9778,72,132,"PCPA",16
4,"4054",352,280,278,2,2,"PCPA",0
4,"4062",4460,3466,3425,12,41,"PCPA",2
23,"23020",1524,1363,1348,12,15,"PCPA",2
29,"29099",969,757,735,5,22,"PCPA",0
21,"21066",495,401,396,4,5,"PCPA",1
41,"41047",10411,8348,8242,84,106,"PCPA",2
4,"4032",5698,4168,4138,20,30,"PCPA",2
18,"18132",3124,2575,2548,17,27,"PCPA",3
41,"41903",6769,5018,4919,73,99,"PCPA",2
41,"41007",12438,9009,8775,135,234,"PCPA",13
29,"29047",1103,909,898,2,11,"PCPA",1
18,"18109",599,452,448,3,4,"PCPA",0
21,"21034",1159,863,845,4,18,"PCPA",2
14,"14063",1000,767,757,4,10,"PCPA",0
23,"23034",2490,2033,1999,15,34,"PCPA",1
18,"18174",434,362,357,0,5,"PCPA",0
18,"18150",6903,5149,5063,42,86,"PCPA",9
18,"18051",1090,800,795,13,5,"PCPA",0
18,"18023",15645,11708,11561,91,147,"PCPA",13
21,"21006",3329,2307,2262,20,45,"PCPA",2
4,"4073",336,243,243,0,0,"PCPA",0
41,"41901",2703,2242,2201,29,41,"PCPA",0
18,"18103",722,556,555,3,1,"PCPA",0
21,"21052",4429,2951,2891,19,60,"PCPA",2
23,"23001",920,769,766,3,3,"PCPA",1
14,"14003",1258,989,968,12,21,"PCPA",0
18,"18003",14413,11095,10883,92,212,"PCPA",6
18,"18141",384,269,264,0,5,"PCPA",0
18,"18083",228,189,188,1,1,"PCPA",0
23,"23101",352,273,271,0,2,"PCPA",1
23,"23081",1483,1137,1109,7,28,"PCPA",0
29,"29091",9407,6859,6719,63,140,"PCPA",2
23,"23066",4299,3603,3545,13,58,"PCPA",4
23,"23009",12808,10348,10233,66,115,"PCPA",7
23,"23082",1875,1402,1389,7,13,"PCPA",0
18,"18018",554,457,451,0,6,"PCPA",2
4,"4078",1110,819,814,2,5,"PCPA",2
14,"14004",1981,1522,1509,8,13,"PCPA",0
29,"29080",6895,5005,4934,59,71,"PCPA",2
41,"41031",1215,866,848,3,18,"PCPA",0
18,"18070",289,224,222,3,2,"PCPA",0
18,"18157",1148,914,898,8,16,"PCPA",0
18,"18177",373,253,252,1,1,"PCPA",0
4,"4096",281,239,237,1,2,"PCPA",0
23,"23905",1840,1358,1341,9,17,"PCPA",1
18,"18908",784,599,581,0,18,"PCPA",1
29,"29003",922,740,727,3,13,"PCPA",1
29,"29050",398,274,269,2,5,"PCPA",0
18,"18038",1047,810,787,4,23,"PCPA",3
11,"11028",32791,24276,24028,279,248,"PCPA",40
41,"41035",1060,803,788,8,15,"PCPA",0
21,"21010",14976,9475,9352,145,123,"PCPA",6
23,"23048",820,644,636,1,8,"PCPA",0
14,"14075",557,429,411,5,18,"PCPA",0
14,"14046",4443,3550,3486,38,64,"PCPA",17
4,"4093",1919,1346,1326,10,20,"PCPA",2
18,"18024",831,682,667,6,15,"PCPA",0
23,"23031",765,659,647,4,12,"PCPA",0
41,"41073",1685,1172,1157,13,15,"PCPA",4
4,"4053",12500,9437,9298,56,139,"PCPA",3
4,"4077",302,275,275,1,0,"PCPA",0
4,"4086",1643,1226,1209,6,17,"PCPA",1
18,"18903",851,644,636,1,8,"PCPA",2
41,"41097",3135,2355,2308,11,47,"PCPA",1
18,"18133",2109,1632,1618,12,14,"PCPA",1
21,"21072",10227,7947,7739,98,208,"PCPA",9
29,"29067",430670,312817,309994,2768,2823,"PCPA",305
18,"18072",664,481,473,0,8,"PCPA",1
23,"23063",3764,2812,2781,22,31,"PCPA",2
14,"14051",1348,1064,1048,7,16,"PCPA",1
18,"18904",743,555,545,1,10,"PCPA",2
21,"21040",3181,2303,2227,21,76,"PCPA",2
21,"21065",255,178,173,2,5,"PCPA",0
11,"11035",13715,9510,9385,128,125,"PCPA",12
4,"4031",2249,1778,1773,2,5,"PCPA",1
23,"23040",1443,1164,1149,3,15,"PCPA",3
18,"18022",13804,9877,9714,92,163,"PCPA",6
18,"18029",1813,1183,1169,9,14,"PCPA",1
21,"21013",10570,7195,7089,73,106,"PCPA",13
21,"21069",1667,1214,1198,13,16,"PCPA",0
18,"18095",2002,1566,1537,11,29,"PCPA",1
18,"18001",230,173,170,1,3,"PCPA",0
23,"23045",2057,1519,1507,7,12,"PCPA",11
18,"18078",710,561,554,4,7,"PCPA",0
18,"18040",226,146,145,0,1,"PCPA",1
14,"14011",572,498,495,5,3,"PCPA",1
29,"29054",42393,30327,30108,218,219,"PCPA",21
23,"23095",8591,6634,6571,27,63,"PCPA",3
29,"29058",1538,1079,1062,5,17,"PCPA",0
18,"18152",906,692,686,1,6,"PCPA",0
18,"18020",501,365,358,2,7,"PCPA",0
21,"21050",12522,8425,8312,84,113,"PCPA",6
23,"23084",907,685,670,0,15,"PCPA",0
18,"18194",2045,1394,1370,11,24,"PCPA",1
29,"29025",41515,29572,29311,221,261,"PCPA",22
18,"18111",2849,2193,2160,24,33,"PCPA",0
41,"41048",2198,1561,1512,22,49,"PCPA",0
18,"18185",542,454,453,2,1,"PCPA",0
41,"41011",15454,11892,11591,160,301,"PCPA",3
21,"21027",50,40,39,0,1,"PCPA",0
29,"29030",774,660,657,3,3,"PCPA",1
18,"18907",1774,1426,1415,10,11,"PCPA",1
41,"41018",9410,6987,6882,52,105,"PCPA",9
18,"18088",1530,1152,1142,0,10,"PCPA",1
41,"41091",539730,412509,408312,3804,4197,"PCPA",239
41,"41046",3006,2464,2427,13,37,"PCPA",0
4,"4061",622,501,494,4,7,"PCPA",0
23,"23025",2727,2125,2090,8,35,"PCPA",2
23,"23046",2331,1953,1926,3,27,"PCPA",1
21,"21045",227,181,178,1,3,"PCPA",0
21,"21020",353,242,236,3,6,"PCPA",1
41,"41049",9493,7463,7312,78,151,"PCPA",8
29,"29039",2728,2084,2050,14,34,"PCPA",4
11,"11031",76294,54123,53583,589,540,"PCPA",35
41,"41092",7679,5668,5568,61,100,"PCPA",1
29,"29061",1033,840,821,5,19,"PCPA",1
41,"41043",667,475,453,3,22,"PCPA",1
29,"29009",1441,1097,1073,8,24,"PCPA",0
23,"23053",9449,6379,6325,25,54,"PCPA",13
18,"18134",6069,4431,4345,30,86,"PCPA",4
23,"23094",3729,3111,3077,16,34,"PCPA",6
21,"21041",112810,77371,76488,900,883,"PCPA",66
29,"29002",1150,851,842,4,9,"PCPA",0
14,"14028",307,258,257,0,1,"PCPA",1
4,"4011",2757,2171,2136,11,35,"PCPA",1
11,"11017",3194,2265,2221,38,44,"PCPA",3
29,"29014",222,151,150,6,1,"PCPA",1
23,"23075",3220,2559,2524,18,35,"PCPA",10
41,"41066",1310,1027,1010,1,17,"PCPA",0
41,"41044",7698,5967,5898,59,69,"PCPA",1
14,"14033",1265,994,985,9,9,"PCPA",1
21,"21031",1172,807,764,5,43,"PCPA",1
29,"29040",1936,1419,1395,7,24,"PCPA",0
14,"14002",10859,8215,8078,93,137,"PCPA",85
18,"18138",2482,1698,1668,20,30,"PCPA",2
18,"18045",1060,748,737,10,11,"PCPA",0
11,"11033",21702,14645,14436,190,209,"PCPA",17
14,"14023",2007,1734,1711,9,23,"PCPA",0
23,"23056",3062,2332,2281,13,51,"PCPA",10
18,"18168",781,613,604,6,9,"PCPA",1
21,"21068",962,562,550,14,12,"PCPA",1
29,"29008",15183,10716,10555,93,161,"PCPA",7
29,"29074",781,606,597,2,9,"PCPA",0
23,"23077",611,483,479,0,4,"PCPA",0
14,"14073",2772,2124,2069,18,55,"PCPA",5
21,"21056",2922,2307,2228,27,79,"PCPA",2
41,"41051",2311,1770,1734,5,36,"PCPA",3
41,"41045",5854,4287,4200,58,87,"PCPA",2
11,"11023",9372,7032,6950,94,82,"PCPA",1
41,"41083",1128,865,859,6,6,"PCPA",2
29,"29053",1694,1263,1245,18,18,"PCPA",0
4,"4087",156,117,116,1,1,"PCPA",0
18,"18066",2108,1537,1525,9,12,"PCPA",2
23,"23016",384,316,311,0,5,"PCPA",1
18,"18086",339,291,289,0,2,"PCPA",0
4,"4009",151,126,124,3,2,"PCPA",0
21,"21062",1386,893,885,15,8,"PCPA",1
23,"23067",2421,1909,1873,13,36,"PCPA",6
14,"14034",304,246,239,1,7,"PCPA",0
21,"21037",459,363,357,4,6,"PCPA",0
29,"29032",6657,5314,5190,30,124,"PCPA",12
14,"14072",999,763,754,4,9,"PCPA",0
18,"18034",486,376,374,4,2,"PCPA",0
21,"21026",253,189,183,1,6,"PCPA",0
11,"11008",17840,12434,12236,181,198,"PCPA",17
11,"11025",4388,3092,3045,30,47,"PCPA",3
29,"29066",346,266,266,2,0,"PCPA",1
41,"41013",4807,3480,3425,30,55,"PCPA",6
11,"11029",5423,3161,3105,55,56,"PCPA",5
4,"4080",199,158,157,0,1,"PCPA",0
23,"23047",1579,1260,1247,13,13,"PCPA",0
23,"23079",3639,2859,2818,20,41,"PCPA",0
41,"41020",12992,8679,8524,117,155,"PCPA",7
4,"4100",9266,6046,5988,49,58,"PCPA",6
4,"4028",202,183,181,0,2,"PCPA",0
21,"21007",6318,4614,4524,50,90,"PCPA",12
41,"41067",7227,5367,5271,56,96,"PCPA",3
23,"23007",3026,2317,2301,13,16,"PCPA",4
29,"29086",774,537,532,1,5,"PCPA",0
4,"4089",694,516,510,1,6,"PCPA",2
18,"18049",596,485,481,0,4,"PCPA",0
18,"18017",18148,12712,12523,96,189,"PCPA",7
29,"29090",1653,1215,1200,8,15,"PCPA",1
23,"23070",3808,2598,2565,34,33,"PCPA",2
23,"23049",1747,1321,1305,11,16,"PCPA",2
41,"41052",3027,2357,2288,14,69,"PCPA",1
41,"41017",15712,12048,11896,118,152,"PCPA",3
41,"41058",17860,12850,12598,152,252,"PCPA",11
29,"29031",1559,1139,1113,13,26,"PCPA",0
18,"18151",259,194,193,3,1,"PCPA",0
23,"23096",2571,2099,2063,9,36,"PCPA",0
18,"18046",1753,1206,1185,1,21,"PCPA",1
4,"4074",2887,2062,2038,16,24,"PCPA",3
14,"14031",566,453,446,2,7,"PCPA",0
29,"29038",18683,12820,12666,168,154,"PCPA",16
29,"29023",2290,1569,1550,3,19,"PCPA",1
21,"21049",3282,2294,2214,21,80,"PCPA",4
21,"21001",610,480,461,3,19,"PCPA",2
21,"21025",3898,2765,2705,39,60,"PCPA",0
29,"29001",4199,3380,3341,20,39,"PCPA",4
18,"18004",687,521,515,4,6,"PCPA",0
14,"14025",2857,2482,2436,14,46,"PCPA",6
18,"18012",2143,1651,1634,8,17,"PCPA",0
18,"18911",7869,5871,5765,49,106,"PCPA",4
14,"14042",18727,15069,14837,201,232,"PCPA",28
4,"4056",164,135,133,1,2,"PCPA",0
4,"4019",232,181,179,0,2,"PCPA",0
4,"4084",341,258,255,0,3,"PCPA",0
18,"18170",324,225,224,1,1,"PCPA",0
23,"23051",2727,2060,2023,5,37,"PCPA",2
18,"18135",4434,3169,3105,23,64,"PCPA",3
18,"18122",16001,11761,11556,110,205,"PCPA",11
11,"11037",5644,4567,4433,34,134,"PCPA",13
23,"23099",4822,3687,3633,28,54,"PCPA",4
21,"21043",1857,1465,1424,7,41,"PCPA",1
14,"14019",6408,5163,5086,58,77,"PCPA",7
4,"4060",407,308,304,1,4,"PCPA",0
18,"18056",3418,2523,2478,22,45,"PCPA",0
21,"21019",584,441,425,10,16,"PCPA",0
23,"23021",517,446,440,0,6,"PCPA",0
11,"11026",4695,3656,3564,18,92,"PCPA",2
23,"23076",768,653,646,3,7,"PCPA",0
18,"18909",539,432,426,1,6,"PCPA",0
11,"11010",6351,4472,4385,140,87,"PCPA",4
18,"18123",288,219,219,2,0,"PCPA",0
14,"14030",7797,6116,6036,54,80,"PCPA",12
18,"18069",497,374,366,4,8,"PCPA",1
18,"18145",10869,8532,8405,69,127,"PCPA",7
41,"41077",8631,6441,6289,46,152,"PCPA",9
23,"23035",1103,903,882,6,21,"PCPA",0
29,"29052",222,156,153,2,3,"PCPA",0
4,"4090",312,253,249,0,4,"PCPA",0
29,"29019",864,687,679,7,8,"PCPA",0
4,"4010",580,445,434,2,11,"PCPA",0
41,"41081",29840,22819,22465,228,354,"PCPA",15
29,"29049",2926,2197,2165,9,32,"PCPA",1
23,"23086",11442,8618,8431,80,187,"PCPA",11
23,"23060",19153,14444,14281,87,163,"PCPA",12
14,"14008",2785,1942,1910,15,32,"PCPA",4
18,"18063",1217,712,702,6,10,"PCPA",0
41,"41053",21618,16549,16150,194,399,"PCPA",9
18,"18106",415,300,295,0,5,"PCPA",0
41,"41059",35105,27781,27472,261,309,"PCPA",18
23,"23061",7691,5636,5531,51,105,"PCPA",1
21,"21038",1076,786,771,8,15,"PCPA",1
23,"23041",491,383,382,0,1,"PCPA",0
29,"29006",665,491,483,5,8,"PCPA",0
4,"4036",223,188,186,1,2,"PCPA",0
29,"29051",41793,29275,28764,249,511,"PCPA",16
21,"21055",7218,5328,5215,41,113,"PCPA",7
11,"11013",2332,1747,1713,16,34,"PCPA",1
41,"41085",4170,3337,3270,27,67,"PCPA",3
14,"14053",5925,4442,4348,75,94,"PCPA",12
41,"41029",13483,10357,10199,120,158,"PCPA",8
21,"21067",402,300,299,2,1,"PCPA",0
29,"29096",2756,2061,2018,21,43,"PCPA",1
29,"29073",1645,1200,1185,13,15,"PCPA",2
18,"18193",14802,11165,10973,110,192,"PCPA",12
29,"29081",261,212,210,2,2,"PCPA",0
41,"41023",7975,5918,5812,51,106,"PCPA",6
18,"18189",772,619,611,4,8,"PCPA",1
29,"29079",2335,1796,1765,7,31,"PCPA",0
21,"21902",1144,829,824,9,5,"PCPA",2
14,"14054",13796,11042,10799,102,243,"PCPA",8
23,"23024",12224,9586,9329,46,257,"PCPA",10
41,"41039",31500,23692,23345,234,347,"PCPA",12
23,"23004",421,356,355,2,1,"PCPA",0
23,"23085",2182,1733,1717,7,16,"PCPA",1
29,"29901",44578,31840,31537,286,303,"PCPA",24
4,"4016",2128,1643,1621,4,22,"PCPA",2
4,"4012",187,163,162,1,1,"PCPA",0
18,"18112",110,80,76,0,4,"PCPA",0
18,"18182",1917,1391,1381,7,10,"PCPA",0
11,"11011",1736,1285,1249,7,36,"PCPA",0
11,"11036",687,457,447,7,10,"PCPA",2
11,"11007",18020,11346,11152,176,194,"PCPA",18
18,"18192",1466,1171,1156,1,15,"PCPA",0
14,"14058",7859,5854,5745,51,109,"PCPA",11
18,"18085",701,465,460,1,5,"PCPA",0
21,"21077",1725,1307,1286,10,21,"PCPA",0
18,"18050",1670,1231,1213,9,18,"PCPA",4
41,"41902",4600,3141,3092,48,49,"PCPA",2
23,"23044",4719,3817,3749,18,68,"PCPA",10
18,"18149",5401,4290,4212,28,78,"PCPA",2
18,"18079",3469,2667,2623,16,44,"PCPA",12
11,"11016",15051,10188,10042,131,146,"PCPA",10
4,"4003",17540,12174,12051,75,123,"PCPA",11
21,"21046",1714,1097,1071,13,26,"PCPA",1
14,"14055",18446,13919,13711,148,208,"PCPA",12
18,"18119",1712,1352,1317,11,35,"PCPA",0
41,"41102",14750,10972,10677,110,295,"PCPA",9
18,"18187",512,388,387,0,1,"PCPA",0
4,"4076",1221,951,933,8,18,"PCPA",3
4,"4064",2879,2196,2179,12,17,"PCPA",1
41,"41019",4895,3518,3462,36,56,"PCPA",5
14,"14062",963,753,745,4,8,"PCPA",0
14,"14043",7408,5721,5619,76,102,"PCPA",6
18,"18115",2650,1988,1975,20,13,"PCPA",2
4,"4101",4375,3161,3112,34,49,"PCPA",0
4,"4024",3225,2558,2534,23,24,"PCPA",1
41,"41076",2143,1419,1403,14,16,"PCPA",16
18,"18062",11041,8531,8355,71,176,"PCPA",10
4,"4057",1260,970,953,10,17,"PCPA",3
4,"4903",4308,3102,3075,17,27,"PCPA",0
11,"11018",1446,1126,1100,6,26,"PCPA",0
4,"4021",180,146,143,0,3,"PCPA",0
29,"29098",1235,953,935,12,18,"PCPA",1
29,"29059",2643,2086,2042,8,44,"PCPA",1
18,"18021",17869,13238,13004,110,234,"PCPA",13
41,"41021",21397,15585,15334,201,251,"PCPA",7
18,"18013",4152,3168,3103,16,65,"PCPA",5
21,"21008",2613,1803,1777,6,26,"PCPA",2
11,"11027",68637,48919,48441,519,478,"PCPA",71
21,"21028",370,300,293,1,7,"PCPA",0
18,"18173",8972,6594,6459,58,135,"PCPA",3
18,"18901",488,335,329,2,6,"PCPA",0
41,"41101",6016,4524,4480,42,44,"PCPA",2
29,"29024",372,265,250,3,15,"PCPA",0
18,"18137",1002,776,773,0,3,"PCPA",0
4,"4095",690,508,502,2,6,"PCPA",1
29,"29902",2592,1841,1817,18,24,"PCPA",0
41,"41069",29569,21075,20657,361,418,"PCPA",23
14,"14021",260397,195951,193914,2025,2037,"PCPA",237
18,"18044",164,113,112,0,1,"PCPA",0
14,"14049",16282,12515,12301,121,214,"PCPA",25
21,"21051",221,180,177,1,3,"PCPA",0
4,"4072",314,245,240,0,5,"PCPA",1
18,"18087",182514,141305,139588,865,1717,"PCPA",73
18,"18030",567,448,442,4,6,"PCPA",1
14,"14901",915,795,782,8,13,"PCPA",0
11,"11004",89545,60056,59323,741,733,"PCPA",60
18,"18096",344,265,265,2,0,"PCPA",0
18,"18093",2756,1902,1885,8,17,"PCPA",1
14,"14012",6076,4579,4489,38,90,"PCPA",6
29,"29029",380,294,287,2,7,"PCPA",0
23,"23018",2268,1738,1722,8,16,"PCPA",6
4,"4902",45395,31127,30881,251,246,"PCPA",29
11,"11012",97629,73036,72347,715,689,"PCPA",81
23,"23080",1721,1370,1355,8,15,"PCPA",0
21,"21048",313,243,237,4,6,"PCPA",0
18,"18057",5540,4306,4246,30,60,"PCPA",3
41,"41094",6447,4998,4912,43,86,"PCPA",2
41,"41074",2998,2364,2322,17,42,"PCPA",0
21,"21015",654,363,359,8,4,"PCPA",1
18,"18120",257,219,217,1,2,"PCPA",0
4,"4017",1276,907,900,4,7,"PCPA",1
4,"4081",346,272,271,2,1,"PCPA",0
14,"14067",3870,3057,2998,24,59,"PCPA",11
4,"4029",8819,6149,6073,45,76,"PCPA",7
18,"18116",2853,2265,2233,15,32,"PCPA",3
18,"18101",9410,7280,7181,72,99,"PCPA",4
29,"29071",979,718,712,14,6,"PCPA",0
14,"14041",3115,2449,2376,45,73,"PCPA",9
29,"29057",341,236,233,0,3,"PCPA",0
29,"29035",1505,1151,1133,6,18,"PCPA",1
18,"18011",4376,3286,3248,18,38,"PCPA",2
23,"23003",8644,6604,6523,36,81,"PCPA",7
4,"4034",165,107,106,1,1,"PCPA",0
4,"4043",511,423,421,3,2,"PCPA",0
23,"23028",6131,4696,4635,24,61,"PCPA",4
41,"41040",11111,8768,8679,76,89,"PCPA",2
23,"23058",8817,6964,6873,48,91,"PCPA",10
41,"41010",4573,3407,3345,27,62,"PCPA",7
23,"23064",1678,1413,1404,10,9,"PCPA",0
29,"29018",1996,1523,1481,11,42,"PCPA",2
11,"11040",398,348,342,4,6,"PCPA",1
41,"41038",102179,76348,75425,819,923,"PCPA",73
4,"4023",120,95,95,2,0,"PCPA",0
18,"18002",526,400,400,0,0,"PCPA",0
41,"41078",2459,1910,1895,24,15,"PCPA",1
4,"4020",286,218,217,1,1,"PCPA",0
41,"41001",1565,1224,1213,8,11,"PCPA",0
23,"23054",376,296,289,1,7,"PCPA",0
41,"41057",253,189,188,0,1,"PCPA",0
21,"21030",1879,1523,1504,14,19,"PCPA",0
23,"23033",1319,1076,1057,8,19,"PCPA",0
21,"21079",687,503,500,5,3,"PCPA",0
11,"11001",4342,2928,2870,32,58,"PCPA",5
21,"21024",466,355,341,4,14,"PCPA",1
14,"14016",1283,1005,994,4,11,"PCPA",0
29,"29041",3599,2570,2532,22,38,"PCPA",5
41,"41009",1167,820,805,4,15,"PCPA",0
18,"18159",999,828,824,1,4,"PCPA",3
21,"21044",17955,11674,11479,136,195,"PCPA",10
14,"14020",338,240,233,2,7,"PCPA",0
21,"21036",203,147,143,0,4,"PCPA",0
18,"18016",308,232,231,5,1,"PCPA",0
11,"11042",1155,870,852,7,18,"PCPA",0
18,"18178",671,535,532,0,3,"PCPA",0
11,"11039",9945,6824,6726,111,98,"PCPA",12
41,"41055",14804,10863,10720,79,143,"PCPA",3
41,"41100",967,765,727,8,38,"PCPA",0
23,"23074",2971,2410,2378,8,32,"PCPA",3
14,"14061",688,567,556,2,11,"PCPA",2
18,"18015",425,333,333,0,0,"PCPA",0
23,"23037",520,431,425,6,6,"PCPA",0
18,"18163",315,246,241,1,5,"PCPA",0
23,"23057",732,613,611,4,2,"PCPA",0
23,"23088",6020,4779,4703,56,76,"PCPA",6
18,"18059",4253,3166,3123,22,43,"PCPA",2
23,"23091",679,575,571,3,4,"PCPA",0
29,"29021",159,121,120,0,1,"PCPA",0
18,"18165",4251,3113,3073,20,40,"PCPA",3
18,"18047",6074,4437,4353,33,84,"PCPA",3
18,"18099",1581,1279,1245,5,34,"PCPA",2
14,"14045",3013,2508,2468,13,40,"PCPA",2
41,"41033",4965,3634,3580,27,54,"PCPA",0
18,"18005",362,268,265,0,3,"PCPA",1
18,"18905",15550,11394,11230,132,164,"PCPA",11
23,"23093",3131,2428,2380,22,48,"PCPA",1
41,"41904",1792,1171,1162,16,9,"PCPA",0
23,"23027",716,524,518,2,6,"PCPA",1
18,"18912",1367,990,984,5,6,"PCPA",1
18,"18167",1850,1330,1317,17,13,"PCPA",0
18,"18035",1190,965,952,4,13,"PCPA",0
21,"21018",1719,1167,1139,9,28,"PCPA",0
41,"41061",2144,1763,1712,7,51,"PCPA",3
14,"14026",2014,1502,1474,10,28,"PCPA",0
18,"18082",827,587,577,5,10,"PCPA",1
41,"41084",2815,2177,2111,3,66,"PCPA",2
23,"23097",6356,4509,4462,17,47,"PCPA",3
41,"41080",1240,940,913,11,27,"PCPA",2
4,"4045",1704,1355,1326,12,29,"PCPA",4
18,"18127",16822,12735,12537,106,198,"PCPA",16
18,"18061",1000,827,822,1,5,"PCPA",0
4,"4069",4757,3633,3588,25,45,"PCPA",3
4,"4037",1221,975,960,8,15,"PCPA",1
21,"21022",186,132,129,0,3,"PCPA",0
18,"18064",366,307,306,0,1,"PCPA",0
41,"41082",3359,2760,2718,11,42,"PCPA",5
18,"18032",242,180,178,2,2,"PCPA",0
4,"4092",2789,2207,2173,6,34,"PCPA",7
21,"21035",9726,6628,6520,78,108,"PCPA",5
11,"11006",24522,16656,16392,220,264,"PCPA",13
18,"18175",11786,8883,8730,58,153,"PCPA",4
41,"41086",16209,11006,10881,116,125,"PCPA",9
18,"18914",1657,1315,1278,5,37,"PCPA",1
29,"29089",3161,2477,2426,19,51,"PCPA",10
21,"21054",8157,6002,5869,60,133,"PCPA",5
29,"29007",28584,21525,21318,202,207,"PCPA",22
29,"29072",3277,2628,2592,16,36,"PCPA",2
18,"18180",627,442,435,4,7,"PCPA",0
14,"14001",3443,2724,2675,24,49,"PCPA",8
23,"23038",3785,3182,3162,16,20,"PCPA",3
18,"18105",3822,2688,2650,12,38,"PCPA",4
29,"29033",1089,776,761,2,15,"PCPA",0
4,"4901",494,381,378,0,3,"PCPA",0
14,"14013",16604,12618,12388,155,230,"PCPA",19
18,"18028",907,766,756,0,10,"PCPA",1
41,"41042",5849,4730,4692,20,38,"PCPA",0
29,"29077",214,158,156,1,2,"PCPA",0
29,"29062",651,576,567,4,9,"PCPA",1
29,"29075",12890,9033,8949,73,84,"PCPA",5
14,"14032",393,328,321,2,7,"PCPA",0
11,"11005",4520,3212,3128,23,84,"PCPA",1
18,"18097",995,708,702,4,6,"PCPA",1
18,"18027",2604,1902,1887,6,15,"PCPA",1
23,"23032",523,443,439,1,4,"PCPA",0
4,"4068",174,134,134,0,0,"PCPA",0
11,"11030",22973,16087,15853,165,234,"PCPA",9
41,"41096",6134,4926,4845,44,81,"PCPA",5
14,"14006",1321,1155,1127,4,28,"PCPA",2
18,"18916",1778,1249,1236,9,13,"PCPA",0
14,"14902",1121,928,900,7,28,"PCPA",0
23,"23059",5728,4259,4187,18,72,"PCPA",6
41,"41093",19012,15637,15525,97,112,"PCPA",10
18,"18183",624,442,441,1,1,"PCPA",0
14,"14036",3676,2850,2766,40,84,"PCPA",5
4,"4088",2435,1708,1693,6,15,"PCPA",3
14,"14056",23513,17065,16684,147,381,"PCPA",40
41,"41014",2486,1939,1878,6,61,"PCPA",7
21,"21059",220,184,180,0,4,"PCPA",0
14,"14005",6318,4464,4380,59,84,"PCPA",11
14,"14057",6139,5054,4964,51,90,"PCPA",14
41,"41070",6397,4987,4921,55,66,"PCPA",0
18,"18144",803,650,640,2,10,"PCPA",1
18,"18153",8796,6686,6594,59,92,"PCPA",2
18,"18143",949,757,740,5,17,"PCPA",0
23,"23903",3499,2738,2714,7,24,"PCPA",6
41,"41022",4269,3158,3110,16,48,"PCPA",6
18,"18102",8227,6100,5969,32,131,"PCPA",5
21,"21023",2051,1356,1332,5,24,"PCPA",1
21,"21058",2556,1732,1709,21,23,"PCPA",3
18,"18906",911,722,716,4,6,"PCPA",0
23,"23026",3450,2625,2573,17,52,"PCPA",1
29,"29010",1632,1372,1319,4,53,"PCPA",1
41,"41050",5180,4217,4149,34,68,"PCPA",6
23,"23029",806,651,637,0,14,"PCPA",0
29,"29034",467,374,373,1,1,"PCPA",0
41,"41041",9760,7835,7646,44,189,"PCPA",2
29,"29903",493,358,354,6,4,"PCPA",0
38,"38004",4490,3242,3202,18,40,"PCPC",7
38,"38040",5446,3513,3462,13,51,"PCPC",1
35,"35029",4357,2869,2832,32,37,"PCPC",4
38,"38017",30646,18576,18373,100,203,"PCPC",30
38,"38007",1625,1124,1104,2,20,"PCPC",1
38,"38047",1756,1276,1259,6,17,"PCPC",1
35,"35021",15014,10909,10792,71,117,"PCPC",20
38,"38901",1456,1024,1010,9,14,"PCPC",2
38,"38037",12803,8628,8517,48,111,"PCPC",5
35,"35011",24705,17099,16823,129,276,"PCPC",18
38,"38009",4299,3105,3069,16,36,"PCPC",5
35,"35032",3348,2585,2542,20,43,"PCPC",1
38,"38046",9271,7297,7212,53,85,"PCPC",4
35,"35027",10499,7651,7530,57,121,"PCPC",4
35,"35010",3797,2601,2572,9,29,"PCPC",5
38,"38039",11112,8233,8161,54,72,"PCPC",10
35,"35020",5933,4140,4088,14,52,"PCPC",4
38,"38013",3019,2023,1991,12,32,"PCPC",1
38,"38006",41302,23632,23415,133,217,"PCPC",30
38,"38001",20907,12323,12197,70,126,"PCPC",19
38,"38027",5545,3937,3896,22,41,"PCPC",3
35,"35006",31309,23434,23019,221,415,"PCPC",33
35,"35008",6207,4733,4654,42,79,"PCPC",9
35,"35025",1773,1247,1235,9,12,"PCPC",0
38,"38025",7088,5166,5089,39,77,"PCPC",2
35,"35023",11694,8785,8607,67,178,"PCPC",15
35,"35018",13056,8699,8618,73,81,"PCPC",7
35,"35001",4571,3523,3463,8,60,"PCPC",3
35,"35007",518,405,401,0,4,"PCPC",2
38,"38051",7326,5418,5352,27,66,"PCPC",5
35,"35005",1017,751,743,1,8,"PCPC",0
35,"35033",6403,4565,4502,34,63,"PCPC",5
35,"35031",7412,5593,5519,41,74,"PCPC",5
38,"38052",1280,893,887,4,6,"PCPC",2
38,"38035",10384,6657,6596,50,61,"PCPC",4
35,"35002",24129,16979,16736,116,243,"PCPC",34
38,"38008",5658,4126,4056,19,70,"PCPC",8
38,"38005",5666,3795,3761,24,34,"PCPC",4
38,"38015",4067,2951,2926,22,25,"PCPC",3
35,"35030",9949,6611,6462,65,149,"PCPC",8
38,"38031",29154,22871,22598,143,273,"PCPC",25
35,"35034",8396,4599,4546,55,53,"PCPC",4
35,"35015",10728,6233,6108,54,125,"PCPC",15
38,"38012",2310,1705,1687,6,18,"PCPC",1
35,"35028",10044,6188,6105,52,83,"PCPC",3
38,"38049",2683,1781,1743,18,38,"PCPC",3
38,"38042",3781,2799,2774,11,25,"PCPC",2
38,"38003",1510,1058,1047,4,11,"PCPC",0
38,"38032",13536,9924,9867,63,57,"PCPC",6
38,"38053",3763,2628,2588,21,40,"PCPC",3
38,"38020",15899,11057,10924,90,133,"PCPC",12
38,"38041",6970,5288,5258,38,30,"PCPC",6
38,"38048",3957,2889,2842,12,47,"PCPC",4
35,"35022",51302,33009,32566,198,443,"PCPC",39
38,"38016",1178,654,648,6,6,"PCPC",1
38,"38024",15310,10234,10088,82,146,"PCPC",15
35,"35019",32841,21136,20850,125,286,"PCPC",29
35,"35012",10765,6327,6270,32,57,"PCPC",10
38,"38038",164468,112475,111577,728,898,"PCPC",158
38,"38018",4455,3242,3198,24,44,"PCPC",3
38,"38045",3549,2149,2109,6,40,"PCPC",0
35,"35024",14243,9496,9394,65,102,"PCPC",8
38,"38036",6831,4947,4829,58,118,"PCPC",10
38,"38011",21563,15380,15214,69,166,"PCPC",18
35,"35016",300503,203470,201240,1598,2230,"PCPC",367
38,"38028",22035,15684,15522,86,162,"PCPC",18
38,"38033",3594,2512,2467,11,45,"PCPC",4
35,"35014",11908,7101,6947,63,154,"PCPC",10
38,"38022",18629,12903,12759,84,144,"PCPC",10
38,"38010",3974,2814,2777,20,37,"PCPC",1
35,"35009",20109,15017,14803,78,214,"PCPC",18
38,"38026",33514,26298,26076,191,222,"PCPC",22
38,"38050",2436,1564,1529,12,35,"PCPC",3
38,"38044",2199,1443,1429,10,14,"PCPC",0
38,"38034",3998,3033,2993,19,40,"PCPC",3
38,"38002",972,678,640,3,38,"PCPC",0
35,"35013",6584,5067,4974,49,93,"PCPC",4
38,"38019",13758,8870,8776,46,94,"PCPC",8
38,"38014",1341,991,981,6,10,"PCPC",0
35,"35003",5582,3441,3391,26,50,"PCPC",2
38,"38021",1599,1079,1057,8,22,"PCPC",3
38,"38023",125528,88323,87456,598,867,"PCPC",132
35,"35026",82764,55647,54846,499,801,"PCPC",70
38,"38030",1945,1430,1420,6,10,"PCPC",2
38,"38029",1493,839,823,5,16,"PCPC",5
38,"38043",19265,14000,13856,115,144,"PCPC",26
35,"35017",27216,17531,17102,133,429,"PCPC",34
35,"35004",41728,23957,23683,219,274,"PCPC",39
17,"17185",2275,1777,1768,7,9,"PCPC",0
43,"43141",105,86,86,0,0,"PCPC",0
8,"8281",4840,4009,3998,23,11,"PCPC",0
17,"17034",7205,5337,5291,16,46,"PCPC",5
8,"8006",11774,9039,8981,33,58,"PCPC",5
8,"8259",6904,5626,5601,27,25,"PCPC",2
43,"43019",1336,1020,1008,4,12,"PCPC",2
8,"8152",116,94,94,0,0,"PCPC",1
25,"25006",317,246,245,3,1,"PCPC",0
25,"25904",162,147,147,3,0,"PCPC",0
43,"43165",572,492,492,1,0,"PCPC",0
8,"8249",272,248,248,2,0,"PCPC",0
25,"25234",4201,3087,3072,13,15,"PCPC",3
17,"17094",1068,772,766,1,6,"PCPC",0
17,"17093",922,716,715,2,1,"PCPC",0
17,"17230",499,397,393,0,4,"PCPC",0
8,"8016",1812,1454,1448,6,6,"PCPC",0
8,"8265",1590,1339,1334,6,5,"PCPC",1
17,"17019",1784,1472,1462,3,10,"PCPC",0
17,"17080",144,124,124,2,0,"PCPC",0
17,"17155",14861,10307,10234,52,73,"PCPC",16
8,"8202",12843,10074,10025,57,49,"PCPC",2
8,"8260",18400,14471,14406,87,65,"PCPC",10
8,"8084",1167,941,936,6,5,"PCPC",2
43,"43004",6274,4744,4691,39,53,"PCPC",1
25,"25064",98,88,88,0,0,"PCPC",0
25,"25249",176,139,138,1,1,"PCPC",0
17,"17213",5535,3998,3985,20,13,"PCPC",1
25,"25103",136,103,102,2,1,"PCPC",0
43,"43060",2684,2158,2152,8,6,"PCPC",0
25,"25251",713,562,558,4,4,"PCPC",0
8,"8146",1358,1086,1079,2,7,"PCPC",1
43,"43099",286,234,234,0,0,"PCPC",1
17,"17215",2227,1936,1925,12,11,"PCPC",1
8,"8022",12219,9089,9038,42,51,"PCPC",16
8,"8139",177,156,156,0,0,"PCPC",0
8,"8095",67,53,52,0,1,"PCPC",0
17,"17177",567,459,457,2,2,"PCPC",1
17,"17139",1394,1163,1154,3,9,"PCPC",0
8,"8172",20417,16196,16144,88,52,"PCPC",14
25,"25020",274,221,221,2,0,"PCPC",0
25,"25152",144,106,106,1,0,"PCPC",0
8,"8220",2411,2119,2115,13,4,"PCPC",2
25,"25185",679,493,491,6,2,"PCPC",0
8,"8100",2092,1792,1782,16,10,"PCPC",0
8,"8123",19489,16197,16135,58,62,"PCPC",11
17,"17020",3671,3021,3006,11,15,"PCPC",0
8,"8242",222,180,180,0,0,"PCPC",0
25,"25225",541,427,420,4,7,"PCPC",0
25,"25133",686,528,527,2,1,"PCPC",1
43,"43026",765,614,613,3,1,"PCPC",0
8,"8224",878,697,695,1,2,"PCPC",0
17,"17115",278,226,222,2,4,"PCPC",0
25,"25181",175,136,135,0,1,"PCPC",0
25,"25203",8798,6279,6231,26,48,"PCPC",6
25,"25227",664,517,517,1,0,"PCPC",0
43,"43033",768,609,607,3,2,"PCPC",2
25,"25137",8686,6327,6296,46,31,"PCPC",11
25,"25217",10819,8163,8120,64,43,"PCPC",6
25,"25120",92704,68713,68361,445,352,"PCPC",67
8,"8135",6735,5445,5421,36,24,"PCPC",4
8,"8048",569,442,442,2,0,"PCPC",0
43,"43018",385,335,334,3,1,"PCPC",0
17,"17046",710,574,571,3,3,"PCPC",1
43,"43011",1079,912,909,1,3,"PCPC",1
17,"17901",983,790,789,3,1,"PCPC",0
43,"43023",214,186,186,1,0,"PCPC",0
43,"43002",1875,1367,1348,11,19,"PCPC",0
43,"43014",14357,10596,10542,60,54,"PCPC",15
43,"43006",676,531,525,4,6,"PCPC",0
25,"25005",274,202,202,2,0,"PCPC",0
8,"8031",2336,1886,1882,11,4,"PCPC",0
25,"25004",575,470,467,2,3,"PCPC",0
43,"43061",38,28,28,0,0,"PCPC",0
25,"25008",1088,867,857,7,10,"PCPC",0
25,"25168",488,408,407,6,1,"PCPC",0
25,"25016",2083,1590,1587,8,3,"PCPC",0
25,"25035",366,306,302,2,4,"PCPC",2
43,"43153",11092,8327,8291,34,36,"PCPC",3
17,"17077",567,434,434,2,0,"PCPC",0
25,"25254",711,576,571,5,5,"PCPC",0
43,"43036",865,605,602,1,3,"PCPC",0
17,"17042",408,313,311,0,2,"PCPC",0
8,"8009",9480,7649,7620,35,29,"PCPC",3
8,"8096",43555,34070,33871,194,199,"PCPC",29
8,"8056",42727,33215,33054,220,161,"PCPC",23
25,"25062",695,578,573,3,5,"PCPC",1
17,"17200",623,512,510,1,2,"PCPC",0
8,"8075",4059,3127,3119,14,8,"PCPC",0
43,"43137",1905,1515,1499,15,16,"PCPC",3
17,"17142",2673,2250,2241,14,9,"PCPC",1
43,"43122",111,98,97,0,1,"PCPC",0
17,"17040",551,465,459,4,6,"PCPC",1
8,"8252",24729,19751,19642,125,109,"PCPC",19
17,"17062",5978,4358,4334,26,24,"PCPC",3
25,"25111",113,90,89,0,1,"PCPC",0
43,"43071",891,713,706,6,7,"PCPC",0
43,"43001",694,543,543,5,0,"PCPC",0
43,"43066",155,121,121,1,0,"PCPC",0
25,"25077",440,331,330,1,1,"PCPC",0
8,"8120",7048,5892,5881,49,11,"PCPC",0
8,"8226",926,811,807,1,4,"PCPC",1
17,"17054",347,271,271,0,0,"PCPC",0
17,"17175",564,381,381,1,0,"PCPC",2
17,"17029",199,160,157,1,3,"PCPC",0
8,"8076",16497,12734,12667,82,67,"PCPC",11
8,"8250",7182,5461,5421,38,40,"PCPC",7
8,"8228",288,239,239,2,0,"PCPC",0
25,"25015",335,262,260,8,2,"PCPC",0
8,"8227",2410,1882,1877,10,5,"PCPC",1
8,"8136",11614,9159,9079,84,80,"PCPC",3
25,"25204",1191,936,930,5,6,"PCPC",0
25,"25038",1482,1111,1094,11,17,"PCPC",0
43,"43100",3489,2820,2816,15,4,"PCPC",0
8,"8215",2589,2044,2034,19,10,"PCPC",1
17,"17902",1306,1076,1074,3,2,"PCPC",0
8,"8206",737,625,624,3,1,"PCPC",0
17,"17075",334,282,281,5,1,"PCPC",0
8,"8008",179,139,138,0,1,"PCPC",0
17,"17136",195,156,155,0,1,"PCPC",0
25,"25913",86,77,77,0,0,"PCPC",0
8,"8306",527,390,388,2,2,"PCPC",2
43,"43040",326,278,276,0,2,"PCPC",0
25,"25167",226,185,185,2,0,"PCPC",0
25,"25042",208,160,160,1,0,"PCPC",0
8,"8035",12871,9574,9538,31,36,"PCPC",9
17,"17151",185,150,150,1,0,"PCPC",0
43,"43907",4359,3370,3346,22,24,"PCPC",2
43,"43112",250,204,204,1,0,"PCPC",1
17,"17171",172,143,141,0,2,"PCPC",0
43,"43143",51,45,44,0,1,"PCPC",0
25,"25092",127,101,99,1,2,"PCPC",0
43,"43154",126,111,111,0,0,"PCPC",0
17,"17048",6251,4565,4537,20,28,"PCPC",6
25,"25226",242,184,183,4,1,"PCPC",0
8,"8082",1143,868,861,4,7,"PCPC",0
43,"43084",521,424,423,2,1,"PCPC",0
43,"43052",934,765,756,2,9,"PCPC",0
8,"8024",357,301,298,1,3,"PCPC",0
25,"25146",221,172,170,3,2,"PCPC",0
8,"8214",6966,5648,5633,21,15,"PCPC",4
8,"8267",6748,5389,5362,28,27,"PCPC",1
8,"8126",8865,7125,7098,33,27,"PCPC",4
43,"43017",116,98,98,1,0,"PCPC",1
25,"25052",1562,1273,1264,3,9,"PCPC",2
25,"25220",994,822,816,3,6,"PCPC",0
17,"17095",19938,13998,13918,69,80,"PCPC",22
17,"17081",248,192,190,0,2,"PCPC",0
43,"43050",2634,1881,1868,13,13,"PCPC",2
8,"8162",2124,1659,1651,7,8,"PCPC",0
8,"8248",5616,4378,4365,32,13,"PCPC",3
43,"43163",26013,18942,18796,89,146,"PCPC",9
17,"17126",318,279,279,0,0,"PCPC",0
25,"25072",5874,4468,4450,24,18,"PCPC",1
43,"43062",259,223,220,2,3,"PCPC",0
8,"8023",6915,5339,5299,26,40,"PCPC",3
8,"8101",174954,129953,129198,680,755,"PCPC",116
43,"43149",684,533,533,4,0,"PCPC",0
25,"25010",196,156,155,2,1,"PCPC",0
8,"8293",228,187,187,1,0,"PCPC",0
8,"8257",103,86,86,1,0,"PCPC",0
17,"17222",105,95,95,1,0,"PCPC",0
17,"17076",122,101,100,1,1,"PCPC",0
25,"25051",1510,1176,1172,6,4,"PCPC",0
17,"17003",102,75,75,0,0,"PCPC",0
8,"8188",115,95,95,0,0,"PCPC",0
25,"25141",152,118,118,1,0,"PCPC",0
8,"8087",149,135,133,0,2,"PCPC",0
17,"17124",1599,1258,1254,6,4,"PCPC",2
43,"43902",2743,1996,1980,16,16,"PCPC",4
17,"17181",3467,2664,2648,10,16,"PCPC",2
8,"8091",5413,4301,4283,20,18,"PCPC",3
25,"25177",358,270,268,1,2,"PCPC",0
8,"8290",1534,1289,1284,9,5,"PCPC",2
25,"25002",467,357,356,2,1,"PCPC",1
25,"25009",605,505,491,5,14,"PCPC",0
8,"8105",9724,7557,7505,49,52,"PCPC",8
17,"17152",11026,7610,7564,70,46,"PCPC",4
17,"17210",580,449,445,2,4,"PCPC",0
8,"8050",136,115,114,0,1,"PCPC",0
8,"8128",577,454,451,0,3,"PCPC",1
25,"25027",977,765,763,4,2,"PCPC",0
17,"17146",3127,2404,2381,11,23,"PCPC",3
25,"25136",96,79,79,2,0,"PCPC",0
8,"8244",6041,4994,4970,33,24,"PCPC",3
17,"17001",580,459,454,3,5,"PCPC",0
8,"8230",7666,6202,6168,30,34,"PCPC",3
8,"8241",69,56,56,0,0,"PCPC",0
43,"43007",640,510,509,0,1,"PCPC",0
25,"25001",139,104,103,1,1,"PCPC",0
8,"8080",39,30,30,0,0,"PCPC",0
25,"25151",736,592,584,1,8,"PCPC",0
25,"25910",91,70,67,2,3,"PCPC",0
8,"8187",153380,120687,120090,637,597,"PCPC",74
17,"17055",143,126,125,0,1,"PCPC",0
25,"25058",4358,3269,3254,7,15,"PCPC",0
17,"17147",7959,6164,6130,45,34,"PCPC",9
17,"17105",247,194,194,1,0,"PCPC",0
43,"43128",905,751,747,4,4,"PCPC",0
25,"25022",107,88,88,0,0,"PCPC",0
17,"17058",170,139,139,0,0,"PCPC",0
17,"17141",6072,4251,4221,14,30,"PCPC",3
43,"43081",633,532,531,7,1,"PCPC",0
8,"8156",11155,8956,8923,60,33,"PCPC",2
17,"17009",4051,3263,3248,14,15,"PCPC",5
17,"17063",173,157,156,2,1,"PCPC",0
17,"17184",1264,1068,1060,5,8,"PCPC",1
8,"8044",4136,3193,3175,11,18,"PCPC",7
43,"43120",421,302,297,2,5,"PCPC",0
25,"25086",521,414,411,2,3,"PCPC",1
8,"8102",28794,22420,22317,92,103,"PCPC",5
43,"43166",1628,1292,1285,3,7,"PCPC",3
8,"8021",61,47,45,0,2,"PCPC",0
43,"43091",123,93,93,1,0,"PCPC",0
8,"8178",451,389,388,3,1,"PCPC",0
17,"17004",533,445,441,3,4,"PCPC",1
8,"8301",49135,38575,38398,272,177,"PCPC",27
17,"17032",1742,1235,1224,6,11,"PCPC",0
25,"25903",229,189,188,0,1,"PCPC",0
17,"17223",800,623,616,5,7,"PCPC",2
43,"43020",2276,1831,1819,12,12,"PCPC",1
8,"8903",197,177,176,0,1,"PCPC",0
25,"25157",162,137,137,4,0,"PCPC",0
8,"8179",611,496,493,2,3,"PCPC",1
17,"17024",285,228,227,0,1,"PCPC",0
8,"8083",1672,1478,1471,7,7,"PCPC",0
8,"8158",3108,2458,2453,13,5,"PCPC",0
17,"17033",5587,4157,4130,13,27,"PCPC",7
43,"43058",96,77,77,0,0,"PCPC",0
43,"43070",238,194,193,1,1,"PCPC",1
8,"8015",156003,117736,117183,704,553,"PCPC",81
17,"17153",188,162,162,0,0,"PCPC",0
43,"43133",5605,4202,4168,21,34,"PCPC",2
25,"25007",1392,1089,1083,4,6,"PCPC",1
17,"17214",723,584,580,7,4,"PCPC",0
43,"43117",143,114,113,0,1,"PCPC",0
25,"25048",1632,1274,1264,7,10,"PCPC",3
25,"25148",219,168,168,1,0,"PCPC",0
25,"25122",1925,1505,1497,23,8,"PCPC",1
8,"8274",4674,3710,3698,12,12,"PCPC",1
43,"43032",466,379,379,1,0,"PCPC",0
25,"25189",2164,1591,1583,11,8,"PCPC",0
8,"8216",25,19,19,0,0,"PCPC",0
8,"8168",394,287,287,1,0,"PCPC",0
17,"17092",3467,2660,2633,17,27,"PCPC",3
8,"8002",220,184,183,2,1,"PCPC",0
8,"8027",720,592,588,3,4,"PCPC",1
43,"43172",337,261,257,2,4,"PCPC",1
8,"8266",43383,35117,34994,178,123,"PCPC",18
8,"8160",316,252,247,2,5,"PCPC",0
8,"8052",139,111,110,0,1,"PCPC",1
43,"43145",4209,3409,3391,9,18,"PCPC",0
43,"43003",350,266,264,3,2,"PCPC",0
25,"25030",123,90,90,1,0,"PCPC",0
43,"43126",1211,1005,999,4,6,"PCPC",1
43,"43905",14941,10510,10446,40,64,"PCPC",7
17,"17117",14471,10565,10504,52,61,"PCPC",10
17,"17168",379,332,329,0,3,"PCPC",0
17,"17188",169,139,138,1,1,"PCPC",0
8,"8060",135,111,109,0,2,"PCPC",0
8,"8134",842,649,646,3,3,"PCPC",0
8,"8054",9155,7468,7428,43,40,"PCPC",4
25,"25139",491,390,388,3,2,"PCPC",0
17,"17178",1056,804,798,3,6,"PCPC",0
43,"43127",759,630,626,3,4,"PCPC",0
8,"8192",5679,4605,4589,20,16,"PCPC",2
25,"25078",1001,807,805,5,2,"PCPC",2
25,"25210",1079,867,853,4,14,"PCPC",0
25,"25112",268,214,212,2,2,"PCPC",2
17,"17123",345,304,303,4,1,"PCPC",0
25,"25907",497,389,386,2,3,"PCPC",0
25,"25039",261,216,216,1,0,"PCPC",1
8,"8121",87292,67638,67328,362,310,"PCPC",39
17,"17018",494,405,402,1,3,"PCPC",1
25,"25085",141,118,117,2,1,"PCPC",0
8,"8057",61,50,50,0,0,"PCPC",0
25,"25069",425,329,327,1,2,"PCPC",0
8,"8219",15629,12910,12865,58,45,"PCPC",5
8,"8251",5127,3972,3940,17,32,"PCPC",3
25,"25029",1607,1270,1265,6,5,"PCPC",2
25,"25079",285,228,227,0,1,"PCPC",0
17,"17044",6930,5514,5493,26,21,"PCPC",3
43,"43029",314,253,252,0,1,"PCPC",0
17,"17119",73,58,58,2,0,"PCPC",0
8,"8078",219,176,172,1,4,"PCPC",0
25,"25134",603,492,490,1,2,"PCPC",0
25,"25101",543,454,449,1,5,"PCPC",0
17,"17038",380,312,308,3,4,"PCPC",0
8,"8130",108,89,86,2,3,"PCPC",1
43,"43177",284,243,242,0,1,"PCPC",1
25,"25248",880,714,713,4,1,"PCPC",0
17,"17212",142,117,117,2,0,"PCPC",1
17,"17089",5695,4211,4194,13,17,"PCPC",3
8,"8011",1745,1414,1407,10,7,"PCPC",0
8,"8140",4778,3756,3737,19,19,"PCPC",1
8,"8157",8547,6949,6918,39,31,"PCPC",99
8,"8131",741,585,585,4,0,"PCPC",0
25,"25165",276,221,219,1,2,"PCPC",0
17,"17061",183,148,148,0,0,"PCPC",0
17,"17121",229,184,184,1,0,"PCPC",0
8,"8086",14017,10746,10677,89,69,"PCPC",5
25,"25135",1000,773,769,2,4,"PCPC",0
43,"43072",93,74,74,0,0,"PCPC",0
25,"25100",184,145,144,1,1,"PCPC",1
8,"8239",460,380,378,2,2,"PCPC",0
17,"17182",272,220,220,3,0,"PCPC",0
25,"25231",494,410,408,2,2,"PCPC",0
25,"25179",171,134,134,1,0,"PCPC",0
8,"8197",7896,6197,6174,28,23,"PCPC",2
8,"8189",122,106,106,0,0,"PCPC",0
25,"25142",365,300,299,2,1,"PCPC",0
8,"8106",7469,5816,5795,34,21,"PCPC",2
43,"43105",156,132,132,3,0,"PCPC",0
25,"25013",2108,1570,1557,12,13,"PCPC",6
8,"8195",76,69,69,0,0,"PCPC",0
43,"43048",763,614,609,7,5,"PCPC",0
8,"8104",653,516,516,2,0,"PCPC",0
25,"25192",724,564,558,4,6,"PCPC",0
17,"17150",1426,1199,1192,8,7,"PCPC",0
8,"8263",21151,16360,16269,116,91,"PCPC",12
25,"25228",3115,2468,2459,19,9,"PCPC",1
8,"8113",52518,39750,39592,198,158,"PCPC",26
43,"43024",1556,1154,1137,3,17,"PCPC",0
8,"8116",558,459,459,0,0,"PCPC",0
43,"43056",806,616,613,5,3,"PCPC",0
8,"8280",95,78,78,1,0,"PCPC",0
17,"17190",838,681,677,0,4,"PCPC",0
43,"43139",1999,1552,1539,10,13,"PCPC",2
43,"43065",382,308,304,1,4,"PCPC",0
43,"43140",2438,1847,1837,16,10,"PCPC",0
17,"17109",698,558,553,1,5,"PCPC",1
8,"8017",2827,2192,2182,16,10,"PCPC",1
17,"17165",634,516,512,3,4,"PCPC",0
17,"17102",548,439,435,3,4,"PCPC",0
8,"8142",139,126,126,1,0,"PCPC",0
25,"25190",257,215,215,0,0,"PCPC",1
25,"25145",76,66,66,1,0,"PCPC",0
43,"43074",1812,1419,1412,4,7,"PCPC",1
17,"17194",78,62,62,0,0,"PCPC",0
25,"25102",661,517,511,8,6,"PCPC",3
17,"17114",23269,17558,17474,91,84,"PCPC",35
17,"17129",144,120,120,1,0,"PCPC",0
8,"8233",1846,1485,1478,8,7,"PCPC",1
17,"17125",131,98,97,1,1,"PCPC",0
43,"43124",472,379,373,1,6,"PCPC",1
8,"8039",402,334,334,2,0,"PCPC",0
17,"17099",78,59,59,0,0,"PCPC",0
8,"8028",1088,783,780,2,3,"PCPC",3
17,"17192",146,121,120,0,1,"PCPC",1
17,"17180",8500,6462,6431,28,31,"PCPC",5
43,"43086",5263,4046,4021,17,25,"PCPC",4
8,"8118",17542,14101,14059,56,42,"PCPC",6
43,"43075",86,71,69,0,2,"PCPC",0
43,"43157",345,303,303,0,0,"PCPC",0
17,"17225",207,161,161,0,0,"PCPC",1
25,"25024",352,273,272,0,1,"PCPC",0
25,"25238",205,163,163,2,0,"PCPC",0
17,"17025",1170,972,967,6,5,"PCPC",3
8,"8007",6775,5447,5419,21,28,"PCPC",2
8,"8029",3560,3027,3019,13,8,"PCPC",1
17,"17071",1128,978,978,3,0,"PCPC",1
17,"17205",211,184,184,1,0,"PCPC",0
25,"25128",127,87,87,0,0,"PCPC",0
8,"8268",971,746,737,3,9,"PCPC",0
25,"25113",1116,912,908,8,4,"PCPC",0
25,"25233",285,231,229,2,2,"PCPC",0
25,"25216",241,199,199,2,0,"PCPC",0
25,"25250",330,261,258,1,3,"PCPC",0
43,"43904",2861,2083,2058,27,25,"PCPC",2
17,"17023",27144,20301,20146,120,155,"PCPC",20
8,"8245",77805,57956,57666,313,290,"PCPC",69
8,"8235",3829,3176,3167,14,9,"PCPC",1
8,"8154",701,587,586,5,1,"PCPC",0
25,"25205",562,451,447,7,4,"PCPC",0
43,"43118",425,357,356,0,1,"PCPC",0
17,"17086",1745,1223,1210,7,13,"PCPC",0
8,"8304",816,686,678,1,8,"PCPC",1
43,"43077",455,342,339,2,3,"PCPC",0
25,"25031",57,39,39,0,0,"PCPC",1
8,"8287",1057,877,871,7,6,"PCPC",0
43,"43156",3956,2993,2965,23,28,"PCPC",1
17,"17106",143,124,123,0,1,"PCPC",0
25,"25161",343,243,243,0,0,"PCPC",0
8,"8164",934,784,776,1,8,"PCPC",1
25,"25082",295,229,229,2,0,"PCPC",0
43,"43085",235,198,194,0,4,"PCPC",0
8,"8285",10321,8169,8120,52,49,"PCPC",1
43,"43042",2198,1820,1816,8,4,"PCPC",0
25,"25163",236,181,179,3,2,"PCPC",0
17,"17010",327,264,263,2,1,"PCPC",0
8,"8194",25674,17691,17585,115,106,"PCPC",123
43,"43021",345,270,269,3,1,"PCPC",0
8,"8210",4584,3455,3435,23,20,"PCPC",2
8,"8069",3280,2691,2680,17,11,"PCPC",1
17,"17078",336,252,251,3,1,"PCPC",1
43,"43173",99,80,78,0,2,"PCPC",0
17,"17107",269,221,219,2,2,"PCPC",0
43,"43013",4392,3341,3321,14,20,"PCPC",2
8,"8010",4207,3327,3304,13,23,"PCPC",2
8,"8153",559,460,458,2,2,"PCPC",0
25,"25180",228,176,174,1,2,"PCPC",0
43,"43136",10463,7789,7749,36,40,"PCPC",5
17,"17199",6955,5328,5308,23,20,"PCPC",2
17,"17068",246,194,193,0,1,"PCPC",0
43,"43103",905,746,740,8,6,"PCPC",0
25,"25230",1555,1221,1208,8,13,"PCPC",1
17,"17098",303,245,245,2,0,"PCPC",0
17,"17170",180,147,147,2,0,"PCPC",0
25,"25073",546,420,418,2,2,"PCPC",3
17,"17069",364,286,284,2,2,"PCPC",0
43,"43155",22619,16724,16624,101,100,"PCPC",19
8,"8193",984,792,790,5,2,"PCPC",0
43,"43104",1762,1410,1401,5,9,"PCPC",4
43,"43046",90,73,73,1,0,"PCPC",0
8,"8148",2334,1803,1794,6,9,"PCPC",2
25,"25209",1550,1192,1172,4,20,"PCPC",2
25,"25909",140,108,107,2,1,"PCPC",0
25,"25074",180,157,155,2,2,"PCPC",0
25,"25023",4527,3621,3601,23,20,"PCPC",0
17,"17110",1329,1064,1054,5,10,"PCPC",0
25,"25019",4646,3224,3199,22,25,"PCPC",1
8,"8097",1080,891,880,2,11,"PCPC",0
8,"8229",521,435,433,3,2,"PCPC",2
25,"25132",143,118,118,0,0,"PCPC",0
25,"25232",1356,1066,1061,2,5,"PCPC",3
25,"25034",2288,1733,1719,9,14,"PCPC",2
8,"8299",377,318,317,0,1,"PCPC",0
25,"25003",3721,2828,2815,19,13,"PCPC",10
8,"8221",12699,10571,10537,53,34,"PCPC",4
17,"17007",1752,1430,1422,2,8,"PCPC",1
8,"8262",6919,5090,5060,33,30,"PCPC",3
8,"8308",137,118,118,0,0,"PCPC",0
17,"17051",207,174,173,3,1,"PCPC",0
25,"25055",163,130,129,0,1,"PCPC",0
25,"25154",118,94,94,0,0,"PCPC",0
25,"25045",54,31,31,5,0,"PCPC",0
17,"17211",831,694,691,1,3,"PCPC",0
25,"25093",629,489,487,4,2,"PCPC",0
17,"17041",218,166,165,3,1,"PCPC",0
17,"17008",3594,2763,2741,16,22,"PCPC",0
25,"25032",67,53,53,0,0,"PCPC",0
25,"25089",97,72,71,1,1,"PCPC",0
25,"25014",249,203,200,2,3,"PCPC",0
8,"8098",2409,1916,1912,9,4,"PCPC",1
17,"17022",7008,5386,5354,22,32,"PCPC",2
8,"8014",2000,1578,1567,5,11,"PCPC",0
17,"17193",4312,3202,3179,15,23,"PCPC",3
8,"8081",353,299,297,2,2,"PCPC",0
25,"25911",424,332,331,1,1,"PCPC",0
25,"25056",213,163,163,3,0,"PCPC",0
43,"43054",2792,2145,2134,21,11,"PCPC",1
43,"43009",1391,1086,1078,3,8,"PCPC",3
8,"8005",6380,5122,5106,18,16,"PCPC",2
17,"17234",179,147,146,2,1,"PCPC",0
8,"8047",3737,2903,2876,16,27,"PCPC",0
25,"25902",542,449,439,3,10,"PCPC",1
8,"8074",11054,8273,8235,34,38,"PCPC",5
25,"25114",95,79,79,0,0,"PCPC",0
8,"8258",813,661,657,6,4,"PCPC",0
17,"17013",2774,2180,2173,15,7,"PCPC",1
25,"25057",214,162,161,0,1,"PCPC",0
25,"25224",126,98,98,0,0,"PCPC",0
25,"25068",531,402,399,6,3,"PCPC",0
43,"43164",306,228,228,0,0,"PCPC",0
17,"17166",547,460,459,2,1,"PCPC",0
17,"17204",596,461,460,2,1,"PCPC",0
25,"25156",784,608,605,4,3,"PCPC",1
43,"43108",1778,1374,1365,6,9,"PCPC",1
8,"8143",2719,2121,2109,10,12,"PCPC",0
43,"43178",1421,1118,1113,7,5,"PCPC",1
8,"8062",1004,829,826,11,3,"PCPC",2
43,"43094",2120,1659,1646,9,13,"PCPC",0
43,"43010",337,286,284,2,2,"PCPC",0
43,"43083",144,116,113,1,3,"PCPC",0
17,"17065",324,254,253,0,1,"PCPC",0
43,"43092",7235,5200,5174,21,26,"PCPC",5
25,"25115",801,638,637,4,1,"PCPC",0
25,"25047",972,784,781,8,3,"PCPC",1
43,"43125",890,700,698,12,2,"PCPC",0
25,"25017",232,184,181,0,3,"PCPC",0
17,"17135",395,309,307,0,2,"PCPC",0
17,"17116",354,283,282,0,1,"PCPC",0
8,"8093",24,20,20,0,0,"PCPC",0
17,"17015",12819,10133,10078,38,55,"PCPC",4
8,"8040",11004,8468,8431,24,37,"PCPC",98
17,"17138",845,650,646,0,4,"PCPC",4
8,"8225",94,81,81,1,0,"PCPC",0
17,"17206",155,118,115,0,3,"PCPC",0
17,"17176",123,110,110,1,0,"PCPC",0
17,"17026",543,450,449,4,1,"PCPC",1
25,"25046",407,349,347,1,2,"PCPC",0
8,"8905",2308,1943,1938,7,5,"PCPC",0
43,"43093",3884,2956,2933,14,23,"PCPC",0
17,"17006",1186,880,878,10,2,"PCPC",1
25,"25158",1606,1291,1277,5,14,"PCPC",0
17,"17187",625,530,529,4,1,"PCPC",0
25,"25150",165,136,133,0,3,"PCPC",0
43,"43134",273,224,223,5,1,"PCPC",0
43,"43158",77,61,61,1,0,"PCPC",0
8,"8217",25355,20935,20855,110,80,"PCPC",20
25,"25071",42,32,31,0,1,"PCPC",0
8,"8269",2712,2258,2250,19,8,"PCPC",1
8,"8137",274,232,229,0,3,"PCPC",0
17,"17036",2643,2076,2071,12,5,"PCPC",7
8,"8103",640,507,505,4,2,"PCPC",0
17,"17027",2866,2375,2364,8,11,"PCPC",2
25,"25206",250,189,188,2,1,"PCPC",0
8,"8296",1843,1520,1514,10,6,"PCPC",0
8,"8003",7183,5761,5742,39,19,"PCPC",1
43,"43028",2766,2007,1988,7,19,"PCPC",0
8,"8253",128,113,113,0,0,"PCPC",0
17,"17208",976,772,768,5,4,"PCPC",0
8,"8018",2551,1998,1984,6,14,"PCPC",7
17,"17118",12916,9521,9460,37,61,"PCPC",11
17,"17130",322,268,268,0,0,"PCPC",1
8,"8043",3378,2579,2569,20,10,"PCPC",1
17,"17028",297,238,237,1,1,"PCPC",0
8,"8183",4563,3628,3613,9,15,"PCPC",3
43,"43037",17902,12787,12695,63,92,"PCPC",8
8,"8066",1463,1185,1181,9,4,"PCPC",0
25,"25908",221,159,158,1,1,"PCPC",0
25,"25033",1121,899,890,5,9,"PCPC",1
43,"43095",2564,1995,1984,14,11,"PCPC",2
17,"17079",65381,50872,50631,242,241,"PCPC",47
8,"8070",266,232,232,0,0,"PCPC",0
8,"8184",54876,41661,41447,248,214,"PCPC",25
43,"43079",356,306,305,1,1,"PCPC",0
17,"17060",408,311,311,1,0,"PCPC",0
43,"43038",21861,16504,16406,112,98,"PCPC",6
25,"25244",362,296,294,2,2,"PCPC",0
8,"8165",1664,1315,1311,9,4,"PCPC",1
25,"25155",618,493,489,2,4,"PCPC",0
17,"17074",532,436,426,2,10,"PCPC",0
8,"8223",1886,1434,1425,4,9,"PCPC",1
43,"43169",450,396,396,3,0,"PCPC",0
17,"17120",820,604,598,3,6,"PCPC",0
8,"8166",962,753,745,7,8,"PCPC",1
43,"43129",4611,3528,3495,21,33,"PCPC",1
43,"43055",1988,1631,1622,7,9,"PCPC",2
8,"8238",14851,12472,12428,50,44,"PCPC",5
8,"8255",137,105,105,1,0,"PCPC",0
17,"17232",149,117,116,0,1,"PCPC",0
8,"8149",984,770,768,3,2,"PCPC",0
25,"25053",1092,879,873,8,6,"PCPC",0
8,"8132",361,281,281,2,0,"PCPC",0
8,"8176",161,132,131,2,1,"PCPC",0
17,"17111",958,772,771,3,1,"PCPC",1
25,"25212",224,195,195,2,0,"PCPC",0
8,"8089",34019,26317,26191,170,126,"PCPC",16
8,"8273",2353,1944,1934,9,10,"PCPC",2
8,"8033",13218,10480,10435,50,45,"PCPC",6
8,"8037",1930,1618,1610,10,8,"PCPC",1
8,"8247",980,832,828,3,4,"PCPC",0
8,"8212",491,406,402,1,4,"PCPC",0
25,"25166",172,137,136,1,1,"PCPC",0
8,"8291",4919,3865,3854,28,11,"PCPC",2
17,"17031",182,130,129,0,1,"PCPC",0
8,"8072",10699,8226,8193,45,33,"PCPC",1
25,"25124",157,114,114,0,0,"PCPC",0
25,"25219",149,118,118,1,0,"PCPC",0
43,"43016",3445,2628,2608,11,20,"PCPC",0
25,"25036",184,144,143,0,1,"PCPC",1
25,"25222",66,57,57,0,0,"PCPC",0
8,"8055",541,443,442,2,1,"PCPC",0
25,"25076",134,94,93,0,1,"PCPC",0
17,"17082",436,341,339,0,2,"PCPC",0
8,"8133",128,98,98,5,0,"PCPC",0
8,"8107",11900,9303,9187,43,116,"PCPC",9
43,"43090",1169,749,742,2,7,"PCPC",1
8,"8240",9453,7807,7776,21,31,"PCPC",9
8,"8205",61279,51629,51497,360,132,"PCPC",109
17,"17056",1766,1438,1433,9,5,"PCPC",0
25,"25240",1385,1116,1110,10,6,"PCPC",0
17,"17148",1531,1165,1153,4,12,"PCPC",0
8,"8196",19444,15361,15263,90,98,"PCPC",7
17,"17226",895,673,669,3,4,"PCPC",0
17,"17083",2961,2321,2300,12,21,"PCPC",2
43,"43148",90763,69756,69423,299,333,"PCPC",47
25,"25912",843,685,684,4,1,"PCPC",1
17,"17052",134,104,104,1,0,"PCPC",0
8,"8125",25485,19719,19627,101,92,"PCPC",28
43,"43107",383,308,308,1,0,"PCPC",0
25,"25099",1291,981,978,2,3,"PCPC",0
8,"8169",48284,37528,37326,218,202,"PCPC",24
25,"25191",321,248,244,3,4,"PCPC",0
17,"17043",167,135,134,0,1,"PCPC",0
8,"8161",11625,8521,8470,44,51,"PCPC",10
25,"25109",214,179,176,3,3,"PCPC",1
8,"8174",392,330,330,4,0,"PCPC",0
8,"8111",215,200,199,4,1,"PCPC",0
43,"43111",2098,1496,1483,8,13,"PCPC",0
17,"17189",1476,1278,1275,2,3,"PCPC",0
25,"25169",167,118,117,0,1,"PCPC",0
8,"8276",233,180,180,0,0,"PCPC",0
17,"17224",302,233,231,2,2,"PCPC",0
8,"8294",2063,1644,1643,10,1,"PCPC",0
8,"8092",3714,2912,2889,8,23,"PCPC",1
25,"25140",773,573,571,5,2,"PCPC",0
43,"43051",9092,6577,6502,26,75,"PCPC",2
17,"17157",124,107,107,0,0,"PCPC",0
8,"8180",27072,21218,21100,126,118,"PCPC",15
25,"25127",214,172,172,0,0,"PCPC",0
43,"43109",2704,1937,1922,16,15,"PCPC",1
8,"8198",4640,3713,3691,23,22,"PCPC",1
8,"8303",256,215,213,1,2,"PCPC",0
17,"17167",2609,2122,2102,14,20,"PCPC",2
8,"8171",2066,1607,1597,7,10,"PCPC",1
8,"8145",2701,2156,2144,7,12,"PCPC",3
25,"25049",155,113,111,0,2,"PCPC",0
43,"43142",1083,850,842,8,8,"PCPC",1
17,"17197",131,113,113,1,0,"PCPC",0
17,"17101",562,415,413,2,2,"PCPC",0
8,"8222",1819,1484,1476,11,8,"PCPC",1
17,"17164",3932,3078,3054,8,24,"PCPC",2
17,"17128",316,255,252,1,3,"PCPC",0
8,"8211",33731,27698,27561,126,137,"PCPC",19
25,"25096",888,663,661,2,2,"PCPC",0
25,"25193",767,614,606,6,8,"PCPC",2
43,"43096",98,82,82,0,0,"PCPC",0
17,"17201",143,120,120,0,0,"PCPC",0
43,"43044",3949,3060,3032,31,28,"PCPC",1
8,"8053",2865,2105,2098,17,7,"PCPC",0
8,"8151",448,378,377,2,1,"PCPC",0
17,"17016",719,584,581,1,3,"PCPC",0
25,"25242",689,539,531,0,8,"PCPC",1
25,"25172",1779,1407,1405,3,2,"PCPC",0
43,"43102",463,384,379,2,5,"PCPC",0
43,"43047",4209,2878,2856,23,22,"PCPC",0
43,"43138",2648,1926,1896,8,30,"PCPC",1
43,"43031",1446,1180,1178,7,2,"PCPC",1
25,"25175",176,135,135,1,0,"PCPC",0
17,"17096",164,113,113,1,0,"PCPC",0
25,"25050",3269,2457,2446,23,11,"PCPC",2
17,"17169",2497,2047,2042,8,5,"PCPC",1
25,"25121",635,436,429,1,7,"PCPC",3
17,"17198",433,332,329,0,3,"PCPC",0
43,"43008",307,202,200,1,2,"PCPC",0
8,"8254",1753,1485,1482,3,3,"PCPC",0
17,"17209",615,519,517,2,2,"PCPC",0
25,"25196",112,94,93,0,1,"PCPC",0
8,"8112",12935,9822,9765,74,57,"PCPC",6
17,"17097",199,172,170,1,2,"PCPC",0
25,"25208",333,252,249,0,3,"PCPC",1
8,"8061",1590,1236,1233,8,3,"PCPC",0
25,"25173",1649,1278,1262,5,16,"PCPC",0
8,"8289",4457,3605,3594,20,11,"PCPC",0
17,"17088",578,468,468,1,0,"PCPC",0
8,"8246",1672,1412,1406,7,6,"PCPC",0
17,"17132",1333,1088,1080,9,8,"PCPC",0
25,"25011",5260,3908,3871,30,37,"PCPC",7
8,"8208",5760,4660,4643,25,17,"PCPC",1
17,"17216",155,127,124,0,3,"PCPC",0
25,"25081",287,221,220,2,1,"PCPC",0
43,"43131",4772,3432,3401,18,31,"PCPC",1
17,"17174",162,132,132,4,0,"PCPC",1
8,"8237",1662,1334,1327,7,7,"PCPC",0
43,"43063",536,401,397,1,4,"PCPC",0
8,"8099",753,565,561,2,4,"PCPC",2
8,"8073",62572,48770,48527,255,243,"PCPC",58
8,"8088",12248,9945,9904,57,41,"PCPC",7
43,"43025",590,476,472,0,4,"PCPC",0
43,"43161",17113,12944,12881,64,63,"PCPC",6
25,"25255",395,321,318,2,3,"PCPC",0
17,"17143",144,115,115,0,0,"PCPC",0
25,"25221",117,92,92,0,0,"PCPC",0
25,"25063",95,61,61,0,0,"PCPC",0
8,"8302",9373,7001,6934,61,67,"PCPC",2
43,"43116",463,381,379,2,2,"PCPC",0
43,"43175",537,426,419,5,7,"PCPC",0
8,"8270",18837,14541,14497,66,44,"PCPC",5
43,"43012",3647,3028,3019,15,9,"PCPC",1
8,"8203",2472,1884,1873,4,11,"PCPC",3
8,"8019",1117818,875679,872180,4327,3499,"PCPC",674
43,"43089",281,209,208,0,1,"PCPC",0
8,"8256",691,571,568,3,3,"PCPC",0
17,"17050",674,585,582,5,3,"PCPC",0
8,"8065",1180,967,964,4,3,"PCPC",1
17,"17202",3813,2876,2851,8,25,"PCPC",1
25,"25201",110,89,89,0,0,"PCPC",0
8,"8231",21132,15940,15880,75,60,"PCPC",14
25,"25247",147,100,100,2,0,"PCPC",0
25,"25143",84,72,71,0,1,"PCPC",0
17,"17073",1939,1695,1693,7,2,"PCPC",1
25,"25176",307,262,259,1,3,"PCPC",0
8,"8046",13478,10989,10939,67,50,"PCPC",4
17,"17183",255,216,216,0,0,"PCPC",0
25,"25170",261,230,228,4,2,"PCPC",1
17,"17012",1171,916,914,10,2,"PCPC",1
17,"17173",182,156,156,0,0,"PCPC",3
25,"25125",389,303,300,1,3,"PCPC",2
43,"43057",38,31,31,1,0,"PCPC",0
25,"25202",108,75,75,0,0,"PCPC",0
8,"8124",37130,29069,28915,146,154,"PCPC",19
8,"8163",19497,14616,14548,67,68,"PCPC",4
8,"8119",6838,5352,5326,31,26,"PCPC",2
25,"25105",103,89,88,1,1,"PCPC",0
43,"43115",128,112,111,1,1,"PCPC",0
25,"25149",1378,1108,1102,3,6,"PCPC",1
8,"8122",1716,1260,1254,8,6,"PCPC",0
25,"25037",366,286,284,3,2,"PCPC",0
8,"8307",49310,38223,38022,162,201,"PCPC",17
8,"8902",3937,3176,3164,17,12,"PCPC",0
17,"17049",3204,2634,2615,9,19,"PCPC",4
17,"17090",544,469,468,0,1,"PCPC",0
43,"43132",363,292,291,2,1,"PCPC",0
43,"43041",228,179,177,3,2,"PCPC",0
25,"25218",86,79,79,0,0,"PCPC",0
43,"43151",109,98,98,0,0,"PCPC",0
25,"25044",178,145,144,6,1,"PCPC",0
43,"43097",399,341,341,1,0,"PCPC",0
8,"8059",344,292,290,2,2,"PCPC",0
17,"17227",139,106,106,0,0,"PCPC",0
8,"8236",1557,1204,1202,2,2,"PCPC",0
43,"43082",351,303,297,1,6,"PCPC",0
25,"25215",505,299,299,4,0,"PCPC",1
8,"8170",442,338,338,0,0,"PCPC",0
8,"8129",484,406,405,3,1,"PCPC",0
25,"25207",6430,4899,4867,41,32,"PCPC",5
8,"8138",4432,3435,3413,10,22,"PCPC",3
43,"43160",1322,1051,1045,0,6,"PCPC",1
43,"43067",528,450,445,1,5,"PCPC",0
43,"43059",250,214,214,1,0,"PCPC",0
25,"25118",327,241,239,2,2,"PCPC",0
43,"43903",2333,1717,1700,11,17,"PCPC",0
8,"8144",713,565,563,5,2,"PCPC",0
8,"8147",17282,13644,13560,94,84,"PCPC",10
8,"8271",67,57,57,0,0,"PCPC",0
8,"8067",5728,4535,4513,21,22,"PCPC",6
17,"17085",291,248,246,0,2,"PCPC",0
25,"25119",2245,1798,1792,10,6,"PCPC",0
25,"25094",139,116,116,0,0,"PCPC",0
8,"8904",10514,7733,7697,38,36,"PCPC",9
17,"17196",242,198,198,1,0,"PCPC",0
8,"8117",2480,2055,2050,16,5,"PCPC",1
17,"17203",165,135,135,0,0,"PCPC",0
8,"8038",1525,1228,1220,2,8,"PCPC",0
8,"8295",11184,8566,8529,43,37,"PCPC",4
8,"8079",334,284,282,0,2,"PCPC",0
8,"8109",208,184,183,0,1,"PCPC",0
25,"25012",2342,1748,1739,10,9,"PCPC",3
8,"8284",12482,8959,8887,41,72,"PCPC",6
17,"17133",1273,1048,1043,7,5,"PCPC",0
8,"8030",5209,4318,4305,16,13,"PCPC",0
17,"17217",353,312,311,1,1,"PCPC",0
8,"8261",2378,1821,1815,14,6,"PCPC",0
25,"25245",430,346,342,1,4,"PCPC",0
43,"43080",227,195,195,0,0,"PCPC",0
8,"8232",1786,1444,1434,9,10,"PCPC",1
43,"43121",591,463,462,0,1,"PCPC",0
8,"8042",2362,1910,1904,7,6,"PCPC",2
8,"8068",6878,5456,5437,25,19,"PCPC",4
8,"8191",5270,4176,4162,19,14,"PCPC",7
17,"17149",364,314,314,0,0,"PCPC",0
43,"43045",146,128,127,0,1,"PCPC",0
25,"25060",69,49,49,1,0,"PCPC",0
43,"43146",41,35,35,0,0,"PCPC",0
17,"17144",210,171,170,0,1,"PCPC",0
17,"17091",398,310,305,2,5,"PCPC",0
17,"17134",223,189,189,1,0,"PCPC",1
8,"8201",447,327,324,5,3,"PCPC",1
17,"17228",285,229,229,1,0,"PCPC",0
8,"8175",3368,2496,2486,16,10,"PCPC",0
25,"25021",2541,1891,1882,14,9,"PCPC",1
43,"43906",2103,1595,1587,14,8,"PCPC",0
8,"8115",3825,2994,2975,12,19,"PCPC",3
43,"43106",793,656,651,2,5,"PCPC",0
8,"8234",3373,2742,2734,25,8,"PCPC",2
25,"25197",141,109,108,0,1,"PCPC",1
8,"8034",784,648,646,1,2,"PCPC",0
8,"8013",1280,1040,1031,5,9,"PCPC",1
43,"43098",354,291,291,1,0,"PCPC",1
25,"25239",595,367,366,3,1,"PCPC",0
17,"17035",550,460,460,3,0,"PCPC",0
25,"25059",813,621,612,3,9,"PCPC",0
8,"8181",8061,6442,6402,28,40,"PCPC",2
25,"25070",811,677,675,4,2,"PCPC",0
8,"8199",651,542,542,4,0,"PCPC",0
43,"43110",251,184,184,1,0,"PCPC",0
17,"17064",326,263,261,2,2,"PCPC",2
43,"43076",460,378,377,2,1,"PCPC",3
8,"8108",5192,4204,4189,26,15,"PCPC",1
8,"8264",4535,3623,3613,13,10,"PCPC",0
17,"17162",156,114,111,1,3,"PCPC",0
8,"8185",197,172,171,2,1,"PCPC",0
8,"8012",1721,1340,1331,8,9,"PCPC",0
25,"25126",284,233,232,1,1,"PCPC",0
25,"25040",10614,7791,7734,58,57,"PCPC",8
43,"43015",119,101,101,0,0,"PCPC",0
17,"17191",166,145,144,2,1,"PCPC",0
17,"17039",1740,1385,1380,8,5,"PCPC",1
8,"8051",18437,14951,14887,85,64,"PCPC",10
43,"43167",384,334,333,2,1,"PCPC",0
25,"25075",131,102,102,0,0,"PCPC",0
43,"43039",105,85,85,0,0,"PCPC",0
17,"17172",457,352,349,1,3,"PCPC",0
17,"17005",460,336,331,0,5,"PCPC",0
25,"25097",84,72,72,1,0,"PCPC",0
43,"43135",341,283,280,4,3,"PCPC",0
17,"17207",2411,2006,1992,8,14,"PCPC",0
8,"8004",209,194,191,0,3,"PCPC",0
43,"43064",2017,1569,1558,9,11,"PCPC",2
43,"43073",84,68,67,0,1,"PCPC",0
43,"43114",375,306,305,0,1,"PCPC",0
43,"43034",468,393,393,0,0,"PCPC",0
25,"25164",357,264,261,4,3,"PCPC",0
8,"8283",6113,4832,4813,33,19,"PCPC",1
43,"43147",521,446,442,4,4,"PCPC",0
43,"43123",71092,53689,53369,241,320,"PCPC",24
8,"8058",1787,1357,1340,5,17,"PCPC",0
43,"43049",727,589,584,2,5,"PCPC",1
8,"8277",171,150,150,0,0,"PCPC",0
25,"25025",1378,996,983,8,13,"PCPC",0
8,"8275",248,223,222,1,1,"PCPC",0
17,"17145",1432,1113,1103,7,10,"PCPC",1
43,"43101",145,122,122,1,0,"PCPC",0
17,"17158",468,337,336,1,1,"PCPC",2
25,"25223",911,732,723,6,9,"PCPC",0
43,"43053",188,153,149,0,4,"PCPC",0
8,"8094",1586,1310,1306,10,4,"PCPC",0
25,"25153",192,152,150,1,2,"PCPC",0
17,"17161",1018,859,855,1,4,"PCPC",0
43,"43088",2026,1565,1562,9,3,"PCPC",1
25,"25087",56,49,49,0,0,"PCPC",0
8,"8085",976,812,811,2,1,"PCPC",0
17,"17021",122,98,98,0,0,"PCPC",0
25,"25200",323,253,252,0,1,"PCPC",1
17,"17084",231,181,180,1,1,"PCPC",0
17,"17220",805,673,665,2,8,"PCPC",1
17,"17159",626,487,483,1,4,"PCPC",0
25,"25043",801,613,606,1,7,"PCPC",0
17,"17233",2328,1924,1912,6,12,"PCPC",0
25,"25067",706,537,532,4,5,"PCPC",0
17,"17137",3467,2925,2912,15,13,"PCPC",3
8,"8305",27533,21656,21539,96,117,"PCPC",22
8,"8282",6711,5696,5677,27,19,"PCPC",2
43,"43170",878,706,704,7,2,"PCPC",0
17,"17002",564,491,488,3,3,"PCPC",0
43,"43152",434,357,356,0,1,"PCPC",0
17,"17186",3824,3115,3098,15,17,"PCPC",1
8,"8110",13592,10111,10058,50,53,"PCPC",7
43,"43144",1236,1025,1021,8,4,"PCPC",0
17,"17014",63,51,50,0,1,"PCPC",0
25,"25130",183,142,140,0,2,"PCPC",0
8,"8032",2087,1607,1598,9,9,"PCPC",0
25,"25182",1043,842,839,9,3,"PCPC",0
8,"8127",2240,1694,1683,13,11,"PCPC",0
43,"43027",164,137,137,0,0,"PCPC",0
8,"8286",2919,2210,2199,15,11,"PCPC",4
8,"8049",1320,981,977,5,4,"PCPC",0
43,"43043",3289,2624,2613,14,11,"PCPC",3
8,"8207",2014,1736,1730,9,6,"PCPC",0
8,"8278",4893,4034,4018,17,16,"PCPC",1
43,"43030",482,373,372,2,1,"PCPC",0
43,"43174",144,128,127,0,1,"PCPC",0
25,"25171",2127,1639,1630,8,9,"PCPC",1
8,"8243",156,139,139,0,0,"PCPC",0
17,"17154",99,84,83,0,1,"PCPC",0
8,"8297",135,111,111,1,0,"PCPC",0
8,"8001",9079,7383,7341,40,42,"PCPC",5
25,"25041",528,399,396,4,3,"PCPC",0
17,"17047",4968,3447,3429,22,18,"PCPC",3
43,"43113",397,325,323,2,2,"PCPC",0
8,"8036",163,134,133,0,1,"PCPC",0
43,"43162",4418,3467,3453,20,14,"PCPC",2
8,"8272",165,133,133,0,0,"PCPC",0
25,"25098",232,172,170,2,2,"PCPC",0
43,"43171",14705,11002,10956,62,46,"PCPC",12
17,"17067",697,581,578,4,3,"PCPC",1
8,"8041",10692,7805,7732,48,73,"PCPC",3
43,"43150",1238,1034,1026,6,8,"PCPC",1
43,"43176",746,588,586,7,2,"PCPC",1
8,"8159",14323,11399,11359,57,40,"PCPC",3
8,"8292",1062,835,831,3,4,"PCPC",0
17,"17103",5084,3575,3543,13,32,"PCPC",5
25,"25194",415,325,325,3,0,"PCPC",1
43,"43069",178,146,146,0,0,"PCPC",1
25,"25186",207,174,173,7,1,"PCPC",0
43,"43068",483,367,365,5,2,"PCPC",0
25,"25905",369,308,307,1,1,"PCPC",0
17,"17066",27323,18373,18269,98,104,"PCPC",24
8,"8026",193,161,161,1,0,"PCPC",0
8,"8045",71,52,49,0,3,"PCPC",0
25,"25253",145,122,121,0,1,"PCPC",0
8,"8279",155280,121081,120515,802,566,"PCPC",80
8,"8155",6960,5427,5390,39,37,"PCPC",6
25,"25906",210,157,155,0,2,"PCPC",0
8,"8200",62161,48645,48330,261,315,"PCPC",41
25,"25174",390,324,324,0,0,"PCPC",0
43,"43022",1435,1130,1123,8,7,"PCPC",0
17,"17030",650,479,477,4,2,"PCPC",0
8,"8114",18648,14251,14170,69,81,"PCPC",12
8,"8150",251,211,211,0,0,"PCPC",0
8,"8063",467,406,405,3,1,"PCPC",1
43,"43035",235,205,203,7,2,"PCPC",0
25,"25211",672,513,512,6,1,"PCPC",1
17,"17221",4152,3260,3247,11,13,"PCPC",4
17,"17100",195,157,154,0,3,"PCPC",1
8,"8300",5892,4912,4880,24,32,"PCPC",2
17,"17011",651,544,544,4,0,"PCPC",0
8,"8190",258,216,215,1,1,"PCPC",0
8,"8182",2892,2217,2204,18,13,"PCPC",0
17,"17195",342,296,295,3,1,"PCPC",0
8,"8071",241,200,200,0,0,"PCPC",0
17,"17163",2824,2358,2351,13,7,"PCPC",0
43,"43119",838,630,628,4,2,"PCPC",2
17,"17903",889,726,721,4,5,"PCPC",0
25,"25131",402,321,320,1,1,"PCPC",0
8,"8204",3115,2548,2534,22,14,"PCPC",3
25,"25110",2731,2121,2106,14,15,"PCPC",2
25,"25138",547,440,436,1,4,"PCPC",0
17,"17070",110,94,94,0,0,"PCPC",0
17,"17160",14733,10833,10766,43,67,"PCPC",6
25,"25252",557,424,422,4,2,"PCPC",0
17,"17057",968,826,822,1,4,"PCPC",0
8,"8077",34578,27617,27501,134,116,"PCPC",15
25,"25129",159,115,115,2,0,"PCPC",0
25,"25123",189,151,151,0,0,"PCPC",0
8,"8298",26980,20900,20817,91,83,"PCPC",7
8,"8218",8104,6419,6389,34,30,"PCPC",6
25,"25104",122,91,91,0,0,"PCPC",0
8,"8167",6048,4833,4822,48,11,"PCPC",2
25,"25901",287,209,207,1,2,"PCPC",1
8,"8213",6547,5270,5245,23,25,"PCPC",4
25,"25061",80,59,58,0,1,"PCPC",0
8,"8090",137,113,113,2,0,"PCPC",1
25,"25088",95,85,83,0,2,"PCPC",0
43,"43901",8750,6057,6004,43,53,"PCPC",3
8,"8288",1676,1196,1182,6,14,"PCPC",3
43,"43168",84,65,65,1,0,"PCPC",0
8,"8025",1535,1221,1214,7,7,"PCPC",1
8,"8209",6896,5269,5244,25,25,"PCPC",5
8,"8064",1920,1516,1506,6,10,"PCPC",0
43,"43078",843,653,644,4,9,"PCPC",0
8,"8020",5172,4337,4327,26,10,"PCPC",0
8,"8901",240,203,201,1,2,"PCPC",0
43,"43159",81,63,62,0,1,"PCPC",0
25,"25183",535,419,416,4,3,"PCPC",2
17,"17112",194,154,152,2,2,"PCPC",0
17,"17140",639,539,527,4,12,"PCPC",0
43,"43005",3643,2765,2749,22,16,"PCPC",1
8,"8141",4573,3611,3595,26,16,"PCPC",1
8,"8177",39,31,31,0,0,"PCPC",0
43,"43130",177,145,145,0,0,"PCPC",0
17,"17087",222,177,176,0,1,"PCPC",0
25,"25243",3730,2637,2606,20,31,"PCPC",1
17,"17218",570,468,465,5,3,"PCPC",1
17,"17037",114,98,98,6,0,"PCPC",0
22,"22187",294,244,243,2,1,"PCPE",1
44,"44232",368,284,273,2,11,"PCPE",0
2,"2001",695,567,559,3,8,"PCPE",0
50,"50060",170,137,135,2,2,"PCPE",0
47,"47106",44,35,35,0,0,"PCPE",0
50,"50247",842,621,616,7,5,"PCPE",1
46,"46106",1466,1156,1142,3,14,"PCPE",3
30,"30027",49767,39111,38724,245,387,"PCPE",45
46,"46110",21317,15839,15699,89,140,"PCPE",17
2,"2009",19456,15229,15007,152,222,"PCPE",10
50,"50191",445,341,337,2,4,"PCPE",1
46,"46018",567,483,479,3,4,"PCPE",0
47,"47170",43,34,32,0,2,"PCPE",0
46,"46201",62,47,47,0,0,"PCPE",1
47,"47037",163,134,128,2,6,"PCPE",1
50,"50009",97,72,71,1,1,"PCPE",0
22,"22901",714,521,508,3,13,"PCPE",0
46,"46204",6657,5262,5204,27,58,"PCPE",6
47,"47165",6822,5456,5296,62,160,"PCPE",2
22,"22015",300,232,226,5,6,"PCPE",1
47,"47007",4036,3261,3217,25,44,"PCPE",1
44,"44158",1166,921,904,7,17,"PCPE",1
44,"44211",35,24,24,0,0,"PCPE",0
28,"28007",126831,103108,102202,710,906,"PCPE",64
28,"28120",1209,991,974,3,17,"PCPE",0
28,"28140",3139,2547,2523,12,24,"PCPE",1
50,"50272",13174,10143,10042,103,101,"PCPE",9
44,"44141",127,100,100,0,0,"PCPE",0
50,"50198",49,43,43,1,0,"PCPE",0
22,"22223",74,63,63,1,0,"PCPE",1
44,"44136",51,43,43,1,0,"PCPE",0
50,"50283",69,53,52,3,1,"PCPE",0
22,"22111",146,115,115,1,0,"PCPE",0
3,"3046",1619,1213,1190,17,23,"PCPE",0
46,"46216",5252,4291,4263,23,28,"PCPE",2
46,"46025",2455,2002,1981,6,21,"PCPE",1
2,"2023",515,442,435,1,7,"PCPE",0
50,"50159",641,527,526,8,1,"PCPE",0
50,"50074",6166,4547,4444,33,103,"PCPE",6
22,"22052",885,708,702,6,6,"PCPE",0
47,"47066",1407,1131,1122,11,9,"PCPE",1
3,"3115",255,222,221,2,1,"PCPE",0
50,"50157",286,226,220,0,6,"PCPE",0
28,"28163",429,361,345,4,16,"PCPE",0
44,"44044",83,65,64,2,1,"PCPE",0
50,"50163",3787,3041,3022,31,19,"PCPE",2
2,"2027",283,239,238,3,1,"PCPE",1
46,"46233",3781,2901,2847,22,54,"PCPE",0
47,"47039",166,134,134,0,0,"PCPE",0
22,"22220",150,120,117,0,3,"PCPE",1
28,"28901",868,653,639,6,14,"PCPE",0
46,"46130",857,680,669,6,11,"PCPE",0
46,"46255",3209,2415,2381,18,34,"PCPE",6
50,"50003",119,95,95,1,0,"PCPE",0
50,"50087",29,18,18,0,0,"PCPE",0
47,"47216",114,102,98,0,4,"PCPE",0
44,"44008",1565,1158,1138,8,20,"PCPE",1
39,"39101",236,173,171,1,2,"PCPE",0
46,"46155",993,785,772,2,13,"PCPE",0
44,"44224",21,15,15,0,0,"PCPE",0
22,"22175",184,139,137,1,2,"PCPE",1
28,"28090",9128,7590,7516,54,74,"PCPE",4
28,"28016",78,62,61,1,1,"PCPE",0
44,"44113",72,51,50,0,1,"PCPE",1
22,"22239",88,71,71,0,0,"PCPE",0
28,"28123",61103,52177,51832,338,345,"PCPE",31
39,"39028",3870,3131,3094,19,37,"PCPE",3
47,"47223",152,123,120,2,3,"PCPE",0
2,"2002",435,358,352,2,6,"PCPE",0
50,"50224",65,54,54,1,0,"PCPE",0
28,"28035",1394,1057,1043,3,14,"PCPE",1
44,"44155",1056,830,813,9,17,"PCPE",0
3,"3110",312,271,269,1,2,"PCPE",2
28,"28038",5155,4142,4090,20,52,"PCPE",1
22,"22162",129,99,99,0,0,"PCPE",0
2,"2017",777,588,584,0,4,"PCPE",0
46,"46142",761,580,565,4,15,"PCPE",0
44,"44047",229,125,124,2,1,"PCPE",0
3,"3058",4967,4031,3967,24,64,"PCPE",8
50,"50037",127,93,93,0,0,"PCPE",0
46,"46072",3542,3008,2961,33,47,"PCPE",3
50,"50273",32,24,24,0,0,"PCPE",0
50,"50055",3627,2627,2571,41,56,"PCPE",1
46,"46103",1338,1056,1042,5,14,"PCPE",0
47,"47199",71,59,59,3,0,"PCPE",0
44,"44118",158,126,122,1,4,"PCPE",0
3,"3002",3631,2841,2801,16,40,"PCPE",9
46,"46088",150,129,127,0,2,"PCPE",0
44,"44144",325,249,247,1,2,"PCPE",0
44,"44191",722,567,561,7,6,"PCPE",2
50,"50215",20,18,18,0,0,"PCPE",0
50,"50262",1163,930,912,15,18,"PCPE",0
22,"22214",118,98,97,1,1,"PCPE",0
3,"3031",41857,28648,28362,163,286,"PCPE",41
47,"47028",30,17,17,0,0,"PCPE",1
22,"22080",264,208,202,2,6,"PCPE",0
50,"50189",678,544,534,5,10,"PCPE",0
22,"22063",159,133,132,2,1,"PCPE",0
50,"50015",81,61,59,1,2,"PCPE",0
46,"46125",846,681,675,1,6,"PCPE",0
46,"46035",6855,5500,5422,34,78,"PCPE",3
47,"47101",1644,1354,1337,9,17,"PCPE",1
39,"39081",437,356,347,2,9,"PCPE",0
30,"30032",2851,2256,2218,14,38,"PCPE",1
47,"47164",350,290,286,2,4,"PCPE",0
28,"28004",6564,4798,4767,26,31,"PCPE",0
44,"44174",409,306,300,3,6,"PCPE",0
47,"47091",74,64,63,1,1,"PCPE",0
50,"50034",787,568,556,3,12,"PCPE",0
50,"50026",421,340,328,4,12,"PCPE",3
28,"28127",66441,56199,55932,327,267,"PCPE",12
44,"44129",36,29,29,0,0,"PCPE",0
28,"28178",1134,949,935,1,14,"PCPE",0
47,"47054",613,501,498,0,3,"PCPE",0
22,"22049",74,63,63,0,0,"PCPE",0
47,"47232",100,76,76,1,0,"PCPE",0
3,"3071",3988,3125,3088,28,37,"PCPE",2
30,"30012",9069,7397,7266,53,131,"PCPE",3
50,"50101",832,625,614,1,11,"PCPE",1
28,"28037",1578,1196,1180,5,16,"PCPE",0
39,"39017",553,416,409,0,7,"PCPE",0
47,"47217",1973,1569,1541,19,28,"PCPE",2
22,"22172",520,412,407,3,5,"PCPE",1
2,"2067",1129,866,852,4,14,"PCPE",0
22,"22190",122,89,89,0,0,"PCPE",0
44,"44020",22,18,18,0,0,"PCPE",1
3,"3029",244,174,167,1,7,"PCPE",0
50,"50134",118,91,89,0,2,"PCPE",0
50,"50190",675,565,553,5,12,"PCPE",0
50,"50276",119,91,91,1,0,"PCPE",1
44,"44108",300,228,224,5,4,"PCPE",0
44,"44241",506,416,407,1,9,"PCPE",1
46,"46119",752,627,614,8,13,"PCPE",0
28,"28171",4382,3202,3134,11,68,"PCPE",0
50,"50212",32,29,29,1,0,"PCPE",0
46,"46039",2121,1730,1698,19,32,"PCPE",2
46,"46187",1304,991,982,8,9,"PCPE",1
28,"28052",3949,2890,2818,8,72,"PCPE",3
3,"3032",99,87,87,0,0,"PCPE",0
50,"50261",205,171,167,1,4,"PCPE",0
47,"47204",235,182,178,0,4,"PCPE",0
44,"44143",394,327,327,2,0,"PCPE",3
39,"39092",871,635,629,2,6,"PCPE",0
22,"22083",445,379,372,5,7,"PCPE",1
44,"44132",58,47,47,0,0,"PCPE",0
3,"3140",26027,19805,19438,230,367,"PCPE",22
46,"46023",328,277,269,1,8,"PCPE",0
46,"46181",16908,12749,12597,82,152,"PCPE",17
22,"22094",98,72,71,2,1,"PCPE",0
44,"44218",31,25,25,2,0,"PCPE",0
28,"28084",16103,12519,12378,82,141,"PCPE",9
44,"44055",77,58,56,0,2,"PCPE",0
44,"44145",972,741,732,11,9,"PCPE",2
50,"50184",90,79,79,0,0,"PCPE",0
28,"28137",1744,1385,1366,8,19,"PCPE",0
46,"46099",772,620,614,1,6,"PCPE",1
3,"3138",3183,2390,2359,16,31,"PCPE",5
22,"22106",20,15,15,0,0,"PCPE",0
46,"46210",344,265,258,2,7,"PCPE",1
47,"47009",99,84,84,0,0,"PCPE",0
28,"28118",61,52,51,0,1,"PCPE",0
28,"28113",36716,29939,29607,224,332,"PCPE",11
50,"50053",650,505,497,4,8,"PCPE",0
50,"50006",908,705,689,3,16,"PCPE",0
3,"3125",336,259,257,1,2,"PCPE",0
44,"44082",89,72,69,0,3,"PCPE",0
22,"22082",285,230,226,2,4,"PCPE",1
2,"2039",952,798,789,9,9,"PCPE",0
44,"44033",244,174,172,0,2,"PCPE",0
22,"22036",88,76,75,0,1,"PCPE",0
28,"28003",170,148,148,1,0,"PCPE",0
44,"44084",55,45,45,0,0,"PCPE",0
47,"47020",272,228,225,5,3,"PCPE",0
44,"44157",64,38,38,1,0,"PCPE",0
46,"46113",2527,1906,1892,12,14,"PCPE",0
50,"50204",2394,1876,1855,21,21,"PCPE",0
50,"50028",77,59,58,1,1,"PCPE",0
50,"50270",38,32,30,1,2,"PCPE",0
28,"28141",6246,4943,4890,44,53,"PCPE",2
3,"3009",46121,36093,35720,235,373,"PCPE",58
46,"46243",124,105,104,0,1,"PCPE",0
50,"50107",988,837,828,11,9,"PCPE",0
46,"46052",508,436,426,3,10,"PCPE",2
46,"46032",5692,4518,4476,22,42,"PCPE",6
2,"2034",1324,1088,1083,10,5,"PCPE",1
28,"28125",3216,2459,2444,11,15,"PCPE",2
47,"47083",83,66,65,1,1,"PCPE",0
47,"47116",403,321,320,3,1,"PCPE",0
44,"44039",202,166,165,3,1,"PCPE",0
22,"22039",805,667,662,5,5,"PCPE",1
22,"22129",163,117,116,0,1,"PCPE",0
46,"46084",1503,1225,1195,1,30,"PCPE",1
2,"2085",309,264,263,4,1,"PCPE",0
44,"44178",53,39,39,0,0,"PCPE",0
46,"46261",1709,1367,1340,14,27,"PCPE",0
22,"22188",76,60,59,1,1,"PCPE",0
22,"22047",241,213,212,2,1,"PCPE",2
28,"28013",41563,32024,31693,194,331,"PCPE",17
46,"46048",3509,2758,2720,11,38,"PCPE",7
3,"3101",4911,3827,3772,20,55,"PCPE",4
46,"46217",893,733,723,6,10,"PCPE",1
44,"44149",100,74,73,0,1,"PCPE",0
46,"46065",1576,1246,1228,6,18,"PCPE",2
47,"47003",204,171,168,4,3,"PCPE",0
47,"47150",259,206,202,0,4,"PCPE",0
28,"28036",2675,2135,2093,17,42,"PCPE",1
28,"28091",5474,4027,3977,26,50,"PCPE",1
50,"50180",106,84,84,1,0,"PCPE",0
28,"28063",254,203,202,2,1,"PCPE",0
46,"46259",462,395,394,2,1,"PCPE",0
28,"28017",1280,1017,1012,9,5,"PCPE",0
2,"2052",466,394,394,3,0,"PCPE",0
44,"44267",71,53,52,0,1,"PCPE",0
50,"50043",246,172,170,2,2,"PCPE",0
3,"3020",95,84,84,2,0,"PCPE",0
46,"46222",394,325,324,1,1,"PCPE",0
50,"50089",8584,6951,6912,34,39,"PCPE",6
50,"50176",222,161,156,3,5,"PCPE",0
50,"50122",67,55,54,0,1,"PCPE",0
50,"50111",183,144,142,2,2,"PCPE",0
39,"39037",2019,1572,1560,2,12,"PCPE",0
50,"50256",74,46,45,0,1,"PCPE",1
2,"2042",818,631,620,1,11,"PCPE",0
22,"22142",94,80,80,2,0,"PCPE",0
47,"47207",260,213,211,2,2,"PCPE",0
44,"44142",28,21,21,0,0,"PCPE",0
50,"50201",444,357,354,1,3,"PCPE",0
3,"3044",4557,3650,3600,17,50,"PCPE",2
47,"47055",192,157,154,1,3,"PCPE",0
22,"22904",761,581,566,2,15,"PCPE",1
39,"39095",2240,1809,1778,12,31,"PCPE",1
39,"39030",1895,1374,1358,6,16,"PCPE",1
50,"50081",491,390,384,5,6,"PCPE",0
44,"44258",53,44,44,0,0,"PCPE",0
50,"50120",55,43,43,2,0,"PCPE",0
3,"3135",192,157,155,0,2,"PCPE",0
22,"22066",748,576,567,6,9,"PCPE",0
46,"46169",32294,24909,24676,157,233,"PCPE",28
46,"46183",6028,4620,4534,29,86,"PCPE",4
44,"44125",65,50,50,0,0,"PCPE",0
3,"3039",89,70,70,0,0,"PCPE",1
28,"28106",78429,59182,58471,417,711,"PCPE",62
46,"46079",313,252,248,1,4,"PCPE",0
47,"47193",1609,1347,1332,9,15,"PCPE",1
22,"22199",6926,5113,5051,44,62,"PCPE",12
50,"50064",438,368,362,1,6,"PCPE",0
3,"3075",149,125,125,0,0,"PCPE",1
44,"44245",245,176,171,1,5,"PCPE",0
46,"46231",2401,1780,1770,8,10,"PCPE",6
28,"28061",22564,18245,18064,117,181,"PCPE",8
44,"44175",113,84,82,1,2,"PCPE",0
47,"47153",104,76,75,0,1,"PCPE",0
47,"47006",186,153,149,1,4,"PCPE",0
39,"39078",1406,1101,1090,7,11,"PCPE",3
3,"3109",2976,2375,2345,11,30,"PCPE",3
44,"44035",105,86,84,1,2,"PCPE",0
39,"39044",3868,3019,2985,8,34,"PCPE",2
46,"46170",3408,2769,2720,16,49,"PCPE",0
28,"28001",80,64,64,0,0,"PCPE",0
50,"50241",595,434,423,3,11,"PCPE",0
47,"47065",817,658,653,2,5,"PCPE",2
47,"47001",52,47,46,0,1,"PCPE",0
47,"47214",1364,1112,1074,7,38,"PCPE",0
22,"22023",389,313,305,6,8,"PCPE",0
50,"50117",125,100,100,3,0,"PCPE",0
50,"50147",751,564,559,3,5,"PCPE",1
22,"22184",168,142,139,2,3,"PCPE",0
28,"28181",20669,17314,17205,101,109,"PCPE",4
22,"22213",2923,2261,2221,24,40,"PCPE",3
30,"30002",9735,7319,7227,33,92,"PCPE",3
3,"3038",335,275,267,1,8,"PCPE",0
46,"46030",796,653,633,7,20,"PCPE",1
2,"2030",2978,2357,2315,13,42,"PCPE",3
44,"44115",102,96,95,0,1,"PCPE",0
50,"50002",125,96,91,1,5,"PCPE",0
44,"44080",284,214,212,1,2,"PCPE",0
46,"46903",6285,5035,4996,27,39,"PCPE",2
50,"50268",42,33,32,1,1,"PCPE",0
28,"28040",16648,11709,11551,66,158,"PCPE",13
46,"46213",15504,11420,11232,124,188,"PCPE",13
39,"39062",1841,1511,1500,9,11,"PCPE",0
39,"39050",255,188,184,2,4,"PCPE",0
44,"44206",103,83,82,0,1,"PCPE",0
22,"22130",10128,7355,7294,61,61,"PCPE",5
22,"22158",11951,8877,8801,69,76,"PCPE",14
47,"47069",118,96,92,1,4,"PCPE",0
3,"3069",3311,2356,2327,12,29,"PCPE",3
47,"47040",61,45,44,0,1,"PCPE",0
39,"39080",3505,2735,2701,8,34,"PCPE",0
22,"22242",63,47,45,1,2,"PCPE",0
44,"44156",46,36,33,1,3,"PCPE",0
46,"46133",472,374,374,2,0,"PCPE",0
28,"28162",2771,2264,2243,6,21,"PCPE",0
47,"47157",495,428,426,3,2,"PCPE",0
28,"28024",168,146,145,1,1,"PCPE",0
50,"50179",264,231,228,0,3,"PCPE",0
50,"50203",1057,849,837,9,12,"PCPE",0
39,"39070",123,101,99,0,2,"PCPE",0
28,"28086",5390,3992,3936,26,56,"PCPE",4
44,"44066",87,66,65,0,1,"PCPE",0
28,"28128",445,352,352,2,0,"PCPE",0
30,"30018",8326,6544,6438,25,106,"PCPE",5
46,"46131",49504,37495,37064,259,431,"PCPE",31
22,"22195",234,193,192,0,1,"PCPE",0
46,"46235",21270,15754,15592,101,162,"PCPE",10
47,"47062",157,134,134,0,0,"PCPE",0
44,"44107",205,159,158,0,1,"PCPE",0
44,"44199",39,39,38,5,1,"PCPE",0
22,"22075",119,87,87,1,0,"PCPE",1
47,"47052",6752,5665,5589,57,76,"PCPE",8
47,"47148",423,342,339,2,3,"PCPE",0
3,"3103",245,212,211,4,1,"PCPE",1
44,"44252",75,56,56,1,0,"PCPE",0
44,"44097",126,91,90,2,1,"PCPE",0
50,"50150",621,451,450,2,1,"PCPE",0
44,"44180",72,61,61,0,0,"PCPE",0
28,"28095",1677,1310,1293,4,17,"PCPE",1
50,"50234",242,194,187,3,7,"PCPE",1
28,"28129",8578,6925,6853,45,72,"PCPE",2
28,"28031",2140,1642,1614,11,28,"PCPE",0
30,"30013",7467,5621,5553,26,68,"PCPE",5
44,"44189",48,36,36,0,0,"PCPE",0
3,"3025",1292,1009,991,7,18,"PCPE",2
50,"50063",61,54,54,0,0,"PCPE",1
2,"2016",538,405,401,4,4,"PCPE",0
44,"44010",184,137,137,1,0,"PCPE",0
46,"46045",1243,1033,1018,3,15,"PCPE",9
50,"50266",121,85,80,0,5,"PCPE",0
47,"47160",392,317,314,2,3,"PCPE",0
22,"22232",87,66,65,2,1,"PCPE",0
46,"46096",257,220,217,0,3,"PCPE",1
47,"47044",323,282,279,1,3,"PCPE",0
47,"47191",115,85,84,0,1,"PCPE",0
44,"44050",3115,2333,2299,27,34,"PCPE",3
2,"2005",545,443,436,5,7,"PCPE",1
44,"44230",152,112,111,1,1,"PCPE",0
44,"44036",23,20,20,0,0,"PCPE",0
44,"44262",143,115,112,0,3,"PCPE",0
47,"47089",132,116,115,1,1,"PCPE",0
22,"22229",108,80,80,2,0,"PCPE",0
3,"3901",1109,827,820,5,7,"PCPE",0
46,"46144",628,511,505,1,6,"PCPE",0
50,"50077",206,158,157,1,1,"PCPE",0
44,"44161",430,320,316,1,4,"PCPE",0
46,"46249",9159,7113,7012,73,101,"PCPE",9
46,"46077",7344,5873,5761,49,112,"PCPE",13
2,"2031",541,432,425,0,7,"PCPE",0
50,"50258",53,33,33,3,0,"PCPE",0
50,"50083",84,70,68,0,2,"PCPE",0
22,"22043",93,68,67,1,1,"PCPE",0
50,"50286",75,58,55,0,3,"PCPE",0
46,"46027",932,769,755,1,14,"PCPE",0
22,"22028",362,284,282,5,2,"PCPE",0
46,"46199",5842,4451,4414,23,37,"PCPE",4
46,"46251",2442,2017,1976,9,41,"PCPE",0
47,"47142",124,94,92,0,2,"PCPE",1
44,"44215",168,121,120,1,1,"PCPE",0
47,"47098",556,480,475,4,5,"PCPE",1
3,"3035",632,529,525,2,4,"PCPE",8
22,"22227",199,155,154,1,1,"PCPE",0
47,"47194",292,245,243,1,2,"PCPE",1
46,"46143",4230,3255,3200,20,55,"PCPE",3
47,"47132",39,33,33,0,0,"PCPE",0
50,"50066",2835,2199,2177,19,22,"PCPE",3
47,"47163",280,238,232,2,6,"PCPE",0
50,"50183",319,242,241,4,1,"PCPE",0
28,"28169",1553,1280,1273,15,7,"PCPE",0
50,"50085",183,136,136,1,0,"PCPE",0
39,"39041",1767,1437,1417,18,20,"PCPE",2
50,"50175",924,713,710,9,3,"PCPE",5
50,"50146",190,152,149,0,3,"PCPE",0
47,"47027",2775,2246,2222,14,24,"PCPE",3
44,"44163",114,92,92,0,0,"PCPE",0
22,"22136",749,579,576,5,3,"PCPE",0
28,"28094",959,736,729,6,7,"PCPE",1
47,"47126",44,42,42,1,0,"PCPE",0
50,"50289",51,40,38,1,2,"PCPE",0
28,"28056",914,715,703,4,12,"PCPE",1
47,"47123",461,391,390,3,1,"PCPE",0
44,"44169",310,250,245,4,5,"PCPE",0
50,"50082",84,63,63,0,0,"PCPE",0
2,"2026",832,682,673,6,9,"PCPE",1
46,"46050",186,157,154,1,3,"PCPE",0
50,"50067",13788,10562,10413,107,149,"PCPE",8
46,"46009",3140,2582,2536,14,46,"PCPE",2
47,"47059",97,75,75,0,0,"PCPE",0
47,"47175",6704,5296,5222,52,74,"PCPE",6
47,"47145",586,446,440,2,6,"PCPE",0
46,"46172",5412,3878,3832,18,46,"PCPE",2
3,"3121",21787,15670,15453,81,217,"PCPE",14
28,"28012",918,727,711,6,16,"PCPE",1
22,"22125",39429,29988,29612,337,376,"PCPE",66
2,"2011",578,461,459,2,2,"PCPE",1
3,"3111",5565,4183,4149,29,34,"PCPE",3
50,"50243",311,252,247,1,5,"PCPE",0
39,"39079",8861,6827,6745,47,82,"PCPE",3
22,"22035",226,174,174,0,0,"PCPE",0
3,"3129",1218,994,982,5,12,"PCPE",1
3,"3028",964,804,795,6,9,"PCPE",2
50,"50011",116,100,99,0,1,"PCPE",0
22,"22029",119,103,103,0,0,"PCPE",0
3,"3100",496,402,395,2,7,"PCPE",0
44,"44056",457,352,341,4,11,"PCPE",0
46,"46224",154,124,124,2,0,"PCPE",1
50,"50069",67,44,44,0,0,"PCPE",0
28,"28034",370,284,280,0,4,"PCPE",0
3,"3019",15465,12156,11988,80,168,"PCPE",29
46,"46164",12073,8987,8836,63,151,"PCPE",7
22,"22127",529,434,432,4,2,"PCPE",2
3,"3059",20590,15909,15766,96,143,"PCPE",10
50,"50099",3042,2299,2265,20,34,"PCPE",0
46,"46904",805,643,628,13,15,"PCPE",2
44,"44229",143,110,108,4,2,"PCPE",0
22,"22067",71,52,52,0,0,"PCPE",0
3,"3113",4342,3194,3154,23,40,"PCPE",2
44,"44164",20,18,18,0,0,"PCPE",0
44,"44070",55,45,45,0,0,"PCPE",0
46,"46161",1472,1200,1172,7,28,"PCPE",2
3,"3037",341,289,284,1,5,"PCPE",1
2,"2006",561,482,480,2,2,"PCPE",1
47,"47093",797,628,615,6,13,"PCPE",2
3,"3102",7226,5600,5516,28,84,"PCPE",10
50,"50245",76,58,58,0,0,"PCPE",0
22,"22204",1119,836,832,9,4,"PCPE",2
39,"39026",1720,1322,1312,5,10,"PCPE",0
39,"39016",23868,19029,18839,108,190,"PCPE",27
46,"46195",1982,1562,1554,2,8,"PCPE",3
47,"47231",4458,3677,3651,47,26,"PCPE",2
28,"28174",1840,1363,1349,10,14,"PCPE",0
22,"22160",212,171,170,3,1,"PCPE",1
44,"44221",384,320,315,2,5,"PCPE",0
46,"46175",428,367,354,3,13,"PCPE",0
2,"2051",1665,1253,1222,6,31,"PCPE",0
39,"39091",1885,1512,1503,6,9,"PCPE",0
44,"44212",41,32,32,0,0,"PCPE",0
28,"28067",4361,3548,3509,14,39,"PCPE",1
22,"22157",183,136,134,1,2,"PCPE",1
47,"47222",86,71,71,0,0,"PCPE",0
46,"46126",5574,4565,4528,25,37,"PCPE",2
28,"28182",198,169,169,1,0,"PCPE",0
47,"47085",16381,12697,12540,129,157,"PCPE",11
44,"44181",66,58,57,0,1,"PCPE",0
39,"39064",1341,1103,1094,5,9,"PCPE",6
46,"46237",7148,5537,5472,36,65,"PCPE",3
47,"47074",141,122,122,2,0,"PCPE",0
50,"50132",771,589,576,2,13,"PCPE",1
46,"46207",6686,5220,5137,36,83,"PCPE",4
46,"46146",1641,1314,1281,11,33,"PCPE",0
47,"47013",90,80,78,4,2,"PCPE",0
50,"50024",556,427,426,6,1,"PCPE",1
22,"22003",132,114,114,0,0,"PCPE",0
28,"28133",6116,4581,4486,22,95,"PCPE",5
50,"50181",1000,770,754,7,16,"PCPE",1
44,"44068",643,518,511,9,7,"PCPE",0
46,"46019",8948,7150,7067,40,83,"PCPE",3
47,"47188",99,77,77,0,0,"PCPE",0
22,"22055",310,258,255,2,3,"PCPE",0
2,"2038",266,217,216,1,1,"PCPE",0
2,"2014",350,285,280,1,5,"PCPE",0
3,"3077",1374,1131,1114,9,17,"PCPE",3
46,"46208",1070,875,866,2,9,"PCPE",2
28,"28029",562,459,456,2,3,"PCPE",0
50,"50035",75,63,62,0,1,"PCPE",0
46,"46128",1581,1324,1287,2,37,"PCPE",1
39,"39067",759,582,575,3,7,"PCPE",1
39,"39039",546,431,428,0,3,"PCPE",0
28,"28124",59,52,52,0,0,"PCPE",0
39,"39011",1575,1249,1242,3,7,"PCPE",0
47,"47109",171,130,130,1,0,"PCPE",0
50,"50143",546,409,401,5,8,"PCPE",0
44,"44152",67,48,48,2,0,"PCPE",0
3,"3117",377,320,313,1,7,"PCPE",1
47,"47077",237,187,183,2,4,"PCPE",0
46,"46078",28394,20928,20748,156,180,"PCPE",28
3,"3065",169399,128218,127256,967,962,"PCPE",152
46,"46230",14084,10694,10599,67,95,"PCPE",11
28,"28030",1815,1438,1395,10,43,"PCPE",0
22,"22209",159,139,136,5,3,"PCPE",0
22,"22079",114,89,88,1,1,"PCPE",0
50,"50105",279,216,213,4,3,"PCPE",0
22,"22044",234,184,183,3,1,"PCPE",1
47,"47067",153,119,119,3,0,"PCPE",0
2,"2008",1123,857,842,9,15,"PCPE",1
2,"2045",3617,3020,2969,38,51,"PCPE",18
28,"28168",1329,976,969,3,7,"PCPE",1
3,"3086",166,143,143,1,0,"PCPE",0
44,"44013",11250,8525,8420,95,105,"PCPE",12
50,"50174",83,58,58,0,0,"PCPE",0
47,"47226",149,124,123,0,1,"PCPE",0
46,"46160",1907,1508,1485,5,23,"PCPE",2
22,"22135",174,132,132,5,0,"PCPE",0
46,"46221",345,294,294,0,0,"PCPE",0
46,"46134",2380,1836,1825,5,11,"PCPE",0
50,"50279",73,61,60,2,1,"PCPE",0
28,"28099",1923,1490,1475,7,15,"PCPE",0
47,"47184",541,447,441,0,6,"PCPE",0
47,"47097",307,258,256,4,2,"PCPE",0
44,"44265",181,153,148,1,5,"PCPE",0
50,"50242",93,72,70,0,2,"PCPE",0
22,"22019",175,151,151,0,0,"PCPE",0
44,"44025",5825,4337,4197,50,140,"PCPE",10
22,"22009",585,439,435,4,4,"PCPE",1
44,"44217",31,25,25,0,0,"PCPE",0
50,"50137",964,790,781,9,9,"PCPE",0
22,"22020",119,91,87,1,4,"PCPE",0
44,"44093",79,73,73,4,0,"PCPE",0
46,"46091",115,99,99,0,0,"PCPE",0
39,"39060",6693,5459,5394,29,65,"PCPE",3
50,"50233",104,82,82,0,0,"PCPE",0
44,"44146",170,148,146,3,2,"PCPE",1
50,"50195",53,42,41,0,1,"PCPE",0
2,"2048",1178,989,967,7,22,"PCPE",0
30,"30022",17056,12158,11954,126,204,"PCPE",20
44,"44026",95,76,75,2,1,"PCPE",0
50,"50048",33,25,25,0,0,"PCPE",0
28,"28043",6166,4404,4320,30,84,"PCPE",5
2,"2024",3374,2657,2613,23,44,"PCPE",3
50,"50021",25,23,23,1,0,"PCPE",0
39,"39034",257,167,162,2,5,"PCPE",0
50,"50196",102,83,81,2,2,"PCPE",0
46,"46163",1856,1522,1501,4,21,"PCPE",2
22,"22037",112,96,96,0,0,"PCPE",0
28,"28151",3251,2483,2450,11,33,"PCPE",2
46,"46031",10521,7735,7607,62,128,"PCPE",8
44,"44037",449,334,331,1,3,"PCPE",0
50,"50040",86,71,71,0,0,"PCPE",0
47,"47229",231,174,168,0,6,"PCPE",0
3,"3903",2577,1996,1973,11,23,"PCPE",4
50,"50197",96,78,78,1,0,"PCPE",0
50,"50109",98,69,67,3,2,"PCPE",0
47,"47197",867,721,717,2,4,"PCPE",0
22,"22228",529,421,417,3,4,"PCPE",4
44,"44122",1284,995,984,15,11,"PCPE",1
22,"22060",1172,906,901,13,5,"PCPE",2
46,"46191",1949,1541,1505,7,36,"PCPE",3
39,"39073",10200,8230,8150,65,80,"PCPE",3
22,"22068",65,46,44,1,2,"PCPE",0
46,"46066",1285,1058,1043,6,15,"PCPE",0
44,"44137",188,148,146,0,2,"PCPE",0
47,"47031",196,155,155,3,0,"PCPE",0
50,"50292",129,113,113,1,0,"PCPE",0
50,"50255",197,162,160,2,2,"PCPE",0
47,"47211",48,43,43,1,0,"PCPE",1
22,"22085",96,82,81,0,1,"PCPE",0
47,"47104",2836,2339,2267,23,72,"PCPE",1
47,"47073",116,91,89,0,2,"PCPE",0
2,"2063",1375,1067,1047,1,20,"PCPE",0
22,"22013",275,218,217,6,1,"PCPE",0
39,"39008",13900,10895,10767,81,128,"PCPE",10
28,"28066",7515,6105,6039,40,66,"PCPE",5
44,"44096",153,120,112,1,8,"PCPE",0
30,"30902",8225,5797,5715,22,82,"PCPE",3
28,"28026",6703,5422,5367,21,55,"PCPE",2
47,"47002",18,18,18,0,0,"PCPE",0
47,"47063",89,71,71,0,0,"PCPE",0
50,"50209",2747,1993,1975,29,18,"PCPE",1
47,"47095",41,36,34,2,2,"PCPE",0
46,"46116",13608,10792,10731,76,61,"PCPE",8
44,"44243",27,24,23,0,1,"PCPE",0
47,"47053",126,100,97,0,3,"PCPE",0
3,"3052",967,805,790,4,15,"PCPE",0
28,"28902",523,418,415,2,3,"PCPE",0
3,"3012",1133,910,897,7,13,"PCPE",0
50,"50141",109,90,90,1,0,"PCPE",0
46,"46247",961,695,687,3,8,"PCPE",0
46,"46004",1919,1641,1616,14,25,"PCPE",4
22,"22144",257,207,204,1,3,"PCPE",0
46,"46197",1926,1473,1455,9,18,"PCPE",2
22,"22025",1035,764,755,24,9,"PCPE",1
22,"22164",43,33,31,0,2,"PCPE",0
47,"47076",17721,14605,14438,134,167,"PCPE",12
3,"3112",637,526,520,0,6,"PCPE",1
28,"28101",229,183,182,2,1,"PCPE",0
3,"3904",1420,1112,1095,5,17,"PCPE",2
2,"2010",1798,1494,1469,6,25,"PCPE",2
22,"22102",181,153,151,1,2,"PCPE",1
44,"44165",173,136,135,2,1,"PCPE",0
3,"3033",102,87,85,0,2,"PCPE",0
44,"44257",154,110,109,1,1,"PCPE",0
39,"39066",877,711,705,5,6,"PCPE",2
46,"46036",558,391,379,2,12,"PCPE",0
50,"50123",436,344,338,1,6,"PCPE",1
47,"47035",902,715,707,5,8,"PCPE",0
47,"47182",1335,1034,1022,6,12,"PCPE",0
46,"46017",32990,23940,23694,155,246,"PCPE",27
44,"44003",17,14,14,0,0,"PCPE",0
50,"50173",149,107,105,0,2,"PCPE",0
28,"28177",10722,9093,9029,64,64,"PCPE",3
44,"44194",104,80,80,1,0,"PCPE",0
2,"2079",2823,2303,2253,22,50,"PCPE",5
39,"39002",3414,2630,2578,23,52,"PCPE",3
44,"44052",74,50,49,0,1,"PCPE",0
28,"28009",14500,11656,11564,62,92,"PCPE",17
30,"30019",25846,18755,18517,172,238,"PCPE",10
22,"22208",194,159,156,1,3,"PCPE",0
39,"39058",800,574,573,1,1,"PCPE",1
50,"50018",893,705,696,3,9,"PCPE",0
47,"47046",125,107,104,1,3,"PCPE",0
50,"50155",90,70,69,0,1,"PCPE",0
3,"3026",1316,1040,1024,5,16,"PCPE",0
44,"44246",1590,1173,1150,11,23,"PCPE",1
44,"44236",59,44,44,0,0,"PCPE",0
2,"2044",1049,746,737,5,9,"PCPE",0
50,"50094",1518,1172,1155,20,17,"PCPE",0
39,"39022",969,740,732,2,8,"PCPE",0
50,"50260",32,28,28,0,0,"PCPE",0
50,"50135",88,74,74,3,0,"PCPE",0
28,"28126",47,35,35,0,0,"PCPE",0
50,"50288",3444,2689,2668,24,21,"PCPE",0
46,"46211",1837,1490,1462,11,28,"PCPE",0
30,"30020",6431,4991,4940,19,51,"PCPE",6
39,"39069",1928,1650,1627,9,23,"PCPE",3
50,"50057",1332,1001,986,10,15,"PCPE",0
50,"50232",160,116,114,2,2,"PCPE",0
2,"2037",22952,16040,15815,101,225,"PCPE",12
3,"3088",5810,4380,4313,31,67,"PCPE",9
50,"50032",242,179,176,1,3,"PCPE",0
47,"47008",22,15,15,0,0,"PCPE",0
46,"46212",1590,1209,1192,4,17,"PCPE",0
47,"47079",54,48,48,0,0,"PCPE",1
44,"44103",123,101,100,1,1,"PCPE",0
44,"44197",50,35,35,0,0,"PCPE",0
44,"44133",15,12,12,0,0,"PCPE",0
28,"28160",8629,6922,6856,34,66,"PCPE",1
50,"50167",215,181,179,1,2,"PCPE",0
47,"47018",36,31,29,0,2,"PCPE",0
44,"44228",99,83,83,0,0,"PCPE",0
2,"2072",1525,1146,1112,4,34,"PCPE",0
2,"2047",107,89,88,1,1,"PCPE",0
50,"50252",5057,3661,3613,36,48,"PCPE",2
46,"46101",816,696,687,3,9,"PCPE",2
44,"44124",73,58,57,0,1,"PCPE",0
47,"47133",2776,2317,2292,28,25,"PCPE",1
50,"50030",201,138,136,1,2,"PCPE",0
50,"50029",604,475,467,7,8,"PCPE",1
3,"3018",12439,9387,9283,50,104,"PCPE",3
3,"3048",4971,3808,3739,19,69,"PCPE",6
39,"39099",3149,2562,2540,22,22,"PCPE",1
22,"22095",65,57,56,1,1,"PCPE",0
46,"46041",327,251,250,2,1,"PCPE",5
3,"3133",41499,26593,26308,151,285,"PCPE",82
22,"22021",1884,1465,1450,13,15,"PCPE",4
3,"3049",12143,9418,9302,47,116,"PCPE",11
47,"47030",941,759,740,3,19,"PCPE",1
47,"47071",398,345,341,2,4,"PCPE",0
50,"50291",93,78,77,1,1,"PCPE",0
46,"46123",1948,1469,1446,5,23,"PCPE",1
2,"2025",7355,5864,5693,30,171,"PCPE",1
47,"47219",40,38,34,0,4,"PCPE",0
50,"50263",176,119,116,0,3,"PCPE",1
44,"44240",149,121,121,0,0,"PCPE",0
50,"50188",27,24,24,0,0,"PCPE",0
50,"50070",49,28,28,0,0,"PCPE",0
46,"46140",377,312,312,2,0,"PCPE",0
3,"3051",344,312,307,2,5,"PCPE",0
44,"44261",722,584,578,8,6,"PCPE",0
47,"47103",255,215,214,3,1,"PCPE",0
46,"46043",135,119,116,1,3,"PCPE",0
39,"39072",324,206,204,4,2,"PCPE",1
46,"46225",348,279,273,2,6,"PCPE",0
50,"50236",101,82,80,1,2,"PCPE",0
47,"47061",243,203,197,3,6,"PCPE",0
3,"3080",1328,1077,1064,4,13,"PCPE",0
22,"22022",543,441,433,4,8,"PCPE",2
44,"44200",39,25,25,0,0,"PCPE",0
39,"39045",351,280,277,1,3,"PCPE",0
47,"47084",1101,880,871,7,9,"PCPE",0
28,"28143",77,62,62,0,0,"PCPE",0
50,"50023",208,165,164,2,1,"PCPE",0
50,"50090",134,108,108,0,0,"PCPE",0
22,"22189",178,143,143,0,0,"PCPE",0
44,"44009",799,621,611,7,10,"PCPE",0
30,"30005",30193,22648,22419,136,229,"PCPE",22
50,"50131",210,157,156,0,1,"PCPE",0
50,"50062",1863,1441,1416,9,25,"PCPE",2
50,"50033",65,50,50,1,0,"PCPE",0
44,"44266",102,89,86,1,3,"PCPE",0
50,"50199",325,238,232,3,6,"PCPE",0
50,"50072",195,164,161,3,3,"PCPE",1
46,"46136",2619,2030,2003,24,27,"PCPE",1
3,"3094",9626,7206,7138,42,68,"PCPE",8
50,"50091",40,35,35,0,0,"PCPE",0
28,"28100",4409,3425,3382,20,43,"PCPE",2
39,"39019",2229,1785,1751,15,34,"PCPE",2
46,"46075",147,136,134,2,2,"PCPE",0
50,"50005",239,204,201,2,3,"PCPE",0
2,"2040",563,516,513,3,3,"PCPE",0
22,"22116",1369,1025,1003,8,22,"PCPE",1
50,"50218",110,92,92,0,0,"PCPE",0
22,"22105",101,82,82,4,0,"PCPE",0
28,"28166",347,287,286,1,1,"PCPE",0
44,"44011",48,32,32,1,0,"PCPE",0
3,"3127",351,290,277,2,13,"PCPE",0
44,"44126",317,226,222,1,4,"PCPE",0
30,"30021",9441,6664,6591,32,73,"PCPE",4
30,"30025",5001,3951,3898,27,53,"PCPE",1
50,"50114",132,111,111,1,0,"PCPE",0
50,"50172",178,134,131,3,3,"PCPE",0
44,"44268",32,30,30,0,0,"PCPE",0
46,"46046",884,654,643,3,11,"PCPE",1
50,"50295",49,46,46,0,0,"PCPE",0
47,"47119",87,66,65,1,1,"PCPE",1
44,"44062",31,24,23,1,1,"PCPE",0
3,"3054",336,277,272,2,5,"PCPE",2
28,"28049",57902,47976,47561,329,415,"PCPE",52
47,"47130",99,76,76,2,0,"PCPE",1
44,"44121",53,38,38,2,0,"PCPE",0
22,"22133",108,85,83,1,2,"PCPE",1
44,"44205",634,444,426,9,18,"PCPE",0
2,"2018",796,693,682,5,11,"PCPE",0
47,"47225",74,61,60,0,1,"PCPE",0
22,"22234",745,587,578,11,9,"PCPE",0
47,"47192",94,82,81,2,1,"PCPE",0
2,"2007",1013,820,813,6,7,"PCPE",1
3,"3118",2426,1741,1718,8,23,"PCPE",2
28,"28071",64,56,54,0,2,"PCPE",1
44,"44076",2110,1725,1691,22,34,"PCPE",1
39,"39031",1245,990,983,5,7,"PCPE",0
47,"47173",885,708,704,7,4,"PCPE",0
46,"46008",2624,2036,1996,9,40,"PCPE",0
50,"50259",84,58,58,0,0,"PCPE",0
3,"3005",7903,6247,6195,37,52,"PCPE",20
50,"50278",177,137,137,2,0,"PCPE",0
46,"46200",1848,1560,1539,6,21,"PCPE",1
44,"44077",74,55,54,0,1,"PCPE",1
39,"39068",649,515,509,7,6,"PCPE",2
28,"28149",6172,5089,5038,31,51,"PCPE",3
3,"3015",12807,9782,9634,63,148,"PCPE",13
3,"3076",8736,6571,6467,40,104,"PCPE",4
46,"46241",389,318,313,4,5,"PCPE",0
44,"44053",105,81,81,0,0,"PCPE",0
50,"50106",127,97,96,0,1,"PCPE",0
3,"3119",17223,13244,13116,75,128,"PCPE",9
50,"50031",139,97,90,0,7,"PCPE",0
28,"28062",288,243,236,0,7,"PCPE",0
22,"22110",707,531,528,2,3,"PCPE",0
22,"22225",2610,1867,1843,15,24,"PCPE",2
46,"46263",239,204,200,3,4,"PCPE",0
28,"28159",594,493,491,5,2,"PCPE",0
22,"22155",65,54,54,0,0,"PCPE",0
46,"46232",872,714,706,3,8,"PCPE",3
46,"46141",437,367,360,5,7,"PCPE",0
47,"47185",87,77,77,0,0,"PCPE",0
50,"50086",178,121,119,2,2,"PCPE",0
3,"3132",515,417,414,4,3,"PCPE",1
39,"39089",134,99,98,0,1,"PCPE",0
39,"39033",540,430,423,1,7,"PCPE",0
28,"28022",36550,31559,31436,207,123,"PCPE",5
50,"50068",1947,1402,1389,11,13,"PCPE",1
39,"39014",901,709,704,5,5,"PCPE",0
44,"44263",377,296,285,3,11,"PCPE",0
50,"50039",467,366,364,3,2,"PCPE",3
22,"22251",334,269,263,4,6,"PCPE",0
44,"44198",181,151,145,1,6,"PCPE",0
50,"50271",248,197,189,2,8,"PCPE",0
46,"46203",3544,2851,2810,21,41,"PCPE",0
50,"50244",191,153,150,1,3,"PCPE",0
47,"47081",41,36,36,0,0,"PCPE",0
39,"39024",1815,1436,1420,14,16,"PCPE",0
46,"46173",1319,1084,1062,6,22,"PCPE",0
3,"3122",43704,31952,31681,218,271,"PCPE",37
22,"22202",145,127,126,0,1,"PCPE",0
50,"50206",453,371,370,5,1,"PCPE",0
47,"47186",244448,197042,195276,1561,1766,"PCPE",193
46,"46153",435,364,356,1,8,"PCPE",0
46,"46062",4572,3571,3510,20,61,"PCPE",3
47,"47137",31,23,23,0,0,"PCPE",0
47,"47125",51,46,45,0,1,"PCPE",0
28,"28025",404,314,305,3,9,"PCPE",0
39,"39063",954,726,722,4,4,"PCPE",0
28,"28180",5317,4266,4222,26,44,"PCPE",2
2,"2074",5891,4435,4375,41,60,"PCPE",2
47,"47220",154,119,119,1,0,"PCPE",0
44,"44168",184,137,136,4,1,"PCPE",1
3,"3060",106,84,84,0,0,"PCPE",0
22,"22203",76,61,61,0,0,"PCPE",0
22,"22074",275,223,221,10,2,"PCPE",1
50,"50274",66,48,47,0,1,"PCPE",0
2,"2013",135,113,110,0,3,"PCPE",0
44,"44210",743,600,594,8,6,"PCPE",2
50,"50013",200,166,166,3,0,"PCPE",0
46,"46114",574,457,452,1,5,"PCPE",0
46,"46073",1077,867,862,10,5,"PCPE",0
46,"46003",953,828,811,5,17,"PCPE",0
50,"50217",431,346,344,0,2,"PCPE",0
3,"3061",1054,830,816,3,14,"PCPE",0
50,"50161",103,80,80,0,0,"PCPE",0
44,"44086",421,332,327,3,5,"PCPE",0
3,"3021",5578,4720,4626,35,94,"PCPE",4
50,"50004",478,380,376,2,4,"PCPE",1
50,"50246",38,28,28,0,0,"PCPE",0
2,"2015",1433,1234,1214,7,20,"PCPE",0
28,"28057",1549,1246,1239,5,7,"PCPE",2
50,"50208",1748,1360,1344,11,16,"PCPE",1
50,"50284",132,105,104,1,1,"PCPE",0
50,"50171",96,78,78,1,0,"PCPE",0
22,"22086",209,157,155,1,2,"PCPE",0
46,"46055",1284,1031,1021,2,10,"PCPE",0
44,"44119",119,83,82,0,1,"PCPE",0
47,"47139",1004,790,776,2,14,"PCPE",1
44,"44222",122,102,102,1,0,"PCPE",0
50,"50275",110,55,55,0,0,"PCPE",0
39,"39093",302,256,256,2,0,"PCPE",0
22,"22024",222,179,177,1,2,"PCPE",3
3,"3073",222,200,196,3,4,"PCPE",0
28,"28068",11554,9122,9022,44,100,"PCPE",2
3,"3062",221,182,180,1,2,"PCPE",0
3,"3053",7469,5950,5865,26,85,"PCPE",1
46,"46194",15813,11654,11511,83,143,"PCPE",15
39,"39057",2367,1831,1796,14,35,"PCPE",2
47,"47025",114,98,98,0,0,"PCPE",0
46,"46188",693,591,585,3,6,"PCPE",1
22,"22149",308,247,246,3,1,"PCPE",1
22,"22077",362,301,293,3,8,"PCPE",0
2,"2054",383,314,309,1,5,"PCPE",0
28,"28008",1961,1477,1456,6,21,"PCPE",1
44,"44234",70,57,57,1,0,"PCPE",0
3,"3023",1379,1216,1199,6,17,"PCPE",2
39,"39001",2065,1669,1643,16,26,"PCPE",0
46,"46047",532,447,441,4,6,"PCPE",0
44,"44130",27,24,24,0,0,"PCPE",0
3,"3013",1070,882,869,3,13,"PCPE",0
22,"22064",162,121,121,0,0,"PCPE",0
47,"47015",176,136,135,0,1,"PCPE",0
46,"46158",1040,805,796,4,9,"PCPE",0
22,"22078",438,326,323,3,3,"PCPE",1
44,"44183",63,43,43,0,0,"PCPE",0
50,"50104",326,264,259,4,5,"PCPE",0
2,"2019",2368,2009,1975,5,34,"PCPE",3
3,"3096",5779,4433,4352,30,81,"PCPE",6
39,"39049",306,209,208,4,1,"PCPE",0
30,"30039",20191,14552,14380,96,172,"PCPE",18
28,"28070",113,94,94,2,0,"PCPE",0
2,"2020",431,359,356,3,3,"PCPE",0
50,"50269",279,189,186,1,3,"PCPE",0
44,"44014",2499,2015,1963,25,52,"PCPE",3
47,"47099",155,135,133,0,2,"PCPE",0
28,"28093",2142,1751,1728,9,23,"PCPE",1
22,"22109",266,207,205,3,2,"PCPE",0
44,"44153",1749,1264,1243,11,21,"PCPE",3
46,"46028",388,324,319,1,5,"PCPE",1
46,"46109",6174,4763,4639,30,124,"PCPE",8
50,"50202",131,90,88,1,2,"PCPE",0
22,"22122",65,58,58,3,0,"PCPE",0
28,"28148",88647,70218,69546,570,672,"PCPE",47
46,"46129",512,408,400,4,8,"PCPE",0
30,"30040",705,600,596,1,4,"PCPE",0
44,"44196",125,96,95,2,1,"PCPE",0
3,"3036",86,77,75,2,2,"PCPE",0
28,"28021",576,387,386,3,1,"PCPE",0
2,"2021",1014,836,827,5,9,"PCPE",1
2,"2022",344,252,252,1,0,"PCPE",1
39,"39051",73,65,64,0,1,"PCPE",0
46,"46080",985,799,788,5,11,"PCPE",0
22,"22032",107,74,74,2,0,"PCPE",0
28,"28150",3187,2640,2604,20,36,"PCPE",3
46,"46090",1633,1413,1392,5,21,"PCPE",0
50,"50076",75,64,63,0,1,"PCPE",0
46,"46151",757,586,579,0,7,"PCPE",1
3,"3099",42876,32576,32172,192,404,"PCPE",52
22,"22008",155,127,125,0,2,"PCPE",1
2,"2059",313,252,250,3,2,"PCPE",1
46,"46192",790,599,586,8,13,"PCPE",1
47,"47090",2435,1956,1921,12,35,"PCPE",0
44,"44238",2294,1763,1743,10,20,"PCPE",3
44,"44249",46,37,37,1,0,"PCPE",0
28,"28138",63,49,49,0,0,"PCPE",0
50,"50214",18,10,10,0,0,"PCPE",0
22,"22058",191,157,157,3,0,"PCPE",1
50,"50118",2110,1622,1605,19,17,"PCPE",1
3,"3079",18403,14632,14382,114,250,"PCPE",46
2,"2060",1280,1039,1020,5,19,"PCPE",1
44,"44219",173,142,136,1,6,"PCPE",0
47,"47113",142,117,117,1,0,"PCPE",0
46,"46122",2730,2103,2071,19,32,"PCPE",2
46,"46092",263,182,179,1,3,"PCPE",1
46,"46071",470,382,366,0,16,"PCPE",0
44,"44135",102,85,85,0,0,"PCPE",0
47,"47060",231,198,195,4,3,"PCPE",0
22,"22011",97,78,75,2,3,"PCPE",0
47,"47176",202,138,138,1,0,"PCPE",0
46,"46082",4958,3801,3759,21,42,"PCPE",3
46,"46112",542,460,454,0,6,"PCPE",0
47,"47156",150,128,128,2,0,"PCPE",1
22,"22048",12593,9614,9528,82,86,"PCPE",5
30,"30901",10529,8488,8375,37,113,"PCPE",8
47,"47102",264,217,211,1,6,"PCPE",1
30,"30003",25046,17860,17668,99,192,"PCPE",21
46,"46042",3348,2825,2774,11,51,"PCPE",0
46,"46184",26453,21076,20810,172,266,"PCPE",25
46,"46093",2134,1700,1687,8,13,"PCPE",1
46,"46012",929,727,707,3,20,"PCPE",1
28,"28130",28508,23566,23305,179,261,"PCPE",14
30,"30024",60183,45738,45317,290,421,"PCPE",34
30,"30014",1585,1226,1202,3,24,"PCPE",3
22,"22174",462,381,377,0,4,"PCPE",0
46,"46257",5428,4237,4190,23,47,"PCPE",3
44,"44059",550,446,437,7,9,"PCPE",1
28,"28121",205,166,165,1,1,"PCPE",0
39,"39036",971,794,787,5,7,"PCPE",0
46,"46033",196,169,168,3,1,"PCPE",0
3,"3040",258,223,217,1,6,"PCPE",0
3,"3010",336,295,280,0,15,"PCPE",1
44,"44127",57,45,45,0,0,"PCPE",0
22,"22050",93,79,79,2,0,"PCPE",0
50,"50052",85,64,64,0,0,"PCPE",0
47,"47051",321,274,272,1,2,"PCPE",1
47,"47032",153,121,121,1,0,"PCPE",0
44,"44040",191,164,158,2,6,"PCPE",0
46,"46236",937,764,755,5,9,"PCPE",0
22,"22061",6583,5027,4973,51,54,"PCPE",14
28,"28144",6423,5274,5222,35,52,"PCPE",1
30,"30036",15256,10884,10703,56,181,"PCPE",3
50,"50294",64,49,47,0,2,"PCPE",0
46,"46196",140,115,114,0,1,"PCPE",0
39,"39074",7041,5612,5551,31,61,"PCPE",4
22,"22062",154,115,115,1,0,"PCPE",1
3,"3136",410,329,323,3,6,"PCPE",2
28,"28047",42847,33561,33215,216,346,"PCPE",20
28,"28122",570,457,448,3,9,"PCPE",0
3,"3022",137,122,119,0,3,"PCPE",0
28,"28089",3842,3087,3048,12,39,"PCPE",1
44,"44201",478,417,412,3,5,"PCPE",0
3,"3083",5487,3993,3934,28,59,"PCPE",9
39,"39102",2255,1711,1698,11,13,"PCPE",1
44,"44172",295,220,218,4,2,"PCPE",0
44,"44160",440,311,306,2,5,"PCPE",0
39,"39084",874,718,712,4,6,"PCPE",0
3,"3095",4740,3702,3657,23,45,"PCPE",6
46,"46076",591,497,487,0,10,"PCPE",1
47,"47004",1136,950,939,5,11,"PCPE",0
39,"39020",23931,17782,17566,126,216,"PCPE",17
30,"30028",6400,4364,4289,30,75,"PCPE",8
22,"22177",97,81,81,1,0,"PCPE",0
46,"46006",4468,3731,3683,22,48,"PCPE",1
22,"22016",566,423,420,4,3,"PCPE",1
28,"28156",1084,885,880,6,5,"PCPE",0
47,"47151",28,22,22,0,0,"PCPE",0
28,"28039",125,103,103,2,0,"PCPE",0
46,"46218",1031,907,885,6,22,"PCPE",0
47,"47024",232,189,188,0,1,"PCPE",1
50,"50124",399,316,316,3,0,"PCPE",0
50,"50267",573,440,434,7,6,"PCPE",0
28,"28080",49801,41938,41705,248,233,"PCPE",33
47,"47224",97,74,74,0,0,"PCPE",0
50,"50093",83,66,66,1,0,"PCPE",0
3,"3106",564,485,479,4,6,"PCPE",0
47,"47026",49,40,39,0,1,"PCPE",0
28,"28050",4367,3411,3384,14,27,"PCPE",4
3,"3045",213,178,173,4,5,"PCPE",0
50,"50045",1198,957,951,3,6,"PCPE",0
44,"44023",18,14,14,0,0,"PCPE",0
50,"50154",116,98,98,0,0,"PCPE",0
50,"50211",237,177,173,0,4,"PCPE",0
39,"39087",41381,32335,31995,194,340,"PCPE",23
44,"44024",28,25,24,0,1,"PCPE",0
50,"50125",345,264,261,3,3,"PCPE",0
47,"47110",438,352,347,4,5,"PCPE",0
50,"50056",405,332,330,4,2,"PCPE",0
47,"47122",2016,1655,1617,15,38,"PCPE",2
47,"47183",139,118,118,1,0,"PCPE",0
22,"22182",233,178,174,1,4,"PCPE",0
50,"50116",170,132,131,0,1,"PCPE",0
22,"22249",118,93,93,2,0,"PCPE",0
22,"22905",287,226,224,2,2,"PCPE",0
46,"46120",1183,958,936,3,22,"PCPE",3
46,"46100",281,210,205,0,5,"PCPE",0
50,"50136",534,416,405,2,11,"PCPE",0
47,"47111",998,806,795,6,11,"PCPE",3
47,"47058",202,154,153,3,1,"PCPE",0
44,"44005",46,31,31,1,0,"PCPE",0
2,"2033",1870,1503,1463,11,40,"PCPE",0
28,"28042",1266,1020,1010,2,10,"PCPE",1
46,"46171",16429,12527,12373,61,154,"PCPE",13
22,"22236",236,207,203,2,4,"PCPE",0
39,"39097",679,437,435,2,2,"PCPE",1
2,"2071",1058,912,906,2,6,"PCPE",0
46,"46902",356,300,296,8,4,"PCPE",0
44,"44006",223,171,169,2,2,"PCPE",0
50,"50223",916,751,745,13,6,"PCPE",0
46,"46182",1310,988,977,5,11,"PCPE",3
47,"47196",28,24,24,0,0,"PCPE",0
47,"47208",56,37,37,0,0,"PCPE",0
44,"44105",69,54,54,1,0,"PCPE",0
30,"30042",2180,1727,1703,6,24,"PCPE",2
22,"22212",70,56,56,0,0,"PCPE",0
3,"3089",9497,6952,6794,55,158,"PCPE",3
46,"46223",7781,6057,5995,42,62,"PCPE",12
50,"50185",136,103,102,0,1,"PCPE",0
22,"22139",78,60,60,0,0,"PCPE",0
39,"39015",824,646,644,2,2,"PCPE",0
46,"46132",2196,1877,1853,10,24,"PCPE",1
39,"39071",422,318,316,0,2,"PCPE",0
2,"2036",95,75,75,0,0,"PCPE",0
47,"47070",30,26,25,0,1,"PCPE",0
46,"46021",23977,18032,17879,125,153,"PCPE",34
44,"44018",16,16,16,0,0,"PCPE",0
50,"50178",276,193,193,4,0,"PCPE",0
44,"44264",248,175,171,0,4,"PCPE",0
47,"47187",75,54,53,0,1,"PCPE",0
47,"47114",3911,2864,2807,28,57,"PCPE",2
22,"22012",102,81,80,1,1,"PCPE",0
28,"28152",16839,14205,14151,87,54,"PCPE",3
2,"2073",4844,3828,3772,28,56,"PCPE",11
50,"50235",2412,1826,1807,22,19,"PCPE",1
22,"22909",301,233,231,4,2,"PCPE",0
28,"28065",130679,106997,105975,762,1022,"PCPE",58
28,"28172",9751,7994,7928,38,66,"PCPE",0
44,"44038",98,83,80,0,3,"PCPE",0
46,"46002",1215,963,959,5,4,"PCPE",5
50,"50051",800,615,608,3,7,"PCPE",0
28,"28015",20440,17084,16953,103,131,"PCPE",11
28,"28110",2003,1596,1571,7,25,"PCPE",0
22,"22099",465,365,362,3,3,"PCPE",0
47,"47158",858,672,663,8,9,"PCPE",0
39,"39100",849,650,644,9,6,"PCPE",0
28,"28183",1124,857,842,4,15,"PCPE",0
3,"3081",1494,1163,1141,5,22,"PCPE",0
44,"44019",68,42,42,0,0,"PCPE",0
46,"46205",14233,11274,11145,55,129,"PCPE",8
30,"30015",19372,14430,14283,91,147,"PCPE",12
28,"28005",136050,108267,107316,772,951,"PCPE",60
50,"50207",93,68,67,2,1,"PCPE",0
46,"46074",2678,2158,2135,13,23,"PCPE",3
50,"50041",17,14,14,0,0,"PCPE",0
46,"46104",1891,1515,1481,17,34,"PCPE",0
2,"2075",1718,1470,1448,4,22,"PCPE",1
28,"28112",154,137,137,1,0,"PCPE",0
44,"44138",118,90,89,2,1,"PCPE",0
46,"46227",888,708,693,6,15,"PCPE",0
47,"47023",3057,2577,2557,21,20,"PCPE",1
39,"39046",1343,1002,988,8,14,"PCPE",1
44,"44256",34,32,32,1,0,"PCPE",0
28,"28155",485,414,409,0,5,"PCPE",0
44,"44231",36,33,32,0,1,"PCPE",0
28,"28165",1910,1443,1430,11,13,"PCPE",2
39,"39018",4272,3533,3476,17,57,"PCPE",3
28,"28006",80622,64905,64483,400,422,"PCPE",24
46,"46014",3130,2488,2462,7,26,"PCPE",1
39,"39065",232,190,189,5,1,"PCPE",0
44,"44159",37,32,32,1,0,"PCPE",0
22,"22246",71,50,50,0,0,"PCPE",0
47,"47143",110,78,78,1,0,"PCPE",0
44,"44203",9,9,9,0,0,"PCPE",0
2,"2041",321,253,251,3,2,"PCPE",1
47,"47064",37,32,29,0,3,"PCPE",0
28,"28079",2374366,1872679,1859094,11998,13585,"PCPE",972
46,"46117",500,407,399,1,8,"PCPE",0
44,"44150",26,21,21,0,0,"PCPE",0
46,"46168",1982,1543,1522,5,21,"PCPE",2
44,"44110",37,33,33,0,0,"PCPE",0
46,"46167",345,255,255,0,0,"PCPE",0
44,"44111",78,64,64,1,0,"PCPE",0
3,"3116",1159,901,884,3,17,"PCPE",1
2,"2066",223,172,169,1,3,"PCPE",0
46,"46198",871,707,693,4,14,"PCPE",2
47,"47096",126,106,105,0,1,"PCPE",0
50,"50153",922,705,704,6,1,"PCPE",0
47,"47087",368,292,288,3,4,"PCPE",1
50,"50296",382,288,272,1,16,"PCPE",0
47,"47045",734,601,590,5,11,"PCPE",0
47,"47172",135,119,119,0,0,"PCPE",0
28,"28115",62352,53136,52912,268,224,"PCPE",10
44,"44012",310,240,238,5,2,"PCPE",0
22,"22107",100,68,67,0,1,"PCPE",0
50,"50210",36,29,29,0,0,"PCPE",0
50,"50008",5185,3753,3711,35,42,"PCPE",7
3,"3055",5247,4042,3991,24,51,"PCPE",5
46,"46108",426,346,342,1,4,"PCPE",1
46,"46149",344,260,256,2,4,"PCPE",0
47,"47016",70,62,61,0,1,"PCPE",0
44,"44112",408,303,293,2,10,"PCPE",0
2,"2081",18331,14219,13987,108,232,"PCPE",9
46,"46190",50023,37273,36976,250,297,"PCPE",55
47,"47088",105,90,90,0,0,"PCPE",0
46,"46038",307,243,241,0,2,"PCPE",0
39,"39021",467,392,385,2,7,"PCPE",0
46,"46098",2403,1807,1772,8,35,"PCPE",0
46,"46220",48968,35430,34964,306,466,"PCPE",64
46,"46159",23051,17496,17359,104,137,"PCPE",30
46,"46089",2170,1692,1672,6,20,"PCPE",0
50,"50177",276,226,223,0,3,"PCPE",0
28,"28116",759,621,618,7,3,"PCPE",0
44,"44054",94,79,79,0,0,"PCPE",1
50,"50165",1783,1359,1330,20,29,"PCPE",3
39,"39013",535,434,431,1,3,"PCPE",0
3,"3098",518,412,400,1,12,"PCPE",2
44,"44045",368,302,298,8,4,"PCPE",0
22,"22200",239,181,178,0,3,"PCPE",0
30,"30031",500,435,433,3,2,"PCPE",0
44,"44065",57,37,36,0,1,"PCPE",0
22,"22081",243,187,186,0,1,"PCPE",0
44,"44123",99,69,69,1,0,"PCPE",0
44,"44016",436,334,331,1,3,"PCPE",0
50,"50156",209,174,171,1,3,"PCPE",0
2,"2083",209,183,183,0,0,"PCPE",1
47,"47038",101,79,79,0,0,"PCPE",0
50,"50058",63,54,53,2,1,"PCPE",0
3,"3078",474,372,371,2,1,"PCPE",0
47,"47112",2570,2098,2075,13,23,"PCPE",0
47,"47155",3410,2694,2660,21,34,"PCPE",6
44,"44017",272,221,219,0,2,"PCPE",0
44,"44227",72,61,61,0,0,"PCPE",0
3,"3047",9711,6910,6791,36,119,"PCPE",9
44,"44154",248,200,195,2,5,"PCPE",0
3,"3082",12936,9025,8931,57,94,"PCPE",9
22,"22186",191,165,164,2,1,"PCPE",1
28,"28085",4141,3337,3296,13,41,"PCPE",1
47,"47146",278,232,230,3,2,"PCPE",1
3,"3090",17881,13593,13437,108,156,"PCPE",23
22,"22201",266,192,192,2,0,"PCPE",0
22,"22126",87,66,66,0,0,"PCPE",0
50,"50253",382,318,315,2,3,"PCPE",1
28,"28109",1622,1205,1192,3,13,"PCPE",0
50,"50129",213,151,149,5,2,"PCPE",1
22,"22096",320,274,272,2,2,"PCPE",0
28,"28054",11891,9476,9395,64,81,"PCPE",5
44,"44109",102,71,70,1,1,"PCPE",1
46,"46214",16415,12723,12610,74,113,"PCPE",16
44,"44027",149,120,119,0,1,"PCPE",0
2,"2049",796,582,574,1,8,"PCPE",0
44,"44220",113,92,89,0,3,"PCPE",0
47,"47177",100,80,79,0,1,"PCPE",0
47,"47010",14572,12316,12186,102,130,"PCPE",9
50,"50088",282,233,227,2,6,"PCPE",0
50,"50119",872,684,680,4,4,"PCPE",0
39,"39054",4528,3614,3575,23,39,"PCPE",3
2,"2062",386,287,285,4,2,"PCPE",0
22,"22243",39,28,28,0,0,"PCPE",0
22,"22113",470,369,369,2,0,"PCPE",0
44,"44085",49,31,31,0,0,"PCPE",0
39,"39082",1622,1261,1252,16,9,"PCPE",0
2,"2901",2185,1633,1613,9,20,"PCPE",2
3,"3124",460,401,390,2,11,"PCPE",1
50,"50110",336,268,266,1,2,"PCPE",0
28,"28087",3259,2643,2623,16,20,"PCPE",0
28,"28046",4776,3944,3912,22,32,"PCPE",0
47,"47138",219,182,177,1,5,"PCPE",0
46,"46053",537,459,457,2,2,"PCPE",0
28,"28076",425,354,349,3,5,"PCPE",0
46,"46246",1042,860,838,2,22,"PCPE",0
50,"50061",193,173,169,1,4,"PCPE",0
22,"22119",1256,963,954,5,9,"PCPE",1
39,"39083",1074,786,777,4,9,"PCPE",1
3,"3001",345,285,282,1,3,"PCPE",0
46,"46105",16132,11703,11582,64,121,"PCPE",3
2,"2004",606,504,499,5,5,"PCPE",0
47,"47033",204,167,167,2,0,"PCPE",0
44,"44071",585,449,447,6,2,"PCPE",1
47,"47075",4775,3849,3784,38,65,"PCPE",3
22,"22163",419,363,361,1,2,"PCPE",0
50,"50042",16,16,16,0,0,"PCPE",0
47,"47117",286,240,235,0,5,"PCPE",0
39,"39009",3307,2545,2526,11,19,"PCPE",2
22,"22002",106,95,94,0,1,"PCPE",0
50,"50237",102,81,81,3,0,"PCPE",0
22,"22018",308,234,232,2,2,"PCPE",0
2,"2032",265,208,203,3,5,"PCPE",0
22,"22041",152,121,119,2,2,"PCPE",0
44,"44087",68,56,54,0,2,"PCPE",0
39,"39010",610,518,512,1,6,"PCPE",0
47,"47128",56,49,46,0,3,"PCPE",0
22,"22206",182,145,145,0,0,"PCPE",0
44,"44151",182,139,138,1,1,"PCPE",1
28,"28018",4068,3367,3344,15,23,"PCPE",1
22,"22221",90,58,56,0,2,"PCPE",0
46,"46026",1202,1012,997,1,15,"PCPE",2
22,"22004",124,90,88,1,2,"PCPE",0
50,"50249",284,229,227,1,2,"PCPE",0
46,"46260",2647,2136,2113,8,23,"PCPE",1
50,"50007",49,34,34,0,0,"PCPE",0
44,"44182",198,172,171,2,1,"PCPE",0
39,"39085",6964,5489,5445,28,44,"PCPE",4
50,"50200",475,416,407,4,9,"PCPE",0
22,"22233",80,50,50,0,0,"PCPE",0
30,"30038",15674,11755,11675,59,80,"PCPE",8
46,"46229",911,755,752,5,3,"PCPE",0
28,"28102",891,681,666,4,15,"PCPE",0
47,"47005",502,420,414,2,6,"PCPE",0
3,"3128",4295,3007,2982,24,25,"PCPE",11
46,"46067",1744,1451,1432,4,19,"PCPE",2
46,"46118",3670,2930,2894,25,36,"PCPE",2
22,"22006",272,206,201,2,5,"PCPE",0
46,"46179",2116,1723,1678,18,45,"PCPE",0
47,"47131",165,127,127,3,0,"PCPE",0
28,"28060",1565,1262,1247,5,15,"PCPE",1
47,"47205",355,263,258,3,5,"PCPE",0
47,"47078",159,135,131,0,4,"PCPE",0
22,"22151",88,66,65,0,1,"PCPE",0
44,"44235",89,67,66,2,1,"PCPE",0
50,"50065",55,43,43,1,0,"PCPE",0
46,"46058",1734,1349,1325,9,24,"PCPE",1
44,"44225",103,82,81,0,1,"PCPE",0
44,"44034",126,97,97,2,0,"PCPE",0
46,"46262",213,170,165,1,5,"PCPE",0
22,"22112",9516,7043,6956,84,87,"PCPE",6
44,"44147",398,293,286,3,7,"PCPE",4
50,"50250",56,45,45,0,0,"PCPE",0
22,"22090",85,66,66,1,0,"PCPE",0
50,"50221",32,22,22,0,0,"PCPE",0
44,"44004",379,312,310,5,2,"PCPE",0
46,"46029",20423,15450,15274,100,176,"PCPE",11
46,"46069",157,130,129,0,1,"PCPE",0
3,"3006",494,413,409,1,4,"PCPE",1
3,"3131",179,147,139,0,8,"PCPE",1
50,"50019",64,48,47,0,1,"PCPE",0
44,"44237",368,299,293,2,6,"PCPE",0
3,"3056",8629,6838,6737,38,101,"PCPE",7
22,"22235",88,72,72,1,0,"PCPE",0
50,"50047",43,32,31,1,1,"PCPE",0
44,"44092",70,56,55,1,1,"PCPE",0
3,"3067",93,87,87,0,0,"PCPE",0
47,"47049",91,66,64,0,2,"PCPE",0
47,"47080",35,23,21,0,2,"PCPE",0
46,"46242",330,279,279,0,0,"PCPE",1
46,"46010",950,727,718,6,9,"PCPE",5
44,"44046",43,32,32,0,0,"PCPE",0
3,"3068",42,40,40,3,0,"PCPE",0
44,"44207",130,101,101,1,0,"PCPE",0
28,"28033",4082,3172,3140,13,32,"PCPE",1
39,"39023",6523,5205,5144,22,61,"PCPE",7
47,"47094",123,110,109,1,1,"PCPE",0
47,"47189",151,126,123,0,3,"PCPE",0
2,"2035",1946,1592,1576,15,16,"PCPE",1
3,"3902",10578,7654,7530,56,124,"PCPE",11
22,"22908",188,133,131,0,2,"PCPE",0
46,"46152",87,69,69,0,0,"PCPE",0
28,"28074",140580,113723,112489,776,1234,"PCPE",75
47,"47218",979,757,745,5,12,"PCPE",0
44,"44007",152,120,117,0,3,"PCPE",1
44,"44116",76,62,62,0,0,"PCPE",0
44,"44208",26,22,22,0,0,"PCPE",0
22,"22252",118,100,99,0,1,"PCPE",0
3,"3091",241,201,196,0,5,"PCPE",0
3,"3042",1462,1025,1008,3,17,"PCPE",0
30,"30006",829,731,727,4,4,"PCPE",2
44,"44094",123,112,112,0,0,"PCPE",0
50,"50168",27,20,20,0,0,"PCPE",0
47,"47210",402,300,289,2,11,"PCPE",0
47,"47092",102,86,85,0,1,"PCPE",0
22,"22141",114,86,85,0,1,"PCPE",0
46,"46001",783,612,607,4,5,"PCPE",0
44,"44251",242,197,187,0,10,"PCPE",0
47,"47178",166,144,143,4,1,"PCPE",0
3,"3070",2106,1554,1528,9,26,"PCPE",0
47,"47011",557,478,476,5,2,"PCPE",0
22,"22253",57,48,47,0,1,"PCPE",0
3,"3134",141,119,117,0,2,"PCPE",0
22,"22084",555,438,433,5,5,"PCPE",3
50,"50079",227,182,178,1,4,"PCPE",0
22,"22215",128,91,91,1,0,"PCPE",1
46,"46124",785,680,675,5,5,"PCPE",1
3,"3092",6688,5444,5370,36,74,"PCPE",7
50,"50139",322,257,256,0,1,"PCPE",1
22,"22217",372,296,290,5,6,"PCPE",0
44,"44028",171,140,138,1,2,"PCPE",0
3,"3041",6093,4444,4398,13,46,"PCPE",4
22,"22254",1094,857,850,11,7,"PCPE",0
46,"46094",20691,15841,15672,88,169,"PCPE",19
50,"50227",110,74,73,2,1,"PCPE",0
50,"50240",965,720,702,9,18,"PCPE",0
44,"44063",65,55,55,1,0,"PCPE",0
3,"3114",1581,1263,1237,9,26,"PCPE",5
44,"44031",82,52,52,1,0,"PCPE",0
39,"39055",1075,836,829,8,7,"PCPE",0
47,"47012",101,80,80,0,0,"PCPE",0
2,"2028",118,99,98,4,1,"PCPE",1
47,"47179",373,275,273,1,2,"PCPE",0
3,"3104",27091,21366,21119,250,247,"PCPE",31
22,"22051",91,78,78,1,0,"PCPE",0
46,"46095",578,467,458,1,9,"PCPE",2
2,"2077",54,45,44,0,1,"PCPE",0
22,"22245",306,266,263,0,3,"PCPE",0
28,"28020",169,110,109,0,1,"PCPE",0
3,"3107",2769,2011,1986,10,25,"PCPE",4
50,"50193",663,536,516,1,20,"PCPE",1
44,"44260",138,91,90,1,1,"PCPE",0
3,"3097",996,833,816,4,17,"PCPE",1
47,"47215",48,44,44,0,0,"PCPE",0
44,"44074",444,353,346,3,7,"PCPE",0
47,"47129",855,715,696,3,19,"PCPE",1
50,"50152",1368,1061,1043,6,18,"PCPE",0
47,"47014",47,43,43,1,0,"PCPE",0
2,"2078",899,705,691,3,14,"PCPE",0
44,"44032",17,13,13,0,0,"PCPE",0
44,"44002",46,42,42,0,0,"PCPE",0
3,"3105",5471,4099,4003,14,96,"PCPE",4
46,"46137",242,200,200,3,0,"PCPE",0
22,"22903",622,538,533,3,5,"PCPE",0
47,"47213",108,84,84,0,0,"PCPE",0
28,"28048",504,399,392,6,7,"PCPE",0
50,"50182",3675,2846,2810,36,36,"PCPE",6
44,"44173",102,85,80,0,5,"PCPE",0
46,"46087",109,98,98,1,0,"PCPE",0
47,"47141",118,103,102,0,1,"PCPE",0
50,"50277",49,37,37,3,0,"PCPE",0
46,"46138",360,305,303,2,2,"PCPE",0
39,"39048",1765,1429,1420,4,9,"PCPE",0
47,"47134",148,127,126,6,1,"PCPE",0
28,"28170",2487,1840,1810,10,30,"PCPE",0
46,"46219",122,105,104,0,1,"PCPE",0
50,"50231",257,210,207,3,3,"PCPE",0
2,"2056",1643,1330,1308,4,22,"PCPE",0
28,"28010",10538,8708,8635,54,73,"PCPE",6
50,"50036",100,80,80,0,0,"PCPE",0
28,"28104",15318,12897,12797,87,100,"PCPE",4
47,"47162",68,55,55,0,0,"PCPE",0
50,"50084",66,47,47,0,0,"PCPE",0
39,"39040",4267,3428,3385,24,43,"PCPE",2
44,"44195",84,66,65,1,1,"PCPE",0
28,"28092",153428,121511,120211,807,1300,"PCPE",79
3,"3139",23061,16378,16178,128,200,"PCPE",20
46,"46102",19635,15330,15207,95,123,"PCPE",14
47,"47082",810,679,668,8,11,"PCPE",1
30,"30023",3875,3107,3068,20,39,"PCPE",1
28,"28044",6193,5040,4991,31,49,"PCPE",5
39,"39090",772,619,609,1,10,"PCPE",0
44,"44250",19,15,15,0,0,"PCPE",0
44,"44247",287,216,215,6,1,"PCPE",0
44,"44090",66,49,49,0,0,"PCPE",0
50,"50046",167,134,130,3,4,"PCPE",0
22,"22250",344,271,264,6,7,"PCPE",0
44,"44226",124,87,83,2,4,"PCPE",0
3,"3016",91,77,77,1,0,"PCPE",0
22,"22906",174,137,134,5,3,"PCPE",1
22,"22170",668,529,520,4,9,"PCPE",0
47,"47174",270,215,208,2,7,"PCPE",0
47,"47144",75,63,63,1,0,"PCPE",0
39,"39032",1426,1156,1141,8,15,"PCPE",0
47,"47154",146,122,118,2,4,"PCPE",1
22,"22907",1444,1149,1137,12,12,"PCPE",2
3,"3017",379,321,311,1,10,"PCPE",1
2,"2070",384,318,318,2,0,"PCPE",0
46,"46254",943,751,734,4,17,"PCPE",1
39,"39005",1406,1127,1110,12,17,"PCPE",1
28,"28023",5090,4252,4212,31,40,"PCPE",2
50,"50280",301,246,240,1,6,"PCPE",0
39,"39061",3488,2833,2798,18,35,"PCPE",1
50,"50239",63,47,47,0,0,"PCPE",0
50,"50170",364,286,279,1,7,"PCPE",0
28,"28131",13432,10500,10387,81,113,"PCPE",4
44,"44114",238,188,184,1,4,"PCPE",0
46,"46135",9827,7928,7883,44,45,"PCPE",4
50,"50205",74,58,57,0,1,"PCPE",0
50,"50148",290,229,227,2,2,"PCPE",0
28,"28161",51559,41390,40922,255,468,"PCPE",20
50,"50138",47,42,42,1,0,"PCPE",0
47,"47050",3898,3084,3047,36,37,"PCPE",4
44,"44239",22,19,19,0,0,"PCPE",0
28,"28096",19809,15584,15392,118,192,"PCPE",3
50,"50059",754,599,589,6,10,"PCPE",1
22,"22218",40,32,31,1,1,"PCPE",0
46,"46176",2045,1450,1434,12,16,"PCPE",4
50,"50287",252,200,196,7,4,"PCPE",0
44,"44167",39,30,30,0,0,"PCPE",0
50,"50027",224,170,165,1,5,"PCPE",0
50,"50098",162,121,120,3,1,"PCPE",0
39,"39053",213,146,145,2,1,"PCPE",0
50,"50050",86,65,65,1,0,"PCPE",0
2,"2086",2426,1738,1728,8,10,"PCPE",1
28,"28055",907,671,666,5,5,"PCPE",0
3,"3050",19334,14377,14253,71,124,"PCPE",14
22,"22173",218,162,160,1,2,"PCPE",1
44,"44048",53,47,47,0,0,"PCPE",0
3,"3123",7576,5900,5814,36,86,"PCPE",7
30,"30035",19268,14248,14103,92,145,"PCPE",12
28,"28173",519,417,412,4,5,"PCPE",0
50,"50169",336,261,259,2,2,"PCPE",0
39,"39035",9169,7135,7045,40,90,"PCPE",4
46,"46063",1783,1368,1345,9,23,"PCPE",0
47,"47021",72,63,63,0,0,"PCPE",0
28,"28088",286,193,193,2,0,"PCPE",0
22,"22001",214,162,162,0,0,"PCPE",0
46,"46165",7298,5744,5697,38,47,"PCPE",6
50,"50080",34,29,29,0,0,"PCPE",0
46,"46202",17660,13782,13645,93,137,"PCPE",13
39,"39076",3483,2770,2734,21,36,"PCPE",3
22,"22150",461,368,362,1,6,"PCPE",1
46,"46145",22099,16685,16499,128,186,"PCPE",12
3,"3034",1391,1107,1090,7,17,"PCPE",3
2,"2076",318,256,250,1,6,"PCPE",1
46,"46186",19529,15294,15125,69,169,"PCPE",11
28,"28027",1200,920,906,4,14,"PCPE",0
46,"46166",8202,6482,6399,39,83,"PCPE",6
22,"22230",288,229,228,3,1,"PCPE",1
22,"22103",676,520,517,6,3,"PCPE",1
47,"47190",95,81,81,1,0,"PCPE",0
46,"46024",444,339,335,1,4,"PCPE",0
39,"39012",6737,5391,5314,52,77,"PCPE",6
22,"22054",1617,1196,1183,15,13,"PCPE",2
22,"22181",88,60,59,1,1,"PCPE",0
46,"46081",9993,7972,7882,51,90,"PCPE",4
44,"44101",51,43,42,1,1,"PCPE",0
30,"30043",25401,20378,19992,131,386,"PCPE",27
47,"47047",202,164,161,3,3,"PCPE",0
50,"50229",65,57,56,0,1,"PCPE",0
22,"22087",58,47,47,0,0,"PCPE",0
44,"44244",68,48,48,4,0,"PCPE",0
28,"28114",143,104,104,0,0,"PCPE",0
50,"50102",820,653,642,9,11,"PCPE",0
47,"47161",3945,3370,3344,20,26,"PCPE",6
44,"44204",27,22,22,0,0,"PCPE",0
46,"46147",17133,12260,12120,59,140,"PCPE",9
50,"50133",100,82,82,2,0,"PCPE",0
50,"50230",1134,853,846,6,7,"PCPE",2
39,"39047",1976,1564,1538,8,26,"PCPE",2
46,"46107",1849,1501,1480,5,21,"PCPE",2
46,"46178",4943,3684,3641,21,43,"PCPE",0
22,"22207",121,78,78,1,0,"PCPE",0
22,"22247",30,21,21,0,0,"PCPE",0
46,"46239",453,372,366,2,6,"PCPE",1
3,"3085",269,243,237,0,6,"PCPE",0
44,"44075",326,275,263,0,12,"PCPE",0
3,"3003",455,395,388,0,7,"PCPE",0
46,"46016",1075,887,880,8,7,"PCPE",1
50,"50020",802,606,600,7,6,"PCPE",0
30,"30001",4539,3615,3567,16,48,"PCPE",2
30,"30029",12055,9003,8882,58,121,"PCPE",5
50,"50265",74,56,56,0,0,"PCPE",0
22,"22197",439,356,353,10,3,"PCPE",1
44,"44043",88,67,65,1,2,"PCPE",0
46,"46240",206,175,169,2,6,"PCPE",0
50,"50220",43,37,37,0,0,"PCPE",0
44,"44089",52,44,44,0,0,"PCPE",0
50,"50017",1779,1386,1373,14,13,"PCPE",1
2,"2080",499,409,400,0,9,"PCPE",0
2,"2068",324,274,273,0,1,"PCPE",0
46,"46068",345,308,307,4,1,"PCPE",1
47,"47166",251,196,189,3,7,"PCPE",1
2,"2084",305,221,215,1,6,"PCPE",0
22,"22059",1139,867,855,10,12,"PCPE",3
47,"47152",68,59,59,0,0,"PCPE",0
50,"50128",27,24,24,0,0,"PCPE",0
39,"39043",1523,1246,1220,10,26,"PCPE",0
50,"50108",52,43,42,0,1,"PCPE",0
44,"44184",38,28,26,0,2,"PCPE",0
28,"28011",420,315,311,1,4,"PCPE",2
46,"46252",128,106,106,2,0,"PCPE",0
39,"39059",7577,5978,5916,47,62,"PCPE",9
28,"28083",9665,7794,7737,56,57,"PCPE",4
2,"2046",1132,975,953,10,22,"PCPE",3
50,"50095",12136,9020,8928,99,92,"PCPE",9
50,"50213",93,76,75,0,1,"PCPE",0
46,"46049",268,231,228,1,3,"PCPE",0
30,"30030",320172,249965,247884,1497,2081,"PCPE",189
46,"46150",1797,1275,1257,9,18,"PCPE",1
44,"44176",153,124,124,0,0,"PCPE",0
50,"50126",2262,1736,1708,20,28,"PCPE",2
22,"22156",296,246,242,3,4,"PCPE",0
44,"44177",101,75,75,1,0,"PCPE",0
44,"44187",193,155,151,1,4,"PCPE",0
22,"22069",418,337,334,5,3,"PCPE",0
46,"46040",995,807,794,7,13,"PCPE",2
28,"28002",3281,2481,2455,24,26,"PCPE",1
3,"3064",5004,3782,3736,20,46,"PCPE",7
28,"28135",985,762,756,1,6,"PCPE",0
50,"50140",157,108,108,0,0,"PCPE",0
28,"28167",8608,7086,7015,48,71,"PCPE",2
50,"50071",127,89,88,0,1,"PCPE",0
46,"46206",557,461,455,6,6,"PCPE",0
50,"50297",502835,394653,391387,3269,3266,"PCPE",318
50,"50186",37,28,28,0,0,"PCPE",0
22,"22226",771,598,591,6,7,"PCPE",1
47,"47019",91,74,73,0,1,"PCPE",0
44,"44067",108,82,78,0,4,"PCPE",0
44,"44106",153,115,111,2,4,"PCPE",0
30,"30033",10363,8115,7979,54,136,"PCPE",6
22,"22143",197,134,132,1,2,"PCPE",0
46,"46115",352,261,260,0,1,"PCPE",0
3,"3093",19713,15195,14988,108,207,"PCPE",25
22,"22072",194,141,140,0,1,"PCPE",0
28,"28158",678,547,540,1,7,"PCPE",0
28,"28019",1269,990,981,4,9,"PCPE",0
46,"46051",8384,6550,6452,24,98,"PCPE",4
39,"39006",1721,1332,1315,3,17,"PCPE",1
50,"50022",504,396,386,11,10,"PCPE",0
28,"28097",125,100,100,0,0,"PCPE",0
28,"28014",34047,26858,26575,178,283,"PCPE",16
46,"46083",15374,11259,11096,56,163,"PCPE",10
46,"46244",59626,44018,43679,342,339,"PCPE",59
47,"47198",66,47,47,0,0,"PCPE",0
39,"39007",393,300,298,1,2,"PCPE",0
47,"47147",102,85,85,0,0,"PCPE",0
46,"46022",15325,11197,11072,70,125,"PCPE",15
47,"47115",276,231,223,1,8,"PCPE",0
44,"44190",65,45,43,0,2,"PCPE",1
50,"50216",240,189,181,3,8,"PCPE",0
50,"50282",57,47,45,0,2,"PCPE",0
50,"50160",2150,1652,1619,14,33,"PCPE",1
50,"50219",4283,3274,3213,53,61,"PCPE",4
46,"46154",797,645,630,1,15,"PCPE",0
2,"2064",374,318,315,3,3,"PCPE",0
46,"46064",525,427,424,4,3,"PCPE",0
28,"28073",12751,9940,9838,63,102,"PCPE",10
3,"3027",172,156,153,0,3,"PCPE",0
46,"46057",474,319,313,1,6,"PCPE",0
50,"50092",300,234,230,1,4,"PCPE",0
22,"22178",103,84,84,2,0,"PCPE",0
39,"39086",362,273,268,1,5,"PCPE",1
28,"28164",3202,2553,2530,19,23,"PCPE",0
22,"22040",144,124,120,1,4,"PCPE",0
39,"39056",2268,1847,1830,7,17,"PCPE",0
44,"44021",104,86,85,2,1,"PCPE",0
22,"22115",347,262,261,1,1,"PCPE",0
22,"22205",459,347,345,1,2,"PCPE",1
44,"44060",37,28,28,0,0,"PCPE",0
44,"44131",27,22,22,0,0,"PCPE",0
39,"39096",670,523,518,2,5,"PCPE",2
22,"22017",822,664,660,5,4,"PCPE",2
22,"22076",288,228,226,1,2,"PCPE",0
46,"46193",8964,7206,7156,27,50,"PCPE",6
2,"2012",1825,1541,1509,8,32,"PCPE",1
44,"44192",349,288,284,1,4,"PCPE",1
44,"44102",27,22,22,0,0,"PCPE",0
50,"50222",1570,1126,1105,17,21,"PCPE",1
22,"22007",756,576,571,5,5,"PCPE",1
46,"46177",4778,3767,3711,17,56,"PCPE",8
46,"46015",7477,5857,5808,33,49,"PCPE",6
47,"47181",165,143,143,0,0,"PCPE",0
50,"50073",2117,1735,1706,13,29,"PCPE",2
47,"47203",58,48,48,0,0,"PCPE",0
50,"50142",24,18,18,0,0,"PCPE",0
44,"44223",73,58,58,0,0,"PCPE",0
28,"28134",63352,51185,50776,336,409,"PCPE",28
50,"50054",56,48,47,0,1,"PCPE",0
50,"50016",44,31,31,0,0,"PCPE",0
44,"44041",58,48,44,1,4,"PCPE",0
44,"44051",2588,2034,1997,26,37,"PCPE",1
3,"3007",169,145,141,0,4,"PCPE",0
28,"28069",56,47,45,2,2,"PCPE",0
30,"30008",14450,10832,10675,60,157,"PCPE",16
22,"22165",452,360,356,1,4,"PCPE",0
44,"44022",463,342,326,6,16,"PCPE",0
46,"46148",1509,1208,1195,7,13,"PCPE",2
28,"28059",4515,3573,3542,12,31,"PCPE",1
22,"22117",2414,1798,1784,18,14,"PCPE",4
28,"28032",5042,4039,3992,23,47,"PCPE",0
2,"2003",133957,105024,104115,786,909,"PCPE",98
28,"28111",622,492,487,1,5,"PCPE",1
50,"50164",388,279,272,2,7,"PCPE",0
28,"28136",680,569,563,0,6,"PCPE",0
47,"47036",205,162,157,1,5,"PCPE",0
46,"46139",4512,3612,3567,25,45,"PCPE",4
39,"39077",236,175,173,0,2,"PCPE",0
2,"2069",11414,9019,8883,54,136,"PCPE",7
22,"22089",276,216,216,2,0,"PCPE",0
28,"28053",6840,5797,5739,32,58,"PCPE",2
39,"39052",18957,15123,14985,106,138,"PCPE",5
47,"47135",82,69,67,1,2,"PCPE",0
28,"28064",135,110,104,1,6,"PCPE",0
28,"28078",40,37,37,0,0,"PCPE",0
46,"46085",11075,8106,8011,54,95,"PCPE",6
47,"47149",45,39,39,1,0,"PCPE",0
50,"50281",68,55,52,0,3,"PCPE",0
28,"28119",2245,1839,1821,10,18,"PCPE",0
50,"50149",33,25,25,1,0,"PCPE",0
3,"3066",41802,31046,30696,285,350,"PCPE",42
28,"28179",1450,1115,1100,3,15,"PCPE",2
44,"44216",26922,20603,20279,204,324,"PCPE",18
22,"22124",182,148,148,1,0,"PCPE",1
50,"50166",236,200,198,1,2,"PCPE",0
47,"47048",175,148,148,0,0,"PCPE",0
46,"46253",114,85,85,2,0,"PCPE",0
2,"2058",313,218,214,1,4,"PCPE",0
47,"47041",153,119,116,2,3,"PCPE",0
39,"39004",1483,1181,1163,4,18,"PCPE",1
46,"46059",1240,1038,1030,3,8,"PCPE",0
30,"30041",13970,9796,9682,80,114,"PCPE",8
46,"46250",581614,454786,451184,2675,3602,"PCPE",452
50,"50001",88,71,70,0,1,"PCPE",0
50,"50096",36,22,22,0,0,"PCPE",0
30,"30011",4695,3665,3610,16,55,"PCPE",3
39,"39098",1379,1154,1144,7,10,"PCPE",1
28,"28107",442,336,325,3,11,"PCPE",0
22,"22057",364,286,284,3,2,"PCPE",2
47,"47100",119,104,102,2,2,"PCPE",0
39,"39027",3066,2511,2467,15,44,"PCPE",2
30,"30016",152709,110165,109114,717,1051,"PCPE",108
50,"50264",147,122,120,0,2,"PCPE",0
46,"46013",17712,14181,14075,88,106,"PCPE",9
50,"50290",358,272,266,6,6,"PCPE",0
46,"46061",343,285,280,4,5,"PCPE",0
50,"50228",250,217,214,3,3,"PCPE",0
47,"47029",50,43,43,1,0,"PCPE",0
47,"47228",439,353,352,1,1,"PCPE",0
50,"50187",56,43,43,0,0,"PCPE",0
30,"30026",16252,11142,10977,65,165,"PCPE",12
50,"50014",119,85,85,0,0,"PCPE",0
28,"28154",5525,4283,4222,24,61,"PCPE",2
30,"30034",1075,852,831,4,21,"PCPE",0
22,"22128",192,155,154,2,1,"PCPE",0
28,"28175",935,775,767,3,8,"PCPE",0
47,"47168",30,29,29,0,0,"PCPE",0
47,"47127",138,92,89,1,3,"PCPE",1
3,"3130",43,23,23,0,0,"PCPE",0
22,"22222",517,407,398,5,9,"PCPE",0
46,"46234",327,264,263,5,1,"PCPE",0
39,"39094",841,676,670,3,6,"PCPE",4
46,"46256",7211,5263,5209,27,54,"PCPE",8
28,"28058",141251,112674,111423,778,1251,"PCPE",72
3,"3074",1750,1433,1427,3,6,"PCPE",1
46,"46174",949,789,770,4,19,"PCPE",0
39,"39029",636,512,512,5,0,"PCPE",0
47,"47200",71,62,62,0,0,"PCPE",0
3,"3063",27121,19869,19713,131,156,"PCPE",33
3,"3057",177,148,147,0,1,"PCPE",0
46,"46245",528,430,426,2,4,"PCPE",0
47,"47167",242,212,210,0,2,"PCPE",0
46,"46070",17700,13558,13437,115,121,"PCPE",9
22,"22137",1015,741,733,9,8,"PCPE",3
44,"44120",219,158,152,1,6,"PCPE",2
46,"46215",1397,1104,1093,12,11,"PCPE",0
22,"22042",117,96,95,1,1,"PCPE",0
46,"46185",364,315,310,1,5,"PCPE",0
47,"47171",384,315,311,5,4,"PCPE",1
22,"22053",786,573,567,3,6,"PCPE",0
28,"28028",1820,1493,1483,8,10,"PCPE",2
47,"47022",59,56,54,1,2,"PCPE",0
50,"50121",277,220,218,2,2,"PCPE",0
22,"22248",104,83,82,0,1,"PCPE",0
47,"47169",61,53,53,0,0,"PCPE",0
22,"22176",170,136,135,0,1,"PCPE",0
28,"28082",6063,4939,4889,46,50,"PCPE",1
44,"44061",75,66,65,2,1,"PCPE",0
47,"47212",358,312,311,3,1,"PCPE",0
50,"50902",79,69,69,0,0,"PCPE",0
46,"46189",473,412,408,2,4,"PCPE",0
50,"50115",3275,2399,2355,32,44,"PCPE",1
46,"46157",2960,2329,2296,12,33,"PCPE",0
47,"47195",430,335,320,2,15,"PCPE",0
50,"50044",222,161,161,3,0,"PCPE",0
2,"2082",95,83,83,0,0,"PCPE",1
50,"50257",163,136,134,1,2,"PCPE",0
46,"46248",4886,3672,3613,25,59,"PCPE",3
28,"28147",990,779,769,2,10,"PCPE",0
50,"50298",5427,4373,4323,30,50,"PCPE",7
50,"50078",231,173,171,0,2,"PCPE",0
3,"3008",159,127,126,0,1,"PCPE",0
50,"50248",502,390,377,6,13,"PCPE",0
50,"50075",72,59,59,1,0,"PCPE",0
50,"50194",81,59,59,1,0,"PCPE",0
46,"46020",3792,3028,2973,11,55,"PCPE",3
46,"46011",7523,5320,5235,28,85,"PCPE",3
3,"3011",8014,5870,5810,38,60,"PCPE",4
50,"50130",362,252,249,1,3,"PCPE",0
44,"44117",319,263,256,5,7,"PCPE",0
28,"28153",795,566,564,5,2,"PCPE",1
44,"44064",63,49,48,0,1,"PCPE",0
28,"28045",35264,27864,27597,180,267,"PCPE",14
3,"3120",2421,1823,1786,9,37,"PCPE",4
46,"46111",11326,8603,8492,55,111,"PCPE",13
28,"28146",1792,1308,1293,8,15,"PCPE",0
22,"22046",714,592,587,13,5,"PCPE",1
44,"44088",23,21,21,0,0,"PCPE",0
47,"47140",110,91,90,0,1,"PCPE",0
47,"47068",30,23,23,0,0,"PCPE",0
22,"22167",473,392,384,4,8,"PCPE",0
46,"46034",1811,1407,1389,13,18,"PCPE",0
50,"50254",174,123,122,0,1,"PCPE",0
39,"39088",59,51,51,0,0,"PCPE",0
30,"30009",12689,10036,9909,50,127,"PCPE",7
50,"50151",603,490,489,3,1,"PCPE",0
50,"50192",233,189,183,0,6,"PCPE",0
47,"47121",521,429,422,5,7,"PCPE",1
2,"2043",1173,975,962,1,13,"PCPE",0
47,"47124",388,322,319,2,3,"PCPE",0
28,"28176",13836,11415,11326,64,89,"PCPE",3
50,"50901",140,108,108,0,0,"PCPE",0
28,"28108",3642,2878,2841,16,37,"PCPE",0
28,"28117",98,89,87,2,2,"PCPE",0
46,"46228",2417,1953,1913,13,40,"PCPE",3
46,"46238",13105,9717,9610,57,107,"PCPE",11
46,"46097",958,764,756,6,8,"PCPE",2
44,"44185",93,73,72,1,1,"PCPE",0
47,"47057",273,204,200,0,4,"PCPE",0
46,"46180",651,525,519,0,6,"PCPE",1
2,"2061",618,504,500,7,4,"PCPE",1
28,"28041",4788,4012,3973,23,39,"PCPE",0
44,"44209",815,606,592,2,14,"PCPE",0
50,"50010",66,56,55,2,1,"PCPE",0
22,"22014",233,185,182,3,3,"PCPE",0
46,"46156",2024,1642,1628,7,14,"PCPE",0
44,"44099",649,457,450,2,7,"PCPE",0
50,"50100",306,238,235,3,3,"PCPE",0
50,"50251",8207,6352,6242,46,110,"PCPE",5
28,"28072",6088,5001,4961,23,40,"PCPE",2
22,"22114",124,86,82,1,4,"PCPE",0
22,"22193",269,220,217,2,3,"PCPE",0
2,"2050",90,75,75,0,0,"PCPE",0
47,"47227",55,46,46,0,0,"PCPE",0
46,"46121",111,96,94,2,2,"PCPE",0
39,"39042",5930,4722,4676,26,46,"PCPE",2
50,"50162",137,112,110,2,2,"PCPE",0
30,"30010",6857,5533,5457,38,76,"PCPE",2
46,"46086",80,69,69,0,0,"PCPE",0
46,"46005",23013,17487,17286,112,201,"PCPE",22
50,"50238",86,66,66,2,0,"PCPE",0
50,"50293",392,295,293,6,2,"PCPE",0
22,"22168",23,21,20,0,1,"PCPE",0
28,"28075",5952,4797,4758,25,39,"PCPE",0
46,"46044",4198,3399,3337,13,62,"PCPE",4
3,"3024",3948,3210,3164,14,46,"PCPE",3
47,"47221",100,84,83,1,1,"PCPE",0
46,"46162",1177,954,938,4,16,"PCPE",0
47,"47043",309,276,273,1,3,"PCPE",2
46,"46060",9287,7184,7110,40,74,"PCPE",6
3,"3072",348,297,295,2,2,"PCPE",2
47,"47159",831,703,693,0,10,"PCPE",0
46,"46054",11390,8717,8604,52,113,"PCPE",15
22,"22088",143,111,111,1,0,"PCPE",0
2,"2057",1960,1522,1489,15,33,"PCPE",3
47,"47230",288,236,233,1,3,"PCPE",0
3,"3030",563,474,466,2,8,"PCPE",3
50,"50012",96,79,79,1,0,"PCPE",2
28,"28051",1640,1301,1292,9,9,"PCPE",1
47,"47209",34,25,25,0,0,"PCPE",0
47,"47105",175,152,149,1,3,"PCPE",0
50,"50144",31,26,25,0,1,"PCPE",0
46,"46226",31,27,27,0,0,"PCPE",0
44,"44128",59,46,45,0,1,"PCPE",0
44,"44049",796,592,578,9,14,"PCPE",0
28,"28132",12068,9067,8954,63,113,"PCPE",6
46,"46037",1109,927,918,4,9,"PCPE",3
3,"3004",599,465,458,4,7,"PCPE",0
47,"47042",50,41,39,0,2,"PCPE",0
2,"2065",443,373,370,0,3,"PCPE",0
39,"39003",258,205,202,3,3,"PCPE",0
3,"3014",238879,176118,174768,1105,1350,"PCPE",277
50,"50225",1532,1072,1064,10,8,"PCPE",2
46,"46258",2636,2100,2079,9,21,"PCPE",5
46,"46209",1901,1517,1500,5,17,"PCPE",0
47,"47034",72,57,57,1,0,"PCPE",0
28,"28903",35344,30490,30287,201,203,"PCPE",10
30,"30007",6484,4774,4727,25,47,"PCPE",3
47,"47118",149,111,108,1,3,"PCPE",0
50,"50038",1405,1112,1099,13,13,"PCPE",0
44,"44029",579,466,457,3,9,"PCPE",0
44,"44042",114,84,84,0,0,"PCPE",0
44,"44171",182,130,128,0,2,"PCPE",2
2,"2055",1057,770,755,6,15,"PCPE",0
44,"44148",76,64,63,0,1,"PCPE",0
22,"22045",73,57,56,0,1,"PCPE",0
30,"30004",1126,884,876,5,8,"PCPE",0
28,"28157",682,530,516,1,14,"PCPE",0
39,"39038",1506,1093,1076,2,17,"PCPE",3
2,"2029",3327,2586,2556,15,30,"PCPE",3
47,"47180",57,46,46,1,0,"PCPE",1
50,"50903",2238,1750,1732,11,18,"PCPE",2
22,"22244",46,37,37,2,0,"PCPE",0
39,"39075",136968,104358,103487,690,871,"PCPE",83
46,"46056",175,156,156,3,0,"PCPE",0
46,"46007",12284,9370,9265,65,105,"PCPE",14
50,"50285",650,466,462,7,4,"PCPE",0
47,"47056",83,71,71,0,0,"PCPE",0
22,"22902",208,160,156,0,4,"PCPE",0
39,"39025",8703,6954,6854,39,100,"PCPE",2
50,"50025",4516,3417,3364,35,53,"PCPE",1
47,"47206",78,64,64,0,0,"PCPE",0
22,"22131",83,65,65,0,0,"PCPE",0
3,"3043",2899,2466,2434,21,32,"PCPE",9
47,"47017",198,162,160,1,2,"PCPE",0
46,"46127",2740,2174,2147,11,27,"PCPE",0
44,"44193",69,57,56,1,1,"PCPE",0
30,"30017",11477,8952,8844,62,108,"PCPE",2
50,"50113",584,505,495,3,10,"PCPE",0
44,"44179",325,233,231,7,2,"PCPE",0
44,"44213",65,46,46,0,0,"PCPE",0
2,"2053",2885,2313,2282,13,31,"PCPE",7
44,"44100",175,142,141,2,1,"PCPE",0
47,"47086",3823,3090,3046,24,44,"PCPE",0
3,"3084",497,429,429,4,0,"PCPE",0
3,"3137",657,484,480,5,4,"PCPE",0
28,"28145",2640,2014,1987,11,27,"PCPE",1
30,"30037",19254,14416,14217,67,199,"PCPE",12
22,"22027",306,230,225,3,5,"PCPE",0
44,"44001",65,51,50,0,1,"PCPE",0
12,"12126",24347,19023,18749,152,274,"PCPE",43
12,"12001",1033,834,825,8,9,"PCPE",1
12,"12115",208,170,167,1,3,"PCPE",0
12,"12078",333,238,235,1,3,"PCPE",0
12,"12022",328,273,269,1,4,"PCPE",0
12,"12012",2613,2217,2180,6,37,"PCPE",7
12,"12101",356,297,289,2,8,"PCPE",0
12,"12137",37,27,27,0,0,"PCPE",0
12,"12052",539,453,439,5,14,"PCPE",0
12,"12128",1362,1099,1076,9,23,"PCPE",1
12,"12009",17859,13054,12911,98,143,"PCPE",8
12,"12063",44,37,37,1,0,"PCPE",0
12,"12007",731,649,642,8,7,"PCPE",1
12,"12096",744,588,580,7,8,"PCPE",1
12,"12003",943,745,731,6,14,"PCPE",0
12,"12057",578,485,473,3,12,"PCPE",0
12,"12068",41,26,25,1,1,"PCPE",0
12,"12036",546,428,420,9,8,"PCPE",0
12,"12119",137,107,104,1,3,"PCPE",0
12,"12056",257,218,216,1,2,"PCPE",1
12,"12031",3942,2976,2931,24,45,"PCPE",4
12,"12141",92,81,81,0,0,"PCPE",0
12,"12043",560,460,450,2,10,"PCPE",0
12,"12135",36194,27266,26961,192,305,"PCPE",20
12,"12080",1900,1604,1575,10,29,"PCPE",0
12,"12142",145,123,121,1,2,"PCPE",1
12,"12901",3357,2693,2675,19,18,"PCPE",5
12,"12079",419,346,336,2,10,"PCPE",0
12,"12124",1840,1477,1460,8,17,"PCPE",3
12,"12059",228,191,188,0,3,"PCPE",0
12,"12061",380,277,274,2,3,"PCPE",0
12,"12046",182,161,161,1,0,"PCPE",0
12,"12064",80,75,73,1,2,"PCPE",0
12,"12104",6814,5486,5406,35,80,"PCPE",3
12,"12091",176,131,130,0,1,"PCPE",0
12,"12902",2248,1678,1653,7,25,"PCPE",1
12,"12097",65,54,54,1,0,"PCPE",0
12,"12050",1230,987,972,10,15,"PCPE",0
12,"12130",420,345,341,0,4,"PCPE",0
12,"12073",132,110,107,1,3,"PCPE",0
12,"12074",761,659,645,7,14,"PCPE",0
12,"12015",114,99,98,0,1,"PCPE",1
12,"12067",523,423,416,1,7,"PCPE",0
12,"12112",110,97,96,1,1,"PCPE",0
12,"12121",1044,941,915,4,26,"PCPE",0
12,"12065",171,150,147,0,3,"PCPE",0
12,"12140",1140,936,922,7,14,"PCPE",2
12,"12094",875,694,682,2,12,"PCPE",0
12,"12110",219,168,166,1,2,"PCPE",0
12,"12021",4377,3528,3473,23,55,"PCPE",2
12,"12029",673,566,556,3,10,"PCPE",2
12,"12131",59,50,50,0,0,"PCPE",0
12,"12045",328,275,271,2,4,"PCPE",0
12,"12100",1281,1118,1102,5,16,"PCPE",1
12,"12134",135,102,100,0,2,"PCPE",0
12,"12034",1400,1108,1080,7,28,"PCPE",0
12,"12041",100,76,75,0,1,"PCPE",0
12,"12048",249,181,175,2,6,"PCPE",0
12,"12117",3545,2770,2698,11,72,"PCPE",0
12,"12095",950,763,756,9,7,"PCPE",1
12,"12125",222,189,187,0,2,"PCPE",0
12,"12120",161,138,138,0,0,"PCPE",0
12,"12123",43,35,34,1,1,"PCPE",0
12,"12109",653,544,533,3,11,"PCPE",1
12,"12039",792,688,680,3,8,"PCPE",0
12,"12108",438,382,379,4,3,"PCPE",0
12,"12081",602,488,481,0,7,"PCPE",1
12,"12049",421,339,329,2,10,"PCPE",1
12,"12027",17473,12829,12683,90,146,"PCPE",14
12,"12004",4177,3225,3187,13,38,"PCPE",7
12,"12138",19179,14217,14006,124,211,"PCPE",8
12,"12098",533,446,440,4,6,"PCPE",0
12,"12051",448,324,319,2,5,"PCPE",0
12,"12111",334,283,279,4,4,"PCPE",1
12,"12084",17723,13501,13281,118,220,"PCPE",16
12,"12005",8052,6056,5935,50,121,"PCPE",5
12,"12013",137,113,113,0,0,"PCPE",0
12,"12060",430,368,365,1,3,"PCPE",0
12,"12132",484,415,412,4,3,"PCPE",0
12,"12105",816,639,625,5,14,"PCPE",1
12,"12113",87,65,64,0,1,"PCPE",0
12,"12118",76,64,63,0,1,"PCPE",0
12,"12011",4582,3511,3431,27,80,"PCPE",2
12,"12008",224,197,194,1,3,"PCPE",0
12,"12053",2030,1656,1636,10,20,"PCPE",0
12,"12136",2606,2262,2223,17,39,"PCPE",2
12,"12129",1801,1382,1356,17,26,"PCPE",2
12,"12055",106,85,83,2,2,"PCPE",0
12,"12103",90,75,70,1,5,"PCPE",0
12,"12017",148,120,116,0,4,"PCPE",0
12,"12010",237,203,198,1,5,"PCPE",0
12,"12102",521,442,434,2,8,"PCPE",0
12,"12082",9573,7672,7570,55,102,"PCPE",9
12,"12038",156,110,109,1,1,"PCPE",0
12,"12099",586,449,434,3,15,"PCPE",1
12,"12037",17,17,17,1,0,"PCPE",0
12,"12032",23649,17680,17505,118,175,"PCPE",17
12,"12114",194,161,160,2,1,"PCPE",1
12,"12016",1550,1281,1260,11,21,"PCPE",0
12,"12122",767,655,646,3,9,"PCPE",0
12,"12127",67,50,50,1,0,"PCPE",0
12,"12002",115,99,97,0,2,"PCPE",0
12,"12042",574,486,479,8,7,"PCPE",0
12,"12116",67,57,57,0,0,"PCPE",0
12,"12071",1267,1021,1006,11,15,"PCPE",5
12,"12107",351,312,306,1,6,"PCPE",1
12,"12026",835,656,639,4,17,"PCPE",0
12,"12033",1951,1528,1506,10,22,"PCPE",0
12,"12076",76,64,64,1,0,"PCPE",0
12,"12090",104,85,83,1,2,"PCPE",0
12,"12044",452,403,400,4,3,"PCPE",0
12,"12070",499,434,430,3,4,"PCPE",1
12,"12006",174,149,149,2,0,"PCPE",1
12,"12087",25,19,18,2,1,"PCPE",0
12,"12069",53,45,44,1,1,"PCPE",0
12,"12020",120,107,107,0,0,"PCPE",0
12,"12072",1082,901,889,15,12,"PCPE",1
12,"12025",121,102,99,0,3,"PCPE",0
12,"12028",12955,10391,10301,68,90,"PCPE",6
12,"12075",107,89,87,0,2,"PCPE",0
12,"12024",133,117,117,0,0,"PCPE",0
12,"12093",165,128,126,0,2,"PCPE",0
12,"12085",5079,3504,3459,13,45,"PCPE",7
12,"12058",64,56,56,0,0,"PCPE",0
12,"12089",4546,3353,3304,12,49,"PCPE",7
12,"12088",57,54,54,0,0,"PCPE",0
12,"12139",302,219,217,3,2,"PCPE",0
12,"12092",126,108,106,1,2,"PCPE",0
12,"12018",283,242,235,0,7,"PCPE",0
12,"12083",89,73,71,1,2,"PCPE",0
12,"12014",167,131,127,1,4,"PCPE",0
12,"12077",4790,3594,3565,39,29,"PCPE",2
12,"12106",1163,980,951,7,29,"PCPE",1
12,"12133",60,53,52,1,1,"PCPE",0
12,"12040",118683,91285,90499,666,786,"PCPE",97
43,"43118",425,357,356,0,1,"PCTC",0
43,"43156",3956,2993,2965,23,28,"PCTC",2
8,"8266",43383,35117,34994,178,123,"PCTC",20
43,"43036",865,605,602,1,3,"PCTC",0
43,"43148",90763,69756,69423,299,333,"PCTC",84
8,"8057",61,50,50,0,0,"PCTC",0
8,"8042",2362,1910,1904,7,6,"PCTC",0
43,"43025",590,476,472,0,4,"PCTC",0
8,"8033",13218,10480,10435,50,45,"PCTC",7
43,"43074",1812,1419,1412,4,7,"PCTC",0
8,"8024",357,301,298,1,3,"PCTC",0
8,"8050",136,115,114,0,1,"PCTC",0
8,"8082",1143,868,861,4,7,"PCTC",1
8,"8293",228,187,187,1,0,"PCTC",0
8,"8200",62161,48645,48330,261,315,"PCTC",44
8,"8273",2353,1944,1934,9,10,"PCTC",0
43,"43149",684,533,533,4,0,"PCTC",0
8,"8296",1843,1520,1514,10,6,"PCTC",0
8,"8243",156,139,139,0,0,"PCTC",0
8,"8118",17542,14101,14059,56,42,"PCTC",9
8,"8278",4893,4034,4018,17,16,"PCTC",4
8,"8226",926,811,807,1,4,"PCTC",1
8,"8228",288,239,239,2,0,"PCTC",0
8,"8247",980,832,828,3,4,"PCTC",0
43,"43063",536,401,397,1,4,"PCTC",0
8,"8161",11625,8521,8470,44,51,"PCTC",6
43,"43907",4359,3370,3346,22,24,"PCTC",1
43,"43099",286,234,234,0,0,"PCTC",0
43,"43151",109,98,98,0,0,"PCTC",0
8,"8211",33731,27698,27561,126,137,"PCTC",16
8,"8028",1088,783,780,2,3,"PCTC",0
43,"43082",351,303,297,1,6,"PCTC",0
8,"8031",2336,1886,1882,11,4,"PCTC",1
43,"43121",591,463,462,0,1,"PCTC",0
8,"8298",26980,20900,20817,91,83,"PCTC",6
8,"8126",8865,7125,7098,33,27,"PCTC",2
8,"8154",701,587,586,5,1,"PCTC",1
8,"8259",6904,5626,5601,27,25,"PCTC",28
8,"8022",12219,9089,9038,42,51,"PCTC",4
8,"8172",20417,16196,16144,88,52,"PCTC",7
8,"8059",344,292,290,2,2,"PCTC",0
8,"8065",1180,967,964,4,3,"PCTC",2
8,"8105",9724,7557,7505,49,52,"PCTC",5
43,"43001",694,543,543,5,0,"PCTC",0
8,"8202",12843,10074,10025,57,49,"PCTC",2
43,"43088",2026,1565,1562,9,3,"PCTC",1
8,"8074",11054,8273,8235,34,38,"PCTC",0
43,"43112",250,204,204,1,0,"PCTC",0
8,"8249",272,248,248,2,0,"PCTC",0
43,"43102",463,384,379,2,5,"PCTC",0
43,"43067",528,450,445,1,5,"PCTC",0
8,"8265",1590,1339,1334,6,5,"PCTC",1
43,"43039",105,85,85,0,0,"PCTC",0
8,"8215",2589,2044,2034,19,10,"PCTC",0
8,"8208",5760,4660,4643,25,17,"PCTC",2
43,"43116",463,381,379,2,2,"PCTC",1
8,"8162",2124,1659,1651,7,8,"PCTC",2
43,"43017",116,98,98,1,0,"PCTC",0
43,"43060",2684,2158,2152,8,6,"PCTC",5
8,"8268",971,746,737,3,9,"PCTC",1
8,"8189",122,106,106,0,0,"PCTC",0
8,"8285",10321,8169,8120,52,49,"PCTC",6
8,"8169",48284,37528,37326,218,202,"PCTC",30
43,"43108",1778,1374,1365,6,9,"PCTC",1
43,"43071",891,713,706,6,7,"PCTC",0
8,"8257",103,86,86,1,0,"PCTC",0
43,"43129",4611,3528,3495,21,33,"PCTC",3
8,"8128",577,454,451,0,3,"PCTC",0
8,"8084",1167,941,936,6,5,"PCTC",0
43,"43140",2438,1847,1837,16,10,"PCTC",0
43,"43075",86,71,69,0,2,"PCTC",0
43,"43123",71092,53689,53369,241,320,"PCTC",76
8,"8096",43555,34070,33871,194,199,"PCTC",19
8,"8216",25,19,19,0,0,"PCTC",0
43,"43050",2634,1881,1868,13,13,"PCTC",2
8,"8179",611,496,493,2,3,"PCTC",0
8,"8175",3368,2496,2486,16,10,"PCTC",0
43,"43042",2198,1820,1816,8,4,"PCTC",1
8,"8012",1721,1340,1331,8,9,"PCTC",0
8,"8122",1716,1260,1254,8,6,"PCTC",0
8,"8014",2000,1578,1567,5,11,"PCTC",1
43,"43009",1391,1086,1078,3,8,"PCTC",67
43,"43177",284,243,242,0,1,"PCTC",0
8,"8062",1004,829,826,11,3,"PCTC",0
8,"8227",2410,1882,1877,10,5,"PCTC",1
8,"8056",42727,33215,33054,220,161,"PCTC",19
43,"43171",14705,11002,10956,62,46,"PCTC",8
8,"8307",49310,38223,38022,162,201,"PCTC",21
43,"43038",21861,16504,16406,112,98,"PCTC",7
43,"43046",90,73,73,1,0,"PCTC",0
8,"8140",4778,3756,3737,19,19,"PCTC",3
8,"8117",2480,2055,2050,16,5,"PCTC",0
43,"43072",93,74,74,0,0,"PCTC",0
8,"8136",11614,9159,9079,84,80,"PCTC",4
8,"8188",115,95,95,0,0,"PCTC",0
8,"8041",10692,7805,7732,48,73,"PCTC",12
8,"8030",5209,4318,4305,16,13,"PCTC",2
8,"8167",6048,4833,4822,48,11,"PCTC",3
8,"8058",1787,1357,1340,5,17,"PCTC",2
43,"43110",251,184,184,1,0,"PCTC",0
8,"8197",7896,6197,6174,28,23,"PCTC",0
8,"8100",2092,1792,1782,16,10,"PCTC",0
8,"8007",6775,5447,5419,21,28,"PCTC",4
43,"43034",468,393,393,0,0,"PCTC",0
8,"8055",541,443,442,2,1,"PCTC",0
8,"8238",14851,12472,12428,50,44,"PCTC",4
8,"8132",361,281,281,2,0,"PCTC",0
43,"43022",1435,1130,1123,8,7,"PCTC",1
8,"8299",377,318,317,0,1,"PCTC",0
8,"8220",2411,2119,2115,13,4,"PCTC",1
8,"8219",15629,12910,12865,58,45,"PCTC",3
8,"8271",67,57,57,0,0,"PCTC",0
8,"8016",1812,1454,1448,6,6,"PCTC",0
8,"8305",27533,21656,21539,96,117,"PCTC",23
43,"43062",259,223,220,2,3,"PCTC",0
8,"8083",1672,1478,1471,7,7,"PCTC",0
43,"43125",890,700,698,12,2,"PCTC",1
43,"43018",385,335,334,3,1,"PCTC",0
8,"8123",19489,16197,16135,58,62,"PCTC",5
43,"43084",521,424,423,2,1,"PCTC",0
8,"8290",1534,1289,1284,9,5,"PCTC",1
8,"8304",816,686,678,1,8,"PCTC",0
43,"43058",96,77,77,0,0,"PCTC",0
8,"8143",2719,2121,2109,10,12,"PCTC",2
8,"8240",9453,7807,7776,21,31,"PCTC",4
8,"8139",177,156,156,0,0,"PCTC",1
8,"8070",266,232,232,0,0,"PCTC",1
8,"8005",6380,5122,5106,18,16,"PCTC",3
8,"8214",6966,5648,5633,21,15,"PCTC",2
43,"43107",383,308,308,1,0,"PCTC",0
43,"43152",434,357,356,0,1,"PCTC",1
8,"8246",1672,1412,1406,7,6,"PCTC",1
8,"8006",11774,9039,8981,33,58,"PCTC",2
8,"8230",7666,6202,6168,30,34,"PCTC",0
8,"8195",76,69,69,0,0,"PCTC",0
8,"8207",2014,1736,1730,9,6,"PCTC",0
8,"8294",2063,1644,1643,10,1,"PCTC",2
43,"43076",460,378,377,2,1,"PCTC",0
43,"43164",306,228,228,0,0,"PCTC",0
8,"8131",741,585,585,4,0,"PCTC",2
43,"43066",155,121,121,1,0,"PCTC",0
8,"8146",1358,1086,1079,2,7,"PCTC",0
8,"8048",569,442,442,2,0,"PCTC",0
43,"43100",3489,2820,2816,15,4,"PCTC",3
8,"8040",11004,8468,8431,24,37,"PCTC",4
8,"8223",1886,1434,1425,4,9,"PCTC",0
8,"8229",521,435,433,3,2,"PCTC",1
43,"43052",934,765,756,2,9,"PCTC",0
8,"8281",4840,4009,3998,23,11,"PCTC",1
8,"8277",171,150,150,0,0,"PCTC",0
8,"8113",52518,39750,39592,198,158,"PCTC",15
8,"8288",1676,1196,1182,6,14,"PCTC",1
8,"8242",222,180,180,0,0,"PCTC",1
8,"8190",258,216,215,1,1,"PCTC",0
8,"8302",9373,7001,6934,61,67,"PCTC",5
43,"43026",765,614,613,3,1,"PCTC",0
43,"43086",5263,4046,4021,17,25,"PCTC",2
43,"43051",9092,6577,6502,26,75,"PCTC",5
43,"43092",7235,5200,5174,21,26,"PCTC",4
8,"8192",5679,4605,4589,20,16,"PCTC",0
8,"8275",248,223,222,1,1,"PCTC",0
8,"8036",163,134,133,0,1,"PCTC",0
43,"43126",1211,1005,999,4,6,"PCTC",0
8,"8178",451,389,388,3,1,"PCTC",2
8,"8263",21151,16360,16269,116,91,"PCTC",9
8,"8002",220,184,183,2,1,"PCTC",0
43,"43128",905,751,747,4,4,"PCTC",0
8,"8184",54876,41661,41447,248,214,"PCTC",13
43,"43054",2792,2145,2134,21,11,"PCTC",0
8,"8130",108,89,86,2,3,"PCTC",0
43,"43131",4772,3432,3401,18,31,"PCTC",2
8,"8039",402,334,334,2,0,"PCTC",0
8,"8284",12482,8959,8887,41,72,"PCTC",7
43,"43145",4209,3409,3391,9,18,"PCTC",0
8,"8221",12699,10571,10537,53,34,"PCTC",3
8,"8015",156003,117736,117183,704,553,"PCTC",102
8,"8295",11184,8566,8529,43,37,"PCTC",1
8,"8152",116,94,94,0,0,"PCTC",0
8,"8267",6748,5389,5362,28,27,"PCTC",3
43,"43014",14357,10596,10542,60,54,"PCTC",3
8,"8019",1117818,875679,872180,4327,3499,"PCTC",440
43,"43115",128,112,111,1,1,"PCTC",0
8,"8233",1846,1485,1478,8,7,"PCTC",0
43,"43173",99,80,78,0,2,"PCTC",0
8,"8158",3108,2458,2453,13,5,"PCTC",2
43,"43064",2017,1569,1558,9,11,"PCTC",1
43,"43167",384,334,333,2,1,"PCTC",0
43,"43091",123,93,93,1,0,"PCTC",0
8,"8044",4136,3193,3175,11,18,"PCTC",1
43,"43047",4209,2878,2856,23,22,"PCTC",5
8,"8009",9480,7649,7620,35,29,"PCTC",5
43,"43083",144,116,113,1,3,"PCTC",0
8,"8121",87292,67638,67328,362,310,"PCTC",36
43,"43111",2098,1496,1483,8,13,"PCTC",2
43,"43097",399,341,341,1,0,"PCTC",0
43,"43070",238,194,193,1,1,"PCTC",0
43,"43141",105,86,86,0,0,"PCTC",0
8,"8092",3714,2912,2889,8,23,"PCTC",1
43,"43023",214,186,186,1,0,"PCTC",0
8,"8157",8547,6949,6918,39,31,"PCTC",0
8,"8248",5616,4378,4365,32,13,"PCTC",1
43,"43903",2333,1717,1700,11,17,"PCTC",0
8,"8145",2701,2156,2144,7,12,"PCTC",3
8,"8134",842,649,646,3,3,"PCTC",1
8,"8292",1062,835,831,3,4,"PCTC",0
43,"43049",727,589,584,2,5,"PCTC",0
8,"8064",1920,1516,1506,6,10,"PCTC",1
8,"8035",12871,9574,9538,31,36,"PCTC",5
8,"8091",5413,4301,4283,20,18,"PCTC",9
43,"43032",466,379,379,1,0,"PCTC",0
8,"8099",753,565,561,2,4,"PCTC",0
8,"8073",62572,48770,48527,255,243,"PCTC",41
8,"8239",460,380,378,2,2,"PCTC",0
43,"43041",228,179,177,3,2,"PCTC",0
43,"43113",397,325,323,2,2,"PCTC",0
43,"43150",1238,1034,1026,6,8,"PCTC",0
43,"43169",450,396,396,3,0,"PCTC",0
43,"43172",337,261,257,2,4,"PCTC",0
8,"8027",720,592,588,3,4,"PCTC",1
8,"8261",2378,1821,1815,14,6,"PCTC",0
8,"8903",197,177,176,0,1,"PCTC",0
8,"8241",69,56,56,0,0,"PCTC",0
8,"8206",737,625,624,3,1,"PCTC",1
8,"8077",34578,27617,27501,134,116,"PCTC",14
8,"8149",984,770,768,3,2,"PCTC",0
43,"43158",77,61,61,1,0,"PCTC",0
8,"8185",197,172,171,2,1,"PCTC",0
43,"43168",84,65,65,1,0,"PCTC",0
43,"43154",126,111,111,0,0,"PCTC",0
8,"8244",6041,4994,4970,33,24,"PCTC",3
8,"8060",135,111,109,0,2,"PCTC",0
43,"43010",337,286,284,2,2,"PCTC",0
8,"8276",233,180,180,0,0,"PCTC",0
43,"43124",472,379,373,1,6,"PCTC",0
8,"8306",527,390,388,2,2,"PCTC",1
8,"8075",4059,3127,3119,14,8,"PCTC",2
8,"8303",256,215,213,1,2,"PCTC",0
8,"8054",9155,7468,7428,43,40,"PCTC",4
43,"43011",1079,912,909,1,3,"PCTC",1
43,"43059",250,214,214,1,0,"PCTC",0
43,"43013",4392,3341,3321,14,20,"PCTC",49
8,"8236",1557,1204,1202,2,2,"PCTC",1
8,"8289",4457,3605,3594,20,11,"PCTC",1
8,"8193",984,792,790,5,2,"PCTC",0
43,"43035",235,205,203,7,2,"PCTC",0
8,"8280",95,78,78,1,0,"PCTC",0
8,"8013",1280,1040,1031,5,9,"PCTC",1
8,"8166",962,753,745,7,8,"PCTC",1
8,"8905",2308,1943,1938,7,5,"PCTC",0
8,"8125",25485,19719,19627,101,92,"PCTC",11
8,"8163",19497,14616,14548,67,68,"PCTC",4
43,"43096",98,82,82,0,0,"PCTC",0
43,"43093",3884,2956,2933,14,23,"PCTC",2
8,"8151",448,378,377,2,1,"PCTC",0
8,"8237",1662,1334,1327,7,7,"PCTC",1
8,"8108",5192,4204,4189,26,15,"PCTC",1
8,"8047",3737,2903,2876,16,27,"PCTC",3
43,"43003",350,266,264,3,2,"PCTC",0
8,"8003",7183,5761,5742,39,19,"PCTC",5
8,"8106",7469,5816,5795,34,21,"PCTC",1
8,"8025",1535,1221,1214,7,7,"PCTC",0
8,"8258",813,661,657,6,4,"PCTC",0
8,"8071",241,200,200,0,0,"PCTC",0
8,"8103",640,507,505,4,2,"PCTC",0
8,"8112",12935,9822,9765,74,57,"PCTC",3
43,"43146",41,35,35,0,0,"PCTC",0
43,"43161",17113,12944,12881,64,63,"PCTC",6
8,"8270",18837,14541,14497,66,44,"PCTC",6
8,"8018",2551,1998,1984,6,14,"PCTC",0
43,"43002",1875,1367,1348,11,19,"PCTC",1
8,"8037",1930,1618,1610,10,8,"PCTC",2
8,"8034",784,648,646,1,2,"PCTC",0
8,"8069",3280,2691,2680,17,11,"PCTC",0
43,"43033",768,609,607,3,2,"PCTC",0
8,"8147",17282,13644,13560,94,84,"PCTC",6
8,"8135",6735,5445,5421,36,24,"PCTC",2
8,"8171",2066,1607,1597,7,10,"PCTC",0
8,"8148",2334,1803,1794,6,9,"PCTC",5
8,"8183",4563,3628,3613,9,15,"PCTC",1
8,"8245",77805,57956,57666,313,290,"PCTC",50
8,"8021",61,47,45,0,2,"PCTC",0
8,"8222",1819,1484,1476,11,8,"PCTC",1
8,"8204",3115,2548,2534,22,14,"PCTC",5
8,"8087",149,135,133,0,2,"PCTC",0
43,"43120",421,302,297,2,5,"PCTC",0
8,"8301",49135,38575,38398,272,177,"PCTC",28
8,"8272",165,133,133,0,0,"PCTC",0
8,"8093",24,20,20,0,0,"PCTC",1
8,"8076",16497,12734,12667,82,67,"PCTC",10
43,"43155",22619,16724,16624,101,100,"PCTC",8
8,"8142",139,126,126,1,0,"PCTC",1
8,"8053",2865,2105,2098,17,7,"PCTC",1
8,"8191",5270,4176,4162,19,14,"PCTC",0
43,"43904",2861,2083,2058,27,25,"PCTC",0
8,"8232",1786,1444,1434,9,10,"PCTC",0
43,"43027",164,137,137,0,0,"PCTC",0
8,"8170",442,338,338,0,0,"PCTC",0
8,"8085",976,812,811,2,1,"PCTC",1
43,"43061",38,28,28,0,0,"PCTC",0
43,"43905",14941,10510,10446,40,64,"PCTC",7
43,"43134",273,224,223,5,1,"PCTC",0
43,"43094",2120,1659,1646,9,13,"PCTC",0
8,"8176",161,132,131,2,1,"PCTC",0
8,"8194",25674,17691,17585,115,106,"PCTC",16
8,"8129",484,406,405,3,1,"PCTC",0
8,"8203",2472,1884,1873,4,11,"PCTC",0
43,"43105",156,132,132,3,0,"PCTC",0
8,"8114",18648,14251,14170,69,81,"PCTC",14
8,"8209",6896,5269,5244,25,25,"PCTC",0
43,"43040",326,278,276,0,2,"PCTC",0
8,"8109",208,184,183,0,1,"PCTC",0
8,"8153",559,460,458,2,2,"PCTC",0
8,"8279",155280,121081,120515,802,566,"PCTC",92
8,"8045",71,52,49,0,3,"PCTC",0
8,"8043",3378,2579,2569,20,10,"PCTC",3
8,"8180",27072,21218,21100,126,118,"PCTC",10
43,"43157",345,303,303,0,0,"PCTC",0
43,"43016",3445,2628,2608,11,20,"PCTC",2
8,"8115",3825,2994,2975,12,19,"PCTC",3
8,"8234",3373,2742,2734,25,8,"PCTC",1
8,"8066",1463,1185,1181,9,4,"PCTC",0
43,"43133",5605,4202,4168,21,34,"PCTC",2
8,"8269",2712,2258,2250,19,8,"PCTC",0
8,"8160",316,252,247,2,5,"PCTC",0
43,"43144",1236,1025,1021,8,4,"PCTC",0
8,"8078",219,176,172,1,4,"PCTC",0
43,"43906",2103,1595,1587,14,8,"PCTC",0
8,"8119",6838,5352,5326,31,26,"PCTC",7
8,"8260",18400,14471,14406,87,65,"PCTC",11
43,"43057",38,31,31,1,0,"PCTC",0
8,"8287",1057,877,871,7,6,"PCTC",0
8,"8902",3937,3176,3164,17,12,"PCTC",1
8,"8217",25355,20935,20855,110,80,"PCTC",10
43,"43019",1336,1020,1008,4,12,"PCTC",0
43,"43166",1628,1292,1285,3,7,"PCTC",2
43,"43095",2564,1995,1984,14,11,"PCTC",4
43,"43045",146,128,127,0,1,"PCTC",0
8,"8159",14323,11399,11359,57,40,"PCTC",2
8,"8020",5172,4337,4327,26,10,"PCTC",1
8,"8011",1745,1414,1407,10,7,"PCTC",1
8,"8079",334,284,282,0,2,"PCTC",0
43,"43079",356,306,305,1,1,"PCTC",0
8,"8164",934,784,776,1,8,"PCTC",1
8,"8308",137,118,118,0,0,"PCTC",0
43,"43077",455,342,339,2,3,"PCTC",0
43,"43053",188,153,149,0,4,"PCTC",0
43,"43127",759,630,626,3,4,"PCTC",0
8,"8150",251,211,211,0,0,"PCTC",0
43,"43029",314,253,252,0,1,"PCTC",0
43,"43160",1322,1051,1045,0,6,"PCTC",1
8,"8156",11155,8956,8923,60,33,"PCTC",7
8,"8256",691,571,568,3,3,"PCTC",13
43,"43176",746,588,586,7,2,"PCTC",0
43,"43048",763,614,609,7,5,"PCTC",0
43,"43024",1556,1154,1137,3,17,"PCTC",0
8,"8904",10514,7733,7697,38,36,"PCTC",6
8,"8251",5127,3972,3940,17,32,"PCTC",6
8,"8023",6915,5339,5299,26,40,"PCTC",3
8,"8297",135,111,111,1,0,"PCTC",1
8,"8095",67,53,52,0,1,"PCTC",0
43,"43174",144,128,127,0,1,"PCTC",2
8,"8174",392,330,330,4,0,"PCTC",0
43,"43901",8750,6057,6004,43,53,"PCTC",30
43,"43132",363,292,291,2,1,"PCTC",0
8,"8081",353,299,297,2,2,"PCTC",0
8,"8213",6547,5270,5245,23,25,"PCTC",5
8,"8026",193,161,161,1,0,"PCTC",0
43,"43117",143,114,113,0,1,"PCTC",0
8,"8049",1320,981,977,5,4,"PCTC",0
43,"43065",382,308,304,1,4,"PCTC",0
43,"43044",3949,3060,3032,31,28,"PCTC",1
8,"8017",2827,2192,2182,16,10,"PCTC",0
8,"8252",24729,19751,19642,125,109,"PCTC",18
43,"43175",537,426,419,5,7,"PCTC",0
8,"8101",174954,129953,129198,680,755,"PCTC",98
43,"43119",838,630,628,4,2,"PCTC",0
8,"8225",94,81,81,1,0,"PCTC",0
8,"8250",7182,5461,5421,38,40,"PCTC",7
43,"43136",10463,7789,7749,36,40,"PCTC",3
8,"8080",39,30,30,0,0,"PCTC",0
8,"8201",447,327,324,5,3,"PCTC",1
43,"43006",676,531,525,4,6,"PCTC",0
8,"8212",491,406,402,1,4,"PCTC",0
8,"8086",14017,10746,10677,89,69,"PCTC",4
43,"43178",1421,1118,1113,7,5,"PCTC",2
43,"43055",1988,1631,1622,7,9,"PCTC",1
8,"8004",209,194,191,0,3,"PCTC",0
43,"43142",1083,850,842,8,8,"PCTC",0
8,"8116",558,459,459,0,0,"PCTC",0
43,"43103",905,746,740,8,6,"PCTC",0
8,"8124",37130,29069,28915,146,154,"PCTC",25
8,"8032",2087,1607,1598,9,9,"PCTC",2
8,"8199",651,542,542,4,0,"PCTC",0
43,"43043",3289,2624,2613,14,11,"PCTC",3
43,"43004",6274,4744,4691,39,53,"PCTC",2
8,"8198",4640,3713,3691,23,22,"PCTC",0
8,"8231",21132,15940,15880,75,60,"PCTC",8
8,"8254",1753,1485,1482,3,3,"PCTC",0
43,"43098",354,291,291,1,0,"PCTC",0
8,"8097",1080,891,880,2,11,"PCTC",0
43,"43031",1446,1180,1178,7,2,"PCTC",0
8,"8255",137,105,105,1,0,"PCTC",0
8,"8067",5728,4535,4513,21,22,"PCTC",2
8,"8051",18437,14951,14887,85,64,"PCTC",12
43,"43037",17902,12787,12695,63,92,"PCTC",10
8,"8029",3560,3027,3019,13,8,"PCTC",0
43,"43012",3647,3028,3019,15,9,"PCTC",1
43,"43101",145,122,122,1,0,"PCTC",0
8,"8286",2919,2210,2199,15,11,"PCTC",0
8,"8038",1525,1228,1220,2,8,"PCTC",2
43,"43143",51,45,44,0,1,"PCTC",0
8,"8102",28794,22420,22317,92,103,"PCTC",14
8,"8144",713,565,563,5,2,"PCTC",1
8,"8224",878,697,695,1,2,"PCTC",0
8,"8235",3829,3176,3167,14,9,"PCTC",2
8,"8177",39,31,31,0,0,"PCTC",0
8,"8283",6113,4832,4813,33,19,"PCTC",2
8,"8110",13592,10111,10058,50,53,"PCTC",2
43,"43162",4418,3467,3453,20,14,"PCTC",0
43,"43069",178,146,146,0,0,"PCTC",0
43,"43153",11092,8327,8291,34,36,"PCTC",3
43,"43089",281,209,208,0,1,"PCTC",0
8,"8137",274,232,229,0,3,"PCTC",0
8,"8264",4535,3623,3613,13,10,"PCTC",4
43,"43137",1905,1515,1499,15,16,"PCTC",3
43,"43073",84,68,67,0,1,"PCTC",0
8,"8165",1664,1315,1311,9,4,"PCTC",1
8,"8111",215,200,199,4,1,"PCTC",0
8,"8182",2892,2217,2204,18,13,"PCTC",1
43,"43902",2743,1996,1980,16,16,"PCTC",0
43,"43135",341,283,280,4,3,"PCTC",0
8,"8127",2240,1694,1683,13,11,"PCTC",4
8,"8001",9079,7383,7341,40,42,"PCTC",12
8,"8210",4584,3455,3435,23,20,"PCTC",0
43,"43165",572,492,492,1,0,"PCTC",0
8,"8107",11900,9303,9187,43,116,"PCTC",3
8,"8052",139,111,110,0,1,"PCTC",0
8,"8104",653,516,516,2,0,"PCTC",1
8,"8168",394,287,287,1,0,"PCTC",0
43,"43104",1762,1410,1401,5,9,"PCTC",0
43,"43114",375,306,305,0,1,"PCTC",0
8,"8274",4674,3710,3698,12,12,"PCTC",1
43,"43068",483,367,365,5,2,"PCTC",0
43,"43109",2704,1937,1922,16,15,"PCTC",1
8,"8120",7048,5892,5881,49,11,"PCTC",2
8,"8046",13478,10989,10939,67,50,"PCTC",2
43,"43030",482,373,372,2,1,"PCTC",1
8,"8181",8061,6442,6402,28,40,"PCTC",2
8,"8300",5892,4912,4880,24,32,"PCTC",5
8,"8008",179,139,138,0,1,"PCTC",0
43,"43147",521,446,442,4,4,"PCTC",0
8,"8138",4432,3435,3413,10,22,"PCTC",5
8,"8090",137,113,113,2,0,"PCTC",0
43,"43163",26013,18942,18796,89,146,"PCTC",25
43,"43085",235,198,194,0,4,"PCTC",0
43,"43015",119,101,101,0,0,"PCTC",0
8,"8253",128,113,113,0,0,"PCTC",0
43,"43106",793,656,651,2,5,"PCTC",2
8,"8218",8104,6419,6389,34,30,"PCTC",2
8,"8291",4919,3865,3854,28,11,"PCTC",3
43,"43122",111,98,97,0,1,"PCTC",0
8,"8088",12248,9945,9904,57,41,"PCTC",6
8,"8061",1590,1236,1233,8,3,"PCTC",1
43,"43021",345,270,269,3,1,"PCTC",0
8,"8196",19444,15361,15263,90,98,"PCTC",11
8,"8262",6919,5090,5060,33,30,"PCTC",1
8,"8068",6878,5456,5437,25,19,"PCTC",3
8,"8282",6711,5696,5677,27,19,"PCTC",2
8,"8063",467,406,405,3,1,"PCTC",0
43,"43081",633,532,531,7,1,"PCTC",0
8,"8072",10699,8226,8193,45,33,"PCTC",5
8,"8094",1586,1310,1306,10,4,"PCTC",0
43,"43090",1169,749,742,2,7,"PCTC",2
8,"8155",6960,5427,5390,39,37,"PCTC",2
43,"43005",3643,2765,2749,22,16,"PCTC",0
8,"8901",240,203,201,1,2,"PCTC",0
43,"43028",2766,2007,1988,7,19,"PCTC",1
8,"8010",4207,3327,3304,13,23,"PCTC",7
43,"43020",2276,1831,1819,12,12,"PCTC",0
8,"8205",61279,51629,51497,360,132,"PCTC",29
43,"43008",307,202,200,1,2,"PCTC",0
8,"8133",128,98,98,5,0,"PCTC",0
43,"43170",878,706,704,7,2,"PCTC",0
43,"43080",227,195,195,0,0,"PCTC",0
8,"8089",34019,26317,26191,170,126,"PCTC",17
43,"43130",177,145,145,0,0,"PCTC",0
43,"43007",640,510,509,0,1,"PCTC",0
8,"8141",4573,3611,3595,26,16,"PCTC",2
43,"43159",81,63,62,0,1,"PCTC",0
8,"8187",153380,120687,120090,637,597,"PCTC",70
8,"8098",2409,1916,1912,9,4,"PCTC",1
43,"43138",2648,1926,1896,8,30,"PCTC",0
43,"43056",806,616,613,5,3,"PCTC",0
43,"43139",1999,1552,1539,10,13,"PCTC",3
43,"43078",843,653,644,4,9,"PCTC",0
39,"39057",2367,1831,1796,14,35,"PCTE",0
37,"37325",90,70,70,0,0,"PCTE",0
49,"49257",310,205,202,2,3,"PCTE",0
47,"47070",30,26,25,0,1,"PCTE",0
37,"37237",304,238,234,0,4,"PCTE",0
16,"16086",881,751,747,3,4,"PCTE",0
9,"9119",45,26,26,0,0,"PCTE",0
28,"28166",347,287,286,1,1,"PCTE",0
28,"28106",78429,59182,58471,417,711,"PCTE",53
16,"16151",64,52,52,0,0,"PCTE",0
40,"40129",164,129,128,2,1,"PCTE",0
50,"50015",81,61,59,1,2,"PCTE",0
16,"16199",28,23,23,1,0,"PCTE",0
18,"18167",1850,1330,1317,17,13,"PCTE",0
18,"18045",1060,748,737,10,11,"PCTE",0
24,"24001",168,105,104,0,1,"PCTE",1
34,"34058",185,161,161,1,0,"PCTE",0
41,"41078",2459,1910,1895,24,15,"PCTE",3
9,"9024",150,116,114,0,2,"PCTE",0
29,"29017",6428,4943,4871,32,72,"PCTE",7
37,"37348",100,79,79,0,0,"PCTE",0
24,"24143",495,388,380,2,8,"PCTE",0
39,"39089",134,99,98,0,1,"PCTE",0
49,"49184",170,122,121,0,1,"PCTE",0
24,"24056",2762,2062,2013,24,49,"PCTE",1
49,"49044",78,64,64,1,0,"PCTE",0
37,"37358",164,142,135,2,7,"PCTE",0
29,"29011",2871,1955,1926,11,29,"PCTE",2
37,"37140",642,422,418,2,4,"PCTE",0
41,"41098",5152,4046,3986,24,60,"PCTE",2
9,"9198",100,80,79,0,1,"PCTE",1
24,"24050",105,88,87,3,1,"PCTE",0
28,"28095",1677,1310,1293,4,17,"PCTE",0
50,"50163",3787,3041,3022,31,19,"PCTE",3
50,"50231",257,210,207,3,3,"PCTE",0
16,"16018",381,313,312,2,1,"PCTE",1
18,"18071",5612,4271,4184,29,87,"PCTE",1
50,"50128",27,24,24,0,0,"PCTE",0
37,"37032",549,431,430,3,1,"PCTE",1
28,"28119",2245,1839,1821,10,18,"PCTE",1
50,"50266",121,85,80,0,5,"PCTE",0
29,"29064",437,319,315,2,4,"PCTE",0
9,"9441",92,81,81,1,0,"PCTE",0
47,"47085",16381,12697,12540,129,157,"PCTE",10
49,"49167",179,140,136,2,4,"PCTE",1
9,"9134",220,155,151,1,4,"PCTE",1
47,"47170",43,34,32,0,2,"PCTE",0
37,"37317",288,240,238,2,2,"PCTE",0
41,"41062",2175,1763,1746,8,17,"PCTE",1
14,"14072",999,763,754,4,9,"PCTE",0
29,"29008",15183,10716,10555,93,161,"PCTE",5
24,"24187",845,641,630,6,11,"PCTE",1
18,"18114",591,443,437,2,6,"PCTE",2
16,"16192",43,30,29,0,1,"PCTE",0
33,"33002",9474,6779,6662,74,117,"PCTE",12
37,"37126",30,26,26,0,0,"PCTE",0
9,"9355",87,69,67,1,2,"PCTE",0
14,"14009",2669,1863,1844,19,19,"PCTE",1
2,"2004",606,504,499,5,5,"PCTE",0
16,"16254",203,168,166,1,2,"PCTE",0
24,"24017",538,427,424,2,3,"PCTE",0
34,"34037",276,224,223,2,1,"PCTE",0
47,"47196",28,24,24,0,0,"PCTE",0
47,"47022",59,56,54,1,2,"PCTE",0
47,"47084",1101,880,871,7,9,"PCTE",1
28,"28122",570,457,448,3,9,"PCTE",0
40,"40148",228,185,180,0,5,"PCTE",0
37,"37036",57,42,41,0,1,"PCTE",0
42,"42064",85,71,71,0,0,"PCTE",0
49,"49053",915,726,715,5,11,"PCTE",0
34,"34033",17,15,15,0,0,"PCTE",0
42,"42105",46,37,37,1,0,"PCTE",0
40,"40134",697,560,548,7,12,"PCTE",1
16,"16062",25,21,21,0,0,"PCTE",0
2,"2041",321,253,251,3,2,"PCTE",0
16,"16185",35,29,29,0,0,"PCTE",0
47,"47220",154,119,119,1,0,"PCTE",0
16,"16247",63,53,53,1,0,"PCTE",0
34,"34192",82,68,68,0,0,"PCTE",0
37,"37080",212,173,169,0,4,"PCTE",0
49,"49079",103,91,79,1,12,"PCTE",0
37,"37196",72,56,53,0,3,"PCTE",0
9,"9460",167,149,149,5,0,"PCTE",0
9,"9334",48,37,35,0,2,"PCTE",0
50,"50187",56,43,43,0,0,"PCTE",0
24,"24205",981,744,732,8,12,"PCTE",1
16,"16188",77,56,56,0,0,"PCTE",0
33,"33008",1705,1285,1273,9,12,"PCTE",2
39,"39017",553,416,409,0,7,"PCTE",0
18,"18105",3822,2688,2650,12,38,"PCTE",5
41,"41081",29840,22819,22465,228,354,"PCTE",25
24,"24110",1154,895,880,5,15,"PCTE",1
39,"39044",3868,3019,2985,8,34,"PCTE",2
47,"47199",71,59,59,3,0,"PCTE",0
42,"42089",57,48,48,1,0,"PCTE",0
33,"33077",1118,772,761,4,11,"PCTE",0
9,"9068",24,18,18,0,0,"PCTE",0
42,"42187",59,51,49,1,2,"PCTE",0
18,"18181",202,150,148,0,2,"PCTE",0
9,"9066",54,41,40,1,1,"PCTE",0
37,"37334",73,49,49,0,0,"PCTE",0
50,"50149",33,25,25,1,0,"PCTE",0
16,"16106",2708,2200,2163,17,37,"PCTE",0
49,"49125",1401,1031,1010,7,21,"PCTE",1
33,"33016",18904,14376,14235,168,141,"PCTE",22
49,"49012",73,45,45,0,0,"PCTE",0
37,"37299",229,175,168,0,7,"PCTE",0
18,"18095",2002,1566,1537,11,29,"PCTE",1
41,"41095",39970,27911,27583,389,328,"PCTE",22
50,"50141",109,90,90,1,0,"PCTE",1
42,"42184",56,42,41,1,1,"PCTE",0
14,"14055",18446,13919,13711,148,208,"PCTE",10
18,"18070",289,224,222,3,2,"PCTE",1
28,"28121",205,166,165,1,1,"PCTE",0
39,"39043",1523,1246,1220,10,26,"PCTE",1
34,"34053",200,176,171,5,5,"PCTE",0
47,"47087",368,292,288,3,4,"PCTE",1
34,"34230",17,13,13,0,0,"PCTE",0
47,"47034",72,57,57,1,0,"PCTE",0
9,"9003",184,143,142,2,1,"PCTE",1
34,"34158",286,194,194,0,0,"PCTE",0
34,"34163",46,40,40,1,0,"PCTE",0
28,"28111",622,492,487,1,5,"PCTE",0
40,"40014",56,44,43,2,1,"PCTE",0
49,"49243",109,86,83,0,3,"PCTE",0
47,"47125",51,46,45,0,1,"PCTE",0
42,"42051",15,10,10,0,0,"PCTE",0
18,"18048",2462,1873,1832,16,41,"PCTE",1
47,"47009",99,84,84,0,0,"PCTE",0
49,"49008",431,293,289,2,4,"PCTE",0
47,"47106",44,35,35,0,0,"PCTE",0
24,"24046",899,678,663,7,15,"PCTE",1
37,"37359",163,122,117,0,5,"PCTE",0
28,"28107",442,336,325,3,11,"PCTE",1
2,"2009",19456,15229,15007,152,222,"PCTE",10
50,"50098",162,121,120,3,1,"PCTE",0
49,"49025",159,126,124,0,2,"PCTE",0
24,"24171",349,201,198,4,3,"PCTE",0
14,"14008",2785,1942,1910,15,32,"PCTE",3
24,"24012",285,204,202,2,2,"PCTE",0
39,"39068",649,515,509,7,6,"PCTE",0
40,"40222",163,143,142,1,1,"PCTE",0
47,"47007",4036,3261,3217,25,44,"PCTE",2
47,"47011",557,478,476,5,2,"PCTE",0
37,"37282",194,148,146,1,2,"PCTE",0
24,"24066",449,329,324,3,5,"PCTE",1
16,"16177",82,64,63,0,1,"PCTE",0
9,"9421",242,197,196,2,1,"PCTE",1
50,"50083",84,70,68,0,2,"PCTE",0
24,"24011",189,122,121,1,1,"PCTE",0
14,"14036",3676,2850,2766,40,84,"PCTE",1
18,"18147",3644,2492,2441,18,51,"PCTE",2
16,"16035",238,190,188,0,2,"PCTE",0
9,"9169",97,86,85,0,1,"PCTE",1
28,"28168",1329,976,969,3,7,"PCTE",0
47,"47158",858,672,663,8,9,"PCTE",0
37,"37292",94,76,73,1,3,"PCTE",1
18,"18134",6069,4431,4345,30,86,"PCTE",3
49,"49272",77,55,51,0,4,"PCTE",0
40,"40234",376,307,299,2,8,"PCTE",1
24,"24161",295,223,219,0,4,"PCTE",1
40,"40213",95,83,80,1,3,"PCTE",0
24,"24039",1954,1563,1552,28,11,"PCTE",0
47,"47101",1644,1354,1337,9,17,"PCTE",1
42,"42087",51,45,44,1,1,"PCTE",0
40,"40182",173,126,124,1,2,"PCTE",1
42,"42085",178,133,133,3,0,"PCTE",0
50,"50214",18,10,10,0,0,"PCTE",0
50,"50031",139,97,90,0,7,"PCTE",1
28,"28130",28508,23566,23305,179,261,"PCTE",24
2,"2017",777,588,584,0,4,"PCTE",0
40,"40150",61,53,53,1,0,"PCTE",0
40,"40195",813,630,623,5,7,"PCTE",0
37,"37047",228,93,92,1,1,"PCTE",0
40,"40110",316,254,253,2,1,"PCTE",1
16,"16078",41517,31810,31486,340,324,"PCTE",17
49,"49155",80,66,65,1,1,"PCTE",0
41,"41008",1040,840,822,4,18,"PCTE",1
40,"40018",75,60,60,0,0,"PCTE",0
18,"18035",1190,965,952,4,13,"PCTE",0
47,"47182",1335,1034,1022,6,12,"PCTE",0
14,"14028",307,258,257,0,1,"PCTE",0
34,"34081",60,48,48,0,0,"PCTE",0
14,"14044",1620,1279,1264,12,15,"PCTE",0
41,"41902",4600,3141,3092,48,49,"PCTE",3
37,"37259",36,29,29,0,0,"PCTE",0
40,"40159",132,101,101,0,0,"PCTE",0
24,"24100",754,602,598,7,4,"PCTE",0
34,"34113",40,37,37,0,0,"PCTE",0
18,"18059",4253,3166,3123,22,43,"PCTE",5
42,"42009",77,69,69,2,0,"PCTE",0
29,"29042",14447,10383,10199,98,184,"PCTE",8
49,"49267",97,73,68,1,5,"PCTE",0
34,"34023",5098,4016,3973,48,43,"PCTE",4
39,"39052",18957,15123,14985,106,138,"PCTE",5
42,"42059",20,13,13,0,0,"PCTE",0
34,"34015",39,32,31,0,1,"PCTE",0
40,"40229",28,24,24,0,0,"PCTE",0
42,"42167",236,183,182,3,1,"PCTE",1
49,"49261",1505,1168,1149,8,19,"PCTE",4
50,"50244",191,153,150,1,3,"PCTE",0
29,"29903",493,358,354,6,4,"PCTE",0
9,"9231",59,43,43,1,0,"PCTE",0
50,"50228",250,217,214,3,3,"PCTE",0
49,"49024",637,465,461,2,4,"PCTE",0
24,"24101",384,285,283,4,2,"PCTE",0
50,"50903",2238,1750,1732,11,18,"PCTE",1
50,"50256",74,46,45,0,1,"PCTE",0
40,"40214",196,167,163,1,4,"PCTE",0
18,"18061",1000,827,822,1,5,"PCTE",1
49,"49172",481,316,310,2,6,"PCTE",2
39,"39075",136968,104358,103487,690,871,"PCTE",64
9,"9466",112,87,85,2,2,"PCTE",0
24,"24154",955,702,691,3,11,"PCTE",0
16,"16238",464,387,383,2,4,"PCTE",0
24,"24162",1772,1382,1369,22,13,"PCTE",2
49,"49168",93,74,74,0,0,"PCTE",0
34,"34114",198,152,152,0,0,"PCTE",0
41,"41030",500,419,410,6,9,"PCTE",0
9,"9022",61,54,54,0,0,"PCTE",0
39,"39060",6693,5459,5394,29,65,"PCTE",6
42,"42083",26,22,22,0,0,"PCTE",0
37,"37054",238,200,196,3,4,"PCTE",0
18,"18098",5994,4293,4247,29,46,"PCTE",1
50,"50258",53,33,33,3,0,"PCTE",0
9,"9006",59,37,36,1,1,"PCTE",0
24,"24024",638,463,452,8,11,"PCTE",0
9,"9451",238,211,207,2,4,"PCTE",0
49,"49271",181,147,144,1,3,"PCTE",1
2,"2067",1129,866,852,4,14,"PCTE",0
18,"18050",1670,1231,1213,9,18,"PCTE",1
37,"37314",82,72,68,0,4,"PCTE",0
40,"40179",626,540,529,2,11,"PCTE",0
9,"9201",28,20,19,0,1,"PCTE",0
37,"37306",242,184,181,2,3,"PCTE",0
9,"9351",62,51,50,1,1,"PCTE",0
37,"37369",125,95,93,0,2,"PCTE",0
9,"9135",40,34,34,0,0,"PCTE",1
40,"40004",445,348,341,0,7,"PCTE",1
34,"34063",87,77,77,1,0,"PCTE",0
39,"39050",255,188,184,2,4,"PCTE",0
28,"28152",16839,14205,14151,87,54,"PCTE",5
49,"49006",142,111,111,1,0,"PCTE",0
16,"16092",154,113,112,0,1,"PCTE",0
37,"37177",265,209,208,0,1,"PCTE",0
47,"47067",153,119,119,3,0,"PCTE",0
29,"29003",922,740,727,3,13,"PCTE",1
50,"50184",90,79,79,0,0,"PCTE",0
29,"29089",3161,2477,2426,19,51,"PCTE",12
18,"18065",591,482,468,4,14,"PCTE",0
49,"49042",230,179,174,1,5,"PCTE",0
33,"33066",42882,30942,30529,401,413,"PCTE",71
39,"39013",535,434,431,1,3,"PCTE",0
28,"28015",20440,17084,16953,103,131,"PCTE",5
37,"37203",146,113,112,0,1,"PCTE",0
50,"50028",77,59,58,1,1,"PCTE",0
37,"37129",252,206,202,2,4,"PCTE",0
16,"16055",679,478,477,4,1,"PCTE",0
40,"40170",1307,1066,1054,7,12,"PCTE",1
28,"28125",3216,2459,2444,11,15,"PCTE",2
49,"49197",162,129,123,2,6,"PCTE",1
34,"34224",42,30,29,0,1,"PCTE",0
49,"49058",298,244,242,1,2,"PCTE",0
49,"49076",328,260,258,6,2,"PCTE",0
9,"9425",476,366,362,1,4,"PCTE",1
42,"42205",85,64,62,0,2,"PCTE",0
16,"16217",94,77,77,0,0,"PCTE",0
24,"24175",1831,1433,1412,17,21,"PCTE",1
49,"49020",261,215,210,2,5,"PCTE",0
39,"39005",1406,1127,1110,12,17,"PCTE",0
49,"49263",45,37,37,0,0,"PCTE",0
28,"28181",20669,17314,17205,101,109,"PCTE",6
18,"18067",681,511,507,3,4,"PCTE",0
9,"9301",648,545,536,7,9,"PCTE",3
16,"16218",187,149,148,2,1,"PCTE",0
16,"16043",88,71,71,1,0,"PCTE",0
47,"47016",70,62,61,0,1,"PCTE",0
28,"28040",16648,11709,11551,66,158,"PCTE",11
37,"37033",92,69,69,2,0,"PCTE",0
28,"28116",759,621,618,7,3,"PCTE",0
37,"37157",78,64,64,0,0,"PCTE",0
37,"37198",203,163,162,3,1,"PCTE",0
34,"34218",445,352,345,2,7,"PCTE",1
34,"34047",1738,1439,1420,8,19,"PCTE",2
9,"9377",629,494,488,4,6,"PCTE",0
42,"42212",62,48,47,1,1,"PCTE",0
50,"50069",67,44,44,0,0,"PCTE",0
47,"47010",14572,12316,12186,102,130,"PCTE",11
34,"34003",150,122,120,2,2,"PCTE",0
18,"18140",42374,29390,29025,221,365,"PCTE",21
49,"49117",437,340,335,1,5,"PCTE",0
16,"16017",340,281,271,2,10,"PCTE",1
14,"14002",10859,8215,8078,93,137,"PCTE",18
47,"47027",2775,2246,2222,14,24,"PCTE",1
42,"42078",1005,769,756,6,13,"PCTE",3
2,"2034",1324,1088,1083,10,5,"PCTE",0
18,"18171",2111,1679,1638,8,41,"PCTE",3
37,"37291",269,212,209,2,3,"PCTE",0
42,"42181",391,319,317,0,2,"PCTE",0
16,"16050",220,182,179,1,3,"PCTE",0
9,"9476",60,50,50,0,0,"PCTE",0
9,"9215",365,267,264,1,3,"PCTE",0
2,"2039",952,798,789,9,9,"PCTE",1
33,"33071",563,413,407,2,6,"PCTE",1
2,"2901",2185,1633,1613,9,20,"PCTE",4
49,"49064",483,319,317,1,2,"PCTE",0
9,"9343",93,73,72,1,1,"PCTE",0
18,"18083",228,189,188,1,1,"PCTE",0
40,"40118",47,38,37,2,1,"PCTE",0
49,"49093",280,239,238,2,1,"PCTE",0
28,"28174",1840,1363,1349,10,14,"PCTE",0
47,"47231",4458,3677,3651,47,26,"PCTE",8
39,"39046",1343,1002,988,8,14,"PCTE",3
47,"47159",831,703,693,0,10,"PCTE",0
42,"42036",40,34,33,2,1,"PCTE",0
24,"24029",695,521,520,4,1,"PCTE",2
37,"37168",407,305,300,0,5,"PCTE",3
24,"24057",1306,1018,997,7,21,"PCTE",1
47,"47078",159,135,131,0,4,"PCTE",0
34,"34020",51,38,38,0,0,"PCTE",1
49,"49204",57,42,42,0,0,"PCTE",0
37,"37071",76,67,67,0,0,"PCTE",0
47,"47006",186,153,149,1,4,"PCTE",0
40,"40007",68,58,58,0,0,"PCTE",0
40,"40186",34,29,29,0,0,"PCTE",0
40,"40141",833,644,627,5,17,"PCTE",1
9,"9327",29,22,22,0,0,"PCTE",0
50,"50063",61,54,54,0,0,"PCTE",0
40,"40001",706,597,590,7,7,"PCTE",0
9,"9108",432,332,326,1,6,"PCTE",0
50,"50034",787,568,556,3,12,"PCTE",1
9,"9384",295,222,216,1,6,"PCTE",1
29,"29100",2378,1711,1686,22,25,"PCTE",1
42,"42034",44,36,36,1,0,"PCTE",0
41,"41057",253,189,188,0,1,"PCTE",0
34,"34022",1019,856,849,8,7,"PCTE",0
47,"47185",87,77,77,0,0,"PCTE",0
16,"16190",4957,4006,3945,36,61,"PCTE",1
42,"42124",58,41,41,0,0,"PCTE",0
37,"37216",294,248,247,2,1,"PCTE",0
16,"16098",520,441,439,6,2,"PCTE",1
37,"37083",176,160,156,1,4,"PCTE",0
40,"40059",108,90,89,0,1,"PCTE",0
33,"33064",250,175,174,0,1,"PCTE",0
47,"47097",307,258,256,4,2,"PCTE",0
37,"37200",196,145,145,0,0,"PCTE",0
39,"39067",759,582,575,3,7,"PCTE",0
41,"41080",1240,940,913,11,27,"PCTE",0
33,"33004",65515,48686,48245,511,441,"PCTE",136
33,"33024",225188,169937,168490,1483,1447,"PCTE",317
18,"18040",226,146,145,0,1,"PCTE",0
9,"9253",106,88,85,2,3,"PCTE",0
37,"37364",757,549,536,7,13,"PCTE",1
9,"9329",117,90,89,8,1,"PCTE",0
47,"47005",502,420,414,2,6,"PCTE",0
42,"42054",19,15,15,0,0,"PCTE",0
37,"37340",142,101,101,0,0,"PCTE",0
42,"42084",20,16,16,0,0,"PCTE",0
18,"18023",15645,11708,11561,91,147,"PCTE",5
37,"37341",48,36,36,0,0,"PCTE",0
2,"2024",3374,2657,2613,23,44,"PCTE",1
37,"37090",66,51,51,1,0,"PCTE",0
39,"39006",1721,1332,1315,3,17,"PCTE",3
37,"37374",1147,946,923,4,23,"PCTE",0
33,"33076",12147,8532,8452,104,80,"PCTE",7
49,"49086",111,94,93,1,1,"PCTE",0
40,"40145",1105,906,899,2,7,"PCTE",1
9,"9390",569,464,459,5,5,"PCTE",0
42,"42207",47,41,41,0,0,"PCTE",0
9,"9062",40,39,39,0,0,"PCTE",0
28,"28169",1553,1280,1273,15,7,"PCTE",0
37,"37057",209,165,162,2,3,"PCTE",0
50,"50094",1518,1172,1155,20,17,"PCTE",4
37,"37290",134,113,112,0,1,"PCTE",0
34,"34185",68,53,51,1,2,"PCTE",0
50,"50117",125,100,100,3,0,"PCTE",1
9,"9904",468,371,369,3,2,"PCTE",0
50,"50067",13788,10562,10413,107,149,"PCTE",8
37,"37191",104,65,65,1,0,"PCTE",0
24,"24149",146,123,123,0,0,"PCTE",0
47,"47221",100,84,83,1,1,"PCTE",0
40,"40146",238,205,202,0,3,"PCTE",0
37,"37019",140,118,117,1,1,"PCTE",0
42,"42119",145,90,89,6,1,"PCTE",0
9,"9115",91,71,66,2,5,"PCTE",1
18,"18112",110,80,76,0,4,"PCTE",0
40,"40029",24,21,21,0,0,"PCTE",0
49,"49019",228,170,164,0,6,"PCTE",0
9,"9033",81,69,68,1,1,"PCTE",0
16,"16015",351,251,250,4,1,"PCTE",0
9,"9316",108,89,89,0,0,"PCTE",0
16,"16099",184,126,121,0,5,"PCTE",0
37,"37356",87,66,66,0,0,"PCTE",0
29,"29072",3277,2628,2592,16,36,"PCTE",0
9,"9173",129,102,102,0,0,"PCTE",0
24,"24068",443,343,336,1,7,"PCTE",1
34,"34241",18,17,14,4,3,"PCTE",0
40,"40076",6537,5130,5012,22,118,"PCTE",5
49,"49179",346,233,232,0,1,"PCTE",1
16,"16066",2298,1932,1885,17,47,"PCTE",1
42,"42193",16,7,7,0,0,"PCTE",0
9,"9125",552,424,421,3,3,"PCTE",1
47,"47194",292,245,243,1,2,"PCTE",0
34,"34050",185,156,156,2,0,"PCTE",1
14,"14012",6076,4579,4489,38,90,"PCTE",5
34,"34190",49,36,36,3,0,"PCTE",0
37,"37169",176,138,137,1,1,"PCTE",0
41,"41085",4170,3337,3270,27,67,"PCTE",1
14,"14032",393,328,321,2,7,"PCTE",0
18,"18150",6903,5149,5063,42,86,"PCTE",5
37,"37144",338,275,273,1,2,"PCTE",1
49,"49047",100,72,72,0,0,"PCTE",0
47,"47103",255,215,214,3,1,"PCTE",0
37,"37062",77,65,63,0,2,"PCTE",0
49,"49010",348,301,295,6,6,"PCTE",1
49,"49191",266,216,214,1,2,"PCTE",0
37,"37283",119,96,96,0,0,"PCTE",44
42,"42213",25,16,16,0,0,"PCTE",0
50,"50216",240,189,181,3,8,"PCTE",0
2,"2054",383,314,309,1,5,"PCTE",0
9,"9021",51,36,35,1,1,"PCTE",0
9,"9054",89,69,68,1,1,"PCTE",0
24,"24193",365,286,285,0,1,"PCTE",0
47,"47031",196,155,155,3,0,"PCTE",0
14,"14064",300,231,227,6,4,"PCTE",0
18,"18176",241,182,180,0,2,"PCTE",0
16,"16019",185,147,147,0,0,"PCTE",0
41,"41058",17860,12850,12598,152,252,"PCTE",6
42,"42062",20,14,13,0,1,"PCTE",0
24,"24142",24730,18823,18504,201,319,"PCTE",24
50,"50283",69,53,52,3,1,"PCTE",0
50,"50071",127,89,88,0,1,"PCTE",0
47,"47042",50,41,39,0,2,"PCTE",0
49,"49214",664,519,510,2,9,"PCTE",0
47,"47002",18,18,18,0,0,"PCTE",0
16,"16118",1350,1126,1093,6,33,"PCTE",2
40,"40112",2772,2255,2223,21,32,"PCTE",4
33,"33042",4243,3137,3103,36,34,"PCTE",4
2,"2011",578,461,459,2,2,"PCTE",0
18,"18044",164,113,112,0,1,"PCTE",1
34,"34088",264,211,207,1,4,"PCTE",0
24,"24127",268,204,201,3,3,"PCTE",0
40,"40163",41,38,38,0,0,"PCTE",0
49,"49256",242,204,202,4,2,"PCTE",0
34,"34055",263,214,213,3,1,"PCTE",0
24,"24168",439,365,360,3,5,"PCTE",0
47,"47013",90,80,78,4,2,"PCTE",1
9,"9347",135,108,108,0,0,"PCTE",2
39,"39056",2268,1847,1830,7,17,"PCTE",2
49,"49014",116,89,88,2,1,"PCTE",0
28,"28007",126831,103108,102202,710,906,"PCTE",62
40,"40034",75,63,62,1,1,"PCTE",0
34,"34041",84,73,72,3,1,"PCTE",0
40,"40031",540,429,424,6,5,"PCTE",0
28,"28052",3949,2890,2818,8,72,"PCTE",0
9,"9206",55,47,47,1,0,"PCTE",0
37,"37068",340,256,256,3,0,"PCTE",0
37,"37215",134,97,96,3,1,"PCTE",0
49,"49122",778,586,573,6,13,"PCTE",2
16,"16081",49,42,42,0,0,"PCTE",0
34,"34132",107,84,83,0,1,"PCTE",0
49,"49160",43,29,26,0,3,"PCTE",0
16,"16234",23,16,16,0,0,"PCTE",0
9,"9043",186,128,128,1,0,"PCTE",0
16,"16095",81,69,68,1,1,"PCTE",0
9,"9011",73,50,49,0,1,"PCTE",0
29,"29034",467,374,373,1,1,"PCTE",0
33,"33034",10043,6765,6671,69,94,"PCTE",7
24,"24130",418,331,326,0,5,"PCTE",0
47,"47172",135,119,119,0,0,"PCTE",0
47,"47077",237,187,183,2,4,"PCTE",0
28,"28009",14500,11656,11564,62,92,"PCTE",13
40,"40156",281,223,222,1,1,"PCTE",0
34,"34134",40,31,31,1,0,"PCTE",0
29,"29014",222,151,150,6,1,"PCTE",0
29,"29013",1602,1262,1238,12,24,"PCTE",1
50,"50193",663,536,516,1,20,"PCTE",1
28,"28136",680,569,563,0,6,"PCTE",0
42,"42192",38,26,26,1,0,"PCTE",0
29,"29061",1033,840,821,5,19,"PCTE",2
41,"41079",9293,7137,6979,80,158,"PCTE",8
49,"49017",259,196,195,0,1,"PCTE",1
2,"2008",1123,857,842,9,15,"PCTE",2
49,"49247",417,301,294,0,7,"PCTE",0
47,"47017",198,162,160,1,2,"PCTE",0
9,"9114",76,63,63,0,0,"PCTE",1
18,"18010",532,420,416,2,4,"PCTE",1
37,"37330",318,255,248,2,7,"PCTE",0
24,"24026",1099,812,799,5,13,"PCTE",0
37,"37316",716,576,565,4,11,"PCTE",0
34,"34074",683,545,540,4,5,"PCTE",0
40,"40028",105,96,96,1,0,"PCTE",0
49,"49275",51218,38135,37628,388,507,"PCTE",53
9,"9483",189,153,150,1,3,"PCTE",0
14,"14063",1000,767,757,4,10,"PCTE",0
9,"9304",192,164,161,2,3,"PCTE",1
50,"50176",222,161,156,3,5,"PCTE",0
9,"9055",48,34,34,1,0,"PCTE",0
47,"47018",36,31,29,0,2,"PCTE",1
37,"37073",620,481,471,6,10,"PCTE",0
18,"18901",488,335,329,2,6,"PCTE",0
9,"9032",103,72,72,0,0,"PCTE",0
9,"9133",38,33,33,0,0,"PCTE",0
29,"29083",2062,1607,1574,9,33,"PCTE",2
34,"34018",205,181,177,2,4,"PCTE",1
29,"29038",18683,12820,12666,168,154,"PCTE",10
9,"9485",56,50,50,2,0,"PCTE",0
24,"24151",445,334,328,3,6,"PCTE",0
2,"2023",515,442,435,1,7,"PCTE",0
47,"47165",6822,5456,5296,62,160,"PCTE",6
18,"18078",710,561,554,4,7,"PCTE",0
50,"50107",988,837,828,11,9,"PCTE",0
34,"34062",150,108,107,1,1,"PCTE",1
50,"50271",248,197,189,2,8,"PCTE",0
50,"50297",502835,394653,391387,3269,3266,"PCTE",448
34,"34019",110,92,91,2,1,"PCTE",0
49,"49141",296,220,218,0,2,"PCTE",0
37,"37293",106,75,74,0,1,"PCTE",0
37,"37268",108,72,70,0,2,"PCTE",0
40,"40037",34,19,19,0,0,"PCTE",0
50,"50075",72,59,59,1,0,"PCTE",0
47,"47081",41,36,36,0,0,"PCTE",0
16,"16170",653,514,500,3,14,"PCTE",1
14,"14022",3886,3080,3043,18,37,"PCTE",7
9,"9279",167,131,128,2,3,"PCTE",0
28,"28172",9751,7994,7928,38,66,"PCTE",6
50,"50011",116,100,99,0,1,"PCTE",1
37,"37107",10483,7732,7633,78,99,"PCTE",9
9,"9102",33,26,25,0,1,"PCTE",0
47,"47115",276,231,223,1,8,"PCTE",0
9,"9194",1969,1526,1511,14,15,"PCTE",9
9,"9358",248,186,179,1,7,"PCTE",2
16,"16088",101,85,85,1,0,"PCTE",0
9,"9246",609,449,441,2,8,"PCTE",2
47,"47089",132,116,115,1,1,"PCTE",0
37,"37279",726,570,562,6,8,"PCTE",0
50,"50089",8584,6951,6912,34,39,"PCTE",1
47,"47130",99,76,76,2,0,"PCTE",0
9,"9214",641,454,445,5,9,"PCTE",0
2,"2038",266,217,216,1,1,"PCTE",0
40,"40078",151,123,122,2,1,"PCTE",0
49,"49080",630,499,493,4,6,"PCTE",0
41,"41011",15454,11892,11591,160,301,"PCTE",4
37,"37063",60,45,45,1,0,"PCTE",0
18,"18082",827,587,577,5,10,"PCTE",1
50,"50189",678,544,534,5,10,"PCTE",0
40,"40151",43,32,32,0,0,"PCTE",0
37,"37297",401,319,315,2,4,"PCTE",0
37,"37183",386,296,294,4,2,"PCTE",0
42,"42050",27,21,21,1,0,"PCTE",0
28,"28066",7515,6105,6039,40,66,"PCTE",1
40,"40091",108,93,93,1,0,"PCTE",0
50,"50198",49,43,43,1,0,"PCTE",0
9,"9361",112,94,94,1,0,"PCTE",0
28,"28046",4776,3944,3912,22,32,"PCTE",1
18,"18015",425,333,333,0,0,"PCTE",0
28,"28112",154,137,137,1,0,"PCTE",0
24,"24074",96,73,73,0,0,"PCTE",1
16,"16104",55,46,46,0,0,"PCTE",0
50,"50108",52,43,42,0,1,"PCTE",0
49,"49265",120,93,92,1,1,"PCTE",0
40,"40154",23,20,20,0,0,"PCTE",0
9,"9906",1200,975,958,8,17,"PCTE",2
14,"14005",6318,4464,4380,59,84,"PCTE",8
37,"37349",103,69,68,0,1,"PCTE",0
50,"50111",183,144,142,2,2,"PCTE",0
40,"40022",193,162,159,2,3,"PCTE",0
37,"37161",121,88,88,0,0,"PCTE",0
14,"14056",23513,17065,16684,147,381,"PCTE",4
9,"9472",52,45,44,0,1,"PCTE",0
24,"24022",306,227,224,1,3,"PCTE",0
9,"9180",133,104,99,1,5,"PCTE",0
37,"37286",203,147,142,2,5,"PCTE",0
18,"18163",315,246,241,1,5,"PCTE",0
29,"29094",59350,42199,41749,419,450,"PCTE",35
37,"37018",110,86,85,1,1,"PCTE",0
24,"24090",326,213,213,2,0,"PCTE",0
37,"37375",673,583,573,4,10,"PCTE",0
49,"49148",264,146,136,1,10,"PCTE",0
9,"9310",15,14,13,1,1,"PCTE",0
47,"47055",192,157,154,1,3,"PCTE",0
9,"9386",55,49,49,0,0,"PCTE",0
28,"28029",562,459,456,2,3,"PCTE",0
24,"24037",337,234,234,1,0,"PCTE",0
9,"9200",58,40,40,0,0,"PCTE",1
24,"24183",752,549,543,8,6,"PCTE",2
16,"16195",458,368,364,3,4,"PCTE",0
33,"33065",1084,761,746,18,15,"PCTE",0
40,"40024",827,657,645,4,12,"PCTE",1
50,"50055",3627,2627,2571,41,56,"PCTE",6
24,"24227",1548,1148,1128,5,20,"PCTE",0
2,"2031",541,432,425,0,7,"PCTE",0
47,"47215",48,44,44,0,0,"PCTE",0
50,"50104",326,264,259,4,5,"PCTE",0
37,"37377",218,181,176,2,5,"PCTE",0
50,"50065",55,43,43,1,0,"PCTE",0
24,"24172",415,240,237,1,3,"PCTE",1
37,"37100",77,60,59,1,1,"PCTE",0
37,"37148",404,321,315,2,6,"PCTE",1
41,"41063",2713,1988,1944,17,44,"PCTE",0
9,"9273",51,46,46,3,0,"PCTE",0
9,"9061",148,129,129,0,0,"PCTE",0
34,"34154",76,59,58,0,1,"PCTE",0
40,"40903",77,63,62,0,1,"PCTE",0
16,"16109",41,33,33,3,0,"PCTE",0
9,"9372",204,176,175,1,1,"PCTE",0
50,"50288",3444,2689,2668,24,21,"PCTE",0
47,"47226",149,124,123,0,1,"PCTE",0
49,"49164",139,103,102,2,1,"PCTE",0
34,"34089",140,119,114,2,5,"PCTE",0
40,"40180",277,231,224,3,7,"PCTE",0
34,"34237",573,479,472,4,7,"PCTE",0
40,"40039",180,147,144,1,3,"PCTE",0
29,"29015",32064,23769,23461,213,308,"PCTE",22
24,"24031",210,180,176,0,4,"PCTE",2
37,"37271",351,286,280,0,6,"PCTE",0
28,"28012",918,727,711,6,16,"PCTE",0
50,"50203",1057,849,837,9,12,"PCTE",1
50,"50116",170,132,131,0,1,"PCTE",0
50,"50261",205,171,167,1,4,"PCTE",0
47,"47184",541,447,441,0,6,"PCTE",0
24,"24188",3820,3107,3056,33,51,"PCTE",2
47,"47124",388,322,319,2,3,"PCTE",0
37,"37088",199,151,149,1,2,"PCTE",0
42,"42019",511,384,378,7,6,"PCTE",0
18,"18054",838,649,648,8,1,"PCTE",1
47,"47080",35,23,21,0,2,"PCTE",0
34,"34174",178,150,149,2,1,"PCTE",0
37,"37380",56,46,45,1,1,"PCTE",0
29,"29027",2309,1716,1692,18,24,"PCTE",3
9,"9098",477,372,360,4,12,"PCTE",0
29,"29095",3304,2536,2470,22,66,"PCTE",1
9,"9411",154,118,118,0,0,"PCTE",0
47,"47091",74,64,63,1,1,"PCTE",0
9,"9317",19,19,19,1,0,"PCTE",0
50,"50262",1163,930,912,15,18,"PCTE",0
28,"28085",4141,3337,3296,13,41,"PCTE",1
9,"9901",340,256,255,1,1,"PCTE",2
50,"50165",1783,1359,1330,20,29,"PCTE",1
50,"50118",2110,1622,1605,19,17,"PCTE",1
40,"40065",469,376,373,1,3,"PCTE",0
37,"37156",4276,2621,2572,27,49,"PCTE",3
34,"34213",52,42,42,0,0,"PCTE",0
50,"50138",47,42,42,1,0,"PCTE",0
9,"9155",25,20,20,0,0,"PCTE",0
9,"9051",163,134,133,1,1,"PCTE",1
14,"14062",963,753,745,4,8,"PCTE",1
37,"37333",202,138,137,4,1,"PCTE",0
24,"24030",4201,3080,3024,25,56,"PCTE",6
40,"40206",162,132,128,2,4,"PCTE",0
37,"37010",923,739,735,2,4,"PCTE",0
9,"9378",29,21,20,0,1,"PCTE",0
9,"9903",3139,2379,2352,27,27,"PCTE",5
50,"50003",119,95,95,1,0,"PCTE",0
42,"42118",21,13,13,1,0,"PCTE",0
28,"28094",959,736,729,6,7,"PCTE",0
9,"9052",29,17,17,1,0,"PCTE",0
34,"34036",238,199,198,1,1,"PCTE",1
9,"9323",59,41,41,2,0,"PCTE",0
40,"40069",74,65,65,0,0,"PCTE",0
41,"41068",13936,10692,10530,73,162,"PCTE",4
50,"50264",147,122,120,0,2,"PCTE",0
40,"40032",378,287,278,1,9,"PCTE",0
40,"40104",284,229,224,2,5,"PCTE",0
37,"37079",80,69,68,2,1,"PCTE",0
37,"37011",99,75,73,0,2,"PCTE",0
34,"34177",176,154,152,2,2,"PCTE",0
34,"34024",25,17,16,1,1,"PCTE",0
41,"41022",4269,3158,3110,16,48,"PCTE",5
50,"50023",208,165,164,2,1,"PCTE",0
28,"28164",3202,2553,2530,19,23,"PCTE",4
37,"37012",145,116,114,0,2,"PCTE",0
34,"34178",119,105,104,0,1,"PCTE",0
50,"50180",106,84,84,1,0,"PCTE",0
24,"24223",2540,1971,1929,37,42,"PCTE",3
16,"16091",64,46,46,1,0,"PCTE",0
47,"47043",309,276,273,1,3,"PCTE",0
50,"50294",64,49,47,0,2,"PCTE",0
42,"42121",55,42,42,0,0,"PCTE",0
50,"50024",556,427,426,6,1,"PCTE",0
42,"42144",423,338,336,4,2,"PCTE",2
40,"40119",166,133,132,1,1,"PCTE",0
49,"49052",179,125,123,1,2,"PCTE",1
50,"50181",1000,770,754,7,16,"PCTE",0
18,"18144",803,650,640,2,10,"PCTE",1
24,"24156",220,146,144,2,2,"PCTE",1
9,"9907",1507,1198,1174,16,24,"PCTE",2
28,"28101",229,183,182,2,1,"PCTE",0
49,"49159",269,214,213,1,1,"PCTE",1
42,"42038",34,27,27,1,0,"PCTE",0
16,"16063",113,86,83,0,3,"PCTE",0
16,"16246",452,348,340,1,8,"PCTE",0
47,"47203",58,48,48,0,0,"PCTE",0
2,"2005",545,443,436,5,7,"PCTE",0
14,"14023",2007,1734,1711,9,23,"PCTE",0
9,"9137",180,149,147,1,2,"PCTE",0
9,"9110",77,57,57,0,0,"PCTE",0
42,"42175",21,15,15,0,0,"PCTE",0
40,"40901",414,331,328,8,3,"PCTE",0
2,"2042",818,631,620,1,11,"PCTE",0
41,"41061",2144,1763,1712,7,51,"PCTE",2
42,"42001",251,186,186,2,0,"PCTE",0
34,"34165",59,51,50,1,1,"PCTE",0
42,"42161",135,104,104,0,0,"PCTE",0
2,"2030",2978,2357,2315,13,42,"PCTE",3
42,"42129",678,540,539,1,1,"PCTE",1
18,"18108",826,677,669,3,8,"PCTE",2
9,"9294",102,86,85,0,1,"PCTE",0
37,"37288",276,225,224,5,1,"PCTE",0
47,"47066",1407,1131,1122,11,9,"PCTE",0
49,"49004",111,77,77,4,0,"PCTE",0
37,"37016",574,464,455,3,9,"PCTE",0
34,"34133",105,88,86,1,2,"PCTE",0
9,"9220",70,59,58,0,1,"PCTE",0
18,"18099",1581,1279,1245,5,34,"PCTE",0
9,"9438",561,485,473,6,12,"PCTE",0
37,"37302",262,182,181,2,1,"PCTE",0
40,"40190",48,40,39,0,1,"PCTE",0
47,"47205",355,263,258,3,5,"PCTE",0
2,"2044",1049,746,737,5,9,"PCTE",1
34,"34059",402,326,320,3,6,"PCTE",0
49,"49176",610,426,426,4,0,"PCTE",0
24,"24053",406,279,276,6,3,"PCTE",0
41,"41082",3359,2760,2718,11,42,"PCTE",1
16,"16250",65,41,41,0,0,"PCTE",0
9,"9388",33,28,28,0,0,"PCTE",0
47,"47068",30,23,23,0,0,"PCTE",0
37,"37366",41,30,30,0,0,"PCTE",0
50,"50260",32,28,28,0,0,"PCTE",0
40,"40168",28,22,22,0,0,"PCTE",0
14,"14029",4029,3089,3039,15,50,"PCTE",2
28,"28021",576,387,386,3,1,"PCTE",1
40,"40097",125,96,95,1,1,"PCTE",0
42,"42100",31,27,27,0,0,"PCTE",0
18,"18194",2045,1394,1370,11,24,"PCTE",0
16,"16197",66,45,45,0,0,"PCTE",0
2,"2046",1132,975,953,10,22,"PCTE",2
49,"49030",80,66,62,0,4,"PCTE",0
34,"34048",63,54,53,2,1,"PCTE",0
49,"49007",365,271,265,7,6,"PCTE",0
37,"37367",185,150,148,4,2,"PCTE",0
16,"16154",4752,3798,3732,37,66,"PCTE",2
29,"29049",2926,2197,2165,9,32,"PCTE",1
16,"16029",102,81,81,1,0,"PCTE",0
28,"28128",445,352,352,2,0,"PCTE",0
39,"39070",123,101,99,0,2,"PCTE",0
29,"29005",4499,3202,3171,37,31,"PCTE",4
34,"34107",73,54,54,2,0,"PCTE",0
16,"16187",55,43,43,0,0,"PCTE",0
49,"49115",169,137,136,0,1,"PCTE",0
9,"9064",305,251,249,3,2,"PCTE",0
50,"50186",37,28,28,0,0,"PCTE",0
24,"24082",860,690,678,12,12,"PCTE",0
42,"42135",70,46,45,0,1,"PCTE",0
40,"40041",967,773,764,9,9,"PCTE",0
9,"9443",152,115,112,0,3,"PCTE",0
49,"49207",217,151,148,4,3,"PCTE",0
49,"49090",193,153,151,0,2,"PCTE",0
16,"16070",28,26,26,1,0,"PCTE",0
34,"34049",329,251,247,5,4,"PCTE",1
37,"37021",69,52,51,1,1,"PCTE",0
50,"50030",201,138,136,1,2,"PCTE",0
16,"16143",15,10,10,1,0,"PCTE",0
37,"37257",49,40,40,1,0,"PCTE",0
28,"28109",1622,1205,1192,3,13,"PCTE",0
9,"9019",144,113,109,1,4,"PCTE",1
37,"37106",249,173,173,1,0,"PCTE",0
49,"49193",435,303,287,1,16,"PCTE",0
37,"37181",264,185,184,1,1,"PCTE",0
40,"40184",248,205,203,0,2,"PCTE",0
47,"47167",242,212,210,0,2,"PCTE",0
34,"34094",61,44,44,0,0,"PCTE",0
9,"9340",76,56,56,1,0,"PCTE",0
9,"9175",119,93,93,0,0,"PCTE",0
42,"42076",201,157,151,0,6,"PCTE",0
16,"16058",97,73,73,0,0,"PCTE",0
49,"49130",158,131,131,5,0,"PCTE",0
50,"50119",872,684,680,4,4,"PCTE",1
39,"39035",9169,7135,7045,40,90,"PCTE",2
50,"50120",55,43,43,2,0,"PCTE",0
9,"9159",61,52,51,0,1,"PCTE",0
39,"39054",4528,3614,3575,23,39,"PCTE",3
49,"49092",116,87,86,0,1,"PCTE",0
24,"24166",1359,1038,1011,11,27,"PCTE",0
50,"50150",621,451,450,2,1,"PCTE",0
16,"16205",107,80,79,0,1,"PCTE",1
2,"2014",350,285,280,1,5,"PCTE",0
9,"9160",80,64,64,1,0,"PCTE",0
14,"14004",1981,1522,1509,8,13,"PCTE",2
34,"34052",167,144,143,2,1,"PCTE",0
49,"49255",396,324,323,3,1,"PCTE",0
37,"37222",86,64,62,0,2,"PCTE",0
34,"34005",792,659,645,5,14,"PCTE",1
16,"16074",28,23,23,0,0,"PCTE",0
39,"39102",2255,1711,1698,11,13,"PCTE",0
50,"50162",137,112,110,2,2,"PCTE",0
49,"49094",213,138,138,0,0,"PCTE",0
47,"47222",86,71,71,0,0,"PCTE",0
42,"42094",603,484,475,10,9,"PCTE",1
41,"41004",57465,41004,40321,571,683,"PCTE",31
34,"34179",26,20,19,0,1,"PCTE",0
28,"28047",42847,33561,33215,216,346,"PCTE",23
2,"2028",118,99,98,4,1,"PCTE",0
40,"40080",48,39,39,0,0,"PCTE",0
34,"34201",171,139,139,0,0,"PCTE",0
37,"37025",244,209,206,0,3,"PCTE",0
29,"29022",171,144,143,0,1,"PCTE",0
16,"16209",111,97,97,0,0,"PCTE",0
42,"42052",17,15,15,0,0,"PCTE",0
33,"33022",813,555,543,6,12,"PCTE",11
34,"34084",155,127,126,1,1,"PCTE",0
37,"37097",44,29,29,0,0,"PCTE",0
29,"29067",430670,312817,309994,2768,2823,"PCTE",250
34,"34057",462,345,330,3,15,"PCTE",0
42,"42095",1857,1498,1473,21,25,"PCTE",0
9,"9437",270,227,224,2,3,"PCTE",0
16,"16211",322,233,229,0,4,"PCTE",0
50,"50133",100,82,82,2,0,"PCTE",0
33,"33023",3271,2448,2397,35,51,"PCTE",2
9,"9270",159,119,117,4,2,"PCTE",0
47,"47192",94,82,81,2,1,"PCTE",0
9,"9219",27153,20116,19831,215,285,"PCTE",36
47,"47204",235,182,178,0,4,"PCTE",0
9,"9026",371,305,303,2,2,"PCTE",2
49,"49027",126,88,88,0,0,"PCTE",0
37,"37376",2164,1606,1581,15,25,"PCTE",1
40,"40223",228,181,181,0,0,"PCTE",0
47,"47015",176,136,135,0,1,"PCTE",0
40,"40048",35,29,29,0,0,"PCTE",0
16,"16212",230,198,196,2,2,"PCTE",0
34,"34011",386,326,321,2,5,"PCTE",0
34,"34236",147,111,111,0,0,"PCTE",0
37,"37226",150,119,119,2,0,"PCTE",0
42,"42041",31,23,23,1,0,"PCTE",0
34,"34184",49,39,38,0,1,"PCTE",0
24,"24078",336,259,255,0,4,"PCTE",0
50,"50105",279,216,213,4,3,"PCTE",0
18,"18146",937,690,682,6,8,"PCTE",0
9,"9332",140,103,102,0,1,"PCTE",1
33,"33015",1428,1003,993,7,10,"PCTE",4
18,"18111",2849,2193,2160,24,33,"PCTE",3
34,"34012",340,271,265,2,6,"PCTE",0
9,"9295",54,38,38,0,0,"PCTE",0
41,"41007",12438,9009,8775,135,234,"PCTE",6
39,"39041",1767,1437,1417,18,20,"PCTE",0
9,"9013",44,37,37,0,0,"PCTE",1
29,"29047",1103,909,898,2,11,"PCTE",2
40,"40074",245,219,214,5,5,"PCTE",0
50,"50241",595,434,423,3,11,"PCTE",0
41,"41064",5611,3763,3667,47,96,"PCTE",2
34,"34223",205,160,157,1,3,"PCTE",0
47,"47122",2016,1655,1617,15,38,"PCTE",0
9,"9456",137,104,104,0,0,"PCTE",0
9,"9189",126,102,96,0,6,"PCTE",0
41,"41036",3917,2944,2885,27,59,"PCTE",1
24,"24054",417,318,311,0,7,"PCTE",0
34,"34156",50,43,43,0,0,"PCTE",0
16,"16216",278,243,240,0,3,"PCTE",0
34,"34061",96,77,77,2,0,"PCTE",0
50,"50252",5057,3661,3613,36,48,"PCTE",1
50,"50194",81,59,59,1,0,"PCTE",0
24,"24174",469,360,354,5,6,"PCTE",0
37,"37154",129,106,102,3,4,"PCTE",0
37,"37267",182,153,150,1,3,"PCTE",0
42,"42031",26,19,19,1,0,"PCTE",0
9,"9048",1380,1070,1039,8,31,"PCTE",10
41,"41009",1167,820,805,4,15,"PCTE",0
9,"9337",114,93,93,0,0,"PCTE",0
40,"40087",87,70,70,0,0,"PCTE",1
9,"9243",73,57,55,0,2,"PCTE",0
47,"47049",91,66,64,0,2,"PCTE",0
29,"29084",27218,19648,19352,173,296,"PCTE",9
50,"50077",206,158,157,1,1,"PCTE",0
37,"37192",355,234,227,5,7,"PCTE",0
28,"28043",6166,4404,4320,30,84,"PCTE",4
49,"49061",145,111,108,0,3,"PCTE",0
47,"47146",278,232,230,3,2,"PCTE",0
29,"29028",1224,875,858,4,17,"PCTE",2
16,"16087",226,191,184,3,7,"PCTE",0
18,"18093",2756,1902,1885,8,17,"PCTE",2
47,"47019",91,74,73,0,1,"PCTE",0
24,"24219",492,374,371,5,3,"PCTE",1
18,"18902",755,611,595,1,16,"PCTE",0
9,"9303",75,67,67,0,0,"PCTE",0
37,"37078",788,670,658,6,12,"PCTE",2
49,"49250",1194,954,939,8,15,"PCTE",1
24,"24177",472,330,326,3,4,"PCTE",0
16,"16219",81,64,63,0,1,"PCTE",0
40,"40160",93,72,72,0,0,"PCTE",0
2,"2025",7355,5864,5693,30,171,"PCTE",3
37,"37346",252,214,213,3,1,"PCTE",0
40,"40127",35,28,28,0,0,"PCTE",0
18,"18903",851,644,636,1,8,"PCTE",0
16,"16045",185,142,141,0,1,"PCTE",0
24,"24019",341,279,272,0,7,"PCTE",0
40,"40161",35,28,26,0,2,"PCTE",0
37,"37092",1889,1459,1447,16,12,"PCTE",1
9,"9176",59,50,47,2,3,"PCTE",0
37,"37309",37,27,27,0,0,"PCTE",0
50,"50255",197,162,160,2,2,"PCTE",0
37,"37035",165,134,134,0,0,"PCTE",0
47,"47178",166,144,143,4,1,"PCTE",1
39,"39082",1622,1261,1252,16,9,"PCTE",4
9,"9037",106,97,97,0,0,"PCTE",1
9,"9195",55,45,45,1,0,"PCTE",0
16,"16033",1644,1345,1320,11,25,"PCTE",2
14,"14014",2509,2071,2030,7,41,"PCTE",2
37,"37122",203,174,174,1,0,"PCTE",0
50,"50052",85,64,64,0,0,"PCTE",0
40,"40233",396,323,320,2,3,"PCTE",0
50,"50140",157,108,108,0,0,"PCTE",0
2,"2063",1375,1067,1047,1,20,"PCTE",2
9,"9138",87,74,72,2,2,"PCTE",0
50,"50170",364,286,279,1,7,"PCTE",0
49,"49229",113,88,87,0,1,"PCTE",0
24,"24167",716,516,505,4,11,"PCTE",0
49,"49081",1322,1051,1030,11,21,"PCTE",1
24,"24194",266,199,199,1,0,"PCTE",1
29,"29032",6657,5314,5190,30,124,"PCTE",5
16,"16245",400,329,318,0,11,"PCTE",0
47,"47190",95,81,81,1,0,"PCTE",0
42,"42111",279,209,208,3,1,"PCTE",0
50,"50199",325,238,232,3,6,"PCTE",0
40,"40199",101,79,78,0,1,"PCTE",0
39,"39065",232,190,189,5,1,"PCTE",0
39,"39009",3307,2545,2526,11,19,"PCTE",1
49,"49269",220,163,162,1,1,"PCTE",0
49,"49231",293,212,209,0,3,"PCTE",1
24,"24181",1414,1067,1055,14,12,"PCTE",0
34,"34025",53,37,37,2,0,"PCTE",0
28,"28079",2374366,1872679,1859094,11998,13585,"PCTE",1067
16,"16036",122,98,97,1,1,"PCTE",0
50,"50152",1368,1061,1043,6,18,"PCTE",0
39,"39020",23931,17782,17566,126,216,"PCTE",17
40,"40107",92,76,74,0,2,"PCTE",0
49,"49002",58,49,43,0,6,"PCTE",0
34,"34056",1949,1537,1511,7,26,"PCTE",2
37,"37275",101,69,67,0,2,"PCTE",0
29,"29001",4199,3380,3341,20,39,"PCTE",2
14,"14027",7876,6227,6103,81,124,"PCTE",10
47,"47181",165,143,143,0,0,"PCTE",1
49,"49067",336,236,232,0,4,"PCTE",0
42,"42204",54,45,43,2,2,"PCTE",0
24,"24226",193,136,134,2,2,"PCTE",1
39,"39011",1575,1249,1242,3,7,"PCTE",0
16,"16094",120,89,88,0,1,"PCTE",1
40,"40165",74,56,54,1,2,"PCTE",0
24,"24145",618,443,435,3,8,"PCTE",0
9,"9143",27,18,18,0,0,"PCTE",0
50,"50026",421,340,328,4,12,"PCTE",0
50,"50286",75,58,55,0,3,"PCTE",0
49,"49233",85,58,58,0,0,"PCTE",0
49,"49188",110,87,86,0,1,"PCTE",0
9,"9368",28,21,21,1,0,"PCTE",0
49,"49097",74,43,43,0,0,"PCTE",0
49,"49098",204,157,153,2,4,"PCTE",0
24,"24131",677,468,463,1,5,"PCTE",1
28,"28104",15318,12897,12797,87,100,"PCTE",6
37,"37189",114,88,88,2,0,"PCTE",0
49,"49136",312,227,220,3,7,"PCTE",0
40,"40122",525,442,434,2,8,"PCTE",0
28,"28041",4788,4012,3973,23,39,"PCTE",3
28,"28020",169,110,109,0,1,"PCTE",0
16,"16902",127,101,101,0,0,"PCTE",0
29,"29069",86694,58863,58127,561,736,"PCTE",44
40,"40109",72,59,54,1,5,"PCTE",0
28,"28149",6172,5089,5038,31,51,"PCTE",2
42,"42117",133,109,106,0,3,"PCTE",0
9,"9256",333,260,256,2,4,"PCTE",0
41,"41099",3968,2666,2642,23,24,"PCTE",2
16,"16237",98,83,83,0,0,"PCTE",0
47,"47163",280,238,232,2,6,"PCTE",1
50,"50009",97,72,71,1,1,"PCTE",0
47,"47058",202,154,153,3,1,"PCTE",2
33,"33067",747,608,596,9,12,"PCTE",2
14,"14060",3694,2878,2798,26,80,"PCTE",6
50,"50289",51,40,38,1,2,"PCTE",0
34,"34170",51,35,35,0,0,"PCTE",0
37,"37355",162,137,135,0,2,"PCTE",0
16,"16140",19,16,16,0,0,"PCTE",0
18,"18100",7981,5900,5769,44,131,"PCTE",10
47,"47154",146,122,118,2,4,"PCTE",0
37,"37318",199,152,152,1,0,"PCTE",0
34,"34076",545,475,473,2,2,"PCTE",0
39,"39014",901,709,704,5,5,"PCTE",0
16,"16272",199,162,161,1,1,"PCTE",0
49,"49102",183,136,135,2,1,"PCTE",0
28,"28118",61,52,51,0,1,"PCTE",0
9,"9078",37,31,31,0,0,"PCTE",0
40,"40135",269,224,221,1,3,"PCTE",0
39,"39042",5930,4722,4676,26,46,"PCTE",2
37,"37243",90,71,70,0,1,"PCTE",0
40,"40136",106,82,81,0,1,"PCTE",0
9,"9050",52,36,36,0,0,"PCTE",0
37,"37204",255,197,195,0,2,"PCTE",0
29,"29039",2728,2084,2050,14,34,"PCTE",5
49,"49032",287,224,222,0,2,"PCTE",0
37,"37046",10749,8133,7989,84,144,"PCTE",8
9,"9375",42,38,38,0,0,"PCTE",1
34,"34079",1715,1421,1402,10,19,"PCTE",1
18,"18102",8227,6100,5969,32,131,"PCTE",15
9,"9101",74,57,57,0,0,"PCTE",0
9,"9428",103,86,86,0,0,"PCTE",0
16,"16906",71,52,52,1,0,"PCTE",0
24,"24190",146,109,109,1,0,"PCTE",1
18,"18174",434,362,357,0,5,"PCTE",0
9,"9429",55,41,41,0,0,"PCTE",0
28,"28162",2771,2264,2243,6,21,"PCTE",3
37,"37206",91,66,63,1,3,"PCTE",0
24,"24070",3941,3007,2947,27,60,"PCTE",7
47,"47092",102,86,85,0,1,"PCTE",0
47,"47157",495,428,426,3,2,"PCTE",0
41,"41102",14750,10972,10677,110,295,"PCTE",12
34,"34035",100,84,82,1,2,"PCTE",0
16,"16101",139,123,122,0,1,"PCTE",0
41,"41086",16209,11006,10881,116,125,"PCTE",16
37,"37049",127,89,89,0,0,"PCTE",0
47,"47148",423,342,339,2,3,"PCTE",0
16,"16171",1749,1449,1422,6,27,"PCTE",0
47,"47093",797,628,615,6,13,"PCTE",1
37,"37207",325,260,258,1,2,"PCTE",0
28,"28056",914,715,703,4,12,"PCTE",0
34,"34229",58,42,40,1,2,"PCTE",0
18,"18069",497,374,366,4,8,"PCTE",2
37,"37321",149,121,121,0,0,"PCTE",0
33,"33010",1724,1211,1202,15,9,"PCTE",1
50,"50236",101,82,80,1,2,"PCTE",0
47,"47149",45,39,39,1,0,"PCTE",0
41,"41059",35105,27781,27472,261,309,"PCTE",18
40,"40105",44,39,38,0,1,"PCTE",0
39,"39073",10200,8230,8150,65,80,"PCTE",5
24,"24155",442,374,371,6,3,"PCTE",0
37,"37248",152,125,121,1,4,"PCTE",0
16,"16191",858,707,701,8,6,"PCTE",0
33,"33011",10659,6448,6332,119,116,"PCTE",13
29,"29010",1632,1372,1319,4,53,"PCTE",0
28,"28902",523,418,415,2,3,"PCTE",0
40,"40070",148,110,107,1,3,"PCTE",0
37,"37051",80,59,58,0,1,"PCTE",0
47,"47095",41,36,34,2,2,"PCTE",0
16,"16228",176,150,150,1,0,"PCTE",0
49,"49013",229,176,175,4,1,"PCTE",0
9,"9216",374,283,281,2,2,"PCTE",0
40,"40176",375,325,322,6,3,"PCTE",0
18,"18178",671,535,532,0,3,"PCTE",0
18,"18915",731,539,532,1,7,"PCTE",0
29,"29044",757,540,533,7,7,"PCTE",0
49,"49120",53,39,39,0,0,"PCTE",0
40,"40210",98,70,70,0,0,"PCTE",0
16,"16193",58,51,51,2,0,"PCTE",1
41,"41904",1792,1171,1162,16,9,"PCTE",0
50,"50091",40,35,35,0,0,"PCTE",0
33,"33073",8186,5090,5023,65,67,"PCTE",5
16,"16161",52,47,47,0,0,"PCTE",0
40,"40142",52,42,40,0,2,"PCTE",0
47,"47014",47,43,43,1,0,"PCTE",0
29,"29023",2290,1569,1550,3,19,"PCTE",0
39,"39066",877,711,705,5,6,"PCTE",0
40,"40211",69,58,58,1,0,"PCTE",0
49,"49201",285,243,243,7,0,"PCTE",0
49,"49083",50,41,41,1,0,"PCTE",0
37,"37137",99,65,65,0,0,"PCTE",0
42,"42082",7,7,7,0,0,"PCTE",0
24,"24115",53267,39733,39172,433,561,"PCTE",61
49,"49003",869,627,624,3,3,"PCTE",0
37,"37363",107,81,80,0,1,"PCTE",0
47,"47065",817,658,653,2,5,"PCTE",0
2,"2006",561,482,480,2,2,"PCTE",1
2,"2043",1173,975,962,1,13,"PCTE",0
34,"34045",73,67,65,0,2,"PCTE",0
50,"50240",965,720,702,9,18,"PCTE",2
37,"37055",118,96,95,0,1,"PCTE",0
18,"18074",264,207,205,0,2,"PCTE",0
28,"28167",8608,7086,7015,48,71,"PCTE",4
29,"29902",2592,1841,1817,18,24,"PCTE",1
40,"40143",83,73,73,2,0,"PCTE",1
9,"9330",1480,1180,1161,8,19,"PCTE",1
24,"24079",872,671,665,4,6,"PCTE",1
24,"24092",745,606,601,6,5,"PCTE",4
50,"50155",90,70,69,0,1,"PCTE",0
47,"47088",105,90,90,0,0,"PCTE",0
2,"2081",18331,14219,13987,108,232,"PCTE",7
50,"50084",66,47,47,0,0,"PCTE",0
37,"37252",101,80,79,1,1,"PCTE",0
50,"50036",100,80,80,0,0,"PCTE",0
16,"16152",32,28,28,1,0,"PCTE",0
47,"47132",39,33,33,0,0,"PCTE",0
29,"29004",295,233,226,0,7,"PCTE",0
9,"9439",1054,867,851,8,16,"PCTE",7
50,"50066",2835,2199,2177,19,22,"PCTE",1
24,"24118",104,66,66,0,0,"PCTE",0
24,"24201",1039,775,765,5,10,"PCTE",0
33,"33036",11335,8356,8243,92,113,"PCTE",15
16,"16084",50,36,32,0,4,"PCTE",0
37,"37102",379,297,291,3,6,"PCTE",0
24,"24040",412,322,320,2,2,"PCTE",0
34,"34186",47,41,41,0,0,"PCTE",0
49,"49165",55,53,50,0,3,"PCTE",0
24,"24081",122,91,88,0,3,"PCTE",0
42,"42086",33,21,19,0,2,"PCTE",0
29,"29904",417,337,335,2,2,"PCTE",0
16,"16153",936,786,768,7,18,"PCTE",0
49,"49206",794,584,570,7,14,"PCTE",1
50,"50156",209,174,171,1,3,"PCTE",0
18,"18011",4376,3286,3248,18,38,"PCTE",0
34,"34092",260,210,206,0,4,"PCTE",0
33,"33068",1047,624,620,8,4,"PCTE",1
47,"47123",461,391,390,3,1,"PCTE",0
39,"39098",1379,1154,1144,7,10,"PCTE",0
37,"37007",399,311,306,3,5,"PCTE",0
50,"50096",36,22,22,0,0,"PCTE",0
14,"14010",4001,3106,3068,15,38,"PCTE",1
9,"9391",361,286,283,3,3,"PCTE",0
42,"42182",51,42,42,1,0,"PCTE",0
37,"37104",25,18,18,0,0,"PCTE",0
37,"37332",70,53,53,0,0,"PCTE",0
14,"14041",3115,2449,2376,45,73,"PCTE",4
39,"39024",1815,1436,1420,14,16,"PCTE",0
18,"18149",5401,4290,4212,28,78,"PCTE",2
40,"40216",774,670,665,11,5,"PCTE",0
9,"9444",63,43,43,2,0,"PCTE",0
24,"24042",61,47,47,1,0,"PCTE",0
50,"50129",213,151,149,5,2,"PCTE",0
41,"41038",102179,76348,75425,819,923,"PCTE",69
34,"34140",96,69,69,1,0,"PCTE",0
18,"18079",3469,2667,2623,16,44,"PCTE",3
49,"49091",248,185,183,4,2,"PCTE",0
49,"49128",533,428,424,7,4,"PCTE",0
37,"37060",280,224,224,0,0,"PCTE",0
50,"50040",86,71,71,0,0,"PCTE",0
41,"41066",1310,1027,1010,1,17,"PCTE",0
24,"24005",345,255,250,2,5,"PCTE",0
9,"9020",237,184,180,5,4,"PCTE",0
29,"29074",781,606,597,2,9,"PCTE",0
29,"29019",864,687,679,7,8,"PCTE",1
42,"42141",114,89,89,0,0,"PCTE",0
2,"2050",90,75,75,0,0,"PCTE",0
40,"40139",258,207,202,0,5,"PCTE",0
50,"50179",264,231,228,0,3,"PCTE",0
49,"49048",114,85,85,0,0,"PCTE",0
9,"9067",407,285,278,2,7,"PCTE",0
34,"34004",5533,4345,4286,41,59,"PCTE",4
49,"49210",448,372,370,3,2,"PCTE",1
16,"16158",511,428,417,4,11,"PCTE",0
42,"42185",25,20,20,0,0,"PCTE",0
37,"37372",134,104,104,0,0,"PCTE",0
9,"9431",120,98,98,3,0,"PCTE",0
29,"29020",3280,2531,2485,23,46,"PCTE",2
42,"42092",62,42,41,1,1,"PCTE",0
16,"16259",27,22,21,0,1,"PCTE",0
50,"50161",103,80,80,0,0,"PCTE",0
9,"9229",183,136,136,2,0,"PCTE",0
24,"24087",586,469,460,4,9,"PCTE",0
2,"2051",1665,1253,1222,6,31,"PCTE",1
49,"49171",610,477,473,8,4,"PCTE",2
47,"47074",141,122,122,2,0,"PCTE",1
14,"14035",5817,4373,4314,44,59,"PCTE",3
50,"50217",431,346,344,0,2,"PCTE",0
37,"37209",410,288,283,3,5,"PCTE",2
50,"50033",65,50,50,1,0,"PCTE",0
24,"24061",1736,1350,1328,10,22,"PCTE",1
2,"2016",538,405,401,4,4,"PCTE",2
9,"9346",89,69,68,1,1,"PCTE",0
29,"29054",42393,30327,30108,218,219,"PCTE",21
16,"16263",966,763,755,2,8,"PCTE",0
40,"40152",748,637,620,6,17,"PCTE",0
42,"42188",43,35,34,1,1,"PCTE",0
47,"47075",4775,3849,3784,38,65,"PCTE",2
9,"9449",92,75,74,1,1,"PCTE",0
9,"9071",40,32,32,0,0,"PCTE",0
49,"49133",291,213,211,0,2,"PCTE",0
14,"14046",4443,3550,3486,38,64,"PCTE",3
49,"49038",94,68,68,1,0,"PCTE",0
37,"37136",633,448,434,8,14,"PCTE",1
37,"37098",304,214,210,0,4,"PCTE",0
47,"47223",152,123,120,2,3,"PCTE",0
40,"40071",43,37,31,0,6,"PCTE",0
18,"18120",257,219,217,1,2,"PCTE",0
49,"49096",157,129,123,2,6,"PCTE",0
24,"24129",111,91,91,1,0,"PCTE",0
37,"37338",78,66,64,0,2,"PCTE",0
18,"18085",701,465,460,1,5,"PCTE",0
24,"24170",1839,1417,1391,7,26,"PCTE",5
50,"50192",233,189,183,0,6,"PCTE",0
28,"28147",990,779,769,2,10,"PCTE",0
50,"50220",43,37,37,0,0,"PCTE",0
9,"9450",25,17,17,0,0,"PCTE",0
37,"37113",409,330,329,3,1,"PCTE",2
40,"40082",106,83,81,0,2,"PCTE",1
16,"16162",39,31,30,0,1,"PCTE",0
37,"37150",36,31,31,0,0,"PCTE",0
39,"39030",1895,1374,1358,6,16,"PCTE",0
49,"49259",79,62,61,0,1,"PCTE",0
28,"28115",62352,53136,52912,268,224,"PCTE",9
29,"29024",372,265,250,3,15,"PCTE",0
41,"41072",4037,3256,3221,19,35,"PCTE",1
50,"50074",6166,4547,4444,33,103,"PCTE",2
41,"41006",2738,1971,1945,16,26,"PCTE",1
49,"49222",370,284,282,2,2,"PCTE",0
50,"50269",279,189,186,1,3,"PCTE",0
49,"49175",205,150,149,2,1,"PCTE",0
14,"14038",32692,24015,23679,213,336,"PCTE",20
18,"18051",1090,800,795,13,5,"PCTE",2
50,"50018",893,705,696,3,9,"PCTE",2
29,"29025",41515,29572,29311,221,261,"PCTE",17
49,"49041",414,309,307,4,2,"PCTE",0
34,"34135",399,320,315,4,5,"PCTE",2
2,"2020",431,359,356,3,3,"PCTE",0
47,"47047",202,164,161,3,3,"PCTE",0
16,"16270",156,124,124,1,0,"PCTE",0
34,"34060",135,111,110,0,1,"PCTE",0
28,"28137",1744,1385,1366,8,19,"PCTE",1
40,"40203",958,801,788,6,13,"PCTE",5
49,"49177",260,165,162,2,3,"PCTE",0
34,"34208",47,38,38,0,0,"PCTE",0
49,"49057",105,85,81,2,4,"PCTE",0
50,"50106",127,97,96,0,1,"PCTE",0
16,"16085",135,109,109,1,0,"PCTE",0
41,"41091",539730,412509,408312,3804,4197,"PCTE",262
47,"47112",2570,2098,2075,13,23,"PCTE",1
9,"9298",75,62,62,1,0,"PCTE",0
9,"9353",76,64,63,2,1,"PCTE",0
9,"9410",2999,2175,2135,27,40,"PCTE",4
50,"50136",534,416,405,2,11,"PCTE",1
47,"47144",75,63,63,1,0,"PCTE",0
49,"49101",147,99,96,0,3,"PCTE",0
28,"28150",3187,2640,2604,20,36,"PCTE",1
47,"47175",6704,5296,5222,52,74,"PCTE",6
39,"39061",3488,2833,2798,18,35,"PCTE",1
41,"41074",2998,2364,2322,17,42,"PCTE",2
42,"42195",92,53,53,1,0,"PCTE",0
16,"16167",292,235,229,1,6,"PCTE",1
49,"49224",169,117,115,0,2,"PCTE",1
47,"47207",260,213,211,2,2,"PCTE",0
39,"39033",540,430,423,1,7,"PCTE",1
24,"24136",496,375,371,2,4,"PCTE",0
34,"34157",2364,1881,1846,13,35,"PCTE",2
16,"16273",303,236,231,2,5,"PCTE",0
37,"37381",139,97,95,1,2,"PCTE",0
18,"18162",929,730,719,4,11,"PCTE",0
9,"9463",250,203,201,6,2,"PCTE",0
28,"28074",140580,113723,112489,776,1234,"PCTE",106
41,"41075",10279,7543,7370,96,173,"PCTE",1
29,"29062",651,576,567,4,9,"PCTE",0
40,"40126",67,53,51,0,2,"PCTE",0
28,"28014",34047,26858,26575,178,283,"PCTE",25
40,"40054",107,91,88,0,3,"PCTE",0
37,"37077",252,216,213,2,3,"PCTE",0
37,"37307",148,110,107,2,3,"PCTE",0
16,"16274",103,86,85,0,1,"PCTE",0
34,"34214",178,141,141,1,0,"PCTE",0
33,"33029",323,172,170,2,2,"PCTE",1
49,"49181",335,227,224,2,3,"PCTE",0
33,"33060",14132,9960,9794,135,166,"PCTE",27
47,"47210",402,300,289,2,11,"PCTE",1
37,"37120",97,83,81,1,2,"PCTE",0
24,"24058",195,127,125,1,2,"PCTE",0
14,"14043",7408,5721,5619,76,102,"PCTE",3
9,"9084",167,132,127,4,5,"PCTE",1
50,"50254",174,123,122,0,1,"PCTE",0
34,"34067",129,87,87,0,0,"PCTE",1
40,"40162",387,286,278,3,8,"PCTE",0
34,"34215",162,143,142,3,1,"PCTE",0
40,"40020",155,125,119,4,6,"PCTE",0
47,"47211",48,43,43,1,0,"PCTE",0
42,"42108",10,7,7,0,0,"PCTE",0
49,"49170",98,75,75,1,0,"PCTE",0
40,"40092",113,86,84,2,2,"PCTE",0
40,"40128",122,95,93,2,2,"PCTE",0
49,"49268",368,282,279,2,3,"PCTE",1
41,"41021",21397,15585,15334,201,251,"PCTE",7
34,"34068",29,24,23,0,1,"PCTE",0
9,"9467",60,46,46,0,0,"PCTE",0
39,"39064",1341,1103,1094,5,9,"PCTE",0
18,"18164",1794,1225,1205,9,20,"PCTE",3
28,"28016",78,62,61,1,1,"PCTE",0
37,"37081",871,725,717,4,8,"PCTE",1
24,"24034",3457,2627,2588,31,39,"PCTE",3
47,"47117",286,240,235,0,5,"PCTE",0
9,"9009",158,139,137,4,2,"PCTE",0
40,"40164",185,136,134,3,2,"PCTE",0
49,"49065",1073,789,777,3,12,"PCTE",1
18,"18905",15550,11394,11230,132,164,"PCTE",8
42,"42063",47,31,28,0,3,"PCTE",0
42,"42159",40,36,35,0,1,"PCTE",0
39,"39037",2019,1572,1560,2,12,"PCTE",1
42,"42025",1134,824,813,6,11,"PCTE",3
40,"40093",76,68,67,0,1,"PCTE",0
50,"50171",96,78,78,1,0,"PCTE",0
28,"28123",61103,52177,51832,338,345,"PCTE",18
47,"47180",57,46,46,1,0,"PCTE",0
50,"50102",820,653,642,9,11,"PCTE",0
37,"37067",3254,2742,2714,29,28,"PCTE",5
37,"37149",61,56,54,1,2,"PCTE",0
9,"9025",108,73,72,0,1,"PCTE",0
40,"40120",196,176,169,0,7,"PCTE",0
50,"50229",65,57,56,0,1,"PCTE",0
37,"37124",196,153,153,2,0,"PCTE",0
29,"29090",1653,1215,1200,8,15,"PCTE",0
2,"2066",223,172,169,1,3,"PCTE",0
37,"37125",227,171,169,0,2,"PCTE",0
42,"42027",73,63,63,0,0,"PCTE",0
18,"18907",1774,1426,1415,10,11,"PCTE",1
33,"33033",9439,6565,6468,78,97,"PCTE",28
9,"9144",44,37,37,2,0,"PCTE",0
40,"40131",50,47,47,0,0,"PCTE",0
34,"34120",63965,50687,50117,471,570,"PCTE",64
49,"49187",1202,930,921,8,9,"PCTE",1
47,"47214",1364,1112,1074,7,38,"PCTE",1
40,"40201",43,39,37,0,2,"PCTE",0
40,"40095",464,379,369,2,10,"PCTE",0
40,"40094",364,284,279,1,5,"PCTE",0
37,"37276",126,101,101,0,0,"PCTE",0
24,"24064",1515,1159,1141,11,18,"PCTE",2
41,"41025",2019,1492,1439,7,53,"PCTE",2
28,"28050",4367,3411,3384,14,27,"PCTE",0
9,"9454",42,37,36,0,1,"PCTE",0
47,"47225",74,61,60,0,1,"PCTE",0
50,"50045",1198,957,951,3,6,"PCTE",0
50,"50027",224,170,165,1,5,"PCTE",0
47,"47173",885,708,704,7,4,"PCTE",0
40,"40132",46,32,31,1,1,"PCTE",0
49,"49273",166,111,110,0,1,"PCTE",0
16,"16052",537,429,429,2,0,"PCTE",1
34,"34169",381,314,309,6,5,"PCTE",1
42,"42206",8,4,4,0,0,"PCTE",0
37,"37165",31,22,21,0,1,"PCTE",0
16,"16139",324,249,249,2,0,"PCTE",0
24,"24148",1616,1252,1237,11,15,"PCTE",1
40,"40061",65,50,48,2,2,"PCTE",0
9,"9149",34,27,27,0,0,"PCTE",0
33,"33046",483,370,367,6,3,"PCTE",0
9,"9482",35,28,28,0,0,"PCTE",0
37,"37042",41,32,31,1,1,"PCTE",0
28,"28093",2142,1751,1728,9,23,"PCTE",0
37,"37278",789,618,613,8,5,"PCTE",0
9,"9315",393,291,286,4,5,"PCTE",0
9,"9047",54,46,45,0,1,"PCTE",0
37,"37166",199,146,144,0,2,"PCTE",0
29,"29093",2164,1704,1678,4,26,"PCTE",3
49,"49152",483,327,322,2,5,"PCTE",0
42,"42208",20,16,16,0,0,"PCTE",0
33,"33037",33247,23529,23210,297,319,"PCTE",131
24,"24028",365,297,290,2,7,"PCTE",0
50,"50001",88,71,70,0,1,"PCTE",0
16,"16186",412,358,354,1,4,"PCTE",0
28,"28160",8629,6922,6856,34,66,"PCTE",4
16,"16003",133,111,110,1,1,"PCTE",0
47,"47090",2435,1956,1921,12,35,"PCTE",0
50,"50029",604,475,467,7,8,"PCTE",0
41,"41101",6016,4524,4480,42,44,"PCTE",6
9,"9208",179,130,127,1,3,"PCTE",0
2,"2072",1525,1146,1112,4,34,"PCTE",1
18,"18173",8972,6594,6459,58,135,"PCTE",6
29,"29006",665,491,483,5,8,"PCTE",0
50,"50086",178,121,119,2,2,"PCTE",0
14,"14031",566,453,446,2,7,"PCTE",2
47,"47060",231,198,195,4,3,"PCTE",0
16,"16056",453,323,321,1,2,"PCTE",0
40,"40205",229,185,180,1,5,"PCTE",0
33,"33069",3419,2557,2533,32,24,"PCTE",7
28,"28096",19809,15584,15392,118,192,"PCTE",17
33,"33038",2234,1669,1644,16,25,"PCTE",5
50,"50059",754,599,589,6,10,"PCTE",0
37,"37357",258,0,0,0,0,"PCTE",0
40,"40172",45,37,37,0,0,"PCTE",0
16,"16057",64,53,53,0,0,"PCTE",0
34,"34176",127,106,104,2,2,"PCTE",0
34,"34175",87,67,66,0,1,"PCTE",0
49,"49239",617,437,420,7,17,"PCTE",1
18,"18001",230,173,170,1,3,"PCTE",0
18,"18068",1606,1293,1277,11,16,"PCTE",1
49,"49116",360,255,248,5,7,"PCTE",1
37,"37091",164,108,108,3,0,"PCTE",0
18,"18175",11786,8883,8730,58,153,"PCTE",5
33,"33039",1641,1251,1243,6,8,"PCTE",2
40,"40138",2127,1729,1696,18,33,"PCTE",0
40,"40231",98,80,80,2,0,"PCTE",0
16,"16102",1163,951,943,16,8,"PCTE",0
24,"24191",108,89,89,0,0,"PCTE",0
2,"2001",695,567,559,3,8,"PCTE",0
29,"29098",1235,953,935,12,18,"PCTE",0
28,"28025",404,314,305,3,9,"PCTE",0
16,"16243",379,323,318,5,5,"PCTE",0
47,"47062",157,134,134,0,0,"PCTE",0
42,"42171",114,80,79,0,1,"PCTE",0
18,"18036",3970,3197,3149,26,48,"PCTE",3
16,"16060",722,571,560,3,11,"PCTE",0
37,"37247",173,144,143,1,1,"PCTE",1
49,"49241",240,199,199,1,0,"PCTE",0
16,"16910",78,54,54,1,0,"PCTE",1
50,"50004",478,380,376,2,4,"PCTE",0
47,"47063",89,71,71,0,0,"PCTE",0
29,"29009",1441,1097,1073,8,24,"PCTE",0
41,"41087",10496,7661,7477,57,184,"PCTE",3
9,"9471",142,113,112,3,1,"PCTE",1
34,"34130",198,165,161,2,4,"PCTE",1
50,"50062",1863,1441,1416,9,25,"PCTE",2
40,"40033",67,57,57,1,0,"PCTE",0
9,"9197",137,108,107,0,1,"PCTE",1
16,"16061",941,790,763,8,27,"PCTE",1
9,"9105",97,81,76,1,5,"PCTE",1
42,"42217",34,26,26,0,0,"PCTE",0
50,"50209",2747,1993,1975,29,18,"PCTE",2
42,"42173",29702,22141,21776,301,365,"PCTE",34
16,"16147",56,32,32,0,0,"PCTE",0
42,"42127",38,27,27,1,0,"PCTE",0
33,"33012",5105,3601,3566,46,35,"PCTE",2
24,"24114",2893,2017,1989,17,28,"PCTE",3
47,"47064",37,32,29,0,3,"PCTE",0
14,"14066",5756,4396,4310,36,86,"PCTE",10
9,"9164",150,116,114,0,2,"PCTE",1
50,"50025",4516,3417,3364,35,53,"PCTE",1
34,"34039",62,49,49,0,0,"PCTE",0
40,"40035",135,111,110,0,1,"PCTE",0
37,"37362",4729,3769,3720,36,49,"PCTE",3
37,"37014",1153,414,411,4,3,"PCTE",0
50,"50239",63,47,47,0,0,"PCTE",0
16,"16149",154,130,130,2,0,"PCTE",0
40,"40178",90,63,63,1,0,"PCTE",0
50,"50123",436,344,338,1,6,"PCTE",1
9,"9166",98,77,77,1,0,"PCTE",0
37,"37175",404,321,319,8,2,"PCTE",1
50,"50007",49,34,34,0,0,"PCTE",0
29,"29012",9718,7243,7123,47,120,"PCTE",6
37,"37099",61,46,46,1,0,"PCTE",0
2,"2079",2823,2303,2253,22,50,"PCTE",7
9,"9012",92,76,75,0,1,"PCTE",0
40,"40003",121,91,89,1,2,"PCTE",0
49,"49084",268,226,223,9,3,"PCTE",0
41,"41034",23480,16510,16250,230,260,"PCTE",5
49,"49123",532,406,402,2,4,"PCTE",0
33,"33044",177352,134444,133352,1391,1092,"PCTE",201
42,"42130",51,46,45,0,1,"PCTE",0
37,"37138",219,180,176,1,4,"PCTE",0
40,"40108",110,91,90,0,1,"PCTE",0
37,"37264",55,42,42,0,0,"PCTE",0
37,"37214",116,87,87,4,0,"PCTE",1
16,"16249",1938,1544,1529,13,15,"PCTE",0
18,"18135",4434,3169,3105,23,64,"PCTE",4
9,"9113",460,369,364,3,5,"PCTE",0
47,"47036",205,162,157,1,5,"PCTE",0
9,"9112",104,76,76,1,0,"PCTE",0
9,"9014",192,143,142,0,1,"PCTE",0
24,"24199",405,302,297,3,5,"PCTE",0
18,"18007",741,533,527,6,6,"PCTE",0
34,"34046",44,31,31,0,0,"PCTE",0
28,"28031",2140,1642,1614,11,28,"PCTE",0
42,"42004",2294,1807,1767,22,40,"PCTE",1
42,"42043",3838,2897,2855,18,42,"PCTE",5
28,"28159",594,493,491,5,2,"PCTE",1
9,"9274",1045,875,867,8,8,"PCTE",5
28,"28062",288,243,236,0,7,"PCTE",0
37,"37178",99,82,82,0,0,"PCTE",0
24,"24202",7559,5449,5363,63,86,"PCTE",14
14,"14040",3755,3047,3006,21,41,"PCTE",6
34,"34238",305,261,260,2,1,"PCTE",0
2,"2082",95,83,83,0,0,"PCTE",0
47,"47100",119,104,102,2,2,"PCTE",0
49,"49126",273,161,160,1,1,"PCTE",0
29,"29016",263,217,217,0,0,"PCTE",0
9,"9276",389,283,268,5,15,"PCTE",0
42,"42006",152,115,112,2,3,"PCTE",0
33,"33048",136,87,87,1,0,"PCTE",1
42,"42007",109,89,89,1,0,"PCTE",0
42,"42073",73,58,57,0,1,"PCTE",1
47,"47069",118,96,92,1,4,"PCTE",0
50,"50068",1947,1402,1389,11,13,"PCTE",0
39,"39051",73,65,64,0,1,"PCTE",0
41,"41065",22550,16215,16010,189,205,"PCTE",6
28,"28033",4082,3172,3140,13,32,"PCTE",1
28,"28063",254,203,202,2,1,"PCTE",0
9,"9224",159,135,132,0,3,"PCTE",0
37,"37217",59,48,46,1,2,"PCTE",0
16,"16112",1468,1108,1096,6,12,"PCTE",0
24,"24163",4073,3269,3231,36,38,"PCTE",5
18,"18183",624,442,441,1,1,"PCTE",0
33,"33018",2819,2072,2044,28,28,"PCTE",2
24,"24004",494,408,403,7,5,"PCTE",0
37,"37143",375,308,306,2,2,"PCTE",2
16,"16156",82,65,65,0,0,"PCTE",0
28,"28034",370,284,280,0,4,"PCTE",0
28,"28004",6564,4798,4767,26,31,"PCTE",3
37,"37370",308,256,254,2,2,"PCTE",0
16,"16202",741,573,568,4,5,"PCTE",0
28,"28140",3139,2547,2523,12,24,"PCTE",0
47,"47040",61,45,44,0,1,"PCTE",0
16,"16255",136,108,108,0,0,"PCTE",0
16,"16071",20,18,18,0,0,"PCTE",0
16,"16258",172,128,128,2,0,"PCTE",0
9,"9339",126,105,105,1,0,"PCTE",0
18,"18184",2170,1688,1656,3,32,"PCTE",5
37,"37022",245,200,196,2,4,"PCTE",0
50,"50188",27,24,24,0,0,"PCTE",0
9,"9123",43,39,38,0,1,"PCTE",0
24,"24071",967,755,741,7,14,"PCTE",1
50,"50160",2150,1652,1619,14,33,"PCTE",1
24,"24086",266,211,210,0,1,"PCTE",0
50,"50013",200,166,166,3,0,"PCTE",0
16,"16073",188,159,155,0,4,"PCTE",0
37,"37296",298,241,239,2,2,"PCTE",0
16,"16116",77,59,59,0,0,"PCTE",0
42,"42090",88,69,68,2,1,"PCTE",0
16,"16204",241,198,196,1,2,"PCTE",0
40,"40044",139,105,103,2,2,"PCTE",0
50,"50131",210,157,156,0,1,"PCTE",0
24,"24006",487,393,387,3,6,"PCTE",1
37,"37335",389,308,301,3,7,"PCTE",1
40,"40185",815,624,618,4,6,"PCTE",0
34,"34098",783,614,605,3,9,"PCTE",1
24,"24007",753,569,563,4,6,"PCTE",0
16,"16117",1022,822,809,6,13,"PCTE",0
37,"37146",102,86,86,1,0,"PCTE",0
9,"9400",310,250,247,4,3,"PCTE",1
14,"14045",3013,2508,2468,13,40,"PCTE",2
49,"49050",504,351,351,3,0,"PCTE",0
47,"47104",2836,2339,2267,23,72,"PCTE",0
9,"9345",117,96,95,1,1,"PCTE",0
2,"2003",133957,105024,104115,786,909,"PCTE",91
42,"42189",53,44,42,0,2,"PCTE",0
50,"50218",110,92,92,0,0,"PCTE",0
49,"49095",279,221,217,0,4,"PCTE",0
24,"24049",1415,1146,1134,8,12,"PCTE",0
50,"50275",110,55,55,0,0,"PCTE",0
40,"40046",82,69,69,1,0,"PCTE",0
40,"40221",48,42,42,0,0,"PCTE",0
9,"9179",38,32,32,0,0,"PCTE",0
18,"18084",4458,3467,3417,17,50,"PCTE",0
28,"28145",2640,2014,1987,11,27,"PCTE",1
40,"40012",238,178,175,4,3,"PCTE",0
41,"41032",3843,3018,2944,17,74,"PCTE",2
41,"41070",6397,4987,4921,55,66,"PCTE",2
39,"39028",3870,3131,3094,19,37,"PCTE",1
24,"24010",8268,5968,5847,66,121,"PCTE",13
49,"49173",344,220,216,1,4,"PCTE",0
39,"39029",636,512,512,5,0,"PCTE",0
37,"37186",96,79,79,0,0,"PCTE",0
9,"9348",133,105,104,0,1,"PCTE",0
39,"39001",2065,1669,1643,16,26,"PCTE",3
37,"37187",555,437,433,0,4,"PCTE",0
28,"28080",49801,41938,41705,248,233,"PCTE",6
37,"37263",338,251,246,0,5,"PCTE",0
18,"18189",772,619,611,4,8,"PCTE",0
37,"37028",137,111,107,1,4,"PCTE",0
49,"49174",130,93,91,0,2,"PCTE",0
9,"9129",89,75,75,0,0,"PCTE",0
28,"28177",10722,9093,9029,64,64,"PCTE",6
50,"50277",49,37,37,3,0,"PCTE",0
2,"2019",2368,2009,1975,5,34,"PCTE",1
42,"42096",251,164,160,3,4,"PCTE",1
9,"9181",277,220,219,2,1,"PCTE",0
42,"42191",180,129,129,1,0,"PCTE",1
18,"18121",130,104,103,3,1,"PCTE",0
37,"37070",528,422,417,2,5,"PCTE",0
9,"9130",66,55,52,0,3,"PCTE",0
14,"14018",3611,2802,2741,25,61,"PCTE",0
42,"42177",64,55,54,6,1,"PCTE",0
37,"37228",325,278,273,0,5,"PCTE",0
28,"28148",88647,70218,69546,570,672,"PCTE",56
16,"16269",393,322,317,3,5,"PCTE",0
28,"28178",1134,949,935,1,14,"PCTE",1
40,"40157",43,33,33,2,0,"PCTE",0
50,"50278",177,137,137,2,0,"PCTE",0
42,"42055",165,124,122,2,2,"PCTE",0
29,"29059",2643,2086,2042,8,44,"PCTE",2
29,"29026",1010,747,736,3,11,"PCTE",1
9,"9440",80,66,66,0,0,"PCTE",0
2,"2021",1014,836,827,5,9,"PCTE",0
37,"37378",99,69,67,2,2,"PCTE",0
40,"40051",34,33,31,0,2,"PCTE",0
49,"49262",370,287,286,1,1,"PCTE",1
9,"9184",7,5,5,0,0,"PCTE",0
41,"41073",1685,1172,1157,13,15,"PCTE",0
28,"28042",1266,1020,1010,2,10,"PCTE",1
14,"14020",338,240,233,2,7,"PCTE",0
50,"50279",73,61,60,2,1,"PCTE",0
16,"16002",195,166,164,1,2,"PCTE",0
47,"47079",54,48,48,0,0,"PCTE",0
37,"37379",173,152,152,0,0,"PCTE",0
50,"50076",75,64,63,0,1,"PCTE",0
42,"42057",147,95,93,3,2,"PCTE",0
9,"9458",484,408,401,5,7,"PCTE",1
24,"24016",507,314,311,2,3,"PCTE",0
28,"28180",5317,4266,4222,26,44,"PCTE",1
2,"2059",313,252,250,3,2,"PCTE",0
42,"42103",554,448,442,2,6,"PCTE",0
34,"34211",175,160,160,0,0,"PCTE",0
18,"18089",14540,10725,10583,65,142,"PCTE",3
40,"40017",84,74,71,2,3,"PCTE",0
16,"16126",729,622,616,5,6,"PCTE",0
40,"40228",494,397,391,5,6,"PCTE",0
49,"49178",747,574,564,4,10,"PCTE",0
40,"40053",83,62,62,1,0,"PCTE",0
50,"50253",382,318,315,2,3,"PCTE",0
47,"47113",142,117,117,1,0,"PCTE",0
37,"37305",218,180,178,3,2,"PCTE",0
9,"9191",33,24,24,0,0,"PCTE",0
49,"49264",540,372,369,1,3,"PCTE",0
9,"9356",43,36,36,0,0,"PCTE",0
47,"47208",56,37,37,0,0,"PCTE",0
9,"9079",48,42,42,1,0,"PCTE",0
28,"28151",3251,2483,2450,11,33,"PCTE",0
47,"47147",102,85,85,0,0,"PCTE",0
40,"40088",268,200,200,0,0,"PCTE",1
9,"9035",284,213,210,1,3,"PCTE",0
41,"41093",19012,15637,15525,97,112,"PCTE",4
49,"49103",394,343,339,3,4,"PCTE",0
42,"42106",14,12,12,0,0,"PCTE",0
34,"34110",82,66,65,0,1,"PCTE",0
24,"24139",2087,1558,1540,20,18,"PCTE",1
29,"29063",303,243,239,1,4,"PCTE",0
49,"49142",249,175,173,0,2,"PCTE",1
9,"9082",36,34,34,0,0,"PCTE",0
34,"34066",57,52,48,1,4,"PCTE",0
28,"28087",3259,2643,2623,16,20,"PCTE",0
39,"39007",393,300,298,1,2,"PCTE",0
40,"40055",32,26,25,0,1,"PCTE",0
50,"50022",504,396,386,11,10,"PCTE",0
18,"18057",5540,4306,4246,30,60,"PCTE",1
18,"18094",2304,1845,1798,16,47,"PCTE",1
42,"42198",19,15,15,0,0,"PCTE",0
47,"47116",403,321,320,3,1,"PCTE",0
24,"24060",574,371,369,1,2,"PCTE",0
16,"16225",59,40,40,0,0,"PCTE",0
42,"42158",94,78,78,0,0,"PCTE",0
9,"9248",78,64,64,0,0,"PCTE",1
34,"34112",39,30,30,0,0,"PCTE",1
18,"18025",279,214,212,0,2,"PCTE",0
9,"9196",135,108,107,0,1,"PCTE",0
18,"18128",342,274,272,1,2,"PCTE",1
24,"24099",155,121,121,1,0,"PCTE",0
2,"2076",318,256,250,1,6,"PCTE",0
28,"28165",1910,1443,1430,11,13,"PCTE",5
9,"9307",112,87,86,0,1,"PCTE",0
49,"49185",156,126,120,1,6,"PCTE",0
49,"49066",449,319,314,4,5,"PCTE",0
16,"16173",190,141,141,0,0,"PCTE",2
50,"50053",650,505,497,4,8,"PCTE",0
18,"18096",344,265,265,2,0,"PCTE",0
16,"16048",409,331,330,1,1,"PCTE",0
34,"34069",2184,1737,1701,16,36,"PCTE",3
37,"37037",107,86,86,0,0,"PCTE",0
9,"9417",42,32,32,0,0,"PCTE",0
49,"49230",82,67,66,0,1,"PCTE",0
9,"9308",62,48,48,0,0,"PCTE",1
24,"24224",574,435,427,3,8,"PCTE",1
47,"47054",613,501,498,0,3,"PCTE",0
37,"37312",244,198,197,1,1,"PCTE",0
18,"18153",8796,6686,6594,59,92,"PCTE",4
47,"47118",149,111,108,1,3,"PCTE",1
37,"37313",534,413,411,1,2,"PCTE",0
28,"28124",59,52,52,0,0,"PCTE",0
40,"40058",309,277,271,0,6,"PCTE",0
16,"16134",4383,3544,3491,34,53,"PCTE",3
18,"18062",11041,8531,8355,71,176,"PCTE",7
42,"42115",95,77,77,1,0,"PCTE",0
16,"16176",31,22,22,0,0,"PCTE",0
37,"37162",209,156,153,1,3,"PCTE",0
9,"9141",602,501,493,4,8,"PCTE",0
49,"49109",562,445,444,5,1,"PCTE",0
9,"9366",75,60,60,2,0,"PCTE",0
14,"14057",6139,5054,4964,51,90,"PCTE",12
42,"42068",78,62,61,2,1,"PCTE",0
24,"24103",264,162,161,1,1,"PCTE",0
16,"16901",630,498,492,4,6,"PCTE",0
9,"9090",50,45,45,2,0,"PCTE",0
28,"28157",682,530,516,1,14,"PCTE",0
9,"9091",701,545,533,5,12,"PCTE",0
50,"50287",252,200,196,7,4,"PCTE",0
14,"14058",7859,5854,5745,51,109,"PCTE",11
42,"42116",42,30,30,1,0,"PCTE",0
29,"29035",1505,1151,1133,6,18,"PCTE",2
9,"9182",76,65,64,0,1,"PCTE",0
37,"37056",40,33,33,0,0,"PCTE",0
18,"18180",627,442,435,4,7,"PCTE",0
34,"34205",55,44,44,0,0,"PCTE",0
29,"29036",611,448,444,3,4,"PCTE",0
50,"50115",3275,2399,2355,32,44,"PCTE",1
50,"50144",31,26,25,0,1,"PCTE",0
34,"34031",26,24,24,0,0,"PCTE",0
42,"42163",46,37,37,0,0,"PCTE",0
37,"37005",67,48,48,2,0,"PCTE",0
39,"39040",4267,3428,3385,24,43,"PCTE",1
50,"50232",160,116,114,2,2,"PCTE",0
16,"16097",139,121,120,1,1,"PCTE",0
39,"39096",670,523,518,2,5,"PCTE",1
33,"33035",11226,8326,8252,112,74,"PCTE",10
9,"9369",422,328,325,8,3,"PCTE",0
49,"49113",166,139,139,1,0,"PCTE",0
9,"9423",28,26,26,0,0,"PCTE",0
49,"49071",715,500,499,3,1,"PCTE",0
39,"39069",1928,1650,1627,9,23,"PCTE",3
41,"41100",967,765,727,8,38,"PCTE",0
14,"14030",7797,6116,6036,54,80,"PCTE",4
29,"29037",215,179,179,0,0,"PCTE",0
18,"18909",539,432,426,1,6,"PCTE",0
42,"42030",89,72,72,0,0,"PCTE",0
50,"50233",104,82,82,0,0,"PCTE",0
49,"49114",40,33,32,1,1,"PCTE",0
18,"18910",730,491,487,0,4,"PCTE",0
50,"50147",751,564,559,3,5,"PCTE",1
9,"9373",406,284,268,3,16,"PCTE",0
47,"47028",30,17,17,0,0,"PCTE",0
47,"47217",1973,1569,1541,19,28,"PCTE",3
18,"18101",9410,7280,7181,72,99,"PCTE",8
47,"47059",97,75,75,0,0,"PCTE",0
37,"37130",178,150,150,2,0,"PCTE",0
9,"9100",58,46,46,0,0,"PCTE",1
49,"49153",151,110,108,0,2,"PCTE",0
49,"49077",159,104,103,0,1,"PCTE",0
2,"2035",1946,1592,1576,15,16,"PCTE",0
40,"40171",39,29,29,1,0,"PCTE",0
9,"9154",124,101,101,3,0,"PCTE",1
37,"37280",71,41,40,0,1,"PCTE",0
41,"41084",2815,2177,2111,3,66,"PCTE",91
42,"42120",132,89,87,0,2,"PCTE",0
39,"39071",422,318,316,0,2,"PCTE",0
37,"37089",62,51,50,0,1,"PCTE",0
39,"39015",824,646,644,2,2,"PCTE",0
50,"50002",125,96,91,1,5,"PCTE",0
42,"42033",50,45,44,1,1,"PCTE",0
9,"9902",446,345,341,0,4,"PCTE",0
34,"34228",76,62,62,0,0,"PCTE",0
29,"29040",1936,1419,1395,7,24,"PCTE",0
16,"16242",308,266,263,2,3,"PCTE",0
24,"24152",447,301,296,1,5,"PCTE",1
34,"34126",254,220,219,3,1,"PCTE",1
2,"2074",5891,4435,4375,41,60,"PCTE",2
42,"42123",158,118,118,2,0,"PCTE",0
24,"24109",876,635,619,3,16,"PCTE",0
2,"2037",22952,16040,15815,101,225,"PCTE",9
28,"28024",168,146,145,1,1,"PCTE",0
41,"41029",13483,10357,10199,120,158,"PCTE",3
24,"24153",233,187,183,1,4,"PCTE",0
47,"47188",99,77,77,0,0,"PCTE",0
34,"34080",5291,3802,3728,35,74,"PCTE",10
40,"40173",142,122,117,1,5,"PCTE",1
18,"18002",526,400,400,0,0,"PCTE",0
50,"50207",93,68,67,2,1,"PCTE",0
42,"42035",741,537,523,7,14,"PCTE",2
28,"28099",1923,1490,1475,7,15,"PCTE",0
49,"49118",194,151,151,1,0,"PCTE",0
33,"33070",3293,2499,2473,32,26,"PCTE",2
24,"24112",299,226,223,1,3,"PCTE",0
41,"41003",2371,1801,1760,8,41,"PCTE",0
9,"9266",103,85,85,0,0,"PCTE",0
28,"28131",13432,10500,10387,81,113,"PCTE",5
37,"37360",215,158,153,3,5,"PCTE",0
2,"2002",435,358,352,2,6,"PCTE",0
9,"9104",47,39,39,0,0,"PCTE",0
50,"50100",306,238,235,3,3,"PCTE",0
9,"9447",43,40,40,0,0,"PCTE",0
50,"50265",74,56,56,0,0,"PCTE",0
9,"9007",55,37,37,0,0,"PCTE",0
47,"47128",56,49,46,0,3,"PCTE",0
24,"24113",351,277,272,2,5,"PCTE",0
18,"18004",687,521,515,4,6,"PCTE",0
28,"28027",1200,920,906,4,14,"PCTE",1
42,"42080",150,116,116,1,0,"PCTE",0
49,"49037",177,146,143,1,3,"PCTE",0
28,"28100",4409,3425,3382,20,43,"PCTE",1
41,"41088",512,383,377,1,6,"PCTE",0
33,"33072",1455,973,963,14,10,"PCTE",3
28,"28133",6116,4581,4486,22,95,"PCTE",4
47,"47003",204,171,168,4,3,"PCTE",0
37,"37249",38,28,28,0,0,"PCTE",0
40,"40106",183,153,151,2,2,"PCTE",0
50,"50122",67,55,54,0,1,"PCTE",0
9,"9433",58,51,50,1,1,"PCTE",0
24,"24076",1286,998,981,8,17,"PCTE",0
33,"33074",3376,2345,2311,41,34,"PCTE",2
14,"14006",1321,1155,1127,4,28,"PCTE",0
50,"50006",908,705,689,3,16,"PCTE",0
47,"47129",855,715,696,3,19,"PCTE",3
50,"50092",300,234,230,1,4,"PCTE",0
42,"42128",46,41,41,0,0,"PCTE",0
33,"33043",658,462,455,4,7,"PCTE",0
2,"2078",899,705,691,3,14,"PCTE",0
34,"34233",128,118,117,2,1,"PCTE",0
50,"50267",573,440,434,7,6,"PCTE",1
28,"28134",63352,51185,50776,336,409,"PCTE",31
14,"14067",3870,3057,2998,24,59,"PCTE",2
37,"37015",205,131,130,2,1,"PCTE",0
9,"9167",53,39,36,0,3,"PCTE",2
29,"29045",1681,1263,1242,9,21,"PCTE",1
49,"49162",175,134,131,1,3,"PCTE",0
16,"16024",123,96,95,0,1,"PCTE",0
49,"49245",253,183,182,2,1,"PCTE",0
50,"50183",319,242,241,4,1,"PCTE",0
14,"14007",15042,10970,10758,86,212,"PCTE",10
24,"24198",547,402,399,4,3,"PCTE",0
49,"49085",918,673,660,5,13,"PCTE",0
40,"40144",18,16,16,0,0,"PCTE",0
9,"9027",48,41,39,0,2,"PCTE",0
42,"42097",14,7,7,0,0,"PCTE",0
29,"29046",2540,1896,1855,13,41,"PCTE",0
24,"24160",645,481,475,1,6,"PCTE",0
2,"2007",1013,820,813,6,7,"PCTE",0
49,"49246",217,180,177,2,3,"PCTE",0
50,"50125",345,264,261,3,3,"PCTE",0
42,"42131",52,37,37,0,0,"PCTE",0
37,"37365",166,132,131,1,1,"PCTE",0
42,"42042",49,42,42,1,0,"PCTE",0
18,"18193",14802,11165,10973,110,192,"PCTE",12
49,"49005",128,87,85,1,2,"PCTE",0
9,"9223",43,39,39,1,0,"PCTE",0
39,"39078",1406,1101,1090,7,11,"PCTE",0
50,"50037",127,93,93,0,0,"PCTE",0
37,"37329",39,36,36,0,0,"PCTE",0
50,"50212",32,29,29,1,0,"PCTE",0
42,"42132",135,114,113,1,1,"PCTE",1
14,"14039",2575,2037,1990,14,47,"PCTE",0
37,"37058",56,41,41,0,0,"PCTE",0
49,"49087",483,322,320,2,2,"PCTE",0
28,"28032",5042,4039,3992,23,47,"PCTE",3
47,"47195",430,335,320,2,15,"PCTE",0
29,"29070",43090,30294,29928,243,366,"PCTE",31
50,"50095",12136,9020,8928,99,92,"PCTE",7
47,"47227",55,46,46,0,0,"PCTE",0
28,"28138",63,49,49,0,0,"PCTE",0
47,"47133",2776,2317,2292,28,25,"PCTE",0
28,"28108",3642,2878,2841,16,37,"PCTE",4
16,"16068",127,104,104,4,0,"PCTE",0
24,"24041",527,371,364,4,7,"PCTE",0
42,"42044",53,41,39,0,2,"PCTE",0
9,"9172",168,132,132,1,0,"PCTE",0
50,"50126",2262,1736,1708,20,28,"PCTE",3
50,"50038",1405,1112,1099,13,13,"PCTE",2
42,"42134",2652,2028,1989,17,39,"PCTE",1
50,"50157",286,226,220,0,6,"PCTE",0
24,"24003",608,430,418,0,12,"PCTE",0
49,"49127",2430,1835,1799,30,36,"PCTE",0
16,"16155",488,411,408,3,3,"PCTE",0
34,"34093",81,70,70,0,0,"PCTE",0
37,"37180",68,39,39,1,0,"PCTE",0
42,"42088",60,53,53,0,0,"PCTE",0
50,"50272",13174,10143,10042,103,101,"PCTE",14
2,"2048",1178,989,967,7,22,"PCTE",0
9,"9065",138,118,117,1,1,"PCTE",0
24,"24043",122,71,69,0,2,"PCTE",0
29,"29051",41793,29275,28764,249,511,"PCTE",12
42,"42046",46,35,33,2,2,"PCTE",1
50,"50159",641,527,526,8,1,"PCTE",0
28,"28141",6246,4943,4890,44,53,"PCTE",4
24,"24206",1611,1286,1268,7,18,"PCTE",2
2,"2085",309,264,263,4,1,"PCTE",0
39,"39081",437,356,347,2,9,"PCTE",0
47,"47135",82,69,67,1,2,"PCTE",0
40,"40149",486,383,376,3,7,"PCTE",1
42,"42048",60,50,50,0,0,"PCTE",0
16,"16203",10167,7720,7591,49,129,"PCTE",4
16,"16032",277,224,223,1,1,"PCTE",1
50,"50130",362,252,249,1,3,"PCTE",0
47,"47198",66,47,47,0,0,"PCTE",0
49,"49169",34,28,26,0,2,"PCTE",0
9,"9395",122,95,94,0,1,"PCTE",0
37,"37023",1586,1316,1298,12,18,"PCTE",4
39,"39026",1720,1322,1312,5,10,"PCTE",1
41,"41039",31500,23692,23345,234,347,"PCTE",10
9,"9396",153,125,124,0,1,"PCTE",3
33,"33020",13000,9476,9338,108,138,"PCTE",21
24,"24124",346,231,226,2,5,"PCTE",0
28,"28143",77,62,62,0,0,"PCTE",1
34,"34143",157,125,120,1,5,"PCTE",0
40,"40115",156,131,130,4,1,"PCTE",0
40,"40079",226,179,175,1,4,"PCTE",2
18,"18014",6898,5262,5162,43,100,"PCTE",5
42,"42011",17,11,11,0,0,"PCTE",0
41,"41012",3368,2416,2361,23,55,"PCTE",6
40,"40056",32,21,21,0,0,"PCTE",0
29,"29099",969,757,735,5,22,"PCTE",0
33,"33052",704,520,513,5,7,"PCTE",0
47,"47232",100,76,76,1,0,"PCTE",0
34,"34246",69,53,53,0,0,"PCTE",0
14,"14015",2067,1575,1551,16,24,"PCTE",0
34,"34099",52,45,41,0,4,"PCTE",0
50,"50247",842,621,616,7,5,"PCTE",0
34,"34006",79,73,70,3,3,"PCTE",0
9,"9403",103,90,89,0,1,"PCTE",0
9,"9070",33,28,25,0,3,"PCTE",0
2,"2052",466,394,394,3,0,"PCTE",0
37,"37298",172,126,125,0,1,"PCTE",0
16,"16160",60,44,43,1,1,"PCTE",0
28,"28068",11554,9122,9022,44,100,"PCTE",6
24,"24211",263,219,214,3,5,"PCTE",0
28,"28175",935,775,767,3,8,"PCTE",0
28,"28113",36716,29939,29607,224,332,"PCTE",22
34,"34147",160,125,124,1,1,"PCTE",0
33,"33053",1079,738,729,6,9,"PCTE",4
50,"50191",445,341,337,2,4,"PCTE",0
40,"40013",56,47,47,0,0,"PCTE",0
47,"47076",17721,14605,14438,134,167,"PCTE",8
40,"40047",32,25,25,0,0,"PCTE",0
40,"40081",119,96,95,2,1,"PCTE",0
16,"16121",233,183,179,0,4,"PCTE",0
34,"34149",21,18,18,0,0,"PCTE",0
34,"34101",45,39,38,0,1,"PCTE",0
28,"28114",143,104,104,0,0,"PCTE",0
50,"50016",44,31,31,0,0,"PCTE",0
28,"28008",1961,1477,1456,6,21,"PCTE",1
2,"2018",796,693,682,5,11,"PCTE",2
9,"9073",963,799,787,7,12,"PCTE",0
24,"24091",585,433,423,1,10,"PCTE",0
42,"42148",9,9,9,0,0,"PCTE",0
37,"37114",78,64,59,0,5,"PCTE",0
50,"50134",118,91,89,0,2,"PCTE",0
9,"9236",35,29,29,1,0,"PCTE",0
2,"2055",1057,770,755,6,15,"PCTE",0
42,"42149",387,311,308,3,3,"PCTE",0
9,"9350",430,340,339,9,1,"PCTE",0
29,"29057",341,236,233,0,3,"PCTE",0
49,"49221",234,138,130,1,8,"PCTE",0
49,"49163",215,151,148,1,3,"PCTE",0
50,"50124",399,316,316,3,0,"PCTE",0
34,"34103",97,84,81,0,3,"PCTE",0
33,"33055",1492,1156,1121,6,35,"PCTE",2
28,"28082",6063,4939,4889,46,50,"PCTE",1
28,"28010",10538,8708,8635,54,73,"PCTE",5
16,"16213",34,29,28,0,1,"PCTE",0
16,"16165",55,49,48,1,1,"PCTE",0
49,"49260",700,558,548,8,10,"PCTE",0
40,"40202",55,38,38,0,0,"PCTE",1
14,"14049",16282,12515,12301,121,214,"PCTE",8
42,"42152",67,47,46,0,1,"PCTE",0
50,"50046",167,134,130,3,4,"PCTE",0
18,"18088",1530,1152,1142,0,10,"PCTE",8
47,"47111",998,806,795,6,11,"PCTE",0
37,"37072",145,136,134,3,2,"PCTE",0
34,"34106",113,101,101,0,0,"PCTE",0
9,"9030",119,90,89,1,1,"PCTE",0
18,"18159",999,828,824,1,4,"PCTE",1
42,"42194",146,111,111,0,0,"PCTE",0
14,"14019",6408,5163,5086,58,77,"PCTE",6
34,"34210",103,90,90,1,0,"PCTE",0
47,"47174",270,215,208,2,7,"PCTE",0
24,"24134",3294,2540,2479,25,61,"PCTE",3
37,"37190",193,144,144,1,0,"PCTE",0
14,"14050",2352,1840,1801,11,39,"PCTE",7
9,"9241",247,192,188,2,4,"PCTE",1
33,"33057",1538,1129,1097,14,32,"PCTE",2
18,"18053",1561,1102,1099,3,3,"PCTE",3
42,"42153",12,10,10,1,0,"PCTE",0
37,"37343",66,50,48,1,2,"PCTE",0
37,"37155",68,52,52,0,0,"PCTE",0
50,"50223",916,751,745,13,6,"PCTE",0
24,"24217",133,106,105,1,1,"PCTE",1
28,"28073",12751,9940,9838,63,102,"PCTE",13
41,"41018",9410,6987,6882,52,105,"PCTE",3
42,"42032",142,120,120,0,0,"PCTE",1
41,"41056",3694,3044,3009,36,35,"PCTE",4
50,"50048",33,25,25,0,0,"PCTE",0
37,"37344",235,171,168,1,3,"PCTE",0
2,"2060",1280,1039,1020,5,19,"PCTE",1
37,"37232",378,322,321,1,1,"PCTE",0
37,"37118",120,93,90,2,3,"PCTE",0
16,"16004",227,193,191,0,2,"PCTE",0
41,"41092",7679,5668,5568,61,100,"PCTE",3
16,"16128",51,44,44,0,0,"PCTE",0
33,"33058",1664,1205,1176,5,29,"PCTE",9
50,"50224",65,54,54,1,0,"PCTE",0
49,"49180",138,95,95,0,0,"PCTE",0
34,"34109",63,42,41,0,1,"PCTE",0
29,"29085",138,100,98,0,2,"PCTE",1
16,"16005",232,175,172,0,3,"PCTE",0
2,"2061",618,504,500,7,4,"PCTE",0
9,"9464",33,27,27,0,0,"PCTE",0
50,"50021",25,23,23,1,0,"PCTE",0
16,"16129",90,78,77,0,1,"PCTE",0
37,"37233",56,46,46,2,0,"PCTE",0
42,"42060",29,20,19,0,1,"PCTE",0
9,"9083",27,24,23,0,1,"PCTE",0
50,"50078",231,173,171,0,2,"PCTE",0
39,"39063",954,726,722,4,4,"PCTE",0
2,"2062",386,287,285,4,2,"PCTE",0
50,"50109",98,69,67,3,2,"PCTE",0
49,"49022",280,243,241,1,2,"PCTE",0
47,"47083",83,66,65,1,1,"PCTE",0
14,"14053",5925,4442,4348,75,94,"PCTE",3
49,"49023",909,682,674,5,8,"PCTE",1
16,"16224",77,61,60,1,1,"PCTE",0
42,"42061",272,207,204,2,3,"PCTE",0
37,"37310",172,125,124,3,1,"PCTE",0
50,"50901",140,108,108,0,0,"PCTE",0
29,"29031",1559,1139,1113,13,26,"PCTE",1
37,"37272",133,106,106,1,0,"PCTE",0
9,"9306",98,82,81,1,1,"PCTE",0
24,"24020",434,302,299,1,3,"PCTE",0
40,"40196",32,28,28,1,0,"PCTE",0
37,"37159",79,68,68,0,0,"PCTE",0
14,"14034",304,246,239,1,7,"PCTE",1
28,"28067",4361,3548,3509,14,39,"PCTE",1
9,"9905",389,308,303,2,5,"PCTE",1
33,"33001",1504,875,864,15,11,"PCTE",0
14,"14025",2857,2482,2436,14,46,"PCTE",1
16,"16174",168,143,141,1,2,"PCTE",0
18,"18027",2604,1902,1887,6,15,"PCTE",2
16,"16047",214,175,174,4,1,"PCTE",0
29,"29088",2694,2019,1951,31,68,"PCTE",0
41,"41023",7975,5918,5812,51,106,"PCTE",2
37,"37123",162,122,117,3,5,"PCTE",0
34,"34217",1251,1053,1042,7,11,"PCTE",1
37,"37160",606,431,418,6,13,"PCTE",0
42,"42201",23,20,20,0,0,"PCTE",0
18,"18132",3124,2575,2548,17,27,"PCTE",1
16,"16278",63,51,51,0,0,"PCTE",0
37,"37273",88,67,67,0,0,"PCTE",0
16,"16133",4387,3607,3544,38,63,"PCTE",8
9,"9250",259,215,214,1,1,"PCTE",0
37,"37038",751,607,592,4,15,"PCTE",2
50,"50200",475,416,407,4,9,"PCTE",0
18,"18097",995,708,702,4,6,"PCTE",0
9,"9365",27,19,19,1,0,"PCTE",0
16,"16175",5079,4279,4207,40,72,"PCTE",3
37,"37002",126,81,81,0,0,"PCTE",0
28,"28091",5474,4027,3977,26,50,"PCTE",4
42,"42065",23,18,18,2,0,"PCTE",0
24,"24225",992,762,751,5,11,"PCTE",0
34,"34116",55,45,45,0,0,"PCTE",0
28,"28018",4068,3367,3344,15,23,"PCTE",2
41,"41097",3135,2355,2308,11,47,"PCTE",0
16,"16135",118,86,85,0,1,"PCTE",1
39,"39095",2240,1809,1778,12,31,"PCTE",4
34,"34221",170,138,136,2,2,"PCTE",0
18,"18063",1217,712,702,6,10,"PCTE",0
34,"34167",110,88,88,0,0,"PCTE",0
34,"34234",68,59,57,0,2,"PCTE",0
49,"49110",345,222,220,2,2,"PCTE",0
41,"41052",3027,2357,2288,14,69,"PCTE",1
37,"37351",269,234,233,6,1,"PCTE",0
49,"49068",435,287,286,1,1,"PCTE",0
37,"37085",5002,3994,3951,40,43,"PCTE",2
9,"9311",59,47,46,0,1,"PCTE",0
42,"42016",20,13,13,0,0,"PCTE",0
9,"9407",27,23,23,0,0,"PCTE",0
47,"47057",273,204,200,0,4,"PCTE",0
16,"16137",37,27,25,0,2,"PCTE",0
41,"41053",21618,16549,16150,194,399,"PCTE",10
49,"49069",327,211,207,0,4,"PCTE",0
24,"24104",245,173,172,1,1,"PCTE",1
9,"9312",89,75,74,2,1,"PCTE",0
9,"9148",79,63,63,5,0,"PCTE",0
47,"47099",155,135,133,0,2,"PCTE",0
50,"50202",131,90,88,1,2,"PCTE",0
42,"42029",131,98,97,2,1,"PCTE",0
34,"34073",180,149,145,2,4,"PCTE",0
2,"2069",11414,9019,8883,54,136,"PCTE",3
24,"24228",626,432,426,3,6,"PCTE",0
37,"37128",242,187,184,1,3,"PCTE",0
37,"37354",5467,3960,3910,31,50,"PCTE",5
2,"2070",384,318,318,2,0,"PCTE",0
24,"24106",218,164,162,0,2,"PCTE",0
24,"24105",1498,1188,1177,18,11,"PCTE",1
28,"28127",66441,56199,55932,327,267,"PCTE",9
50,"50085",183,136,136,1,0,"PCTE",0
9,"9257",86,74,71,0,3,"PCTE",0
40,"40904",341,302,300,4,2,"PCTE",0
49,"49235",422,312,301,0,11,"PCTE",1
24,"24230",410,312,309,5,3,"PCTE",0
24,"24150",224,176,174,2,2,"PCTE",1
41,"41083",1128,865,859,6,6,"PCTE",0
24,"24107",214,170,170,2,0,"PCTE",1
40,"40204",151,109,104,1,5,"PCTE",0
42,"42165",419,288,285,8,3,"PCTE",0
47,"47155",3410,2694,2660,21,34,"PCTE",2
34,"34171",941,702,688,9,14,"PCTE",2
18,"18066",2108,1537,1525,9,12,"PCTE",1
47,"47218",979,757,745,5,12,"PCTE",1
18,"18137",1002,776,773,0,3,"PCTE",0
40,"40215",83,69,69,0,0,"PCTE",0
9,"9225",81,62,62,0,0,"PCTE",0
9,"9259",227,198,197,2,1,"PCTE",1
50,"50290",358,272,266,6,6,"PCTE",1
28,"28129",8578,6925,6853,45,72,"PCTE",3
18,"18034",486,376,374,4,2,"PCTE",0
47,"47029",50,43,43,1,0,"PCTE",0
37,"37009",196,142,141,1,1,"PCTE",0
18,"18138",2482,1698,1668,20,30,"PCTE",1
37,"37319",93,67,65,1,2,"PCTE",0
49,"49033",666,515,508,1,7,"PCTE",0
40,"40030",428,357,350,3,7,"PCTE",1
42,"42075",78,60,60,1,0,"PCTE",0
49,"49154",109,64,63,0,1,"PCTE",0
9,"9262",158,137,136,1,1,"PCTE",0
37,"37320",88,67,67,1,0,"PCTE",0
16,"16100",640,570,565,1,5,"PCTE",1
50,"50088",282,233,227,2,6,"PCTE",0
2,"2073",4844,3828,3772,28,56,"PCTE",3
9,"9001",30,27,27,0,0,"PCTE",0
29,"29007",28584,21525,21318,202,207,"PCTE",18
50,"50263",176,119,116,0,3,"PCTE",0
9,"9321",1597,1293,1280,4,13,"PCTE",1
47,"47126",44,42,42,1,0,"PCTE",0
18,"18913",781,590,577,5,13,"PCTE",0
14,"14033",1265,994,985,9,9,"PCTE",3
50,"50178",276,193,193,4,0,"PCTE",0
40,"40068",22,21,21,0,0,"PCTE",0
29,"29097",4168,3086,3009,37,77,"PCTE",3
2,"2075",1718,1470,1448,4,22,"PCTE",0
18,"18141",384,269,264,0,5,"PCTE",0
9,"9103",200,179,179,1,0,"PCTE",1
28,"28163",429,361,345,4,16,"PCTE",0
50,"50060",170,137,135,2,2,"PCTE",0
40,"40207",800,662,652,6,10,"PCTE",1
49,"49240",185,141,136,0,5,"PCTE",0
47,"47001",52,47,46,0,1,"PCTE",0
16,"16146",87,68,68,0,0,"PCTE",0
24,"24073",442,328,324,2,4,"PCTE",0
49,"49119",222,181,180,0,1,"PCTE",0
41,"41040",11111,8768,8679,76,89,"PCTE",5
47,"47127",138,92,89,1,3,"PCTE",0
34,"34199",1159,910,880,7,30,"PCTE",1
18,"18106",415,300,295,0,5,"PCTE",0
16,"16020",9,5,5,0,0,"PCTE",0
42,"42172",28,25,25,1,0,"PCTE",0
34,"34083",1664,1244,1229,10,15,"PCTE",1
18,"18037",528,435,426,2,9,"PCTE",0
37,"37013",107,73,72,0,1,"PCTE",0
50,"50237",102,81,81,3,0,"PCTE",0
9,"9163",578,490,481,5,9,"PCTE",0
49,"49158",203,163,155,0,8,"PCTE",0
9,"9432",174,145,137,0,8,"PCTE",0
9,"9326",154,129,127,4,2,"PCTE",0
9,"9056",4812,3585,3533,36,52,"PCTE",10
37,"37285",366,273,272,1,1,"PCTE",0
34,"34180",64,55,55,2,0,"PCTE",0
39,"39019",2229,1785,1751,15,34,"PCTE",1
37,"37173",1420,1077,1058,13,19,"PCTE",0
18,"18107",924,694,680,3,14,"PCTE",0
9,"9269",29,25,23,1,2,"PCTE",0
34,"34232",735,595,584,8,11,"PCTE",1
40,"40177",140,114,113,1,1,"PCTE",0
49,"49244",49,32,32,1,0,"PCTE",0
16,"16023",507,401,398,2,3,"PCTE",0
50,"50295",49,46,46,0,0,"PCTE",0
9,"9058",395,325,317,1,8,"PCTE",0
47,"47224",97,74,74,0,0,"PCTE",0
47,"47004",1136,950,939,5,11,"PCTE",1
14,"14037",3182,2388,2319,22,69,"PCTE",2
41,"41089",6629,4904,4814,48,90,"PCTE",0
37,"37251",107,79,79,1,0,"PCTE",0
42,"42218",75,52,51,0,1,"PCTE",0
9,"9059",136704,109424,108039,1134,1385,"PCTE",212
42,"42039",210,147,141,2,6,"PCTE",0
50,"50164",388,279,272,2,7,"PCTE",0
39,"39048",1765,1429,1420,4,9,"PCTE",1
28,"28102",891,681,666,4,15,"PCTE",0
18,"18006",4087,3109,3042,28,67,"PCTE",2
34,"34087",122,105,105,0,0,"PCTE",0
39,"39076",3483,2770,2734,21,36,"PCTE",1
16,"16065",372,306,305,2,1,"PCTE",0
50,"50093",83,66,66,1,0,"PCTE",0
50,"50296",382,288,272,1,16,"PCTE",0
37,"37139",187,162,157,2,5,"PCTE",0
39,"39021",467,392,385,2,7,"PCTE",0
24,"24159",1746,1393,1368,6,25,"PCTE",3
28,"28060",1565,1262,1247,5,15,"PCTE",0
37,"37289",218,159,158,0,1,"PCTE",0
50,"50154",116,98,98,0,0,"PCTE",0
37,"37101",142,119,117,0,2,"PCTE",0
16,"16196",602,522,510,3,12,"PCTE",0
9,"9029",144,120,118,3,2,"PCTE",0
18,"18087",182514,141305,139588,865,1717,"PCTE",82
47,"47098",556,480,475,4,5,"PCTE",1
49,"49124",237,169,166,1,3,"PCTE",1
37,"37017",222,177,177,1,0,"PCTE",0
42,"42178",101,75,75,0,0,"PCTE",0
24,"24015",2209,1714,1672,19,42,"PCTE",4
16,"16026",93,70,68,1,2,"PCTE",0
9,"9221",492,413,409,0,4,"PCTE",0
2,"2045",3617,3020,2969,38,51,"PCTE",5
37,"37266",70,58,56,0,2,"PCTE",0
18,"18076",790,607,604,1,3,"PCTE",1
16,"16110",91,80,80,0,0,"PCTE",0
34,"34091",122,103,102,4,1,"PCTE",0
37,"37254",175,141,140,1,1,"PCTE",0
24,"24002",233,183,183,1,0,"PCTE",0
9,"9275",166,130,130,2,0,"PCTE",0
40,"40040",2495,1913,1895,20,18,"PCTE",3
37,"37331",188,130,130,1,0,"PCTE",0
49,"49088",82,59,59,0,0,"PCTE",0
39,"39023",6523,5205,5144,22,61,"PCTE",2
24,"24203",95,72,72,0,0,"PCTE",0
9,"9392",49,41,41,0,0,"PCTE",0
28,"28002",3281,2481,2455,24,26,"PCTE",2
47,"47008",22,15,15,0,0,"PCTE",0
47,"47228",439,353,352,1,1,"PCTE",1
49,"49139",153,111,110,1,1,"PCTE",0
28,"28053",6840,5797,5739,32,58,"PCTE",3
39,"39079",8861,6827,6745,47,82,"PCTE",5
2,"2047",107,89,88,1,1,"PCTE",0
16,"16111",163,125,122,1,3,"PCTE",2
33,"33017",2997,2096,2058,29,38,"PCTE",4
42,"42183",106,83,83,1,0,"PCTE",0
37,"37020",425,341,339,4,2,"PCTE",0
37,"37256",195,152,150,0,2,"PCTE",0
47,"47166",251,196,189,3,7,"PCTE",0
28,"28171",4382,3202,3134,11,68,"PCTE",3
34,"34001",39,32,32,3,0,"PCTE",0
16,"16030",22,19,19,1,0,"PCTE",0
9,"9120",38,32,31,2,1,"PCTE",0
47,"47102",264,217,211,1,6,"PCTE",0
14,"14042",18727,15069,14837,201,232,"PCTE",18
40,"40230",95,70,67,0,3,"PCTE",0
34,"34242",93,66,64,1,2,"PCTE",0
9,"9394",662,495,490,10,5,"PCTE",2
50,"50012",96,79,79,1,0,"PCTE",0
24,"24122",1319,983,969,3,14,"PCTE",2
40,"40008",45,37,37,0,0,"PCTE",0
34,"34051",91,81,79,0,2,"PCTE",0
47,"47137",31,23,23,0,0,"PCTE",0
18,"18013",4152,3168,3103,16,65,"PCTE",0
47,"47071",398,345,341,2,4,"PCTE",0
2,"2086",2426,1738,1728,8,10,"PCTE",0
47,"47041",153,119,116,2,3,"PCTE",0
49,"49011",212,166,165,7,1,"PCTE",0
50,"50099",3042,2299,2265,20,34,"PCTE",3
24,"24044",152,116,114,0,2,"PCTE",1
40,"40009",40,34,34,0,0,"PCTE",0
50,"50245",76,58,58,0,0,"PCTE",0
14,"14013",16604,12618,12388,155,230,"PCTE",11
18,"18185",542,454,453,2,1,"PCTE",0
47,"47073",116,91,89,0,2,"PCTE",0
50,"50041",17,14,14,0,0,"PCTE",0
37,"37108",99,80,78,2,2,"PCTE",0
47,"47138",219,182,177,1,5,"PCTE",1
9,"9398",74,59,58,1,1,"PCTE",0
2,"2027",283,239,238,3,1,"PCTE",0
18,"18904",743,555,545,1,10,"PCTE",0
33,"33051",6811,4879,4809,63,70,"PCTE",4
18,"18177",373,253,252,1,1,"PCTE",1
18,"18152",906,692,686,1,6,"PCTE",0
39,"39027",3066,2511,2467,15,44,"PCTE",0
9,"9124",1432,1078,1054,7,24,"PCTE",0
50,"50042",16,16,16,0,0,"PCTE",0
9,"9287",199,169,168,1,1,"PCTE",0
37,"37110",103,84,82,0,2,"PCTE",0
47,"47140",110,91,90,0,1,"PCTE",0
50,"50072",195,164,161,3,3,"PCTE",0
16,"16034",155,124,122,1,2,"PCTE",0
9,"9178",40,27,27,0,0,"PCTE",0
37,"37184",290,199,195,0,4,"PCTE",0
33,"33021",4361,3098,3043,31,55,"PCTE",4
29,"29076",2335,1661,1614,11,47,"PCTE",0
18,"18165",4251,3113,3073,20,40,"PCTE",2
42,"42013",37,29,29,0,0,"PCTE",1
41,"41042",5849,4730,4692,20,38,"PCTE",3
29,"29077",214,158,156,1,2,"PCTE",0
9,"9127",52,45,45,1,0,"PCTE",0
28,"28038",5155,4142,4090,20,52,"PCTE",1
34,"34202",28,20,20,1,0,"PCTE",0
33,"33054",1611,1145,1124,8,21,"PCTE",4
34,"34204",52,41,41,1,0,"PCTE",0
28,"28176",13836,11415,11326,64,89,"PCTE",3
24,"24089",101353,78253,77375,776,878,"PCTE",109
14,"14017",10945,8514,8386,90,128,"PCTE",6
28,"28069",56,47,45,2,2,"PCTE",0
49,"49258",110,93,92,0,1,"PCTE",0
24,"24051",394,290,283,3,7,"PCTE",0
9,"9235",140,105,102,0,3,"PCTE",0
40,"40121",249,196,193,4,3,"PCTE",0
42,"42053",21,15,15,0,0,"PCTE",0
16,"16038",28,21,21,0,0,"PCTE",0
28,"28049",57902,47976,47561,329,415,"PCTE",57
49,"49135",588,409,405,0,4,"PCTE",0
37,"37069",971,721,704,2,17,"PCTE",0
29,"29080",6895,5005,4934,59,71,"PCTE",5
18,"18018",554,457,451,0,6,"PCTE",1
39,"39086",362,273,268,1,5,"PCTE",0
37,"37188",160,115,112,3,3,"PCTE",0
28,"28039",125,103,103,2,0,"PCTE",0
40,"40224",19,16,16,0,0,"PCTE",0
37,"37151",143,112,111,1,1,"PCTE",1
34,"34152",125,104,101,0,3,"PCTE",0
16,"16163",60,50,50,0,0,"PCTE",0
39,"39058",800,574,573,1,1,"PCTE",0
47,"47142",124,94,92,0,2,"PCTE",0
41,"41044",7698,5967,5898,59,69,"PCTE",5
16,"16039",367,263,262,2,1,"PCTE",2
47,"47110",438,352,347,4,5,"PCTE",0
28,"28126",47,35,35,0,0,"PCTE",1
37,"37353",122,95,95,1,0,"PCTE",0
9,"9076",24,17,17,1,0,"PCTE",0
24,"24014",7180,5189,5097,46,92,"PCTE",9
49,"49099",98,75,74,0,1,"PCTE",0
50,"50019",64,48,47,0,1,"PCTE",0
47,"47037",163,134,128,2,6,"PCTE",0
18,"18020",501,365,358,2,7,"PCTE",0
37,"37030",81,68,65,0,3,"PCTE",0
28,"28011",420,315,311,1,4,"PCTE",0
16,"16053",391,334,327,4,7,"PCTE",0
37,"37116",69,51,51,0,0,"PCTE",0
40,"40192",133,104,102,2,2,"PCTE",0
50,"50166",236,200,198,1,2,"PCTE",0
49,"49138",208,159,154,2,5,"PCTE",0
2,"2022",344,252,252,1,0,"PCTE",0
16,"16125",1599,1314,1295,9,19,"PCTE",2
50,"50222",1570,1126,1105,17,21,"PCTE",0
37,"37230",214,176,176,0,0,"PCTE",0
40,"40123",141,108,104,1,4,"PCTE",0
9,"9151",445,358,354,3,4,"PCTE",0
49,"49031",145,107,103,0,4,"PCTE",0
47,"47048",175,148,148,0,0,"PCTE",0
47,"47145",586,446,440,2,6,"PCTE",0
40,"40124",234,175,168,3,7,"PCTE",0
16,"16042",1108,948,938,3,10,"PCTE",0
28,"28084",16103,12519,12378,82,141,"PCTE",7
9,"9374",90,79,78,1,1,"PCTE",0
37,"37103",414,309,309,4,0,"PCTE",1
9,"9152",248,197,195,0,2,"PCTE",0
28,"28013",41563,32024,31693,194,331,"PCTE",23
14,"14021",260397,195951,193914,2025,2037,"PCTE",161
47,"47176",202,138,138,1,0,"PCTE",0
49,"49225",127,81,81,0,0,"PCTE",0
42,"42196",8,6,6,0,0,"PCTE",0
42,"42058",102,84,84,0,0,"PCTE",1
37,"37269",430,331,325,2,6,"PCTE",0
40,"40125",75,61,61,2,0,"PCTE",0
9,"9302",98,75,73,0,2,"PCTE",0
37,"37119",95,78,77,0,1,"PCTE",0
41,"41047",10411,8348,8242,84,106,"PCTE",2
40,"40194",39191,31175,30785,250,390,"PCTE",27
41,"41020",12992,8679,8524,117,155,"PCTE",5
37,"37281",39,34,33,0,1,"PCTE",0
47,"47020",272,228,225,5,3,"PCTE",0
29,"29029",380,294,287,2,7,"PCTE",0
40,"40019",29,26,26,0,0,"PCTE",0
16,"16044",43,31,30,0,1,"PCTE",0
28,"28183",1124,857,842,4,15,"PCTE",0
28,"28075",5952,4797,4758,25,39,"PCTE",2
49,"49266",70,51,49,2,2,"PCTE",0
47,"47177",100,80,79,0,1,"PCTE",0
41,"41076",2143,1419,1403,14,16,"PCTE",2
50,"50197",96,78,78,1,0,"PCTE",0
24,"24221",750,563,553,6,10,"PCTE",2
41,"41094",6447,4998,4912,43,86,"PCTE",1
28,"28045",35264,27864,27597,180,267,"PCTE",19
49,"49143",194,141,135,2,6,"PCTE",0
37,"37195",37,29,29,1,0,"PCTE",0
49,"49105",136,105,103,1,2,"PCTE",0
50,"50110",336,268,266,1,2,"PCTE",1
33,"33030",873,678,671,1,7,"PCTE",2
14,"14024",1859,1461,1418,10,43,"PCTE",1
9,"9036",37,33,32,3,1,"PCTE",0
24,"24179",299,239,238,3,1,"PCTE",0
33,"33061",350,201,200,2,1,"PCTE",0
16,"16007",1159,975,968,10,7,"PCTE",0
50,"50061",193,173,169,1,4,"PCTE",0
37,"37322",2466,1764,1723,17,41,"PCTE",2
40,"40208",720,592,585,4,7,"PCTE",1
50,"50274",66,48,47,0,1,"PCTE",0
37,"37172",853,601,590,4,11,"PCTE",0
2,"2040",563,516,513,3,3,"PCTE",0
50,"50081",491,390,384,5,6,"PCTE",0
50,"50080",34,29,29,0,0,"PCTE",0
49,"49146",274,213,209,1,4,"PCTE",0
50,"50902",79,69,69,0,0,"PCTE",0
41,"41096",6134,4926,4845,44,81,"PCTE",3
28,"28155",485,414,409,0,5,"PCTE",0
28,"28017",1280,1017,1012,9,5,"PCTE",2
16,"16008",83,65,65,0,0,"PCTE",0
39,"39093",302,256,256,2,0,"PCTE",0
9,"9139",98,82,82,2,0,"PCTE",0
16,"16132",34,26,26,0,0,"PCTE",0
42,"42037",29,19,18,0,1,"PCTE",0
47,"47033",204,167,167,2,0,"PCTE",0
16,"16022",78,70,70,0,0,"PCTE",0
28,"28058",141251,112674,111423,778,1251,"PCTE",92
47,"47086",3823,3090,3046,24,44,"PCTE",5
16,"16231",50,40,40,0,0,"PCTE",0
33,"33063",374,284,283,3,1,"PCTE",1
47,"47024",232,189,188,0,1,"PCTE",0
47,"47213",108,84,84,0,0,"PCTE",0
9,"9039",56,44,44,0,0,"PCTE",0
41,"41051",2311,1770,1734,5,36,"PCTE",0
9,"9251",365,278,277,0,1,"PCTE",2
28,"28903",35344,30490,30287,201,203,"PCTE",12
33,"33003",612,373,369,6,4,"PCTE",0
50,"50114",132,111,111,1,0,"PCTE",0
34,"34071",161,138,138,0,0,"PCTE",0
24,"24063",355,261,261,2,0,"PCTE",1
34,"34028",134,110,107,3,3,"PCTE",0
18,"18168",781,613,604,6,9,"PCTE",0
37,"37003",107,82,82,1,0,"PCTE",0
24,"24077",215,178,178,0,0,"PCTE",0
42,"42219",40,33,32,1,1,"PCTE",0
33,"33014",8771,6425,6368,51,57,"PCTE",34
49,"49232",84,71,70,0,1,"PCTE",0
16,"16280",165,130,128,3,2,"PCTE",0
37,"37239",206,184,181,3,3,"PCTE",1
50,"50201",444,357,354,1,3,"PCTE",0
50,"50143",546,409,401,5,8,"PCTE",0
49,"49149",365,285,282,2,3,"PCTE",0
37,"37127",200,145,145,1,0,"PCTE",0
42,"42069",1491,1073,1048,20,25,"PCTE",2
16,"16096",280,239,234,3,5,"PCTE",0
18,"18064",366,307,306,0,1,"PCTE",0
28,"28092",153428,121511,120211,807,1300,"PCTE",83
16,"16012",77,65,65,0,0,"PCTE",0
9,"9480",109,87,85,1,2,"PCTE",0
37,"37277",77,56,56,0,0,"PCTE",0
28,"28061",22564,18245,18064,117,181,"PCTE",6
33,"33045",4382,3214,3156,23,58,"PCTE",6
47,"47216",114,102,98,0,4,"PCTE",0
37,"37086",104,88,88,0,0,"PCTE",0
9,"9094",51,46,45,0,1,"PCTE",0
9,"9046",24,19,19,0,0,"PCTE",0
39,"39087",41381,32335,31995,194,340,"PCTE",52
9,"9409",110,87,87,0,0,"PCTE",1
42,"42164",1589,1201,1172,10,29,"PCTE",1
40,"40026",113,106,105,2,1,"PCTE",0
41,"41035",1060,803,788,8,15,"PCTE",1
33,"33006",1480,1001,992,9,9,"PCTE",4
34,"34032",37,34,34,1,0,"PCTE",0
37,"37202",989,838,828,7,10,"PCTE",1
2,"2033",1870,1503,1463,11,40,"PCTE",4
41,"41055",14804,10863,10720,79,143,"PCTE",7
37,"37006",117,81,81,2,0,"PCTE",0
24,"24229",388,312,307,2,5,"PCTE",0
16,"16141",130,105,105,0,0,"PCTE",0
16,"16904",451,386,383,3,3,"PCTE",0
40,"40181",4166,3405,3337,21,68,"PCTE",4
49,"49043",265,210,208,1,2,"PCTE",1
42,"42209",135,107,100,5,7,"PCTE",0
40,"40905",128,101,100,4,1,"PCTE",0
42,"42071",163,111,108,2,3,"PCTE",0
40,"40062",57,49,49,0,0,"PCTE",0
9,"9258",171,142,141,2,1,"PCTE",0
40,"40111",52,44,44,0,0,"PCTE",0
50,"50195",53,42,41,0,1,"PCTE",0
24,"24120",311,209,209,0,0,"PCTE",1
37,"37045",28,19,18,0,1,"PCTE",0
28,"28023",5090,4252,4212,31,40,"PCTE",1
9,"9209",4419,3407,3338,37,69,"PCTE",4
40,"40063",6944,5479,5352,39,127,"PCTE",3
37,"37131",171,138,137,0,1,"PCTE",0
2,"2036",95,75,75,0,0,"PCTE",0
50,"50087",29,18,18,0,0,"PCTE",0
50,"50148",290,229,227,2,2,"PCTE",0
9,"9261",449,343,342,5,1,"PCTE",3
39,"39099",3149,2562,2540,22,22,"PCTE",1
37,"37205",217,177,174,0,3,"PCTE",0
47,"47219",40,38,34,0,4,"PCTE",0
28,"28003",170,148,148,1,0,"PCTE",0
41,"41001",1565,1224,1213,8,11,"PCTE",1
47,"47030",941,759,740,3,19,"PCTE",1
18,"18012",2143,1651,1634,8,17,"PCTE",1
29,"29096",2756,2061,2018,21,43,"PCTE",3
50,"50206",453,371,370,5,1,"PCTE",1
37,"37132",325,232,231,0,1,"PCTE",0
33,"33009",869,595,591,5,4,"PCTE",0
49,"49034",417,320,317,0,3,"PCTE",0
37,"37170",1370,1009,990,10,19,"PCTE",2
18,"18912",1367,990,984,5,6,"PCTE",0
50,"50292",129,113,113,1,0,"PCTE",0
49,"49194",340,236,233,3,3,"PCTE",0
33,"33040",4566,3205,3150,50,55,"PCTE",6
37,"37133",101,84,80,0,4,"PCTE",1
39,"39100",849,650,644,9,6,"PCTE",1
9,"9430",22,20,20,0,0,"PCTE",0
34,"34129",170,134,132,2,2,"PCTE",0
16,"16909",661,540,535,1,5,"PCTE",0
9,"9265",47,38,36,2,2,"PCTE",0
39,"39016",23868,19029,18839,108,190,"PCTE",15
16,"16908",163,135,133,0,2,"PCTE",0
37,"37050",67,54,54,0,0,"PCTE",0
40,"40140",79,58,58,0,0,"PCTE",0
29,"29053",1694,1263,1245,18,18,"PCTE",0
24,"24222",14431,11296,11135,117,161,"PCTE",12
39,"39092",871,635,629,2,6,"PCTE",0
37,"37284",314,241,237,2,4,"PCTE",0
24,"24032",102,84,83,0,1,"PCTE",0
9,"9177",1127,883,877,6,6,"PCTE",1
28,"28132",12068,9067,8954,63,113,"PCTE",5
9,"9162",132,102,102,1,0,"PCTE",0
37,"37134",212,156,148,0,8,"PCTE",0
50,"50208",1748,1360,1344,11,16,"PCTE",1
39,"39074",7041,5612,5551,31,61,"PCTE",2
41,"41031",1215,866,848,3,18,"PCTE",1
9,"9268",88,71,71,0,0,"PCTE",0
2,"2077",54,45,44,0,1,"PCTE",0
50,"50005",239,204,201,2,3,"PCTE",0
50,"50238",86,66,66,2,0,"PCTE",0
24,"24196",1918,1446,1422,9,24,"PCTE",1
34,"34901",1071,854,847,4,7,"PCTE",1
41,"41903",6769,5018,4919,73,99,"PCTE",3
41,"41069",29569,21075,20657,361,418,"PCTE",18
34,"34009",30,26,26,0,0,"PCTE",0
9,"9382",30,24,23,0,1,"PCTE",0
18,"18038",1047,810,787,4,23,"PCTE",1
42,"42081",136,95,93,0,2,"PCTE",0
37,"37224",189,168,165,0,3,"PCTE",11
9,"9010",32,27,27,1,0,"PCTE",0
9,"9109",1066,686,650,11,36,"PCTE",2
9,"9434",1280,1089,1077,12,12,"PCTE",2
37,"37052",278,201,199,2,2,"PCTE",0
33,"33013",429,320,316,1,4,"PCTE",1
18,"18005",362,268,265,0,3,"PCTE",0
47,"47191",115,85,84,0,1,"PCTE",0
18,"18072",664,481,473,0,8,"PCTE",1
29,"29901",44578,31840,31537,286,303,"PCTE",15
50,"50064",438,368,362,1,6,"PCTE",0
16,"16107",98,76,75,1,1,"PCTE",0
40,"40155",3835,3165,3121,43,44,"PCTE",4
14,"14047",1629,1300,1285,18,15,"PCTE",0
18,"18192",1466,1171,1156,1,15,"PCTE",0
37,"37327",179,154,150,0,4,"PCTE",1
42,"42176",27,22,22,2,0,"PCTE",0
29,"29068",7716,5347,5230,58,117,"PCTE",1
37,"37213",83,65,64,0,1,"PCTE",0
47,"47131",165,127,127,3,0,"PCTE",0
2,"2080",499,409,400,0,9,"PCTE",0
49,"49040",112,97,97,0,0,"PCTE",0
28,"28030",1815,1438,1395,10,43,"PCTE",0
40,"40073",385,339,335,6,4,"PCTE",0
16,"16025",25,21,21,0,0,"PCTE",0
37,"37176",130,103,103,1,0,"PCTE",0
50,"50268",42,33,32,1,1,"PCTE",0
9,"9168",272,222,216,3,6,"PCTE",1
40,"40015",24,24,24,1,0,"PCTE",0
34,"34206",814,668,660,13,8,"PCTE",0
37,"37115",110,81,81,2,0,"PCTE",0
9,"9455",43,37,36,0,1,"PCTE",0
2,"2057",1960,1522,1489,15,33,"PCTE",1
37,"37303",181,137,137,1,0,"PCTE",0
37,"37241",164,129,127,0,2,"PCTE",0
28,"28071",64,56,54,0,2,"PCTE",0
28,"28179",1450,1115,1100,3,15,"PCTE",0
33,"33026",8270,5540,5474,69,66,"PCTE",19
42,"42098",9,8,8,0,0,"PCTE",0
28,"28072",6088,5001,4961,23,40,"PCTE",2
37,"37141",152,120,119,2,1,"PCTE",0
24,"24080",207,162,161,0,1,"PCTE",0
29,"29048",1370,1149,1135,10,14,"PCTE",2
16,"16067",119,96,93,2,3,"PCTE",2
49,"49248",174,142,139,2,3,"PCTE",0
47,"47164",350,290,286,2,4,"PCTE",0
28,"28001",80,64,64,0,0,"PCTE",0
24,"24216",671,504,502,3,2,"PCTE",0
50,"50057",1332,1001,986,10,15,"PCTE",1
18,"18077",471,372,366,5,6,"PCTE",0
9,"9017",90,72,70,2,2,"PCTE",0
41,"41037",3192,2505,2479,15,26,"PCTE",3
42,"42045",276,212,209,2,3,"PCTE",0
37,"37142",566,446,444,6,2,"PCTE",0
40,"40158",15,13,13,1,0,"PCTE",0
2,"2071",1058,912,906,2,6,"PCTE",0
41,"41027",3966,2830,2784,32,46,"PCTE",3
9,"9063",214,185,184,0,1,"PCTE",0
34,"34227",72,63,61,4,2,"PCTE",0
24,"24218",444,343,341,6,2,"PCTE",0
49,"49249",63,52,52,1,0,"PCTE",0
34,"34189",53,39,39,1,0,"PCTE",0
50,"50281",68,55,52,0,3,"PCTE",0
50,"50215",20,18,18,0,0,"PCTE",0
39,"39080",3505,2735,2701,8,34,"PCTE",3
49,"49046",242,178,175,0,3,"PCTE",0
39,"39053",213,146,145,2,1,"PCTE",1
9,"9018",24647,18982,18715,184,267,"PCTE",23
2,"2012",1825,1541,1509,8,32,"PCTE",2
40,"40077",932,747,730,9,17,"PCTE",1
42,"42021",68,44,44,2,0,"PCTE",0
37,"37193",365,277,276,3,1,"PCTE",0
33,"33049",6044,4152,4079,56,73,"PCTE",5
50,"50168",27,20,20,0,0,"PCTE",0
9,"9227",113,93,91,0,2,"PCTE",1
2,"2013",135,113,110,0,3,"PCTE",1
37,"37061",207,160,160,0,0,"PCTE",0
49,"49129",821,628,616,5,12,"PCTE",0
9,"9445",43,36,34,1,2,"PCTE",0
40,"40113",408,339,335,6,4,"PCTE",0
16,"16072",133,96,95,1,1,"PCTE",1
37,"37182",78,57,57,0,0,"PCTE",0
28,"28035",1394,1057,1043,3,14,"PCTE",1
34,"34196",88,74,74,4,0,"PCTE",0
24,"24123",716,514,507,2,7,"PCTE",0
42,"42049",109,73,72,1,1,"PCTE",0
34,"34245",310,244,240,3,4,"PCTE",0
37,"37258",137,99,98,1,1,"PCTE",0
47,"47230",288,236,233,1,3,"PCTE",0
28,"28005",136050,108267,107316,772,951,"PCTE",69
40,"40219",565,451,432,2,19,"PCTE",0
50,"50070",49,28,28,0,0,"PCTE",0
29,"29075",12890,9033,8949,73,84,"PCTE",5
28,"28901",868,653,639,6,14,"PCTE",0
42,"42200",76,54,53,0,1,"PCTE",0
18,"18003",14413,11095,10883,92,212,"PCTE",10
42,"42215",735,540,529,5,11,"PCTE",1
34,"34038",268,198,197,0,1,"PCTE",0
39,"39101",236,173,171,1,2,"PCTE",0
42,"42216",26,20,20,1,0,"PCTE",0
18,"18187",512,388,387,0,1,"PCTE",0
2,"2015",1433,1234,1214,7,20,"PCTE",1
40,"40010",111,95,94,0,1,"PCTE",0
37,"37261",217,166,163,0,3,"PCTE",0
49,"49132",313,252,249,0,3,"PCTE",0
50,"50190",675,565,553,5,12,"PCTE",0
29,"29021",159,121,120,0,1,"PCTE",0
37,"37336",52,46,45,3,1,"PCTE",0
39,"39055",1075,836,829,8,7,"PCTE",0
42,"42142",45,35,35,0,0,"PCTE",0
37,"37361",81,63,61,0,2,"PCTE",0
47,"47200",71,62,62,0,0,"PCTE",0
18,"18117",507,402,396,5,6,"PCTE",1
9,"9217",349,268,266,5,2,"PCTE",0
49,"49216",147,122,114,0,8,"PCTE",0
49,"49147",249,197,196,1,1,"PCTE",0
18,"18016",308,232,231,5,1,"PCTE",0
9,"9041",26,26,26,1,0,"PCTE",0
24,"24169",2809,2165,2146,18,19,"PCTE",4
16,"16079",26,17,17,0,0,"PCTE",0
18,"18017",18148,12712,12523,96,189,"PCTE",6
47,"47044",323,282,279,1,3,"PCTE",1
9,"9072",320,259,258,1,1,"PCTE",1
9,"9405",129,99,97,1,2,"PCTE",0
37,"37225",99,90,86,1,4,"PCTE",0
34,"34902",123,98,98,4,0,"PCTE",0
42,"42014",60,44,44,1,0,"PCTE",0
50,"50248",502,390,377,6,13,"PCTE",2
28,"28146",1792,1308,1293,8,15,"PCTE",0
49,"49054",849,641,629,5,12,"PCTE",0
50,"50173",149,107,105,0,2,"PCTE",0
50,"50230",1134,853,846,6,7,"PCTE",0
50,"50035",75,63,62,0,1,"PCTE",0
39,"39002",3414,2630,2578,23,52,"PCTE",1
47,"47109",171,130,130,1,0,"PCTE",0
29,"29056",1061,783,772,4,11,"PCTE",0
24,"24213",170,140,139,0,1,"PCTE",0
41,"41043",667,475,453,3,22,"PCTE",1
47,"47045",734,601,590,5,11,"PCTE",0
50,"50017",1779,1386,1373,14,13,"PCTE",3
40,"40049",40,30,29,0,1,"PCTE",0
18,"18086",339,291,289,0,2,"PCTE",0
49,"49056",288,232,230,2,2,"PCTE",0
28,"28070",113,94,94,2,0,"PCTE",0
37,"37301",79,69,67,0,2,"PCTE",0
37,"37029",193,139,133,1,6,"PCTE",0
29,"29081",261,212,210,2,2,"PCTE",0
24,"24065",2175,1695,1660,18,35,"PCTE",3
47,"47153",104,76,75,0,1,"PCTE",0
49,"49029",614,497,488,9,9,"PCTE",0
9,"9422",32,27,26,2,1,"PCTE",0
18,"18908",784,599,581,0,18,"PCTE",2
37,"37229",139,110,106,2,4,"PCTE",0
37,"37201",237,188,187,1,1,"PCTE",1
49,"49018",288,225,222,1,3,"PCTE",1
16,"16123",66,43,43,0,0,"PCTE",0
16,"16013",26,21,20,0,1,"PCTE",0
49,"49190",50,45,45,1,0,"PCTE",0
24,"24185",452,339,332,3,7,"PCTE",0
16,"16166",239,176,174,3,2,"PCTE",0
37,"37304",159,105,105,0,0,"PCTE",0
41,"41017",15712,12048,11896,118,152,"PCTE",6
9,"9132",171,136,130,1,6,"PCTE",0
50,"50251",8207,6352,6242,46,110,"PCTE",5
49,"49137",170,138,134,0,4,"PCTE",0
9,"9077",30,22,22,0,0,"PCTE",0
50,"50058",63,54,53,2,1,"PCTE",0
14,"14070",1284,988,969,5,19,"PCTE",0
9,"9095",112,70,68,1,2,"PCTE",0
16,"16014",563,444,443,4,1,"PCTE",0
50,"50167",215,181,179,1,2,"PCTE",0
14,"14051",1348,1064,1048,7,16,"PCTE",0
9,"9190",86,68,67,0,1,"PCTE",0
24,"24067",606,375,371,2,4,"PCTE",0
37,"37368",17,15,11,0,4,"PCTE",0
34,"34137",24,23,22,2,1,"PCTE",0
34,"34077",381,301,293,2,8,"PCTE",0
33,"33078",126,87,85,0,2,"PCTE",0
24,"24189",5816,4434,4382,49,52,"PCTE",4
18,"18022",13804,9877,9714,92,163,"PCTE",10
24,"24108",348,268,265,2,3,"PCTE",0
49,"49238",268,222,216,2,6,"PCTE",1
9,"9034",292,239,238,2,1,"PCTE",0
18,"18126",1450,1115,1087,11,28,"PCTE",0
24,"24176",299,243,238,3,5,"PCTE",0
39,"39090",772,619,609,1,10,"PCTE",0
16,"16169",51,36,32,0,4,"PCTE",0
18,"18124",359,269,267,0,2,"PCTE",2
40,"40906",2131,1830,1814,10,16,"PCTE",7
50,"50177",276,226,223,0,3,"PCTE",0
24,"24069",39,27,27,0,0,"PCTE",0
9,"9244",45,35,35,0,0,"PCTE",0
49,"49062",105,69,69,1,0,"PCTE",0
9,"9136",173,130,128,0,2,"PCTE",0
37,"37382",164,135,134,0,1,"PCTE",0
18,"18056",3418,2523,2478,22,45,"PCTE",2
34,"34159",370,247,244,5,3,"PCTE",0
50,"50050",86,65,65,1,0,"PCTE",0
47,"47082",810,679,668,8,11,"PCTE",1
29,"29086",774,537,532,1,5,"PCTE",0
49,"49104",335,245,240,1,5,"PCTE",1
16,"16145",425,362,357,8,5,"PCTE",0
37,"37234",317,224,222,1,2,"PCTE",0
34,"34160",134,114,112,0,2,"PCTE",0
47,"47021",72,63,63,0,0,"PCTE",0
37,"37158",233,168,166,0,2,"PCTE",0
50,"50079",227,182,178,1,4,"PCTE",0
24,"24098",1149,882,863,7,19,"PCTE",0
50,"50169",336,261,259,2,2,"PCTE",0
2,"2026",832,682,673,6,9,"PCTE",1
39,"39008",13900,10895,10767,81,128,"PCTE",10
29,"29087",371,266,263,2,3,"PCTE",1
40,"40103",146,125,123,0,2,"PCTE",0
39,"39045",351,280,277,1,3,"PCTE",0
42,"42023",60,49,48,0,1,"PCTE",0
9,"9247",22,18,18,0,0,"PCTE",0
49,"49145",210,133,131,1,2,"PCTE",0
41,"41002",1427,1057,1024,5,33,"PCTE",1
50,"50032",242,179,176,1,3,"PCTE",0
47,"47189",151,126,123,0,3,"PCTE",0
24,"24021",1602,1211,1194,7,17,"PCTE",1
37,"37236",127,90,86,0,4,"PCTE",0
50,"50284",132,105,104,1,1,"PCTE",0
9,"9086",661,521,518,5,3,"PCTE",0
42,"42024",86,66,66,3,0,"PCTE",0
40,"40057",1405,1176,1163,10,13,"PCTE",1
9,"9363",922,733,725,3,8,"PCTE",1
9,"9362",205,177,177,3,0,"PCTE",0
9,"9085",472,371,365,3,6,"PCTE",1
37,"37197",87,63,63,0,0,"PCTE",0
47,"47169",61,53,53,0,0,"PCTE",0
37,"37109",177,149,149,3,0,"PCTE",0
16,"16206",196,146,144,3,2,"PCTE",0
42,"42093",35,29,29,2,0,"PCTE",0
34,"34131",58,51,51,0,0,"PCTE",0
41,"41060",15100,11304,11105,113,199,"PCTE",4
28,"28090",9128,7590,7516,54,74,"PCTE",4
49,"49082",343,288,286,8,2,"PCTE",2
18,"18133",2109,1632,1618,12,14,"PCTE",1
28,"28156",1084,885,880,6,5,"PCTE",0
9,"9418",73,58,55,2,3,"PCTE",0
40,"40130",128,102,96,0,6,"PCTE",0
37,"37238",106,88,87,1,1,"PCTE",0
47,"47119",87,66,65,1,1,"PCTE",0
42,"42026",22,20,20,0,0,"PCTE",0
49,"49026",201,163,162,0,1,"PCTE",0
9,"9419",67,53,52,0,1,"PCTE",0
37,"37199",129,97,97,0,0,"PCTE",1
34,"34220",149,133,132,0,1,"PCTE",0
16,"16150",94,75,75,1,0,"PCTE",3
33,"33075",253,139,135,1,4,"PCTE",0
49,"49220",139,110,104,2,6,"PCTE",0
40,"40212",27,22,20,0,2,"PCTE",0
47,"47162",68,55,55,0,0,"PCTE",0
18,"18179",503,346,343,3,3,"PCTE",0
18,"18916",1778,1249,1236,9,13,"PCTE",0
9,"9044",53,49,47,1,2,"PCTE",0
40,"40025",128,109,106,1,3,"PCTE",0
28,"28019",1269,990,981,4,9,"PCTE",2
34,"34222",109,81,79,1,2,"PCTE",1
24,"24184",183,121,119,0,2,"PCTE",0
9,"9478",45,40,40,0,0,"PCTE",0
9,"9045",274,199,196,1,3,"PCTE",0
40,"40166",253,214,213,1,1,"PCTE",0
16,"16236",865,669,665,2,4,"PCTE",1
47,"47121",521,429,422,5,7,"PCTE",0
24,"24214",634,473,471,3,2,"PCTE",0
37,"37041",73,55,55,0,0,"PCTE",0
16,"16001",64,51,51,0,0,"PCTE",0
33,"33025",8996,6369,6309,81,60,"PCTE",9
47,"47143",110,78,78,1,0,"PCTE",0
41,"41054",713,596,588,4,8,"PCTE",0
50,"50250",56,45,45,0,0,"PCTE",0
42,"42151",38,31,30,0,1,"PCTE",0
24,"24173",908,679,667,3,12,"PCTE",0
42,"42056",28,25,24,0,1,"PCTE",0
9,"9389",64,50,50,0,0,"PCTE",0
16,"16083",45,29,28,0,1,"PCTE",0
37,"37087",910,755,747,3,8,"PCTE",0
42,"42070",32,24,24,0,0,"PCTE",0
49,"49151",593,453,444,5,9,"PCTE",0
34,"34123",1637,1376,1354,8,22,"PCTE",0
50,"50242",93,72,70,0,2,"PCTE",0
16,"16903",996,816,806,9,10,"PCTE",0
40,"40075",153,128,127,0,1,"PCTE",0
50,"50047",43,32,31,1,1,"PCTE",0
50,"50213",93,76,75,0,1,"PCTE",0
14,"14071",884,641,634,2,7,"PCTE",0
40,"40100",263,219,215,1,4,"PCTE",0
49,"49236",70,55,55,0,0,"PCTE",0
9,"9117",71,55,53,0,2,"PCTE",0
37,"37231",239,204,203,6,1,"PCTE",0
29,"29060",671,511,506,1,5,"PCTE",0
34,"34240",87,65,63,3,2,"PCTE",0
50,"50020",802,606,600,7,6,"PCTE",0
24,"24901",860,642,630,7,12,"PCTE",0
16,"16016",216,175,174,3,1,"PCTE",0
34,"34034",115,96,95,3,1,"PCTE",0
9,"9442",370,305,301,5,4,"PCTE",0
40,"40101",923,737,728,8,9,"PCTE",1
49,"49192",124,102,102,2,0,"PCTE",0
37,"37244",128,99,97,1,2,"PCTE",0
50,"50234",242,194,187,3,7,"PCTE",1
16,"16142",120,95,95,0,0,"PCTE",0
14,"14001",3443,2724,2675,24,49,"PCTE",5
24,"24083",1005,800,791,7,9,"PCTE",0
29,"29073",1645,1200,1185,13,15,"PCTE",1
9,"9174",781,625,608,3,17,"PCTE",1
9,"9211",1362,1065,1050,16,15,"PCTE",1
9,"9192",55,48,47,2,1,"PCTE",0
47,"47114",3911,2864,2807,28,57,"PCTE",3
42,"42168",108,85,85,1,0,"PCTE",0
50,"50235",2412,1826,1807,22,19,"PCTE",5
16,"16115",47,35,35,0,0,"PCTE",0
24,"24902",335,266,263,1,3,"PCTE",0
50,"50273",32,24,24,0,0,"PCTE",0
9,"9213",270,196,196,1,0,"PCTE",0
16,"16189",262,220,220,1,0,"PCTE",1
29,"29052",222,156,153,2,3,"PCTE",0
39,"39072",324,206,204,4,2,"PCTE",1
29,"29041",3599,2570,2532,22,38,"PCTE",2
18,"18103",722,556,555,3,1,"PCTE",0
50,"50291",93,78,77,1,1,"PCTE",0
14,"14003",1258,989,968,12,21,"PCTE",0
34,"34127",80,64,64,1,0,"PCTE",0
37,"37246",5155,4153,4107,33,46,"PCTE",3
47,"47061",243,203,197,3,6,"PCTE",0
24,"24209",2609,1880,1857,13,23,"PCTE",6
37,"37221",394,299,299,2,0,"PCTE",1
14,"14074",2237,1859,1839,8,20,"PCTE",0
37,"37235",219,170,166,4,4,"PCTE",0
49,"49157",192,153,149,0,4,"PCTE",0
49,"49228",55,47,47,0,0,"PCTE",0
49,"49036",508,361,355,6,6,"PCTE",0
50,"50051",800,615,608,3,7,"PCTE",0
28,"28026",6703,5422,5367,21,55,"PCTE",2
42,"42079",21,18,18,1,0,"PCTE",0
14,"14065",1813,1439,1421,11,18,"PCTE",1
9,"9381",33,25,25,0,0,"PCTE",0
34,"34082",80,68,68,0,0,"PCTE",0
18,"18914",1657,1315,1278,5,37,"PCTE",1
18,"18143",949,757,740,5,17,"PCTE",0
47,"47105",175,152,149,1,3,"PCTE",0
50,"50151",603,490,489,3,1,"PCTE",0
24,"24033",205,146,146,3,0,"PCTE",0
50,"50090",134,108,108,0,0,"PCTE",0
37,"37135",1163,934,924,8,10,"PCTE",0
37,"37223",112,78,76,0,2,"PCTE",0
37,"37185",537,416,405,1,11,"PCTE",0
9,"9230",33,28,28,0,0,"PCTE",0
47,"47046",125,107,104,1,3,"PCTE",1
16,"16119",179,128,128,0,0,"PCTE",0
9,"9288",88,73,71,1,2,"PCTE",0
9,"9057",148,120,116,0,4,"PCTE",0
49,"49219",7221,5301,5186,62,115,"PCTE",4
37,"37337",139,114,114,0,0,"PCTE",0
37,"37250",332,232,231,1,1,"PCTE",0
47,"47161",3945,3370,3344,20,26,"PCTE",2
16,"16148",546,481,479,1,2,"PCTE",0
24,"24036",272,181,179,4,2,"PCTE",0
24,"24197",736,556,552,7,4,"PCTE",3
34,"34086",99,92,90,2,2,"PCTE",0
24,"24158",296,226,220,2,6,"PCTE",0
37,"37174",983,788,768,0,20,"PCTE",2
28,"28028",1820,1493,1483,8,10,"PCTE",2
34,"34042",292,244,243,3,1,"PCTE",0
34,"34181",422,324,321,3,3,"PCTE",2
39,"39085",6964,5489,5445,28,44,"PCTE",3
34,"34903",183,128,128,1,0,"PCTE",0
40,"40902",117,96,96,1,0,"PCTE",0
16,"16122",249,197,196,3,1,"PCTE",0
50,"50249",284,229,227,1,2,"PCTE",0
42,"42015",32,23,23,1,0,"PCTE",0
28,"28059",4515,3573,3542,12,31,"PCTE",1
24,"24116",390,283,279,1,4,"PCTE",0
16,"16248",862,730,720,10,10,"PCTE",1
14,"14068",516,405,400,1,5,"PCTE",0
47,"47193",1609,1347,1332,9,15,"PCTE",1
14,"14069",7376,5511,5398,47,113,"PCTE",3
49,"49203",287,229,223,2,6,"PCTE",0
34,"34182",753,609,604,6,5,"PCTE",0
50,"50008",5185,3753,3711,35,42,"PCTE",10
37,"37253",133,107,103,0,4,"PCTE",0
24,"24117",412,336,335,0,1,"PCTE",0
34,"34121",183,155,151,1,4,"PCTE",0
42,"42162",2325,1721,1699,16,22,"PCTE",4
24,"24025",289,234,226,4,8,"PCTE",1
14,"14059",687,571,563,7,8,"PCTE",1
2,"2032",265,208,203,3,5,"PCTE",0
41,"41026",4300,3561,3521,18,40,"PCTE",1
42,"42008",56,41,41,0,0,"PCTE",0
49,"49189",192,132,128,1,4,"PCTE",0
40,"40191",204,166,165,1,1,"PCTE",1
18,"18158",8010,5524,5449,23,75,"PCTE",7
39,"39031",1245,990,983,5,7,"PCTE",0
9,"9239",47,39,39,0,0,"PCTE",0
34,"34122",86,68,66,0,2,"PCTE",0
16,"16215",237,157,153,1,4,"PCTE",0
9,"9170",209,164,159,0,5,"PCTE",0
16,"16041",339,271,267,2,4,"PCTE",0
28,"28083",9665,7794,7737,56,57,"PCTE",3
39,"39032",1426,1156,1141,8,15,"PCTE",1
18,"18042",418,344,340,7,4,"PCTE",0
39,"39022",969,740,732,2,8,"PCTE",1
16,"16271",595,513,511,2,2,"PCTE",1
39,"39097",679,437,435,2,2,"PCTE",0
28,"28022",36550,31559,31436,207,123,"PCTE",9
33,"33007",1398,960,951,9,9,"PCTE",1
50,"50243",311,252,247,1,5,"PCTE",0
40,"40006",22,18,18,0,0,"PCTE",0
49,"49166",1192,916,899,10,17,"PCTE",2
50,"50137",964,790,781,9,9,"PCTE",1
34,"34124",63,58,58,0,0,"PCTE",0
49,"49237",143,95,93,0,2,"PCTE",0
50,"50185",136,103,102,0,1,"PCTE",0
24,"24095",307,237,235,0,2,"PCTE",1
42,"42211",81,74,73,2,1,"PCTE",0
16,"16239",118,89,88,0,1,"PCTE",0
9,"9427",1364,1002,972,13,30,"PCTE",1
24,"24096",108,69,69,0,0,"PCTE",0
9,"9277",107,92,89,0,3,"PCTE",1
24,"24121",616,491,484,4,7,"PCTE",0
42,"42139",21,15,15,1,0,"PCTE",0
47,"47229",231,174,168,0,6,"PCTE",0
47,"47039",166,134,134,0,0,"PCTE",0
34,"34139",160,119,118,0,1,"PCTE",0
9,"9318",58,37,37,0,0,"PCTE",0
47,"47209",34,25,25,0,0,"PCTE",0
50,"50298",5427,4373,4323,30,50,"PCTE",8
28,"28154",5525,4283,4222,24,61,"PCTE",1
9,"9413",408,313,310,2,3,"PCTE",0
49,"49208",364,260,255,5,5,"PCTE",0
37,"37219",165,101,97,2,4,"PCTE",0
42,"42197",68,56,56,0,0,"PCTE",0
40,"40043",1791,1472,1447,9,25,"PCTE",0
37,"37270",183,143,140,1,3,"PCTE",0
2,"2049",796,582,574,1,8,"PCTE",0
24,"24084",152,113,113,0,0,"PCTE",0
37,"37034",75,66,66,0,0,"PCTE",0
34,"34096",50,44,44,0,0,"PCTE",0
9,"9228",157,136,136,0,0,"PCTE",0
33,"33019",2882,1981,1939,8,42,"PCTE",4
28,"28110",2003,1596,1571,7,25,"PCTE",1
9,"9281",135,104,102,1,2,"PCTE",0
16,"16157",190,163,161,1,2,"PCTE",0
28,"28036",2675,2135,2093,17,42,"PCTE",4
16,"16046",223,162,161,1,1,"PCTE",0
24,"24141",101,78,78,0,0,"PCTE",0
39,"39091",1885,1512,1503,6,9,"PCTE",0
29,"29030",774,660,657,3,3,"PCTE",1
9,"9415",275,206,204,0,2,"PCTE",1
42,"42157",10,10,10,0,0,"PCTE",0
28,"28076",425,354,349,3,5,"PCTE",0
37,"37121",556,448,444,3,4,"PCTE",0
24,"24052",139,99,99,0,0,"PCTE",0
47,"47094",123,110,109,1,1,"PCTE",0
34,"34146",53,47,46,0,1,"PCTE",0
42,"42012",29,23,23,0,0,"PCTE",1
28,"28144",6423,5274,5222,35,52,"PCTE",4
24,"24210",527,387,386,0,1,"PCTE",0
41,"41013",4807,3480,3425,30,55,"PCTE",19
40,"40021",19,18,18,0,0,"PCTE",0
47,"47139",1004,790,776,2,14,"PCTE",1
18,"18119",1712,1352,1317,11,35,"PCTE",0
9,"9448",201,161,161,1,0,"PCTE",0
24,"24088",995,813,802,12,11,"PCTE",1
9,"9038",111,95,95,0,0,"PCTE",0
40,"40198",24,20,20,0,0,"PCTE",0
50,"50135",88,74,74,3,0,"PCTE",0
40,"40060",68,46,46,0,0,"PCTE",0
37,"37163",32,27,27,0,0,"PCTE",0
9,"9218",347,277,271,0,6,"PCTE",0
37,"37324",335,276,274,1,2,"PCTE",0
42,"42202",20,12,11,0,1,"PCTE",0
9,"9140",115,88,88,2,0,"PCTE",0
42,"42145",134,108,108,0,0,"PCTE",0
50,"50043",246,172,170,2,2,"PCTE",0
50,"50276",119,91,91,1,0,"PCTE",0
29,"29055",1880,1493,1470,15,23,"PCTE",2
16,"16265",20,20,19,0,1,"PCTE",0
9,"9289",1379,1002,994,9,8,"PCTE",1
37,"37027",235,188,184,2,4,"PCTE",0
41,"41071",5598,3993,3915,34,78,"PCTE",5
50,"50073",2117,1735,1706,13,29,"PCTE",0
41,"41014",2486,1939,1878,6,61,"PCTE",2
18,"18049",596,485,481,0,4,"PCTE",0
40,"40200",38,32,31,0,1,"PCTE",0
9,"9908",427,294,290,6,4,"PCTE",0
40,"40072",224,198,194,3,4,"PCTE",0
18,"18145",10869,8532,8405,69,127,"PCTE",5
41,"41090",3507,2766,2694,15,72,"PCTE",1
16,"16064",651,575,569,4,6,"PCTE",0
47,"47141",118,103,102,0,1,"PCTE",1
41,"41046",3006,2464,2427,13,37,"PCTE",2
9,"9406",246,203,200,4,3,"PCTE",0
16,"16266",358,281,279,3,2,"PCTE",0
40,"40036",502,413,406,11,7,"PCTE",0
2,"2056",1643,1330,1308,4,22,"PCTE",1
9,"9074",834,697,694,8,3,"PCTE",0
41,"41016",7767,5937,5829,56,108,"PCTE",6
47,"47152",68,59,59,0,0,"PCTE",0
34,"34904",300,220,220,0,0,"PCTE",1
29,"29002",1150,851,842,4,9,"PCTE",0
16,"16181",57,46,46,1,0,"PCTE",0
37,"37315",86,68,67,0,1,"PCTE",0
33,"33005",1376,929,916,14,13,"PCTE",0
9,"9093",162,138,137,1,1,"PCTE",0
28,"28054",11891,9476,9395,64,81,"PCTE",4
28,"28064",135,110,104,1,6,"PCTE",0
47,"47050",3898,3084,3047,36,37,"PCTE",2
37,"37352",201,159,158,0,1,"PCTE",0
9,"9408",42,33,33,0,0,"PCTE",0
16,"16124",1826,1482,1455,6,27,"PCTE",2
49,"49112",118,78,78,2,0,"PCTE",0
16,"16040",85,72,72,1,0,"PCTE",0
40,"40099",52,46,44,0,2,"PCTE",0
41,"41045",5854,4287,4200,58,87,"PCTE",5
28,"28051",1640,1301,1292,9,9,"PCTE",2
49,"49075",134,118,114,1,4,"PCTE",0
42,"42018",131,102,102,1,0,"PCTE",0
18,"18021",17869,13238,13004,110,234,"PCTE",9
24,"24094",1326,982,966,4,16,"PCTE",3
37,"37242",80,65,64,1,1,"PCTE",0
9,"9016",84,55,54,0,1,"PCTE",0
40,"40005",25,21,21,0,0,"PCTE",0
50,"50270",38,32,30,1,2,"PCTE",0
47,"47038",101,79,79,0,0,"PCTE",0
9,"9242",66,53,53,1,0,"PCTE",0
40,"40193",221,163,161,5,2,"PCTE",0
29,"29071",979,718,712,14,6,"PCTE",1
37,"37179",196,172,169,0,3,"PCTE",0
18,"18148",803,652,648,0,4,"PCTE",0
16,"16027",701,540,531,2,9,"PCTE",0
40,"40002",34,30,30,0,0,"PCTE",0
33,"33027",769,505,497,14,8,"PCTE",0
50,"50204",2394,1876,1855,21,21,"PCTE",0
40,"40174",324,254,250,2,4,"PCTE",0
14,"14061",688,567,556,2,11,"PCTE",0
37,"37167",177,159,158,3,1,"PCTE",0
34,"34108",502,424,415,6,9,"PCTE",3
42,"42154",99,81,81,1,0,"PCTE",0
42,"42020",4186,3027,2988,28,39,"PCTE",4
16,"16905",1278,1028,1012,11,16,"PCTE",0
42,"42155",142,92,92,0,0,"PCTE",0
16,"16113",3067,2416,2383,15,33,"PCTE",0
24,"24164",362,221,220,1,1,"PCTE",0
18,"18911",7869,5871,5765,49,106,"PCTE",1
24,"24146",251,206,204,1,2,"PCTE",0
9,"9238",941,573,567,8,6,"PCTE",0
24,"24018",174,141,139,0,2,"PCTE",0
47,"47187",75,54,53,0,1,"PCTE",0
37,"37245",335,240,240,5,0,"PCTE",0
50,"50225",1532,1072,1064,10,8,"PCTE",2
47,"47197",867,721,717,2,4,"PCTE",0
40,"40089",214,176,170,1,6,"PCTE",1
28,"28086",5390,3992,3936,26,56,"PCTE",5
40,"40218",84,62,62,0,0,"PCTE",0
41,"41901",2703,2242,2201,29,41,"PCTE",0
42,"42107",67,48,48,0,0,"PCTE",1
50,"50139",322,257,256,0,1,"PCTE",0
42,"42022",206,161,161,1,0,"PCTE",0
16,"16172",349,278,275,3,3,"PCTE",0
16,"16275",12,12,12,0,0,"PCTE",0
41,"41077",8631,6441,6289,46,152,"PCTE",4
16,"16276",21,18,18,1,0,"PCTE",0
37,"37347",464,368,359,2,9,"PCTE",0
34,"34216",60,46,46,0,0,"PCTE",1
49,"49183",93,73,71,2,2,"PCTE",0
41,"41049",9493,7463,7312,78,151,"PCTE",5
50,"50227",110,74,73,2,1,"PCTE",0
16,"16130",536,445,444,0,1,"PCTE",0
18,"18039",3382,2517,2490,20,27,"PCTE",0
18,"18161",251,222,220,1,2,"PCTE",0
47,"47025",114,98,98,0,0,"PCTE",0
49,"49156",230,189,182,0,7,"PCTE",0
49,"49202",172,125,124,2,1,"PCTE",0
28,"28088",286,193,193,2,0,"PCTE",0
47,"47179",373,275,273,1,2,"PCTE",1
9,"9416",60,44,44,0,0,"PCTE",0
28,"28089",3842,3087,3048,12,39,"PCTE",3
34,"34231",217,184,178,0,6,"PCTE",0
47,"47053",126,100,97,0,3,"PCTE",0
2,"2064",374,318,315,3,3,"PCTE",0
33,"33062",388,250,245,9,5,"PCTE",0
42,"42110",55,43,43,0,0,"PCTE",0
40,"40045",120,92,92,1,0,"PCTE",0
37,"37164",238,194,193,4,1,"PCTE",0
40,"40183",116,103,103,0,0,"PCTE",0
9,"9226",56,47,47,0,0,"PCTE",0
16,"16051",126,102,100,0,2,"PCTE",0
37,"37345",150,134,133,0,1,"PCTE",0
39,"39084",874,718,712,4,6,"PCTE",0
49,"49200",936,744,726,10,18,"PCTE",0
39,"39018",4272,3533,3476,17,57,"PCTE",4
49,"49270",137,111,111,0,0,"PCTE",0
39,"39038",1506,1093,1076,2,17,"PCTE",0
50,"50285",650,466,462,7,4,"PCTE",0
37,"37082",745,546,536,2,10,"PCTE",0
37,"37001",172,133,133,0,0,"PCTE",0
50,"50082",84,63,63,0,0,"PCTE",0
50,"50054",56,48,47,0,1,"PCTE",0
14,"14026",2014,1502,1474,10,28,"PCTE",1
50,"50044",222,161,161,3,0,"PCTE",0
41,"41024",22737,15687,15398,167,289,"PCTE",8
39,"39094",841,676,670,3,6,"PCTE",0
49,"49039",327,255,246,6,9,"PCTE",0
47,"47171",384,315,311,5,4,"PCTE",0
41,"41015",5401,3984,3889,50,95,"PCTE",0
49,"49015",201,157,155,0,2,"PCTE",0
34,"34151",147,99,97,1,2,"PCTE",0
49,"49055",95,83,83,1,0,"PCTE",0
37,"37031",336,261,258,3,3,"PCTE",0
40,"40189",479,392,380,2,12,"PCTE",0
2,"2083",209,183,183,0,0,"PCTE",0
34,"34072",143,130,128,1,2,"PCTE",1
40,"40052",72,56,56,0,0,"PCTE",0
9,"9387",111,91,89,0,2,"PCTE",0
29,"29091",9407,6859,6719,63,140,"PCTE",6
18,"18030",567,448,442,4,6,"PCTE",1
37,"37004",24,19,19,0,0,"PCTE",0
42,"42003",66,55,55,0,0,"PCTE",0
39,"39012",6737,5391,5314,52,77,"PCTE",3
2,"2068",324,274,273,0,1,"PCTE",0
47,"47026",49,40,39,0,1,"PCTE",0
37,"37240",939,694,686,3,8,"PCTE",0
50,"50259",84,58,58,0,0,"PCTE",0
50,"50174",83,58,58,0,0,"PCTE",0
18,"18029",1813,1183,1169,9,14,"PCTE",2
49,"49234",399,339,333,2,6,"PCTE",0
14,"14052",9080,5999,5909,63,90,"PCTE",3
24,"24215",152,125,124,1,1,"PCTE",0
28,"28117",98,89,87,2,2,"PCTE",0
50,"50146",190,152,149,0,3,"PCTE",0
9,"9314",92,75,74,1,1,"PCTE",0
49,"49205",367,286,282,5,4,"PCTE",0
18,"18123",288,219,219,2,0,"PCTE",0
50,"50175",924,713,710,9,3,"PCTE",0
34,"34136",149,105,102,0,3,"PCTE",0
24,"24119",695,515,501,8,14,"PCTE",1
40,"40016",54,43,43,1,0,"PCTE",0
49,"49100",286,210,208,2,2,"PCTE",0
9,"9424",34,24,24,0,0,"PCTE",0
24,"24027",1219,913,886,8,27,"PCTE",1
50,"50010",66,56,55,2,1,"PCTE",0
2,"2010",1798,1494,1469,6,25,"PCTE",0
34,"34017",889,743,738,6,5,"PCTE",0
49,"49059",88,72,71,0,1,"PCTE",0
50,"50210",36,29,29,0,0,"PCTE",0
16,"16253",308,250,249,2,1,"PCTE",0
50,"50153",922,705,704,6,1,"PCTE",1
9,"9335",87,71,71,0,0,"PCTE",0
16,"16108",43,40,39,1,1,"PCTE",0
9,"9325",177,117,117,2,0,"PCTE",0
50,"50121",277,220,218,2,2,"PCTE",0
34,"34225",5001,4070,4021,48,49,"PCTE",3
16,"16240",100,77,76,0,1,"PCTE",0
34,"34125",79,59,58,0,1,"PCTE",0
47,"47156",150,128,128,2,0,"PCTE",1
37,"37218",48,29,29,0,0,"PCTE",0
2,"2084",305,221,215,1,6,"PCTE",0
9,"9023",1178,982,966,14,16,"PCTE",3
9,"9338",231,193,189,2,4,"PCTE",0
24,"24180",1101,844,833,8,11,"PCTE",2
18,"18033",279,221,220,1,1,"PCTE",0
47,"47186",244448,197042,195276,1561,1766,"PCTE",166
34,"34029",659,557,551,5,6,"PCTE",1
28,"28161",51559,41390,40922,255,468,"PCTE",30
50,"50196",102,83,81,2,2,"PCTE",0
41,"41010",4573,3407,3345,27,62,"PCTE",2
14,"14073",2772,2124,2069,18,55,"PCTE",2
33,"33059",4403,3007,2942,42,65,"PCTE",5
28,"28065",130679,106997,105975,762,1022,"PCTE",85
28,"28097",125,100,100,0,0,"PCTE",0
41,"41048",2198,1561,1512,22,49,"PCTE",2
37,"37145",244,187,185,3,2,"PCTE",0
28,"28055",907,671,666,5,5,"PCTE",0
18,"18151",259,194,193,3,1,"PCTE",0
49,"49078",142,113,113,1,0,"PCTE",0
34,"34141",176,154,152,0,2,"PCTE",1
9,"9446",12,8,8,0,0,"PCTE",0
49,"49251",161,125,124,0,1,"PCTE",0
18,"18024",831,682,667,6,15,"PCTE",0
28,"28120",1209,991,974,3,17,"PCTE",3
49,"49186",235,181,178,4,3,"PCTE",0
9,"9414",181,148,146,0,2,"PCTE",1
39,"39010",610,518,512,1,6,"PCTE",1
24,"24059",821,575,572,3,3,"PCTE",1
28,"28170",2487,1840,1810,10,30,"PCTE",0
37,"37300",547,392,391,5,1,"PCTE",1
37,"37255",42,31,31,2,0,"PCTE",0
41,"41033",4965,3634,3580,27,54,"PCTE",1
16,"16194",220,181,173,1,8,"PCTE",0
9,"9272",259,197,195,2,2,"PCTE",1
34,"34102",202,173,171,2,2,"PCTE",0
9,"9267",113,102,101,2,1,"PCTE",0
28,"28057",1549,1246,1239,5,7,"PCTE",1
24,"24008",9025,6803,6702,79,101,"PCTE",8
16,"16264",390,338,328,2,10,"PCTE",1
37,"37208",69,52,51,0,1,"PCTE",0
39,"39039",546,431,428,0,3,"PCTE",0
49,"49242",444,364,359,3,5,"PCTE",1
28,"28158",678,547,540,1,7,"PCTE",0
37,"37260",139,109,109,0,0,"PCTE",0
18,"18115",2650,1988,1975,20,13,"PCTE",3
16,"16011",23,18,18,0,0,"PCTE",0
29,"29050",398,274,269,2,5,"PCTE",0
39,"39062",1841,1511,1500,9,11,"PCTE",0
9,"9075",103,87,87,1,0,"PCTE",1
33,"33032",11086,8028,7849,129,179,"PCTE",30
34,"34027",1046,791,783,13,8,"PCTE",0
9,"9232",140,110,107,0,3,"PCTE",0
49,"49121",368,269,266,1,3,"PCTE",0
14,"14901",915,795,782,8,13,"PCTE",0
47,"47160",392,317,314,2,3,"PCTE",1
42,"42174",179,132,128,1,4,"PCTE",1
24,"24157",2545,2028,1972,25,56,"PCTE",3
47,"47096",126,106,105,0,1,"PCTE",0
42,"42113",521,382,380,3,2,"PCTE",1
41,"41005",9250,6925,6809,69,116,"PCTE",1
9,"9328",74,51,50,0,1,"PCTE",2
37,"37262",69,60,60,0,0,"PCTE",0
16,"16251",1809,1469,1443,11,26,"PCTE",1
42,"42190",92,74,73,1,1,"PCTE",0
33,"33047",1074,841,835,12,6,"PCTE",0
37,"37212",101,85,83,0,2,"PCTE",0
37,"37039",282,222,222,1,0,"PCTE",0
9,"9354",33,29,29,2,0,"PCTE",0
37,"37117",1553,1245,1230,14,15,"PCTE",0
18,"18157",1148,914,898,8,16,"PCTE",0
9,"9292",75,62,62,2,0,"PCTE",0
40,"40083",72,53,51,3,2,"PCTE",0
49,"49035",222,195,195,2,0,"PCTE",0
24,"24038",3048,2360,2315,23,45,"PCTE",2
39,"39049",306,209,208,4,1,"PCTE",0
18,"18109",599,452,448,3,4,"PCTE",0
29,"29092",579,434,426,5,8,"PCTE",0
47,"47035",902,715,707,5,8,"PCTE",0
49,"49028",105,94,93,1,1,"PCTE",0
14,"14011",572,498,495,5,3,"PCTE",0
47,"47056",83,71,71,0,0,"PCTE",0
18,"18188",1648,1295,1276,4,19,"PCTE",1
37,"37040",382,319,316,1,3,"PCTE",0
47,"47134",148,127,126,6,1,"PCTE",0
49,"49111",121,100,100,3,0,"PCTE",0
50,"50132",771,589,576,2,13,"PCTE",0
16,"16277",109,82,82,0,0,"PCTE",0
41,"41019",4895,3518,3462,36,56,"PCTE",1
28,"28044",6193,5040,4991,31,49,"PCTE",5
9,"9352",107,86,86,2,0,"PCTE",0
37,"37152",402,308,302,1,6,"PCTE",2
47,"47206",78,64,64,0,0,"PCTE",0
24,"24132",615,405,404,5,1,"PCTE",2
37,"37044",450,342,335,6,7,"PCTE",0
18,"18136",1782,1382,1359,12,23,"PCTE",1
34,"34155",120,104,103,0,1,"PCTE",0
40,"40086",660,570,548,3,22,"PCTE",0
9,"9297",313,268,267,6,1,"PCTE",1
39,"39004",1483,1181,1163,4,18,"PCTE",2
24,"24133",356,267,267,4,0,"PCTE",0
37,"37342",255,200,199,1,1,"PCTE",0
33,"33056",4877,3469,3420,30,49,"PCTE",6
42,"42156",29,23,23,0,0,"PCTE",1
18,"18182",1917,1391,1381,7,10,"PCTE",0
9,"9199",94,72,70,0,2,"PCTE",0
37,"37059",117,106,100,0,6,"PCTE",0
29,"29079",2335,1796,1765,7,31,"PCTE",4
37,"37274",118473,91137,90221,811,916,"PCTE",103
50,"50101",832,625,614,1,11,"PCTE",0
24,"24055",676,513,508,6,5,"PCTE",0
18,"18043",130,93,93,0,0,"PCTE",1
50,"50280",301,246,240,1,6,"PCTE",0
37,"37339",308,227,226,0,1,"PCTE",1
37,"37171",397,297,292,1,5,"PCTE",0
37,"37024",88,69,69,0,0,"PCTE",0
41,"41028",2071,1741,1713,18,28,"PCTE",0
37,"37074",140,107,106,1,1,"PCTE",0
50,"50205",74,58,57,0,1,"PCTE",0
37,"37008",4222,3431,3393,19,38,"PCTE",3
37,"37147",172,130,127,3,3,"PCTE",0
16,"16227",108,85,85,1,0,"PCTE",0
49,"49209",474,338,334,4,4,"PCTE",0
47,"47212",358,312,311,3,1,"PCTE",0
18,"18170",324,225,224,1,1,"PCTE",1
50,"50039",467,366,364,3,2,"PCTE",1
50,"50246",38,28,28,0,0,"PCTE",0
40,"40220",62,48,48,0,0,"PCTE",0
49,"49131",238,182,178,0,4,"PCTE",0
33,"33028",1158,635,630,6,5,"PCTE",0
40,"40225",1098,902,882,4,20,"PCTE",0
24,"24097",204,155,155,7,0,"PCTE",0
16,"16031",36,25,25,0,0,"PCTE",0
18,"18906",911,722,716,4,6,"PCTE",0
50,"50056",405,332,330,4,2,"PCTE",0
28,"28173",519,417,412,4,5,"PCTE",0
18,"18127",16822,12735,12537,106,198,"PCTE",11
33,"33050",558,381,375,2,6,"PCTE",0
14,"14054",13796,11042,10799,102,243,"PCTE",5
49,"49063",310,246,240,2,6,"PCTE",0
9,"9360",25,22,22,0,0,"PCTE",0
28,"28153",795,566,564,5,2,"PCTE",1
24,"24182",411,302,295,4,7,"PCTE",0
24,"24102",608,457,448,3,9,"PCTE",0
24,"24009",278,154,151,2,3,"PCTE",0
50,"50182",3675,2846,2810,36,36,"PCTE",4
37,"37112",152,104,103,0,1,"PCTE",0
9,"9131",480,412,402,2,10,"PCTE",1
9,"9283",44,33,33,0,0,"PCTE",0
16,"16198",1299,1044,1027,11,17,"PCTE",2
14,"14075",557,429,411,5,18,"PCTE",0
49,"49107",116,82,81,1,1,"PCTE",0
37,"37287",309,215,214,3,1,"PCTE",0
37,"37211",212,164,163,1,1,"PCTE",0
39,"39077",236,175,173,0,2,"PCTE",0
37,"37373",700,522,514,0,8,"PCTE",0
18,"18047",6074,4437,4353,33,84,"PCTE",3
33,"33031",33854,23523,23143,307,380,"PCTE",84
29,"29065",194,150,150,0,0,"PCTE",0
49,"49199",241,174,171,4,3,"PCTE",1
9,"9255",84,70,70,1,0,"PCTE",0
16,"16009",54,49,49,0,0,"PCTE",0
41,"41050",5180,4217,4149,34,68,"PCTE",1
29,"29033",1089,776,761,2,15,"PCTE",0
50,"50219",4283,3274,3213,53,61,"PCTE",4
24,"24125",421,298,289,2,9,"PCTE",0
29,"29082",34113,26248,26002,304,246,"PCTE",11
24,"24047",720,531,523,2,8,"PCTE",0
14,"14016",1283,1005,994,4,11,"PCTE",1
49,"49226",239,207,200,3,7,"PCTE",0
18,"18032",242,180,178,2,2,"PCTE",0
37,"37265",208,184,181,1,3,"PCTE",0
24,"24062",130,90,90,2,0,"PCTE",1
9,"9183",47,41,41,0,0,"PCTE",1
37,"37311",207,164,162,4,2,"PCTE",0
40,"40188",83,71,71,0,0,"PCTE",0
9,"9249",50,39,39,0,0,"PCTE",0
16,"16159",209,147,144,0,3,"PCTE",0
24,"24212",1002,772,764,7,8,"PCTE",0
41,"41041",9760,7835,7646,44,189,"PCTE",3
34,"34010",553,454,449,3,5,"PCTE",1
24,"24093",338,239,232,3,7,"PCTE",0
41,"41067",7227,5367,5271,56,96,"PCTE",2
49,"49016",229,189,187,2,2,"PCTE",1
37,"37026",175,148,148,2,0,"PCTE",0
24,"24023",262,208,206,3,2,"PCTE",0
16,"16049",144,111,108,1,3,"PCTE",0
28,"28182",198,169,169,1,0,"PCTE",0
47,"47052",6752,5665,5589,57,76,"PCTE",8
16,"16010",137,104,101,0,3,"PCTE",1
24,"24165",327,236,233,1,3,"PCTE",0
16,"16131",127,90,90,1,0,"PCTE",0
29,"29018",1996,1523,1481,11,42,"PCTE",0
2,"2058",313,218,214,1,4,"PCTE",0
47,"47168",30,29,29,0,0,"PCTE",0
16,"16082",271,207,206,3,1,"PCTE",0
28,"28048",504,399,392,6,7,"PCTE",0
28,"28135",985,762,756,1,6,"PCTE",0
49,"49150",123,90,90,3,0,"PCTE",0
9,"9412",765,564,558,7,6,"PCTE",1
28,"28037",1578,1196,1180,5,16,"PCTE",0
39,"39059",7577,5978,5916,47,62,"PCTE",6
37,"37323",476,380,377,7,3,"PCTE",0
39,"39083",1074,786,777,4,9,"PCTE",2
40,"40084",53,40,39,0,1,"PCTE",0
16,"16244",708,627,617,1,10,"PCTE",0
16,"16089",377,308,308,1,0,"PCTE",0
24,"24144",639,469,462,2,7,"PCTE",1
37,"37371",258,176,175,0,1,"PCTE",0
33,"33041",7112,5251,5194,63,57,"PCTE",5
39,"39047",1976,1564,1538,8,26,"PCTE",0
39,"39003",258,205,202,3,3,"PCTE",0
9,"9473",87,76,73,0,3,"PCTE",0
24,"24137",1052,815,803,14,12,"PCTE",0
37,"37065",271,187,184,0,3,"PCTE",0
9,"9309",292,224,223,3,1,"PCTE",1
18,"18122",16001,11761,11556,110,205,"PCTE",6
9,"9380",73,53,53,0,0,"PCTE",0
18,"18028",907,766,756,0,10,"PCTE",0
50,"50293",392,295,293,6,2,"PCTE",0
49,"49009",389,305,304,2,1,"PCTE",0
24,"24207",278,242,235,0,7,"PCTE",0
49,"49134",166,111,111,2,0,"PCTE",0
39,"39036",971,794,787,5,7,"PCTE",0
24,"24178",72,65,65,1,0,"PCTE",1
34,"34161",22,17,16,0,1,"PCTE",0
39,"39025",8703,6954,6854,39,100,"PCTE",2
16,"16093",57,47,47,0,0,"PCTE",0
50,"50221",32,22,22,0,0,"PCTE",1
39,"39034",257,167,162,2,5,"PCTE",0
9,"9088",64,42,42,4,0,"PCTE",0
49,"49021",14258,10333,10206,102,127,"PCTE",9
34,"34100",131,100,97,1,3,"PCTE",0
42,"42166",57,49,49,0,0,"PCTE",1
50,"50257",163,136,134,1,2,"PCTE",0
18,"18154",975,701,699,3,2,"PCTE",0
49,"49227",313,255,254,1,1,"PCTE",0
29,"29058",1538,1079,1062,5,17,"PCTE",1
9,"9128",78,63,61,1,2,"PCTE",0
47,"47032",153,121,121,1,0,"PCTE",0
34,"34168",45,39,39,0,0,"PCTE",0
42,"42125",75,62,62,2,0,"PCTE",0
28,"28078",40,37,37,0,0,"PCTE",0
28,"28006",80622,64905,64483,400,422,"PCTE",47
37,"37096",203,162,160,1,2,"PCTE",0
49,"49223",716,552,548,0,4,"PCTE",1
50,"50282",57,47,45,0,2,"PCTE",0
9,"9202",22,22,22,2,0,"PCTE",0
37,"37294",11787,9201,9083,76,118,"PCTE",14
42,"42017",131,104,104,2,0,"PCTE",0
47,"47012",101,80,80,0,0,"PCTE",0
9,"9122",88,64,64,0,0,"PCTE",0
9,"9280",27,22,22,0,0,"PCTE",0
47,"47051",321,274,272,1,2,"PCTE",0
9,"9060",128,111,111,1,0,"PCTE",0
2,"2029",3327,2586,2556,15,30,"PCTE",4
47,"47183",139,118,118,1,0,"PCTE",0
14,"14048",1189,948,933,5,15,"PCTE",1
42,"42028",76,65,65,1,0,"PCTE",0
2,"2053",2885,2313,2282,13,31,"PCTE",2
34,"34104",233,190,189,1,1,"PCTE",1
2,"2065",443,373,370,0,3,"PCTE",0
16,"16103",239,203,203,0,0,"PCTE",0
50,"50142",24,18,18,0,0,"PCTE",0
47,"47150",259,206,202,0,4,"PCTE",2
18,"18046",1753,1206,1185,1,21,"PCTE",0
37,"37350",404,310,307,0,3,"PCTE",0
47,"47023",3057,2577,2557,21,20,"PCTE",1
16,"16006",110,99,98,1,1,"PCTE",0
50,"50211",237,177,173,0,4,"PCTE",0
29,"29043",2474,1764,1720,25,44,"PCTE",4
47,"47151",28,22,22,0,0,"PCTE",0
37,"37194",237,182,181,0,1,"PCTE",0
42,"42140",14,13,12,0,1,"PCTE",0
18,"18116",2853,2265,2233,15,32,"PCTE",2
37,"37328",164,127,127,4,0,"PCTE",0
42,"42010",21,18,16,0,2,"PCTE",0
49,"49252",304,244,241,6,3,"PCTE",0
50,"50014",119,85,85,0,0,"PCTE",0
29,"29066",346,266,266,2,0,"PCTE",0
50,"50113",584,505,495,3,10,"PCTE",0
49,"49108",454,325,322,2,3,"PCTE",0
39,"39088",59,51,51,0,0,"PCTE",0
14,"14902",1121,928,900,7,28,"PCTE",0
50,"50172",178,134,131,3,3,"PCTE",0
42,"42160",247,195,194,4,1,"PCTE",1
34,"34243",320,260,258,1,2,"PCTE",0
16,"16279",174,125,125,0,0,"PCTE",0
34,"34070",135,101,101,1,0,"PCTE",0
1,"1039",195,157,153,0,4,"PCTE/ELAK",1
48,"48901",5151,4042,4012,22,30,"PCTE/ELAK",0
48,"48064",613,494,492,1,2,"PCTE/ELAK",0
48,"48013",79423,59100,58630,458,470,"PCTE/ELAK",78
48,"48047",149,115,115,1,0,"PCTE/ELAK",0
48,"48067",1134,877,872,5,5,"PCTE/ELAK",0
1,"1037",585,426,425,1,1,"PCTE/ELAK",0
48,"48020",272959,203643,202331,1472,1312,"PCTE/ELAK",166
48,"48077",3376,2656,2647,11,9,"PCTE/ELAK",2
48,"48007",385,281,279,1,2,"PCTE/ELAK",0
48,"48074",3273,2480,2460,14,20,"PCTE/ELAK",2
48,"48070",528,392,390,2,2,"PCTE/ELAK",0
48,"48060",3620,2615,2606,13,9,"PCTE/ELAK",1
48,"48084",21858,15943,15796,116,147,"PCTE/ELAK",18
1,"1053",592,376,373,2,3,"PCTE/ELAK",0
1,"1042",907,723,721,4,2,"PCTE/ELAK",0
1,"1047",967,686,673,8,13,"PCTE/ELAK",2
1,"1008",802,576,570,3,6,"PCTE/ELAK",1
48,"48050",187,153,149,0,4,"PCTE/ELAK",0
48,"48059",400,329,325,0,4,"PCTE/ELAK",0
48,"48027",22668,17326,17224,95,102,"PCTE/ELAK",11
48,"48036",24038,18180,18050,94,130,"PCTE/ELAK",15
48,"48053",904,738,728,5,10,"PCTE/ELAK",0
1,"1054",1013,729,726,2,3,"PCTE/ELAK",2
1,"1056",205,134,134,0,0,"PCTE/ELAK",0
1,"1041",152,107,103,2,4,"PCTE/ELAK",1
48,"48063",356,277,274,2,3,"PCTE/ELAK",0
48,"48030",601,490,489,0,1,"PCTE/ELAK",0
1,"1023",262,210,206,3,4,"PCTE/ELAK",0
48,"48910",2802,2082,2073,3,9,"PCTE/ELAK",1
48,"48914",325,286,285,0,1,"PCTE/ELAK",0
1,"1057",243,202,199,0,3,"PCTE/ELAK",0
48,"48043",4539,3566,3556,22,10,"PCTE/ELAK",4
48,"48903",1807,1471,1462,6,9,"PCTE/ELAK",0
1,"1010",2315,1789,1770,14,19,"PCTE/ELAK",3
48,"48046",12644,9809,9744,46,65,"PCTE/ELAK",4
48,"48037",684,537,531,4,6,"PCTE/ELAK",0
48,"48002",7777,6034,5981,48,53,"PCTE/ELAK",3
48,"48087",432,357,356,0,1,"PCTE/ELAK",0
1,"1032",500,372,362,1,10,"PCTE/ELAK",1
48,"48076",284,226,224,1,2,"PCTE/ELAK",0
48,"48018",867,605,603,3,2,"PCTE/ELAK",0
48,"48040",1309,979,973,5,6,"PCTE/ELAK",0
48,"48012",2071,1685,1674,7,11,"PCTE/ELAK",0
48,"48045",5194,4138,4098,25,40,"PCTE/ELAK",3
1,"1019",148,121,121,0,0,"PCTE/ELAK",0
48,"48015",33109,24697,24475,161,222,"PCTE/ELAK",21
48,"48096",6510,5247,5185,36,62,"PCTE/ELAK",5
1,"1063",1830,1363,1353,4,10,"PCTE/ELAK",2
48,"48057",5745,4391,4376,13,15,"PCTE/ELAK",0
48,"48094",3125,2407,2388,12,19,"PCTE/ELAK",1
1,"1034",150,111,111,2,0,"PCTE/ELAK",0
1,"1061",152,129,129,2,0,"PCTE/ELAK",0
48,"48090",6016,4700,4639,24,61,"PCTE/ELAK",2
48,"48913",1224,977,967,6,10,"PCTE/ELAK",1
1,"1016",421,236,229,3,7,"PCTE/ELAK",1
48,"48075",2067,1591,1565,11,26,"PCTE/ELAK",0
48,"48079",395,313,312,2,1,"PCTE/ELAK",0
48,"48039",256,218,217,1,1,"PCTE/ELAK",0
48,"48005",113,80,80,0,0,"PCTE/ELAK",0
1,"1020",320,239,238,1,1,"PCTE/ELAK",0
1,"1062",315,236,229,2,7,"PCTE/ELAK",0
1,"1018",1408,998,993,6,5,"PCTE/ELAK",2
48,"48009",772,628,622,2,6,"PCTE/ELAK",0
48,"48065",3303,2541,2524,15,17,"PCTE/ELAK",1
48,"48026",1139,920,913,4,7,"PCTE/ELAK",0
48,"48073",6837,4950,4921,33,29,"PCTE/ELAK",2
48,"48003",14444,11233,11162,43,71,"PCTE/ELAK",20
48,"48023",580,493,489,0,4,"PCTE/ELAK",0
1,"1004",1356,1007,998,3,9,"PCTE/ELAK",1
48,"48904",3542,2832,2811,27,21,"PCTE/ELAK",2
48,"48019",3461,2647,2633,12,14,"PCTE/ELAK",4
1,"1052",268,188,187,1,1,"PCTE/ELAK",1
48,"48049",545,448,448,0,0,"PCTE/ELAK",0
1,"1036",14772,10850,10746,69,104,"PCTE/ELAK",14
48,"48056",989,791,785,4,6,"PCTE/ELAK",1
48,"48054",24938,19329,19197,124,132,"PCTE/ELAK",16
48,"48068",1528,1218,1211,5,7,"PCTE/ELAK",1
48,"48008",615,454,448,4,6,"PCTE/ELAK",1
48,"48095",2326,1691,1680,11,11,"PCTE/ELAK",0
48,"48911",388,323,322,3,1,"PCTE/ELAK",0
1,"1051",3558,2448,2433,14,15,"PCTE/ELAK",6
48,"48066",347,291,291,0,0,"PCTE/ELAK",0
1,"1033",656,533,525,1,8,"PCTE/ELAK",0
48,"48035",404,334,331,2,3,"PCTE/ELAK",0
1,"1027",430,295,293,2,2,"PCTE/ELAK",1
48,"48908",249,214,213,0,1,"PCTE/ELAK",0
1,"1049",132,100,100,1,0,"PCTE/ELAK",0
48,"48909",202,172,172,2,0,"PCTE/ELAK",0
48,"48028",691,576,573,1,3,"PCTE/ELAK",0
48,"48006",309,265,265,0,0,"PCTE/ELAK",0
48,"48097",1316,979,976,4,3,"PCTE/ELAK",2
48,"48902",18971,14015,13895,101,120,"PCTE/ELAK",15
48,"48078",37991,28582,28382,202,200,"PCTE/ELAK",34
48,"48089",3463,2746,2732,10,14,"PCTE/ELAK",2
1,"1011",215,179,175,3,4,"PCTE/ELAK",0
1,"1009",1265,920,914,6,6,"PCTE/ELAK",1
48,"48091",1090,862,857,9,5,"PCTE/ELAK",0
48,"48004",326,261,260,3,1,"PCTE/ELAK",0
48,"48010",474,368,368,0,0,"PCTE/ELAK",0
48,"48044",62054,49055,48840,373,215,"PCTE/ELAK",34
48,"48033",204,160,159,1,1,"PCTE/ELAK",0
48,"48052",1567,1309,1300,4,9,"PCTE/ELAK",1
48,"48001",5885,4359,4334,35,25,"PCTE/ELAK",5
48,"48041",686,581,579,2,2,"PCTE/ELAK",0
1,"1031",1163,948,928,6,20,"PCTE/ELAK",1
48,"48906",753,611,608,1,3,"PCTE/ELAK",0
48,"48042",1365,1136,1130,7,6,"PCTE/ELAK",2
48,"48014",1242,915,910,4,5,"PCTE/ELAK",1
1,"1058",1403,958,951,4,7,"PCTE/ELAK",2
1,"1014",366,283,277,7,6,"PCTE/ELAK",0
48,"48088",133,99,98,2,1,"PCTE/ELAK",1
1,"1055",840,608,602,10,6,"PCTE/ELAK",1
48,"48022",2316,1645,1631,11,14,"PCTE/ELAK",0
48,"48034",12639,9519,9443,77,76,"PCTE/ELAK",18
1,"1006",176,127,127,2,0,"PCTE/ELAK",2
1,"1030",143,118,117,1,1,"PCTE/ELAK",0
48,"48069",13094,10021,9954,49,67,"PCTE/ELAK",6
1,"1044",231,171,166,0,5,"PCTE/ELAK",0
48,"48031",308,236,236,0,0,"PCTE/ELAK",0
1,"1003",1179,908,903,6,5,"PCTE/ELAK",1
48,"48093",888,720,715,2,5,"PCTE/ELAK",1
48,"48082",37396,27913,27694,172,219,"PCTE/ELAK",32
1,"1021",469,333,330,1,3,"PCTE/ELAK",1
48,"48085",10637,8270,8223,54,47,"PCTE/ELAK",6
48,"48905",2490,1911,1891,16,20,"PCTE/ELAK",2
48,"48081",1883,1532,1518,3,14,"PCTE/ELAK",0
48,"48083",6946,5238,5201,35,37,"PCTE/ELAK",5
1,"1059",189037,133121,131768,792,1353,"PCTE/ELAK",164
48,"48025",860,694,694,3,0,"PCTE/ELAK",0
48,"48048",543,421,419,1,2,"PCTE/ELAK",1
48,"48016",5437,4282,4248,21,34,"PCTE/ELAK",2
48,"48080",9946,7574,7499,46,75,"PCTE/ELAK",7
48,"48011",9652,7293,7251,37,42,"PCTE/ELAK",8
48,"48072",970,735,730,1,5,"PCTE/ELAK",0
48,"48038",1158,891,891,2,0,"PCTE/ELAK",0
48,"48024",999,813,811,2,2,"PCTE/ELAK",0
48,"48071",6038,4711,4674,27,37,"PCTE/ELAK",4
1,"1043",2337,1669,1656,18,13,"PCTE/ELAK",5
48,"48086",2015,1504,1486,6,18,"PCTE/ELAK",0
48,"48915",347,259,259,4,0,"PCTE/ELAK",0
1,"1046",631,464,461,0,3,"PCTE/ELAK",0
48,"48092",869,676,674,9,2,"PCTE/ELAK",0
48,"48058",946,724,715,3,9,"PCTE/ELAK",0
48,"48051",216,157,157,0,0,"PCTE/ELAK",0
48,"48055",2596,2023,2005,12,18,"PCTE/ELAK",2
48,"48021",1336,990,983,4,7,"PCTE/ELAK",1
1,"1902",730,551,545,6,6,"PCTE/ELAK",0
1,"1002",8035,6227,6159,17,68,"PCTE/ELAK",8
48,"48061",799,636,636,2,0,"PCTE/ELAK",0
1,"1901",2474,1655,1631,13,24,"PCTE/ELAK",2
1,"1001",2005,1438,1419,4,19,"PCTE/ELAK",3
48,"48912",2331,1843,1833,7,10,"PCTE/ELAK",5
48,"48062",293,247,245,0,2,"PCTE/ELAK",0
1,"1013",703,491,487,2,4,"PCTE/ELAK",1
48,"48907",340,283,281,1,2,"PCTE/ELAK",0
48,"48032",5773,4504,4476,5,28,"PCTE/ELAK",1
1,"1022",761,577,569,5,8,"PCTE/ELAK",0
1,"1017",816,579,574,2,5,"PCTE/ELAK",1
48,"48029",8613,6697,6642,52,55,"PCTE/ELAK",5
1,"1028",1068,774,772,7,2,"PCTE/ELAK",0
48,"48017",13150,9546,9504,38,42,"PCTE/ELAK",9
1,"1060",201,174,166,1,8,"PCTE/ELAK",1
15,"15041",9581,7223,7082,96,141,"PCTG",9
32,"32032",7932,5956,5831,55,125,"PCTG",3
32,"32090",738,530,525,3,5,"PCTG",5
27,"27902",7150,5067,4953,74,114,"PCTG",4
15,"15005",25263,17634,17347,257,287,"PCTG",21
36,"36045",24478,18627,18327,157,300,"PCTG",21
15,"15003",1701,1234,1210,10,24,"PCTG",0
36,"36004",10123,7396,7273,93,123,"PCTG",7
27,"27040",3035,2285,2234,19,51,"PCTG",1
15,"15057",12051,8814,8660,89,154,"PCTG",9
36,"36051",14315,10396,10223,70,173,"PCTG",8
15,"15014",3836,2739,2698,38,41,"PCTG",2
32,"32052",1819,1399,1379,15,20,"PCTG",1
32,"32020",2460,1899,1876,6,23,"PCTG",0
36,"36023",8279,6187,6085,46,102,"PCTG",9
15,"15009",10615,8066,7919,93,147,"PCTG",3
36,"36008",21884,16428,16170,165,258,"PCTG",30
15,"15051",4562,3302,3249,36,53,"PCTG",5
15,"15073",21760,14900,14630,181,270,"PCTG",22
15,"15037",4031,2700,2677,13,23,"PCTG",1
27,"27045",944,700,698,13,2,"PCTG",0
36,"36037",2554,1839,1793,6,46,"PCTG",3
15,"15045",3629,2263,2237,9,26,"PCTG",5
36,"36030",3946,2847,2810,26,37,"PCTG",3
15,"15022",5574,3846,3798,41,48,"PCTG",6
32,"32042",1505,1097,1091,12,6,"PCTG",1
32,"32014",1045,775,769,5,6,"PCTG",0
15,"15090",1125,811,800,7,11,"PCTG",2
27,"27051",8012,5936,5832,70,104,"PCTG",6
27,"27001",2209,1290,1251,25,39,"PCTG",1
32,"32036",1261,954,938,9,16,"PCTG",1
27,"27038",923,688,677,12,11,"PCTG",1
15,"15083",1036,784,768,7,16,"PCTG",0
15,"15013",6299,4549,4486,45,63,"PCTG",7
32,"32078",1108,794,781,15,13,"PCTG",0
15,"15012",3611,2695,2616,36,79,"PCTG",4
32,"32025",1013,773,761,7,12,"PCTG",0
15,"15034",2724,1832,1811,8,21,"PCTG",1
15,"15053",7548,5364,5309,44,55,"PCTG",5
27,"27004",1149,741,722,2,19,"PCTG",0
15,"15054",31802,22002,21676,368,326,"PCTG",22
15,"15010",1819,1194,1181,16,13,"PCTG",2
32,"32010",360,276,273,3,3,"PCTG",0
15,"15061",5199,3694,3601,40,93,"PCTG",1
32,"32088",1610,1040,1019,11,21,"PCTG",1
36,"36038",66806,50974,50429,507,545,"PCTG",43
15,"15066",4008,2931,2886,30,45,"PCTG",2
36,"36014",1872,1373,1345,14,28,"PCTG",1
27,"27018",3232,2114,2089,24,25,"PCTG",1
32,"32065",630,478,474,5,4,"PCTG",1
27,"27049",1342,934,921,11,13,"PCTG",0
36,"36021",12099,9105,8974,85,131,"PCTG",8
36,"36024",16395,12372,12165,102,207,"PCTG",10
15,"15035",11208,8175,8068,105,107,"PCTG",8
27,"27044",2719,1848,1797,29,51,"PCTG",0
32,"32055",1230,908,889,5,19,"PCTG",1
15,"15028",1393,1076,1063,8,13,"PCTG",0
15,"15036",56248,40194,39764,508,430,"PCTG",59
36,"36016",1064,707,696,7,11,"PCTG",1
27,"27026",2315,1620,1599,17,21,"PCTG",1
36,"36036",2556,1953,1914,14,39,"PCTG",4
32,"32012",716,497,487,7,10,"PCTG",0
15,"15902",4522,3220,3159,47,61,"PCTG",3
32,"32017",1202,821,815,6,6,"PCTG",0
15,"15032",3413,2487,2414,28,73,"PCTG",2
32,"32057",514,367,365,5,2,"PCTG",1
15,"15048",5048,3791,3730,38,61,"PCTG",5
32,"32047",1746,1272,1252,6,20,"PCTG",0
36,"36005",8122,5895,5776,65,119,"PCTG",4
32,"32049",689,468,462,3,6,"PCTG",0
27,"27007",2756,2148,2084,29,64,"PCTG",1
36,"36020",2184,1621,1599,13,22,"PCTG",0
32,"32056",1520,1125,1116,6,9,"PCTG",0
32,"32075",4382,3546,3489,35,57,"PCTG",1
27,"27017",961,667,654,1,13,"PCTG",0
32,"32066",551,399,396,1,3,"PCTG",0
32,"32046",1098,793,782,5,11,"PCTG",0
15,"15039",1224,874,850,11,24,"PCTG",1
15,"15076",2514,1709,1683,19,26,"PCTG",1
15,"15008",5631,4320,4267,64,53,"PCTG",3
32,"32045",2360,1712,1689,18,23,"PCTG",1
27,"27046",1448,1074,1063,7,11,"PCTG",0
32,"32069",4256,3358,3309,39,49,"PCTG",6
15,"15004",4873,3689,3623,31,66,"PCTG",3
36,"36031",562,455,450,2,5,"PCTG",0
32,"32026",2659,1988,1957,26,31,"PCTG",0
27,"27031",15212,10826,10649,125,177,"PCTG",9
15,"15017",19860,14930,14706,204,224,"PCTG",10
27,"27012",1276,776,768,9,8,"PCTG",0
36,"36034",3319,2384,2347,16,37,"PCTG",2
15,"15029",5403,3682,3622,62,60,"PCTG",9
27,"27053",501,384,373,1,11,"PCTG",0
27,"27022",4683,3131,3059,30,72,"PCTG",2
27,"27015",4020,2809,2730,33,79,"PCTG",2
32,"32085",10634,7655,7551,66,104,"PCTG",5
36,"36028",4069,3012,2960,27,52,"PCTG",4
32,"32080",286,223,220,1,3,"PCTG",0
32,"32077",1104,820,815,10,5,"PCTG",0
32,"32031",1014,764,756,5,8,"PCTG",0
27,"27006",2458,1713,1666,27,47,"PCTG",0
15,"15078",78678,60510,59882,621,628,"PCTG",35
15,"15068",4849,3435,3392,55,43,"PCTG",3
36,"36029",16086,12196,12005,126,191,"PCTG",11
15,"15018",1087,771,761,8,10,"PCTG",0
36,"36010",2828,2217,2184,15,33,"PCTG",1
27,"27060",2463,1695,1669,12,26,"PCTG",1
36,"36032",3537,2676,2626,16,50,"PCTG",3
27,"27043",1219,814,797,6,17,"PCTG",1
15,"15046",6163,4625,4497,49,128,"PCTG",4
32,"32001",5105,3760,3715,37,45,"PCTG",0
15,"15027",1555,1227,1204,18,23,"PCTG",0
27,"27034",1025,647,636,4,11,"PCTG",0
36,"36047",2287,1601,1585,14,16,"PCTG",2
15,"15079",1466,1076,1052,11,24,"PCTG",2
36,"36044",2539,1768,1708,18,60,"PCTG",0
27,"27062",584,467,466,3,1,"PCTG",1
32,"32004",1671,907,899,7,8,"PCTG",0
27,"27027",1806,1392,1354,18,38,"PCTG",2
15,"15007",3179,2333,2304,22,29,"PCTG",1
32,"32048",864,550,544,1,6,"PCTG",0
27,"27050",2842,2100,2072,19,28,"PCTG",0
27,"27039",4430,3437,3353,53,84,"PCTG",1
32,"32073",1281,941,932,9,9,"PCTG",1
15,"15070",8797,6312,6173,108,139,"PCTG",3
15,"15023",6318,4501,4436,40,65,"PCTG",3
36,"36058",4942,3470,3402,37,68,"PCTG",1
36,"36041",13621,10098,9939,97,159,"PCTG",12
15,"15011",15481,11249,11037,105,212,"PCTG",12
32,"32061",1070,862,855,8,7,"PCTG",0
32,"32018",1179,950,936,3,14,"PCTG",1
15,"15091",1103,773,758,16,15,"PCTG",2
15,"15081",982,755,741,11,14,"PCTG",2
27,"27033",598,423,415,1,8,"PCTG",0
32,"32008",8572,6301,6216,65,85,"PCTG",9
15,"15042",2955,2057,2002,16,55,"PCTG",0
36,"36049",7019,5414,5283,48,131,"PCTG",13
15,"15901",3359,2237,2205,35,32,"PCTG",3
32,"32021",874,616,615,4,1,"PCTG",0
15,"15025",1000,639,631,6,8,"PCTG",0
15,"15033",2422,1887,1866,13,21,"PCTG",1
27,"27030",3134,2209,2162,27,47,"PCTG",2
36,"36003",10038,7747,7632,79,115,"PCTG",6
32,"32043",2512,1805,1789,16,16,"PCTG",2
15,"15075",12785,9638,9519,121,119,"PCTG",3
32,"32040",1418,1083,1075,3,8,"PCTG",0
32,"32064",480,348,346,2,2,"PCTG",0
32,"32092",482,337,334,2,3,"PCTG",0
27,"27008",1345,965,946,17,19,"PCTG",0
32,"32022",1238,924,916,5,8,"PCTG",0
32,"32041",759,510,502,2,8,"PCTG",1
32,"32050",2280,1788,1775,19,13,"PCTG",2
15,"15065",7151,5281,5165,63,116,"PCTG",5
32,"32091",1703,1312,1306,4,6,"PCTG",1
15,"15038",2123,1441,1413,25,28,"PCTG",4
15,"15092",6250,4358,4297,28,61,"PCTG",2
36,"36002",3076,2225,2185,19,40,"PCTG",1
32,"32044",809,625,617,2,8,"PCTG",1
27,"27055",1197,857,851,2,6,"PCTG",1
27,"27024",1451,1122,1102,5,20,"PCTG",1
15,"15044",1209,889,876,4,13,"PCTG",0
15,"15093",4048,2761,2720,41,41,"PCTG",2
15,"15074",3919,2865,2808,33,57,"PCTG",5
32,"32076",1974,1492,1472,17,20,"PCTG",0
15,"15031",23779,17963,17787,213,176,"PCTG",11
15,"15049",1091,805,796,8,9,"PCTG",1
27,"27011",2358,1582,1558,12,24,"PCTG",0
32,"32005",827,628,622,4,6,"PCTG",0
36,"36060",30432,22488,22196,199,292,"PCTG",21
15,"15015",2883,2079,2049,21,30,"PCTG",3
36,"36022",9061,6640,6482,47,158,"PCTG",5
27,"27063",1715,1236,1198,10,38,"PCTG",1
15,"15059",10255,7423,7262,122,161,"PCTG",8
36,"36039",15610,11844,11592,103,252,"PCTG",6
27,"27029",1427,1068,1047,13,21,"PCTG",0
32,"32058",5225,3915,3857,35,58,"PCTG",1
27,"27005",2551,1908,1868,26,40,"PCTG",1
15,"15056",5648,4033,3979,39,54,"PCTG",0
15,"15087",5692,3883,3838,53,45,"PCTG",3
15,"15052",4104,2928,2878,30,50,"PCTG",1
27,"27010",4402,3015,2940,49,75,"PCTG",6
15,"15030",199972,151737,150397,1576,1340,"PCTG",101
15,"15016",4569,3171,3146,18,25,"PCTG",1
27,"27047",1525,1026,1008,5,18,"PCTG",2
15,"15043",4978,3631,3572,39,59,"PCTG",2
36,"36013",2242,1468,1452,15,16,"PCTG",0
27,"27058",3322,2551,2512,22,39,"PCTG",0
15,"15072",9436,6962,6860,60,102,"PCTG",11
27,"27059",2055,1508,1471,13,37,"PCTG",2
36,"36017",17419,12867,12610,120,257,"PCTG",9
27,"27041",2238,1640,1615,10,25,"PCTG",2
36,"36026",19924,14342,14132,171,210,"PCTG",13
15,"15069",6588,4914,4830,58,84,"PCTG",4
36,"36009",4445,3081,2997,26,84,"PCTG",2
32,"32059",1703,1248,1228,12,20,"PCTG",1
32,"32068",1419,998,987,4,11,"PCTG",2
32,"32071",1378,963,954,7,9,"PCTG",0
36,"36001",2401,1739,1715,19,24,"PCTG",0
32,"32079",1287,1016,1006,6,10,"PCTG",0
32,"32016",724,543,535,3,8,"PCTG",1
36,"36025",2137,1387,1381,7,6,"PCTG",1
32,"32067",1193,827,818,10,9,"PCTG",2
15,"15062",5652,3803,3728,25,75,"PCTG",4
32,"32029",436,340,337,1,3,"PCTG",0
15,"15024",4346,3210,3151,19,59,"PCTG",3
15,"15064",2127,1608,1577,29,31,"PCTG",0
32,"32072",3687,2715,2682,22,33,"PCTG",4
36,"36057",238171,181891,180030,1636,1861,"PCTG",198
15,"15047",2269,1531,1497,25,34,"PCTG",0
15,"15089",4324,3258,3200,33,58,"PCTG",2
27,"27056",1206,896,880,9,16,"PCTG",0
32,"32039",1142,895,890,7,5,"PCTG",0
32,"32083",821,592,587,7,5,"PCTG",0
36,"36042",18072,13314,13091,130,223,"PCTG",14
15,"15080",1640,1177,1150,9,27,"PCTG",2
15,"15077",8155,5554,5433,59,121,"PCTG",8
36,"36019",1463,1041,1030,14,11,"PCTG",1
27,"27901",2275,1542,1531,27,11,"PCTG",3
32,"32081",2035,1592,1565,14,27,"PCTG",1
32,"32033",676,480,468,4,12,"PCTG",0
27,"27025",2743,2191,2138,31,53,"PCTG",0
36,"36053",5784,4407,4327,28,80,"PCTG",2
15,"15085",3220,2284,2239,23,45,"PCTG",1
32,"32087",1675,1313,1288,18,25,"PCTG",1
32,"32015",830,543,541,4,2,"PCTG",2
27,"27065",12076,8393,8183,128,210,"PCTG",8
32,"32013",2017,1388,1380,5,8,"PCTG",2
27,"27016",6973,5139,5064,66,75,"PCTG",7
32,"32019",11512,8281,8161,96,120,"PCTG",14
15,"15060",5843,4360,4281,65,79,"PCTG",5
36,"36054",11074,8032,7873,77,159,"PCTG",10
32,"32051",1407,1158,1153,12,5,"PCTG",1
32,"32003",889,667,654,3,13,"PCTG",1
36,"36050",7650,5616,5506,48,110,"PCTG",2
27,"27035",180,127,123,0,4,"PCTG",0
27,"27048",2019,1499,1467,23,32,"PCTG",1
36,"36061",8617,6498,6391,59,107,"PCTG",7
32,"32011",918,526,521,6,5,"PCTG",0
27,"27052",862,645,640,4,5,"PCTG",0
32,"32054",86475,64472,63712,676,760,"PCTG",37
36,"36901",4152,3400,3338,15,62,"PCTG",3
27,"27020",3380,2764,2713,32,51,"PCTG",1
32,"32038",399,274,271,3,3,"PCTG",1
15,"15055",4485,3097,3057,39,40,"PCTG",5
27,"27009",2022,1514,1488,17,26,"PCTG",1
32,"32028",1550,1176,1171,10,5,"PCTG",0
27,"27021",1649,1080,1048,14,32,"PCTG",4
15,"15040",2675,2011,1979,20,32,"PCTG",2
32,"32070",512,307,304,8,3,"PCTG",0
32,"32034",1074,855,846,1,9,"PCTG",2
15,"15067",7953,6004,5925,51,79,"PCTG",7
36,"36056",4961,3719,3635,30,84,"PCTG",5
27,"27037",1017,759,748,10,11,"PCTG",1
15,"15002",24007,18075,17857,216,218,"PCTG",15
32,"32030",944,690,685,7,5,"PCTG",0
27,"27032",3194,2268,2223,20,45,"PCTG",0
15,"15021",5244,3884,3806,70,78,"PCTG",3
36,"36902",5052,3813,3724,21,89,"PCTG",4
36,"36055",13551,9908,9682,105,226,"PCTG",11
15,"15088",3415,2349,2323,28,26,"PCTG",1
15,"15006",5169,3527,3436,32,91,"PCTG",1
32,"32024",4835,3484,3439,23,45,"PCTG",6
27,"27023",2470,1833,1797,20,36,"PCTG",0
15,"15071",7805,5476,5401,62,75,"PCTG",7
32,"32062",766,582,579,1,3,"PCTG",0
27,"27054",1145,907,890,5,17,"PCTG",0
27,"27066",12633,9139,8911,84,228,"PCTG",11
36,"36033",12244,9553,9358,80,195,"PCTG",14
32,"32053",1363,1114,1098,14,16,"PCTG",0
15,"15082",15381,11803,11642,133,161,"PCTG",8
27,"27064",1503,1078,1039,12,39,"PCTG",0
32,"32009",10590,7661,7574,68,87,"PCTG",6
36,"36027",4380,3262,3206,26,56,"PCTG",3
27,"27014",3162,2181,2139,17,42,"PCTG",0
27,"27057",11097,7917,7735,88,182,"PCTG",9
36,"36052",7234,5292,5151,44,141,"PCTG",7
32,"32082",1178,880,872,12,8,"PCTG",1
32,"32035",1370,881,872,5,9,"PCTG",0
32,"32023",1132,867,862,7,5,"PCTG",0
27,"27019",8189,6148,6039,94,109,"PCTG",7
36,"36018",3073,2184,2144,9,40,"PCTG",1
32,"32027",1000,762,747,5,15,"PCTG",1
27,"27042",1648,1247,1233,21,14,"PCTG",0
32,"32063",1819,1313,1287,6,26,"PCTG",0
32,"32006",1434,1033,1019,8,14,"PCTG",0
15,"15084",3059,2236,2217,20,19,"PCTG",2
32,"32074",993,737,734,4,3,"PCTG",0
36,"36006",11468,8959,8782,66,177,"PCTG",13
32,"32060",765,577,567,2,10,"PCTG",0
15,"15020",3593,2491,2469,18,22,"PCTG",0
32,"32089",1220,872,857,15,15,"PCTG",0
27,"27003",1772,1271,1241,6,30,"PCTG",0
36,"36043",4682,3345,3303,17,42,"PCTG",4
27,"27028",78798,58316,57546,629,770,"PCTG",189
32,"32084",902,636,631,2,5,"PCTG",2
15,"15050",1748,1038,1027,15,11,"PCTG",1
32,"32086",2563,1699,1686,19,13,"PCTG",1
36,"36007",1618,1163,1133,7,30,"PCTG",0
36,"36040",2517,1895,1853,18,42,"PCTG",0
32,"32002",2022,1510,1485,8,25,"PCTG",0
32,"32007",1412,1011,1001,9,10,"PCTG",0
15,"15001",4689,3422,3362,52,60,"PCTG",7
36,"36046",4043,3157,3084,27,73,"PCTG",2
36,"36048",5244,3859,3786,33,73,"PCTG",5
27,"27061",1016,784,763,9,21,"PCTG",1
27,"27013",3684,2997,2935,26,62,"PCTG",4
36,"36059",4663,3196,3115,31,81,"PCTG",7
32,"32037",681,534,523,6,11,"PCTG",0
15,"15086",2785,2015,1987,14,28,"PCTG",1
27,"27002",1546,1136,1103,9,33,"PCTG",0
15,"15058",28606,22203,22022,261,181,"PCTG",17
15,"15019",26006,18323,18075,280,248,"PCTG",17
36,"36015",4076,2903,2834,37,69,"PCTG",2
36,"36035",14571,11096,10917,105,179,"PCTG",5
13,"13901",864,687,673,1,14,"PDSJE-UDEC",0
13,"13049",747,566,553,4,13,"PDSJE-UDEC",0
13,"13046",693,558,547,0,11,"PDSJE-UDEC",4
13,"13027",3223,2343,2309,22,34,"PDSJE-UDEC",0
13,"13019",5095,3758,3717,25,41,"PDSJE-UDEC",1
13,"13072",729,542,531,3,11,"PDSJE-UDEC",1
13,"13041",249,179,171,2,8,"PDSJE-UDEC",0
13,"13084",841,683,673,6,10,"PDSJE-UDEC",1
13,"13086",162,139,136,1,3,"PDSJE-UDEC",0
13,"13073",497,394,390,1,4,"PDSJE-UDEC",0
13,"13015",5226,4010,3959,20,51,"PDSJE-UDEC",4
13,"13085",2287,1911,1885,13,26,"PDSJE-UDEC",2
13,"13071",38130,27060,26802,237,258,"PDSJE-UDEC",27
13,"13007",1233,1005,967,11,38,"PDSJE-UDEC",0
13,"13079",12265,9441,9218,123,223,"PDSJE-UDEC",1
13,"13033",1560,1278,1262,9,16,"PDSJE-UDEC",1
13,"13013",7050,5475,5371,39,104,"PDSJE-UDEC",7
13,"13088",589,439,429,1,10,"PDSJE-UDEC",0
13,"13047",5780,4553,4461,32,92,"PDSJE-UDEC",2
13,"13043",209,167,167,1,0,"PDSJE-UDEC",0
13,"13064",1836,1455,1446,18,9,"PDSJE-UDEC",1
13,"13036",766,626,617,0,9,"PDSJE-UDEC",0
13,"13074",944,826,813,1,13,"PDSJE-UDEC",0
13,"13052",6313,4844,4762,38,82,"PDSJE-UDEC",3
13,"13014",481,400,395,1,5,"PDSJE-UDEC",1
13,"13060",272,219,214,4,5,"PDSJE-UDEC",0
13,"13094",290,227,227,1,0,"PDSJE-UDEC",0
13,"13058",4050,3188,3128,24,60,"PDSJE-UDEC",1
13,"13022",332,264,256,1,8,"PDSJE-UDEC",0
13,"13051",336,272,271,1,1,"PDSJE-UDEC",0
13,"13082",25882,17928,17721,101,207,"PDSJE-UDEC",23
13,"13083",2392,1772,1714,13,58,"PDSJE-UDEC",0
13,"13020",4729,3461,3416,34,45,"PDSJE-UDEC",8
13,"13078",8936,6820,6733,46,87,"PDSJE-UDEC",3
13,"13008",427,304,302,0,2,"PDSJE-UDEC",1
13,"13068",1037,802,783,2,19,"PDSJE-UDEC",1
13,"13003",449,346,343,0,3,"PDSJE-UDEC",0
13,"13040",841,690,666,2,24,"PDSJE-UDEC",2
13,"13059",196,169,168,0,1,"PDSJE-UDEC",0
13,"13090",1023,814,796,5,18,"PDSJE-UDEC",0
13,"13021",417,343,343,0,0,"PDSJE-UDEC",0
13,"13080",321,246,246,1,0,"PDSJE-UDEC",0
13,"13039",14212,10929,10761,107,168,"PDSJE-UDEC",11
13,"13023",8950,6359,6271,76,88,"PDSJE-UDEC",4
13,"13030",120,97,96,0,1,"PDSJE-UDEC",0
13,"13009",1397,1145,1123,4,22,"PDSJE-UDEC",0
13,"13042",888,699,686,2,13,"PDSJE-UDEC",0
13,"13038",1604,1251,1216,14,35,"PDSJE-UDEC",0
13,"13028",10273,8434,8273,42,161,"PDSJE-UDEC",3
13,"13016",661,508,495,2,13,"PDSJE-UDEC",0
13,"13075",199,157,157,0,0,"PDSJE-UDEC",10
13,"13056",11657,9236,9142,85,94,"PDSJE-UDEC",10
13,"13012",382,279,277,2,2,"PDSJE-UDEC",0
13,"13010",881,680,666,4,14,"PDSJE-UDEC",0
13,"13025",296,260,256,1,4,"PDSJE-UDEC",0
13,"13045",616,482,479,4,3,"PDSJE-UDEC",1
13,"13903",493,412,406,1,6,"PDSJE-UDEC",0
13,"13070",766,620,604,6,16,"PDSJE-UDEC",0
13,"13034",58768,46017,45585,385,432,"PDSJE-UDEC",49
13,"13031",2471,2044,2020,15,24,"PDSJE-UDEC",0
13,"13053",14075,10930,10798,98,132,"PDSJE-UDEC",18
13,"13089",1609,1336,1299,10,37,"PDSJE-UDEC",1
13,"13017",247,189,188,2,1,"PDSJE-UDEC",0
13,"13097",2205,1764,1742,6,22,"PDSJE-UDEC",0
13,"13004",996,769,763,3,6,"PDSJE-UDEC",1
13,"13002",1419,1021,995,5,26,"PDSJE-UDEC",1
13,"13095",72,60,60,1,0,"PDSJE-UDEC",0
13,"13087",23207,17321,17032,202,289,"PDSJE-UDEC",25
13,"13902",449,362,360,2,2,"PDSJE-UDEC",0
13,"13024",891,636,628,2,8,"PDSJE-UDEC",0
13,"13063",3652,2692,2649,32,43,"PDSJE-UDEC",5
13,"13067",342,298,295,0,3,"PDSJE-UDEC",0
13,"13904",504,394,376,6,18,"PDSJE-UDEC",1
13,"13011",4506,3111,3044,29,67,"PDSJE-UDEC",5
13,"13055",615,475,465,5,10,"PDSJE-UDEC",0
13,"13098",1983,1537,1485,22,52,"PDSJE-UDEC",0
13,"13065",2813,1993,1971,13,22,"PDSJE-UDEC",2
13,"13005",23187,18379,18119,174,260,"PDSJE-UDEC",11
13,"13018",766,644,634,0,10,"PDSJE-UDEC",0
13,"13066",2604,2182,2146,6,36,"PDSJE-UDEC",1
13,"13092",1715,1434,1425,1,9,"PDSJE-UDEC",0
13,"13076",461,377,369,0,8,"PDSJE-UDEC",0
13,"13061",5639,4119,4071,56,48,"PDSJE-UDEC",7
13,"13091",544,485,476,4,9,"PDSJE-UDEC",0
13,"13026",415,342,340,1,2,"PDSJE-UDEC",0
13,"13050",479,399,394,2,5,"PDSJE-UDEC",0
13,"13069",618,488,469,3,19,"PDSJE-UDEC",0
13,"13001",1195,947,943,5,4,"PDSJE-UDEC",1
13,"13006",572,437,430,5,7,"PDSJE-UDEC",1
13,"13054",4914,3946,3890,31,56,"PDSJE-UDEC",1
13,"13057",1105,934,919,3,15,"PDSJE-UDEC",0
13,"13096",7533,5766,5696,43,70,"PDSJE-UDEC",2
13,"13044",2569,1984,1951,12,33,"PDSJE-UDEC",3
13,"13029",90,77,77,0,0,"PDSJE-UDEC",1
13,"13093",3930,2960,2906,34,54,"PDSJE-UDEC",1
13,"13032",1084,842,831,9,11,"PDSJE-UDEC",0
13,"13048",506,388,384,3,4,"PDSJE-UDEC",0
13,"13081",590,449,440,0,9,"PDSJE-UDEC",0
13,"13035",955,739,720,6,19,"PDSJE-UDEC",0
13,"13077",3399,2447,2380,30,67,"PDSJE-UDEC",4
13,"13062",559,478,471,1,7,"PDSJE-UDEC",0
13,"13037",790,633,620,3,13,"PDSJE-UDEC",1
33,"33030",873,678,671,1,7,"PH",0
28,"28009",14500,11656,11564,62,92,"PH",12
28,"28056",914,715,703,4,12,"PH",0
33,"33060",14132,9960,9794,135,166,"PH",8
28,"28131",13432,10500,10387,81,113,"PH",15
35,"35015",10728,6233,6108,54,125,"PH",10
28,"28089",3842,3087,3048,12,39,"PH",2
28,"28072",6088,5001,4961,23,40,"PH",3
28,"28055",907,671,666,5,5,"PH",1
28,"28084",16103,12519,12378,82,141,"PH",6
28,"28110",2003,1596,1571,7,25,"PH",1
35,"35012",10765,6327,6270,32,57,"PH",6
28,"28059",4515,3573,3542,12,31,"PH",3
33,"33036",11335,8356,8243,92,113,"PH",5
35,"35018",13056,8699,8618,73,81,"PH",9
28,"28097",125,100,100,0,0,"PH",0
33,"33001",1504,875,864,15,11,"PH",0
35,"35019",32841,21136,20850,125,286,"PH",14
33,"33074",3376,2345,2311,41,34,"PH",4
28,"28147",990,779,769,2,10,"PH",0
28,"28100",4409,3425,3382,20,43,"PH",6
33,"33024",225188,169937,168490,1483,1447,"PH",127
28,"28107",442,336,325,3,11,"PH",0
33,"33020",13000,9476,9338,108,138,"PH",7
28,"28115",62352,53136,52912,268,224,"PH",27
33,"33003",612,373,369,6,4,"PH",1
28,"28029",562,459,456,2,3,"PH",1
33,"33008",1705,1285,1273,9,12,"PH",1
28,"28025",404,314,305,3,9,"PH",0
28,"28046",4776,3944,3912,22,32,"PH",2
28,"28094",959,736,729,6,7,"PH",1
28,"28082",6063,4939,4889,46,50,"PH",3
28,"28122",570,457,448,3,9,"PH",1
35,"35002",24129,16979,16736,116,243,"PH",18
28,"28050",4367,3411,3384,14,27,"PH",2
28,"28015",20440,17084,16953,103,131,"PH",13
28,"28160",8629,6922,6856,34,66,"PH",6
28,"28164",3202,2553,2530,19,23,"PH",2
28,"28106",78429,59182,58471,417,711,"PH",86
28,"28021",576,387,386,3,1,"PH",0
28,"28040",16648,11709,11551,66,158,"PH",15
33,"33028",1158,635,630,6,5,"PH",0
35,"35034",8396,4599,4546,55,53,"PH",4
28,"28073",12751,9940,9838,63,102,"PH",9
35,"35020",5933,4140,4088,14,52,"PH",2
28,"28168",1329,976,969,3,7,"PH",0
33,"33006",1480,1001,992,9,9,"PH",1
33,"33010",1724,1211,1202,15,9,"PH",1
33,"33011",10659,6448,6332,119,116,"PH",2
28,"28051",1640,1301,1292,9,9,"PH",1
28,"28114",143,104,104,0,0,"PH",0
33,"33013",429,320,316,1,4,"PH",1
33,"33077",1118,772,761,4,11,"PH",0
28,"28087",3259,2643,2623,16,20,"PH",0
28,"28132",12068,9067,8954,63,113,"PH",6
28,"28125",3216,2459,2444,11,15,"PH",1
33,"33067",747,608,596,9,12,"PH",0
33,"33078",126,87,85,0,2,"PH",0
33,"33038",2234,1669,1644,16,25,"PH",2
33,"33075",253,139,135,1,4,"PH",0
28,"28151",3251,2483,2450,11,33,"PH",3
28,"28085",4141,3337,3296,13,41,"PH",3
28,"28092",153428,121511,120211,807,1300,"PH",131
28,"28088",286,193,193,2,0,"PH",0
33,"33057",1538,1129,1097,14,32,"PH",2
35,"35030",9949,6611,6462,65,149,"PH",5
28,"28180",5317,4266,4222,26,44,"PH",9
28,"28057",1549,1246,1239,5,7,"PH",1
35,"35025",1773,1247,1235,9,12,"PH",2
28,"28070",113,94,94,2,0,"PH",0
35,"35007",518,405,401,0,4,"PH",0
28,"28061",22564,18245,18064,117,181,"PH",16
33,"33016",18904,14376,14235,168,141,"PH",7
33,"33043",658,462,455,4,7,"PH",0
28,"28116",759,621,618,7,3,"PH",0
33,"33065",1084,761,746,18,15,"PH",2
28,"28170",2487,1840,1810,10,30,"PH",0
28,"28027",1200,920,906,4,14,"PH",1
28,"28069",56,47,45,2,2,"PH",0
28,"28063",254,203,202,2,1,"PH",0
33,"33023",3271,2448,2397,35,51,"PH",4
28,"28042",1266,1020,1010,2,10,"PH",1
28,"28183",1124,857,842,4,15,"PH",0
35,"35014",11908,7101,6947,63,154,"PH",6
28,"28062",288,243,236,0,7,"PH",0
28,"28127",66441,56199,55932,327,267,"PH",40
28,"28045",35264,27864,27597,180,267,"PH",30
28,"28067",4361,3548,3509,14,39,"PH",5
33,"33072",1455,973,963,14,10,"PH",0
28,"28008",1961,1477,1456,6,21,"PH",0
33,"33045",4382,3214,3156,23,58,"PH",1
28,"28079",2374366,1872679,1859094,11998,13585,"PH",1626
35,"35027",10499,7651,7530,57,121,"PH",8
33,"33048",136,87,87,1,0,"PH",0
28,"28026",6703,5422,5367,21,55,"PH",2
33,"33041",7112,5251,5194,63,57,"PH",2
33,"33007",1398,960,951,9,9,"PH",2
33,"33054",1611,1145,1124,8,21,"PH",0
28,"28006",80622,64905,64483,400,422,"PH",60
33,"33052",704,520,513,5,7,"PH",0
33,"33039",1641,1251,1243,6,8,"PH",0
35,"35023",11694,8785,8607,67,178,"PH",7
28,"28124",59,52,52,0,0,"PH",0
28,"28134",63352,51185,50776,336,409,"PH",49
28,"28171",4382,3202,3134,11,68,"PH",1
33,"33049",6044,4152,4079,56,73,"PH",4
28,"28140",3139,2547,2523,12,24,"PH",3
33,"33009",869,595,591,5,4,"PH",0
28,"28155",485,414,409,0,5,"PH",0
28,"28169",1553,1280,1273,15,7,"PH",1
28,"28101",229,183,182,2,1,"PH",0
28,"28093",2142,1751,1728,9,23,"PH",2
33,"33076",12147,8532,8452,104,80,"PH",7
28,"28156",1084,885,880,6,5,"PH",0
28,"28109",1622,1205,1192,3,13,"PH",2
33,"33046",483,370,367,6,3,"PH",0
33,"33050",558,381,375,2,6,"PH",0
33,"33033",9439,6565,6468,78,97,"PH",3
28,"28048",504,399,392,6,7,"PH",0
35,"35021",15014,10909,10792,71,117,"PH",9
28,"28146",1792,1308,1293,8,15,"PH",0
33,"33037",33247,23529,23210,297,319,"PH",16
28,"28173",519,417,412,4,5,"PH",0
28,"28014",34047,26858,26575,178,283,"PH",20
35,"35026",82764,55647,54846,499,801,"PH",53
33,"33058",1664,1205,1176,5,29,"PH",3
33,"33031",33854,23523,23143,307,380,"PH",28
33,"33061",350,201,200,2,1,"PH",0
28,"28035",1394,1057,1043,3,14,"PH",1
28,"28121",205,166,165,1,1,"PH",2
28,"28060",1565,1262,1247,5,15,"PH",0
28,"28138",63,49,49,0,0,"PH",0
28,"28016",78,62,61,1,1,"PH",0
28,"28019",1269,990,981,4,9,"PH",0
28,"28167",8608,7086,7015,48,71,"PH",14
28,"28039",125,103,103,2,0,"PH",0
28,"28150",3187,2640,2604,20,36,"PH",5
28,"28074",140580,113723,112489,776,1234,"PH",126
28,"28162",2771,2264,2243,6,21,"PH",2
28,"28083",9665,7794,7737,56,57,"PH",10
28,"28041",4788,4012,3973,23,39,"PH",2
28,"28066",7515,6105,6039,40,66,"PH",3
33,"33035",11226,8326,8252,112,74,"PH",6
28,"28037",1578,1196,1180,5,16,"PH",0
28,"28119",2245,1839,1821,10,18,"PH",4
33,"33015",1428,1003,993,7,10,"PH",0
33,"33018",2819,2072,2044,28,28,"PH",4
35,"35004",41728,23957,23683,219,274,"PH",27
28,"28902",523,418,415,2,3,"PH",1
28,"28096",19809,15584,15392,118,192,"PH",15
28,"28137",1744,1385,1366,8,19,"PH",3
28,"28117",98,89,87,2,2,"PH",0
28,"28058",141251,112674,111423,778,1251,"PH",131
35,"35008",6207,4733,4654,42,79,"PH",2
28,"28011",420,315,311,1,4,"PH",0
28,"28031",2140,1642,1614,11,28,"PH",0
28,"28038",5155,4142,4090,20,52,"PH",0
33,"33040",4566,3205,3150,50,55,"PH",0
28,"28163",429,361,345,4,16,"PH",1
28,"28022",36550,31559,31436,207,123,"PH",18
28,"28001",80,64,64,0,0,"PH",0
35,"35011",24705,17099,16823,129,276,"PH",16
28,"28002",3281,2481,2455,24,26,"PH",2
35,"35016",300503,203470,201240,1598,2230,"PH",237
28,"28118",61,52,51,0,1,"PH",0
28,"28901",868,653,639,6,14,"PH",0
28,"28052",3949,2890,2818,8,72,"PH",2
28,"28144",6423,5274,5222,35,52,"PH",3
33,"33071",563,413,407,2,6,"PH",0
35,"35006",31309,23434,23019,221,415,"PH",36
28,"28080",49801,41938,41705,248,233,"PH",29
35,"35031",7412,5593,5519,41,74,"PH",11
28,"28099",1923,1490,1475,7,15,"PH",1
28,"28181",20669,17314,17205,101,109,"PH",10
28,"28012",918,727,711,6,16,"PH",0
28,"28159",594,493,491,5,2,"PH",0
28,"28024",168,146,145,1,1,"PH",0
33,"33066",42882,30942,30529,401,413,"PH",21
28,"28126",47,35,35,0,0,"PH",0
28,"28158",678,547,540,1,7,"PH",0
28,"28148",88647,70218,69546,570,672,"PH",96
28,"28007",126831,103108,102202,710,906,"PH",76
35,"35013",6584,5067,4974,49,93,"PH",1
28,"28003",170,148,148,1,0,"PH",0
33,"33056",4877,3469,3420,30,49,"PH",6
33,"33073",8186,5090,5023,65,67,"PH",3
33,"33032",11086,8028,7849,129,179,"PH",5
33,"33027",769,505,497,14,8,"PH",0
28,"28068",11554,9122,9022,44,100,"PH",11
33,"33026",8270,5540,5474,69,66,"PH",3
35,"35029",4357,2869,2832,32,37,"PH",1
33,"33029",323,172,170,2,2,"PH",0
28,"28130",28508,23566,23305,179,261,"PH",24
28,"28065",130679,106997,105975,762,1022,"PH",89
28,"28141",6246,4943,4890,44,53,"PH",7
35,"35005",1017,751,743,1,8,"PH",0
28,"28113",36716,29939,29607,224,332,"PH",21
28,"28032",5042,4039,3992,23,47,"PH",1
35,"35033",6403,4565,4502,34,63,"PH",6
28,"28071",64,56,54,0,2,"PH",0
28,"28182",198,169,169,1,0,"PH",0
33,"33053",1079,738,729,6,9,"PH",1
28,"28179",1450,1115,1100,3,15,"PH",1
28,"28153",795,566,564,5,2,"PH",0
33,"33044",177352,134444,133352,1391,1092,"PH",102
33,"33014",8771,6425,6368,51,57,"PH",2
28,"28135",985,762,756,1,6,"PH",0
28,"28076",425,354,349,3,5,"PH",1
28,"28177",10722,9093,9029,64,64,"PH",8
28,"28075",5952,4797,4758,25,39,"PH",6
33,"33017",2997,2096,2058,29,38,"PH",2
28,"28054",11891,9476,9395,64,81,"PH",5
28,"28047",42847,33561,33215,216,346,"PH",35
28,"28123",61103,52177,51832,338,345,"PH",38
28,"28013",41563,32024,31693,194,331,"PH",24
35,"35022",51302,33009,32566,198,443,"PH",22
28,"28033",4082,3172,3140,13,32,"PH",3
28,"28175",935,775,767,3,8,"PH",0
33,"33042",4243,3137,3103,36,34,"PH",3
28,"28086",5390,3992,3936,26,56,"PH",9
28,"28034",370,284,280,0,4,"PH",0
28,"28108",3642,2878,2841,16,37,"PH",5
33,"33069",3419,2557,2533,32,24,"PH",1
28,"28010",10538,8708,8635,54,73,"PH",7
35,"35028",10044,6188,6105,52,83,"PH",4
28,"28017",1280,1017,1012,9,5,"PH",1
28,"28044",6193,5040,4991,31,49,"PH",2
35,"35017",27216,17531,17102,133,429,"PH",14
28,"28028",1820,1493,1483,8,10,"PH",0
28,"28903",35344,30490,30287,201,203,"PH",22
33,"33063",374,284,283,3,1,"PH",0
28,"28176",13836,11415,11326,64,89,"PH",8
33,"33002",9474,6779,6662,74,117,"PH",2
33,"33068",1047,624,620,8,4,"PH",0
28,"28104",15318,12897,12797,87,100,"PH",11
28,"28136",680,569,563,0,6,"PH",0
28,"28005",136050,108267,107316,772,951,"PH",109
33,"33012",5105,3601,3566,46,35,"PH",4
28,"28020",169,110,109,0,1,"PH",0
28,"28023",5090,4252,4212,31,40,"PH",2
28,"28043",6166,4404,4320,30,84,"PH",2
28,"28078",40,37,37,0,0,"PH",0
28,"28036",2675,2135,2093,17,42,"PH",3
33,"33025",8996,6369,6309,81,60,"PH",3
28,"28128",445,352,352,2,0,"PH",1
33,"33047",1074,841,835,12,6,"PH",0
35,"35032",3348,2585,2542,20,43,"PH",2
28,"28095",1677,1310,1293,4,17,"PH",1
28,"28172",9751,7994,7928,38,66,"PH",11
28,"28178",1134,949,935,1,14,"PH",1
28,"28154",5525,4283,4222,24,61,"PH",5
33,"33021",4361,3098,3043,31,55,"PH",5
28,"28112",154,137,137,1,0,"PH",0
28,"28064",135,110,104,1,6,"PH",0
28,"28174",1840,1363,1349,10,14,"PH",1
33,"33034",10043,6765,6671,69,94,"PH",5
33,"33070",3293,2499,2473,32,26,"PH",2
28,"28090",9128,7590,7516,54,74,"PH",2
33,"33062",388,250,245,9,5,"PH",1
28,"28149",6172,5089,5038,31,51,"PH",5
33,"33019",2882,1981,1939,8,42,"PH",0
28,"28152",16839,14205,14151,87,54,"PH",5
33,"33022",813,555,543,6,12,"PH",0
33,"33051",6811,4879,4809,63,70,"PH",3
28,"28157",682,530,516,1,14,"PH",0
28,"28053",6840,5797,5739,32,58,"PH",6
33,"33059",4403,3007,2942,42,65,"PH",3
33,"33004",65515,48686,48245,511,441,"PH",36
35,"35001",4571,3523,3463,8,60,"PH",1
28,"28129",8578,6925,6853,45,72,"PH",3
33,"33064",250,175,174,0,1,"PH",0
28,"28049",57902,47976,47561,329,415,"PH",49
28,"28102",891,681,666,4,15,"PH",0
28,"28165",1910,1443,1430,11,13,"PH",3
35,"35009",20109,15017,14803,78,214,"PH",10
28,"28091",5474,4027,3977,26,50,"PH",5
33,"33005",1376,929,916,14,13,"PH",0
33,"33055",1492,1156,1121,6,35,"PH",1
28,"28120",1209,991,974,3,17,"PH",0
35,"35010",3797,2601,2572,9,29,"PH",2
28,"28166",347,287,286,1,1,"PH",0
28,"28018",4068,3367,3344,15,23,"PH",1
28,"28030",1815,1438,1395,10,43,"PH",0
28,"28145",2640,2014,1987,11,27,"PH",5
28,"28111",622,492,487,1,5,"PH",1
35,"35024",14243,9496,9394,65,102,"PH",7
28,"28133",6116,4581,4486,22,95,"PH",2
28,"28143",77,62,62,0,0,"PH",0
28,"28161",51559,41390,40922,255,468,"PH",57
28,"28004",6564,4798,4767,26,31,"PH",2
35,"35003",5582,3441,3391,26,50,"PH",3
39,"39048",1765,1429,1420,4,9,"P-LIB",1
16,"16225",59,40,40,0,0,"P-LIB",0
16,"16091",64,46,46,1,0,"P-LIB",0
16,"16212",230,198,196,2,2,"P-LIB",0
16,"16043",88,71,71,1,0,"P-LIB",0
16,"16030",22,19,19,1,0,"P-LIB",0
3,"3064",5004,3782,3736,20,46,"P-LIB",5
16,"16142",120,95,95,0,0,"P-LIB",0
3,"3085",269,243,237,0,6,"P-LIB",0
16,"16046",223,162,161,1,1,"P-LIB",0
39,"39077",236,175,173,0,2,"P-LIB",0
16,"16231",50,40,40,0,0,"P-LIB",0
16,"16025",25,21,21,0,0,"P-LIB",0
3,"3101",4911,3827,3772,20,55,"P-LIB",4
39,"39055",1075,836,829,8,7,"P-LIB",1
3,"3068",42,40,40,3,0,"P-LIB",0
39,"39021",467,392,385,2,7,"P-LIB",0
39,"39029",636,512,512,5,0,"P-LIB",0
16,"16195",458,368,364,3,4,"P-LIB",0
3,"3044",4557,3650,3600,17,50,"P-LIB",2
16,"16177",82,64,63,0,1,"P-LIB",0
16,"16128",51,44,44,0,0,"P-LIB",0
39,"39035",9169,7135,7045,40,90,"P-LIB",2
16,"16002",195,166,164,1,2,"P-LIB",0
39,"39085",6964,5489,5445,28,44,"P-LIB",0
16,"16064",651,575,569,4,6,"P-LIB",0
39,"39075",136968,104358,103487,690,871,"P-LIB",49
16,"16149",154,130,130,2,0,"P-LIB",0
16,"16249",1938,1544,1529,13,15,"P-LIB",0
16,"16272",199,162,161,1,1,"P-LIB",0
3,"3129",1218,994,982,5,12,"P-LIB",1
16,"16100",640,570,565,1,5,"P-LIB",0
16,"16240",100,77,76,0,1,"P-LIB",0
3,"3079",18403,14632,14382,114,250,"P-LIB",25
39,"39008",13900,10895,10767,81,128,"P-LIB",9
39,"39052",18957,15123,14985,106,138,"P-LIB",2
39,"39023",6523,5205,5144,22,61,"P-LIB",0
16,"16273",303,236,231,2,5,"P-LIB",1
3,"3119",17223,13244,13116,75,128,"P-LIB",7
3,"3081",1494,1163,1141,5,22,"P-LIB",0
16,"16125",1599,1314,1295,9,19,"P-LIB",0
16,"16122",249,197,196,3,1,"P-LIB",0
16,"16126",729,622,616,5,6,"P-LIB",0
16,"16027",701,540,531,2,9,"P-LIB",0
16,"16061",941,790,763,8,27,"P-LIB",1
16,"16173",190,141,141,0,0,"P-LIB",0
16,"16264",390,338,328,2,10,"P-LIB",0
3,"3031",41857,28648,28362,163,286,"P-LIB",28
39,"39080",3505,2735,2701,8,34,"P-LIB",0
3,"3076",8736,6571,6467,40,104,"P-LIB",1
16,"16124",1826,1482,1455,6,27,"P-LIB",0
39,"39101",236,173,171,1,2,"P-LIB",0
16,"16217",94,77,77,0,0,"P-LIB",0
16,"16109",41,33,33,3,0,"P-LIB",0
16,"16082",271,207,206,3,1,"P-LIB",0
16,"16015",351,251,250,4,1,"P-LIB",0
16,"16066",2298,1932,1885,17,47,"P-LIB",2
16,"16051",126,102,100,0,2,"P-LIB",0
3,"3106",564,485,479,4,6,"P-LIB",0
16,"16116",77,59,59,0,0,"P-LIB",0
16,"16029",102,81,81,1,0,"P-LIB",0
16,"16055",679,478,477,4,1,"P-LIB",0
16,"16060",722,571,560,3,11,"P-LIB",1
3,"3089",9497,6952,6794,55,158,"P-LIB",4
16,"16048",409,331,330,1,1,"P-LIB",0
3,"3063",27121,19869,19713,131,156,"P-LIB",19
16,"16106",2708,2200,2163,17,37,"P-LIB",0
16,"16165",55,49,48,1,1,"P-LIB",0
16,"16188",77,56,56,0,0,"P-LIB",0
3,"3036",86,77,75,2,2,"P-LIB",0
3,"3130",43,23,23,0,0,"P-LIB",0
39,"39070",123,101,99,0,2,"P-LIB",0
16,"16063",113,86,83,0,3,"P-LIB",0
16,"16056",453,323,321,1,2,"P-LIB",0
16,"16155",488,411,408,3,3,"P-LIB",0
3,"3048",4971,3808,3739,19,69,"P-LIB",4
39,"39056",2268,1847,1830,7,17,"P-LIB",1
16,"16006",110,99,98,1,1,"P-LIB",0
16,"16253",308,250,249,2,1,"P-LIB",0
16,"16145",425,362,357,8,5,"P-LIB",0
16,"16089",377,308,308,1,0,"P-LIB",0
16,"16085",135,109,109,1,0,"P-LIB",0
16,"16023",507,401,398,2,3,"P-LIB",2
16,"16121",233,183,179,0,4,"P-LIB",2
16,"16158",511,428,417,4,11,"P-LIB",0
16,"16033",1644,1345,1320,11,25,"P-LIB",4
16,"16186",412,358,354,1,4,"P-LIB",0
39,"39091",1885,1512,1503,6,9,"P-LIB",0
3,"3072",348,297,295,2,2,"P-LIB",0
3,"3901",1109,827,820,5,7,"P-LIB",0
3,"3114",1581,1263,1237,9,26,"P-LIB",1
39,"39017",553,416,409,0,7,"P-LIB",0
16,"16191",858,707,701,8,6,"P-LIB",0
39,"39089",134,99,98,0,1,"P-LIB",0
39,"39030",1895,1374,1358,6,16,"P-LIB",2
3,"3055",5247,4042,3991,24,51,"P-LIB",4
16,"16202",741,573,568,4,5,"P-LIB",0
39,"39049",306,209,208,4,1,"P-LIB",0
3,"3061",1054,830,816,3,14,"P-LIB",0
3,"3103",245,212,211,4,1,"P-LIB",0
3,"3021",5578,4720,4626,35,94,"P-LIB",1
16,"16072",133,96,95,1,1,"P-LIB",0
16,"16147",56,32,32,0,0,"P-LIB",0
3,"3056",8629,6838,6737,38,101,"P-LIB",3
39,"39078",1406,1101,1090,7,11,"P-LIB",0
16,"16250",65,41,41,0,0,"P-LIB",0
16,"16001",64,51,51,0,0,"P-LIB",0
16,"16020",9,5,5,0,0,"P-LIB",0
16,"16084",50,36,32,0,4,"P-LIB",0
39,"39034",257,167,162,2,5,"P-LIB",0
16,"16228",176,150,150,1,0,"P-LIB",0
39,"39069",1928,1650,1627,9,23,"P-LIB",0
3,"3006",494,413,409,1,4,"P-LIB",0
3,"3047",9711,6910,6791,36,119,"P-LIB",6
39,"39102",2255,1711,1698,11,13,"P-LIB",2
16,"16152",32,28,28,1,0,"P-LIB",0
16,"16102",1163,951,943,16,8,"P-LIB",0
3,"3092",6688,5444,5370,36,74,"P-LIB",1
16,"16243",379,323,318,5,5,"P-LIB",0
16,"16041",339,271,267,2,4,"P-LIB",0
3,"3007",169,145,141,0,4,"P-LIB",0
16,"16205",107,80,79,0,1,"P-LIB",0
3,"3131",179,147,139,0,8,"P-LIB",0
16,"16167",292,235,229,1,6,"P-LIB",0
16,"16162",39,31,30,0,1,"P-LIB",0
16,"16049",144,111,108,1,3,"P-LIB",0
16,"16108",43,40,39,1,1,"P-LIB",0
39,"39041",1767,1437,1417,18,20,"P-LIB",0
16,"16067",119,96,93,2,3,"P-LIB",0
3,"3018",12439,9387,9283,50,104,"P-LIB",14
16,"16199",28,23,23,1,0,"P-LIB",0
16,"16095",81,69,68,1,1,"P-LIB",0
16,"16112",1468,1108,1096,6,12,"P-LIB",0
16,"16146",87,68,68,0,0,"P-LIB",0
3,"3118",2426,1741,1718,8,23,"P-LIB",2
3,"3100",496,402,395,2,7,"P-LIB",0
16,"16196",602,522,510,3,12,"P-LIB",1
16,"16070",28,26,26,1,0,"P-LIB",0
16,"16213",34,29,28,0,1,"P-LIB",0
39,"39006",1721,1332,1315,3,17,"P-LIB",0
39,"39007",393,300,298,1,2,"P-LIB",0
39,"39045",351,280,277,1,3,"P-LIB",0
39,"39009",3307,2545,2526,11,19,"P-LIB",0
16,"16193",58,51,51,2,0,"P-LIB",0
16,"16133",4387,3607,3544,38,63,"P-LIB",0
16,"16148",546,481,479,1,2,"P-LIB",0
16,"16209",111,97,97,0,0,"P-LIB",0
3,"3025",1292,1009,991,7,18,"P-LIB",0
3,"3097",996,833,816,4,17,"P-LIB",0
16,"16247",63,53,53,1,0,"P-LIB",0
16,"16166",239,176,174,3,2,"P-LIB",0
3,"3005",7903,6247,6195,37,52,"P-LIB",15
16,"16903",996,816,806,9,10,"P-LIB",0
16,"16153",936,786,768,7,18,"P-LIB",1
3,"3020",95,84,84,2,0,"P-LIB",0
3,"3904",1420,1112,1095,5,17,"P-LIB",2
16,"16111",163,125,122,1,3,"P-LIB",0
3,"3057",177,148,147,0,1,"P-LIB",0
16,"16140",19,16,16,0,0,"P-LIB",0
16,"16018",381,313,312,2,1,"P-LIB",0
16,"16014",563,444,443,4,1,"P-LIB",1
39,"39020",23931,17782,17566,126,216,"P-LIB",1
16,"16032",277,224,223,1,1,"P-LIB",0
16,"16073",188,159,155,0,4,"P-LIB",0
39,"39026",1720,1322,1312,5,10,"P-LIB",0
16,"16081",49,42,42,0,0,"P-LIB",0
39,"39064",1341,1103,1094,5,9,"P-LIB",0
16,"16131",127,90,90,1,0,"P-LIB",0
16,"16244",708,627,617,1,10,"P-LIB",0
16,"16019",185,147,147,0,0,"P-LIB",0
16,"16909",661,540,535,1,5,"P-LIB",0
39,"39061",3488,2833,2798,18,35,"P-LIB",1
39,"39058",800,574,573,1,1,"P-LIB",0
16,"16163",60,50,50,0,0,"P-LIB",0
39,"39033",540,430,423,1,7,"P-LIB",0
3,"3139",23061,16378,16178,128,200,"P-LIB",18
16,"16169",51,36,32,0,4,"P-LIB",0
3,"3004",599,465,458,4,7,"P-LIB",0
39,"39099",3149,2562,2540,22,22,"P-LIB",0
39,"39095",2240,1809,1778,12,31,"P-LIB",0
3,"3052",967,805,790,4,15,"P-LIB",1
39,"39093",302,256,256,2,0,"P-LIB",0
16,"16013",26,21,20,0,1,"P-LIB",0
3,"3026",1316,1040,1024,5,16,"P-LIB",0
39,"39068",649,515,509,7,6,"P-LIB",0
16,"16110",91,80,80,0,0,"P-LIB",0
16,"16270",156,124,124,1,0,"P-LIB",0
16,"16159",209,147,144,0,3,"P-LIB",0
16,"16115",47,35,35,0,0,"P-LIB",0
16,"16189",262,220,220,1,0,"P-LIB",1
39,"39071",422,318,316,0,2,"P-LIB",0
3,"3080",1328,1077,1064,4,13,"P-LIB",0
16,"16098",520,441,439,6,2,"P-LIB",0
16,"16185",35,29,29,0,0,"P-LIB",0
16,"16154",4752,3798,3732,37,66,"P-LIB",0
16,"16198",1299,1044,1027,11,17,"P-LIB",1
16,"16224",77,61,60,1,1,"P-LIB",0
16,"16275",12,12,12,0,0,"P-LIB",0
3,"3113",4342,3194,3154,23,40,"P-LIB",1
16,"16068",127,104,104,4,0,"P-LIB",0
16,"16251",1809,1469,1443,11,26,"P-LIB",0
16,"16216",278,243,240,0,3,"P-LIB",0
3,"3054",336,277,272,2,5,"P-LIB",0
39,"39001",2065,1669,1643,16,26,"P-LIB",0
3,"3067",93,87,87,0,0,"P-LIB",0
16,"16194",220,181,173,1,8,"P-LIB",0
39,"39088",59,51,51,0,0,"P-LIB",0
3,"3124",460,401,390,2,11,"P-LIB",0
3,"3024",3948,3210,3164,14,46,"P-LIB",0
16,"16007",1159,975,968,10,7,"P-LIB",0
39,"39086",362,273,268,1,5,"P-LIB",0
3,"3065",169399,128218,127256,967,962,"P-LIB",262
16,"16086",881,751,747,3,4,"P-LIB",0
3,"3038",335,275,267,1,8,"P-LIB",0
16,"16269",393,322,317,3,5,"P-LIB",0
16,"16151",64,52,52,0,0,"P-LIB",0
3,"3117",377,320,313,1,7,"P-LIB",1
16,"16042",1108,948,938,3,10,"P-LIB",0
39,"39011",1575,1249,1242,3,7,"P-LIB",0
3,"3078",474,372,371,2,1,"P-LIB",0
16,"16004",227,193,191,0,2,"P-LIB",0
39,"39050",255,188,184,2,4,"P-LIB",0
3,"3104",27091,21366,21119,250,247,"P-LIB",9
39,"39028",3870,3131,3094,19,37,"P-LIB",2
3,"3001",345,285,282,1,3,"P-LIB",0
3,"3115",255,222,221,2,1,"P-LIB",0
16,"16062",25,21,21,0,0,"P-LIB",0
16,"16078",41517,31810,31486,340,324,"P-LIB",23
3,"3094",9626,7206,7138,42,68,"P-LIB",4
39,"39016",23868,19029,18839,108,190,"P-LIB",5
39,"39043",1523,1246,1220,10,26,"P-LIB",0
16,"16218",187,149,148,2,1,"P-LIB",0
39,"39044",3868,3019,2985,8,34,"P-LIB",1
16,"16053",391,334,327,4,7,"P-LIB",1
16,"16190",4957,4006,3945,36,61,"P-LIB",2
16,"16172",349,278,275,3,3,"P-LIB",0
3,"3135",192,157,155,0,2,"P-LIB",0
16,"16040",85,72,72,1,0,"P-LIB",0
39,"39051",73,65,64,0,1,"P-LIB",0
3,"3077",1374,1131,1114,9,17,"P-LIB",1
16,"16094",120,89,88,0,1,"P-LIB",0
39,"39067",759,582,575,3,7,"P-LIB",0
39,"39032",1426,1156,1141,8,15,"P-LIB",0
39,"39060",6693,5459,5394,29,65,"P-LIB",4
3,"3073",222,200,196,3,4,"P-LIB",2
3,"3084",497,429,429,4,0,"P-LIB",0
16,"16279",174,125,125,0,0,"P-LIB",0
16,"16176",31,22,22,0,0,"P-LIB",0
16,"16074",28,23,23,0,0,"P-LIB",0
3,"3093",19713,15195,14988,108,207,"P-LIB",14
3,"3034",1391,1107,1090,7,17,"P-LIB",1
16,"16099",184,126,121,0,5,"P-LIB",0
39,"39002",3414,2630,2578,23,52,"P-LIB",1
39,"39039",546,431,428,0,3,"P-LIB",0
3,"3132",515,417,414,4,3,"P-LIB",3
3,"3075",149,125,125,0,0,"P-LIB",0
16,"16277",109,82,82,0,0,"P-LIB",0
39,"39076",3483,2770,2734,21,36,"P-LIB",3
3,"3111",5565,4183,4149,29,34,"P-LIB",3
3,"3045",213,178,173,4,5,"P-LIB",0
3,"3903",2577,1996,1973,11,23,"P-LIB",1
3,"3022",137,122,119,0,3,"P-LIB",0
39,"39084",874,718,712,4,6,"P-LIB",2
16,"16902",127,101,101,0,0,"P-LIB",0
16,"16237",98,83,83,0,0,"P-LIB",0
39,"39096",670,523,518,2,5,"P-LIB",0
39,"39003",258,205,202,3,3,"P-LIB",0
16,"16123",66,43,43,0,0,"P-LIB",0
16,"16012",77,65,65,0,0,"P-LIB",0
16,"16254",203,168,166,1,2,"P-LIB",0
39,"39100",849,650,644,9,6,"P-LIB",0
3,"3049",12143,9418,9302,47,116,"P-LIB",1
3,"3039",89,70,70,0,0,"P-LIB",0
16,"16026",93,70,68,1,2,"P-LIB",0
39,"39013",535,434,431,1,3,"P-LIB",0
39,"39042",5930,4722,4676,26,46,"P-LIB",1
39,"39097",679,437,435,2,2,"P-LIB",0
3,"3102",7226,5600,5516,28,84,"P-LIB",1
39,"39072",324,206,204,4,2,"P-LIB",0
39,"39081",437,356,347,2,9,"P-LIB",0
39,"39031",1245,990,983,5,7,"P-LIB",0
39,"39004",1483,1181,1163,4,18,"P-LIB",0
3,"3074",1750,1433,1427,3,6,"P-LIB",1
3,"3138",3183,2390,2359,16,31,"P-LIB",2
16,"16010",137,104,101,0,3,"P-LIB",1
16,"16079",26,17,17,0,0,"P-LIB",0
16,"16107",98,76,75,1,1,"P-LIB",0
3,"3060",106,84,84,0,0,"P-LIB",0
16,"16024",123,96,95,0,1,"P-LIB",0
3,"3128",4295,3007,2982,24,25,"P-LIB",8
3,"3041",6093,4444,4398,13,46,"P-LIB",9
16,"16038",28,21,21,0,0,"P-LIB",0
3,"3902",10578,7654,7530,56,124,"P-LIB",6
3,"3027",172,156,153,0,3,"P-LIB",1
39,"39014",901,709,704,5,5,"P-LIB",1
3,"3096",5779,4433,4352,30,81,"P-LIB",4
16,"16236",865,669,665,2,4,"P-LIB",0
16,"16901",630,498,492,4,6,"P-LIB",0
16,"16181",57,46,46,1,0,"P-LIB",0
16,"16245",400,329,318,0,11,"P-LIB",0
16,"16096",280,239,234,3,5,"P-LIB",0
16,"16035",238,190,188,0,2,"P-LIB",0
3,"3016",91,77,77,1,0,"P-LIB",0
3,"3012",1133,910,897,7,13,"P-LIB",0
16,"16008",83,65,65,0,0,"P-LIB",0
16,"16160",60,44,43,1,1,"P-LIB",0
3,"3083",5487,3993,3934,28,59,"P-LIB",6
39,"39083",1074,786,777,4,9,"P-LIB",0
16,"16071",20,18,18,0,0,"P-LIB",0
39,"39027",3066,2511,2467,15,44,"P-LIB",1
3,"3091",241,201,196,0,5,"P-LIB",1
16,"16017",340,281,271,2,10,"P-LIB",0
16,"16242",308,266,263,2,3,"P-LIB",0
16,"16058",97,73,73,0,0,"P-LIB",0
3,"3109",2976,2375,2345,11,30,"P-LIB",3
39,"39022",969,740,732,2,8,"P-LIB",0
16,"16204",241,198,196,1,2,"P-LIB",1
16,"16157",190,163,161,1,2,"P-LIB",0
3,"3098",518,412,400,1,12,"P-LIB",0
39,"39087",41381,32335,31995,194,340,"P-LIB",66
39,"39038",1506,1093,1076,2,17,"P-LIB",0
16,"16271",595,513,511,2,2,"P-LIB",0
16,"16134",4383,3544,3491,34,53,"P-LIB",1
3,"3037",341,289,284,1,5,"P-LIB",2
3,"3066",41802,31046,30696,285,350,"P-LIB",14
16,"16135",118,86,85,0,1,"P-LIB",0
16,"16265",20,20,19,0,1,"P-LIB",0
3,"3017",379,321,311,1,10,"P-LIB",0
39,"39082",1622,1261,1252,16,9,"P-LIB",1
16,"16259",27,22,21,0,1,"P-LIB",0
16,"16050",220,182,179,1,3,"P-LIB",0
3,"3120",2421,1823,1786,9,37,"P-LIB",0
39,"39010",610,518,512,1,6,"P-LIB",0
16,"16266",358,281,279,3,2,"P-LIB",0
16,"16904",451,386,383,3,3,"P-LIB",0
16,"16003",133,111,110,1,1,"P-LIB",0
16,"16910",78,54,54,1,0,"P-LIB",0
39,"39074",7041,5612,5551,31,61,"P-LIB",8
16,"16016",216,175,174,3,1,"P-LIB",1
39,"39036",971,794,787,5,7,"P-LIB",0
16,"16113",3067,2416,2383,15,33,"P-LIB",0
3,"3028",964,804,795,6,9,"P-LIB",0
39,"39037",2019,1572,1560,2,12,"P-LIB",3
3,"3035",632,529,525,2,4,"P-LIB",1
16,"16197",66,45,45,0,0,"P-LIB",0
3,"3086",166,143,143,1,0,"P-LIB",0
39,"39012",6737,5391,5314,52,77,"P-LIB",4
16,"16097",139,121,120,1,1,"P-LIB",0
16,"16052",537,429,429,2,0,"P-LIB",0
39,"39094",841,676,670,3,6,"P-LIB",0
39,"39053",213,146,145,2,1,"P-LIB",0
16,"16280",165,130,128,3,2,"P-LIB",0
3,"3008",159,127,126,0,1,"P-LIB",0
16,"16908",163,135,133,0,2,"P-LIB",1
3,"3088",5810,4380,4313,31,67,"P-LIB",1
16,"16045",185,142,141,0,1,"P-LIB",0
39,"39059",7577,5978,5916,47,62,"P-LIB",1
16,"16005",232,175,172,0,3,"P-LIB",0
3,"3050",19334,14377,14253,71,124,"P-LIB",8
16,"16258",172,128,128,2,0,"P-LIB",0
3,"3009",46121,36093,35720,235,373,"P-LIB",28
16,"16234",23,16,16,0,0,"P-LIB",0
16,"16047",214,175,174,4,1,"P-LIB",0
16,"16248",862,730,720,10,10,"P-LIB",0
16,"16011",23,18,18,0,0,"P-LIB",0
16,"16255",136,108,108,0,0,"P-LIB",0
16,"16211",322,233,229,0,4,"P-LIB",0
39,"39019",2229,1785,1751,15,34,"P-LIB",0
3,"3013",1070,882,869,3,13,"P-LIB",0
16,"16276",21,18,18,1,0,"P-LIB",0
39,"39073",10200,8230,8150,65,80,"P-LIB",1
16,"16141",130,105,105,0,0,"P-LIB",0
39,"39079",8861,6827,6745,47,82,"P-LIB",0
3,"3099",42876,32576,32172,192,404,"P-LIB",20
16,"16187",55,43,43,0,0,"P-LIB",0
3,"3053",7469,5950,5865,26,85,"P-LIB",4
3,"3071",3988,3125,3088,28,37,"P-LIB",6
16,"16227",108,85,85,1,0,"P-LIB",0
16,"16150",94,75,75,1,0,"P-LIB",0
16,"16170",653,514,500,3,14,"P-LIB",0
39,"39046",1343,1002,988,8,14,"P-LIB",0
16,"16905",1278,1028,1012,11,16,"P-LIB",0
39,"39018",4272,3533,3476,17,57,"P-LIB",1
39,"39024",1815,1436,1420,14,16,"P-LIB",0
3,"3032",99,87,87,0,0,"P-LIB",0
3,"3062",221,182,180,1,2,"P-LIB",1
16,"16246",452,348,340,1,8,"P-LIB",0
16,"16203",10167,7720,7591,49,129,"P-LIB",0
16,"16039",367,263,262,2,1,"P-LIB",0
3,"3033",102,87,85,0,2,"P-LIB",0
3,"3043",2899,2466,2434,21,32,"P-LIB",0
3,"3003",455,395,388,0,7,"P-LIB",0
16,"16174",168,143,141,1,2,"P-LIB",0
3,"3133",41499,26593,26308,151,285,"P-LIB",34
3,"3019",15465,12156,11988,80,168,"P-LIB",14
16,"16238",464,387,383,2,4,"P-LIB",0
3,"3030",563,474,466,2,8,"P-LIB",0
3,"3140",26027,19805,19438,230,367,"P-LIB",21
3,"3123",7576,5900,5814,36,86,"P-LIB",5
39,"39054",4528,3614,3575,23,39,"P-LIB",4
16,"16031",36,25,25,0,0,"P-LIB",0
3,"3002",3631,2841,2801,16,40,"P-LIB",1
3,"3011",8014,5870,5810,38,60,"P-LIB",6
16,"16036",122,98,97,1,1,"P-LIB",0
16,"16119",179,128,128,0,0,"P-LIB",0
3,"3023",1379,1216,1199,6,17,"P-LIB",2
39,"39066",877,711,705,5,6,"P-LIB",0
3,"3105",5471,4099,4003,14,96,"P-LIB",1
16,"16161",52,47,47,0,0,"P-LIB",0
16,"16118",1350,1126,1093,6,33,"P-LIB",1
3,"3058",4967,4031,3967,24,64,"P-LIB",5
3,"3107",2769,2011,1986,10,25,"P-LIB",1
39,"39098",1379,1154,1144,7,10,"P-LIB",0
3,"3110",312,271,269,1,2,"P-LIB",0
39,"39005",1406,1127,1110,12,17,"P-LIB",0
39,"39090",772,619,609,1,10,"P-LIB",0
16,"16263",966,763,755,2,8,"P-LIB",0
16,"16022",78,70,70,0,0,"P-LIB",0
3,"3116",1159,901,884,3,17,"P-LIB",0
39,"39057",2367,1831,1796,14,35,"P-LIB",0
3,"3051",344,312,307,2,5,"P-LIB",0
16,"16103",239,203,203,0,0,"P-LIB",0
16,"16057",64,53,53,0,0,"P-LIB",0
16,"16175",5079,4279,4207,40,72,"P-LIB",1
16,"16129",90,78,77,0,1,"P-LIB",0
3,"3046",1619,1213,1190,17,23,"P-LIB",3
3,"3015",12807,9782,9634,63,148,"P-LIB",6
16,"16034",155,124,122,1,2,"P-LIB",0
3,"3082",12936,9025,8931,57,94,"P-LIB",28
3,"3122",43704,31952,31681,218,271,"P-LIB",44
3,"3136",410,329,323,3,6,"P-LIB",0
16,"16274",103,86,85,0,1,"P-LIB",0
16,"16192",43,30,29,0,1,"P-LIB",0
3,"3112",637,526,520,0,6,"P-LIB",0
16,"16044",43,31,30,0,1,"P-LIB",0
3,"3070",2106,1554,1528,9,26,"P-LIB",1
3,"3010",336,295,280,0,15,"P-LIB",0
16,"16065",372,306,305,2,1,"P-LIB",1
3,"3040",258,223,217,1,6,"P-LIB",1
39,"39063",954,726,722,4,4,"P-LIB",0
3,"3029",244,174,167,1,7,"P-LIB",0
3,"3059",20590,15909,15766,96,143,"P-LIB",12
16,"16137",37,27,25,0,2,"P-LIB",0
39,"39015",824,646,644,2,2,"P-LIB",0
3,"3069",3311,2356,2327,12,29,"P-LIB",2
16,"16171",1749,1449,1422,6,27,"P-LIB",0
16,"16009",54,49,49,0,0,"P-LIB",0
3,"3090",17881,13593,13437,108,156,"P-LIB",15
16,"16239",118,89,88,0,1,"P-LIB",0
16,"16083",45,29,28,0,1,"P-LIB",0
16,"16278",63,51,51,0,0,"P-LIB",0
16,"16093",57,47,47,0,0,"P-LIB",0
3,"3125",336,259,257,1,2,"P-LIB",0
3,"3042",1462,1025,1008,3,17,"P-LIB",2
16,"16139",324,249,249,2,0,"P-LIB",0
39,"39065",232,190,189,5,1,"P-LIB",0
3,"3127",351,290,277,2,13,"P-LIB",0
16,"16132",34,26,26,0,0,"P-LIB",0
16,"16156",82,65,65,0,0,"P-LIB",0
16,"16906",71,52,52,1,0,"P-LIB",0
3,"3121",21787,15670,15453,81,217,"P-LIB",13
16,"16104",55,46,46,0,0,"P-LIB",0
39,"39025",8703,6954,6854,39,100,"P-LIB",2
3,"3095",4740,3702,3657,23,45,"P-LIB",18
16,"16092",154,113,112,0,1,"P-LIB",0
16,"16101",139,123,122,0,1,"P-LIB",1
39,"39040",4267,3428,3385,24,43,"P-LIB",0
16,"16215",237,157,153,1,4,"P-LIB",1
39,"39062",1841,1511,1500,9,11,"P-LIB",1
16,"16130",536,445,444,0,1,"P-LIB",0
39,"39047",1976,1564,1538,8,26,"P-LIB",0
39,"39092",871,635,629,2,6,"P-LIB",0
3,"3134",141,119,117,0,2,"P-LIB",0
3,"3137",657,484,480,5,4,"P-LIB",0
16,"16143",15,10,10,1,0,"P-LIB",0
16,"16206",196,146,144,3,2,"P-LIB",0
16,"16088",101,85,85,1,0,"P-LIB",0
3,"3014",238879,176118,174768,1105,1350,"P-LIB",132
16,"16087",226,191,184,3,7,"P-LIB",0
16,"16117",1022,822,809,6,13,"P-LIB",1
16,"16219",81,64,63,0,1,"P-LIB",0
7,"7040",288348,192799,191053,1586,1746,"PODEMOS-EUI",34980
7,"7030",1590,1234,1202,8,32,"PODEMOS-EUI",172
7,"7005",6975,4824,4775,43,49,"PODEMOS-EUI",758
7,"7038",2025,1581,1556,14,25,"PODEMOS-EUI",214
7,"7054",22958,14097,13908,123,189,"PODEMOS-EUI",2717
7,"7041",2097,1662,1634,20,28,"PODEMOS-EUI",200
7,"7020",3692,2833,2808,42,25,"PODEMOS-EUI",606
7,"7050",3442,2303,2275,28,28,"PODEMOS-EUI",380
7,"7051",5414,3610,3575,37,35,"PODEMOS-EUI",582
7,"7024",7294,4213,4160,44,53,"PODEMOS-EUI",940
7,"7053",1164,956,948,4,8,"PODEMOS-EUI",176
7,"7008",6047,4570,4513,31,57,"PODEMOS-EUI",853
7,"7045",1300,1038,1030,6,8,"PODEMOS-EUI",217
7,"7047",2371,1775,1747,13,28,"PODEMOS-EUI",342
7,"7055",7897,5264,5176,47,88,"PODEMOS-EUI",623
7,"7018",379,287,286,1,1,"PODEMOS-EUI",58
7,"7009",741,554,544,4,10,"PODEMOS-EUI",73
7,"7012",1909,1358,1343,15,15,"PODEMOS-EUI",189
7,"7006",5332,3769,3722,25,47,"PODEMOS-EUI",729
7,"7031",24784,16683,16527,160,156,"PODEMOS-EUI",2581
7,"7016",2931,2201,2178,31,23,"PODEMOS-EUI",372
7,"7037",3357,2142,2120,16,22,"PODEMOS-EUI",440
7,"7034",1064,906,900,6,6,"PODEMOS-EUI",115
7,"7901",594,454,446,6,8,"PODEMOS-EUI",33
7,"7044",8791,6335,6196,66,139,"PODEMOS-EUI",738
7,"7059",3035,2257,2226,13,31,"PODEMOS-EUI",251
7,"7036",27950,20870,20707,154,163,"PODEMOS-EUI",3438
7,"7029",4366,3270,3229,25,41,"PODEMOS-EUI",478
7,"7015",21976,14458,14297,205,161,"PODEMOS-EUI",3163
7,"7025",446,363,362,4,1,"PODEMOS-EUI",67
7,"7064",5528,3793,3765,23,28,"PODEMOS-EUI",900
7,"7060",2665,1976,1964,14,12,"PODEMOS-EUI",302
7,"7002",6612,4721,4672,43,49,"PODEMOS-EUI",944
7,"7902",1091,776,743,10,33,"PODEMOS-EUI",161
7,"7010",5070,3815,3777,47,38,"PODEMOS-EUI",720
7,"7001",3628,2792,2753,18,39,"PODEMOS-EUI",457
7,"7023",3757,2777,2735,43,42,"PODEMOS-EUI",555
7,"7007",414,326,324,2,2,"PODEMOS-EUI",38
7,"7021",230,183,178,3,5,"PODEMOS-EUI",31
7,"7026",30991,19827,19602,161,225,"PODEMOS-EUI",3618
7,"7052",4816,3276,3258,39,18,"PODEMOS-EUI",770
7,"7046",16718,10573,10469,94,104,"PODEMOS-EUI",2031
7,"7017",882,652,646,6,6,"PODEMOS-EUI",102
7,"7039",4970,3557,3489,36,68,"PODEMOS-EUI",381
7,"7061",9564,6678,6583,67,95,"PODEMOS-EUI",1181
7,"7027",22047,14986,14853,139,133,"PODEMOS-EUI",2285
7,"7049",1480,1092,1075,10,17,"PODEMOS-EUI",144
7,"7019",164,124,124,0,0,"PODEMOS-EUI",11
7,"7004",4033,2898,2860,28,38,"PODEMOS-EUI",448
7,"7033",28373,17884,17684,201,200,"PODEMOS-EUI",3125
7,"7058",2857,2258,2233,18,25,"PODEMOS-EUI",344
7,"7063",1420,1139,1129,10,10,"PODEMOS-EUI",194
7,"7056",5245,3883,3841,32,42,"PODEMOS-EUI",802
7,"7014",7778,4724,4669,50,55,"PODEMOS-EUI",946
7,"7043",3430,2465,2438,24,27,"PODEMOS-EUI",249
7,"7022",11615,8055,7934,91,121,"PODEMOS-EUI",1020
7,"7013",7231,5372,5253,43,119,"PODEMOS-EUI",596
7,"7057",7404,5117,5028,50,89,"PODEMOS-EUI",620
7,"7035",1596,1242,1234,13,8,"PODEMOS-EUI",158
7,"7003",12374,7550,7442,51,108,"PODEMOS-EUI",1346
7,"7032",20888,14257,14096,108,161,"PODEMOS-EUI",2780
7,"7048",18412,11528,11412,112,116,"PODEMOS-EUI",2528
7,"7011",28642,19567,19396,147,171,"PODEMOS-EUI",3069
7,"7042",10785,7256,7191,60,65,"PODEMOS-EUI",1473
7,"7062",7902,4889,4828,58,61,"PODEMOS-EUI",988
7,"7065",2302,1633,1603,10,30,"PODEMOS-EUI",331
7,"7028",920,686,676,8,10,"PODEMOS-EUI",135
15,"15073",21760,14900,14630,181,270,"PODEMOS-EU-",2118
32,"32081",2035,1592,1565,14,27,"PODEMOS-EU-",100
27,"27004",1149,741,722,2,19,"PODEMOS-EU-",40
15,"15005",25263,17634,17347,257,287,"PODEMOS-EU-",3262
36,"36024",16395,12372,12165,102,207,"PODEMOS-EU-",953
15,"15070",8797,6312,6173,108,139,"PODEMOS-EU-",1036
36,"36044",2539,1768,1708,18,60,"PODEMOS-EU-",265
36,"36028",4069,3012,2960,27,52,"PODEMOS-EU-",296
32,"32056",1520,1125,1116,6,9,"PODEMOS-EU-",37
32,"32013",2017,1388,1380,5,8,"PODEMOS-EU-",58
15,"15093",4048,2761,2720,41,41,"PODEMOS-EU-",251
32,"32047",1746,1272,1252,6,20,"PODEMOS-EU-",69
27,"27014",3162,2181,2139,17,42,"PODEMOS-EU-",137
15,"15092",6250,4358,4297,28,61,"PODEMOS-EU-",384
32,"32006",1434,1033,1019,8,14,"PODEMOS-EU-",50
32,"32001",5105,3760,3715,37,45,"PODEMOS-EU-",514
36,"36041",13621,10098,9939,97,159,"PODEMOS-EU-",1378
36,"36901",4152,3400,3338,15,62,"PODEMOS-EU-",492
32,"32044",809,625,617,2,8,"PODEMOS-EU-",18
15,"15010",1819,1194,1181,16,13,"PODEMOS-EU-",52
36,"36004",10123,7396,7273,93,123,"PODEMOS-EU-",1366
27,"27022",4683,3131,3059,30,72,"PODEMOS-EU-",350
32,"32075",4382,3546,3489,35,57,"PODEMOS-EU-",317
27,"27025",2743,2191,2138,31,53,"PODEMOS-EU-",275
15,"15023",6318,4501,4436,40,65,"PODEMOS-EU-",551
36,"36002",3076,2225,2185,19,40,"PODEMOS-EU-",183
36,"36005",8122,5895,5776,65,119,"PODEMOS-EU-",724
15,"15012",3611,2695,2616,36,79,"PODEMOS-EU-",255
32,"32014",1045,775,769,5,6,"PODEMOS-EU-",36
32,"32066",551,399,396,1,3,"PODEMOS-EU-",7
32,"32062",766,582,579,1,3,"PODEMOS-EU-",24
36,"36023",8279,6187,6085,46,102,"PODEMOS-EU-",1047
27,"27009",2022,1514,1488,17,26,"PODEMOS-EU-",64
27,"27044",2719,1848,1797,29,51,"PODEMOS-EU-",129
36,"36037",2554,1839,1793,6,46,"PODEMOS-EU-",321
15,"15061",5199,3694,3601,40,93,"PODEMOS-EU-",338
32,"32031",1014,764,756,5,8,"PODEMOS-EU-",58
36,"36054",11074,8032,7873,77,159,"PODEMOS-EU-",1263
27,"27027",1806,1392,1354,18,38,"PODEMOS-EU-",100
36,"36003",10038,7747,7632,79,115,"PODEMOS-EU-",1366
36,"36008",21884,16428,16170,165,258,"PODEMOS-EU-",4303
27,"27039",4430,3437,3353,53,84,"PODEMOS-EU-",298
32,"32069",4256,3358,3309,39,49,"PODEMOS-EU-",399
27,"27060",2463,1695,1669,12,26,"PODEMOS-EU-",136
27,"27049",1342,934,921,11,13,"PODEMOS-EU-",30
36,"36038",66806,50974,50429,507,545,"PODEMOS-EU-",7681
15,"15081",982,755,741,11,14,"PODEMOS-EU-",71
32,"32092",482,337,334,2,3,"PODEMOS-EU-",25
27,"27028",78798,58316,57546,629,770,"PODEMOS-EU-",6925
27,"27046",1448,1074,1063,7,11,"PODEMOS-EU-",87
32,"32088",1610,1040,1019,11,21,"PODEMOS-EU-",81
27,"27065",12076,8393,8183,128,210,"PODEMOS-EU-",747
15,"15034",2724,1832,1811,8,21,"PODEMOS-EU-",142
15,"15046",6163,4625,4497,49,128,"PODEMOS-EU-",448
32,"32064",480,348,346,2,2,"PODEMOS-EU-",22
36,"36017",17419,12867,12610,120,257,"PODEMOS-EU-",1416
15,"15065",7151,5281,5165,63,116,"PODEMOS-EU-",722
32,"32085",10634,7655,7551,66,104,"PODEMOS-EU-",602
15,"15008",5631,4320,4267,64,53,"PODEMOS-EU-",496
15,"15060",5843,4360,4281,65,79,"PODEMOS-EU-",530
36,"36007",1618,1163,1133,7,30,"PODEMOS-EU-",88
32,"32090",738,530,525,3,5,"PODEMOS-EU-",42
27,"27058",3322,2551,2512,22,39,"PODEMOS-EU-",125
32,"32080",286,223,220,1,3,"PODEMOS-EU-",10
32,"32040",1418,1083,1075,3,8,"PODEMOS-EU-",53
32,"32012",716,497,487,7,10,"PODEMOS-EU-",38
15,"15072",9436,6962,6860,60,102,"PODEMOS-EU-",1137
27,"27032",3194,2268,2223,20,45,"PODEMOS-EU-",188
32,"32033",676,480,468,4,12,"PODEMOS-EU-",22
15,"15004",4873,3689,3623,31,66,"PODEMOS-EU-",594
27,"27023",2470,1833,1797,20,36,"PODEMOS-EU-",74
15,"15055",4485,3097,3057,39,40,"PODEMOS-EU-",518
15,"15013",6299,4549,4486,45,63,"PODEMOS-EU-",671
15,"15031",23779,17963,17787,213,176,"PODEMOS-EU-",3051
15,"15054",31802,22002,21676,368,326,"PODEMOS-EU-",4036
32,"32026",2659,1988,1957,26,31,"PODEMOS-EU-",198
27,"27045",944,700,698,13,2,"PODEMOS-EU-",26
15,"15051",4562,3302,3249,36,53,"PODEMOS-EU-",641
27,"27018",3232,2114,2089,24,25,"PODEMOS-EU-",152
27,"27017",961,667,654,1,13,"PODEMOS-EU-",48
36,"36010",2828,2217,2184,15,33,"PODEMOS-EU-",305
27,"27002",1546,1136,1103,9,33,"PODEMOS-EU-",62
15,"15086",2785,2015,1987,14,28,"PODEMOS-EU-",137
27,"27048",2019,1499,1467,23,32,"PODEMOS-EU-",81
32,"32004",1671,907,899,7,8,"PODEMOS-EU-",18
27,"27042",1648,1247,1233,21,14,"PODEMOS-EU-",56
32,"32067",1193,827,818,10,9,"PODEMOS-EU-",46
32,"32048",864,550,544,1,6,"PODEMOS-EU-",46
32,"32076",1974,1492,1472,17,20,"PODEMOS-EU-",64
15,"15045",3629,2263,2237,9,26,"PODEMOS-EU-",172
36,"36052",7234,5292,5151,44,141,"PODEMOS-EU-",488
32,"32017",1202,821,815,6,6,"PODEMOS-EU-",35
27,"27012",1276,776,768,9,8,"PODEMOS-EU-",27
15,"15083",1036,784,768,7,16,"PODEMOS-EU-",47
36,"36020",2184,1621,1599,13,22,"PODEMOS-EU-",92
32,"32018",1179,950,936,3,14,"PODEMOS-EU-",54
15,"15049",1091,805,796,8,9,"PODEMOS-EU-",44
36,"36019",1463,1041,1030,14,11,"PODEMOS-EU-",107
32,"32015",830,543,541,4,2,"PODEMOS-EU-",20
36,"36902",5052,3813,3724,21,89,"PODEMOS-EU-",390
27,"27040",3035,2285,2234,19,51,"PODEMOS-EU-",143
15,"15088",3415,2349,2323,28,26,"PODEMOS-EU-",193
15,"15037",4031,2700,2677,13,23,"PODEMOS-EU-",404
36,"36016",1064,707,696,7,11,"PODEMOS-EU-",24
15,"15022",5574,3846,3798,41,48,"PODEMOS-EU-",505
27,"27033",598,423,415,1,8,"PODEMOS-EU-",30
15,"15050",1748,1038,1027,15,11,"PODEMOS-EU-",79
32,"32046",1098,793,782,5,11,"PODEMOS-EU-",62
32,"32065",630,478,474,5,4,"PODEMOS-EU-",23
32,"32057",514,367,365,5,2,"PODEMOS-EU-",27
15,"15044",1209,889,876,4,13,"PODEMOS-EU-",84
15,"15075",12785,9638,9519,121,119,"PODEMOS-EU-",1409
32,"32053",1363,1114,1098,14,16,"PODEMOS-EU-",76
32,"32025",1013,773,761,7,12,"PODEMOS-EU-",70
36,"36040",2517,1895,1853,18,42,"PODEMOS-EU-",191
27,"27007",2756,2148,2084,29,64,"PODEMOS-EU-",146
27,"27020",3380,2764,2713,32,51,"PODEMOS-EU-",128
27,"27062",584,467,466,3,1,"PODEMOS-EU-",25
32,"32016",724,543,535,3,8,"PODEMOS-EU-",15
32,"32010",360,276,273,3,3,"PODEMOS-EU-",25
27,"27026",2315,1620,1599,17,21,"PODEMOS-EU-",134
32,"32068",1419,998,987,4,11,"PODEMOS-EU-",60
15,"15901",3359,2237,2205,35,32,"PODEMOS-EU-",312
15,"15087",5692,3883,3838,53,45,"PODEMOS-EU-",533
36,"36031",562,455,450,2,5,"PODEMOS-EU-",49
32,"32061",1070,862,855,8,7,"PODEMOS-EU-",39
27,"27021",1649,1080,1048,14,32,"PODEMOS-EU-",91
15,"15028",1393,1076,1063,8,13,"PODEMOS-EU-",168
32,"32060",765,577,567,2,10,"PODEMOS-EU-",57
15,"15003",1701,1234,1210,10,24,"PODEMOS-EU-",82
27,"27001",2209,1290,1251,25,39,"PODEMOS-EU-",69
27,"27051",8012,5936,5832,70,104,"PODEMOS-EU-",743
36,"36018",3073,2184,2144,9,40,"PODEMOS-EU-",164
27,"27024",1451,1122,1102,5,20,"PODEMOS-EU-",63
15,"15029",5403,3682,3622,62,60,"PODEMOS-EU-",366
27,"27064",1503,1078,1039,12,39,"PODEMOS-EU-",83
27,"27038",923,688,677,12,11,"PODEMOS-EU-",55
36,"36026",19924,14342,14132,171,210,"PODEMOS-EU-",2239
36,"36015",4076,2903,2834,37,69,"PODEMOS-EU-",306
15,"15064",2127,1608,1577,29,31,"PODEMOS-EU-",130
15,"15015",2883,2079,2049,21,30,"PODEMOS-EU-",315
27,"27047",1525,1026,1008,5,18,"PODEMOS-EU-",84
32,"32022",1238,924,916,5,8,"PODEMOS-EU-",53
32,"32024",4835,3484,3439,23,45,"PODEMOS-EU-",222
36,"36030",3946,2847,2810,26,37,"PODEMOS-EU-",383
32,"32043",2512,1805,1789,16,16,"PODEMOS-EU-",176
32,"32071",1378,963,954,7,9,"PODEMOS-EU-",54
36,"36043",4682,3345,3303,17,42,"PODEMOS-EU-",409
15,"15071",7805,5476,5401,62,75,"PODEMOS-EU-",728
36,"36039",15610,11844,11592,103,252,"PODEMOS-EU-",2520
36,"36001",2401,1739,1715,19,24,"PODEMOS-EU-",159
32,"32059",1703,1248,1228,12,20,"PODEMOS-EU-",89
32,"32019",11512,8281,8161,96,120,"PODEMOS-EU-",657
27,"27054",1145,907,890,5,17,"PODEMOS-EU-",60
27,"27003",1772,1271,1241,6,30,"PODEMOS-EU-",78
32,"32038",399,274,271,3,3,"PODEMOS-EU-",19
32,"32050",2280,1788,1775,19,13,"PODEMOS-EU-",100
15,"15024",4346,3210,3151,19,59,"PODEMOS-EU-",301
27,"27030",3134,2209,2162,27,47,"PODEMOS-EU-",175
32,"32054",86475,64472,63712,676,760,"PODEMOS-EU-",7495
32,"32079",1287,1016,1006,6,10,"PODEMOS-EU-",68
36,"36034",3319,2384,2347,16,37,"PODEMOS-EU-",293
15,"15041",9581,7223,7082,96,141,"PODEMOS-EU-",944
15,"15039",1224,874,850,11,24,"PODEMOS-EU-",62
15,"15014",3836,2739,2698,38,41,"PODEMOS-EU-",271
15,"15090",1125,811,800,7,11,"PODEMOS-EU-",38
27,"27056",1206,896,880,9,16,"PODEMOS-EU-",79
15,"15062",5652,3803,3728,25,75,"PODEMOS-EU-",396
15,"15048",5048,3791,3730,38,61,"PODEMOS-EU-",561
36,"36032",3537,2676,2626,16,50,"PODEMOS-EU-",232
32,"32078",1108,794,781,15,13,"PODEMOS-EU-",34
36,"36060",30432,22488,22196,199,292,"PODEMOS-EU-",3667
27,"27043",1219,814,797,6,17,"PODEMOS-EU-",61
32,"32083",821,592,587,7,5,"PODEMOS-EU-",23
32,"32030",944,690,685,7,5,"PODEMOS-EU-",50
15,"15059",10255,7423,7262,122,161,"PODEMOS-EU-",736
15,"15082",15381,11803,11642,133,161,"PODEMOS-EU-",1777
15,"15052",4104,2928,2878,30,50,"PODEMOS-EU-",268
36,"36029",16086,12196,12005,126,191,"PODEMOS-EU-",2691
27,"27029",1427,1068,1047,13,21,"PODEMOS-EU-",83
32,"32089",1220,872,857,15,15,"PODEMOS-EU-",35
15,"15056",5648,4033,3979,39,54,"PODEMOS-EU-",440
15,"15078",78678,60510,59882,621,628,"PODEMOS-EU-",8799
32,"32034",1074,855,846,1,9,"PODEMOS-EU-",48
15,"15036",56248,40194,39764,508,430,"PODEMOS-EU-",7047
36,"36046",4043,3157,3084,27,73,"PODEMOS-EU-",370
15,"15043",4978,3631,3572,39,59,"PODEMOS-EU-",472
32,"32021",874,616,615,4,1,"PODEMOS-EU-",39
32,"32009",10590,7661,7574,68,87,"PODEMOS-EU-",704
32,"32074",993,737,734,4,3,"PODEMOS-EU-",48
32,"32037",681,534,523,6,11,"PODEMOS-EU-",33
15,"15019",26006,18323,18075,280,248,"PODEMOS-EU-",2315
36,"36057",238171,181891,180030,1636,1861,"PODEMOS-EU-",37757
36,"36047",2287,1601,1585,14,16,"PODEMOS-EU-",79
27,"27055",1197,857,851,2,6,"PODEMOS-EU-",33
36,"36053",5784,4407,4327,28,80,"PODEMOS-EU-",675
32,"32051",1407,1158,1153,12,5,"PODEMOS-EU-",27
36,"36056",4961,3719,3635,30,84,"PODEMOS-EU-",488
15,"15069",6588,4914,4830,58,84,"PODEMOS-EU-",836
15,"15068",4849,3435,3392,55,43,"PODEMOS-EU-",417
27,"27034",1025,647,636,4,11,"PODEMOS-EU-",44
15,"15009",10615,8066,7919,93,147,"PODEMOS-EU-",1154
32,"32072",3687,2715,2682,22,33,"PODEMOS-EU-",271
36,"36021",12099,9105,8974,85,131,"PODEMOS-EU-",1597
27,"27063",1715,1236,1198,10,38,"PODEMOS-EU-",120
36,"36058",4942,3470,3402,37,68,"PODEMOS-EU-",470
15,"15076",2514,1709,1683,19,26,"PODEMOS-EU-",168
32,"32023",1132,867,862,7,5,"PODEMOS-EU-",67
15,"15042",2955,2057,2002,16,55,"PODEMOS-EU-",251
27,"27057",11097,7917,7735,88,182,"PODEMOS-EU-",792
15,"15066",4008,2931,2886,30,45,"PODEMOS-EU-",261
27,"27902",7150,5067,4953,74,114,"PODEMOS-EU-",781
27,"27061",1016,784,763,9,21,"PODEMOS-EU-",60
36,"36022",9061,6640,6482,47,158,"PODEMOS-EU-",1602
15,"15030",199972,151737,150397,1576,1340,"PODEMOS-EU-",24429
15,"15011",15481,11249,11037,105,212,"PODEMOS-EU-",1813
15,"15001",4689,3422,3362,52,60,"PODEMOS-EU-",403
27,"27019",8189,6148,6039,94,109,"PODEMOS-EU-",779
36,"36025",2137,1387,1381,7,6,"PODEMOS-EU-",127
32,"32077",1104,820,815,10,5,"PODEMOS-EU-",58
32,"32002",2022,1510,1485,8,25,"PODEMOS-EU-",98
32,"32042",1505,1097,1091,12,6,"PODEMOS-EU-",67
15,"15057",12051,8814,8660,89,154,"PODEMOS-EU-",1221
32,"32073",1281,941,932,9,9,"PODEMOS-EU-",86
15,"15025",1000,639,631,6,8,"PODEMOS-EU-",27
32,"32063",1819,1313,1287,6,26,"PODEMOS-EU-",76
15,"15033",2422,1887,1866,13,21,"PODEMOS-EU-",205
36,"36036",2556,1953,1914,14,39,"PODEMOS-EU-",306
15,"15085",3220,2284,2239,23,45,"PODEMOS-EU-",162
36,"36033",12244,9553,9358,80,195,"PODEMOS-EU-",1842
32,"32003",889,667,654,3,13,"PODEMOS-EU-",55
27,"27016",6973,5139,5064,66,75,"PODEMOS-EU-",440
15,"15089",4324,3258,3200,33,58,"PODEMOS-EU-",361
15,"15027",1555,1227,1204,18,23,"PODEMOS-EU-",110
15,"15902",4522,3220,3159,47,61,"PODEMOS-EU-",273
27,"27011",2358,1582,1558,12,24,"PODEMOS-EU-",123
32,"32084",902,636,631,2,5,"PODEMOS-EU-",16
36,"36049",7019,5414,5283,48,131,"PODEMOS-EU-",1007
27,"27006",2458,1713,1666,27,47,"PODEMOS-EU-",121
15,"15053",7548,5364,5309,44,55,"PODEMOS-EU-",854
15,"15079",1466,1076,1052,11,24,"PODEMOS-EU-",65
36,"36051",14315,10396,10223,70,173,"PODEMOS-EU-",1392
15,"15020",3593,2491,2469,18,22,"PODEMOS-EU-",261
32,"32035",1370,881,872,5,9,"PODEMOS-EU-",32
27,"27059",2055,1508,1471,13,37,"PODEMOS-EU-",117
32,"32039",1142,895,890,7,5,"PODEMOS-EU-",31
27,"27031",15212,10826,10649,125,177,"PODEMOS-EU-",1153
32,"32027",1000,762,747,5,15,"PODEMOS-EU-",54
36,"36055",13551,9908,9682,105,226,"PODEMOS-EU-",1376
36,"36009",4445,3081,2997,26,84,"PODEMOS-EU-",357
15,"15017",19860,14930,14706,204,224,"PODEMOS-EU-",2671
32,"32005",827,628,622,4,6,"PODEMOS-EU-",21
32,"32007",1412,1011,1001,9,10,"PODEMOS-EU-",61
32,"32055",1230,908,889,5,19,"PODEMOS-EU-",84
32,"32008",8572,6301,6216,65,85,"PODEMOS-EU-",772
32,"32036",1261,954,938,9,16,"PODEMOS-EU-",69
15,"15018",1087,771,761,8,10,"PODEMOS-EU-",113
27,"27901",2275,1542,1531,27,11,"PODEMOS-EU-",105
32,"32049",689,468,462,3,6,"PODEMOS-EU-",26
15,"15067",7953,6004,5925,51,79,"PODEMOS-EU-",1172
27,"27050",2842,2100,2072,19,28,"PODEMOS-EU-",157
27,"27041",2238,1640,1615,10,25,"PODEMOS-EU-",120
15,"15035",11208,8175,8068,105,107,"PODEMOS-EU-",1648
36,"36048",5244,3859,3786,33,73,"PODEMOS-EU-",632
36,"36059",4663,3196,3115,31,81,"PODEMOS-EU-",239
27,"27037",1017,759,748,10,11,"PODEMOS-EU-",39
32,"32087",1675,1313,1288,18,25,"PODEMOS-EU-",86
36,"36050",7650,5616,5506,48,110,"PODEMOS-EU-",946
36,"36035",14571,11096,10917,105,179,"PODEMOS-EU-",1794
36,"36013",2242,1468,1452,15,16,"PODEMOS-EU-",187
15,"15047",2269,1531,1497,25,34,"PODEMOS-EU-",146
32,"32028",1550,1176,1171,10,5,"PODEMOS-EU-",46
15,"15040",2675,2011,1979,20,32,"PODEMOS-EU-",197
15,"15077",8155,5554,5433,59,121,"PODEMOS-EU-",401
36,"36006",11468,8959,8782,66,177,"PODEMOS-EU-",1147
36,"36027",4380,3262,3206,26,56,"PODEMOS-EU-",307
32,"32058",5225,3915,3857,35,58,"PODEMOS-EU-",378
27,"27008",1345,965,946,17,19,"PODEMOS-EU-",65
27,"27053",501,384,373,1,11,"PODEMOS-EU-",9
15,"15058",28606,22203,22022,261,181,"PODEMOS-EU-",3466
27,"27066",12633,9139,8911,84,228,"PODEMOS-EU-",1339
32,"32091",1703,1312,1306,4,6,"PODEMOS-EU-",66
32,"32029",436,340,337,1,3,"PODEMOS-EU-",9
36,"36045",24478,18627,18327,157,300,"PODEMOS-EU-",3908
32,"32032",7932,5956,5831,55,125,"PODEMOS-EU-",549
15,"15007",3179,2333,2304,22,29,"PODEMOS-EU-",134
15,"15038",2123,1441,1413,25,28,"PODEMOS-EU-",118
15,"15084",3059,2236,2217,20,19,"PODEMOS-EU-",106
15,"15021",5244,3884,3806,70,78,"PODEMOS-EU-",525
27,"27005",2551,1908,1868,26,40,"PODEMOS-EU-",176
32,"32020",2460,1899,1876,6,23,"PODEMOS-EU-",75
36,"36061",8617,6498,6391,59,107,"PODEMOS-EU-",628
15,"15016",4569,3171,3146,18,25,"PODEMOS-EU-",186
32,"32082",1178,880,872,12,8,"PODEMOS-EU-",38
36,"36042",18072,13314,13091,130,223,"PODEMOS-EU-",2759
27,"27013",3684,2997,2935,26,62,"PODEMOS-EU-",531
32,"32041",759,510,502,2,8,"PODEMOS-EU-",24
32,"32070",512,307,304,8,3,"PODEMOS-EU-",19
15,"15032",3413,2487,2414,28,73,"PODEMOS-EU-",213
32,"32086",2563,1699,1686,19,13,"PODEMOS-EU-",96
15,"15006",5169,3527,3436,32,91,"PODEMOS-EU-",281
32,"32045",2360,1712,1689,18,23,"PODEMOS-EU-",102
32,"32052",1819,1399,1379,15,20,"PODEMOS-EU-",72
27,"27010",4402,3015,2940,49,75,"PODEMOS-EU-",272
36,"36014",1872,1373,1345,14,28,"PODEMOS-EU-",122
27,"27015",4020,2809,2730,33,79,"PODEMOS-EU-",207
27,"27035",180,127,123,0,4,"PODEMOS-EU-",21
15,"15002",24007,18075,17857,216,218,"PODEMOS-EU-",2959
27,"27052",862,645,640,4,5,"PODEMOS-EU-",36
15,"15074",3919,2865,2808,33,57,"PODEMOS-EU-",271
32,"32011",918,526,521,6,5,"PODEMOS-EU-",16
15,"15080",1640,1177,1150,9,27,"PODEMOS-EU-",90
15,"15091",1103,773,758,16,15,"PODEMOS-EU-",92
3,"3106",564,485,479,4,6,"PODEMOS-EUP",53
3,"3001",345,285,282,1,3,"PODEMOS-EUP",31
46,"46152",87,69,69,0,0,"PODEMOS-EUP",3
46,"46061",343,285,280,4,5,"PODEMOS-EUP",37
12,"12058",64,56,56,0,0,"PODEMOS-EUP",6
12,"12008",224,197,194,1,3,"PODEMOS-EUP",24
46,"46223",7781,6057,5995,42,62,"PODEMOS-EUP",793
12,"12022",328,273,269,1,4,"PODEMOS-EUP",34
46,"46016",1075,887,880,8,7,"PODEMOS-EUP",117
3,"3044",4557,3650,3600,17,50,"PODEMOS-EUP",294
46,"46213",15504,11420,11232,124,188,"PODEMOS-EUP",1338
46,"46094",20691,15841,15672,88,169,"PODEMOS-EUP",2301
46,"46132",2196,1877,1853,10,24,"PODEMOS-EUP",205
46,"46077",7344,5873,5761,49,112,"PODEMOS-EUP",1784
12,"12129",1801,1382,1356,17,26,"PODEMOS-EUP",166
12,"12091",176,131,130,0,1,"PODEMOS-EUP",5
46,"46169",32294,24909,24676,157,233,"PODEMOS-EUP",4047
12,"12140",1140,936,922,7,14,"PODEMOS-EUP",139
3,"3038",335,275,267,1,8,"PODEMOS-EUP",31
3,"3021",5578,4720,4626,35,94,"PODEMOS-EUP",496
3,"3118",2426,1741,1718,8,23,"PODEMOS-EUP",180
12,"12094",875,694,682,2,12,"PODEMOS-EUP",149
46,"46011",7523,5320,5235,28,85,"PODEMOS-EUP",602
46,"46183",6028,4620,4534,29,86,"PODEMOS-EUP",422
46,"46047",532,447,441,4,6,"PODEMOS-EUP",62
3,"3008",159,127,126,0,1,"PODEMOS-EUP",13
46,"46155",993,785,772,2,13,"PODEMOS-EUP",97
46,"46109",6174,4763,4639,30,124,"PODEMOS-EUP",766
3,"3089",9497,6952,6794,55,158,"PODEMOS-EUP",932
12,"12053",2030,1656,1636,10,20,"PODEMOS-EUP",206
12,"12021",4377,3528,3473,23,55,"PODEMOS-EUP",602
12,"12103",90,75,70,1,5,"PODEMOS-EUP",6
46,"46057",474,319,313,1,6,"PODEMOS-EUP",33
46,"46084",1503,1225,1195,1,30,"PODEMOS-EUP",124
46,"46117",500,407,399,1,8,"PODEMOS-EUP",66
3,"3135",192,157,155,0,2,"PODEMOS-EUP",31
46,"46192",790,599,586,8,13,"PODEMOS-EUP",66
3,"3015",12807,9782,9634,63,148,"PODEMOS-EUP",1215
3,"3090",17881,13593,13437,108,156,"PODEMOS-EUP",2007
12,"12038",156,110,109,1,1,"PODEMOS-EUP",5
46,"46145",22099,16685,16499,128,186,"PODEMOS-EUP",2705
46,"46018",567,483,479,3,4,"PODEMOS-EUP",48
3,"3035",632,529,525,2,4,"PODEMOS-EUP",69
46,"46091",115,99,99,0,0,"PODEMOS-EUP",4
46,"46255",3209,2415,2381,18,34,"PODEMOS-EUP",343
46,"46003",953,828,811,5,17,"PODEMOS-EUP",63
12,"12092",126,108,106,1,2,"PODEMOS-EUP",27
12,"12013",137,113,113,0,0,"PODEMOS-EUP",22
12,"12045",328,275,271,2,4,"PODEMOS-EUP",41
46,"46175",428,367,354,3,13,"PODEMOS-EUP",47
46,"46079",313,252,248,1,4,"PODEMOS-EUP",30
3,"3024",3948,3210,3164,14,46,"PODEMOS-EUP",221
12,"12112",110,97,96,1,1,"PODEMOS-EUP",3
3,"3125",336,259,257,1,2,"PODEMOS-EUP",36
46,"46106",1466,1156,1142,3,14,"PODEMOS-EUP",170
3,"3109",2976,2375,2345,11,30,"PODEMOS-EUP",200
3,"3116",1159,901,884,3,17,"PODEMOS-EUP",128
12,"12072",1082,901,889,15,12,"PODEMOS-EUP",71
46,"46130",857,680,669,6,11,"PODEMOS-EUP",75
3,"3071",3988,3125,3088,28,37,"PODEMOS-EUP",449
46,"46207",6686,5220,5137,36,83,"PODEMOS-EUP",694
3,"3088",5810,4380,4313,31,67,"PODEMOS-EUP",640
12,"12011",4582,3511,3431,27,80,"PODEMOS-EUP",435
46,"46081",9993,7972,7882,51,90,"PODEMOS-EUP",961
3,"3111",5565,4183,4149,29,34,"PODEMOS-EUP",446
3,"3120",2421,1823,1786,9,37,"PODEMOS-EUP",221
46,"46168",1982,1543,1522,5,21,"PODEMOS-EUP",184
3,"3027",172,156,153,0,3,"PODEMOS-EUP",16
46,"46023",328,277,269,1,8,"PODEMOS-EUP",60
3,"3131",179,147,139,0,8,"PODEMOS-EUP",21
12,"12040",118683,91285,90499,666,786,"PODEMOS-EUP",13388
46,"46114",574,457,452,1,5,"PODEMOS-EUP",39
46,"46171",16429,12527,12373,61,154,"PODEMOS-EUP",1874
3,"3113",4342,3194,3154,23,40,"PODEMOS-EUP",366
46,"46053",537,459,457,2,2,"PODEMOS-EUP",58
12,"12014",167,131,127,1,4,"PODEMOS-EUP",12
46,"46146",1641,1314,1281,11,33,"PODEMOS-EUP",133
12,"12108",438,382,379,4,3,"PODEMOS-EUP",40
46,"46010",950,727,718,6,9,"PODEMOS-EUP",147
12,"12132",484,415,412,4,3,"PODEMOS-EUP",62
12,"12135",36194,27266,26961,192,305,"PODEMOS-EUP",4113
46,"46031",10521,7735,7607,62,128,"PODEMOS-EUP",1167
46,"46048",3509,2758,2720,11,38,"PODEMOS-EUP",341
12,"12009",17859,13054,12911,98,143,"PODEMOS-EUP",1574
46,"46041",327,251,250,2,1,"PODEMOS-EUP",56
46,"46124",785,680,675,5,5,"PODEMOS-EUP",41
46,"46219",122,105,104,0,1,"PODEMOS-EUP",10
46,"46156",2024,1642,1628,7,14,"PODEMOS-EUP",197
46,"46166",8202,6482,6399,39,83,"PODEMOS-EUP",944
12,"12065",171,150,147,0,3,"PODEMOS-EUP",7
46,"46074",2678,2158,2135,13,23,"PODEMOS-EUP",330
46,"46099",772,620,614,1,6,"PODEMOS-EUP",41
3,"3022",137,122,119,0,3,"PODEMOS-EUP",23
46,"46149",344,260,256,2,4,"PODEMOS-EUP",17
12,"12052",539,453,439,5,14,"PODEMOS-EUP",28
12,"12100",1281,1118,1102,5,16,"PODEMOS-EUP",111
12,"12083",89,73,71,1,2,"PODEMOS-EUP",4
3,"3036",86,77,75,2,2,"PODEMOS-EUP",14
12,"12128",1362,1099,1076,9,23,"PODEMOS-EUP",132
12,"12075",107,89,87,0,2,"PODEMOS-EUP",15
46,"46080",985,799,788,5,11,"PODEMOS-EUP",123
3,"3020",95,84,84,2,0,"PODEMOS-EUP",15
46,"46075",147,136,134,2,2,"PODEMOS-EUP",15
46,"46144",628,511,505,1,6,"PODEMOS-EUP",40
46,"46134",2380,1836,1825,5,11,"PODEMOS-EUP",300
46,"46229",911,755,752,5,3,"PODEMOS-EUP",118
46,"46257",5428,4237,4190,23,47,"PODEMOS-EUP",653
12,"12101",356,297,289,2,8,"PODEMOS-EUP",46
12,"12138",19179,14217,14006,124,211,"PODEMOS-EUP",2707
3,"3023",1379,1216,1199,6,17,"PODEMOS-EUP",159
46,"46026",1202,1012,997,1,15,"PODEMOS-EUP",106
3,"3064",5004,3782,3736,20,46,"PODEMOS-EUP",300
3,"3114",1581,1263,1237,9,26,"PODEMOS-EUP",118
46,"46013",17712,14181,14075,88,106,"PODEMOS-EUP",2202
3,"3019",15465,12156,11988,80,168,"PODEMOS-EUP",1655
3,"3068",42,40,40,3,0,"PODEMOS-EUP",2
3,"3902",10578,7654,7530,56,124,"PODEMOS-EUP",609
3,"3082",12936,9025,8931,57,94,"PODEMOS-EUP",1370
3,"3058",4967,4031,3967,24,64,"PODEMOS-EUP",300
3,"3086",166,143,143,1,0,"PODEMOS-EUP",32
46,"46021",23977,18032,17879,125,153,"PODEMOS-EUP",2913
3,"3079",18403,14632,14382,114,250,"PODEMOS-EUP",2276
46,"46098",2403,1807,1772,8,35,"PODEMOS-EUP",163
12,"12093",165,128,126,0,2,"PODEMOS-EUP",17
3,"3073",222,200,196,3,4,"PODEMOS-EUP",25
3,"3026",1316,1040,1024,5,16,"PODEMOS-EUP",168
3,"3127",351,290,277,2,13,"PODEMOS-EUP",18
3,"3081",1494,1163,1141,5,22,"PODEMOS-EUP",150
46,"46170",3408,2769,2720,16,49,"PODEMOS-EUP",185
46,"46247",961,695,687,3,8,"PODEMOS-EUP",82
46,"46190",50023,37273,36976,250,297,"PODEMOS-EUP",5884
46,"46085",11075,8106,8011,54,95,"PODEMOS-EUP",797
46,"46139",4512,3612,3567,25,45,"PODEMOS-EUP",323
46,"46240",206,175,169,2,6,"PODEMOS-EUP",18
46,"46237",7148,5537,5472,36,65,"PODEMOS-EUP",869
3,"3083",5487,3993,3934,28,59,"PODEMOS-EUP",582
3,"3097",996,833,816,4,17,"PODEMOS-EUP",113
46,"46029",20423,15450,15274,100,176,"PODEMOS-EUP",1772
46,"46191",1949,1541,1505,7,36,"PODEMOS-EUP",227
3,"3901",1109,827,820,5,7,"PODEMOS-EUP",127
46,"46110",21317,15839,15699,89,140,"PODEMOS-EUP",2578
46,"46019",8948,7150,7067,40,83,"PODEMOS-EUP",695
3,"3110",312,271,269,1,2,"PODEMOS-EUP",34
46,"46090",1633,1413,1392,5,21,"PODEMOS-EUP",131
3,"3006",494,413,409,1,4,"PODEMOS-EUP",60
12,"12141",92,81,81,0,0,"PODEMOS-EUP",6
46,"46059",1240,1038,1030,3,8,"PODEMOS-EUP",204
46,"46253",114,85,85,2,0,"PODEMOS-EUP",7
46,"46181",16908,12749,12597,82,152,"PODEMOS-EUP",1533
46,"46030",796,653,633,7,20,"PODEMOS-EUP",100
46,"46121",111,96,94,2,2,"PODEMOS-EUP",5
46,"46178",4943,3684,3641,21,43,"PODEMOS-EUP",592
46,"46064",525,427,424,4,3,"PODEMOS-EUP",57
46,"46246",1042,860,838,2,22,"PODEMOS-EUP",62
12,"12111",334,283,279,4,4,"PODEMOS-EUP",20
12,"12126",24347,19023,18749,152,274,"PODEMOS-EUP",3151
46,"46043",135,119,116,1,3,"PODEMOS-EUP",6
3,"3055",5247,4042,3991,24,51,"PODEMOS-EUP",432
12,"12107",351,312,306,1,6,"PODEMOS-EUP",40
46,"46165",7298,5744,5697,38,47,"PODEMOS-EUP",858
12,"12073",132,110,107,1,3,"PODEMOS-EUP",15
46,"46209",1901,1517,1500,5,17,"PODEMOS-EUP",121
3,"3100",496,402,395,2,7,"PODEMOS-EUP",79
46,"46025",2455,2002,1981,6,21,"PODEMOS-EUP",268
46,"46116",13608,10792,10731,76,61,"PODEMOS-EUP",1668
12,"12137",37,27,27,0,0,"PODEMOS-EUP",1
46,"46176",2045,1450,1434,12,16,"PODEMOS-EUP",185
46,"46038",307,243,241,0,2,"PODEMOS-EUP",42
12,"12136",2606,2262,2223,17,39,"PODEMOS-EUP",125
46,"46230",14084,10694,10599,67,95,"PODEMOS-EUP",1445
46,"46014",3130,2488,2462,7,26,"PODEMOS-EUP",331
46,"46137",242,200,200,3,0,"PODEMOS-EUP",20
3,"3056",8629,6838,6737,38,101,"PODEMOS-EUP",1087
46,"46194",15813,11654,11511,83,143,"PODEMOS-EUP",1622
3,"3040",258,223,217,1,6,"PODEMOS-EUP",32
46,"46039",2121,1730,1698,19,32,"PODEMOS-EUP",206
12,"12064",80,75,73,1,2,"PODEMOS-EUP",10
12,"12088",57,54,54,0,0,"PODEMOS-EUP",7
46,"46009",3140,2582,2536,14,46,"PODEMOS-EUP",259
12,"12004",4177,3225,3187,13,38,"PODEMOS-EUP",327
46,"46093",2134,1700,1687,8,13,"PODEMOS-EUP",175
12,"12097",65,54,54,1,0,"PODEMOS-EUP",5
46,"46174",949,789,770,4,19,"PODEMOS-EUP",67
12,"12122",767,655,646,3,9,"PODEMOS-EUP",35
46,"46036",558,391,379,2,12,"PODEMOS-EUP",50
3,"3117",377,320,313,1,7,"PODEMOS-EUP",57
46,"46073",1077,867,862,10,5,"PODEMOS-EUP",171
12,"12125",222,189,187,0,2,"PODEMOS-EUP",26
46,"46235",21270,15754,15592,101,162,"PODEMOS-EUP",1987
12,"12078",333,238,235,1,3,"PODEMOS-EUP",28
3,"3085",269,243,237,0,6,"PODEMOS-EUP",22
46,"46006",4468,3731,3683,22,48,"PODEMOS-EUP",369
46,"46138",360,305,303,2,2,"PODEMOS-EUP",32
46,"46239",453,372,366,2,6,"PODEMOS-EUP",28
46,"46182",1310,988,977,5,11,"PODEMOS-EUP",215
12,"12130",420,345,341,0,4,"PODEMOS-EUP",10
12,"12102",521,442,434,2,8,"PODEMOS-EUP",31
3,"3129",1218,994,982,5,12,"PODEMOS-EUP",137
3,"3007",169,145,141,0,4,"PODEMOS-EUP",31
46,"46007",12284,9370,9265,65,105,"PODEMOS-EUP",1287
3,"3139",23061,16378,16178,128,200,"PODEMOS-EUP",2441
12,"12003",943,745,731,6,14,"PODEMOS-EUP",80
46,"46189",473,412,408,2,4,"PODEMOS-EUP",37
12,"12118",76,64,63,0,1,"PODEMOS-EUP",9
12,"12070",499,434,430,3,4,"PODEMOS-EUP",38
12,"12031",3942,2976,2931,24,45,"PODEMOS-EUP",457
46,"46001",783,612,607,4,5,"PODEMOS-EUP",70
46,"46200",1848,1560,1539,6,21,"PODEMOS-EUP",158
3,"3072",348,297,295,2,2,"PODEMOS-EUP",52
46,"46058",1734,1349,1325,9,24,"PODEMOS-EUP",183
3,"3066",41802,31046,30696,285,350,"PODEMOS-EUP",4605
46,"46163",1856,1522,1501,4,21,"PODEMOS-EUP",223
46,"46136",2619,2030,2003,24,27,"PODEMOS-EUP",332
12,"12007",731,649,642,8,7,"PODEMOS-EUP",83
46,"46197",1926,1473,1455,9,18,"PODEMOS-EUP",358
46,"46221",345,294,294,0,0,"PODEMOS-EUP",21
3,"3037",341,289,284,1,5,"PODEMOS-EUP",47
46,"46120",1183,958,936,3,22,"PODEMOS-EUP",164
12,"12010",237,203,198,1,5,"PODEMOS-EUP",20
12,"12131",59,50,50,0,0,"PODEMOS-EUP",1
3,"3057",177,148,147,0,1,"PODEMOS-EUP",19
3,"3067",93,87,87,0,0,"PODEMOS-EUP",5
12,"12084",17723,13501,13281,118,220,"PODEMOS-EUP",1730
46,"46231",2401,1780,1770,8,10,"PODEMOS-EUP",320
46,"46107",1849,1501,1480,5,21,"PODEMOS-EUP",223
12,"12017",148,120,116,0,4,"PODEMOS-EUP",7
46,"46250",581614,454786,451184,2675,3602,"PODEMOS-EUP",65993
46,"46242",330,279,279,0,0,"PODEMOS-EUP",20
46,"46063",1783,1368,1345,9,23,"PODEMOS-EUP",183
12,"12116",67,57,57,0,0,"PODEMOS-EUP",3
12,"12005",8052,6056,5935,50,121,"PODEMOS-EUP",861
3,"3018",12439,9387,9283,50,104,"PODEMOS-EUP",1389
3,"3078",474,372,371,2,1,"PODEMOS-EUP",34
3,"3070",2106,1554,1528,9,26,"PODEMOS-EUP",195
3,"3048",4971,3808,3739,19,69,"PODEMOS-EUP",370
46,"46151",757,586,579,0,7,"PODEMOS-EUP",122
46,"46088",150,129,127,0,2,"PODEMOS-EUP",25
12,"12082",9573,7672,7570,55,102,"PODEMOS-EUP",852
46,"46092",263,182,179,1,3,"PODEMOS-EUP",20
12,"12142",145,123,121,1,2,"PODEMOS-EUP",2
3,"3107",2769,2011,1986,10,25,"PODEMOS-EUP",334
46,"46071",470,382,366,0,16,"PODEMOS-EUP",70
3,"3025",1292,1009,991,7,18,"PODEMOS-EUP",67
3,"3046",1619,1213,1190,17,23,"PODEMOS-EUP",167
12,"12133",60,53,52,1,1,"PODEMOS-EUP",2
46,"46259",462,395,394,2,1,"PODEMOS-EUP",50
3,"3032",99,87,87,0,0,"PODEMOS-EUP",13
3,"3140",26027,19805,19438,230,367,"PODEMOS-EUP",2917
12,"12079",419,346,336,2,10,"PODEMOS-EUP",24
12,"12121",1044,941,915,4,26,"PODEMOS-EUP",56
3,"3904",1420,1112,1095,5,17,"PODEMOS-EUP",126
46,"46072",3542,3008,2961,33,47,"PODEMOS-EUP",349
46,"46904",805,643,628,13,15,"PODEMOS-EUP",66
46,"46089",2170,1692,1672,6,20,"PODEMOS-EUP",206
46,"46256",7211,5263,5209,27,54,"PODEMOS-EUP",644
3,"3009",46121,36093,35720,235,373,"PODEMOS-EUP",6512
3,"3102",7226,5600,5516,28,84,"PODEMOS-EUP",851
12,"12074",761,659,645,7,14,"PODEMOS-EUP",38
12,"12036",546,428,420,9,8,"PODEMOS-EUP",41
12,"12068",41,26,25,1,1,"PODEMOS-EUP",3
46,"46103",1338,1056,1042,5,14,"PODEMOS-EUP",154
3,"3030",563,474,466,2,8,"PODEMOS-EUP",90
46,"46249",9159,7113,7012,73,101,"PODEMOS-EUP",750
46,"46066",1285,1058,1043,6,15,"PODEMOS-EUP",115
46,"46140",377,312,312,2,0,"PODEMOS-EUP",31
3,"3098",518,412,400,1,12,"PODEMOS-EUP",55
12,"12113",87,65,64,0,1,"PODEMOS-EUP",10
46,"46033",196,169,168,3,1,"PODEMOS-EUP",6
12,"12061",380,277,274,2,3,"PODEMOS-EUP",18
46,"46198",871,707,693,4,14,"PODEMOS-EUP",102
46,"46185",364,315,310,1,5,"PODEMOS-EUP",35
3,"3031",41857,28648,28362,163,286,"PODEMOS-EUP",3515
46,"46037",1109,927,918,4,9,"PODEMOS-EUP",59
46,"46027",932,769,755,1,14,"PODEMOS-EUP",65
46,"46104",1891,1515,1481,17,34,"PODEMOS-EUP",133
12,"12104",6814,5486,5406,35,80,"PODEMOS-EUP",733
3,"3061",1054,830,816,3,14,"PODEMOS-EUP",59
46,"46017",32990,23940,23694,155,246,"PODEMOS-EUP",2992
46,"46078",28394,20928,20748,156,180,"PODEMOS-EUP",3798
3,"3054",336,277,272,2,5,"PODEMOS-EUP",34
46,"46203",3544,2851,2810,21,41,"PODEMOS-EUP",460
3,"3094",9626,7206,7138,42,68,"PODEMOS-EUP",1089
46,"46220",48968,35430,34964,306,466,"PODEMOS-EUP",7688
46,"46119",752,627,614,8,13,"PODEMOS-EUP",68
46,"46173",1319,1084,1062,6,22,"PODEMOS-EUP",151
12,"12018",283,242,235,0,7,"PODEMOS-EUP",23
46,"46042",3348,2825,2774,11,51,"PODEMOS-EUP",264
3,"3065",169399,128218,127256,967,962,"PODEMOS-EUP",16775
12,"12901",3357,2693,2675,19,18,"PODEMOS-EUP",306
46,"46193",8964,7206,7156,27,50,"PODEMOS-EUP",1118
46,"46214",16415,12723,12610,74,113,"PODEMOS-EUP",1945
46,"46211",1837,1490,1462,11,28,"PODEMOS-EUP",150
12,"12042",574,486,479,8,7,"PODEMOS-EUP",20
3,"3047",9711,6910,6791,36,119,"PODEMOS-EUP",967
46,"46245",528,430,426,2,4,"PODEMOS-EUP",68
3,"3050",19334,14377,14253,71,124,"PODEMOS-EUP",2171
12,"12020",120,107,107,0,0,"PODEMOS-EUP",3
46,"46201",62,47,47,0,0,"PODEMOS-EUP",1
3,"3003",455,395,388,0,7,"PODEMOS-EUP",47
12,"12110",219,168,166,1,2,"PODEMOS-EUP",15
46,"46049",268,231,228,1,3,"PODEMOS-EUP",25
46,"46128",1581,1324,1287,2,37,"PODEMOS-EUP",99
3,"3010",336,295,280,0,15,"PODEMOS-EUP",38
46,"46215",1397,1104,1093,12,11,"PODEMOS-EUP",252
12,"12028",12955,10391,10301,68,90,"PODEMOS-EUP",1473
46,"46902",356,300,296,8,4,"PODEMOS-EUP",40
12,"12046",182,161,161,1,0,"PODEMOS-EUP",16
12,"12025",121,102,99,0,3,"PODEMOS-EUP",15
46,"46199",5842,4451,4414,23,37,"PODEMOS-EUP",559
3,"3004",599,465,458,4,7,"PODEMOS-EUP",64
46,"46212",1590,1209,1192,4,17,"PODEMOS-EUP",175
12,"12095",950,763,756,9,7,"PODEMOS-EUP",94
3,"3096",5779,4433,4352,30,81,"PODEMOS-EUP",604
46,"46087",109,98,98,1,0,"PODEMOS-EUP",17
46,"46251",2442,2017,1976,9,41,"PODEMOS-EUP",217
3,"3132",515,417,414,4,3,"PODEMOS-EUP",54
46,"46243",124,105,104,0,1,"PODEMOS-EUP",7
46,"46108",426,346,342,1,4,"PODEMOS-EUP",24
12,"12055",106,85,83,2,2,"PODEMOS-EUP",9
3,"3014",238879,176118,174768,1105,1350,"PODEMOS-EUP",24290
3,"3005",7903,6247,6195,37,52,"PODEMOS-EUP",557
3,"3119",17223,13244,13116,75,128,"PODEMOS-EUP",1981
12,"12056",257,218,216,1,2,"PODEMOS-EUP",48
12,"12105",816,639,625,5,14,"PODEMOS-EUP",38
12,"12127",67,50,50,1,0,"PODEMOS-EUP",7
46,"46252",128,106,106,2,0,"PODEMOS-EUP",5
46,"46159",23051,17496,17359,104,137,"PODEMOS-EUP",2986
12,"12012",2613,2217,2180,6,37,"PODEMOS-EUP",339
46,"46068",345,308,307,4,1,"PODEMOS-EUP",26
3,"3903",2577,1996,1973,11,23,"PODEMOS-EUP",215
3,"3062",221,182,180,1,2,"PODEMOS-EUP",20
12,"12077",4790,3594,3565,39,29,"PODEMOS-EUP",500
46,"46062",4572,3571,3510,20,61,"PODEMOS-EUP",340
46,"46160",1907,1508,1485,5,23,"PODEMOS-EUP",224
46,"46052",508,436,426,3,10,"PODEMOS-EUP",42
12,"12106",1163,980,951,7,29,"PODEMOS-EUP",146
46,"46002",1215,963,959,5,4,"PODEMOS-EUP",146
46,"46083",15374,11259,11096,56,163,"PODEMOS-EUP",1510
46,"46082",4958,3801,3759,21,42,"PODEMOS-EUP",642
3,"3138",3183,2390,2359,16,31,"PODEMOS-EUP",277
3,"3043",2899,2466,2434,21,32,"PODEMOS-EUP",343
3,"3074",1750,1433,1427,3,6,"PODEMOS-EUP",89
46,"46248",4886,3672,3613,25,59,"PODEMOS-EUP",428
12,"12027",17473,12829,12683,90,146,"PODEMOS-EUP",1779
12,"12039",792,688,680,3,8,"PODEMOS-EUP",78
12,"12001",1033,834,825,8,9,"PODEMOS-EUP",91
3,"3017",379,321,311,1,10,"PODEMOS-EUP",82
3,"3034",1391,1107,1090,7,17,"PODEMOS-EUP",137
12,"12085",5079,3504,3459,13,45,"PODEMOS-EUP",420
12,"12037",17,17,17,1,0,"PODEMOS-EUP",0
46,"46154",797,645,630,1,15,"PODEMOS-EUP",55
46,"46060",9287,7184,7110,40,74,"PODEMOS-EUP",936
3,"3099",42876,32576,32172,192,404,"PODEMOS-EUP",3138
46,"46232",872,714,706,3,8,"PODEMOS-EUP",58
46,"46179",2116,1723,1678,18,45,"PODEMOS-EUP",196
12,"12139",302,219,217,3,2,"PODEMOS-EUP",27
46,"46158",1040,805,796,4,9,"PODEMOS-EUP",146
46,"46233",3781,2901,2847,22,54,"PODEMOS-EUP",401
46,"46142",761,580,565,4,15,"PODEMOS-EUP",58
3,"3122",43704,31952,31681,218,271,"PODEMOS-EUP",5171
3,"3002",3631,2841,2801,16,40,"PODEMOS-EUP",347
46,"46065",1576,1246,1228,6,18,"PODEMOS-EUP",187
3,"3076",8736,6571,6467,40,104,"PODEMOS-EUP",758
3,"3029",244,174,167,1,7,"PODEMOS-EUP",28
46,"46206",557,461,455,6,6,"PODEMOS-EUP",65
46,"46051",8384,6550,6452,24,98,"PODEMOS-EUP",659
3,"3059",20590,15909,15766,96,143,"PODEMOS-EUP",1803
46,"46012",929,727,707,3,20,"PODEMOS-EUP",105
12,"12034",1400,1108,1080,7,28,"PODEMOS-EUP",146
46,"46180",651,525,519,0,6,"PODEMOS-EUP",61
46,"46150",1797,1275,1257,9,18,"PODEMOS-EUP",136
46,"46164",12073,8987,8836,63,151,"PODEMOS-EUP",1237
12,"12050",1230,987,972,10,15,"PODEMOS-EUP",131
46,"46113",2527,1906,1892,12,14,"PODEMOS-EUP",221
46,"46225",348,279,273,2,6,"PODEMOS-EUP",46
46,"46056",175,156,156,3,0,"PODEMOS-EUP",23
3,"3063",27121,19869,19713,131,156,"PODEMOS-EUP",3104
46,"46076",591,497,487,0,10,"PODEMOS-EUP",40
46,"46241",389,318,313,4,5,"PODEMOS-EUP",68
12,"12081",602,488,481,0,7,"PODEMOS-EUP",61
3,"3092",6688,5444,5370,36,74,"PODEMOS-EUP",1065
3,"3084",497,429,429,4,0,"PODEMOS-EUP",47
46,"46167",345,255,255,0,0,"PODEMOS-EUP",27
46,"46205",14233,11274,11145,55,129,"PODEMOS-EUP",1537
46,"46005",23013,17487,17286,112,201,"PODEMOS-EUP",2904
3,"3060",106,84,84,0,0,"PODEMOS-EUP",18
3,"3041",6093,4444,4398,13,46,"PODEMOS-EUP",725
3,"3128",4295,3007,2982,24,25,"PODEMOS-EUP",378
12,"12123",43,35,34,1,1,"PODEMOS-EUP",3
46,"46148",1509,1208,1195,7,13,"PODEMOS-EUP",135
46,"46141",437,367,360,5,7,"PODEMOS-EUP",51
46,"46195",1982,1562,1554,2,8,"PODEMOS-EUP",173
46,"46044",4198,3399,3337,13,62,"PODEMOS-EUP",474
12,"12029",673,566,556,3,10,"PODEMOS-EUP",78
3,"3115",255,222,221,2,1,"PODEMOS-EUP",41
3,"3103",245,212,211,4,1,"PODEMOS-EUP",33
46,"46261",1709,1367,1340,14,27,"PODEMOS-EUP",225
3,"3101",4911,3827,3772,20,55,"PODEMOS-EUP",772
46,"46069",157,130,129,0,1,"PODEMOS-EUP",7
46,"46112",542,460,454,0,6,"PODEMOS-EUP",57
46,"46055",1284,1031,1021,2,10,"PODEMOS-EUP",137
46,"46024",444,339,335,1,4,"PODEMOS-EUP",33
46,"46262",213,170,165,1,5,"PODEMOS-EUP",17
46,"46258",2636,2100,2079,9,21,"PODEMOS-EUP",306
3,"3011",8014,5870,5810,38,60,"PODEMOS-EUP",761
12,"12134",135,102,100,0,2,"PODEMOS-EUP",9
46,"46122",2730,2103,2071,19,32,"PODEMOS-EUP",314
12,"12115",208,170,167,1,3,"PODEMOS-EUP",12
46,"46123",1948,1469,1446,5,23,"PODEMOS-EUP",196
46,"46263",239,204,200,3,4,"PODEMOS-EUP",23
3,"3130",43,23,23,0,0,"PODEMOS-EUP",2
46,"46153",435,364,356,1,8,"PODEMOS-EUP",51
46,"46234",327,264,263,5,1,"PODEMOS-EUP",33
46,"46022",15325,11197,11072,70,125,"PODEMOS-EUP",1767
3,"3091",241,201,196,0,5,"PODEMOS-EUP",15
46,"46143",4230,3255,3200,20,55,"PODEMOS-EUP",431
12,"12060",430,368,365,1,3,"PODEMOS-EUP",45
46,"46188",693,591,585,3,6,"PODEMOS-EUP",51
46,"46046",884,654,643,3,11,"PODEMOS-EUP",75
3,"3105",5471,4099,4003,14,96,"PODEMOS-EUP",501
12,"12071",1267,1021,1006,11,15,"PODEMOS-EUP",124
3,"3137",657,484,480,5,4,"PODEMOS-EUP",92
46,"46097",958,764,756,6,8,"PODEMOS-EUP",74
46,"46100",281,210,205,0,5,"PODEMOS-EUP",22
12,"12119",137,107,104,1,3,"PODEMOS-EUP",9
12,"12002",115,99,97,0,2,"PODEMOS-EUP",22
46,"46903",6285,5035,4996,27,39,"PODEMOS-EUP",628
46,"46254",943,751,734,4,17,"PODEMOS-EUP",65
12,"12033",1951,1528,1506,10,22,"PODEMOS-EUP",152
3,"3077",1374,1131,1114,9,17,"PODEMOS-EUP",127
12,"12051",448,324,319,2,5,"PODEMOS-EUP",15
3,"3045",213,178,173,4,5,"PODEMOS-EUP",9
3,"3075",149,125,125,0,0,"PODEMOS-EUP",18
12,"12041",100,76,75,0,1,"PODEMOS-EUP",1
46,"46067",1744,1451,1432,4,19,"PODEMOS-EUP",152
12,"12006",174,149,149,2,0,"PODEMOS-EUP",27
12,"12089",4546,3353,3304,12,49,"PODEMOS-EUP",378
3,"3104",27091,21366,21119,250,247,"PODEMOS-EUP",3657
12,"12076",76,64,64,1,0,"PODEMOS-EUP",5
46,"46028",388,324,319,1,5,"PODEMOS-EUP",64
46,"46008",2624,2036,1996,9,40,"PODEMOS-EUP",294
46,"46115",352,261,260,0,1,"PODEMOS-EUP",15
3,"3093",19713,15195,14988,108,207,"PODEMOS-EUP",2360
12,"12109",653,544,533,3,11,"PODEMOS-EUP",58
3,"3080",1328,1077,1064,4,13,"PODEMOS-EUP",86
12,"12087",25,19,18,2,1,"PODEMOS-EUP",1
46,"46045",1243,1033,1018,3,15,"PODEMOS-EUP",276
3,"3039",89,70,70,0,0,"PODEMOS-EUP",14
46,"46204",6657,5262,5204,27,58,"PODEMOS-EUP",674
12,"12024",133,117,117,0,0,"PODEMOS-EUP",21
3,"3123",7576,5900,5814,36,86,"PODEMOS-EUP",761
46,"46086",80,69,69,0,0,"PODEMOS-EUP",18
3,"3095",4740,3702,3657,23,45,"PODEMOS-EUP",569
46,"46177",4778,3767,3711,17,56,"PODEMOS-EUP",646
12,"12114",194,161,160,2,1,"PODEMOS-EUP",13
46,"46157",2960,2329,2296,12,33,"PODEMOS-EUP",258
46,"46111",11326,8603,8492,55,111,"PODEMOS-EUP",1186
46,"46208",1070,875,866,2,9,"PODEMOS-EUP",118
46,"46187",1304,991,982,8,9,"PODEMOS-EUP",118
12,"12099",586,449,434,3,15,"PODEMOS-EUP",54
46,"46216",5252,4291,4263,23,28,"PODEMOS-EUP",586
46,"46070",17700,13558,13437,115,121,"PODEMOS-EUP",1561
46,"46118",3670,2930,2894,25,36,"PODEMOS-EUP",334
46,"46131",49504,37495,37064,259,431,"PODEMOS-EUP",4889
46,"46040",995,807,794,7,13,"PODEMOS-EUP",93
3,"3028",964,804,795,6,9,"PODEMOS-EUP",105
46,"46222",394,325,324,1,1,"PODEMOS-EUP",52
12,"12015",114,99,98,0,1,"PODEMOS-EUP",12
46,"46050",186,157,154,1,3,"PODEMOS-EUP",22
12,"12096",744,588,580,7,8,"PODEMOS-EUP",88
3,"3052",967,805,790,4,15,"PODEMOS-EUP",83
46,"46135",9827,7928,7883,44,45,"PODEMOS-EUP",1216
3,"3133",41499,26593,26308,151,285,"PODEMOS-EUP",3672
3,"3016",91,77,77,1,0,"PODEMOS-EUP",11
12,"12090",104,85,83,1,2,"PODEMOS-EUP",4
3,"3012",1133,910,897,7,13,"PODEMOS-EUP",81
46,"46129",512,408,400,4,8,"PODEMOS-EUP",128
12,"12124",1840,1477,1460,8,17,"PODEMOS-EUP",118
3,"3121",21787,15670,15453,81,217,"PODEMOS-EUP",2221
3,"3136",410,329,323,3,6,"PODEMOS-EUP",51
46,"46147",17133,12260,12120,59,140,"PODEMOS-EUP",1737
46,"46260",2647,2136,2113,8,23,"PODEMOS-EUP",312
46,"46228",2417,1953,1913,13,40,"PODEMOS-EUP",254
12,"12067",523,423,416,1,7,"PODEMOS-EUP",48
46,"46102",19635,15330,15207,95,123,"PODEMOS-EUP",2455
3,"3013",1070,882,869,3,13,"PODEMOS-EUP",60
46,"46032",5692,4518,4476,22,42,"PODEMOS-EUP",772
46,"46210",344,265,258,2,7,"PODEMOS-EUP",27
46,"46184",26453,21076,20810,172,266,"PODEMOS-EUP",3536
46,"46218",1031,907,885,6,22,"PODEMOS-EUP",60
12,"12057",578,485,473,3,12,"PODEMOS-EUP",53
3,"3069",3311,2356,2327,12,29,"PODEMOS-EUP",310
46,"46238",13105,9717,9610,57,107,"PODEMOS-EUP",1516
46,"46004",1919,1641,1616,14,25,"PODEMOS-EUP",154
46,"46202",17660,13782,13645,93,137,"PODEMOS-EUP",1938
46,"46020",3792,3028,2973,11,55,"PODEMOS-EUP",355
3,"3053",7469,5950,5865,26,85,"PODEMOS-EUP",837
12,"12120",161,138,138,0,0,"PODEMOS-EUP",8
46,"46224",154,124,124,2,0,"PODEMOS-EUP",11
46,"46244",59626,44018,43679,342,339,"PODEMOS-EUP",5630
46,"46226",31,27,27,0,0,"PODEMOS-EUP",1
46,"46161",1472,1200,1172,7,28,"PODEMOS-EUP",160
46,"46015",7477,5857,5808,33,49,"PODEMOS-EUP",899
46,"46101",816,696,687,3,9,"PODEMOS-EUP",83
46,"46196",140,115,114,0,1,"PODEMOS-EUP",6
46,"46035",6855,5500,5422,34,78,"PODEMOS-EUP",769
46,"46126",5574,4565,4528,25,37,"PODEMOS-EUP",665
3,"3033",102,87,85,0,2,"PODEMOS-EUP",10
12,"12080",1900,1604,1575,10,29,"PODEMOS-EUP",140
46,"46162",1177,954,938,4,16,"PODEMOS-EUP",69
46,"46172",5412,3878,3832,18,46,"PODEMOS-EUP",613
3,"3134",141,119,117,0,2,"PODEMOS-EUP",18
12,"12117",3545,2770,2698,11,72,"PODEMOS-EUP",316
3,"3112",637,526,520,0,6,"PODEMOS-EUP",52
12,"12048",249,181,175,2,6,"PODEMOS-EUP",13
46,"46236",937,764,755,5,9,"PODEMOS-EUP",146
12,"12043",560,460,450,2,10,"PODEMOS-EUP",69
12,"12049",421,339,329,2,10,"PODEMOS-EUP",68
12,"12016",1550,1281,1260,11,21,"PODEMOS-EUP",98
46,"46096",257,220,217,0,3,"PODEMOS-EUP",29
46,"46095",578,467,458,1,9,"PODEMOS-EUP",35
46,"46186",19529,15294,15125,69,169,"PODEMOS-EUP",2258
3,"3049",12143,9418,9302,47,116,"PODEMOS-EUP",1099
12,"12902",2248,1678,1653,7,25,"PODEMOS-EUP",212
12,"12059",228,191,188,0,3,"PODEMOS-EUP",28
46,"46127",2740,2174,2147,11,27,"PODEMOS-EUP",276
12,"12032",23649,17680,17505,118,175,"PODEMOS-EUP",2144
12,"12069",53,45,44,1,1,"PODEMOS-EUP",2
12,"12098",533,446,440,4,6,"PODEMOS-EUP",25
46,"46125",846,681,675,1,6,"PODEMOS-EUP",77
46,"46034",1811,1407,1389,13,18,"PODEMOS-EUP",188
12,"12063",44,37,37,1,0,"PODEMOS-EUP",15
12,"12044",452,403,400,4,3,"PODEMOS-EUP",39
46,"46227",888,708,693,6,15,"PODEMOS-EUP",109
46,"46105",16132,11703,11582,64,121,"PODEMOS-EUP",1208
3,"3051",344,312,307,2,5,"PODEMOS-EUP",38
46,"46217",893,733,723,6,10,"PODEMOS-EUP",76
46,"46133",472,374,374,2,0,"PODEMOS-EUP",23
3,"3124",460,401,390,2,11,"PODEMOS-EUP",63
12,"12026",835,656,639,4,17,"PODEMOS-EUP",52
3,"3042",1462,1025,1008,3,17,"PODEMOS-EUP",160
46,"46054",11390,8717,8604,52,113,"PODEMOS-EUP",1417
26,"26069",230,187,186,0,1,"PODEMOS-IU-",10
44,"44155",1056,830,813,9,17,"PODEMOS-IU-",156
45,"45106",7395,5971,5861,40,110,"PODEMOS-IU-",638
28,"28090",9128,7590,7516,54,74,"PODEMOS-IU-",1294
40,"40076",6537,5130,5012,22,118,"PODEMOS-IU-",629
50,"50024",556,427,426,6,1,"PODEMOS-IU-",46
26,"26003",389,329,328,1,1,"PODEMOS-IU-",14
37,"37332",70,53,53,0,0,"PODEMOS-IU-",0
6,"6095",9511,7338,7152,116,186,"PODEMOS-IU-",753
13,"13027",3223,2343,2309,22,34,"PODEMOS-IU-",114
42,"42196",8,6,6,0,0,"PODEMOS-IU-",0
37,"37166",199,146,144,0,2,"PODEMOS-IU-",2
40,"40110",316,254,253,2,1,"PODEMOS-IU-",14
2,"2074",5891,4435,4375,41,60,"PODEMOS-IU-",390
9,"9346",89,69,68,1,1,"PODEMOS-IU-",6
19,"19052",21,16,16,0,0,"PODEMOS-IU-",0
26,"26002",827,643,639,5,4,"PODEMOS-IU-",54
37,"37317",288,240,238,2,2,"PODEMOS-IU-",8
50,"50034",787,568,556,3,12,"PODEMOS-IU-",59
50,"50295",49,46,46,0,0,"PODEMOS-IU-",6
10,"10024",675,518,505,4,13,"PODEMOS-IU-",62
9,"9361",112,94,94,1,0,"PODEMOS-IU-",5
19,"19109",33,30,30,1,0,"PODEMOS-IU-",1
9,"9022",61,54,54,0,0,"PODEMOS-IU-",4
9,"9033",81,69,68,1,1,"PODEMOS-IU-",7
40,"40148",228,185,180,0,5,"PODEMOS-IU-",14
44,"44097",126,91,90,2,1,"PODEMOS-IU-",1
37,"37018",110,86,85,1,1,"PODEMOS-IU-",3
42,"42088",60,53,53,0,0,"PODEMOS-IU-",2
5,"5212",197,138,136,0,2,"PODEMOS-IU-",0
2,"2027",283,239,238,3,1,"PODEMOS-IU-",11
47,"47228",439,353,352,1,1,"PODEMOS-IU-",23
47,"47007",4036,3261,3217,25,44,"PODEMOS-IU-",482
42,"42058",102,84,84,0,0,"PODEMOS-IU-",0
42,"42110",55,43,43,0,0,"PODEMOS-IU-",2
24,"24049",1415,1146,1134,8,12,"PODEMOS-IU-",136
9,"9085",472,371,365,3,6,"PODEMOS-IU-",43
47,"47019",91,74,73,0,1,"PODEMOS-IU-",5
28,"28006",80622,64905,64483,400,422,"PODEMOS-IU-",8310
50,"50902",79,69,69,0,0,"PODEMOS-IU-",5
37,"37223",112,78,76,0,2,"PODEMOS-IU-",6
50,"50262",1163,930,912,15,18,"PODEMOS-IU-",145
45,"45011",275,241,238,2,3,"PODEMOS-IU-",3
24,"24022",306,227,224,1,3,"PODEMOS-IU-",30
50,"50284",132,105,104,1,1,"PODEMOS-IU-",16
42,"42050",27,21,21,1,0,"PODEMOS-IU-",0
50,"50117",125,100,100,3,0,"PODEMOS-IU-",10
49,"49185",156,126,120,1,6,"PODEMOS-IU-",6
2,"2063",1375,1067,1047,1,20,"PODEMOS-IU-",29
37,"37374",1147,946,923,4,23,"PODEMOS-IU-",32
9,"9358",248,186,179,1,7,"PODEMOS-IU-",13
10,"10077",637,501,499,3,2,"PODEMOS-IU-",31
37,"37174",983,788,768,0,20,"PODEMOS-IU-",25
42,"42142",45,35,35,0,0,"PODEMOS-IU-",0
49,"49065",1073,789,777,3,12,"PODEMOS-IU-",30
50,"50143",546,409,401,5,8,"PODEMOS-IU-",36
44,"44241",506,416,407,1,9,"PODEMOS-IU-",46
42,"42162",2325,1721,1699,16,22,"PODEMOS-IU-",95
24,"24144",639,469,462,2,7,"PODEMOS-IU-",42
16,"16163",60,50,50,0,0,"PODEMOS-IU-",3
49,"49012",73,45,45,0,0,"PODEMOS-IU-",2
16,"16237",98,83,83,0,0,"PODEMOS-IU-",8
45,"45124",2069,1757,1718,14,39,"PODEMOS-IU-",89
5,"5001",179,153,152,2,1,"PODEMOS-IU-",9
24,"24224",574,435,427,3,8,"PODEMOS-IU-",33
24,"24009",278,154,151,2,3,"PODEMOS-IU-",27
37,"37159",79,68,68,0,0,"PODEMOS-IU-",3
6,"6003",766,625,610,3,15,"PODEMOS-IU-",39
38,"38033",3594,2512,2467,11,45,"PODEMOS-IU-",199
9,"9466",112,87,85,2,2,"PODEMOS-IU-",6
39,"39053",213,146,145,2,1,"PODEMOS-IU-",4
40,"40159",132,101,101,0,0,"PODEMOS-IU-",3
37,"37038",751,607,592,4,15,"PODEMOS-IU-",50
44,"44129",36,29,29,0,0,"PODEMOS-IU-",3
50,"50065",55,43,43,1,0,"PODEMOS-IU-",4
26,"26152",27,23,23,1,0,"PODEMOS-IU-",3
40,"40109",72,59,54,1,5,"PODEMOS-IU-",1
19,"19066",50,43,43,0,0,"PODEMOS-IU-",5
47,"47070",30,26,25,0,1,"PODEMOS-IU-",0
6,"6069",3005,2172,2133,24,39,"PODEMOS-IU-",126
26,"26172",25,23,23,0,0,"PODEMOS-IU-",3
9,"9355",87,69,67,1,2,"PODEMOS-IU-",1
5,"5013",847,708,701,0,7,"PODEMOS-IU-",124
37,"37163",32,27,27,0,0,"PODEMOS-IU-",5
24,"24080",207,162,161,0,1,"PODEMOS-IU-",12
19,"19004",59,52,52,0,0,"PODEMOS-IU-",0
37,"37216",294,248,247,2,1,"PODEMOS-IU-",3
6,"6078",506,415,410,1,5,"PODEMOS-IU-",18
10,"10182",124,91,90,0,1,"PODEMOS-IU-",7
24,"24082",860,690,678,12,12,"PODEMOS-IU-",106
44,"44222",122,102,102,1,0,"PODEMOS-IU-",2
49,"49071",715,500,499,3,1,"PODEMOS-IU-",21
34,"34127",80,64,64,1,0,"PODEMOS-IU-",3
2,"2014",350,285,280,1,5,"PODEMOS-IU-",35
10,"10095",314,260,255,2,5,"PODEMOS-IU-",8
47,"47177",100,80,79,0,1,"PODEMOS-IU-",9
9,"9903",3139,2379,2352,27,27,"PODEMOS-IU-",312
37,"37049",127,89,89,0,0,"PODEMOS-IU-",5
26,"26160",732,578,574,4,4,"PODEMOS-IU-",43
24,"24099",155,121,121,1,0,"PODEMOS-IU-",16
47,"47052",6752,5665,5589,57,76,"PODEMOS-IU-",877
10,"10211",447,345,343,2,2,"PODEMOS-IU-",19
24,"24152",447,301,296,1,5,"PODEMOS-IU-",32
9,"9460",167,149,149,5,0,"PODEMOS-IU-",10
50,"50196",102,83,81,2,2,"PODEMOS-IU-",6
44,"44014",2499,2015,1963,25,52,"PODEMOS-IU-",331
13,"13034",58768,46017,45585,385,432,"PODEMOS-IU-",4707
47,"47091",74,64,63,1,1,"PODEMOS-IU-",6
9,"9429",55,41,41,0,0,"PODEMOS-IU-",4
19,"19171",5302,4297,4238,24,59,"PODEMOS-IU-",680
26,"26063",118,96,95,2,1,"PODEMOS-IU-",9
40,"40101",923,737,728,8,9,"PODEMOS-IU-",103
37,"37274",118473,91137,90221,811,916,"PODEMOS-IU-",7973
37,"37299",229,175,168,0,7,"PODEMOS-IU-",11
19,"19245",1145,904,880,8,24,"PODEMOS-IU-",67
10,"10146",1513,1128,1104,6,24,"PODEMOS-IU-",87
19,"19222",96,73,72,2,1,"PODEMOS-IU-",5
19,"19088",95,82,82,2,0,"PODEMOS-IU-",3
13,"13073",497,394,390,1,4,"PODEMOS-IU-",12
24,"24007",753,569,563,4,6,"PODEMOS-IU-",108
19,"19057",72,59,58,0,1,"PODEMOS-IU-",18
19,"19190",2302,1788,1767,13,21,"PODEMOS-IU-",233
45,"45096",987,829,813,3,16,"PODEMOS-IU-",197
49,"49083",50,41,41,1,0,"PODEMOS-IU-",1
26,"26037",131,99,98,1,1,"PODEMOS-IU-",15
19,"19219",9,7,7,0,0,"PODEMOS-IU-",1
37,"37270",183,143,140,1,3,"PODEMOS-IU-",4
16,"16278",63,51,51,0,0,"PODEMOS-IU-",2
10,"10202",588,469,459,0,10,"PODEMOS-IU-",37
42,"42187",59,51,49,1,2,"PODEMOS-IU-",2
2,"2052",466,394,394,3,0,"PODEMOS-IU-",33
40,"40113",408,339,335,6,4,"PODEMOS-IU-",51
50,"50060",170,137,135,2,2,"PODEMOS-IU-",23
37,"37372",134,104,104,0,0,"PODEMOS-IU-",5
16,"16175",5079,4279,4207,40,72,"PODEMOS-IU-",269
39,"39047",1976,1564,1538,8,26,"PODEMOS-IU-",109
9,"9283",44,33,33,0,0,"PODEMOS-IU-",0
49,"49050",504,351,351,3,0,"PODEMOS-IU-",32
34,"34028",134,110,107,3,3,"PODEMOS-IU-",7
9,"9368",28,21,21,1,0,"PODEMOS-IU-",0
37,"37276",126,101,101,0,0,"PODEMOS-IU-",3
37,"37122",203,174,174,1,0,"PODEMOS-IU-",8
49,"49013",229,176,175,4,1,"PODEMOS-IU-",5
40,"40134",697,560,548,7,12,"PODEMOS-IU-",32
45,"45073",287,226,225,1,1,"PODEMOS-IU-",19
9,"9038",111,95,95,0,0,"PODEMOS-IU-",9
40,"40034",75,63,62,1,1,"PODEMOS-IU-",2
47,"47028",30,17,17,0,0,"PODEMOS-IU-",0
50,"50258",53,33,33,3,0,"PODEMOS-IU-",2
49,"49021",14258,10333,10206,102,127,"PODEMOS-IU-",1020
9,"9303",75,67,67,0,0,"PODEMOS-IU-",3
9,"9169",97,86,85,0,1,"PODEMOS-IU-",11
44,"44219",173,142,136,1,6,"PODEMOS-IU-",14
39,"39065",232,190,189,5,1,"PODEMOS-IU-",23
42,"42121",55,42,42,0,0,"PODEMOS-IU-",1
34,"34012",340,271,265,2,6,"PODEMOS-IU-",25
39,"39095",2240,1809,1778,12,31,"PODEMOS-IU-",179
19,"19188",43,34,33,0,1,"PODEMOS-IU-",0
40,"40001",706,597,590,7,7,"PODEMOS-IU-",31
42,"42116",42,30,30,1,0,"PODEMOS-IU-",3
6,"6132",829,598,593,0,5,"PODEMOS-IU-",91
47,"47089",132,116,115,1,1,"PODEMOS-IU-",3
9,"9440",80,66,66,0,0,"PODEMOS-IU-",2
26,"26153",10,9,9,0,0,"PODEMOS-IU-",1
40,"40142",52,42,40,0,2,"PODEMOS-IU-",1
44,"44199",39,39,38,5,1,"PODEMOS-IU-",2
34,"34091",122,103,102,4,1,"PODEMOS-IU-",5
28,"28127",66441,56199,55932,327,267,"PODEMOS-IU-",5141
50,"50291",93,78,77,1,1,"PODEMOS-IU-",4
49,"49006",142,111,111,1,0,"PODEMOS-IU-",10
44,"44183",63,43,43,0,0,"PODEMOS-IU-",1
50,"50207",93,68,67,2,1,"PODEMOS-IU-",4
37,"37178",99,82,82,0,0,"PODEMOS-IU-",0
9,"9334",48,37,35,0,2,"PODEMOS-IU-",3
50,"50014",119,85,85,0,0,"PODEMOS-IU-",10
39,"39032",1426,1156,1141,8,15,"PODEMOS-IU-",58
24,"24024",638,463,452,8,11,"PODEMOS-IU-",44
34,"34167",110,88,88,0,0,"PODEMOS-IU-",1
19,"19272",65,58,56,1,2,"PODEMOS-IU-",2
10,"10020",1576,1259,1225,9,34,"PODEMOS-IU-",100
34,"34108",502,424,415,6,9,"PODEMOS-IU-",29
37,"37040",382,319,316,1,3,"PODEMOS-IU-",12
37,"37118",120,93,90,2,3,"PODEMOS-IU-",2
37,"37181",264,185,184,1,1,"PODEMOS-IU-",3
34,"34904",300,220,220,0,0,"PODEMOS-IU-",12
42,"42195",92,53,53,1,0,"PODEMOS-IU-",2
39,"39073",10200,8230,8150,65,80,"PODEMOS-IU-",784
30,"30043",25401,20378,19992,131,386,"PODEMOS-IU-",2603
5,"5104",33,24,23,0,1,"PODEMOS-IU-",4
50,"50011",116,100,99,0,1,"PODEMOS-IU-",10
44,"44106",153,115,111,2,4,"PODEMOS-IU-",13
24,"24018",174,141,139,0,2,"PODEMOS-IU-",14
9,"9014",192,143,142,0,1,"PODEMOS-IU-",14
10,"10012",564,469,464,1,5,"PODEMOS-IU-",40
9,"9327",29,22,22,0,0,"PODEMOS-IU-",0
6,"6060",5723,4401,4323,31,78,"PODEMOS-IU-",532
47,"47196",28,24,24,0,0,"PODEMOS-IU-",0
19,"19237",40,33,33,0,0,"PODEMOS-IU-",5
35,"35022",51302,33009,32566,198,443,"PODEMOS-IU-",5595
28,"28171",4382,3202,3134,11,68,"PODEMOS-IU-",348
50,"50178",276,193,193,4,0,"PODEMOS-IU-",20
49,"49062",105,69,69,1,0,"PODEMOS-IU-",7
34,"34066",57,52,48,1,4,"PODEMOS-IU-",3
2,"2013",135,113,110,0,3,"PODEMOS-IU-",7
42,"42034",44,36,36,1,0,"PODEMOS-IU-",4
34,"34060",135,111,110,0,1,"PODEMOS-IU-",13
37,"37062",77,65,63,0,2,"PODEMOS-IU-",1
50,"50204",2394,1876,1855,21,21,"PODEMOS-IU-",249
5,"5102",1681,1358,1329,4,29,"PODEMOS-IU-",72
37,"37257",49,40,40,1,0,"PODEMOS-IU-",4
40,"40125",75,61,61,2,0,"PODEMOS-IU-",5
37,"37254",175,141,140,1,1,"PODEMOS-IU-",7
19,"19246",42,30,30,0,0,"PODEMOS-IU-",1
42,"42124",58,41,41,0,0,"PODEMOS-IU-",5
49,"49271",181,147,144,1,3,"PODEMOS-IU-",6
44,"44169",310,250,245,4,5,"PODEMOS-IU-",20
44,"44133",15,12,12,0,0,"PODEMOS-IU-",0
28,"28094",959,736,729,6,7,"PODEMOS-IU-",172
5,"5012",121,100,97,0,3,"PODEMOS-IU-",0
34,"34053",200,176,171,5,5,"PODEMOS-IU-",5
34,"34005",792,659,645,5,14,"PODEMOS-IU-",53
50,"50189",678,544,534,5,10,"PODEMOS-IU-",73
24,"24167",716,516,505,4,11,"PODEMOS-IU-",50
5,"5237",155,131,129,1,2,"PODEMOS-IU-",1
6,"6036",4958,3785,3728,22,57,"PODEMOS-IU-",281
37,"37191",104,65,65,1,0,"PODEMOS-IU-",0
19,"19191",13,12,12,0,0,"PODEMOS-IU-",3
45,"45103",362,306,299,0,7,"PODEMOS-IU-",7
13,"13012",382,279,277,2,2,"PODEMOS-IU-",14
34,"34049",329,251,247,5,4,"PODEMOS-IU-",23
5,"5059",92,63,63,0,0,"PODEMOS-IU-",11
2,"2081",18331,14219,13987,108,232,"PODEMOS-IU-",1512
40,"40018",75,60,60,0,0,"PODEMOS-IU-",4
47,"47105",175,152,149,1,3,"PODEMOS-IU-",9
2,"2028",118,99,98,4,1,"PODEMOS-IU-",2
42,"42043",3838,2897,2855,18,42,"PODEMOS-IU-",249
5,"5184",240,207,204,1,3,"PODEMOS-IU-",16
37,"37316",716,576,565,4,11,"PODEMOS-IU-",15
50,"50080",34,29,29,0,0,"PODEMOS-IU-",12
24,"24168",439,365,360,3,5,"PODEMOS-IU-",20
2,"2016",538,405,401,4,4,"PODEMOS-IU-",23
40,"40154",23,20,20,0,0,"PODEMOS-IU-",0
9,"9024",150,116,114,0,2,"PODEMOS-IU-",9
49,"49053",915,726,715,5,11,"PODEMOS-IU-",57
19,"19064",64,56,56,0,0,"PODEMOS-IU-",4
13,"13065",2813,1993,1971,13,22,"PODEMOS-IU-",94
26,"26045",11,11,11,0,0,"PODEMOS-IU-",0
5,"5053",80,57,57,2,0,"PODEMOS-IU-",0
45,"45070",1406,1201,1188,4,13,"PODEMOS-IU-",108
26,"26056",403,334,328,2,6,"PODEMOS-IU-",31
49,"49263",45,37,37,0,0,"PODEMOS-IU-",0
37,"37169",176,138,137,1,1,"PODEMOS-IU-",4
9,"9458",484,408,401,5,7,"PODEMOS-IU-",66
35,"35002",24129,16979,16736,116,243,"PODEMOS-IU-",2951
40,"40158",15,13,13,1,0,"PODEMOS-IU-",0
28,"28125",3216,2459,2444,11,15,"PODEMOS-IU-",341
9,"9176",59,50,47,2,3,"PODEMOS-IU-",5
40,"40104",284,229,224,2,5,"PODEMOS-IU-",40
50,"50114",132,111,111,1,0,"PODEMOS-IU-",10
34,"34029",659,557,551,5,6,"PODEMOS-IU-",13
24,"24183",752,549,543,8,6,"PODEMOS-IU-",56
26,"26058",143,116,115,2,1,"PODEMOS-IU-",19
19,"19117",1611,1279,1257,7,22,"PODEMOS-IU-",163
49,"49111",121,100,100,3,0,"PODEMOS-IU-",5
49,"49123",532,406,402,2,4,"PODEMOS-IU-",37
47,"47121",521,429,422,5,7,"PODEMOS-IU-",18
16,"16236",865,669,665,2,4,"PODEMOS-IU-",13
40,"40121",249,196,193,4,3,"PODEMOS-IU-",17
44,"44052",74,50,49,0,1,"PODEMOS-IU-",2
37,"37377",218,181,176,2,5,"PODEMOS-IU-",4
26,"26052",148,113,113,1,0,"PODEMOS-IU-",6
9,"9051",163,134,133,1,1,"PODEMOS-IU-",11
50,"50193",663,536,516,1,20,"PODEMOS-IU-",104
50,"50078",231,173,171,0,2,"PODEMOS-IU-",17
49,"49269",220,163,162,1,1,"PODEMOS-IU-",7
34,"34218",445,352,345,2,7,"PODEMOS-IU-",20
49,"49124",237,169,166,1,3,"PODEMOS-IU-",11
44,"44007",152,120,117,0,3,"PODEMOS-IU-",2
37,"37286",203,147,142,2,5,"PODEMOS-IU-",27
42,"42085",178,133,133,3,0,"PODEMOS-IU-",6
47,"47184",541,447,441,0,6,"PODEMOS-IU-",26
19,"19270",25,21,21,0,0,"PODEMOS-IU-",0
28,"28001",80,64,64,0,0,"PODEMOS-IU-",15
19,"19106",76,57,57,0,0,"PODEMOS-IU-",6
16,"16198",1299,1044,1027,11,17,"PODEMOS-IU-",64
28,"28107",442,336,325,3,11,"PODEMOS-IU-",36
26,"26178",71,57,56,1,1,"PODEMOS-IU-",2
49,"49058",298,244,242,1,2,"PODEMOS-IU-",3
5,"5061",261,214,208,0,6,"PODEMOS-IU-",23
45,"45127",764,582,577,3,5,"PODEMOS-IU-",85
45,"45183",2337,1743,1704,7,39,"PODEMOS-IU-",289
50,"50280",301,246,240,1,6,"PODEMOS-IU-",29
39,"39038",1506,1093,1076,2,17,"PODEMOS-IU-",154
26,"26038",81,61,61,0,0,"PODEMOS-IU-",5
38,"38042",3781,2799,2774,11,25,"PODEMOS-IU-",328
37,"37088",199,151,149,1,2,"PODEMOS-IU-",7
49,"49040",112,97,97,0,0,"PODEMOS-IU-",9
2,"2030",2978,2357,2315,13,42,"PODEMOS-IU-",180
34,"34210",103,90,90,1,0,"PODEMOS-IU-",2
9,"9298",75,62,62,1,0,"PODEMOS-IU-",4
47,"47090",2435,1956,1921,12,35,"PODEMOS-IU-",196
49,"49102",183,136,135,2,1,"PODEMOS-IU-",5
40,"40053",83,62,62,1,0,"PODEMOS-IU-",6
47,"47155",3410,2694,2660,21,34,"PODEMOS-IU-",409
37,"37156",4276,2621,2572,27,49,"PODEMOS-IU-",143
45,"45006",1326,983,972,6,11,"PODEMOS-IU-",64
2,"2023",515,442,435,1,7,"PODEMOS-IU-",19
34,"34062",150,108,107,1,1,"PODEMOS-IU-",3
26,"26075",321,266,265,0,1,"PODEMOS-IU-",22
19,"19200",64,56,56,0,0,"PODEMOS-IU-",8
44,"44250",19,15,15,0,0,"PODEMOS-IU-",1
49,"49056",288,232,230,2,2,"PODEMOS-IU-",7
16,"16240",100,77,76,0,1,"PODEMOS-IU-",5
19,"19213",70,53,52,0,1,"PODEMOS-IU-",1
6,"6151",1054,791,778,2,13,"PODEMOS-IU-",64
10,"10089",1328,1014,982,20,32,"PODEMOS-IU-",90
50,"50091",40,35,35,0,0,"PODEMOS-IU-",0
28,"28165",1910,1443,1430,11,13,"PODEMOS-IU-",124
24,"24161",295,223,219,0,4,"PODEMOS-IU-",39
24,"24043",122,71,69,0,2,"PODEMOS-IU-",6
26,"26144",188,161,160,1,1,"PODEMOS-IU-",15
34,"34140",96,69,69,1,0,"PODEMOS-IU-",1
9,"9377",629,494,488,4,6,"PODEMOS-IU-",35
6,"6112",383,334,334,1,0,"PODEMOS-IU-",22
38,"38031",29154,22871,22598,143,273,"PODEMOS-IU-",2524
49,"49251",161,125,124,0,1,"PODEMOS-IU-",5
49,"49239",617,437,420,7,17,"PODEMOS-IU-",15
49,"49142",249,175,173,0,2,"PODEMOS-IU-",12
50,"50079",227,182,178,1,4,"PODEMOS-IU-",12
49,"49087",483,322,320,2,2,"PODEMOS-IU-",4
19,"19271",41,26,26,0,0,"PODEMOS-IU-",0
19,"19198",17,17,17,0,0,"PODEMOS-IU-",1
19,"19089",25,19,19,1,0,"PODEMOS-IU-",3
6,"6902",1663,1273,1252,4,21,"PODEMOS-IU-",129
37,"37117",1553,1245,1230,14,15,"PODEMOS-IU-",131
10,"10213",534,447,441,5,6,"PODEMOS-IU-",18
37,"37379",173,152,152,0,0,"PODEMOS-IU-",8
38,"38028",22035,15684,15522,86,162,"PODEMOS-IU-",1962
34,"34052",167,144,143,2,1,"PODEMOS-IU-",19
16,"16205",107,80,79,0,1,"PODEMOS-IU-",10
13,"13062",559,478,471,1,7,"PODEMOS-IU-",43
42,"42092",62,42,41,1,1,"PODEMOS-IU-",1
2,"2015",1433,1234,1214,7,20,"PODEMOS-IU-",72
19,"19220",2536,1833,1813,9,20,"PODEMOS-IU-",342
40,"40162",387,286,278,3,8,"PODEMOS-IU-",18
26,"26079",620,526,521,0,5,"PODEMOS-IU-",32
49,"49170",98,75,75,1,0,"PODEMOS-IU-",4
40,"40118",47,38,37,2,1,"PODEMOS-IU-",4
30,"30015",19372,14430,14283,91,147,"PODEMOS-IU-",1014
38,"38032",13536,9924,9867,63,57,"PODEMOS-IU-",1562
9,"9191",33,24,24,0,0,"PODEMOS-IU-",2
5,"5219",37,30,30,0,0,"PODEMOS-IU-",0
37,"37302",262,182,181,2,1,"PODEMOS-IU-",3
40,"40172",45,37,37,0,0,"PODEMOS-IU-",3
42,"42167",236,183,182,3,1,"PODEMOS-IU-",16
34,"34201",171,139,139,0,0,"PODEMOS-IU-",7
50,"50269",279,189,186,1,3,"PODEMOS-IU-",4
37,"37290",134,113,112,0,1,"PODEMOS-IU-",6
37,"37370",308,256,254,2,2,"PODEMOS-IU-",17
6,"6059",1759,1300,1285,12,15,"PODEMOS-IU-",107
13,"13048",506,388,384,3,4,"PODEMOS-IU-",52
9,"9039",56,44,44,0,0,"PODEMOS-IU-",0
10,"10025",379,328,317,3,11,"PODEMOS-IU-",47
13,"13003",449,346,343,0,3,"PODEMOS-IU-",22
50,"50285",650,466,462,7,4,"PODEMOS-IU-",41
50,"50082",84,63,63,0,0,"PODEMOS-IU-",6
42,"42095",1857,1498,1473,21,25,"PODEMOS-IU-",161
40,"40071",43,37,31,0,6,"PODEMOS-IU-",1
26,"26149",45,36,36,0,0,"PODEMOS-IU-",1
47,"47093",797,628,615,6,13,"PODEMOS-IU-",93
37,"37279",726,570,562,6,8,"PODEMOS-IU-",20
26,"26082",100,85,85,0,0,"PODEMOS-IU-",3
9,"9365",27,19,19,1,0,"PODEMOS-IU-",1
5,"5253",78,62,60,0,2,"PODEMOS-IU-",5
9,"9055",48,34,34,1,0,"PODEMOS-IU-",2
5,"5179",199,181,175,0,6,"PODEMOS-IU-",1
6,"6079",644,492,487,3,5,"PODEMOS-IU-",12
40,"40055",32,26,25,0,1,"PODEMOS-IU-",1
9,"9166",98,77,77,1,0,"PODEMOS-IU-",6
42,"42115",95,77,77,1,0,"PODEMOS-IU-",7
45,"45108",482,385,382,0,3,"PODEMOS-IU-",8
47,"47087",368,292,288,3,4,"PODEMOS-IU-",26
44,"44224",21,15,15,0,0,"PODEMOS-IU-",2
19,"19267",21,17,17,1,0,"PODEMOS-IU-",0
45,"45200",4478,3666,3565,35,101,"PODEMOS-IU-",251
37,"37376",2164,1606,1581,15,25,"PODEMOS-IU-",80
44,"44130",27,24,24,0,0,"PODEMOS-IU-",1
28,"28080",49801,41938,41705,248,233,"PODEMOS-IU-",3442
39,"39067",759,582,575,3,7,"PODEMOS-IU-",27
10,"10028",82,60,59,0,1,"PODEMOS-IU-",5
34,"34073",180,149,145,2,4,"PODEMOS-IU-",4
16,"16083",45,29,28,0,1,"PODEMOS-IU-",0
10,"10129",348,263,250,0,13,"PODEMOS-IU-",19
5,"5216",213,166,165,0,1,"PODEMOS-IU-",18
37,"37057",209,165,162,2,3,"PODEMOS-IU-",4
50,"50094",1518,1172,1155,20,17,"PODEMOS-IU-",110
50,"50253",382,318,315,2,3,"PODEMOS-IU-",18
26,"26080",453,385,383,2,2,"PODEMOS-IU-",15
5,"5121",262,201,199,0,2,"PODEMOS-IU-",17
34,"34046",44,31,31,0,0,"PODEMOS-IU-",4
10,"10003",540,388,386,4,2,"PODEMOS-IU-",51
24,"24001",168,105,104,0,1,"PODEMOS-IU-",4
16,"16197",66,45,45,0,0,"PODEMOS-IU-",4
19,"19227",73,55,53,0,2,"PODEMOS-IU-",2
19,"19269",94,75,75,0,0,"PODEMOS-IU-",34
6,"6119",681,551,547,1,4,"PODEMOS-IU-",27
34,"34136",149,105,102,0,3,"PODEMOS-IU-",1
13,"13024",891,636,628,2,8,"PODEMOS-IU-",23
50,"50009",97,72,71,1,1,"PODEMOS-IU-",4
34,"34208",47,38,38,0,0,"PODEMOS-IU-",2
19,"19233",82,72,72,1,0,"PODEMOS-IU-",18
37,"37102",379,297,291,3,6,"PODEMOS-IU-",10
5,"5205",79,66,66,0,0,"PODEMOS-IU-",1
10,"10004",690,529,517,8,12,"PODEMOS-IU-",19
47,"47080",35,23,21,0,2,"PODEMOS-IU-",3
6,"6057",537,442,433,1,9,"PODEMOS-IU-",11
9,"9032",103,72,72,0,0,"PODEMOS-IU-",6
47,"47204",235,182,178,0,4,"PODEMOS-IU-",11
47,"47123",461,391,390,3,1,"PODEMOS-IU-",55
9,"9047",54,46,45,0,1,"PODEMOS-IU-",7
40,"40170",1307,1066,1054,7,12,"PODEMOS-IU-",60
16,"16141",130,105,105,0,0,"PODEMOS-IU-",4
44,"44036",23,20,20,0,0,"PODEMOS-IU-",4
34,"34018",205,181,177,2,4,"PODEMOS-IU-",19
50,"50107",988,837,828,11,9,"PODEMOS-IU-",68
9,"9151",445,358,354,3,4,"PODEMOS-IU-",39
44,"44055",77,58,56,0,2,"PODEMOS-IU-",2
38,"38009",4299,3105,3069,16,36,"PODEMOS-IU-",385
37,"37356",87,66,66,0,0,"PODEMOS-IU-",3
47,"47113",142,117,117,1,0,"PODEMOS-IU-",5
45,"45069",1817,1460,1438,4,22,"PODEMOS-IU-",130
45,"45083",551,470,465,5,5,"PODEMOS-IU-",26
24,"24199",405,302,297,3,5,"PODEMOS-IU-",29
34,"34157",2364,1881,1846,13,35,"PODEMOS-IU-",168
10,"10905",632,491,485,4,6,"PODEMOS-IU-",24
49,"49265",120,93,92,1,1,"PODEMOS-IU-",5
37,"37081",871,725,717,4,8,"PODEMOS-IU-",17
19,"19197",27,22,22,0,0,"PODEMOS-IU-",3
6,"6041",457,381,374,5,7,"PODEMOS-IU-",46
28,"28162",2771,2264,2243,6,21,"PODEMOS-IU-",249
24,"24030",4201,3080,3024,25,56,"PODEMOS-IU-",556
40,"40007",68,58,58,0,0,"PODEMOS-IU-",1
44,"44038",98,83,80,0,3,"PODEMOS-IU-",6
40,"40008",45,37,37,0,0,"PODEMOS-IU-",0
10,"10022",412,319,316,1,3,"PODEMOS-IU-",40
19,"19095",11,10,10,1,0,"PODEMOS-IU-",0
28,"28163",429,361,345,4,16,"PODEMOS-IU-",63
16,"16157",190,163,161,1,2,"PODEMOS-IU-",5
16,"16017",340,281,271,2,10,"PODEMOS-IU-",20
44,"44229",143,110,108,4,2,"PODEMOS-IU-",15
2,"2070",384,318,318,2,0,"PODEMOS-IU-",14
10,"10154",177,134,133,1,1,"PODEMOS-IU-",9
19,"19145",41,38,38,0,0,"PODEMOS-IU-",2
13,"13015",5226,4010,3959,20,51,"PODEMOS-IU-",266
42,"42118",21,13,13,1,0,"PODEMOS-IU-",0
28,"28052",3949,2890,2818,8,72,"PODEMOS-IU-",318
50,"50292",129,113,113,1,0,"PODEMOS-IU-",5
50,"50106",127,97,96,0,1,"PODEMOS-IU-",9
16,"16243",379,323,318,5,5,"PODEMOS-IU-",24
40,"40174",324,254,250,2,4,"PODEMOS-IU-",14
24,"24193",365,286,285,0,1,"PODEMOS-IU-",32
10,"10010",2213,1499,1470,6,29,"PODEMOS-IU-",95
9,"9215",365,267,264,1,3,"PODEMOS-IU-",40
9,"9266",103,85,85,0,0,"PODEMOS-IU-",4
40,"40009",40,34,34,0,0,"PODEMOS-IU-",6
28,"28164",3202,2553,2530,19,23,"PODEMOS-IU-",313
37,"37036",57,42,41,0,1,"PODEMOS-IU-",2
37,"37311",207,164,162,4,2,"PODEMOS-IU-",13
49,"49184",170,122,121,0,1,"PODEMOS-IU-",3
2,"2003",133957,105024,104115,786,909,"PODEMOS-IU-",11970
40,"40033",67,57,57,1,0,"PODEMOS-IU-",13
24,"24060",574,371,369,1,2,"PODEMOS-IU-",34
42,"42075",78,60,60,1,0,"PODEMOS-IU-",5
6,"6052",3969,3043,2970,21,73,"PODEMOS-IU-",235
40,"40156",281,223,222,1,1,"PODEMOS-IU-",14
24,"24132",615,405,404,5,1,"PODEMOS-IU-",47
50,"50125",345,264,261,3,3,"PODEMOS-IU-",12
5,"5038",113,89,88,0,1,"PODEMOS-IU-",5
16,"16202",741,573,568,4,5,"PODEMOS-IU-",27
16,"16148",546,481,479,1,2,"PODEMOS-IU-",18
28,"28017",1280,1017,1012,9,5,"PODEMOS-IU-",214
37,"37173",1420,1077,1058,13,19,"PODEMOS-IU-",68
6,"6081",1042,825,811,4,14,"PODEMOS-IU-",104
16,"16193",58,51,51,2,0,"PODEMOS-IU-",1
50,"50266",121,85,80,0,5,"PODEMOS-IU-",6
44,"44267",71,53,52,0,1,"PODEMOS-IU-",2
38,"38044",2199,1443,1429,10,14,"PODEMOS-IU-",67
9,"9907",1507,1198,1174,16,24,"PODEMOS-IU-",203
10,"10216",1522,1195,1167,9,28,"PODEMOS-IU-",109
42,"42128",46,41,41,0,0,"PODEMOS-IU-",5
42,"42198",19,15,15,0,0,"PODEMOS-IU-",1
9,"9054",89,69,68,1,1,"PODEMOS-IU-",7
19,"19331",2643,2043,2009,11,34,"PODEMOS-IU-",224
37,"37363",107,81,80,0,1,"PODEMOS-IU-",1
5,"5016",6354,5090,5005,40,85,"PODEMOS-IU-",349
50,"50083",84,70,68,0,2,"PODEMOS-IU-",11
49,"49122",778,586,573,6,13,"PODEMOS-IU-",51
47,"47103",255,215,214,3,1,"PODEMOS-IU-",19
19,"19150",126,102,100,0,2,"PODEMOS-IU-",5
10,"10109",1730,1208,1181,12,27,"PODEMOS-IU-",89
9,"9011",73,50,49,0,1,"PODEMOS-IU-",6
10,"10001",283,233,232,3,1,"PODEMOS-IU-",19
10,"10123",575,470,465,2,5,"PODEMOS-IU-",39
6,"6083",46489,34360,33989,270,371,"PODEMOS-IU-",3981
50,"50287",252,200,196,7,4,"PODEMOS-IU-",25
44,"44194",104,80,80,1,0,"PODEMOS-IU-",13
9,"9310",15,14,13,1,1,"PODEMOS-IU-",3
45,"45093",154,124,123,0,1,"PODEMOS-IU-",4
16,"16234",23,16,16,0,0,"PODEMOS-IU-",1
37,"37252",101,80,79,1,1,"PODEMOS-IU-",2
16,"16151",64,52,52,0,0,"PODEMOS-IU-",7
34,"34134",40,31,31,1,0,"PODEMOS-IU-",3
42,"42097",14,7,7,0,0,"PODEMOS-IU-",0
37,"37269",430,331,325,2,6,"PODEMOS-IU-",22
44,"44135",102,85,85,0,0,"PODEMOS-IU-",1
10,"10197",108,84,84,0,0,"PODEMOS-IU-",6
50,"50148",290,229,227,2,2,"PODEMOS-IU-",20
19,"19102",92,80,80,0,0,"PODEMOS-IU-",7
49,"49066",449,319,314,4,5,"PODEMOS-IU-",18
40,"40004",445,348,341,0,7,"PODEMOS-IU-",19
47,"47226",149,124,123,0,1,"PODEMOS-IU-",10
40,"40051",34,33,31,0,2,"PODEMOS-IU-",4
42,"42070",32,24,24,0,0,"PODEMOS-IU-",1
26,"26024",210,171,169,1,2,"PODEMOS-IU-",11
47,"47099",155,135,133,0,2,"PODEMOS-IU-",4
47,"47194",292,245,243,1,2,"PODEMOS-IU-",84
39,"39022",969,740,732,2,8,"PODEMOS-IU-",33
10,"10018",1630,1149,1112,12,37,"PODEMOS-IU-",97
44,"44247",287,216,215,6,1,"PODEMOS-IU-",29
24,"24054",417,318,311,0,7,"PODEMOS-IU-",12
42,"42178",101,75,75,0,0,"PODEMOS-IU-",3
6,"6086",1174,869,862,4,7,"PODEMOS-IU-",73
5,"5217",54,44,43,0,1,"PODEMOS-IU-",3
13,"13055",615,475,465,5,10,"PODEMOS-IU-",41
24,"24081",122,91,88,0,3,"PODEMOS-IU-",2
5,"5005",171,142,142,2,0,"PODEMOS-IU-",6
37,"37203",146,113,112,0,1,"PODEMOS-IU-",11
37,"37291",269,212,209,2,3,"PODEMOS-IU-",11
35,"35021",15014,10909,10792,71,117,"PODEMOS-IU-",1714
9,"9115",91,71,66,2,5,"PODEMOS-IU-",6
9,"9063",214,185,184,0,1,"PODEMOS-IU-",10
19,"19244",74,54,54,0,0,"PODEMOS-IU-",1
40,"40062",57,49,49,0,0,"PODEMOS-IU-",1
19,"19091",23,19,19,0,0,"PODEMOS-IU-",0
6,"6142",259,214,208,1,6,"PODEMOS-IU-",12
2,"2011",578,461,459,2,2,"PODEMOS-IU-",15
50,"50029",604,475,467,7,8,"PODEMOS-IU-",35
10,"10088",196,139,138,0,1,"PODEMOS-IU-",5
16,"16199",28,23,23,1,0,"PODEMOS-IU-",0
42,"42087",51,45,44,1,1,"PODEMOS-IU-",13
9,"9392",49,41,41,0,0,"PODEMOS-IU-",7
44,"44238",2294,1763,1743,10,20,"PODEMOS-IU-",160
49,"49136",312,227,220,3,7,"PODEMOS-IU-",8
19,"19300",788,664,652,2,12,"PODEMOS-IU-",117
40,"40037",34,19,19,0,0,"PODEMOS-IU-",1
44,"44013",11250,8525,8420,95,105,"PODEMOS-IU-",963
9,"9130",66,55,52,0,3,"PODEMOS-IU-",3
13,"13068",1037,802,783,2,19,"PODEMOS-IU-",70
24,"24017",538,427,424,2,3,"PODEMOS-IU-",25
40,"40194",39191,31175,30785,250,390,"PODEMOS-IU-",3141
37,"37294",11787,9201,9083,76,118,"PODEMOS-IU-",944
45,"45131",264,226,225,0,1,"PODEMOS-IU-",23
9,"9019",144,113,109,1,4,"PODEMOS-IU-",16
34,"34228",76,62,62,0,0,"PODEMOS-IU-",6
47,"47219",40,38,34,0,4,"PODEMOS-IU-",0
9,"9280",27,22,22,0,0,"PODEMOS-IU-",0
49,"49091",248,185,183,4,2,"PODEMOS-IU-",9
13,"13060",272,219,214,4,5,"PODEMOS-IU-",37
13,"13029",90,77,77,0,0,"PODEMOS-IU-",6
34,"34192",82,68,68,0,0,"PODEMOS-IU-",3
10,"10117",243,156,154,1,2,"PODEMOS-IU-",8
28,"28045",35264,27864,27597,180,267,"PODEMOS-IU-",4368
28,"28015",20440,17084,16953,103,131,"PODEMOS-IU-",2314
2,"2001",695,567,559,3,8,"PODEMOS-IU-",33
28,"28131",13432,10500,10387,81,113,"PODEMOS-IU-",1586
10,"10037",76855,60447,59702,451,745,"PODEMOS-IU-",6882
44,"44148",76,64,63,0,1,"PODEMOS-IU-",2
44,"44029",579,466,457,3,9,"PODEMOS-IU-",42
45,"45010",389,280,280,3,0,"PODEMOS-IU-",22
50,"50130",362,252,249,1,3,"PODEMOS-IU-",19
38,"38022",18629,12903,12759,84,144,"PODEMOS-IU-",1038
42,"42035",741,537,523,7,14,"PODEMOS-IU-",24
19,"19248",76,56,56,0,0,"PODEMOS-IU-",7
37,"37146",102,86,86,1,0,"PODEMOS-IU-",3
37,"37247",173,144,143,1,1,"PODEMOS-IU-",7
24,"24046",899,678,663,7,15,"PODEMOS-IU-",71
28,"28111",622,492,487,1,5,"PODEMOS-IU-",70
30,"30036",15256,10884,10703,56,181,"PODEMOS-IU-",961
49,"49093",280,239,238,2,1,"PODEMOS-IU-",7
49,"49094",213,138,138,0,0,"PODEMOS-IU-",12
50,"50217",431,346,344,0,2,"PODEMOS-IU-",9
28,"28144",6423,5274,5222,35,52,"PODEMOS-IU-",713
19,"19157",56,40,37,0,3,"PODEMOS-IU-",8
24,"24083",1005,800,791,7,9,"PODEMOS-IU-",82
19,"19289",23,19,19,0,0,"PODEMOS-IU-",2
37,"37369",125,95,93,0,2,"PODEMOS-IU-",5
38,"38020",15899,11057,10924,90,133,"PODEMOS-IU-",1664
47,"47125",51,46,45,0,1,"PODEMOS-IU-",2
49,"49200",936,744,726,10,18,"PODEMOS-IU-",62
5,"5027",260,217,211,3,6,"PODEMOS-IU-",8
5,"5095",236,193,191,0,2,"PODEMOS-IU-",14
47,"47075",4775,3849,3784,38,65,"PODEMOS-IU-",276
9,"9071",40,32,32,0,0,"PODEMOS-IU-",4
50,"50275",110,55,55,0,0,"PODEMOS-IU-",2
5,"5225",353,300,297,2,3,"PODEMOS-IU-",14
9,"9403",103,90,89,0,1,"PODEMOS-IU-",2
26,"26081",15,14,14,1,0,"PODEMOS-IU-",0
34,"34180",64,55,55,2,0,"PODEMOS-IU-",2
37,"37262",69,60,60,0,0,"PODEMOS-IU-",0
19,"19194",94,76,76,0,0,"PODEMOS-IU-",5
37,"37300",547,392,391,5,1,"PODEMOS-IU-",39
44,"44244",68,48,48,4,0,"PODEMOS-IU-",5
42,"42052",17,15,15,0,0,"PODEMOS-IU-",2
49,"49054",849,641,629,5,12,"PODEMOS-IU-",35
16,"16024",123,96,95,0,1,"PODEMOS-IU-",10
26,"26136",92,80,80,3,0,"PODEMOS-IU-",12
42,"42068",78,62,61,2,1,"PODEMOS-IU-",0
50,"50192",233,189,183,0,6,"PODEMOS-IU-",24
40,"40072",224,198,194,3,4,"PODEMOS-IU-",22
50,"50102",820,653,642,9,11,"PODEMOS-IU-",78
49,"49015",201,157,155,0,2,"PODEMOS-IU-",7
45,"45153",1560,1243,1230,4,13,"PODEMOS-IU-",101
19,"19016",57,40,40,0,0,"PODEMOS-IU-",1
26,"26150",100,83,83,0,0,"PODEMOS-IU-",4
19,"19211",356,301,300,0,1,"PODEMOS-IU-",26
9,"9026",371,305,303,2,2,"PODEMOS-IU-",28
26,"26164",51,37,37,1,0,"PODEMOS-IU-",2
44,"44111",78,64,64,1,0,"PODEMOS-IU-",15
6,"6062",576,435,430,0,5,"PODEMOS-IU-",30
24,"24171",349,201,198,4,3,"PODEMOS-IU-",21
40,"40190",48,40,39,0,1,"PODEMOS-IU-",6
16,"16122",249,197,196,3,1,"PODEMOS-IU-",10
34,"34236",147,111,111,0,0,"PODEMOS-IU-",2
19,"19240",51,42,41,1,1,"PODEMOS-IU-",4
24,"24053",406,279,276,6,3,"PODEMOS-IU-",16
50,"50165",1783,1359,1330,20,29,"PODEMOS-IU-",267
47,"47212",358,312,311,3,1,"PODEMOS-IU-",7
6,"6030",169,147,146,1,1,"PODEMOS-IU-",4
34,"34154",76,59,58,0,1,"PODEMOS-IU-",5
38,"38006",41302,23632,23415,133,217,"PODEMOS-IU-",3383
28,"28093",2142,1751,1728,9,23,"PODEMOS-IU-",188
50,"50212",32,29,29,1,0,"PODEMOS-IU-",7
16,"16196",602,522,510,3,12,"PODEMOS-IU-",37
24,"24229",388,312,307,2,5,"PODEMOS-IU-",14
9,"9372",204,176,175,1,1,"PODEMOS-IU-",18
50,"50260",32,28,28,0,0,"PODEMOS-IU-",2
44,"44144",325,249,247,1,2,"PODEMOS-IU-",15
10,"10153",283,204,199,0,5,"PODEMOS-IU-",30
5,"5242",686,588,585,11,3,"PODEMOS-IU-",21
6,"6031",461,316,301,1,15,"PODEMOS-IU-",6
37,"37190",193,144,144,1,0,"PODEMOS-IU-",3
37,"37367",185,150,148,4,2,"PODEMOS-IU-",1
9,"9353",76,64,63,2,1,"PODEMOS-IU-",10
26,"26074",107,97,96,2,1,"PODEMOS-IU-",13
5,"5127",608,499,496,0,3,"PODEMOS-IU-",31
9,"9441",92,81,81,1,0,"PODEMOS-IU-",2
44,"44207",130,101,101,1,0,"PODEMOS-IU-",12
19,"19121",264,219,217,0,2,"PODEMOS-IU-",18
39,"39004",1483,1181,1163,4,18,"PODEMOS-IU-",62
16,"16272",199,162,161,1,1,"PODEMOS-IU-",8
9,"9242",66,53,53,1,0,"PODEMOS-IU-",0
44,"44054",94,79,79,0,0,"PODEMOS-IU-",7
10,"10059",325,234,232,1,2,"PODEMOS-IU-",10
9,"9317",19,19,19,1,0,"PODEMOS-IU-",7
9,"9277",107,92,89,0,3,"PODEMOS-IU-",24
6,"6098",534,421,411,8,10,"PODEMOS-IU-",21
37,"37368",17,15,11,0,4,"PODEMOS-IU-",3
2,"2059",313,252,250,3,2,"PODEMOS-IU-",9
9,"9243",73,57,55,0,2,"PODEMOS-IU-",8
5,"5037",219,143,142,2,1,"PODEMOS-IU-",4
37,"37074",140,107,106,1,1,"PODEMOS-IU-",6
16,"16086",881,751,747,3,4,"PODEMOS-IU-",51
42,"42020",4186,3027,2988,28,39,"PODEMOS-IU-",260
47,"47176",202,138,138,1,0,"PODEMOS-IU-",3
37,"37306",242,184,181,2,3,"PODEMOS-IU-",4
19,"19259",28,24,24,0,0,"PODEMOS-IU-",6
19,"19333",105,74,73,1,1,"PODEMOS-IU-",6
42,"42105",46,37,37,1,0,"PODEMOS-IU-",0
50,"50281",68,55,52,0,3,"PODEMOS-IU-",5
37,"37009",196,142,141,1,1,"PODEMOS-IU-",8
6,"6033",1269,1026,1010,4,16,"PODEMOS-IU-",41
5,"5024",198,142,139,2,3,"PODEMOS-IU-",10
40,"40161",35,28,26,0,2,"PODEMOS-IU-",2
49,"49046",242,178,175,0,3,"PODEMOS-IU-",8
10,"10130",1747,1352,1321,12,31,"PODEMOS-IU-",219
49,"49180",138,95,95,0,0,"PODEMOS-IU-",16
50,"50109",98,69,67,3,2,"PODEMOS-IU-",11
42,"42009",77,69,69,2,0,"PODEMOS-IU-",3
9,"9194",1969,1526,1511,14,15,"PODEMOS-IU-",195
42,"42106",14,12,12,0,0,"PODEMOS-IU-",0
40,"40126",67,53,51,0,2,"PODEMOS-IU-",9
6,"6045",476,368,362,3,6,"PODEMOS-IU-",13
26,"26066",259,216,212,3,4,"PODEMOS-IU-",21
49,"49035",222,195,195,2,0,"PODEMOS-IU-",26
5,"5247",227,182,177,1,5,"PODEMOS-IU-",9
34,"34177",176,154,152,2,2,"PODEMOS-IU-",6
40,"40069",74,65,65,0,0,"PODEMOS-IU-",1
49,"49156",230,189,182,0,7,"PODEMOS-IU-",10
16,"16224",77,61,60,1,1,"PODEMOS-IU-",7
34,"34022",1019,856,849,8,7,"PODEMOS-IU-",43
47,"47178",166,144,143,4,1,"PODEMOS-IU-",17
47,"47011",557,478,476,5,2,"PODEMOS-IU-",15
9,"9104",47,39,39,0,0,"PODEMOS-IU-",2
37,"37079",80,69,68,2,1,"PODEMOS-IU-",3
26,"26043",349,272,268,2,4,"PODEMOS-IU-",29
44,"44127",57,45,45,0,0,"PODEMOS-IU-",4
13,"13092",1715,1434,1425,1,9,"PODEMOS-IU-",49
16,"16131",127,90,90,1,0,"PODEMOS-IU-",5
49,"49107",116,82,81,1,1,"PODEMOS-IU-",11
49,"49229",113,88,87,0,1,"PODEMOS-IU-",3
26,"26018",10441,8400,8311,64,89,"PODEMOS-IU-",998
16,"16046",223,162,161,1,1,"PODEMOS-IU-",5
37,"37323",476,380,377,7,3,"PODEMOS-IU-",9
5,"5133",67,48,48,0,0,"PODEMOS-IU-",0
5,"5249",96,69,69,0,0,"PODEMOS-IU-",32
10,"10039",402,302,301,0,1,"PODEMOS-IU-",37
5,"5117",193,169,167,0,2,"PODEMOS-IU-",5
19,"19281",18,17,17,3,0,"PODEMOS-IU-",2
44,"44159",37,32,32,1,0,"PODEMOS-IU-",5
37,"37273",88,67,67,0,0,"PODEMOS-IU-",1
9,"9287",199,169,168,1,1,"PODEMOS-IU-",29
45,"45120",121,96,96,0,0,"PODEMOS-IU-",7
49,"49108",454,325,322,2,3,"PODEMOS-IU-",19
6,"6004",1549,1276,1257,6,19,"PODEMOS-IU-",86
44,"44192",349,288,284,1,4,"PODEMOS-IU-",16
26,"26174",132,116,116,5,0,"PODEMOS-IU-",18
26,"26134",83,70,67,0,3,"PODEMOS-IU-",4
40,"40129",164,129,128,2,1,"PODEMOS-IU-",3
49,"49014",116,89,88,2,1,"PODEMOS-IU-",5
10,"10121",7914,5924,5809,36,115,"PODEMOS-IU-",598
44,"44141",127,100,100,0,0,"PODEMOS-IU-",17
39,"39019",2229,1785,1751,15,34,"PODEMOS-IU-",183
37,"37014",1153,414,411,4,3,"PODEMOS-IU-",28
50,"50025",4516,3417,3364,35,53,"PODEMOS-IU-",295
2,"2029",3327,2586,2556,15,30,"PODEMOS-IU-",335
10,"10082",1810,1495,1476,9,19,"PODEMOS-IU-",111
24,"24077",215,178,178,0,0,"PODEMOS-IU-",6
47,"47130",99,76,76,2,0,"PODEMOS-IU-",5
40,"40901",414,331,328,8,3,"PODEMOS-IU-",46
38,"38025",7088,5166,5089,39,77,"PODEMOS-IU-",524
40,"40165",74,56,54,1,2,"PODEMOS-IU-",1
19,"19179",76,66,64,1,2,"PODEMOS-IU-",2
9,"9200",58,40,40,0,0,"PODEMOS-IU-",2
49,"49068",435,287,286,1,1,"PODEMOS-IU-",11
9,"9043",186,128,128,1,0,"PODEMOS-IU-",16
50,"50173",149,107,105,0,2,"PODEMOS-IU-",2
49,"49148",264,146,136,1,10,"PODEMOS-IU-",9
13,"13052",6313,4844,4762,38,82,"PODEMOS-IU-",314
9,"9421",242,197,196,2,1,"PODEMOS-IU-",17
39,"39011",1575,1249,1242,3,7,"PODEMOS-IU-",80
10,"10151",198,161,157,2,4,"PODEMOS-IU-",5
44,"44101",51,43,42,1,1,"PODEMOS-IU-",0
9,"9201",28,20,19,0,1,"PODEMOS-IU-",1
5,"5125",56,47,43,0,4,"PODEMOS-IU-",0
37,"37070",528,422,417,2,5,"PODEMOS-IU-",31
50,"50124",399,316,316,3,0,"PODEMOS-IU-",14
39,"39049",306,209,208,4,1,"PODEMOS-IU-",11
5,"5113",62,49,49,0,0,"PODEMOS-IU-",2
16,"16025",25,21,21,0,0,"PODEMOS-IU-",1
9,"9314",92,75,74,1,1,"PODEMOS-IU-",4
44,"44077",74,55,54,0,1,"PODEMOS-IU-",2
44,"44143",394,327,327,2,0,"PODEMOS-IU-",15
16,"16165",55,49,48,1,1,"PODEMOS-IU-",5
24,"24026",1099,812,799,5,13,"PODEMOS-IU-",52
39,"39050",255,188,184,2,4,"PODEMOS-IU-",10
5,"5100",267,217,212,1,5,"PODEMOS-IU-",24
16,"16250",65,41,41,0,0,"PODEMOS-IU-",1
9,"9046",24,19,19,0,0,"PODEMOS-IU-",6
40,"40214",196,167,163,1,4,"PODEMOS-IU-",13
16,"16251",1809,1469,1443,11,26,"PODEMOS-IU-",77
47,"47058",202,154,153,3,1,"PODEMOS-IU-",9
16,"16097",139,121,120,1,1,"PODEMOS-IU-",11
47,"47154",146,122,118,2,4,"PODEMOS-IU-",14
44,"44262",143,115,112,0,3,"PODEMOS-IU-",4
44,"44164",20,18,18,0,0,"PODEMOS-IU-",0
9,"9224",159,135,132,0,3,"PODEMOS-IU-",5
50,"50261",205,171,167,1,4,"PODEMOS-IU-",36
30,"30011",4695,3665,3610,16,55,"PODEMOS-IU-",277
28,"28021",576,387,386,3,1,"PODEMOS-IU-",100
24,"24067",606,375,371,2,4,"PODEMOS-IU-",14
9,"9373",406,284,268,3,16,"PODEMOS-IU-",13
42,"42031",26,19,19,1,0,"PODEMOS-IU-",0
2,"2071",1058,912,906,2,6,"PODEMOS-IU-",34
6,"6076",824,631,620,0,11,"PODEMOS-IU-",86
9,"9425",476,366,362,1,4,"PODEMOS-IU-",65
24,"24028",365,297,290,2,7,"PODEMOS-IU-",31
10,"10073",721,553,546,4,7,"PODEMOS-IU-",40
28,"28085",4141,3337,3296,13,41,"PODEMOS-IU-",494
19,"19186",78,67,67,0,0,"PODEMOS-IU-",3
40,"40100",263,219,215,1,4,"PODEMOS-IU-",12
47,"47059",97,75,75,0,0,"PODEMOS-IU-",10
37,"37281",39,34,33,0,1,"PODEMOS-IU-",4
19,"19092",395,317,309,1,8,"PODEMOS-IU-",24
9,"9050",52,36,36,0,0,"PODEMOS-IU-",4
50,"50087",29,18,18,0,0,"PODEMOS-IU-",0
9,"9901",340,256,255,1,1,"PODEMOS-IU-",17
5,"5207",645,543,540,3,3,"PODEMOS-IU-",33
2,"2036",95,75,75,0,0,"PODEMOS-IU-",3
28,"28096",19809,15584,15392,118,192,"PODEMOS-IU-",2084
28,"28086",5390,3992,3936,26,56,"PODEMOS-IU-",483
28,"28074",140580,113723,112489,776,1234,"PODEMOS-IU-",21388
6,"6111",493,374,370,2,4,"PODEMOS-IU-",29
26,"26143",242,190,189,0,1,"PODEMOS-IU-",20
2,"2073",4844,3828,3772,28,56,"PODEMOS-IU-",512
26,"26064",2337,1764,1724,14,40,"PODEMOS-IU-",247
9,"9035",284,213,210,1,3,"PODEMOS-IU-",22
16,"16908",163,135,133,0,2,"PODEMOS-IU-",21
38,"38040",5446,3513,3462,13,51,"PODEMOS-IU-",290
37,"37320",88,67,67,1,0,"PODEMOS-IU-",3
19,"19325",144,87,87,1,0,"PODEMOS-IU-",5
19,"19142",249,178,177,1,1,"PODEMOS-IU-",35
50,"50235",2412,1826,1807,22,19,"PODEMOS-IU-",229
13,"13045",616,482,479,4,3,"PODEMOS-IU-",20
19,"19174",91,69,69,0,0,"PODEMOS-IU-",7
40,"40127",35,28,28,0,0,"PODEMOS-IU-",1
47,"47126",44,42,42,1,0,"PODEMOS-IU-",0
50,"50179",264,231,228,0,3,"PODEMOS-IU-",21
47,"47220",154,119,119,1,0,"PODEMOS-IU-",4
5,"5144",66,51,51,0,0,"PODEMOS-IU-",2
9,"9380",73,53,53,0,0,"PODEMOS-IU-",7
47,"47001",52,47,46,0,1,"PODEMOS-IU-",2
44,"44230",152,112,111,1,1,"PODEMOS-IU-",18
6,"6046",1250,1010,995,7,15,"PODEMOS-IU-",47
9,"9446",12,8,8,0,0,"PODEMOS-IU-",0
50,"50150",621,451,450,2,1,"PODEMOS-IU-",32
10,"10036",306,240,237,2,3,"PODEMOS-IU-",29
10,"10159",317,241,240,0,1,"PODEMOS-IU-",4
2,"2039",952,798,789,9,9,"PODEMOS-IU-",46
50,"50237",102,81,81,3,0,"PODEMOS-IU-",9
6,"6014",6535,4757,4679,36,78,"PODEMOS-IU-",336
16,"16910",78,54,54,1,0,"PODEMOS-IU-",6
9,"9267",113,102,101,2,1,"PODEMOS-IU-",1
9,"9431",120,98,98,3,0,"PODEMOS-IU-",9
26,"26019",350,270,256,3,14,"PODEMOS-IU-",25
49,"49082",343,288,286,8,2,"PODEMOS-IU-",13
9,"9307",112,87,86,0,1,"PODEMOS-IU-",0
28,"28057",1549,1246,1239,5,7,"PODEMOS-IU-",193
13,"13063",3652,2692,2649,32,43,"PODEMOS-IU-",272
10,"10161",82,50,50,1,0,"PODEMOS-IU-",3
45,"45135",4173,3402,3349,18,53,"PODEMOS-IU-",589
42,"42080",150,116,116,1,0,"PODEMOS-IU-",6
37,"37197",87,63,63,0,0,"PODEMOS-IU-",6
24,"24194",266,199,199,1,0,"PODEMOS-IU-",13
26,"26147",34,30,29,0,1,"PODEMOS-IU-",1
37,"37013",107,73,72,0,1,"PODEMOS-IU-",4
50,"50063",61,54,54,0,0,"PODEMOS-IU-",3
6,"6048",824,714,702,2,12,"PODEMOS-IU-",46
44,"44203",9,9,9,0,0,"PODEMOS-IU-",0
9,"9057",148,120,116,0,4,"PODEMOS-IU-",25
9,"9127",52,45,45,1,0,"PODEMOS-IU-",2
24,"24050",105,88,87,3,1,"PODEMOS-IU-",2
24,"24197",736,556,552,7,4,"PODEMOS-IU-",52
28,"28113",36716,29939,29607,224,332,"PODEMOS-IU-",5401
30,"30028",6400,4364,4289,30,75,"PODEMOS-IU-",641
28,"28166",347,287,286,1,1,"PODEMOS-IU-",46
47,"47161",3945,3370,3344,20,26,"PODEMOS-IU-",295
47,"47065",817,658,653,2,5,"PODEMOS-IU-",28
19,"19166",152,125,122,0,3,"PODEMOS-IU-",19
45,"45047",2668,1922,1882,11,40,"PODEMOS-IU-",235
2,"2079",2823,2303,2253,22,50,"PODEMOS-IU-",595
19,"19239",91,64,63,1,1,"PODEMOS-IU-",3
9,"9058",395,325,317,1,8,"PODEMOS-IU-",46
26,"26070",155,133,132,0,1,"PODEMOS-IU-",5
40,"40002",34,30,30,0,0,"PODEMOS-IU-",2
50,"50064",438,368,362,1,6,"PODEMOS-IU-",36
9,"9059",136704,109424,108039,1134,1385,"PODEMOS-IU-",12858
37,"37016",574,464,455,3,9,"PODEMOS-IU-",44
19,"19195",37,29,28,2,1,"PODEMOS-IU-",5
28,"28168",1329,976,969,3,7,"PODEMOS-IU-",145
9,"9272",259,197,195,2,2,"PODEMOS-IU-",18
34,"34133",105,88,86,1,2,"PODEMOS-IU-",2
9,"9437",270,227,224,2,3,"PODEMOS-IU-",8
9,"9438",561,485,473,6,12,"PODEMOS-IU-",59
42,"42042",49,42,42,1,0,"PODEMOS-IU-",3
50,"50240",965,720,702,9,18,"PODEMOS-IU-",72
26,"26047",1879,1569,1549,10,20,"PODEMOS-IU-",83
49,"49175",205,150,149,2,1,"PODEMOS-IU-",4
45,"45094",367,290,288,4,2,"PODEMOS-IU-",35
5,"5228",167,124,124,0,0,"PODEMOS-IU-",2
5,"5215",159,126,124,0,2,"PODEMOS-IU-",9
26,"26084",7187,5620,5558,36,62,"PODEMOS-IU-",641
9,"9455",43,37,36,0,1,"PODEMOS-IU-",2
26,"26177",301,250,246,2,4,"PODEMOS-IU-",17
10,"10206",201,146,144,1,2,"PODEMOS-IU-",15
44,"44034",126,97,97,2,0,"PODEMOS-IU-",10
16,"16052",537,429,429,2,0,"PODEMOS-IU-",51
39,"39096",670,523,518,2,5,"PODEMOS-IU-",20
34,"34047",1738,1439,1420,8,19,"PODEMOS-IU-",79
5,"5204",583,486,482,4,4,"PODEMOS-IU-",26
19,"19120",108,90,90,1,0,"PODEMOS-IU-",10
26,"26036",17013,12543,12354,95,189,"PODEMOS-IU-",1266
6,"6118",157,125,125,1,0,"PODEMOS-IU-",4
24,"24040",412,322,320,2,2,"PODEMOS-IU-",29
9,"9335",87,71,71,0,0,"PODEMOS-IU-",9
5,"5021",1871,1469,1440,15,29,"PODEMOS-IU-",166
50,"50085",183,136,136,1,0,"PODEMOS-IU-",7
44,"44045",368,302,298,8,4,"PODEMOS-IU-",28
16,"16186",412,358,354,1,4,"PODEMOS-IU-",12
26,"26113",31,30,30,0,0,"PODEMOS-IU-",0
39,"39023",6523,5205,5144,22,61,"PODEMOS-IU-",510
6,"6020",1739,1420,1387,5,33,"PODEMOS-IU-",133
40,"40146",238,205,202,0,3,"PODEMOS-IU-",14
5,"5178",345,287,283,1,4,"PODEMOS-IU-",11
40,"40181",4166,3405,3337,21,68,"PODEMOS-IU-",460
6,"6054",5454,4329,4190,46,139,"PODEMOS-IU-",362
26,"26180",223,182,177,3,5,"PODEMOS-IU-",15
37,"37180",68,39,39,1,0,"PODEMOS-IU-",1
37,"37045",28,19,18,0,1,"PODEMOS-IU-",1
5,"5218",105,82,81,0,1,"PODEMOS-IU-",3
47,"47195",430,335,320,2,15,"PODEMOS-IU-",54
37,"37104",25,18,18,0,0,"PODEMOS-IU-",0
2,"2047",107,89,88,1,1,"PODEMOS-IU-",2
49,"49249",63,52,52,1,0,"PODEMOS-IU-",1
13,"13072",729,542,531,3,11,"PODEMOS-IU-",29
42,"42045",276,212,209,2,3,"PODEMOS-IU-",7
9,"9119",45,26,26,0,0,"PODEMOS-IU-",3
2,"2084",305,221,215,1,6,"PODEMOS-IU-",16
49,"49167",179,140,136,2,4,"PODEMOS-IU-",12
49,"49250",1194,954,939,8,15,"PODEMOS-IU-",42
50,"50059",754,599,589,6,10,"PODEMOS-IU-",33
9,"9428",103,86,86,0,0,"PODEMOS-IU-",5
50,"50244",191,153,150,1,3,"PODEMOS-IU-",9
9,"9444",63,43,43,2,0,"PODEMOS-IU-",0
39,"39024",1815,1436,1420,14,16,"PODEMOS-IU-",150
49,"49009",389,305,304,2,1,"PODEMOS-IU-",24
45,"45038",3505,2749,2705,16,44,"PODEMOS-IU-",416
37,"37021",69,52,51,1,1,"PODEMOS-IU-",1
37,"37144",338,275,273,1,2,"PODEMOS-IU-",7
44,"44047",229,125,124,2,1,"PODEMOS-IU-",14
40,"40218",84,62,62,0,0,"PODEMOS-IU-",0
24,"24005",345,255,250,2,5,"PODEMOS-IU-",17
28,"28004",6564,4798,4767,26,31,"PODEMOS-IU-",665
5,"5130",94,86,86,0,0,"PODEMOS-IU-",5
16,"16145",425,362,357,8,5,"PODEMOS-IU-",30
44,"44137",188,148,146,0,2,"PODEMOS-IU-",8
44,"44265",181,153,148,1,5,"PODEMOS-IU-",8
42,"42123",158,118,118,2,0,"PODEMOS-IU-",4
50,"50013",200,166,166,3,0,"PODEMOS-IU-",14
37,"37283",119,96,96,0,0,"PODEMOS-IU-",1
49,"49048",114,85,85,0,0,"PODEMOS-IU-",3
5,"5183",123,104,96,0,8,"PODEMOS-IU-",1
16,"16158",511,428,417,4,11,"PODEMOS-IU-",50
26,"26042",799,605,596,5,9,"PODEMOS-IU-",63
19,"19097",14,13,13,0,0,"PODEMOS-IU-",1
37,"37063",60,45,45,1,0,"PODEMOS-IU-",0
9,"9343",93,73,72,1,1,"PODEMOS-IU-",1
50,"50099",3042,2299,2265,20,34,"PODEMOS-IU-",228
9,"9230",33,28,28,0,0,"PODEMOS-IU-",0
9,"9398",74,59,58,1,1,"PODEMOS-IU-",1
49,"49011",212,166,165,7,1,"PODEMOS-IU-",9
47,"47073",116,91,89,0,2,"PODEMOS-IU-",2
50,"50071",127,89,88,0,1,"PODEMOS-IU-",2
24,"24125",421,298,289,2,9,"PODEMOS-IU-",13
6,"6025",5096,3981,3904,28,77,"PODEMOS-IU-",432
19,"19264",34,28,28,0,0,"PODEMOS-IU-",1
16,"16245",400,329,318,0,11,"PODEMOS-IU-",35
49,"49037",177,146,143,1,3,"PODEMOS-IU-",4
9,"9382",30,24,23,0,1,"PODEMOS-IU-",0
2,"2004",606,504,499,5,5,"PODEMOS-IU-",22
40,"40163",41,38,38,0,0,"PODEMOS-IU-",2
26,"26095",95,78,78,1,0,"PODEMOS-IU-",7
9,"9216",374,283,281,2,2,"PODEMOS-IU-",48
47,"47013",90,80,78,4,2,"PODEMOS-IU-",4
38,"38023",125528,88323,87456,598,867,"PODEMOS-IU-",17400
42,"42051",15,10,10,0,0,"PODEMOS-IU-",0
9,"9448",201,161,161,1,0,"PODEMOS-IU-",6
39,"39028",3870,3131,3094,19,37,"PODEMOS-IU-",320
40,"40012",238,178,175,4,3,"PODEMOS-IU-",3
28,"28176",13836,11415,11326,64,89,"PODEMOS-IU-",1004
10,"10215",413,305,301,2,4,"PODEMOS-IU-",26
40,"40177",140,114,113,1,1,"PODEMOS-IU-",2
26,"26108",290,241,237,0,4,"PODEMOS-IU-",27
5,"5186",1558,1255,1247,9,8,"PODEMOS-IU-",67
26,"26096",260,221,212,2,9,"PODEMOS-IU-",18
9,"9449",92,75,74,1,1,"PODEMOS-IU-",3
34,"34204",52,41,41,1,0,"PODEMOS-IU-",0
26,"26122",116,98,97,0,1,"PODEMOS-IU-",15
44,"44151",182,139,138,1,1,"PODEMOS-IU-",9
37,"37275",101,69,67,0,2,"PODEMOS-IU-",0
9,"9180",133,104,99,1,5,"PODEMOS-IU-",14
37,"37113",409,330,329,3,1,"PODEMOS-IU-",11
26,"26009",391,317,314,2,3,"PODEMOS-IU-",42
16,"16266",358,281,279,3,2,"PODEMOS-IU-",2
26,"26123",124,112,110,0,2,"PODEMOS-IU-",8
49,"49259",79,62,61,0,1,"PODEMOS-IU-",1
47,"47076",17721,14605,14438,134,167,"PODEMOS-IU-",2076
44,"44121",53,38,38,2,0,"PODEMOS-IU-",3
5,"5227",340,237,234,0,3,"PODEMOS-IU-",35
50,"50249",284,229,227,1,2,"PODEMOS-IU-",6
44,"44152",67,48,48,2,0,"PODEMOS-IU-",0
6,"6029",1183,946,935,12,11,"PODEMOS-IU-",65
9,"9294",102,86,85,0,1,"PODEMOS-IU-",9
47,"47172",135,119,119,0,0,"PODEMOS-IU-",21
38,"38026",33514,26298,26076,191,222,"PODEMOS-IU-",2958
10,"10097",106,88,85,3,3,"PODEMOS-IU-",7
45,"45063",380,294,289,0,5,"PODEMOS-IU-",17
9,"9388",33,28,28,0,0,"PODEMOS-IU-",3
35,"35019",32841,21136,20850,125,286,"PODEMOS-IU-",2895
19,"19168",266,211,206,4,5,"PODEMOS-IU-",25
50,"50183",319,242,241,4,1,"PODEMOS-IU-",6
16,"16270",156,124,124,1,0,"PODEMOS-IU-",6
49,"49273",166,111,110,0,1,"PODEMOS-IU-",5
44,"44195",84,66,65,1,1,"PODEMOS-IU-",1
26,"26112",223,177,174,0,3,"PODEMOS-IU-",8
6,"6063",2938,2299,2264,11,35,"PODEMOS-IU-",111
5,"5019",44838,36021,35637,287,384,"PODEMOS-IU-",2844
9,"9113",460,369,364,3,5,"PODEMOS-IU-",40
50,"50066",2835,2199,2177,19,22,"PODEMOS-IU-",320
34,"34074",683,545,540,4,5,"PODEMOS-IU-",18
42,"42004",2294,1807,1767,22,40,"PODEMOS-IU-",85
19,"19319",4583,3640,3585,24,55,"PODEMOS-IU-",567
24,"24015",2209,1714,1672,19,42,"PODEMOS-IU-",100
40,"40157",43,33,33,2,0,"PODEMOS-IU-",2
45,"45203",2713,2092,2053,16,39,"PODEMOS-IU-",226
19,"19257",3283,2448,2424,21,24,"PODEMOS-IU-",237
16,"16084",50,36,32,0,4,"PODEMOS-IU-",2
42,"42132",135,114,113,1,1,"PODEMOS-IU-",13
16,"16216",278,243,240,0,3,"PODEMOS-IU-",18
6,"6152",1285,952,935,4,17,"PODEMOS-IU-",77
6,"6064",850,658,647,2,11,"PODEMOS-IU-",115
42,"42103",554,448,442,2,6,"PODEMOS-IU-",23
26,"26050",130,97,97,0,0,"PODEMOS-IU-",12
16,"16042",1108,948,938,3,10,"PODEMOS-IU-",67
24,"24134",3294,2540,2479,25,61,"PODEMOS-IU-",345
40,"40017",84,74,71,2,3,"PODEMOS-IU-",4
24,"24016",507,314,311,2,3,"PODEMOS-IU-",19
37,"37380",56,46,45,1,1,"PODEMOS-IU-",6
9,"9374",90,79,78,1,1,"PODEMOS-IU-",5
19,"19054",167,144,141,2,3,"PODEMOS-IU-",1
49,"49101",147,99,96,0,3,"PODEMOS-IU-",5
26,"26168",5515,4130,4077,36,53,"PODEMOS-IU-",657
40,"40124",234,175,168,3,7,"PODEMOS-IU-",29
9,"9301",648,545,536,7,9,"PODEMOS-IU-",71
16,"16169",51,36,32,0,4,"PODEMOS-IU-",2
44,"44124",73,58,57,0,1,"PODEMOS-IU-",7
49,"49020",261,215,210,2,5,"PODEMOS-IU-",20
40,"40229",28,24,24,0,0,"PODEMOS-IU-",1
49,"49226",239,207,200,3,7,"PODEMOS-IU-",17
10,"10102",503,407,403,3,4,"PODEMOS-IU-",25
5,"5193",180,156,156,2,0,"PODEMOS-IU-",3
19,"19217",42,38,38,0,0,"PODEMOS-IU-",2
5,"5232",106,87,84,1,3,"PODEMOS-IU-",7
47,"47081",41,36,36,0,0,"PODEMOS-IU-",4
34,"34213",52,42,42,0,0,"PODEMOS-IU-",8
39,"39034",257,167,162,2,5,"PODEMOS-IU-",6
5,"5078",100,87,86,0,1,"PODEMOS-IU-",2
28,"28172",9751,7994,7928,38,66,"PODEMOS-IU-",1062
9,"9082",36,34,34,0,0,"PODEMOS-IU-",1
49,"49103",394,343,339,3,4,"PODEMOS-IU-",25
19,"19124",380,271,268,0,3,"PODEMOS-IU-",34
44,"44157",64,38,38,1,0,"PODEMOS-IU-",4
2,"2024",3374,2657,2613,23,44,"PODEMOS-IU-",319
44,"44190",65,45,43,0,2,"PODEMOS-IU-",0
26,"26130",201,164,163,0,1,"PODEMOS-IU-",6
30,"30901",10529,8488,8375,37,113,"PODEMOS-IU-",1035
49,"49022",280,243,241,1,2,"PODEMOS-IU-",18
6,"6133",1799,1476,1453,12,23,"PODEMOS-IU-",53
40,"40078",151,123,122,2,1,"PODEMOS-IU-",10
9,"9304",192,164,161,2,3,"PODEMOS-IU-",8
19,"19247",142,118,117,2,1,"PODEMOS-IU-",14
19,"19125",40,28,28,0,0,"PODEMOS-IU-",4
42,"42061",272,207,204,2,3,"PODEMOS-IU-",17
10,"10023",791,619,614,1,5,"PODEMOS-IU-",25
10,"10145",125,106,104,1,2,"PODEMOS-IU-",3
44,"44117",319,263,256,5,7,"PODEMOS-IU-",16
47,"47116",403,321,320,3,1,"PODEMOS-IU-",25
39,"39036",971,794,787,5,7,"PODEMOS-IU-",77
44,"44221",384,320,315,2,5,"PODEMOS-IU-",38
42,"42062",20,14,13,0,1,"PODEMOS-IU-",2
5,"5196",57,45,42,0,3,"PODEMOS-IU-",2
40,"40021",19,18,18,0,0,"PODEMOS-IU-",0
9,"9306",98,82,81,1,1,"PODEMOS-IU-",6
34,"34024",25,17,16,1,1,"PODEMOS-IU-",1
50,"50170",364,286,279,1,7,"PODEMOS-IU-",19
16,"16225",59,40,40,0,0,"PODEMOS-IU-",0
24,"24087",586,469,460,4,9,"PODEMOS-IU-",24
37,"37272",133,106,106,1,0,"PODEMOS-IU-",5
24,"24196",1918,1446,1422,9,24,"PODEMOS-IU-",221
5,"5014",5291,4096,4044,29,52,"PODEMOS-IU-",450
19,"19080",65,51,51,0,0,"PODEMOS-IU-",7
42,"42173",29702,22141,21776,301,365,"PODEMOS-IU-",2170
44,"44071",585,449,447,6,2,"PODEMOS-IU-",55
40,"40046",82,69,69,1,0,"PODEMOS-IU-",5
16,"16092",154,113,112,0,1,"PODEMOS-IU-",3
9,"9140",115,88,88,2,0,"PODEMOS-IU-",4
9,"9471",142,113,112,3,1,"PODEMOS-IU-",18
50,"50256",74,46,45,0,1,"PODEMOS-IU-",3
49,"49146",274,213,209,1,4,"PODEMOS-IU-",9
40,"40199",101,79,78,0,1,"PODEMOS-IU-",7
40,"40022",193,162,159,2,3,"PODEMOS-IU-",6
28,"28089",3842,3087,3048,12,39,"PODEMOS-IU-",421
44,"44150",26,21,21,0,0,"PODEMOS-IU-",1
34,"34202",28,20,20,1,0,"PODEMOS-IU-",2
6,"6082",393,314,305,5,9,"PODEMOS-IU-",31
24,"24036",272,181,179,4,2,"PODEMOS-IU-",22
13,"13050",479,399,394,2,5,"PODEMOS-IU-",13
5,"5122",119,90,88,1,2,"PODEMOS-IU-",3
10,"10067",10245,7850,7701,80,149,"PODEMOS-IU-",670
45,"45122",5516,4611,4561,28,50,"PODEMOS-IU-",496
35,"35017",27216,17531,17102,133,429,"PODEMOS-IU-",3119
51,"51001",59934,38342,37884,322,458,"PODEMOS-IU-",1822
24,"24145",618,443,435,3,8,"PODEMOS-IU-",38
13,"13005",23187,18379,18119,174,260,"PODEMOS-IU-",2271
37,"37351",269,234,233,6,1,"PODEMOS-IU-",6
28,"28018",4068,3367,3344,15,23,"PODEMOS-IU-",523
9,"9366",75,60,60,2,0,"PODEMOS-IU-",11
16,"16050",220,182,179,1,3,"PODEMOS-IU-",10
45,"45077",562,442,437,0,5,"PODEMOS-IU-",45
50,"50026",421,340,328,4,12,"PODEMOS-IU-",32
28,"28049",57902,47976,47561,329,415,"PODEMOS-IU-",9360
19,"19317",127,98,97,0,1,"PODEMOS-IU-",11
5,"5084",69,46,46,0,0,"PODEMOS-IU-",2
47,"47025",114,98,98,0,0,"PODEMOS-IU-",1
16,"16135",118,86,85,0,1,"PODEMOS-IU-",4
40,"40059",108,90,89,0,1,"PODEMOS-IU-",4
16,"16177",82,64,63,0,1,"PODEMOS-IU-",7
24,"24064",1515,1159,1141,11,18,"PODEMOS-IU-",190
10,"10219",1212,814,806,8,8,"PODEMOS-IU-",61
50,"50017",1779,1386,1373,14,13,"PODEMOS-IU-",201
44,"44235",89,67,66,2,1,"PODEMOS-IU-",7
9,"9075",103,87,87,1,0,"PODEMOS-IU-",7
49,"49029",614,497,488,9,9,"PODEMOS-IU-",26
44,"44112",408,303,293,2,10,"PODEMOS-IU-",19
37,"37139",187,162,157,2,5,"PODEMOS-IU-",22
9,"9029",144,120,118,3,2,"PODEMOS-IU-",19
50,"50144",31,26,25,0,1,"PODEMOS-IU-",4
47,"47088",105,90,90,0,0,"PODEMOS-IU-",5
42,"42117",133,109,106,0,3,"PODEMOS-IU-",10
9,"9256",333,260,256,2,4,"PODEMOS-IU-",28
10,"10126",1470,1114,1104,7,10,"PODEMOS-IU-",45
45,"45080",3,3,3,0,0,"PODEMOS-IU-",1
40,"40145",1105,906,899,2,7,"PODEMOS-IU-",104
37,"37165",31,22,21,0,1,"PODEMOS-IU-",0
19,"19183",71,61,59,0,2,"PODEMOS-IU-",3
26,"26061",1552,1228,1194,14,34,"PODEMOS-IU-",166
49,"49275",51218,38135,37628,388,507,"PODEMOS-IU-",3901
16,"16053",391,334,327,4,7,"PODEMOS-IU-",38
28,"28022",36550,31559,31436,207,123,"PODEMOS-IU-",2556
19,"19136",12,12,12,0,0,"PODEMOS-IU-",1
50,"50289",51,40,38,1,2,"PODEMOS-IU-",6
49,"49075",134,118,114,1,4,"PODEMOS-IU-",0
49,"49190",50,45,45,1,0,"PODEMOS-IU-",2
10,"10031",164,136,135,0,1,"PODEMOS-IU-",9
38,"38008",5658,4126,4056,19,70,"PODEMOS-IU-",415
49,"49031",145,107,103,0,4,"PODEMOS-IU-",3
50,"50001",88,71,70,0,1,"PODEMOS-IU-",1
34,"34033",17,15,15,0,0,"PODEMOS-IU-",1
26,"26039",38,34,34,0,0,"PODEMOS-IU-",4
26,"26062",86,74,72,1,2,"PODEMOS-IU-",10
19,"19322",26,21,21,1,0,"PODEMOS-IU-",1
10,"10114",962,754,737,2,17,"PODEMOS-IU-",146
13,"13057",1105,934,919,3,15,"PODEMOS-IU-",43
45,"45082",1143,976,967,7,9,"PODEMOS-IU-",84
24,"24901",860,642,630,7,12,"PODEMOS-IU-",68
39,"39043",1523,1246,1220,10,26,"PODEMOS-IU-",92
24,"24029",695,521,520,4,1,"PODEMOS-IU-",61
5,"5051",162,135,131,0,4,"PODEMOS-IU-",6
42,"42211",81,74,73,2,1,"PODEMOS-IU-",9
10,"10156",100,78,78,0,0,"PODEMOS-IU-",15
40,"40136",106,82,81,0,1,"PODEMOS-IU-",20
5,"5008",208,168,163,1,5,"PODEMOS-IU-",5
50,"50118",2110,1622,1605,19,17,"PODEMOS-IU-",162
5,"5168",3500,2774,2730,25,44,"PODEMOS-IU-",168
44,"44198",181,151,145,1,6,"PODEMOS-IU-",2
50,"50088",282,233,227,2,6,"PODEMOS-IU-",12
44,"44228",99,83,83,0,0,"PODEMOS-IU-",2
37,"37090",66,51,51,1,0,"PODEMOS-IU-",6
37,"37282",194,148,146,1,2,"PODEMOS-IU-",2
9,"9902",446,345,341,0,4,"PODEMOS-IU-",66
10,"10116",3728,2849,2776,27,73,"PODEMOS-IU-",421
40,"40138",2127,1729,1696,18,33,"PODEMOS-IU-",160
9,"9378",29,21,20,0,1,"PODEMOS-IU-",4
40,"40206",162,132,128,2,4,"PODEMOS-IU-",30
45,"45177",2023,1693,1651,11,42,"PODEMOS-IU-",151
42,"42168",108,85,85,1,0,"PODEMOS-IU-",10
47,"47092",102,86,85,0,1,"PODEMOS-IU-",5
16,"16058",97,73,73,0,0,"PODEMOS-IU-",3
19,"19076",19,18,18,0,0,"PODEMOS-IU-",1
50,"50089",8584,6951,6912,34,39,"PODEMOS-IU-",863
24,"24032",102,84,83,0,1,"PODEMOS-IU-",6
50,"50206",453,371,370,5,1,"PODEMOS-IU-",48
19,"19096",101,81,79,1,2,"PODEMOS-IU-",8
16,"16244",708,627,617,1,10,"PODEMOS-IU-",19
9,"9003",184,143,142,2,1,"PODEMOS-IU-",27
24,"24154",955,702,691,3,11,"PODEMOS-IU-",89
45,"45087",8198,6375,6281,36,94,"PODEMOS-IU-",520
5,"5093",353,275,269,0,6,"PODEMOS-IU-",26
16,"16909",661,540,535,1,5,"PODEMOS-IU-",35
37,"37134",212,156,148,0,8,"PODEMOS-IU-",13
6,"6113",2677,2117,2076,13,41,"PODEMOS-IU-",273
49,"49241",240,199,199,1,0,"PODEMOS-IU-",2
47,"47063",89,71,71,0,0,"PODEMOS-IU-",11
39,"39018",4272,3533,3476,17,57,"PODEMOS-IU-",488
39,"39101",236,173,171,1,2,"PODEMOS-IU-",34
6,"6047",837,677,669,6,8,"PODEMOS-IU-",40
34,"34161",22,17,16,0,1,"PODEMOS-IU-",0
34,"34232",735,595,584,8,11,"PODEMOS-IU-",18
5,"5081",37,29,29,0,0,"PODEMOS-IU-",0
38,"38003",1510,1058,1047,4,11,"PODEMOS-IU-",109
44,"44010",184,137,137,1,0,"PODEMOS-IU-",14
45,"45013",1671,1320,1298,4,22,"PODEMOS-IU-",62
42,"42111",279,209,208,3,1,"PODEMOS-IU-",23
47,"47117",286,240,235,0,5,"PODEMOS-IU-",14
39,"39046",1343,1002,988,8,14,"PODEMOS-IU-",99
47,"47095",41,36,34,2,2,"PODEMOS-IU-",2
9,"9906",1200,975,958,8,17,"PODEMOS-IU-",97
28,"28100",4409,3425,3382,20,43,"PODEMOS-IU-",707
9,"9163",578,490,481,5,9,"PODEMOS-IU-",30
38,"38013",3019,2023,1991,12,32,"PODEMOS-IU-",165
37,"37136",633,448,434,8,14,"PODEMOS-IU-",25
49,"49159",269,214,213,1,1,"PODEMOS-IU-",31
10,"10040",434,321,314,1,7,"PODEMOS-IU-",26
42,"42038",34,27,27,1,0,"PODEMOS-IU-",1
45,"45198",1790,1488,1464,5,24,"PODEMOS-IU-",61
37,"37149",61,56,54,1,2,"PODEMOS-IU-",0
28,"28133",6116,4581,4486,22,95,"PODEMOS-IU-",601
9,"9218",347,277,271,0,6,"PODEMOS-IU-",25
19,"19238",44,30,30,1,0,"PODEMOS-IU-",4
19,"19193",23,20,20,0,0,"PODEMOS-IU-",1
39,"39076",3483,2770,2734,21,36,"PODEMOS-IU-",270
47,"47129",855,715,696,3,19,"PODEMOS-IU-",62
34,"34233",128,118,117,2,1,"PODEMOS-IU-",0
16,"16107",98,76,75,1,1,"PODEMOS-IU-",2
44,"44268",32,30,30,0,0,"PODEMOS-IU-",1
42,"42175",21,15,15,0,0,"PODEMOS-IU-",0
35,"35018",13056,8699,8618,73,81,"PODEMOS-IU-",1737
37,"37055",118,96,95,0,1,"PODEMOS-IU-",3
49,"49039",327,255,246,6,9,"PODEMOS-IU-",25
38,"38015",4067,2951,2926,22,25,"PODEMOS-IU-",242
34,"34045",73,67,65,0,2,"PODEMOS-IU-",1
2,"2006",561,482,480,2,2,"PODEMOS-IU-",20
47,"47005",502,420,414,2,6,"PODEMOS-IU-",22
40,"40036",502,413,406,11,7,"PODEMOS-IU-",8
26,"26034",612,509,497,5,12,"PODEMOS-IU-",45
30,"30029",12055,9003,8882,58,121,"PODEMOS-IU-",869
24,"24038",3048,2360,2315,23,45,"PODEMOS-IU-",351
50,"50153",922,705,704,6,1,"PODEMOS-IU-",81
6,"6018",740,543,536,5,7,"PODEMOS-IU-",78
40,"40108",110,91,90,0,1,"PODEMOS-IU-",9
42,"42151",38,31,30,0,1,"PODEMOS-IU-",0
47,"47036",205,162,157,1,5,"PODEMOS-IU-",8
50,"50241",595,434,423,3,11,"PODEMOS-IU-",25
26,"26165",337,289,284,0,5,"PODEMOS-IU-",37
5,"5074",665,571,565,2,6,"PODEMOS-IU-",11
9,"9480",109,87,85,1,2,"PODEMOS-IU-",6
9,"9274",1045,875,867,8,8,"PODEMOS-IU-",98
24,"24039",1954,1563,1552,28,11,"PODEMOS-IU-",114
2,"2008",1123,857,842,9,15,"PODEMOS-IU-",62
19,"19241",35,24,23,2,1,"PODEMOS-IU-",1
45,"45079",349,272,272,1,0,"PODEMOS-IU-",39
9,"9332",140,103,102,0,1,"PODEMOS-IU-",11
50,"50203",1057,849,837,9,12,"PODEMOS-IU-",153
19,"19051",61,54,54,0,0,"PODEMOS-IU-",3
50,"50184",90,79,79,0,0,"PODEMOS-IU-",2
45,"45004",552,434,434,4,0,"PODEMOS-IU-",43
40,"40180",277,231,224,3,7,"PODEMOS-IU-",7
9,"9275",166,130,130,2,0,"PODEMOS-IU-",12
45,"45188",2762,2144,2098,14,46,"PODEMOS-IU-",286
38,"38018",4455,3242,3198,24,44,"PODEMOS-IU-",282
45,"45142",7800,6245,6143,67,102,"PODEMOS-IU-",540
49,"49206",794,584,570,7,14,"PODEMOS-IU-",31
50,"50242",93,72,70,0,2,"PODEMOS-IU-",8
39,"39051",73,65,64,0,1,"PODEMOS-IU-",7
49,"49043",265,210,208,1,2,"PODEMOS-IU-",19
45,"45051",1634,1336,1290,9,46,"PODEMOS-IU-",78
19,"19107",315,273,270,2,3,"PODEMOS-IU-",17
49,"49126",273,161,160,1,1,"PODEMOS-IU-",13
5,"5206",29,21,20,1,1,"PODEMOS-IU-",1
50,"50243",311,252,247,1,5,"PODEMOS-IU-",5
10,"10128",5628,4238,4126,43,112,"PODEMOS-IU-",292
42,"42044",53,41,39,0,2,"PODEMOS-IU-",1
40,"40006",22,18,18,0,0,"PODEMOS-IU-",1
37,"37256",195,152,150,0,2,"PODEMOS-IU-",4
16,"16254",203,168,166,1,2,"PODEMOS-IU-",11
49,"49090",193,153,151,0,2,"PODEMOS-IU-",4
38,"38019",13758,8870,8776,46,94,"PODEMOS-IU-",713
50,"50096",36,22,22,0,0,"PODEMOS-IU-",2
49,"49044",78,64,64,1,0,"PODEMOS-IU-",1
6,"6154",2799,2075,2022,15,53,"PODEMOS-IU-",114
50,"50272",13174,10143,10042,103,101,"PODEMOS-IU-",1497
42,"42046",46,35,33,2,2,"PODEMOS-IU-",10
10,"10210",492,362,358,3,4,"PODEMOS-IU-",14
16,"16155",488,411,408,3,3,"PODEMOS-IU-",17
44,"44209",815,606,592,2,14,"PODEMOS-IU-",44
19,"19110",56,47,47,0,0,"PODEMOS-IU-",4
2,"2012",1825,1541,1509,8,32,"PODEMOS-IU-",104
34,"34050",185,156,156,2,0,"PODEMOS-IU-",9
37,"37333",202,138,137,4,1,"PODEMOS-IU-",6
34,"34190",49,36,36,3,0,"PODEMOS-IU-",1
5,"5261",33,26,26,0,0,"PODEMOS-IU-",1
49,"49047",100,72,72,0,0,"PODEMOS-IU-",1
47,"47197",867,721,717,2,4,"PODEMOS-IU-",19
9,"9175",119,93,93,0,0,"PODEMOS-IU-",4
38,"38021",1599,1079,1057,8,22,"PODEMOS-IU-",75
34,"34004",5533,4345,4286,41,59,"PODEMOS-IU-",453
9,"9067",407,285,278,2,7,"PODEMOS-IU-",20
37,"37170",1370,1009,990,10,19,"PODEMOS-IU-",51
44,"44179",325,233,231,7,2,"PODEMOS-IU-",32
13,"13076",461,377,369,0,8,"PODEMOS-IU-",15
37,"37296",298,241,239,2,2,"PODEMOS-IU-",7
42,"42141",114,89,89,0,0,"PODEMOS-IU-",6
40,"40150",61,53,53,1,0,"PODEMOS-IU-",7
26,"26078",86,71,70,1,1,"PODEMOS-IU-",8
47,"47198",66,47,47,0,0,"PODEMOS-IU-",2
19,"19112",53,41,40,1,1,"PODEMOS-IU-",0
10,"10132",365,276,271,2,5,"PODEMOS-IU-",14
19,"19059",74,53,46,0,7,"PODEMOS-IU-",3
40,"40115",156,131,130,4,1,"PODEMOS-IU-",8
45,"45195",2072,1615,1583,4,32,"PODEMOS-IU-",150
13,"13031",2471,2044,2020,15,24,"PODEMOS-IU-",131
9,"9021",51,36,35,1,1,"PODEMOS-IU-",7
34,"34199",1159,910,880,7,30,"PODEMOS-IU-",98
50,"50274",66,48,47,0,1,"PODEMOS-IU-",7
19,"19249",28,28,28,0,0,"PODEMOS-IU-",1
49,"49171",610,477,473,8,4,"PODEMOS-IU-",29
16,"16246",452,348,340,1,8,"PODEMOS-IU-",9
19,"19280",3611,2805,2767,25,38,"PODEMOS-IU-",462
37,"37261",217,166,163,0,3,"PODEMOS-IU-",9
10,"10038",83,70,69,0,1,"PODEMOS-IU-",3
16,"16192",43,30,29,0,1,"PODEMOS-IU-",0
13,"13017",247,189,188,2,1,"PODEMOS-IU-",7
40,"40080",48,39,39,0,0,"PODEMOS-IU-",0
24,"24210",527,387,386,0,1,"PODEMOS-IU-",39
26,"26121",30,21,21,1,0,"PODEMOS-IU-",0
37,"37067",3254,2742,2714,29,28,"PODEMOS-IU-",258
44,"44243",27,24,23,0,1,"PODEMOS-IU-",1
5,"5108",40,28,28,0,0,"PODEMOS-IU-",2
40,"40152",748,637,620,6,17,"PODEMOS-IU-",59
28,"28038",5155,4142,4090,20,52,"PODEMOS-IU-",838
37,"37185",537,416,405,1,11,"PODEMOS-IU-",25
6,"6126",2142,1619,1594,9,25,"PODEMOS-IU-",100
6,"6049",974,732,712,7,20,"PODEMOS-IU-",64
37,"37052",278,201,199,2,2,"PODEMOS-IU-",11
40,"40222",163,143,142,1,1,"PODEMOS-IU-",10
16,"16079",26,17,17,0,0,"PODEMOS-IU-",0
16,"16036",122,98,97,1,1,"PODEMOS-IU-",18
44,"44120",219,158,152,1,6,"PODEMOS-IU-",17
38,"38024",15310,10234,10088,82,146,"PODEMOS-IU-",864
24,"24051",394,290,283,3,7,"PODEMOS-IU-",22
34,"34101",45,39,38,0,1,"PODEMOS-IU-",1
45,"45015",662,506,500,2,6,"PODEMOS-IU-",52
19,"19116",12,9,9,1,0,"PODEMOS-IU-",1
30,"30008",14450,10832,10675,60,157,"PODEMOS-IU-",1491
45,"45107",3423,2806,2770,18,36,"PODEMOS-IU-",333
9,"9181",277,220,219,2,1,"PODEMOS-IU-",17
40,"40155",3835,3165,3121,43,44,"PODEMOS-IU-",386
39,"39057",2367,1831,1796,14,35,"PODEMOS-IU-",193
28,"28115",62352,53136,52912,268,224,"PODEMOS-IU-",3695
40,"40048",35,29,29,0,0,"PODEMOS-IU-",1
9,"9451",238,211,207,2,4,"PODEMOS-IU-",33
47,"47077",237,187,183,2,4,"PODEMOS-IU-",4
44,"44023",18,14,14,0,0,"PODEMOS-IU-",0
16,"16212",230,198,196,2,2,"PODEMOS-IU-",7
10,"10056",532,434,428,3,6,"PODEMOS-IU-",49
26,"26083",354,295,291,1,4,"PODEMOS-IU-",27
9,"9027",48,41,39,0,2,"PODEMOS-IU-",11
42,"42191",180,129,129,1,0,"PODEMOS-IU-",5
37,"37100",77,60,59,1,1,"PODEMOS-IU-",0
9,"9183",47,41,41,0,0,"PODEMOS-IU-",4
42,"42192",38,26,26,1,0,"PODEMOS-IU-",1
9,"9045",274,199,196,1,3,"PODEMOS-IU-",30
40,"40132",46,32,31,1,1,"PODEMOS-IU-",0
37,"37289",218,159,158,0,1,"PODEMOS-IU-",4
40,"40224",19,16,16,0,0,"PODEMOS-IU-",2
50,"50250",56,45,45,0,0,"PODEMOS-IU-",11
34,"34059",402,326,320,3,6,"PODEMOS-IU-",18
49,"49057",105,85,81,2,4,"PODEMOS-IU-",3
28,"28030",1815,1438,1395,10,43,"PODEMOS-IU-",300
26,"26125",2663,2042,2011,32,31,"PODEMOS-IU-",116
49,"49247",417,301,294,0,7,"PODEMOS-IU-",16
24,"24216",671,504,502,3,2,"PODEMOS-IU-",37
50,"50019",64,48,47,0,1,"PODEMOS-IU-",2
26,"26166",147,136,136,2,0,"PODEMOS-IU-",7
5,"5229",82,67,67,1,0,"PODEMOS-IU-",1
10,"10017",772,595,591,3,4,"PODEMOS-IU-",27
42,"42057",147,95,93,3,2,"PODEMOS-IU-",8
28,"28042",1266,1020,1010,2,10,"PODEMOS-IU-",153
37,"37267",182,153,150,1,3,"PODEMOS-IU-",19
2,"2022",344,252,252,1,0,"PODEMOS-IU-",7
44,"44154",248,200,195,2,5,"PODEMOS-IU-",25
9,"9132",171,136,130,1,6,"PODEMOS-IU-",7
28,"28117",98,89,87,2,2,"PODEMOS-IU-",17
49,"49178",747,574,564,4,10,"PODEMOS-IU-",70
45,"45112",1841,1250,1220,7,30,"PODEMOS-IU-",94
34,"34061",96,77,77,2,0,"PODEMOS-IU-",5
13,"13040",841,690,666,2,24,"PODEMOS-IU-",66
9,"9133",38,33,33,0,0,"PODEMOS-IU-",0
26,"26167",50,38,38,1,0,"PODEMOS-IU-",4
49,"49061",145,111,108,0,3,"PODEMOS-IU-",7
19,"19074",65,60,60,0,0,"PODEMOS-IU-",10
50,"50020",802,606,600,7,6,"PODEMOS-IU-",60
38,"38029",1493,839,823,5,16,"PODEMOS-IU-",116
28,"28043",6166,4404,4320,30,84,"PODEMOS-IU-",560
10,"10141",289,224,223,0,1,"PODEMOS-IU-",4
37,"37073",620,481,471,6,10,"PODEMOS-IU-",19
10,"10019",1416,1120,1094,3,26,"PODEMOS-IU-",123
16,"16217",94,77,77,0,0,"PODEMOS-IU-",5
5,"5116",96,77,75,0,2,"PODEMOS-IU-",3
10,"10142",840,641,639,5,2,"PODEMOS-IU-",86
26,"26089",111800,87863,86778,700,1085,"PODEMOS-IU-",11173
16,"16087",226,191,184,3,7,"PODEMOS-IU-",5
19,"19173",51,47,47,0,0,"PODEMOS-IU-",4
39,"39062",1841,1511,1500,9,11,"PODEMOS-IU-",122
44,"44189",48,36,36,0,0,"PODEMOS-IU-",3
19,"19022",571,443,434,7,9,"PODEMOS-IU-",31
45,"45023",2248,1799,1784,16,15,"PODEMOS-IU-",221
50,"50021",25,23,23,1,0,"PODEMOS-IU-",0
10,"10021",5045,3932,3840,32,92,"PODEMOS-IU-",428
45,"45115",2586,2158,2114,8,44,"PODEMOS-IU-",111
5,"5039",48,47,47,0,0,"PODEMOS-IU-",6
40,"40160",93,72,72,0,0,"PODEMOS-IU-",3
5,"5118",68,44,43,0,1,"PODEMOS-IU-",3
37,"37346",252,214,213,3,1,"PODEMOS-IU-",4
49,"49227",313,255,254,1,1,"PODEMOS-IU-",20
47,"47082",810,679,668,8,11,"PODEMOS-IU-",43
16,"16088",101,85,85,1,0,"PODEMOS-IU-",7
10,"10144",920,731,723,4,8,"PODEMOS-IU-",32
50,"50254",174,123,122,0,1,"PODEMOS-IU-",8
35,"35033",6403,4565,4502,34,63,"PODEMOS-IU-",593
19,"19126",1687,1306,1285,9,21,"PODEMOS-IU-",194
26,"26054",292,235,231,2,4,"PODEMOS-IU-",10
47,"47021",72,63,63,0,0,"PODEMOS-IU-",6
49,"49266",70,51,49,2,2,"PODEMOS-IU-",2
19,"19078",50,38,37,0,1,"PODEMOS-IU-",3
50,"50255",197,162,160,2,2,"PODEMOS-IU-",11
39,"39035",9169,7135,7045,40,90,"PODEMOS-IU-",708
50,"50283",69,53,52,3,1,"PODEMOS-IU-",0
34,"34068",29,24,23,0,1,"PODEMOS-IU-",4
39,"39064",1341,1103,1094,5,9,"PODEMOS-IU-",93
13,"13046",693,558,547,0,11,"PODEMOS-IU-",30
45,"45118",2088,1562,1540,11,22,"PODEMOS-IU-",183
24,"24059",821,575,572,3,3,"PODEMOS-IU-",51
50,"50198",49,43,43,1,0,"PODEMOS-IU-",5
19,"19263",22,13,12,0,1,"PODEMOS-IU-",0
28,"28088",286,193,193,2,0,"PODEMOS-IU-",45
37,"37310",172,125,124,3,1,"PODEMOS-IU-",4
40,"40056",32,21,21,0,0,"PODEMOS-IU-",0
49,"49064",483,319,317,1,2,"PODEMOS-IU-",17
19,"19221",35,26,26,0,0,"PODEMOS-IU-",1
42,"42063",47,31,28,0,3,"PODEMOS-IU-",1
19,"19061",53,45,45,0,0,"PODEMOS-IU-",4
44,"44128",59,46,45,0,1,"PODEMOS-IU-",1
34,"34070",135,101,101,1,0,"PODEMOS-IU-",11
16,"16008",83,65,65,0,0,"PODEMOS-IU-",8
19,"19129",27,25,25,0,0,"PODEMOS-IU-",0
44,"44256",34,32,32,1,0,"PODEMOS-IU-",0
45,"45028",3628,2916,2863,16,53,"PODEMOS-IU-",192
30,"30016",152709,110165,109114,717,1051,"PODEMOS-IU-",12068
40,"40234",376,307,299,2,8,"PODEMOS-IU-",16
37,"37349",103,69,68,0,1,"PODEMOS-IU-",1
24,"24101",384,285,283,4,2,"PODEMOS-IU-",33
13,"13004",996,769,763,3,6,"PODEMOS-IU-",39
16,"16161",52,47,47,0,0,"PODEMOS-IU-",3
16,"16209",111,97,97,0,0,"PODEMOS-IU-",9
9,"9199",94,72,70,0,2,"PODEMOS-IU-",1
9,"9309",292,224,223,3,1,"PODEMOS-IU-",19
47,"47024",232,189,188,0,1,"PODEMOS-IU-",11
19,"19266",229,194,192,1,2,"PODEMOS-IU-",9
47,"47213",108,84,84,0,0,"PODEMOS-IU-",4
47,"47181",165,143,143,0,0,"PODEMOS-IU-",12
19,"19034",23,23,22,0,1,"PODEMOS-IU-",2
5,"5044",250,189,189,1,0,"PODEMOS-IU-",6
5,"5083",141,104,103,2,1,"PODEMOS-IU-",2
10,"10068",711,576,556,2,20,"PODEMOS-IU-",55
34,"34071",161,138,138,0,0,"PODEMOS-IU-",8
5,"5239",231,177,174,1,3,"PODEMOS-IU-",4
37,"37083",176,160,156,1,4,"PODEMOS-IU-",7
37,"37199",129,97,97,0,0,"PODEMOS-IU-",5
9,"9311",59,47,46,0,1,"PODEMOS-IU-",9
6,"6039",1807,1506,1474,13,32,"PODEMOS-IU-",102
16,"16176",31,22,22,0,0,"PODEMOS-IU-",3
44,"44161",430,320,316,1,4,"PODEMOS-IU-",13
6,"6106",413,267,263,3,4,"PODEMOS-IU-",22
19,"19133",81,70,70,0,0,"PODEMOS-IU-",7
2,"2067",1129,866,852,4,14,"PODEMOS-IU-",91
30,"30019",25846,18755,18517,172,238,"PODEMOS-IU-",2334
37,"37315",86,68,67,0,1,"PODEMOS-IU-",2
34,"34072",143,130,128,1,2,"PODEMOS-IU-",9
5,"5073",289,239,238,0,1,"PODEMOS-IU-",16
37,"37214",116,87,87,4,0,"PODEMOS-IU-",4
45,"45187",3976,3365,3308,24,57,"PODEMOS-IU-",234
2,"2007",1013,820,813,6,7,"PODEMOS-IU-",110
13,"13022",332,264,256,1,8,"PODEMOS-IU-",9
40,"40049",40,30,29,0,1,"PODEMOS-IU-",2
44,"44131",27,22,22,0,0,"PODEMOS-IU-",4
34,"34031",26,24,24,0,0,"PODEMOS-IU-",1
40,"40903",77,63,62,0,1,"PODEMOS-IU-",2
6,"6040",987,747,739,6,8,"PODEMOS-IU-",32
49,"49151",593,453,444,5,9,"PODEMOS-IU-",52
13,"13054",4914,3946,3890,31,56,"PODEMOS-IU-",206
37,"37086",104,88,88,0,0,"PODEMOS-IU-",3
42,"42207",47,41,41,0,0,"PODEMOS-IU-",7
26,"26100",56,46,46,0,0,"PODEMOS-IU-",4
40,"40060",68,46,46,0,0,"PODEMOS-IU-",0
37,"37087",910,755,747,3,8,"PODEMOS-IU-",81
50,"50288",3444,2689,2668,24,21,"PODEMOS-IU-",324
6,"6108",2249,1726,1684,22,42,"PODEMOS-IU-",192
19,"19135",93,76,72,0,4,"PODEMOS-IU-",5
34,"34032",37,34,34,1,0,"PODEMOS-IU-",7
45,"45081",19138,15010,14829,110,181,"PODEMOS-IU-",1896
24,"24149",146,123,123,0,0,"PODEMOS-IU-",6
24,"24027",1219,913,886,8,27,"PODEMOS-IU-",141
50,"50175",924,713,710,9,3,"PODEMOS-IU-",104
16,"16098",520,441,439,6,2,"PODEMOS-IU-",40
47,"47217",1973,1569,1541,19,28,"PODEMOS-IU-",200
19,"19039",59,56,55,1,1,"PODEMOS-IU-",1
26,"26101",34,27,27,0,0,"PODEMOS-IU-",0
39,"39070",123,101,99,0,2,"PODEMOS-IU-",1
49,"49076",328,260,258,6,2,"PODEMOS-IU-",9
40,"40171",39,29,29,1,0,"PODEMOS-IU-",1
5,"5089",455,354,340,1,14,"PODEMOS-IU-",26
30,"30022",17056,12158,11954,126,204,"PODEMOS-IU-",1255
24,"24107",214,170,170,2,0,"PODEMOS-IU-",16
10,"10032",1596,1263,1243,5,20,"PODEMOS-IU-",120
19,"19230",548,437,430,1,7,"PODEMOS-IU-",67
9,"9048",1380,1070,1039,8,31,"PODEMOS-IU-",139
16,"16099",184,126,121,0,5,"PODEMOS-IU-",1
28,"28095",1677,1310,1293,4,17,"PODEMOS-IU-",207
10,"10033",403,306,302,6,4,"PODEMOS-IU-",7
40,"40906",2131,1830,1814,10,16,"PODEMOS-IU-",213
50,"50030",201,138,136,1,2,"PODEMOS-IU-",27
16,"16056",453,323,321,1,2,"PODEMOS-IU-",13
49,"49238",268,222,216,2,6,"PODEMOS-IU-",4
10,"10034",336,269,267,0,2,"PODEMOS-IU-",18
16,"16188",77,56,56,0,0,"PODEMOS-IU-",6
9,"9375",42,38,38,0,0,"PODEMOS-IU-",1
34,"34080",5291,3802,3728,35,74,"PODEMOS-IU-",334
24,"24902",335,266,263,1,3,"PODEMOS-IU-",27
16,"16101",139,123,122,0,1,"PODEMOS-IU-",7
34,"34079",1715,1421,1402,10,19,"PODEMOS-IU-",115
37,"37205",217,177,174,0,3,"PODEMOS-IU-",16
28,"28054",11891,9476,9395,64,81,"PODEMOS-IU-",1556
40,"40103",146,125,123,0,2,"PODEMOS-IU-",16
26,"26104",11,9,9,0,0,"PODEMOS-IU-",2
16,"16189",262,220,220,1,0,"PODEMOS-IU-",3
24,"24031",210,180,176,0,4,"PODEMOS-IU-",21
10,"10157",245,185,185,1,0,"PODEMOS-IU-",21
9,"9262",158,137,136,1,1,"PODEMOS-IU-",7
37,"37133",101,84,80,0,4,"PODEMOS-IU-",4
24,"24191",108,89,89,0,0,"PODEMOS-IU-",3
5,"5131",95,72,71,0,1,"PODEMOS-IU-",0
40,"40139",258,207,202,0,5,"PODEMOS-IU-",14
19,"19278",24,24,24,0,0,"PODEMOS-IU-",0
10,"10118",281,242,242,2,0,"PODEMOS-IU-",22
37,"37207",325,260,258,1,2,"PODEMOS-IU-",29
19,"19143",1754,1422,1402,11,20,"PODEMOS-IU-",126
49,"49118",194,151,151,1,0,"PODEMOS-IU-",4
44,"44200",39,25,25,0,0,"PODEMOS-IU-",0
19,"19044",284,226,223,1,3,"PODEMOS-IU-",13
2,"2075",1718,1470,1448,4,22,"PODEMOS-IU-",103
47,"47094",123,110,109,1,1,"PODEMOS-IU-",10
16,"16103",239,203,203,0,0,"PODEMOS-IU-",6
10,"10200",341,262,261,0,1,"PODEMOS-IU-",3
37,"37360",215,158,153,3,5,"PODEMOS-IU-",7
9,"9007",55,37,37,0,0,"PODEMOS-IU-",0
39,"39017",553,416,409,0,7,"PODEMOS-IU-",19
44,"44231",36,33,32,0,1,"PODEMOS-IU-",9
6,"6147",338,262,258,2,4,"PODEMOS-IU-",43
50,"50090",134,108,108,0,0,"PODEMOS-IU-",3
2,"2040",563,516,513,3,3,"PODEMOS-IU-",33
9,"9326",154,129,127,4,2,"PODEMOS-IU-",15
40,"40141",833,644,627,5,17,"PODEMOS-IU-",47
30,"30026",16252,11142,10977,65,165,"PODEMOS-IU-",937
47,"47033",204,167,167,2,0,"PODEMOS-IU-",10
50,"50238",86,66,66,2,0,"PODEMOS-IU-",12
39,"39074",7041,5612,5551,31,61,"PODEMOS-IU-",500
47,"47222",86,71,71,0,0,"PODEMOS-IU-",1
47,"47160",392,317,314,2,3,"PODEMOS-IU-",31
50,"50033",65,50,50,1,0,"PODEMOS-IU-",2
37,"37097",44,29,29,0,0,"PODEMOS-IU-",1
9,"9009",158,139,137,4,2,"PODEMOS-IU-",9
28,"28101",229,183,182,2,1,"PODEMOS-IU-",36
47,"47064",37,32,29,0,3,"PODEMOS-IU-",9
24,"24157",2545,2028,1972,25,56,"PODEMOS-IU-",199
5,"5251",56,39,39,0,0,"PODEMOS-IU-",2
24,"24076",1286,998,981,8,17,"PODEMOS-IU-",138
47,"47096",126,106,105,0,1,"PODEMOS-IU-",6
40,"40106",183,153,151,2,2,"PODEMOS-IU-",5
44,"44172",295,220,218,4,2,"PODEMOS-IU-",8
47,"47223",152,123,120,2,3,"PODEMOS-IU-",5
49,"49244",49,32,32,1,0,"PODEMOS-IU-",1
5,"5057",2401,1949,1917,19,32,"PODEMOS-IU-",120
9,"9434",1280,1089,1077,12,12,"PODEMOS-IU-",160
34,"34086",99,92,90,2,2,"PODEMOS-IU-",11
6,"6116",1512,1158,1144,3,14,"PODEMOS-IU-",78
44,"44042",114,84,84,0,0,"PODEMOS-IU-",5
47,"47192",94,82,81,2,1,"PODEMOS-IU-",10
28,"28134",63352,51185,50776,336,409,"PODEMOS-IU-",8133
9,"9386",55,49,49,0,0,"PODEMOS-IU-",3
47,"47035",902,715,707,5,8,"PODEMOS-IU-",46
42,"42129",678,540,539,1,1,"PODEMOS-IU-",35
16,"16195",458,368,364,3,4,"PODEMOS-IU-",15
34,"34181",422,324,321,3,3,"PODEMOS-IU-",25
42,"42041",31,23,23,1,0,"PODEMOS-IU-",0
28,"28029",562,459,456,2,3,"PODEMOS-IU-",91
37,"37364",757,549,536,7,13,"PODEMOS-IU-",25
50,"50211",237,177,173,0,4,"PODEMOS-IU-",8
10,"10002",359,284,279,2,5,"PODEMOS-IU-",29
40,"40144",18,16,16,0,0,"PODEMOS-IU-",1
9,"9330",1480,1180,1161,8,19,"PODEMOS-IU-",143
42,"42054",19,15,15,0,0,"PODEMOS-IU-",1
45,"45017",260,218,213,1,5,"PODEMOS-IU-",16
44,"44153",1749,1264,1243,11,21,"PODEMOS-IU-",125
34,"34206",814,668,660,13,8,"PODEMOS-IU-",31
49,"49069",327,211,207,0,4,"PODEMOS-IU-",7
6,"6085",3410,2719,2663,28,56,"PODEMOS-IU-",380
19,"19285",20,18,18,0,0,"PODEMOS-IU-",1
49,"49204",57,42,42,0,0,"PODEMOS-IU-",2
37,"37328",164,127,127,4,0,"PODEMOS-IU-",25
40,"40074",245,219,214,5,5,"PODEMOS-IU-",9
47,"47132",39,33,33,0,0,"PODEMOS-IU-",0
9,"9061",148,129,129,0,0,"PODEMOS-IU-",4
16,"16067",119,96,93,2,3,"PODEMOS-IU-",6
34,"34185",68,53,51,1,2,"PODEMOS-IU-",9
9,"9389",64,50,50,0,0,"PODEMOS-IU-",7
37,"37253",133,107,103,0,4,"PODEMOS-IU-",5
9,"9114",76,63,63,0,0,"PODEMOS-IU-",4
16,"16026",93,70,68,1,2,"PODEMOS-IU-",0
26,"26073",94,72,68,0,4,"PODEMOS-IU-",15
44,"44176",153,124,124,0,0,"PODEMOS-IU-",8
5,"5101",277,224,222,0,2,"PODEMOS-IU-",8
9,"9170",209,164,159,0,5,"PODEMOS-IU-",14
2,"2009",19456,15229,15007,152,222,"PODEMOS-IU-",1839
47,"47227",55,46,46,0,0,"PODEMOS-IU-",1
42,"42006",152,115,112,2,3,"PODEMOS-IU-",13
10,"10168",320,209,202,1,7,"PODEMOS-IU-",10
50,"50213",93,76,75,0,1,"PODEMOS-IU-",1
37,"37217",59,48,46,1,2,"PODEMOS-IU-",6
45,"45143",1190,940,925,3,15,"PODEMOS-IU-",151
47,"47101",1644,1354,1337,9,17,"PODEMOS-IU-",121
47,"47100",119,104,102,2,2,"PODEMOS-IU-",9
47,"47069",118,96,92,1,4,"PODEMOS-IU-",3
9,"9337",114,93,93,0,0,"PODEMOS-IU-",10
24,"24163",4073,3269,3231,36,38,"PODEMOS-IU-",368
50,"50010",66,56,55,2,1,"PODEMOS-IU-",3
34,"34048",63,54,53,2,1,"PODEMOS-IU-",6
24,"24003",608,430,418,0,12,"PODEMOS-IU-",22
5,"5022",1571,1295,1282,5,13,"PODEMOS-IU-",62
34,"34092",260,210,206,0,4,"PODEMOS-IU-",1
30,"30032",2851,2256,2218,14,38,"PODEMOS-IU-",161
45,"45144",740,605,598,7,7,"PODEMOS-IU-",41
19,"19006",757,556,548,7,8,"PODEMOS-IU-",53
38,"38050",2436,1564,1529,12,35,"PODEMOS-IU-",160
26,"26076",116,93,91,0,2,"PODEMOS-IU-",2
9,"9279",167,131,128,2,3,"PODEMOS-IU-",5
24,"24164",362,221,220,1,1,"PODEMOS-IU-",13
40,"40043",1791,1472,1447,9,25,"PODEMOS-IU-",72
39,"39081",437,356,347,2,9,"PODEMOS-IU-",14
47,"47135",82,69,67,1,2,"PODEMOS-IU-",1
40,"40183",116,103,103,0,0,"PODEMOS-IU-",3
24,"24122",1319,983,969,3,14,"PODEMOS-IU-",102
40,"40077",932,747,730,9,17,"PODEMOS-IU-",90
44,"44116",76,62,62,0,0,"PODEMOS-IU-",2
42,"42140",14,13,12,0,1,"PODEMOS-IU-",0
24,"24084",152,113,113,0,0,"PODEMOS-IU-",2
16,"16072",133,96,95,1,1,"PODEMOS-IU-",2
47,"47102",264,217,211,1,6,"PODEMOS-IU-",4
24,"24044",152,116,114,0,2,"PODEMOS-IU-",14
6,"6056",454,378,376,1,2,"PODEMOS-IU-",21
5,"5106",28,22,22,0,0,"PODEMOS-IU-",0
6,"6090",824,602,578,4,24,"PODEMOS-IU-",39
28,"28065",130679,106997,105975,762,1022,"PODEMOS-IU-",21096
45,"45102",3585,2724,2676,20,48,"PODEMOS-IU-",290
44,"44085",49,31,31,0,0,"PODEMOS-IU-",0
34,"34096",50,44,44,0,0,"PODEMOS-IU-",2
49,"49210",448,372,370,3,2,"PODEMOS-IU-",49
40,"40185",815,624,618,4,6,"PODEMOS-IU-",42
42,"42090",88,69,68,2,1,"PODEMOS-IU-",3
45,"45194",65,49,48,0,1,"PODEMOS-IU-",3
44,"44048",53,47,47,0,0,"PODEMOS-IU-",2
37,"37183",386,296,294,4,2,"PODEMOS-IU-",16
16,"16073",188,159,155,0,4,"PODEMOS-IU-",7
19,"19294",25,19,18,0,1,"PODEMOS-IU-",5
37,"37335",389,308,301,3,7,"PODEMOS-IU-",10
13,"13077",3399,2447,2380,30,67,"PODEMOS-IU-",238
26,"26006",1825,1496,1470,8,26,"PODEMOS-IU-",168
47,"47139",1004,790,776,2,14,"PODEMOS-IU-",60
34,"34098",783,614,605,3,9,"PODEMOS-IU-",77
47,"47104",2836,2339,2267,23,72,"PODEMOS-IU-",153
49,"49052",179,125,123,1,2,"PODEMOS-IU-",4
19,"19162",67,50,48,0,2,"PODEMOS-IU-",6
50,"50072",195,164,161,3,3,"PODEMOS-IU-",16
10,"10094",228,180,180,0,0,"PODEMOS-IU-",22
19,"19296",27,24,24,0,0,"PODEMOS-IU-",2
28,"28145",2640,2014,1987,11,27,"PODEMOS-IU-",317
47,"47074",141,122,122,2,0,"PODEMOS-IU-",16
19,"19208",41,34,34,0,0,"PODEMOS-IU-",4
42,"42144",423,338,336,4,2,"PODEMOS-IU-",32
34,"34099",52,45,41,0,4,"PODEMOS-IU-",2
5,"5264",57,40,38,1,2,"PODEMOS-IU-",5
50,"50101",832,625,614,1,11,"PODEMOS-IU-",85
37,"37112",152,104,103,0,1,"PODEMOS-IU-",4
40,"40188",83,71,71,0,0,"PODEMOS-IU-",1
26,"26162",112,95,94,0,1,"PODEMOS-IU-",6
34,"34009",30,26,26,0,0,"PODEMOS-IU-",2
24,"24169",2809,2165,2146,18,19,"PODEMOS-IU-",460
50,"50248",502,390,377,6,13,"PODEMOS-IU-",42
24,"24170",1839,1417,1391,7,26,"PODEMOS-IU-",241
19,"19115",32,23,23,0,0,"PODEMOS-IU-",0
5,"5110",706,550,546,4,4,"PODEMOS-IU-",36
49,"49173",344,220,216,1,4,"PODEMOS-IU-",9
10,"10013",266,203,202,2,1,"PODEMOS-IU-",15
47,"47141",118,103,102,0,1,"PODEMOS-IU-",0
24,"24090",326,213,213,2,0,"PODEMOS-IU-",24
50,"50219",4283,3274,3213,53,61,"PODEMOS-IU-",465
34,"34903",183,128,128,1,0,"PODEMOS-IU-",4
9,"9406",246,203,200,4,3,"PODEMOS-IU-",38
44,"44182",198,172,171,2,1,"PODEMOS-IU-",5
28,"28069",56,47,45,2,2,"PODEMOS-IU-",12
9,"9235",140,105,102,0,3,"PODEMOS-IU-",12
24,"24213",170,140,139,0,1,"PODEMOS-IU-",5
37,"37301",79,69,67,0,2,"PODEMOS-IU-",3
19,"19212",674,528,519,2,9,"PODEMOS-IU-",48
9,"9350",430,340,339,9,1,"PODEMOS-IU-",15
45,"45016",4442,3621,3583,21,38,"PODEMOS-IU-",434
10,"10015",627,488,475,0,13,"PODEMOS-IU-",43
44,"44089",52,44,44,0,0,"PODEMOS-IU-",7
37,"37114",78,64,59,0,5,"PODEMOS-IU-",2
19,"19167",129,104,102,0,2,"PODEMOS-IU-",4
47,"47193",1609,1347,1332,9,15,"PODEMOS-IU-",182
2,"2080",499,409,400,0,9,"PODEMOS-IU-",28
24,"24065",2175,1695,1660,18,35,"PODEMOS-IU-",178
28,"28158",678,547,540,1,7,"PODEMOS-IU-",88
34,"34088",264,211,207,1,4,"PODEMOS-IU-",33
40,"40083",72,53,51,3,2,"PODEMOS-IU-",1
19,"19255",72,51,51,0,0,"PODEMOS-IU-",3
13,"13038",1604,1251,1216,14,35,"PODEMOS-IU-",65
5,"5189",396,325,321,1,4,"PODEMOS-IU-",22
13,"13085",2287,1911,1885,13,26,"PODEMOS-IU-",95
9,"9076",24,17,17,1,0,"PODEMOS-IU-",1
50,"50018",893,705,696,3,9,"PODEMOS-IU-",30
28,"28149",6172,5089,5038,31,51,"PODEMOS-IU-",770
45,"45018",551,399,397,3,2,"PODEMOS-IU-",80
16,"16271",595,513,511,2,2,"PODEMOS-IU-",60
19,"19256",44,32,32,0,0,"PODEMOS-IU-",1
16,"16001",64,51,51,0,0,"PODEMOS-IU-",5
37,"37072",145,136,134,3,2,"PODEMOS-IU-",0
45,"45111",53,43,41,0,2,"PODEMOS-IU-",0
2,"2021",1014,836,827,5,9,"PODEMOS-IU-",50
37,"37304",159,105,105,0,0,"PODEMOS-IU-",1
39,"39060",6693,5459,5394,29,65,"PODEMOS-IU-",675
10,"10903",796,623,614,4,9,"PODEMOS-IU-",52
49,"49177",260,165,162,2,3,"PODEMOS-IU-",14
28,"28072",6088,5001,4961,23,40,"PODEMOS-IU-",800
44,"44092",70,56,55,1,1,"PODEMOS-IU-",9
42,"42153",12,10,10,1,0,"PODEMOS-IU-",0
5,"5154",34,25,25,1,0,"PODEMOS-IU-",0
44,"44185",93,73,72,1,1,"PODEMOS-IU-",10
24,"24217",133,106,105,1,1,"PODEMOS-IU-",6
40,"40087",87,70,70,0,0,"PODEMOS-IU-",5
19,"19122",81,64,64,1,0,"PODEMOS-IU-",12
5,"5231",151,126,126,0,0,"PODEMOS-IU-",2
28,"28150",3187,2640,2604,20,36,"PODEMOS-IU-",415
13,"13087",23207,17321,17032,202,289,"PODEMOS-IU-",1862
19,"19304",220,177,175,1,2,"PODEMOS-IU-",30
45,"45021",2605,1987,1950,23,37,"PODEMOS-IU-",200
16,"16003",133,111,110,1,1,"PODEMOS-IU-",15
50,"50297",502835,394653,391387,3269,3266,"PODEMOS-IU-",58410
9,"9079",48,42,42,1,0,"PODEMOS-IU-",0
45,"45068",171,142,142,0,0,"PODEMOS-IU-",15
26,"26128",96,74,74,1,0,"PODEMOS-IU-",6
16,"16004",227,193,191,0,2,"PODEMOS-IU-",11
24,"24056",2762,2062,2013,24,49,"PODEMOS-IU-",173
26,"26169",68,61,61,2,0,"PODEMOS-IU-",1
39,"39090",772,619,609,1,10,"PODEMOS-IU-",67
16,"16170",653,514,500,3,14,"PODEMOS-IU-",47
16,"16044",43,31,30,0,1,"PODEMOS-IU-",3
42,"42059",20,13,13,0,0,"PODEMOS-IU-",0
34,"34109",63,42,41,0,1,"PODEMOS-IU-",1
37,"37345",150,134,133,0,1,"PODEMOS-IU-",8
2,"2061",618,504,500,7,4,"PODEMOS-IU-",21
24,"24057",1306,1018,997,7,21,"PODEMOS-IU-",121
30,"30013",7467,5621,5553,26,68,"PODEMOS-IU-",477
9,"9192",55,48,47,2,1,"PODEMOS-IU-",8
2,"2025",7355,5864,5693,30,171,"PODEMOS-IU-",569
39,"39091",1885,1512,1503,6,9,"PODEMOS-IU-",122
10,"10185",573,463,460,3,3,"PODEMOS-IU-",43
47,"47051",321,274,272,1,2,"PODEMOS-IU-",41
47,"47147",102,85,85,0,0,"PODEMOS-IU-",5
40,"40195",813,630,623,5,7,"PODEMOS-IU-",33
10,"10063",161,141,141,1,0,"PODEMOS-IU-",12
16,"16045",185,142,141,0,1,"PODEMOS-IU-",5
44,"44158",1166,921,904,7,17,"PODEMOS-IU-",77
50,"50282",57,47,45,0,2,"PODEMOS-IU-",1
44,"44251",242,197,187,0,10,"PODEMOS-IU-",2
37,"37195",37,29,29,1,0,"PODEMOS-IU-",5
37,"37271",351,286,280,0,6,"PODEMOS-IU-",5
6,"6035",865,678,670,4,8,"PODEMOS-IU-",35
5,"5080",44,31,29,0,2,"PODEMOS-IU-",0
5,"5235",139,106,101,0,5,"PODEMOS-IU-",1
9,"9037",106,97,97,0,0,"PODEMOS-IU-",14
45,"45164",172,143,143,1,0,"PODEMOS-IU-",12
37,"37348",100,79,79,0,0,"PODEMOS-IU-",3
37,"37347",464,368,359,2,9,"PODEMOS-IU-",42
42,"42024",86,66,66,3,0,"PODEMOS-IU-",3
39,"39008",13900,10895,10767,81,128,"PODEMOS-IU-",1298
5,"5120",32,25,25,1,0,"PODEMOS-IU-",0
16,"16091",64,46,46,1,0,"PODEMOS-IU-",7
44,"44060",37,28,28,0,0,"PODEMOS-IU-",2
42,"42158",94,78,78,0,0,"PODEMOS-IU-",3
6,"6070",7686,6083,5948,44,135,"PODEMOS-IU-",605
45,"45074",401,335,326,3,9,"PODEMOS-IU-",18
37,"37160",606,431,418,6,13,"PODEMOS-IU-",23
50,"50171",96,78,78,1,0,"PODEMOS-IU-",2
47,"47085",16381,12697,12540,129,157,"PODEMOS-IU-",1334
47,"47023",3057,2577,2557,21,20,"PODEMOS-IU-",322
2,"2064",374,318,315,3,3,"PODEMOS-IU-",15
28,"28155",485,414,409,0,5,"PODEMOS-IU-",32
5,"5197",100,84,83,0,1,"PODEMOS-IU-",8
9,"9086",661,521,518,5,3,"PODEMOS-IU-",53
19,"19310",7,6,6,0,0,"PODEMOS-IU-",0
10,"10107",1030,840,828,5,12,"PODEMOS-IU-",107
42,"42201",23,20,20,0,0,"PODEMOS-IU-",3
49,"49147",249,197,196,1,1,"PODEMOS-IU-",10
9,"9363",922,733,725,3,8,"PODEMOS-IU-",43
37,"37313",534,413,411,1,2,"PODEMOS-IU-",11
42,"42113",521,382,380,3,2,"PODEMOS-IU-",21
44,"44062",31,24,23,1,1,"PODEMOS-IU-",1
45,"45167",1385,1143,1130,2,13,"PODEMOS-IU-",76
47,"47150",259,206,202,0,4,"PODEMOS-IU-",18
19,"19033",48,42,41,0,1,"PODEMOS-IU-",3
44,"44257",154,110,109,1,1,"PODEMOS-IU-",5
28,"28091",5474,4027,3977,26,50,"PODEMOS-IU-",612
38,"38005",5666,3795,3761,24,34,"PODEMOS-IU-",475
16,"16280",165,130,128,3,2,"PODEMOS-IU-",8
42,"42064",85,71,71,0,0,"PODEMOS-IU-",5
47,"47151",28,22,22,0,0,"PODEMOS-IU-",2
45,"45168",62790,50868,50335,359,533,"PODEMOS-IU-",6063
16,"16011",23,18,18,0,0,"PODEMOS-IU-",1
45,"45030",478,368,364,3,4,"PODEMOS-IU-",37
16,"16094",120,89,88,0,1,"PODEMOS-IU-",2
5,"5124",92,71,70,1,1,"PODEMOS-IU-",1
44,"44063",65,55,55,1,0,"PODEMOS-IU-",5
45,"45169",186,135,134,0,1,"PODEMOS-IU-",3
6,"6138",1013,783,767,3,16,"PODEMOS-IU-",53
37,"37239",206,184,181,3,3,"PODEMOS-IU-",29
37,"37314",82,72,68,0,4,"PODEMOS-IU-",1
16,"16901",630,498,492,4,6,"PODEMOS-IU-",39
37,"37352",201,159,158,0,1,"PODEMOS-IU-",8
50,"50202",131,90,88,1,2,"PODEMOS-IU-",3
9,"9351",62,51,50,1,1,"PODEMOS-IU-",4
10,"10138",540,422,415,3,7,"PODEMOS-IU-",58
49,"49163",215,151,148,1,3,"PODEMOS-IU-",15
40,"40179",626,540,529,2,11,"PODEMOS-IU-",39
19,"19017",57,50,49,0,1,"PODEMOS-IU-",6
2,"2068",324,274,273,0,1,"PODEMOS-IU-",29
42,"42029",131,98,97,2,1,"PODEMOS-IU-",0
9,"9422",32,27,26,2,1,"PODEMOS-IU-",1
40,"40097",125,96,95,1,1,"PODEMOS-IU-",4
49,"49112",118,78,78,2,0,"PODEMOS-IU-",15
28,"28051",1640,1301,1292,9,9,"PODEMOS-IU-",213
45,"45171",1326,1032,1013,6,19,"PODEMOS-IU-",66
44,"44163",114,92,92,0,0,"PODEMOS-IU-",7
37,"37241",164,129,127,0,2,"PODEMOS-IU-",3
47,"47057",273,204,200,0,4,"PODEMOS-IU-",20
10,"10071",124,85,84,0,1,"PODEMOS-IU-",4
37,"37006",117,81,81,2,0,"PODEMOS-IU-",14
42,"42030",89,72,72,0,0,"PODEMOS-IU-",5
9,"9424",34,24,24,0,0,"PODEMOS-IU-",2
50,"50028",77,59,58,1,1,"PODEMOS-IU-",4
38,"38038",164468,112475,111577,728,898,"PODEMOS-IU-",19024
24,"24066",449,329,324,3,5,"PODEMOS-IU-",25
16,"16238",464,387,383,2,4,"PODEMOS-IU-",20
34,"34076",545,475,473,2,2,"PODEMOS-IU-",18
28,"28160",8629,6922,6856,34,66,"PODEMOS-IU-",1024
44,"44197",50,35,35,0,0,"PODEMOS-IU-",3
44,"44035",105,86,84,1,2,"PODEMOS-IU-",0
45,"45173",9729,7664,7558,46,106,"PODEMOS-IU-",653
6,"6009",228,190,187,2,3,"PODEMOS-IU-",21
44,"44006",223,171,169,2,2,"PODEMOS-IU-",10
24,"24230",410,312,309,5,3,"PODEMOS-IU-",27
19,"19138",223,176,172,4,4,"PODEMOS-IU-",21
10,"10195",7557,5790,5691,38,99,"PODEMOS-IU-",403
16,"16187",55,43,43,0,0,"PODEMOS-IU-",1
34,"34124",63,58,58,0,0,"PODEMOS-IU-",3
40,"40204",151,109,104,1,5,"PODEMOS-IU-",5
16,"16905",1278,1028,1012,11,16,"PODEMOS-IU-",108
37,"37244",128,99,97,1,2,"PODEMOS-IU-",12
19,"19139",26,20,20,1,0,"PODEMOS-IU-",1
39,"39015",824,646,644,2,2,"PODEMOS-IU-",25
40,"40063",6944,5479,5352,39,127,"PODEMOS-IU-",656
6,"6043",686,553,544,6,9,"PODEMOS-IU-",52
49,"49192",124,102,102,2,0,"PODEMOS-IU-",4
19,"19274",950,753,741,7,12,"PODEMOS-IU-",118
10,"10075",236,186,182,1,4,"PODEMOS-IU-",27
6,"6077",321,260,256,4,4,"PODEMOS-IU-",41
37,"37357",258,0,0,0,0,"PODEMOS-IU-",0
49,"49115",169,137,136,0,1,"PODEMOS-IU-",5
9,"9318",58,37,37,0,0,"PODEMOS-IU-",3
34,"34175",87,67,66,0,1,"PODEMOS-IU-",4
5,"5169",219,176,173,1,3,"PODEMOS-IU-",6
9,"9101",74,57,57,0,0,"PODEMOS-IU-",5
42,"42033",50,45,44,1,1,"PODEMOS-IU-",0
28,"28129",8578,6925,6853,45,72,"PODEMOS-IU-",873
5,"5052",87,77,77,0,0,"PODEMOS-IU-",2
9,"9052",29,17,17,1,0,"PODEMOS-IU-",0
39,"39072",324,206,204,4,2,"PODEMOS-IU-",19
49,"49116",360,255,248,5,7,"PODEMOS-IU-",8
39,"39044",3868,3019,2985,8,34,"PODEMOS-IU-",354
42,"42076",201,157,151,0,6,"PODEMOS-IU-",12
28,"28097",125,100,100,0,0,"PODEMOS-IU-",24
42,"42078",1005,769,756,6,13,"PODEMOS-IU-",44
50,"50120",55,43,43,2,0,"PODEMOS-IU-",4
5,"5209",75,58,57,0,1,"PODEMOS-IU-",0
28,"28056",914,715,703,4,12,"PODEMOS-IU-",203
26,"26105",2211,1744,1723,19,21,"PODEMOS-IU-",169
37,"37359",163,122,117,0,5,"PODEMOS-IU-",4
2,"2038",266,217,216,1,1,"PODEMOS-IU-",11
34,"34129",170,134,132,2,2,"PODEMOS-IU-",2
24,"24112",299,226,223,1,3,"PODEMOS-IU-",23
9,"9325",177,117,117,2,0,"PODEMOS-IU-",8
45,"45041",3897,2959,2904,28,55,"PODEMOS-IU-",381
49,"49197",162,129,123,2,6,"PODEMOS-IU-",11
50,"50032",242,179,176,1,3,"PODEMOS-IU-",38
47,"47127",138,92,89,1,3,"PODEMOS-IU-",11
19,"19045",127,107,107,1,0,"PODEMOS-IU-",3
42,"42079",21,18,18,1,0,"PODEMOS-IU-",0
47,"47159",831,703,693,0,10,"PODEMOS-IU-",50
44,"44138",118,90,89,2,1,"PODEMOS-IU-",8
42,"42036",40,34,33,2,1,"PODEMOS-IU-",9
5,"5211",430,364,357,6,7,"PODEMOS-IU-",13
40,"40176",375,325,322,6,3,"PODEMOS-IU-",35
16,"16104",55,46,46,0,0,"PODEMOS-IU-",1
37,"37135",1163,934,924,8,10,"PODEMOS-IU-",50
37,"37361",81,63,61,0,2,"PODEMOS-IU-",3
37,"37051",80,59,58,0,1,"PODEMOS-IU-",0
39,"39102",2255,1711,1698,11,13,"PODEMOS-IU-",124
19,"19192",1759,1367,1360,3,7,"PODEMOS-IU-",52
45,"45090",368,287,286,1,1,"PODEMOS-IU-",9
9,"9433",58,51,50,1,1,"PODEMOS-IU-",4
24,"24114",2893,2017,1989,17,28,"PODEMOS-IU-",277
5,"5173",59,52,52,0,0,"PODEMOS-IU-",2
42,"42037",29,19,18,0,1,"PODEMOS-IU-",0
9,"9164",150,116,114,0,2,"PODEMOS-IU-",8
9,"9217",349,268,266,5,2,"PODEMOS-IU-",51
26,"26148",150,128,124,1,4,"PODEMOS-IU-",16
37,"37362",4729,3769,3720,36,49,"PODEMOS-IU-",366
13,"13064",1836,1455,1446,18,9,"PODEMOS-IU-",159
24,"24034",3457,2627,2588,31,39,"PODEMOS-IU-",467
49,"49121",368,269,266,1,3,"PODEMOS-IU-",30
40,"40107",92,76,74,0,2,"PODEMOS-IU-",3
16,"16023",507,401,398,2,3,"PODEMOS-IU-",59
5,"5252",58,38,38,0,0,"PODEMOS-IU-",0
47,"47034",72,57,57,1,0,"PODEMOS-IU-",1
19,"19048",19,13,13,0,0,"PODEMOS-IU-",2
16,"16247",63,53,53,1,0,"PODEMOS-IU-",1
5,"5135",398,324,320,2,4,"PODEMOS-IU-",12
37,"37212",101,85,83,0,2,"PODEMOS-IU-",10
45,"45046",2369,1860,1832,5,28,"PODEMOS-IU-",129
50,"50239",63,47,47,0,0,"PODEMOS-IU-",1
45,"45185",7600,6094,5999,19,95,"PODEMOS-IU-",553
50,"50268",42,33,32,1,1,"PODEMOS-IU-",12
19,"19284",10,9,9,1,0,"PODEMOS-IU-",0
49,"49162",175,134,131,1,3,"PODEMOS-IU-",11
40,"40212",27,22,20,0,2,"PODEMOS-IU-",1
26,"26071",8662,6409,6288,52,121,"PODEMOS-IU-",971
9,"9110",77,57,57,0,0,"PODEMOS-IU-",1
6,"6117",1401,1089,1067,6,22,"PODEMOS-IU-",47
37,"37288",276,225,224,5,1,"PODEMOS-IU-",8
10,"10084",1294,899,869,5,30,"PODEMOS-IU-",86
28,"28060",1565,1262,1247,5,15,"PODEMOS-IU-",190
6,"6161",288,226,222,1,4,"PODEMOS-IU-",16
5,"5034",14,12,12,0,0,"PODEMOS-IU-",0
50,"50115",3275,2399,2355,32,44,"PODEMOS-IU-",218
19,"19050",15,13,13,0,0,"PODEMOS-IU-",0
45,"45186",2945,2319,2280,11,39,"PODEMOS-IU-",520
24,"24117",412,336,335,0,1,"PODEMOS-IU-",11
19,"19196",90,77,70,1,7,"PODEMOS-IU-",5
50,"50155",90,70,69,0,1,"PODEMOS-IU-",1
24,"24118",104,66,66,0,0,"PODEMOS-IU-",8
47,"47067",153,119,119,3,0,"PODEMOS-IU-",3
37,"37140",642,422,418,2,4,"PODEMOS-IU-",18
44,"44113",72,51,50,0,1,"PODEMOS-IU-",25
42,"42131",52,37,37,0,0,"PODEMOS-IU-",1
10,"10085",319,240,236,1,4,"PODEMOS-IU-",16
28,"28106",78429,59182,58471,417,711,"PODEMOS-IU-",11495
34,"34089",140,119,114,2,5,"PODEMOS-IU-",16
10,"10044",1404,1092,1077,7,15,"PODEMOS-IU-",109
45,"45050",489,381,363,3,18,"PODEMOS-IU-",48
10,"10086",303,249,244,3,5,"PODEMOS-IU-",13
10,"10167",307,238,237,1,1,"PODEMOS-IU-",7
13,"13070",766,620,604,6,16,"PODEMOS-IU-",54
16,"16111",163,125,122,1,3,"PODEMOS-IU-",11
28,"28169",1553,1280,1273,15,7,"PODEMOS-IU-",158
40,"40005",25,21,21,0,0,"PODEMOS-IU-",1
44,"44114",238,188,184,1,4,"PODEMOS-IU-",17
50,"50067",13788,10562,10413,107,149,"PODEMOS-IU-",1030
37,"37019",140,118,117,1,1,"PODEMOS-IU-",3
40,"40215",83,69,69,0,0,"PODEMOS-IU-",5
28,"28108",3642,2878,2841,16,37,"PODEMOS-IU-",496
47,"47008",22,15,15,0,0,"PODEMOS-IU-",4
40,"40040",2495,1913,1895,20,18,"PODEMOS-IU-",93
19,"19156",933,756,745,1,11,"PODEMOS-IU-",45
37,"37331",188,130,130,1,0,"PODEMOS-IU-",4
5,"5259",106,87,87,0,0,"PODEMOS-IU-",6
44,"44177",101,75,75,1,0,"PODEMOS-IU-",4
9,"9064",305,251,249,3,2,"PODEMOS-IU-",7
50,"50157",286,226,220,0,6,"PODEMOS-IU-",27
40,"40111",52,44,44,0,0,"PODEMOS-IU-",0
37,"37020",425,341,339,4,2,"PODEMOS-IU-",29
45,"45191",521,449,446,0,3,"PODEMOS-IU-",21
49,"49008",431,293,289,2,4,"PODEMOS-IU-",15
44,"44208",26,22,22,0,0,"PODEMOS-IU-",1
24,"24004",494,408,403,7,5,"PODEMOS-IU-",33
44,"44239",22,19,19,0,0,"PODEMOS-IU-",3
34,"34093",81,70,70,0,0,"PODEMOS-IU-",1
9,"9065",138,118,117,1,1,"PODEMOS-IU-",15
24,"24121",616,491,484,4,7,"PODEMOS-IU-",74
9,"9443",152,115,112,0,3,"PODEMOS-IU-",11
6,"6122",6562,4837,4723,43,114,"PODEMOS-IU-",405
50,"50012",96,79,79,1,0,"PODEMOS-IU-",4
9,"9120",38,32,31,2,1,"PODEMOS-IU-",3
44,"44178",53,39,39,0,0,"PODEMOS-IU-",1
37,"37107",10483,7732,7633,78,99,"PODEMOS-IU-",488
37,"37022",245,200,196,2,4,"PODEMOS-IU-",11
50,"50159",641,527,526,8,1,"PODEMOS-IU-",39
49,"49129",821,628,616,5,12,"PODEMOS-IU-",74
45,"45193",589,512,507,6,5,"PODEMOS-IU-",30
37,"37371",258,176,175,0,1,"PODEMOS-IU-",1
42,"42010",21,18,16,0,2,"PODEMOS-IU-",1
5,"5025",82,70,70,0,0,"PODEMOS-IU-",0
10,"10131",12808,9377,9254,67,123,"PODEMOS-IU-",892
49,"49169",34,28,26,0,2,"PODEMOS-IU-",4
16,"16258",172,128,128,2,0,"PODEMOS-IU-",2
37,"37023",1586,1316,1298,12,18,"PODEMOS-IU-",108
19,"19203",29,25,25,0,0,"PODEMOS-IU-",3
50,"50245",76,58,58,0,0,"PODEMOS-IU-",8
37,"37259",36,29,29,0,0,"PODEMOS-IU-",0
49,"49252",304,244,241,6,3,"PODEMOS-IU-",18
28,"28035",1394,1057,1043,3,14,"PODEMOS-IU-",163
6,"6024",1133,963,941,5,22,"PODEMOS-IU-",99
45,"45056",2300,1526,1501,8,25,"PODEMOS-IU-",215
47,"47042",50,41,39,0,2,"PODEMOS-IU-",3
50,"50246",38,28,28,0,0,"PODEMOS-IU-",1
49,"49255",396,324,323,3,1,"PODEMOS-IU-",14
24,"24124",346,231,226,2,5,"PODEMOS-IU-",9
37,"37222",86,64,62,0,2,"PODEMOS-IU-",5
49,"49131",238,182,178,0,4,"PODEMOS-IU-",10
45,"45057",224,188,184,0,4,"PODEMOS-IU-",10
5,"5263",163,121,120,0,1,"PODEMOS-IU-",2
50,"50042",16,16,16,0,0,"PODEMOS-IU-",0
10,"10093",393,313,303,4,10,"PODEMOS-IU-",20
10,"10174",171,129,127,0,2,"PODEMOS-IU-",9
5,"5185",90,71,70,0,1,"PODEMOS-IU-",3
19,"19297",32,27,27,0,0,"PODEMOS-IU-",0
45,"45197",1894,1525,1499,6,26,"PODEMOS-IU-",65
28,"28112",154,137,137,1,0,"PODEMOS-IU-",13
9,"9023",1178,982,966,14,16,"PODEMOS-IU-",134
37,"37373",700,522,514,0,8,"PODEMOS-IU-",45
34,"34147",160,125,124,1,1,"PODEMOS-IU-",4
28,"28007",126831,103108,102202,710,906,"PODEMOS-IU-",17675
47,"47170",43,34,32,0,2,"PODEMOS-IU-",2
37,"37026",175,148,148,2,0,"PODEMOS-IU-",6
24,"24127",268,204,201,3,3,"PODEMOS-IU-",11
49,"49172",481,316,310,2,6,"PODEMOS-IU-",5
44,"44181",66,58,57,0,1,"PODEMOS-IU-",1
49,"49257",310,205,202,2,3,"PODEMOS-IU-",24
9,"9288",88,73,71,1,2,"PODEMOS-IU-",7
37,"37068",340,256,256,3,0,"PODEMOS-IU-",6
30,"30037",19254,14416,14217,67,199,"PODEMOS-IU-",1065
9,"9289",1379,1002,994,9,8,"PODEMOS-IU-",86
19,"19298",55,47,47,0,0,"PODEMOS-IU-",8
6,"6160",3019,2252,2209,10,43,"PODEMOS-IU-",176
5,"5030",43,36,36,0,0,"PODEMOS-IU-",13
34,"34010",553,454,449,3,5,"PODEMOS-IU-",31
10,"10217",521,436,432,0,4,"PODEMOS-IU-",18
28,"28177",10722,9093,9029,64,64,"PODEMOS-IU-",987
49,"49258",110,93,92,0,1,"PODEMOS-IU-",6
45,"45199",3107,2221,2184,8,37,"PODEMOS-IU-",382
9,"9450",25,17,17,0,0,"PODEMOS-IU-",0
40,"40120",196,176,169,0,7,"PODEMOS-IU-",11
19,"19065",114,92,91,0,1,"PODEMOS-IU-",17
34,"34011",386,326,321,2,5,"PODEMOS-IU-",15
44,"44215",168,121,120,1,1,"PODEMOS-IU-",13
2,"2019",2368,2009,1975,5,34,"PODEMOS-IU-",169
24,"24091",585,433,423,1,10,"PODEMOS-IU-",52
35,"35028",10044,6188,6105,52,83,"PODEMOS-IU-",912
26,"26010",85,68,68,1,0,"PODEMOS-IU-",2
13,"13037",790,633,620,3,13,"PODEMOS-IU-",23
5,"5188",41,36,34,0,2,"PODEMOS-IU-",0
9,"9454",42,37,36,0,1,"PODEMOS-IU-",5
37,"37340",142,101,101,0,0,"PODEMOS-IU-",0
39,"39077",236,175,173,0,2,"PODEMOS-IU-",7
19,"19182",39,32,32,0,0,"PODEMOS-IU-",9
19,"19334",44,37,37,0,0,"PODEMOS-IU-",2
49,"49260",700,558,548,8,10,"PODEMOS-IU-",25
39,"39030",1895,1374,1358,6,16,"PODEMOS-IU-",169
37,"37265",208,184,181,1,3,"PODEMOS-IU-",7
24,"24012",285,204,202,2,2,"PODEMOS-IU-",22
47,"47110",438,352,347,4,5,"PODEMOS-IU-",37
50,"50278",177,137,137,2,0,"PODEMOS-IU-",9
19,"19119",75,68,66,2,2,"PODEMOS-IU-",5
40,"40191",204,166,165,1,1,"PODEMOS-IU-",16
37,"37342",255,200,199,1,1,"PODEMOS-IU-",10
37,"37266",70,58,56,0,2,"PODEMOS-IU-",5
47,"47047",202,164,161,3,3,"PODEMOS-IU-",8
47,"47143",110,78,78,1,0,"PODEMOS-IU-",2
40,"40123",141,108,104,1,4,"PODEMOS-IU-",19
16,"16041",339,271,267,2,4,"PODEMOS-IU-",20
42,"42056",28,25,24,0,1,"PODEMOS-IU-",2
6,"6901",2117,1686,1655,17,31,"PODEMOS-IU-",157
10,"10140",1082,868,855,8,13,"PODEMOS-IU-",45
28,"28011",420,315,311,1,4,"PODEMOS-IU-",54
24,"24055",676,513,508,6,5,"PODEMOS-IU-",42
5,"5036",116,100,100,0,0,"PODEMOS-IU-",0
45,"45066",7770,6064,5962,21,102,"PODEMOS-IU-",596
19,"19071",8155,6327,6242,35,85,"PODEMOS-IU-",806
10,"10100",783,584,566,7,18,"PODEMOS-IU-",76
47,"47079",54,48,48,0,0,"PODEMOS-IU-",2
28,"28012",918,727,711,6,16,"PODEMOS-IU-",62
45,"45067",2289,1860,1820,17,40,"PODEMOS-IU-",105
44,"44217",31,25,25,0,0,"PODEMOS-IU-",3
47,"47145",586,446,440,2,6,"PODEMOS-IU-",61
6,"6032",78,65,64,0,1,"PODEMOS-IU-",8
37,"37032",549,431,430,3,1,"PODEMOS-IU-",22
39,"39033",540,430,423,1,7,"PODEMOS-IU-",24
35,"35031",7412,5593,5519,41,74,"PODEMOS-IU-",865
37,"37155",68,52,52,0,0,"PODEMOS-IU-",5
19,"19216",130,100,99,1,1,"PODEMOS-IU-",22
44,"44218",31,25,25,2,0,"PODEMOS-IU-",3
5,"5077",158,133,131,1,2,"PODEMOS-IU-",7
39,"39061",3488,2833,2798,18,35,"PODEMOS-IU-",264
50,"50195",53,42,41,0,1,"PODEMOS-IU-",10
10,"10101",179,140,138,2,2,"PODEMOS-IU-",12
37,"37381",139,97,95,1,2,"PODEMOS-IU-",3
24,"24176",299,243,238,3,5,"PODEMOS-IU-",9
16,"16043",88,71,71,1,0,"PODEMOS-IU-",4
28,"28119",2245,1839,1821,10,18,"PODEMOS-IU-",241
45,"45114",560,441,436,0,5,"PODEMOS-IU-",31
37,"37077",252,216,213,2,3,"PODEMOS-IU-",7
16,"16129",90,78,77,0,1,"PODEMOS-IU-",2
10,"10062",393,339,334,0,5,"PODEMOS-IU-",49
34,"34214",178,141,141,1,0,"PODEMOS-IU-",7
16,"16005",232,175,172,0,3,"PODEMOS-IU-",17
26,"26091",147,132,131,1,1,"PODEMOS-IU-",7
10,"10184",740,607,597,5,10,"PODEMOS-IU-",65
28,"28120",1209,991,974,3,17,"PODEMOS-IU-",110
13,"13044",2569,1984,1951,12,33,"PODEMOS-IU-",123
40,"40089",214,176,170,1,6,"PODEMOS-IU-",15
42,"42060",29,20,19,0,1,"PODEMOS-IU-",0
5,"5079",68,56,56,0,0,"PODEMOS-IU-",2
24,"24221",750,563,553,6,10,"PODEMOS-IU-",35
37,"37194",237,182,181,0,1,"PODEMOS-IU-",24
42,"42107",67,48,48,0,0,"PODEMOS-IU-",6
47,"47083",83,66,65,1,1,"PODEMOS-IU-",9
34,"34159",370,247,244,5,3,"PODEMOS-IU-",38
49,"49023",909,682,674,5,8,"PODEMOS-IU-",35
40,"40231",98,80,80,2,0,"PODEMOS-IU-",7
47,"47115",276,231,223,1,8,"PODEMOS-IU-",4
49,"49063",310,246,240,2,6,"PODEMOS-IU-",21
28,"28046",4776,3944,3912,22,32,"PODEMOS-IU-",653
50,"50169",336,261,259,2,2,"PODEMOS-IU-",27
28,"28076",425,354,349,3,5,"PODEMOS-IU-",47
10,"10105",2476,1798,1760,21,38,"PODEMOS-IU-",144
28,"28901",868,653,639,6,14,"PODEMOS-IU-",125
47,"47084",1101,880,871,7,9,"PODEMOS-IU-",46
9,"9467",60,46,46,0,0,"PODEMOS-IU-",3
13,"13001",1195,947,943,5,4,"PODEMOS-IU-",49
16,"16276",21,18,18,1,0,"PODEMOS-IU-",0
6,"6135",1096,915,902,3,13,"PODEMOS-IU-",50
28,"28121",205,166,165,1,1,"PODEMOS-IU-",14
49,"49268",368,282,279,2,3,"PODEMOS-IU-",9
26,"26055",39,35,35,1,0,"PODEMOS-IU-",3
47,"47179",373,275,273,1,2,"PODEMOS-IU-",27
10,"10106",127,108,106,0,2,"PODEMOS-IU-",9
39,"39009",3307,2545,2526,11,19,"PODEMOS-IU-",241
40,"40057",1405,1176,1163,10,13,"PODEMOS-IU-",102
47,"47053",126,100,97,0,3,"PODEMOS-IU-",14
26,"26173",6,6,6,0,0,"PODEMOS-IU-",0
24,"24021",1602,1211,1194,7,17,"PODEMOS-IU-",176
45,"45119",3485,2478,2430,21,48,"PODEMOS-IU-",387
37,"37037",107,86,86,0,0,"PODEMOS-IU-",1
37,"37161",121,88,88,0,0,"PODEMOS-IU-",3
10,"10188",478,387,379,0,8,"PODEMOS-IU-",9
42,"42159",40,36,35,0,1,"PODEMOS-IU-",2
49,"49231",293,212,209,0,3,"PODEMOS-IU-",12
37,"37001",172,133,133,0,0,"PODEMOS-IU-",8
38,"38035",10384,6657,6596,50,61,"PODEMOS-IU-",804
5,"5238",739,589,586,1,3,"PODEMOS-IU-",59
16,"16279",174,125,125,0,0,"PODEMOS-IU-",8
10,"10108",203,131,130,1,1,"PODEMOS-IU-",8
19,"19081",27,19,19,0,0,"PODEMOS-IU-",0
49,"49027",126,88,88,0,0,"PODEMOS-IU-",6
6,"6005",1691,1246,1225,15,21,"PODEMOS-IU-",86
50,"50142",24,18,18,0,0,"PODEMOS-IU-",4
39,"39094",841,676,670,3,6,"PODEMOS-IU-",57
40,"40024",827,657,645,4,12,"PODEMOS-IU-",34
6,"6072",2225,1777,1752,20,25,"PODEMOS-IU-",127
47,"47119",87,66,65,1,1,"PODEMOS-IU-",0
30,"30018",8326,6544,6438,25,106,"PODEMOS-IU-",520
26,"26175",47,40,40,2,0,"PODEMOS-IU-",0
13,"13006",572,437,430,5,7,"PODEMOS-IU-",11
28,"28019",1269,990,981,4,9,"PODEMOS-IU-",154
9,"9476",60,50,50,0,0,"PODEMOS-IU-",1
44,"44033",244,174,172,0,2,"PODEMOS-IU-",10
40,"40902",117,96,96,1,0,"PODEMOS-IU-",4
16,"16095",81,69,68,1,1,"PODEMOS-IU-",4
49,"49187",1202,930,921,8,9,"PODEMOS-IU-",50
28,"28157",682,530,516,1,14,"PODEMOS-IU-",53
2,"2031",541,432,425,0,7,"PODEMOS-IU-",40
50,"50259",84,58,58,0,0,"PODEMOS-IU-",2
28,"28092",153428,121511,120211,807,1300,"PODEMOS-IU-",20712
6,"6073",700,506,492,11,14,"PODEMOS-IU-",128
37,"37028",137,111,107,1,4,"PODEMOS-IU-",4
6,"6084",1065,904,890,8,14,"PODEMOS-IU-",39
24,"24131",677,468,463,1,5,"PODEMOS-IU-",29
45,"45033",298,224,221,1,3,"PODEMOS-IU-",11
19,"19087",17,14,14,0,0,"PODEMOS-IU-",1
5,"5086",76,64,61,0,3,"PODEMOS-IU-",0
42,"42069",1491,1073,1048,20,25,"PODEMOS-IU-",132
9,"9312",89,75,74,2,1,"PODEMOS-IU-",7
37,"37041",73,55,55,0,0,"PODEMOS-IU-",1
39,"39040",4267,3428,3385,24,43,"PODEMOS-IU-",261
50,"50174",83,58,58,0,0,"PODEMOS-IU-",2
28,"28020",169,110,109,0,1,"PODEMOS-IU-",37
13,"13008",427,304,302,0,2,"PODEMOS-IU-",10
37,"37042",41,32,31,1,1,"PODEMOS-IU-",0
24,"24148",1616,1252,1237,11,15,"PODEMOS-IU-",107
42,"42164",1589,1201,1172,10,29,"PODEMOS-IU-",94
44,"44132",58,47,47,0,0,"PODEMOS-IU-",2
40,"40026",113,106,105,2,1,"PODEMOS-IU-",28
9,"9315",393,291,286,4,5,"PODEMOS-IU-",39
16,"16185",35,29,29,0,0,"PODEMOS-IU-",2
44,"44226",124,87,83,2,4,"PODEMOS-IU-",13
37,"37278",789,618,613,8,5,"PODEMOS-IU-",70
19,"19228",29,22,22,0,0,"PODEMOS-IU-",3
10,"10113",2258,1695,1657,6,38,"PODEMOS-IU-",236
6,"6075",475,379,369,2,10,"PODEMOS-IU-",13
39,"39041",1767,1437,1417,18,20,"PODEMOS-IU-",141
2,"2034",1324,1088,1083,10,5,"PODEMOS-IU-",137
19,"19090",90,73,72,1,1,"PODEMOS-IU-",7
9,"9483",189,153,150,1,3,"PODEMOS-IU-",14
40,"40029",24,21,21,0,0,"PODEMOS-IU-",0
44,"44227",72,61,61,0,0,"PODEMOS-IU-",2
47,"47185",87,77,77,0,0,"PODEMOS-IU-",4
19,"19229",57,52,52,0,0,"PODEMOS-IU-",2
10,"10072",835,632,625,3,7,"PODEMOS-IU-",51
13,"13056",11657,9236,9142,85,94,"PODEMOS-IU-",1429
10,"10155",1082,825,819,4,6,"PODEMOS-IU-",76
28,"28023",5090,4252,4212,31,40,"PODEMOS-IU-",798
9,"9485",56,50,50,2,0,"PODEMOS-IU-",0
37,"37168",407,305,300,0,5,"PODEMOS-IU-",10
26,"26181",14,14,14,0,0,"PODEMOS-IU-",0
37,"37280",71,41,40,0,1,"PODEMOS-IU-",1
50,"50290",358,272,266,6,6,"PODEMOS-IU-",21
49,"49154",109,64,63,0,1,"PODEMOS-IU-",7
47,"47218",979,757,745,5,12,"PODEMOS-IU-",129
9,"9211",1362,1065,1050,16,15,"PODEMOS-IU-",71
19,"19041",167,133,129,1,4,"PODEMOS-IU-",17
6,"6044",29204,21778,21492,203,286,"PODEMOS-IU-",2108
37,"37046",10749,8133,7989,84,144,"PODEMOS-IU-",771
45,"45130",302,241,235,2,6,"PODEMOS-IU-",15
13,"13059",196,169,168,0,1,"PODEMOS-IU-",20
5,"5090",77,70,69,0,1,"PODEMOS-IU-",0
50,"50177",276,226,223,0,3,"PODEMOS-IU-",18
50,"50263",176,119,116,0,3,"PODEMOS-IU-",13
49,"49033",666,515,508,1,7,"PODEMOS-IU-",28
9,"9321",1597,1293,1280,4,13,"PODEMOS-IU-",68
45,"45176",3841,2992,2952,16,40,"PODEMOS-IU-",411
9,"9102",33,26,25,0,1,"PODEMOS-IU-",8
37,"37047",228,93,92,1,1,"PODEMOS-IU-",2
28,"28055",907,671,666,5,5,"PODEMOS-IU-",43
47,"47187",75,54,53,0,1,"PODEMOS-IU-",0
10,"10198",1071,945,924,3,21,"PODEMOS-IU-",17
47,"47031",196,155,155,3,0,"PODEMOS-IU-",6
50,"50003",119,95,95,1,0,"PODEMOS-IU-",3
38,"38041",6970,5288,5258,38,30,"PODEMOS-IU-",773
16,"16102",1163,951,943,16,8,"PODEMOS-IU-",32
5,"5246",52,39,39,0,0,"PODEMOS-IU-",0
34,"34081",60,48,48,0,0,"PODEMOS-IU-",1
47,"47158",858,672,663,8,9,"PODEMOS-IU-",65
45,"45132",2376,1915,1908,13,7,"PODEMOS-IU-",143
49,"49240",185,141,136,0,5,"PODEMOS-IU-",10
47,"47062",157,134,134,0,0,"PODEMOS-IU-",4
35,"35015",10728,6233,6108,54,125,"PODEMOS-IU-",1037
5,"5054",1203,946,927,5,19,"PODEMOS-IU-",157
5,"5172",116,95,93,0,2,"PODEMOS-IU-",4
45,"45180",2834,2269,2239,11,30,"PODEMOS-IU-",168
16,"16191",858,707,701,8,6,"PODEMOS-IU-",27
44,"44108",300,228,224,5,4,"PODEMOS-IU-",34
44,"44040",191,164,158,2,6,"PODEMOS-IU-",15
28,"28099",1923,1490,1475,7,15,"PODEMOS-IU-",160
44,"44009",799,621,611,7,10,"PODEMOS-IU-",51
16,"16061",941,790,763,8,27,"PODEMOS-IU-",57
37,"37012",145,116,114,0,2,"PODEMOS-IU-",6
45,"45181",2337,1846,1818,7,28,"PODEMOS-IU-",87
45,"45088",2332,1724,1695,16,29,"PODEMOS-IU-",181
10,"10120",156,110,108,0,2,"PODEMOS-IU-",6
45,"45134",1609,1305,1291,6,14,"PODEMOS-IU-",154
45,"45089",1432,1159,1134,5,25,"PODEMOS-IU-",186
28,"28027",1200,920,906,4,14,"PODEMOS-IU-",121
35,"35016",300503,203470,201240,1598,2230,"PODEMOS-IU-",36089
24,"24156",220,146,144,2,2,"PODEMOS-IU-",15
42,"42217",34,26,26,0,0,"PODEMOS-IU-",3
37,"37285",366,273,272,1,1,"PODEMOS-IU-",19
34,"34179",26,20,19,0,1,"PODEMOS-IU-",1
47,"47003",204,171,168,4,3,"PODEMOS-IU-",7
40,"40210",98,70,70,0,0,"PODEMOS-IU-",4
13,"13019",5095,3758,3717,25,41,"PODEMOS-IU-",642
50,"50181",1000,770,754,7,16,"PODEMOS-IU-",104
44,"44041",58,48,44,1,4,"PODEMOS-IU-",11
37,"37098",304,214,210,0,4,"PODEMOS-IU-",17
10,"10081",184,142,140,4,2,"PODEMOS-IU-",15
50,"50006",908,705,689,3,16,"PODEMOS-IU-",65
49,"49038",94,68,68,1,0,"PODEMOS-IU-",5
6,"6016",2943,2283,2247,24,36,"PODEMOS-IU-",155
10,"10203",4428,3212,3152,25,60,"PODEMOS-IU-",263
49,"49002",58,49,43,0,6,"PODEMOS-IU-",5
42,"42082",7,7,7,0,0,"PODEMOS-IU-",1
40,"40211",69,58,58,1,0,"PODEMOS-IU-",3
26,"26033",163,143,142,3,1,"PODEMOS-IU-",21
28,"28102",891,681,666,4,15,"PODEMOS-IU-",103
44,"44142",28,21,21,0,0,"PODEMOS-IU-",3
50,"50092",300,234,230,1,4,"PODEMOS-IU-",12
24,"24037",337,234,234,1,0,"PODEMOS-IU-",30
47,"47066",1407,1131,1122,11,9,"PODEMOS-IU-",142
42,"42083",26,22,22,0,0,"PODEMOS-IU-",1
9,"9219",27153,20116,19831,215,285,"PODEMOS-IU-",4008
5,"5214",27,22,22,0,0,"PODEMOS-IU-",2
24,"24078",336,259,255,0,4,"PODEMOS-IU-",14
19,"19151",1083,785,770,5,15,"PODEMOS-IU-",99
6,"6150",780,637,635,2,2,"PODEMOS-IU-",96
5,"5138",289,224,223,2,1,"PODEMOS-IU-",4
50,"50008",5185,3753,3711,35,42,"PODEMOS-IU-",727
10,"10205",1965,1344,1300,8,44,"PODEMOS-IU-",171
24,"24214",634,473,471,3,2,"PODEMOS-IU-",44
10,"10029",380,320,315,1,5,"PODEMOS-IU-",21
47,"47006",186,153,149,1,4,"PODEMOS-IU-",36
19,"19104",18,16,16,0,0,"PODEMOS-IU-",0
47,"47098",556,480,475,4,5,"PODEMOS-IU-",50
2,"2044",1049,746,737,5,9,"PODEMOS-IU-",39
26,"26072",285,252,247,1,5,"PODEMOS-IU-",30
9,"9013",44,37,37,0,0,"PODEMOS-IU-",5
44,"44236",59,44,44,0,0,"PODEMOS-IU-",7
24,"24160",645,481,475,1,6,"PODEMOS-IU-",38
37,"37177",265,209,208,0,1,"PODEMOS-IU-",9
10,"10125",862,655,639,4,16,"PODEMOS-IU-",52
5,"5060",109,88,88,0,0,"PODEMOS-IU-",6
45,"45095",660,528,519,3,9,"PODEMOS-IU-",19
13,"13069",618,488,469,3,19,"PODEMOS-IU-",23
42,"42177",64,55,54,6,1,"PODEMOS-IU-",1
10,"10207",464,349,340,3,9,"PODEMOS-IU-",18
50,"50037",127,93,93,0,0,"PODEMOS-IU-",5
19,"19154",59,48,47,0,1,"PODEMOS-IU-",0
49,"49042",230,179,174,1,5,"PODEMOS-IU-",21
44,"44237",368,299,293,2,6,"PODEMOS-IU-",18
44,"44145",972,741,732,11,9,"PODEMOS-IU-",85
44,"44044",83,65,64,2,1,"PODEMOS-IU-",2
6,"6053",590,461,444,7,17,"PODEMOS-IU-",32
16,"16068",127,104,104,4,0,"PODEMOS-IU-",5
2,"2010",1798,1494,1469,6,25,"PODEMOS-IU-",109
19,"19243",36,32,31,0,1,"PODEMOS-IU-",3
9,"9016",84,55,54,0,1,"PODEMOS-IU-",6
19,"19155",66,56,56,0,0,"PODEMOS-IU-",8
10,"10006",1230,1006,995,8,11,"PODEMOS-IU-",39
9,"9017",90,72,70,2,2,"PODEMOS-IU-",1
45,"45052",3134,2670,2652,23,18,"PODEMOS-IU-",332
6,"6021",908,708,698,9,10,"PODEMOS-IU-",22
10,"10087",1606,1239,1223,5,16,"PODEMOS-IU-",80
9,"9117",71,55,53,0,2,"PODEMOS-IU-",2
45,"45190",458,378,365,2,13,"PODEMOS-IU-",29
16,"16112",1468,1108,1096,6,12,"PODEMOS-IU-",101
50,"50128",27,24,24,0,0,"PODEMOS-IU-",4
40,"40041",967,773,764,9,9,"PODEMOS-IU-",44
37,"37292",94,76,73,1,3,"PODEMOS-IU-",1
28,"28033",4082,3172,3140,13,32,"PODEMOS-IU-",364
47,"47009",99,84,84,0,0,"PODEMOS-IU-",7
16,"16070",28,26,26,1,0,"PODEMOS-IU-",2
19,"19055",44,34,34,1,0,"PODEMOS-IU-",3
5,"5181",46,39,39,0,0,"PODEMOS-IU-",3
34,"34001",39,32,32,3,0,"PODEMOS-IU-",9
45,"45100",179,150,148,1,2,"PODEMOS-IU-",7
50,"50098",162,121,120,3,1,"PODEMOS-IU-",7
28,"28109",1622,1205,1192,3,13,"PODEMOS-IU-",164
10,"10048",204,156,154,0,2,"PODEMOS-IU-",7
5,"5023",175,158,155,2,3,"PODEMOS-IU-",5
45,"45192",2412,2103,2068,7,35,"PODEMOS-IU-",96
16,"16255",136,108,108,0,0,"PODEMOS-IU-",2
6,"6155",1825,1316,1292,21,24,"PODEMOS-IU-",108
50,"50273",32,24,24,0,0,"PODEMOS-IU-",1
28,"28110",2003,1596,1571,7,25,"PODEMOS-IU-",178
30,"30003",25046,17860,17668,99,192,"PODEMOS-IU-",1716
50,"50188",27,24,24,0,0,"PODEMOS-IU-",3
44,"44240",149,121,121,0,0,"PODEMOS-IU-",7
19,"19111",162,142,142,0,0,"PODEMOS-IU-",9
39,"39054",4528,3614,3575,23,39,"PODEMOS-IU-",381
26,"26005",2480,1687,1661,5,26,"PODEMOS-IU-",180
47,"47168",30,29,29,0,0,"PODEMOS-IU-",3
10,"10009",263,196,193,2,3,"PODEMOS-IU-",8
9,"9020",237,184,180,5,4,"PODEMOS-IU-",3
6,"6156",1171,919,901,10,18,"PODEMOS-IU-",77
39,"39082",1622,1261,1252,16,9,"PODEMOS-IU-",68
34,"34196",88,74,74,4,0,"PODEMOS-IU-",6
24,"24086",266,211,210,0,1,"PODEMOS-IU-",7
30,"30035",19268,14248,14103,92,145,"PODEMOS-IU-",1459
5,"5222",152,111,109,0,2,"PODEMOS-IU-",6
10,"10091",350,293,291,1,2,"PODEMOS-IU-",25
30,"30004",1126,884,876,5,8,"PODEMOS-IU-",64
40,"40151",43,32,32,0,0,"PODEMOS-IU-",4
5,"5107",55,43,43,2,0,"PODEMOS-IU-",3
28,"28036",2675,2135,2093,17,42,"PODEMOS-IU-",427
9,"9345",117,96,95,1,1,"PODEMOS-IU-",8
6,"6157",397,296,292,1,4,"PODEMOS-IU-",13
38,"38053",3763,2628,2588,21,40,"PODEMOS-IU-",252
30,"30005",30193,22648,22419,136,229,"PODEMOS-IU-",2003
13,"13032",1084,842,831,9,11,"PODEMOS-IU-",50
37,"37065",271,187,184,0,3,"PODEMOS-IU-",6
44,"44212",41,32,32,0,0,"PODEMOS-IU-",3
6,"6026",815,661,653,5,8,"PODEMOS-IU-",50
38,"38901",1456,1024,1010,9,14,"PODEMOS-IU-",126
45,"45012",631,516,509,2,7,"PODEMOS-IU-",61
19,"19163",60,46,44,0,2,"PODEMOS-IU-",9
30,"30006",829,731,727,4,4,"PODEMOS-IU-",72
50,"50015",81,61,59,1,2,"PODEMOS-IU-",0
45,"45105",380,284,275,2,9,"PODEMOS-IU-",16
13,"13078",8936,6820,6733,46,87,"PODEMOS-IU-",460
39,"39056",2268,1847,1830,7,17,"PODEMOS-IU-",136
47,"47140",110,91,90,0,1,"PODEMOS-IU-",4
42,"42013",37,29,29,0,0,"PODEMOS-IU-",0
16,"16035",238,190,188,0,2,"PODEMOS-IU-",21
16,"16119",179,128,128,0,0,"PODEMOS-IU-",19
28,"28068",11554,9122,9022,44,100,"PODEMOS-IU-",1240
50,"50163",3787,3041,3022,31,19,"PODEMOS-IU-",501
19,"19209",41,35,34,0,1,"PODEMOS-IU-",1
5,"5226",65,52,52,0,0,"PODEMOS-IU-",1
44,"44213",65,46,46,0,0,"PODEMOS-IU-",3
42,"42014",60,44,44,1,0,"PODEMOS-IU-",1
40,"40047",32,25,25,0,0,"PODEMOS-IU-",3
10,"10135",1241,995,981,5,14,"PODEMOS-IU-",35
39,"39001",2065,1669,1643,16,26,"PODEMOS-IU-",163
13,"13035",955,739,720,6,19,"PODEMOS-IU-",77
28,"28114",143,104,104,0,0,"PODEMOS-IU-",19
19,"19252",60,49,47,0,2,"PODEMOS-IU-",2
47,"47109",171,130,130,1,0,"PODEMOS-IU-",8
10,"10136",285,223,223,1,0,"PODEMOS-IU-",16
49,"49055",95,83,83,1,0,"PODEMOS-IU-",8
50,"50016",44,31,31,0,0,"PODEMOS-IU-",0
44,"44245",245,176,171,1,5,"PODEMOS-IU-",13
50,"50164",388,279,272,2,7,"PODEMOS-IU-",39
16,"16038",28,21,21,0,0,"PODEMOS-IU-",0
24,"24052",139,99,99,0,0,"PODEMOS-IU-",9
24,"24011",189,122,121,1,1,"PODEMOS-IU-",7
50,"50045",1198,957,951,3,6,"PODEMOS-IU-",81
37,"37069",971,721,704,2,17,"PODEMOS-IU-",62
10,"10137",404,346,344,3,2,"PODEMOS-IU-",16
28,"28178",1134,949,935,1,14,"PODEMOS-IU-",148
42,"42084",20,16,16,0,0,"PODEMOS-IU-",0
49,"49246",217,180,177,2,3,"PODEMOS-IU-",7
37,"37115",110,81,81,2,0,"PODEMOS-IU-",0
45,"45109",2786,2273,2206,9,67,"PODEMOS-IU-",128
24,"24172",415,240,237,1,3,"PODEMOS-IU-",12
37,"37188",160,115,112,3,3,"PODEMOS-IU-",8
5,"5901",253,173,171,1,2,"PODEMOS-IU-",18
47,"47173",885,708,704,7,4,"PODEMOS-IU-",94
24,"24014",7180,5189,5097,46,92,"PODEMOS-IU-",694
10,"10180",4168,2735,2680,18,55,"PODEMOS-IU-",175
40,"40122",525,442,434,2,8,"PODEMOS-IU-",61
50,"50135",88,74,74,3,0,"PODEMOS-IU-",13
37,"37071",76,67,67,0,0,"PODEMOS-IU-",1
40,"40015",24,24,24,1,0,"PODEMOS-IU-",1
19,"19214",72,56,55,0,1,"PODEMOS-IU-",4
16,"16215",237,157,153,1,4,"PODEMOS-IU-",12
9,"9030",119,90,89,1,1,"PODEMOS-IU-",4
6,"6097",2283,1803,1762,10,41,"PODEMOS-IU-",164
49,"49018",288,225,222,1,3,"PODEMOS-IU-",6
35,"35030",9949,6611,6462,65,149,"PODEMOS-IU-",853
28,"28179",1450,1115,1100,3,15,"PODEMOS-IU-",172
24,"24133",356,267,267,4,0,"PODEMOS-IU-",16
44,"44025",5825,4337,4197,50,140,"PODEMOS-IU-",714
9,"9410",2999,2175,2135,27,40,"PODEMOS-IU-",395
2,"2058",313,218,214,1,4,"PODEMOS-IU-",15
5,"5230",65,58,58,4,0,"PODEMOS-IU-",0
42,"42100",31,27,27,0,0,"PODEMOS-IU-",0
50,"50194",81,59,59,1,0,"PODEMOS-IU-",3
19,"19020",46,35,34,1,1,"PODEMOS-IU-",1
37,"37343",66,50,48,1,2,"PODEMOS-IU-",5
34,"34156",50,43,43,0,0,"PODEMOS-IU-",1
37,"37305",218,180,178,3,2,"PODEMOS-IU-",17
28,"28118",61,52,51,0,1,"PODEMOS-IU-",7
6,"6065",298,258,255,1,3,"PODEMOS-IU-",3
16,"16085",135,109,109,1,0,"PODEMOS-IU-",10
19,"19258",84,69,66,1,3,"PODEMOS-IU-",3
45,"45113",1797,1300,1281,6,19,"PODEMOS-IU-",59
44,"44093",79,73,73,4,0,"PODEMOS-IU-",12
47,"47208",56,37,37,0,0,"PODEMOS-IU-",10
26,"26015",180,145,142,1,3,"PODEMOS-IU-",10
49,"49225",127,81,81,0,0,"PODEMOS-IU-",3
26,"26088",41,38,38,0,0,"PODEMOS-IU-",3
6,"6066",1725,1297,1286,9,11,"PODEMOS-IU-",68
37,"37033",92,69,69,2,0,"PODEMOS-IU-",2
50,"50108",52,43,42,0,1,"PODEMOS-IU-",2
45,"45022",393,290,288,3,2,"PODEMOS-IU-",19
50,"50224",65,54,54,1,0,"PODEMOS-IU-",5
19,"19305",135,104,103,3,1,"PODEMOS-IU-",4
28,"28013",41563,32024,31693,194,331,"PODEMOS-IU-",4867
37,"37120",97,83,81,1,2,"PODEMOS-IU-",2
16,"16274",103,86,85,0,1,"PODEMOS-IU-",8
24,"24177",472,330,326,3,4,"PODEMOS-IU-",16
19,"19306",22,19,19,0,0,"PODEMOS-IU-",2
38,"38030",1945,1430,1420,6,10,"PODEMOS-IU-",115
42,"42155",142,92,92,0,0,"PODEMOS-IU-",0
19,"19075",61,44,43,0,1,"PODEMOS-IU-",4
40,"40019",29,26,26,0,0,"PODEMOS-IU-",1
28,"28152",16839,14205,14151,87,54,"PODEMOS-IU-",1512
13,"13090",1023,814,796,5,18,"PODEMOS-IU-",27
42,"42197",68,56,56,0,0,"PODEMOS-IU-",2
26,"26016",28,24,23,0,1,"PODEMOS-IU-",1
37,"37234",317,224,222,1,2,"PODEMOS-IU-",6
44,"44126",317,226,222,1,4,"PODEMOS-IU-",20
50,"50197",96,78,78,1,0,"PODEMOS-IU-",7
19,"19262",123,98,97,0,1,"PODEMOS-IU-",9
9,"9036",37,33,32,3,1,"PODEMOS-IU-",7
26,"26171",156,131,127,0,4,"PODEMOS-IU-",6
24,"24019",341,279,272,0,7,"PODEMOS-IU-",44
6,"6134",530,337,331,3,6,"PODEMOS-IU-",21
49,"49183",93,73,71,2,2,"PODEMOS-IU-",2
9,"9195",55,45,45,1,0,"PODEMOS-IU-",5
24,"24179",299,239,238,3,1,"PODEMOS-IU-",20
9,"9360",25,22,22,0,0,"PODEMOS-IU-",3
34,"34215",162,143,142,3,1,"PODEMOS-IU-",8
9,"9248",78,64,64,0,0,"PODEMOS-IU-",4
42,"42023",60,49,48,0,1,"PODEMOS-IU-",5
34,"34023",5098,4016,3973,48,43,"PODEMOS-IU-",584
47,"47022",59,56,54,1,2,"PODEMOS-IU-",1
49,"49267",97,73,68,1,5,"PODEMOS-IU-",5
26,"26093",48,38,38,0,0,"PODEMOS-IU-",6
44,"44252",75,56,56,1,0,"PODEMOS-IU-",1
24,"24180",1101,844,833,8,11,"PODEMOS-IU-",45
38,"38002",972,678,640,3,38,"PODEMOS-IU-",40
28,"28016",78,62,61,1,1,"PODEMOS-IU-",11
16,"16173",190,141,141,0,0,"PODEMOS-IU-",7
5,"5082",495,399,394,1,5,"PODEMOS-IU-",27
9,"9197",137,108,107,0,1,"PODEMOS-IU-",10
10,"10148",32986,23987,23589,201,398,"PODEMOS-IU-",2796
37,"37123",162,122,117,3,5,"PODEMOS-IU-",2
5,"5161",550,444,434,2,10,"PODEMOS-IU-",32
40,"40092",113,86,84,2,2,"PODEMOS-IU-",5
9,"9308",62,48,48,0,0,"PODEMOS-IU-",2
24,"24143",495,388,380,2,8,"PODEMOS-IU-",44
42,"42025",1134,824,813,6,11,"PODEMOS-IU-",41
45,"45075",124,93,90,0,3,"PODEMOS-IU-",10
26,"26057",51,47,47,1,0,"PODEMOS-IU-",3
9,"9473",87,76,73,0,3,"PODEMOS-IU-",5
34,"34027",1046,791,783,13,8,"PODEMOS-IU-",82
38,"38034",3998,3033,2993,19,40,"PODEMOS-IU-",284
9,"9198",100,80,79,0,1,"PODEMOS-IU-",18
37,"37198",203,163,162,3,1,"PODEMOS-IU-",30
16,"16093",57,47,47,0,0,"PODEMOS-IU-",4
37,"37039",282,222,222,1,0,"PODEMOS-IU-",10
50,"50229",65,57,56,0,1,"PODEMOS-IU-",11
6,"6071",238,197,193,0,4,"PODEMOS-IU-",6
37,"37350",404,310,307,0,3,"PODEMOS-IU-",18
10,"10190",521,372,361,2,11,"PODEMOS-IU-",22
49,"49110",345,222,220,2,2,"PODEMOS-IU-",24
37,"37082",745,546,536,2,10,"PODEMOS-IU-",31
16,"16231",50,40,40,0,0,"PODEMOS-IU-",7
24,"24063",355,261,261,2,0,"PODEMOS-IU-",22
10,"10150",331,277,272,6,5,"PODEMOS-IU-",17
45,"45123",3160,2434,2392,16,42,"PODEMOS-IU-",394
26,"26098",99,77,77,1,0,"PODEMOS-IU-",21
47,"47056",83,71,71,0,0,"PODEMOS-IU-",1
19,"19036",248,213,210,1,3,"PODEMOS-IU-",15
37,"37003",107,82,82,1,0,"PODEMOS-IU-",2
50,"50230",1134,853,846,6,7,"PODEMOS-IU-",79
28,"28050",4367,3411,3384,14,27,"PODEMOS-IU-",462
49,"49188",110,87,86,0,1,"PODEMOS-IU-",6
37,"37200",196,145,145,0,0,"PODEMOS-IU-",7
30,"30009",12689,10036,9909,50,127,"PODEMOS-IU-",1021
34,"34152",125,104,101,0,3,"PODEMOS-IU-",2
6,"6107",1570,1117,1106,9,11,"PODEMOS-IU-",75
39,"39068",649,515,509,7,6,"PODEMOS-IU-",48
16,"16096",280,239,234,3,5,"PODEMOS-IU-",16
24,"24184",183,121,119,0,2,"PODEMOS-IU-",15
44,"44260",138,91,90,1,1,"PODEMOS-IU-",4
37,"37085",5002,3994,3951,40,43,"PODEMOS-IU-",342
9,"9369",422,328,325,8,3,"PODEMOS-IU-",41
37,"37201",237,188,187,1,1,"PODEMOS-IU-",9
24,"24185",452,339,332,3,7,"PODEMOS-IU-",28
44,"44261",722,584,578,8,6,"PODEMOS-IU-",47
47,"47026",49,40,39,0,1,"PODEMOS-IU-",0
40,"40061",65,50,48,2,2,"PODEMOS-IU-",7
19,"19134",30,24,24,0,0,"PODEMOS-IU-",4
5,"5047",4118,3334,3248,25,86,"PODEMOS-IU-",219
5,"5126",62,53,52,0,1,"PODEMOS-IU-",2
47,"47122",2016,1655,1617,15,38,"PODEMOS-IU-",155
30,"30020",6431,4991,4940,19,51,"PODEMOS-IU-",494
40,"40168",28,22,22,0,0,"PODEMOS-IU-",6
45,"45126",239,173,168,0,5,"PODEMOS-IU-",21
47,"47027",2775,2246,2222,14,24,"PODEMOS-IU-",275
24,"24187",845,641,630,6,11,"PODEMOS-IU-",46
39,"39069",1928,1650,1627,9,23,"PODEMOS-IU-",142
39,"39098",1379,1154,1144,7,10,"PODEMOS-IU-",75
44,"44065",57,37,36,0,1,"PODEMOS-IU-",3
13,"13903",493,412,406,1,6,"PODEMOS-IU-",24
37,"37355",162,137,135,0,2,"PODEMOS-IU-",9
50,"50116",170,132,131,0,1,"PODEMOS-IU-",10
44,"44165",173,136,135,2,1,"PODEMOS-IU-",14
45,"45128",2552,1874,1839,9,35,"PODEMOS-IU-",165
26,"26102",6057,4672,4579,37,93,"PODEMOS-IU-",553
42,"42119",145,90,89,6,1,"PODEMOS-IU-",3
40,"40905",128,101,100,4,1,"PODEMOS-IU-",2
26,"26026",1265,1061,1049,2,12,"PODEMOS-IU-",59
37,"37243",90,71,70,0,1,"PODEMOS-IU-",0
47,"47124",388,322,319,2,3,"PODEMOS-IU-",32
44,"44263",377,296,285,3,11,"PODEMOS-IU-",32
24,"24068",443,343,336,1,7,"PODEMOS-IU-",34
38,"38039",11112,8233,8161,54,72,"PODEMOS-IU-",815
37,"37204",255,197,195,0,2,"PODEMOS-IU-",6
34,"34174",178,150,149,2,1,"PODEMOS-IU-",5
5,"5129",116,82,76,1,6,"PODEMOS-IU-",2
49,"49032",287,224,222,0,2,"PODEMOS-IU-",5
40,"40205",229,185,180,1,5,"PODEMOS-IU-",12
37,"37089",62,51,50,0,1,"PODEMOS-IU-",2
24,"24069",39,27,27,0,0,"PODEMOS-IU-",0
42,"42120",132,89,87,0,2,"PODEMOS-IU-",4
13,"13013",7050,5475,5371,39,104,"PODEMOS-IU-",365
44,"44037",449,334,331,1,3,"PODEMOS-IU-",66
49,"49078",142,113,113,1,0,"PODEMOS-IU-",6
24,"24190",146,109,109,1,0,"PODEMOS-IU-",2
5,"5245",348,295,290,3,5,"PODEMOS-IU-",19
28,"28130",28508,23566,23305,179,261,"PODEMOS-IU-",4492
30,"30023",3875,3107,3068,20,39,"PODEMOS-IU-",435
50,"50031",139,97,90,0,7,"PODEMOS-IU-",9
5,"5208",38,31,31,0,0,"PODEMOS-IU-",1
2,"2037",22952,16040,15815,101,225,"PODEMOS-IU-",1354
42,"42212",62,48,47,1,1,"PODEMOS-IU-",1
38,"38010",3974,2814,2777,20,37,"PODEMOS-IU-",459
45,"45086",493,373,368,0,5,"PODEMOS-IU-",24
38,"38011",21563,15380,15214,69,166,"PODEMOS-IU-",2427
40,"40173",142,122,117,1,5,"PODEMOS-IU-",8
6,"6145",899,744,723,1,21,"PODEMOS-IU-",33
34,"34036",238,199,198,1,1,"PODEMOS-IU-",21
47,"47188",99,77,77,0,0,"PODEMOS-IU-",3
10,"10078",370,289,278,4,11,"PODEMOS-IU-",27
50,"50236",101,82,80,1,2,"PODEMOS-IU-",2
9,"9214",641,454,445,5,9,"PODEMOS-IU-",70
5,"5171",67,57,51,1,6,"PODEMOS-IU-",1
16,"16146",87,68,68,0,0,"PODEMOS-IU-",3
40,"40032",378,287,278,1,9,"PODEMOS-IU-",12
13,"13061",5639,4119,4071,56,48,"PODEMOS-IU-",349
40,"40140",79,58,58,0,0,"PODEMOS-IU-",4
45,"45133",2808,2233,2187,14,46,"PODEMOS-IU-",198
19,"19234",45,32,32,0,0,"PODEMOS-IU-",5
45,"45042",183,141,137,0,4,"PODEMOS-IU-",13
19,"19327",397,333,332,0,1,"PODEMOS-IU-",7
9,"9162",132,102,102,1,0,"PODEMOS-IU-",22
19,"19329",59,49,49,0,0,"PODEMOS-IU-",2
28,"28026",6703,5422,5367,21,55,"PODEMOS-IU-",815
40,"40070",148,110,107,1,3,"PODEMOS-IU-",10
49,"49081",1322,1051,1030,11,21,"PODEMOS-IU-",69
24,"24113",351,277,272,2,5,"PODEMOS-IU-",15
49,"49120",53,39,39,0,0,"PODEMOS-IU-",1
10,"10080",360,256,246,0,10,"PODEMOS-IU-",7
19,"19235",98,82,81,0,1,"PODEMOS-IU-",14
26,"26032",45,37,37,1,0,"PODEMOS-IU-",4
5,"5056",94,83,83,0,0,"PODEMOS-IU-",5
19,"19147",45,36,36,0,0,"PODEMOS-IU-",4
37,"37324",335,276,274,1,2,"PODEMOS-IU-",4
50,"50294",64,49,47,0,2,"PODEMOS-IU-",1
2,"2077",54,45,44,0,1,"PODEMOS-IU-",7
19,"19148",42,35,33,0,2,"PODEMOS-IU-",3
24,"24074",96,73,73,0,0,"PODEMOS-IU-",2
45,"45136",5825,4314,4260,22,54,"PODEMOS-IU-",316
45,"45182",987,815,800,7,15,"PODEMOS-IU-",53
47,"47190",95,81,81,1,0,"PODEMOS-IU-",2
30,"30027",49767,39111,38724,245,387,"PODEMOS-IU-",4293
5,"5134",49,41,40,0,1,"PODEMOS-IU-",0
44,"44074",444,353,346,3,7,"PODEMOS-IU-",18
50,"50209",2747,1993,1975,29,18,"PODEMOS-IU-",257
5,"5213",95,77,75,0,2,"PODEMOS-IU-",6
9,"9109",1066,686,650,11,36,"PODEMOS-IU-",216
40,"40178",90,63,63,1,0,"PODEMOS-IU-",2
37,"37175",404,321,319,8,2,"PODEMOS-IU-",17
26,"26109",73,66,66,0,0,"PODEMOS-IU-",10
16,"16248",862,730,720,10,10,"PODEMOS-IU-",67
13,"13066",2604,2182,2146,6,36,"PODEMOS-IU-",110
19,"19283",32,26,26,0,0,"PODEMOS-IU-",1
37,"37099",61,46,46,1,0,"PODEMOS-IU-",1
38,"38045",3549,2149,2109,6,40,"PODEMOS-IU-",292
19,"19332",85,70,70,1,0,"PODEMOS-IU-",8
26,"26035",16,14,13,0,1,"PODEMOS-IU-",2
49,"49245",253,183,182,2,1,"PODEMOS-IU-",20
24,"24116",390,283,279,1,4,"PODEMOS-IU-",27
19,"19001",41,33,33,0,0,"PODEMOS-IU-",3
40,"40073",385,339,335,6,4,"PODEMOS-IU-",6
50,"50036",100,80,80,0,0,"PODEMOS-IU-",14
6,"6051",1543,1206,1188,3,18,"PODEMOS-IU-",53
37,"37005",67,48,48,2,0,"PODEMOS-IU-",1
5,"5017",86,74,73,0,1,"PODEMOS-IU-",7
9,"9060",128,111,111,1,0,"PODEMOS-IU-",6
24,"24079",872,671,665,4,6,"PODEMOS-IU-",42
10,"10165",253,212,210,1,2,"PODEMOS-IU-",12
5,"5176",223,173,166,2,7,"PODEMOS-IU-",8
45,"45002",2608,1840,1821,7,19,"PODEMOS-IU-",209
5,"5018",24,18,17,0,1,"PODEMOS-IU-",4
9,"9439",1054,867,851,8,16,"PODEMOS-IU-",111
45,"45140",1089,887,870,5,17,"PODEMOS-IU-",61
38,"38047",1756,1276,1259,6,17,"PODEMOS-IU-",104
10,"10043",754,578,572,3,6,"PODEMOS-IU-",49
19,"19105",2540,2013,1988,13,25,"PODEMOS-IU-",282
28,"28136",680,569,563,0,6,"PODEMOS-IU-",62
5,"5177",139,117,117,0,0,"PODEMOS-IU-",8
28,"28031",2140,1642,1614,11,28,"PODEMOS-IU-",143
24,"24201",1039,775,765,5,10,"PODEMOS-IU-",52
30,"30030",320172,249965,247884,1497,2081,"PODEMOS-IU-",27026
9,"9223",43,39,39,1,0,"PODEMOS-IU-",6
9,"9062",40,39,39,0,0,"PODEMOS-IU-",3
2,"2045",3617,3020,2969,38,51,"PODEMOS-IU-",744
16,"16110",91,80,80,0,0,"PODEMOS-IU-",1
26,"26001",198,171,165,1,6,"PODEMOS-IU-",13
34,"34238",305,261,260,2,1,"PODEMOS-IU-",20
45,"45005",227,180,174,5,6,"PODEMOS-IU-",17
38,"38048",3957,2889,2842,12,47,"PODEMOS-IU-",390
9,"9390",569,464,459,5,5,"PODEMOS-IU-",31
19,"19287",136,107,105,3,2,"PODEMOS-IU-",7
10,"10045",970,739,735,6,4,"PODEMOS-IU-",64
37,"37179",196,172,169,0,3,"PODEMOS-IU-",7
24,"24041",527,371,364,4,7,"PODEMOS-IU-",27
50,"50186",37,28,28,0,0,"PODEMOS-IU-",6
30,"30001",4539,3615,3567,16,48,"PODEMOS-IU-",188
37,"37059",117,106,100,0,6,"PODEMOS-IU-",5
13,"13026",415,342,340,1,2,"PODEMOS-IU-",55
16,"16029",102,81,81,1,0,"PODEMOS-IU-",9
38,"38049",2683,1781,1743,18,38,"PODEMOS-IU-",208
10,"10209",265,184,184,2,0,"PODEMOS-IU-",30
16,"16113",3067,2416,2383,15,33,"PODEMOS-IU-",160
10,"10169",494,405,395,1,10,"PODEMOS-IU-",18
42,"42008",56,41,41,0,0,"PODEMOS-IU-",3
9,"9226",56,47,47,0,0,"PODEMOS-IU-",1
39,"39052",18957,15123,14985,106,138,"PODEMOS-IU-",1621
37,"37060",280,224,224,0,0,"PODEMOS-IU-",14
9,"9338",231,193,189,2,4,"PODEMOS-IU-",13
42,"42139",21,15,15,1,0,"PODEMOS-IU-",0
19,"19290",851,581,577,5,4,"PODEMOS-IU-",86
26,"26117",2097,1680,1647,17,33,"PODEMOS-IU-",169
5,"5064",102,83,81,2,2,"PODEMOS-IU-",0
19,"19201",60,45,45,0,0,"PODEMOS-IU-",6
5,"5260",97,81,80,1,1,"PODEMOS-IU-",1
37,"37143",375,308,306,2,2,"PODEMOS-IU-",19
45,"45145",2613,1950,1921,13,29,"PODEMOS-IU-",179
9,"9395",122,95,94,0,1,"PODEMOS-IU-",10
2,"2049",796,582,574,1,8,"PODEMOS-IU-",34
34,"34094",61,44,44,0,0,"PODEMOS-IU-",2
30,"30034",1075,852,831,4,21,"PODEMOS-IU-",46
38,"38051",7326,5418,5352,27,66,"PODEMOS-IU-",402
2,"2050",90,75,75,0,0,"PODEMOS-IU-",7
19,"19159",87,77,76,0,1,"PODEMOS-IU-",2
5,"5221",323,249,244,1,5,"PODEMOS-IU-",48
40,"40044",139,105,103,2,2,"PODEMOS-IU-",5
13,"13075",199,157,157,0,0,"PODEMOS-IU-",6
50,"50216",240,189,181,3,8,"PODEMOS-IU-",7
37,"37221",394,299,299,2,0,"PODEMOS-IU-",16
37,"37258",137,99,98,1,1,"PODEMOS-IU-",5
10,"10172",696,517,513,0,4,"PODEMOS-IU-",53
19,"19058",7375,6122,6061,34,61,"PODEMOS-IU-",869
34,"34143",157,125,120,1,5,"PODEMOS-IU-",7
47,"47138",219,182,177,1,5,"PODEMOS-IU-",12
16,"16204",241,198,196,1,2,"PODEMOS-IU-",13
37,"37109",177,149,149,3,0,"PODEMOS-IU-",1
9,"9229",183,136,136,2,0,"PODEMOS-IU-",7
49,"49214",664,519,510,2,9,"PODEMOS-IU-",21
26,"26119",177,150,147,2,3,"PODEMOS-IU-",22
19,"19161",211,165,163,2,2,"PODEMOS-IU-",26
10,"10173",558,445,439,0,6,"PODEMOS-IU-",35
50,"50161",103,80,80,0,0,"PODEMOS-IU-",5
40,"40186",34,29,29,0,0,"PODEMOS-IU-",0
26,"26120",1460,1130,1109,3,21,"PODEMOS-IU-",99
9,"9070",33,28,25,0,3,"PODEMOS-IU-",4
44,"44180",72,61,61,0,0,"PODEMOS-IU-",1
24,"24008",9025,6803,6702,79,101,"PODEMOS-IU-",678
5,"5069",74,63,62,0,1,"PODEMOS-IU-",4
28,"28175",935,775,767,3,8,"PODEMOS-IU-",118
44,"44021",104,86,85,2,1,"PODEMOS-IU-",10
10,"10052",166,124,123,0,1,"PODEMOS-IU-",4
50,"50162",137,112,110,2,2,"PODEMOS-IU-",1
10,"10051",433,338,332,0,6,"PODEMOS-IU-",3
16,"16160",60,44,43,1,1,"PODEMOS-IU-",1
2,"2053",2885,2313,2282,13,31,"PODEMOS-IU-",247
19,"19011",236,181,181,0,0,"PODEMOS-IU-",13
16,"16264",390,338,328,2,10,"PODEMOS-IU-",4
50,"50218",110,92,92,0,0,"PODEMOS-IU-",5
45,"45060",158,118,118,0,0,"PODEMOS-IU-",8
19,"19251",39,31,31,0,0,"PODEMOS-IU-",1
2,"2017",777,588,584,0,4,"PODEMOS-IU-",26
37,"37224",189,168,165,0,3,"PODEMOS-IU-",1
34,"34056",1949,1537,1511,7,26,"PODEMOS-IU-",156
47,"47014",47,43,43,1,0,"PODEMOS-IU-",0
49,"49096",157,129,123,2,6,"PODEMOS-IU-",8
6,"6093",4345,3356,3281,18,75,"PODEMOS-IU-",189
50,"50073",2117,1735,1706,13,29,"PODEMOS-IU-",180
9,"9073",963,799,787,7,12,"PODEMOS-IU-",112
40,"40189",479,392,380,2,12,"PODEMOS-IU-",30
30,"30038",15674,11755,11675,59,80,"PODEMOS-IU-",1061
50,"50044",222,161,161,3,0,"PODEMOS-IU-",10
47,"47045",734,601,590,5,11,"PODEMOS-IU-",107
16,"16162",39,31,30,0,1,"PODEMOS-IU-",0
2,"2054",383,314,309,1,5,"PODEMOS-IU-",21
49,"49097",74,43,43,0,0,"PODEMOS-IU-",2
19,"19254",43,36,36,0,0,"PODEMOS-IU-",3
42,"42096",251,164,160,3,4,"PODEMOS-IU-",17
47,"47046",125,107,104,1,3,"PODEMOS-IU-",6
9,"9182",76,65,64,0,1,"PODEMOS-IU-",3
39,"39058",800,574,573,1,1,"PODEMOS-IU-",58
9,"9236",35,29,29,1,0,"PODEMOS-IU-",0
49,"49016",229,189,187,2,2,"PODEMOS-IU-",12
42,"42149",387,311,308,3,3,"PODEMOS-IU-",29
42,"42003",66,55,55,0,0,"PODEMOS-IU-",1
47,"47016",70,62,61,0,1,"PODEMOS-IU-",3
45,"45201",3620,2465,2419,10,46,"PODEMOS-IU-",306
47,"47142",124,94,92,0,2,"PODEMOS-IU-",1
42,"42017",131,104,104,2,0,"PODEMOS-IU-",11
49,"49098",204,157,153,2,4,"PODEMOS-IU-",5
16,"16039",367,263,262,2,1,"PODEMOS-IU-",13
10,"10098",381,310,309,1,1,"PODEMOS-IU-",26
45,"45110",1697,1339,1326,11,13,"PODEMOS-IU-",31
50,"50075",72,59,59,1,0,"PODEMOS-IU-",0
2,"2020",431,359,356,3,3,"PODEMOS-IU-",20
30,"30010",6857,5533,5457,38,76,"PODEMOS-IU-",419
28,"28071",64,56,54,0,2,"PODEMOS-IU-",4
13,"13084",841,683,673,6,10,"PODEMOS-IU-",35
44,"44090",66,49,49,0,0,"PODEMOS-IU-",1
39,"39087",41381,32335,31995,194,340,"PODEMOS-IU-",3681
28,"28083",9665,7794,7737,56,57,"PODEMOS-IU-",1211
5,"5114",1264,1061,1030,3,31,"PODEMOS-IU-",45
44,"44246",1590,1173,1150,11,23,"PODEMOS-IU-",183
50,"50105",279,216,213,4,3,"PODEMOS-IU-",39
16,"16166",239,176,174,3,2,"PODEMOS-IU-",9
24,"24094",1326,982,966,4,16,"PODEMOS-IU-",115
40,"40225",1098,902,882,4,20,"PODEMOS-IU-",59
28,"28084",16103,12519,12378,82,141,"PODEMOS-IU-",2397
16,"16002",195,166,164,1,2,"PODEMOS-IU-",9
26,"26013",323,258,256,1,2,"PODEMOS-IU-",44
24,"24174",469,360,354,5,6,"PODEMOS-IU-",45
50,"50252",5057,3661,3613,36,48,"PODEMOS-IU-",299
28,"28180",5317,4266,4222,26,44,"PODEMOS-IU-",501
40,"40086",660,570,548,3,22,"PODEMOS-IU-",78
9,"9078",37,31,31,0,0,"PODEMOS-IU-",1
24,"24095",307,237,235,0,2,"PODEMOS-IU-",21
40,"40193",221,163,161,5,2,"PODEMOS-IU-",8
39,"39089",134,99,98,0,1,"PODEMOS-IU-",4
45,"45159",85,75,74,0,1,"PODEMOS-IU-",2
26,"26014",447,313,309,2,4,"PODEMOS-IU-",33
40,"40228",494,397,391,5,6,"PODEMOS-IU-",17
5,"5904",112,81,81,3,0,"PODEMOS-IU-",7
47,"47175",6704,5296,5222,52,74,"PODEMOS-IU-",748
26,"26051",210,178,176,1,2,"PODEMOS-IU-",12
13,"13088",589,439,429,1,10,"PODEMOS-IU-",31
10,"10183",958,748,735,3,13,"PODEMOS-IU-",52
49,"49179",346,233,232,0,1,"PODEMOS-IU-",20
39,"39006",1721,1332,1315,3,17,"PODEMOS-IU-",93
44,"44125",65,50,50,0,0,"PODEMOS-IU-",1
34,"34019",110,92,91,2,1,"PODEMOS-IU-",4
49,"49264",540,372,369,1,3,"PODEMOS-IU-",13
16,"16218",187,149,148,2,1,"PODEMOS-IU-",5
5,"5233",226,198,197,0,1,"PODEMOS-IU-",8
19,"19123",36,33,32,2,1,"PODEMOS-IU-",4
24,"24219",492,374,371,5,3,"PODEMOS-IU-",39
10,"10143",141,118,113,1,5,"PODEMOS-IU-",5
37,"37157",78,64,64,0,0,"PODEMOS-IU-",2
28,"28087",3259,2643,2623,16,20,"PODEMOS-IU-",337
9,"9464",33,27,27,0,0,"PODEMOS-IU-",0
9,"9413",408,313,310,2,3,"PODEMOS-IU-",32
37,"37034",75,66,66,0,0,"PODEMOS-IU-",0
26,"26170",427,343,338,2,5,"PODEMOS-IU-",28
9,"9246",609,449,441,2,8,"PODEMOS-IU-",62
19,"19218",45,34,34,1,0,"PODEMOS-IU-",4
9,"9136",173,130,128,0,2,"PODEMOS-IU-",20
19,"19024",8525,6587,6485,33,102,"PODEMOS-IU-",979
9,"9083",27,24,23,0,1,"PODEMOS-IU-",0
39,"39007",393,300,298,1,2,"PODEMOS-IU-",19
19,"19307",26,23,23,0,0,"PODEMOS-IU-",3
6,"6068",431,324,317,4,7,"PODEMOS-IU-",6
37,"37309",37,27,27,0,0,"PODEMOS-IU-",1
28,"28183",1124,857,842,4,15,"PODEMOS-IU-",236
45,"45071",1802,1488,1465,0,23,"PODEMOS-IU-",201
49,"49105",136,105,103,1,2,"PODEMOS-IU-",7
16,"16006",110,99,98,1,1,"PODEMOS-IU-",7
9,"9415",275,206,204,0,2,"PODEMOS-IU-",16
19,"19308",60,57,57,1,0,"PODEMOS-IU-",3
37,"37035",165,134,134,0,0,"PODEMOS-IU-",2
19,"19079",8,7,7,1,0,"PODEMOS-IU-",0
40,"40091",108,93,93,1,0,"PODEMOS-IU-",1
10,"10064",1409,1103,1072,6,31,"PODEMOS-IU-",57
9,"9196",135,108,107,0,1,"PODEMOS-IU-",9
6,"6102",1019,852,842,2,10,"PODEMOS-IU-",54
50,"50140",157,108,108,0,0,"PODEMOS-IU-",13
24,"24223",2540,1971,1929,37,42,"PODEMOS-IU-",217
37,"37080",212,173,169,0,4,"PODEMOS-IU-",8
19,"19309",21,18,17,0,1,"PODEMOS-IU-",2
10,"10065",200,149,149,0,0,"PODEMOS-IU-",21
16,"16227",108,85,85,1,0,"PODEMOS-IU-",2
13,"13093",3930,2960,2906,34,54,"PODEMOS-IU-",226
47,"47149",45,39,39,1,0,"PODEMOS-IU-",14
34,"34025",53,37,37,2,0,"PODEMOS-IU-",0
6,"6037",1668,1137,1125,6,12,"PODEMOS-IU-",46
6,"6136",1510,1189,1160,7,29,"PODEMOS-IU-",99
5,"5042",141,117,116,0,1,"PODEMOS-IU-",3
9,"9417",42,32,32,0,0,"PODEMOS-IU-",1
34,"34163",46,40,40,1,0,"PODEMOS-IU-",3
26,"26020",454,347,337,4,10,"PODEMOS-IU-",35
37,"37237",304,238,234,0,4,"PODEMOS-IU-",14
19,"19223",101,66,66,1,0,"PODEMOS-IU-",6
10,"10027",76,66,66,0,0,"PODEMOS-IU-",3
2,"2066",223,172,169,1,3,"PODEMOS-IU-",17
50,"50903",2238,1750,1732,11,18,"PODEMOS-IU-",314
45,"45029",188,160,159,0,1,"PODEMOS-IU-",8
37,"37124",196,153,153,2,0,"PODEMOS-IU-",13
39,"39066",877,711,705,5,6,"PODEMOS-IU-",81
42,"42065",23,18,18,2,0,"PODEMOS-IU-",2
5,"5163",1705,1360,1345,4,15,"PODEMOS-IU-",101
19,"19082",99,76,75,0,1,"PODEMOS-IU-",10
9,"9141",602,501,493,4,8,"PODEMOS-IU-",45
19,"19132",93,72,72,0,0,"PODEMOS-IU-",2
13,"13096",7533,5766,5696,43,70,"PODEMOS-IU-",324
49,"49232",84,71,70,0,1,"PODEMOS-IU-",4
9,"9090",50,45,45,2,0,"PODEMOS-IU-",7
47,"47152",68,59,59,0,0,"PODEMOS-IU-",5
34,"34120",63965,50687,50117,471,570,"PODEMOS-IU-",4916
13,"13051",336,272,271,1,1,"PODEMOS-IU-",18
34,"34221",170,138,136,2,2,"PODEMOS-IU-",8
37,"37126",30,26,26,0,0,"PODEMOS-IU-",0
50,"50286",75,58,55,0,3,"PODEMOS-IU-",9
45,"45031",2824,2104,2068,20,36,"PODEMOS-IU-",230
37,"37240",939,694,686,3,8,"PODEMOS-IU-",57
9,"9044",53,49,47,1,2,"PODEMOS-IU-",3
6,"6128",4415,3345,3288,34,57,"PODEMOS-IU-",336
13,"13007",1233,1005,967,11,38,"PODEMOS-IU-",103
19,"19226",41,32,32,0,0,"PODEMOS-IU-",2
45,"45170",199,154,150,1,4,"PODEMOS-IU-",6
24,"24104",245,173,172,1,1,"PODEMOS-IU-",21
42,"42163",46,37,37,0,0,"PODEMOS-IU-",6
16,"16012",77,65,65,0,0,"PODEMOS-IU-",1
44,"44004",379,312,310,5,2,"PODEMOS-IU-",60
6,"6007",1433,1078,1071,5,7,"PODEMOS-IU-",72
50,"50056",405,332,330,4,2,"PODEMOS-IU-",39
13,"13901",864,687,673,1,14,"PODEMOS-IU-",35
44,"44102",27,22,22,0,0,"PODEMOS-IU-",1
10,"10193",1412,1158,1145,4,13,"PODEMOS-IU-",54
39,"39097",679,437,435,2,2,"PODEMOS-IU-",15
16,"16139",324,249,249,2,0,"PODEMOS-IU-",19
34,"34169",381,314,309,6,5,"PODEMOS-IU-",27
26,"26139",55,43,43,0,0,"PODEMOS-IU-",2
2,"2069",11414,9019,8883,54,136,"PODEMOS-IU-",782
26,"26140",239,199,194,1,5,"PODEMOS-IU-",37
34,"34123",1637,1376,1354,8,22,"PODEMOS-IU-",82
9,"9095",112,70,68,1,2,"PODEMOS-IU-",0
24,"24106",218,164,162,0,2,"PODEMOS-IU-",9
19,"19184",62,45,45,0,0,"PODEMOS-IU-",5
10,"10194",524,440,435,4,5,"PODEMOS-IU-",31
9,"9206",55,47,47,1,0,"PODEMOS-IU-",3
49,"49114",40,33,32,1,1,"PODEMOS-IU-",4
26,"26025",89,77,77,0,0,"PODEMOS-IU-",9
42,"42208",20,16,16,0,0,"PODEMOS-IU-",0
37,"37129",252,206,202,2,4,"PODEMOS-IU-",14
45,"45035",293,228,223,1,5,"PODEMOS-IU-",43
50,"50176",222,161,156,3,5,"PODEMOS-IU-",11
26,"26141",100,73,73,0,0,"PODEMOS-IU-",5
37,"37007",399,311,306,3,5,"PODEMOS-IU-",5
9,"9208",179,130,127,1,3,"PODEMOS-IU-",5
42,"42073",73,58,57,0,1,"PODEMOS-IU-",4
42,"42166",57,49,49,0,0,"PODEMOS-IU-",3
9,"9098",477,372,360,4,12,"PODEMOS-IU-",24
16,"16015",351,251,250,4,1,"PODEMOS-IU-",13
35,"35012",10765,6327,6270,32,57,"PODEMOS-IU-",835
9,"9427",1364,1002,972,13,30,"PODEMOS-IU-",87
10,"10196",294,231,231,2,0,"PODEMOS-IU-",24
49,"49077",159,104,103,0,1,"PODEMOS-IU-",2
19,"19187",42,36,36,0,0,"PODEMOS-IU-",3
26,"26103",827,655,645,3,10,"PODEMOS-IU-",113
39,"39071",422,318,316,0,2,"PODEMOS-IU-",10
45,"45175",614,512,504,3,8,"PODEMOS-IU-",16
39,"39099",3149,2562,2540,22,22,"PODEMOS-IU-",252
34,"34125",79,59,58,0,1,"PODEMOS-IU-",3
50,"50234",242,194,187,3,7,"PODEMOS-IU-",21
26,"26027",143,101,98,1,3,"PODEMOS-IU-",7
28,"28024",168,146,145,1,1,"PODEMOS-IU-",24
45,"45084",2121,1708,1676,16,32,"PODEMOS-IU-",156
37,"37131",171,138,137,0,1,"PODEMOS-IU-",3
37,"37132",325,232,231,0,1,"PODEMOS-IU-",23
37,"37246",5155,4153,4107,33,46,"PODEMOS-IU-",281
45,"45039",208,176,176,0,0,"PODEMOS-IU-",4
47,"47030",941,759,740,3,19,"PODEMOS-IU-",106
49,"49117",437,340,335,1,5,"PODEMOS-IU-",13
40,"40065",469,376,373,1,3,"PODEMOS-IU-",31
19,"19231",10,7,7,0,0,"PODEMOS-IU-",0
49,"49194",340,236,233,3,3,"PODEMOS-IU-",14
49,"49079",103,91,79,1,12,"PODEMOS-IU-",5
37,"37358",164,142,135,2,7,"PODEMOS-IU-",6
44,"44168",184,137,136,4,1,"PODEMOS-IU-",4
5,"5010",145,119,118,1,1,"PODEMOS-IU-",3
42,"42213",25,16,16,0,0,"PODEMOS-IU-",0
44,"44264",248,175,171,0,4,"PODEMOS-IU-",17
39,"39100",849,650,644,9,6,"PODEMOS-IU-",47
37,"37010",923,739,735,2,4,"PODEMOS-IU-",82
6,"6013",265,227,221,0,6,"PODEMOS-IU-",27
45,"45040",1276,842,828,4,14,"PODEMOS-IU-",73
42,"42171",114,80,79,0,1,"PODEMOS-IU-",1
9,"9430",22,20,20,0,0,"PODEMOS-IU-",2
45,"45179",495,383,382,3,1,"PODEMOS-IU-",23
37,"37171",397,297,292,1,5,"PODEMOS-IU-",6
37,"37284",314,241,237,2,4,"PODEMOS-IU-",22
6,"6146",1048,837,819,4,18,"PODEMOS-IU-",93
19,"19098",18,18,17,0,1,"PODEMOS-IU-",0
9,"9006",59,37,36,1,1,"PODEMOS-IU-",4
37,"37096",203,162,160,1,2,"PODEMOS-IU-",6
42,"42172",28,25,25,1,0,"PODEMOS-IU-",1
44,"44266",102,89,86,1,3,"PODEMOS-IU-",6
42,"42125",75,62,62,2,0,"PODEMOS-IU-",2
16,"16020",9,5,5,0,0,"PODEMOS-IU-",0
10,"10079",858,694,684,1,10,"PODEMOS-IU-",59
37,"37172",853,601,590,4,11,"PODEMOS-IU-",49
50,"50180",106,84,84,1,0,"PODEMOS-IU-",20
24,"24033",205,146,146,3,0,"PODEMOS-IU-",4
40,"40105",44,39,38,0,1,"PODEMOS-IU-",7
16,"16062",25,21,21,0,0,"PODEMOS-IU-",3
50,"50005",239,204,201,2,3,"PODEMOS-IU-",12
26,"26068",79,62,62,1,0,"PODEMOS-IU-",5
44,"44232",368,284,273,2,11,"PODEMOS-IU-",11
19,"19099",289,217,214,0,3,"PODEMOS-IU-",38
2,"2041",321,253,251,3,2,"PODEMOS-IU-",13
19,"19047",55,47,47,0,0,"PODEMOS-IU-",7
16,"16022",78,70,70,0,0,"PODEMOS-IU-",4
9,"9108",432,332,326,1,6,"PODEMOS-IU-",55
38,"38014",1341,991,981,6,10,"PODEMOS-IU-",111
37,"37211",212,164,163,1,1,"PODEMOS-IU-",9
6,"6115",1243,898,876,3,22,"PODEMOS-IU-",89
2,"2078",899,705,691,3,14,"PODEMOS-IU-",123
44,"44011",48,32,32,1,0,"PODEMOS-IU-",1
10,"10162",528,430,424,2,6,"PODEMOS-IU-",28
37,"37054",238,200,196,3,4,"PODEMOS-IU-",13
50,"50007",49,34,34,0,0,"PODEMOS-IU-",13
10,"10163",339,275,269,0,6,"PODEMOS-IU-",10
34,"34132",107,84,83,0,1,"PODEMOS-IU-",7
19,"19103",251,218,216,1,2,"PODEMOS-IU-",12
49,"49003",869,627,624,3,3,"PODEMOS-IU-",26
5,"5175",149,122,119,1,3,"PODEMOS-IU-",5
37,"37015",205,131,130,2,1,"PODEMOS-IU-",4
42,"42039",210,147,141,2,6,"PODEMOS-IU-",21
9,"9329",117,90,89,8,1,"PODEMOS-IU-",15
37,"37327",179,154,150,0,4,"PODEMOS-IU-",11
24,"24159",1746,1393,1368,6,25,"PODEMOS-IU-",80
34,"34182",753,609,604,6,5,"PODEMOS-IU-",33
34,"34234",68,59,57,0,2,"PODEMOS-IU-",4
42,"42001",251,186,186,2,0,"PODEMOS-IU-",13
47,"47131",165,127,127,3,0,"PODEMOS-IU-",9
40,"40143",83,73,73,2,0,"PODEMOS-IU-",3
42,"42176",27,22,22,2,0,"PODEMOS-IU-",0
50,"50154",116,98,98,0,0,"PODEMOS-IU-",3
9,"9112",104,76,76,1,0,"PODEMOS-IU-",5
40,"40003",121,91,89,1,2,"PODEMOS-IU-",3
16,"16249",1938,1544,1529,13,15,"PODEMOS-IU-",75
9,"9273",51,46,46,3,0,"PODEMOS-IU-",4
19,"19002",57,45,45,0,0,"PODEMOS-IU-",1
13,"13023",8950,6359,6271,76,88,"PODEMOS-IU-",238
16,"16152",32,28,28,1,0,"PODEMOS-IU-",3
34,"34135",399,320,315,4,5,"PODEMOS-IU-",34
6,"6019",2012,1539,1495,14,44,"PODEMOS-IU-",159
49,"49005",128,87,85,1,2,"PODEMOS-IU-",2
49,"49164",139,103,102,2,1,"PODEMOS-IU-",8
16,"16066",2298,1932,1885,17,47,"PODEMOS-IU-",186
5,"5256",112,94,92,1,2,"PODEMOS-IU-",5
9,"9297",313,268,267,6,1,"PODEMOS-IU-",23
39,"39078",1406,1101,1090,7,11,"PODEMOS-IU-",88
19,"19286",742,610,603,4,7,"PODEMOS-IU-",84
49,"49205",367,286,282,5,4,"PODEMOS-IU-",17
37,"37366",41,30,30,0,0,"PODEMOS-IU-",3
28,"28061",22564,18245,18064,117,181,"PODEMOS-IU-",2870
24,"24002",233,183,183,1,0,"PODEMOS-IU-",8
2,"2082",95,83,83,0,0,"PODEMOS-IU-",11
47,"47164",350,290,286,2,4,"PODEMOS-IU-",9
28,"28170",2487,1840,1810,10,30,"PODEMOS-IU-",252
44,"44016",436,334,331,1,3,"PODEMOS-IU-",16
50,"50156",209,174,171,1,3,"PODEMOS-IU-",31
42,"42134",2652,2028,1989,17,39,"PODEMOS-IU-",250
45,"45097",1044,901,890,4,11,"PODEMOS-IU-",22
13,"13071",38130,27060,26802,237,258,"PODEMOS-IU-",3399
44,"44046",43,32,32,0,0,"PODEMOS-IU-",1
9,"9442",370,305,301,5,4,"PODEMOS-IU-",30
9,"9225",81,62,62,0,0,"PODEMOS-IU-",0
9,"9391",361,286,283,3,3,"PODEMOS-IU-",11
42,"42007",109,89,89,1,0,"PODEMOS-IU-",1
49,"49166",1192,916,899,10,17,"PODEMOS-IU-",109
5,"5062",166,136,133,0,3,"PODEMOS-IU-",2
26,"26114",74,62,60,0,2,"PODEMOS-IU-",2
19,"19108",102,92,89,0,3,"PODEMOS-IU-",17
26,"26154",10,10,10,1,0,"PODEMOS-IU-",0
44,"44017",272,221,219,0,2,"PODEMOS-IU-",21
28,"28003",170,148,148,1,0,"PODEMOS-IU-",24
26,"26155",149,119,119,0,0,"PODEMOS-IU-",9
50,"50068",1947,1402,1389,11,13,"PODEMOS-IU-",118
24,"24206",1611,1286,1268,7,18,"PODEMOS-IU-",113
2,"2085",309,264,263,4,1,"PODEMOS-IU-",8
45,"45053",7834,6440,6333,46,107,"PODEMOS-IU-",527
39,"39025",8703,6954,6854,39,100,"PODEMOS-IU-",703
9,"9174",781,625,608,3,17,"PODEMOS-IU-",59
13,"13028",10273,8434,8273,42,161,"PODEMOS-IU-",685
16,"16115",47,35,35,0,0,"PODEMOS-IU-",0
47,"47040",61,45,44,0,1,"PODEMOS-IU-",2
49,"49168",93,74,74,0,0,"PODEMOS-IU-",4
16,"16156",82,65,65,0,0,"PODEMOS-IU-",4
34,"34051",91,81,79,0,2,"PODEMOS-IU-",4
47,"47071",398,345,341,2,4,"PODEMOS-IU-",60
5,"5182",731,494,490,6,4,"PODEMOS-IU-",36
19,"19202",17,13,13,0,0,"PODEMOS-IU-",5
9,"9445",43,36,34,1,2,"PODEMOS-IU-",3
28,"28143",77,62,62,0,0,"PODEMOS-IU-",7
37,"37334",73,49,49,0,0,"PODEMOS-IU-",0
44,"44019",68,42,42,0,0,"PODEMOS-IU-",1
50,"50070",49,28,28,0,0,"PODEMOS-IU-",2
35,"35024",14243,9496,9394,65,102,"PODEMOS-IU-",1569
24,"24207",278,242,235,0,7,"PODEMOS-IU-",13
26,"26118",72,63,60,1,3,"PODEMOS-IU-",3
16,"16116",77,59,59,0,0,"PODEMOS-IU-",3
2,"2901",2185,1633,1613,9,20,"PODEMOS-IU-",79
42,"42049",109,73,72,1,1,"PODEMOS-IU-",3
9,"9177",1127,883,877,6,6,"PODEMOS-IU-",86
40,"40220",62,48,48,0,0,"PODEMOS-IU-",4
16,"16033",1644,1345,1320,11,25,"PODEMOS-IU-",119
9,"9123",43,39,38,0,1,"PODEMOS-IU-",7
16,"16117",1022,822,809,6,13,"PODEMOS-IU-",55
5,"5066",439,373,367,2,6,"PODEMOS-IU-",58
19,"19113",446,352,342,3,10,"PODEMOS-IU-",31
5,"5067",74,61,60,0,1,"PODEMOS-IU-",4
44,"44211",35,24,24,0,0,"PODEMOS-IU-",3
45,"45058",352,270,269,5,1,"PODEMOS-IU-",23
26,"26161",8,7,7,0,0,"PODEMOS-IU-",0
37,"37024",88,69,69,0,0,"PODEMOS-IU-",2
42,"42093",35,29,29,2,0,"PODEMOS-IU-",2
35,"35025",1773,1247,1235,9,12,"PODEMOS-IU-",136
19,"19250",15,13,13,0,0,"PODEMOS-IU-",1
34,"34006",79,73,70,3,3,"PODEMOS-IU-",2
50,"50190",675,565,553,5,12,"PODEMOS-IU-",46
50,"50247",842,621,616,7,5,"PODEMOS-IU-",49
16,"16078",41517,31810,31486,340,324,"PODEMOS-IU-",2867
44,"44049",796,592,578,9,14,"PODEMOS-IU-",68
42,"42202",20,12,11,0,1,"PODEMOS-IU-",0
44,"44001",65,51,50,0,1,"PODEMOS-IU-",9
19,"19013",114,99,99,0,0,"PODEMOS-IU-",12
40,"40081",119,96,95,2,1,"PODEMOS-IU-",10
49,"49216",147,122,114,0,8,"PODEMOS-IU-",10
40,"40221",48,42,42,0,0,"PODEMOS-IU-",5
44,"44119",119,83,82,0,1,"PODEMOS-IU-",14
37,"37148",404,321,315,2,6,"PODEMOS-IU-",14
6,"6027",645,572,568,0,4,"PODEMOS-IU-",52
9,"9405",129,99,97,1,2,"PODEMOS-IU-",5
40,"40119",166,133,132,1,1,"PODEMOS-IU-",7
47,"47203",58,48,48,0,0,"PODEMOS-IU-",1
6,"6159",2339,1577,1507,25,70,"PODEMOS-IU-",198
37,"37027",235,188,184,2,4,"PODEMOS-IU-",16
37,"37375",673,583,573,4,10,"PODEMOS-IU-",28
5,"5187",1728,1394,1364,7,30,"PODEMOS-IU-",168
42,"42190",92,74,73,1,1,"PODEMOS-IU-",6
39,"39029",636,512,512,5,0,"PODEMOS-IU-",47
9,"9025",108,73,72,0,1,"PODEMOS-IU-",5
26,"26163",124,106,104,1,2,"PODEMOS-IU-",11
9,"9292",75,62,62,2,0,"PODEMOS-IU-",4
37,"37264",55,42,42,0,0,"PODEMOS-IU-",6
10,"10218",1083,810,796,3,14,"PODEMOS-IU-",15
49,"49134",166,111,111,2,0,"PODEMOS-IU-",11
5,"5267",107,71,70,3,1,"PODEMOS-IU-",12
28,"28147",990,779,769,2,10,"PODEMOS-IU-",113
16,"16082",271,207,206,3,1,"PODEMOS-IU-",25
5,"5112",95,66,64,2,2,"PODEMOS-IU-",10
40,"40223",228,181,181,0,0,"PODEMOS-IU-",19
34,"34058",185,161,161,1,0,"PODEMOS-IU-",4
49,"49135",588,409,405,0,4,"PODEMOS-IU-",36
34,"34205",55,44,44,0,0,"PODEMOS-IU-",0
19,"19067",69,53,50,1,3,"PODEMOS-IU-",7
28,"28082",6063,4939,4889,46,50,"PODEMOS-IU-",1165
42,"42055",165,124,122,2,2,"PODEMOS-IU-",4
28,"28148",88647,70218,69546,570,672,"PODEMOS-IU-",11637
45,"45155",319,261,253,1,8,"PODEMOS-IU-",22
9,"9238",941,573,567,8,6,"PODEMOS-IU-",65
10,"10139",95,78,77,1,1,"PODEMOS-IU-",5
44,"44184",38,28,26,0,2,"PODEMOS-IU-",1
45,"45156",3338,2805,2750,9,55,"PODEMOS-IU-",329
49,"49261",1505,1168,1149,8,19,"PODEMOS-IU-",119
9,"9295",54,38,38,0,0,"PODEMOS-IU-",1
10,"10901",1177,818,805,1,13,"PODEMOS-IU-",68
34,"34015",39,32,31,0,1,"PODEMOS-IU-",4
28,"28159",594,493,491,5,2,"PODEMOS-IU-",49
9,"9352",107,86,86,2,0,"PODEMOS-IU-",2
50,"50076",75,64,63,0,1,"PODEMOS-IU-",9
50,"50166",236,200,198,1,2,"PODEMOS-IU-",26
19,"19070",67,53,51,0,2,"PODEMOS-IU-",0
24,"24093",338,239,232,3,7,"PODEMOS-IU-",27
5,"5190",53,47,47,1,0,"PODEMOS-IU-",1
19,"19170",189,116,116,0,0,"PODEMOS-IU-",13
45,"45020",1239,987,973,4,14,"PODEMOS-IU-",62
37,"37154",129,106,102,3,4,"PODEMOS-IU-",3
16,"16167",292,235,229,1,6,"PODEMOS-IU-",21
19,"19019",14,10,10,0,0,"PODEMOS-IU-",1
19,"19302",52,43,41,1,2,"PODEMOS-IU-",3
30,"30041",13970,9796,9682,80,114,"PODEMOS-IU-",1101
49,"49138",208,159,154,2,5,"PODEMOS-IU-",1
49,"49019",228,170,164,0,6,"PODEMOS-IU-",7
6,"6131",1063,880,874,5,6,"PODEMOS-IU-",131
5,"5076",473,417,413,7,4,"PODEMOS-IU-",29
49,"49139",153,111,110,1,1,"PODEMOS-IU-",7
9,"9190",86,68,67,0,1,"PODEMOS-IU-",19
5,"5192",93,81,78,0,3,"PODEMOS-IU-",7
39,"39088",59,51,51,0,0,"PODEMOS-IU-",3
50,"50167",215,181,179,1,2,"PODEMOS-IU-",16
5,"5903",138,94,92,0,2,"PODEMOS-IU-",3
35,"35003",5582,3441,3391,26,50,"PODEMOS-IU-",543
10,"10060",935,670,658,4,12,"PODEMOS-IU-",34
34,"34211",175,160,160,0,0,"PODEMOS-IU-",2
13,"13042",888,699,686,2,13,"PODEMOS-IU-",29
45,"45901",780,593,587,3,6,"PODEMOS-IU-",53
6,"6903",2027,1607,1594,16,13,"PODEMOS-IU-",187
37,"37192",355,234,227,5,7,"PODEMOS-IU-",24
16,"16273",303,236,231,2,5,"PODEMOS-IU-",7
9,"9244",45,35,35,0,0,"PODEMOS-IU-",4
9,"9412",765,564,558,7,6,"PODEMOS-IU-",94
44,"44094",123,112,112,0,0,"PODEMOS-IU-",9
37,"37193",365,277,276,3,1,"PODEMOS-IU-",14
28,"28075",5952,4797,4758,25,39,"PODEMOS-IU-",835
37,"37307",148,110,107,2,3,"PODEMOS-IU-",3
44,"44156",46,36,33,1,3,"PODEMOS-IU-",0
49,"49141",296,220,218,0,2,"PODEMOS-IU-",19
37,"37382",164,135,134,0,1,"PODEMOS-IU-",2
6,"6100",852,681,677,3,4,"PODEMOS-IU-",28
42,"42156",29,23,23,0,0,"PODEMOS-IU-",1
16,"16171",1749,1449,1422,6,27,"PODEMOS-IU-",73
6,"6001",659,539,534,7,5,"PODEMOS-IU-",49
19,"19023",127,98,96,0,2,"PODEMOS-IU-",9
37,"37078",788,670,658,6,12,"PODEMOS-IU-",64
49,"49181",335,227,224,2,3,"PODEMOS-IU-",5
49,"49143",194,141,135,2,6,"PODEMOS-IU-",12
5,"5195",206,157,157,0,0,"PODEMOS-IU-",12
38,"38001",20907,12323,12197,70,126,"PODEMOS-IU-",1824
44,"44028",171,140,138,1,2,"PODEMOS-IU-",8
28,"28153",795,566,564,5,2,"PODEMOS-IU-",174
34,"34067",129,87,87,0,0,"PODEMOS-IU-",15
37,"37121",556,448,444,3,4,"PODEMOS-IU-",22
42,"42108",10,7,7,0,0,"PODEMOS-IU-",0
2,"2026",832,682,673,6,9,"PODEMOS-IU-",75
42,"42200",76,54,53,0,1,"PODEMOS-IU-",1
19,"19027",131,98,96,0,2,"PODEMOS-IU-",13
26,"26131",34,34,34,1,0,"PODEMOS-IU-",3
24,"24020",434,302,299,1,3,"PODEMOS-IU-",18
40,"40020",155,125,119,4,6,"PODEMOS-IU-",7
5,"5041",995,776,767,3,9,"PODEMOS-IU-",47
42,"42216",26,20,20,1,0,"PODEMOS-IU-",0
39,"39045",351,280,277,1,3,"PODEMOS-IU-",17
49,"49080",630,499,493,4,6,"PODEMOS-IU-",21
40,"40233",396,323,320,2,3,"PODEMOS-IU-",33
24,"24142",24730,18823,18504,201,319,"PODEMOS-IU-",2466
40,"40128",122,95,93,2,2,"PODEMOS-IU-",13
40,"40198",24,20,20,0,0,"PODEMOS-IU-",0
19,"19127",90,63,63,0,0,"PODEMOS-IU-",5
28,"28902",523,418,415,2,3,"PODEMOS-IU-",90
34,"34217",1251,1053,1042,7,11,"PODEMOS-IU-",119
45,"45027",327,276,273,0,3,"PODEMOS-IU-",19
9,"9249",50,39,39,0,0,"PODEMOS-IU-",2
49,"49025",159,126,124,0,2,"PODEMOS-IU-",9
9,"9056",4812,3585,3533,36,52,"PODEMOS-IU-",454
47,"47128",56,49,46,0,3,"PODEMOS-IU-",3
50,"50141",109,90,90,1,0,"PODEMOS-IU-",8
45,"45166",1564,1298,1279,6,19,"PODEMOS-IU-",99
49,"49026",201,163,162,0,1,"PODEMOS-IU-",4
42,"42204",54,45,43,2,2,"PODEMOS-IU-",2
45,"45076",564,389,388,2,1,"PODEMOS-IU-",23
37,"37162",209,156,153,1,3,"PODEMOS-IU-",8
38,"38004",4490,3242,3202,18,40,"PODEMOS-IU-",448
49,"49270",137,111,111,0,0,"PODEMOS-IU-",8
19,"19311",87,71,71,2,0,"PODEMOS-IU-",3
5,"5162",75,58,58,0,0,"PODEMOS-IU-",5
5,"5199",37,31,31,0,0,"PODEMOS-IU-",7
42,"42026",22,20,20,0,0,"PODEMOS-IU-",1
16,"16134",4383,3544,3491,34,53,"PODEMOS-IU-",444
9,"9419",67,53,52,0,1,"PODEMOS-IU-",2
28,"28124",59,52,52,0,0,"PODEMOS-IU-",8
9,"9143",27,18,18,0,0,"PODEMOS-IU-",2
40,"40131",50,47,47,0,0,"PODEMOS-IU-",2
19,"19086",1392,1095,1083,7,12,"PODEMOS-IU-",91
49,"49149",365,285,282,2,3,"PODEMOS-IU-",13
5,"5200",40,27,26,0,1,"PODEMOS-IU-",1
10,"10191",523,406,398,3,8,"PODEMOS-IU-",49
5,"5045",80,65,65,0,0,"PODEMOS-IU-",0
6,"6105",604,406,400,2,6,"PODEMOS-IU-",22
9,"9091",701,545,533,5,12,"PODEMOS-IU-",31
24,"24227",1548,1148,1128,5,20,"PODEMOS-IU-",87
6,"6139",502,429,421,5,8,"PODEMOS-IU-",36
19,"19225",851,664,650,3,14,"PODEMOS-IU-",73
34,"34222",109,81,79,1,2,"PODEMOS-IU-",3
44,"44064",63,49,48,0,1,"PODEMOS-IU-",2
38,"38036",6831,4947,4829,58,118,"PODEMOS-IU-",584
42,"42206",8,4,4,0,0,"PODEMOS-IU-",0
49,"49028",105,94,93,1,1,"PODEMOS-IU-",3
24,"24146",251,206,204,1,2,"PODEMOS-IU-",17
37,"37277",77,56,56,0,0,"PODEMOS-IU-",2
24,"24025",289,234,226,4,8,"PODEMOS-IU-",11
47,"47183",139,118,118,1,0,"PODEMOS-IU-",3
9,"9148",79,63,63,5,0,"PODEMOS-IU-",5
28,"28126",47,35,35,0,0,"PODEMOS-IU-",4
5,"5241",3041,2242,2204,24,38,"PODEMOS-IU-",183
10,"10152",446,354,350,2,4,"PODEMOS-IU-",20
47,"47216",114,102,98,0,4,"PODEMOS-IU-",2
37,"37101",142,119,117,0,2,"PODEMOS-IU-",5
13,"13053",14075,10930,10798,98,132,"PODEMOS-IU-",995
45,"45049",423,340,335,1,5,"PODEMOS-IU-",21
39,"39013",535,434,431,1,3,"PODEMOS-IU-",18
40,"40904",341,302,300,4,2,"PODEMOS-IU-",46
6,"6141",1688,1308,1291,16,17,"PODEMOS-IU-",61
38,"38007",1625,1124,1104,2,20,"PODEMOS-IU-",89
40,"40028",105,96,96,1,0,"PODEMOS-IU-",3
37,"37044",450,342,335,6,7,"PODEMOS-IU-",17
42,"42071",163,111,108,2,3,"PODEMOS-IU-",6
37,"37242",80,65,64,1,1,"PODEMOS-IU-",3
37,"37354",5467,3960,3910,31,50,"PODEMOS-IU-",394
40,"40203",958,801,788,6,13,"PODEMOS-IU-",91
42,"42165",419,288,285,8,3,"PODEMOS-IU-",27
50,"50086",178,121,119,2,2,"PODEMOS-IU-",14
9,"9316",108,89,89,0,0,"PODEMOS-IU-",4
16,"16140",19,16,16,0,0,"PODEMOS-IU-",1
16,"16055",679,478,477,4,1,"PODEMOS-IU-",44
24,"24150",224,176,174,2,2,"PODEMOS-IU-",12
9,"9259",227,198,197,2,1,"PODEMOS-IU-",12
9,"9258",171,142,141,2,1,"PODEMOS-IU-",3
9,"9152",248,197,195,0,2,"PODEMOS-IU-",24
37,"37130",178,150,150,2,0,"PODEMOS-IU-",2
10,"10115",3488,2878,2816,15,62,"PODEMOS-IU-",317
34,"34034",115,96,95,3,1,"PODEMOS-IU-",4
13,"13011",4506,3111,3044,29,67,"PODEMOS-IU-",229
39,"39042",5930,4722,4676,26,46,"PODEMOS-IU-",351
49,"49153",151,110,108,0,2,"PODEMOS-IU-",3
2,"2035",1946,1592,1576,15,16,"PODEMOS-IU-",126
6,"6011",24665,18486,18253,178,233,"PODEMOS-IU-",1635
45,"45129",109,84,83,0,1,"PODEMOS-IU-",16
13,"13058",4050,3188,3128,24,60,"PODEMOS-IU-",142
40,"40030",428,357,350,3,7,"PODEMOS-IU-",41
9,"9154",124,101,101,3,0,"PODEMOS-IU-",7
16,"16016",216,175,174,3,1,"PODEMOS-IU-",2
35,"35013",6584,5067,4974,49,93,"PODEMOS-IU-",571
24,"24189",5816,4434,4382,49,52,"PODEMOS-IU-",510
19,"19277",16,13,13,0,0,"PODEMOS-IU-",2
50,"50002",125,96,91,1,5,"PODEMOS-IU-",0
49,"49155",80,66,65,1,1,"PODEMOS-IU-",2
5,"5092",146,118,116,0,2,"PODEMOS-IU-",4
34,"34035",100,84,82,1,2,"PODEMOS-IU-",4
19,"19324",160,128,123,1,5,"PODEMOS-IU-",3
19,"19232",58,49,49,0,0,"PODEMOS-IU-",1
19,"19042",21,19,18,1,1,"PODEMOS-IU-",1
24,"24109",876,635,619,3,16,"PODEMOS-IU-",84
16,"16203",10167,7720,7591,49,129,"PODEMOS-IU-",679
35,"35014",11908,7101,6947,63,154,"PODEMOS-IU-",1371
26,"26065",58,49,47,0,2,"PODEMOS-IU-",6
9,"9159",61,52,51,0,1,"PODEMOS-IU-",3
50,"50264",147,122,120,0,2,"PODEMOS-IU-",14
34,"34229",58,42,40,1,2,"PODEMOS-IU-",1
16,"16190",4957,4006,3945,36,61,"PODEMOS-IU-",178
40,"40219",565,451,432,2,19,"PODEMOS-IU-",41
38,"38052",1280,893,887,4,6,"PODEMOS-IU-",95
5,"5170",50,38,38,0,0,"PODEMOS-IU-",5
37,"37011",99,75,73,0,2,"PODEMOS-IU-",7
39,"39016",23868,19029,18839,108,190,"PODEMOS-IU-",1901
50,"50061",193,173,169,1,4,"PODEMOS-IU-",13
37,"37050",67,54,54,0,0,"PODEMOS-IU-",0
47,"47157",495,428,426,3,2,"PODEMOS-IU-",41
10,"10119",574,458,455,0,3,"PODEMOS-IU-",43
50,"50293",392,295,293,6,2,"PODEMOS-IU-",38
26,"26146",86,69,69,1,0,"PODEMOS-IU-",10
38,"38012",2310,1705,1687,6,18,"PODEMOS-IU-",298
9,"9068",24,18,18,0,0,"PODEMOS-IU-",5
45,"45149",539,448,440,0,8,"PODEMOS-IU-",31
37,"37297",401,319,315,2,4,"PODEMOS-IU-",12
2,"2076",318,256,250,1,6,"PODEMOS-IU-",5
37,"37209",410,288,283,3,5,"PODEMOS-IU-",24
47,"47189",151,126,123,0,3,"PODEMOS-IU-",7
28,"28132",12068,9067,8954,63,113,"PODEMOS-IU-",1480
9,"9381",33,25,25,0,0,"PODEMOS-IU-",2
50,"50151",603,490,489,3,1,"PODEMOS-IU-",23
49,"49158",203,163,155,0,8,"PODEMOS-IU-",10
44,"44109",102,71,70,1,1,"PODEMOS-IU-",3
5,"5055",540,448,445,1,3,"PODEMOS-IU-",25
34,"34131",58,51,51,0,0,"PODEMOS-IU-",0
37,"37147",172,130,127,3,3,"PODEMOS-IU-",14
50,"50228",250,217,214,3,3,"PODEMOS-IU-",6
39,"39037",2019,1572,1560,2,12,"PODEMOS-IU-",143
49,"49201",285,243,243,7,0,"PODEMOS-IU-",18
13,"13018",766,644,634,0,10,"PODEMOS-IU-",26
42,"42081",136,95,93,0,2,"PODEMOS-IU-",4
5,"5015",68,48,48,1,0,"PODEMOS-IU-",1
49,"49219",7221,5301,5186,62,115,"PODEMOS-IU-",556
37,"37249",38,28,28,0,0,"PODEMOS-IU-",1
16,"16063",113,86,83,0,3,"PODEMOS-IU-",3
2,"2005",545,443,436,5,7,"PODEMOS-IU-",23
45,"45137",1567,1155,1139,11,16,"PODEMOS-IU-",148
9,"9269",29,25,23,1,2,"PODEMOS-IU-",4
42,"42174",179,132,128,1,4,"PODEMOS-IU-",21
9,"9328",74,51,50,0,1,"PODEMOS-IU-",9
34,"34041",84,73,72,3,1,"PODEMOS-IU-",4
44,"44234",70,57,57,1,0,"PODEMOS-IU-",8
10,"10122",220,171,164,0,7,"PODEMOS-IU-",11
9,"9908",427,294,290,6,4,"PODEMOS-IU-",45
34,"34042",292,244,243,3,1,"PODEMOS-IU-",6
6,"6149",10203,8194,8051,72,143,"PODEMOS-IU-",669
47,"47097",307,258,256,4,2,"PODEMOS-IU-",27
10,"10041",1025,840,825,6,15,"PODEMOS-IU-",63
37,"37137",99,65,65,0,0,"PODEMOS-IU-",1
10,"10083",96,74,73,0,1,"PODEMOS-IU-",10
5,"5136",84,64,64,2,0,"PODEMOS-IU-",4
16,"16150",94,75,75,1,0,"PODEMOS-IU-",12
19,"19049",9,8,8,0,0,"PODEMOS-IU-",0
47,"47225",74,61,60,0,1,"PODEMOS-IU-",1
45,"45139",145,118,117,1,1,"PODEMOS-IU-",3
5,"5099",457,392,389,2,3,"PODEMOS-IU-",3
9,"9167",53,39,36,0,3,"PODEMOS-IU-",2
50,"50093",83,66,66,1,0,"PODEMOS-IU-",9
34,"34184",49,39,38,0,1,"PODEMOS-IU-",5
10,"10042",88,59,59,0,0,"PODEMOS-IU-",7
39,"39021",467,392,385,2,7,"PODEMOS-IU-",20
44,"44043",88,67,65,1,2,"PODEMOS-IU-",7
42,"42016",20,13,13,0,0,"PODEMOS-IU-",1
16,"16109",41,33,33,3,0,"PODEMOS-IU-",4
49,"49041",414,309,307,4,2,"PODEMOS-IU-",22
38,"38016",1178,654,648,6,6,"PODEMOS-IU-",105
44,"44175",113,84,82,1,2,"PODEMOS-IU-",6
37,"37215",134,97,96,3,1,"PODEMOS-IU-",1
37,"37303",181,137,137,1,0,"PODEMOS-IU-",1
34,"34237",573,479,472,4,7,"PODEMOS-IU-",24
28,"28041",4788,4012,3973,23,39,"PODEMOS-IU-",482
24,"24173",908,679,667,3,12,"PODEMOS-IU-",39
5,"5902",293,246,242,1,4,"PODEMOS-IU-",13
49,"49086",111,94,93,1,1,"PODEMOS-IU-",5
5,"5257",135,104,104,0,0,"PODEMOS-IU-",8
35,"35020",5933,4140,4088,14,52,"PODEMOS-IU-",319
50,"50185",136,103,102,0,1,"PODEMOS-IU-",38
34,"34186",47,41,41,0,0,"PODEMOS-IU-",1
50,"50095",12136,9020,8928,99,92,"PODEMOS-IU-",1143
40,"40039",180,147,144,1,3,"PODEMOS-IU-",10
37,"37058",56,41,41,0,0,"PODEMOS-IU-",1
50,"50270",38,32,30,1,2,"PODEMOS-IU-",8
50,"50126",2262,1736,1708,20,28,"PODEMOS-IU-",113
2,"2046",1132,975,953,10,22,"PODEMOS-IU-",89
50,"50271",248,197,189,2,8,"PODEMOS-IU-",15
28,"28032",5042,4039,3992,23,47,"PODEMOS-IU-",512
9,"9172",168,132,132,1,0,"PODEMOS-IU-",12
34,"34137",24,23,22,2,1,"PODEMOS-IU-",1
2,"2083",209,183,183,0,0,"PODEMOS-IU-",1
10,"10046",187,154,152,0,2,"PODEMOS-IU-",19
49,"49088",82,59,59,0,0,"PODEMOS-IU-",2
5,"5141",95,82,82,0,0,"PODEMOS-IU-",4
24,"24205",981,744,732,8,12,"PODEMOS-IU-",79
50,"50214",18,10,10,0,0,"PODEMOS-IU-",1
49,"49207",217,151,148,4,3,"PODEMOS-IU-",10
9,"9018",24647,18982,18715,184,267,"PODEMOS-IU-",2306
45,"45099",3635,2741,2684,23,57,"PODEMOS-IU-",377
44,"44146",170,148,146,3,2,"PODEMOS-IU-",15
6,"6022",2634,2156,2112,7,44,"PODEMOS-IU-",188
24,"24042",61,47,47,1,0,"PODEMOS-IU-",1
16,"16071",20,18,18,0,0,"PODEMOS-IU-",3
10,"10007",630,513,507,4,6,"PODEMOS-IU-",10
45,"45008",142,121,121,0,0,"PODEMOS-IU-",2
9,"9394",662,495,490,10,5,"PODEMOS-IU-",53
6,"6055",1998,1552,1523,9,29,"PODEMOS-IU-",94
40,"40216",774,670,665,11,5,"PODEMOS-IU-",52
34,"34139",160,119,118,0,1,"PODEMOS-IU-",12
47,"47229",231,174,168,0,6,"PODEMOS-IU-",8
37,"37061",207,160,160,0,0,"PODEMOS-IU-",7
13,"13074",944,826,813,1,13,"PODEMOS-IU-",66
10,"10008",1291,1015,997,16,18,"PODEMOS-IU-",72
44,"44147",398,293,286,3,7,"PODEMOS-IU-",39
5,"5157",235,175,174,2,1,"PODEMOS-IU-",8
47,"47010",14572,12316,12186,102,130,"PODEMOS-IU-",1514
5,"5220",363,312,308,5,4,"PODEMOS-IU-",17
5,"5105",336,272,266,2,6,"PODEMOS-IU-",35
24,"24166",1359,1038,1011,11,27,"PODEMOS-IU-",98
45,"45101",3709,3052,3002,14,50,"PODEMOS-IU-",267
28,"28005",136050,108267,107316,772,951,"PODEMOS-IU-",16164
50,"50022",504,396,386,11,10,"PODEMOS-IU-",24
26,"26092",109,84,82,1,2,"PODEMOS-IU-",2
19,"19008",37,32,32,1,0,"PODEMOS-IU-",11
39,"39026",1720,1322,1312,5,10,"PODEMOS-IU-",79
19,"19160",905,618,613,3,5,"PODEMOS-IU-",112
19,"19009",247,190,187,0,3,"PODEMOS-IU-",11
10,"10050",1015,831,823,2,8,"PODEMOS-IU-",25
42,"42011",17,11,11,0,0,"PODEMOS-IU-",0
50,"50131",210,157,156,0,1,"PODEMOS-IU-",12
28,"28066",7515,6105,6039,40,66,"PODEMOS-IU-",673
47,"47231",4458,3677,3651,47,26,"PODEMOS-IU-",467
24,"24141",101,78,78,0,0,"PODEMOS-IU-",8
9,"9905",389,308,303,2,5,"PODEMOS-IU-",63
19,"19146",46,41,41,1,0,"PODEMOS-IU-",9
6,"6058",1980,1519,1493,13,26,"PODEMOS-IU-",108
40,"40045",120,92,92,1,0,"PODEMOS-IU-",8
37,"37260",139,109,109,0,0,"PODEMOS-IU-",9
40,"40010",111,95,94,0,1,"PODEMOS-IU-",3
5,"5224",100,91,90,1,1,"PODEMOS-IU-",1
47,"47043",309,276,273,1,3,"PODEMOS-IU-",8
28,"28037",1578,1196,1180,5,16,"PODEMOS-IU-",107
45,"45150",414,326,320,2,6,"PODEMOS-IU-",16
10,"10134",553,396,392,2,4,"PODEMOS-IU-",17
16,"16034",155,124,122,1,2,"PODEMOS-IU-",4
6,"6103",4753,3656,3598,35,58,"PODEMOS-IU-",306
26,"26031",98,89,87,0,2,"PODEMOS-IU-",10
6,"6148",957,762,746,12,16,"PODEMOS-IU-",122
19,"19177",61,49,48,0,1,"PODEMOS-IU-",3
35,"35026",82764,55647,54846,499,801,"PODEMOS-IU-",9059
26,"26008",1822,1436,1420,14,16,"PODEMOS-IU-",75
50,"50043",246,172,170,2,2,"PODEMOS-IU-",24
30,"30017",11477,8952,8844,62,108,"PODEMOS-IU-",763
44,"44050",3115,2333,2299,27,34,"PODEMOS-IU-",170
47,"47106",44,35,35,0,0,"PODEMOS-IU-",2
19,"19210",18,18,17,0,1,"PODEMOS-IU-",3
5,"5109",441,363,356,5,7,"PODEMOS-IU-",19
47,"47044",323,282,279,1,3,"PODEMOS-IU-",40
5,"5149",100,82,79,0,3,"PODEMOS-IU-",3
34,"34149",21,18,18,0,0,"PODEMOS-IU-",2
10,"10054",524,435,422,1,13,"PODEMOS-IU-",33
34,"34057",462,345,330,3,15,"PODEMOS-IU-",27
16,"16081",49,42,42,0,0,"PODEMOS-IU-",5
2,"2018",796,693,682,5,11,"PODEMOS-IU-",29
37,"37225",99,90,86,1,4,"PODEMOS-IU-",5
50,"50191",445,341,337,2,4,"PODEMOS-IU-",27
47,"47015",176,136,135,0,1,"PODEMOS-IU-",15
13,"13081",590,449,440,0,9,"PODEMOS-IU-",34
28,"28039",125,103,103,2,0,"PODEMOS-IU-",19
10,"10014",1829,1448,1419,12,29,"PODEMOS-IU-",113
6,"6127",2809,2285,2258,13,27,"PODEMOS-IU-",109
34,"34151",147,99,97,1,2,"PODEMOS-IU-",5
10,"10055",696,527,512,1,15,"PODEMOS-IU-",61
34,"34102",202,173,171,2,2,"PODEMOS-IU-",5
37,"37187",555,437,433,0,4,"PODEMOS-IU-",8
40,"40082",106,83,81,0,2,"PODEMOS-IU-",2
19,"19118",10,10,10,1,0,"PODEMOS-IU-",1
2,"2056",1643,1330,1308,4,22,"PODEMOS-IU-",59
10,"10178",729,567,559,4,8,"PODEMOS-IU-",40
30,"30039",20191,14552,14380,96,172,"PODEMOS-IU-",1611
24,"24092",745,606,601,6,5,"PODEMOS-IU-",56
34,"34103",97,84,81,0,3,"PODEMOS-IU-",3
2,"2032",265,208,203,3,5,"PODEMOS-IU-",36
50,"50046",167,134,130,3,4,"PODEMOS-IU-",11
16,"16213",34,29,28,0,1,"PODEMOS-IU-",6
26,"26048",22,22,22,0,0,"PODEMOS-IU-",1
35,"35029",4357,2869,2832,32,37,"PODEMOS-IU-",403
19,"19169",33,26,25,0,1,"PODEMOS-IU-",6
37,"37017",222,177,177,1,0,"PODEMOS-IU-",10
47,"47017",198,162,160,1,2,"PODEMOS-IU-",8
19,"19153",22,22,22,0,0,"PODEMOS-IU-",9
5,"5165",370,293,285,4,8,"PODEMOS-IU-",34
45,"45034",1291,1066,1039,7,27,"PODEMOS-IU-",132
37,"37202",989,838,828,7,10,"PODEMOS-IU-",90
42,"42098",9,8,8,0,0,"PODEMOS-IU-",0
38,"38027",5545,3937,3896,22,41,"PODEMOS-IU-",341
42,"42193",16,7,7,0,0,"PODEMOS-IU-",0
26,"26049",153,115,115,1,0,"PODEMOS-IU-",13
50,"50251",8207,6352,6242,46,110,"PODEMOS-IU-",954
37,"37116",69,51,51,0,0,"PODEMOS-IU-",6
50,"50136",534,416,405,2,11,"PODEMOS-IU-",15
9,"9189",126,102,96,0,6,"PODEMOS-IU-",6
19,"19215",144,121,119,0,2,"PODEMOS-IU-",2
5,"5048",106,98,94,1,4,"PODEMOS-IU-",2
37,"37031",336,261,258,3,3,"PODEMOS-IU-",11
47,"47048",175,148,148,0,0,"PODEMOS-IU-",8
47,"47018",36,31,29,0,2,"PODEMOS-IU-",3
9,"9354",33,29,29,2,0,"PODEMOS-IU-",3
13,"13041",249,179,171,2,8,"PODEMOS-IU-",21
47,"47207",260,213,211,2,2,"PODEMOS-IU-",3
34,"34107",73,54,54,2,0,"PODEMOS-IU-",0
5,"5115",516,397,395,3,2,"PODEMOS-IU-",25
49,"49059",88,72,71,0,1,"PODEMOS-IU-",4
9,"9134",220,155,151,1,4,"PODEMOS-IU-",36
45,"45205",7342,5347,5275,30,72,"PODEMOS-IU-",724
5,"5128",342,274,267,1,7,"PODEMOS-IU-",31
44,"44026",95,76,75,2,1,"PODEMOS-IU-",9
47,"47049",91,66,64,0,2,"PODEMOS-IU-",5
19,"19172",50,35,35,1,0,"PODEMOS-IU-",1
42,"42154",99,81,81,1,0,"PODEMOS-IU-",3
47,"47050",3898,3084,3047,36,37,"PODEMOS-IU-",375
37,"37344",235,171,168,1,3,"PODEMOS-IU-",2
28,"28182",198,169,169,1,0,"PODEMOS-IU-",41
34,"34158",286,194,194,0,0,"PODEMOS-IU-",22
5,"5905",222,165,164,1,1,"PODEMOS-IU-",6
13,"13043",209,167,167,1,0,"PODEMOS-IU-",7
26,"26129",936,770,759,1,11,"PODEMOS-IU-",42
16,"16219",81,64,63,0,1,"PODEMOS-IU-",5
24,"24097",204,155,155,7,0,"PODEMOS-IU-",9
6,"6034",167,115,115,1,0,"PODEMOS-IU-",5
44,"44056",457,352,341,4,11,"PODEMOS-IU-",18
24,"24137",1052,815,803,14,12,"PODEMOS-IU-",91
35,"35032",3348,2585,2542,20,43,"PODEMOS-IU-",303
26,"26053",195,161,160,3,1,"PODEMOS-IU-",26
26,"26183",66,50,50,0,0,"PODEMOS-IU-",8
40,"40230",95,70,67,0,3,"PODEMOS-IU-",13
44,"44220",113,92,89,0,3,"PODEMOS-IU-",6
50,"50139",322,257,256,0,1,"PODEMOS-IU-",15
49,"49104",335,245,240,1,5,"PODEMOS-IU-",8
44,"44059",550,446,437,7,9,"PODEMOS-IU-",31
45,"45117",715,571,556,1,15,"PODEMOS-IU-",18
10,"10199",159,123,123,1,0,"PODEMOS-IU-",8
26,"26158",246,207,206,2,1,"PODEMOS-IU-",10
10,"10104",5151,3862,3782,22,80,"PODEMOS-IU-",340
6,"6101",442,359,354,2,5,"PODEMOS-IU-",17
9,"9414",181,148,146,0,2,"PODEMOS-IU-",9
34,"34112",39,30,30,0,0,"PODEMOS-IU-",2
35,"35006",31309,23434,23019,221,415,"PODEMOS-IU-",4004
50,"50110",336,268,266,1,2,"PODEMOS-IU-",14
9,"9138",87,74,72,2,2,"PODEMOS-IU-",3
34,"34160",134,114,112,0,2,"PODEMOS-IU-",18
45,"45026",218,177,172,0,5,"PODEMOS-IU-",14
42,"42157",10,10,10,0,0,"PODEMOS-IU-",0
5,"5210",79,57,57,0,0,"PODEMOS-IU-",2
34,"34245",310,244,240,3,4,"PODEMOS-IU-",3
16,"16074",28,23,23,0,0,"PODEMOS-IU-",2
34,"34178",119,105,104,0,1,"PODEMOS-IU-",16
13,"13047",5780,4553,4461,32,92,"PODEMOS-IU-",391
50,"50023",208,165,164,2,1,"PODEMOS-IU-",6
24,"24061",1736,1350,1328,10,22,"PODEMOS-IU-",154
37,"37236",127,90,86,0,4,"PODEMOS-IU-",2
28,"28078",40,37,37,0,0,"PODEMOS-IU-",12
26,"26094",69,56,56,0,0,"PODEMOS-IU-",2
44,"44099",649,457,450,2,7,"PODEMOS-IU-",51
50,"50081",491,390,384,5,6,"PODEMOS-IU-",40
9,"9139",98,82,82,2,0,"PODEMOS-IU-",9
9,"9268",88,71,71,0,0,"PODEMOS-IU-",9
10,"10133",1154,971,955,3,16,"PODEMOS-IU-",79
13,"13002",1419,1021,995,5,26,"PODEMOS-IU-",40
24,"24100",754,602,598,7,4,"PODEMOS-IU-",94
35,"35007",518,405,401,0,4,"PODEMOS-IU-",25
28,"28123",61103,52177,51832,338,345,"PODEMOS-IU-",13580
45,"45121",7273,5362,5291,27,71,"PODEMOS-IU-",460
49,"49243",109,86,83,0,3,"PODEMOS-IU-",9
16,"16228",176,150,150,1,0,"PODEMOS-IU-",9
19,"19130",61365,49363,48747,383,616,"PODEMOS-IU-",5214
24,"24181",1414,1067,1055,14,12,"PODEMOS-IU-",45
44,"44032",17,13,13,0,0,"PODEMOS-IU-",0
34,"34165",59,51,50,1,1,"PODEMOS-IU-",1
13,"13095",72,60,60,1,0,"PODEMOS-IU-",6
24,"24023",262,208,206,3,2,"PODEMOS-IU-",24
6,"6038",790,583,574,4,9,"PODEMOS-IU-",25
44,"44193",69,57,56,1,1,"PODEMOS-IU-",12
26,"26021",2752,2132,2105,10,27,"PODEMOS-IU-",153
24,"24182",411,302,295,4,7,"PODEMOS-IU-",20
35,"35008",6207,4733,4654,42,79,"PODEMOS-IU-",709
16,"16010",137,104,101,0,3,"PODEMOS-IU-",1
34,"34220",149,133,132,0,1,"PODEMOS-IU-",4
50,"50201",444,357,354,1,3,"PODEMOS-IU-",44
10,"10110",2224,1618,1559,5,59,"PODEMOS-IU-",161
47,"47214",1364,1112,1074,7,38,"PODEMOS-IU-",65
2,"2042",818,631,620,1,11,"PODEMOS-IU-",54
10,"10069",785,609,596,2,13,"PODEMOS-IU-",22
42,"42027",73,63,63,0,0,"PODEMOS-IU-",5
13,"13097",2205,1764,1742,6,22,"PODEMOS-IU-",116
47,"47055",192,157,154,1,3,"PODEMOS-IU-",12
47,"47215",48,44,44,0,0,"PODEMOS-IU-",2
49,"49150",123,90,90,3,0,"PODEMOS-IU-",4
40,"40025",128,109,106,1,3,"PODEMOS-IU-",14
37,"37353",122,95,95,1,0,"PODEMOS-IU-",4
50,"50027",224,170,165,1,5,"PODEMOS-IU-",16
26,"26099",1216,993,973,14,20,"PODEMOS-IU-",91
49,"49234",399,339,333,2,6,"PODEMOS-IU-",16
40,"40014",56,44,43,2,1,"PODEMOS-IU-",2
19,"19268",43,42,42,0,0,"PODEMOS-IU-",6
38,"38037",12803,8628,8517,48,111,"PODEMOS-IU-",974
40,"40201",43,39,37,0,2,"PODEMOS-IU-",0
16,"16902",127,101,101,0,0,"PODEMOS-IU-",4
26,"26023",435,351,347,5,4,"PODEMOS-IU-",16
44,"44216",26922,20603,20279,204,324,"PODEMOS-IU-",2048
40,"40213",95,83,80,1,3,"PODEMOS-IU-",4
19,"19018",141,112,110,0,2,"PODEMOS-IU-",3
47,"47037",163,134,128,2,6,"PODEMOS-IU-",7
35,"35001",4571,3523,3463,8,60,"PODEMOS-IU-",441
9,"9456",137,104,104,0,0,"PODEMOS-IU-",6
5,"5002",1890,1497,1468,8,29,"PODEMOS-IU-",205
6,"6074",4755,3719,3638,27,81,"PODEMOS-IU-",468
10,"10030",472,323,318,1,5,"PODEMOS-IU-",20
40,"40099",52,46,44,0,2,"PODEMOS-IU-",3
2,"2033",1870,1503,1463,11,40,"PODEMOS-IU-",164
13,"13009",1397,1145,1123,4,22,"PODEMOS-IU-",30
30,"30021",9441,6664,6591,32,73,"PODEMOS-IU-",354
45,"45172",641,504,496,4,8,"PODEMOS-IU-",22
5,"5166",160,128,123,1,5,"PODEMOS-IU-",4
28,"28062",288,243,236,0,7,"PODEMOS-IU-",32
50,"50233",104,82,82,0,0,"PODEMOS-IU-",4
13,"13010",881,680,666,4,14,"PODEMOS-IU-",32
50,"50057",1332,1001,986,10,15,"PODEMOS-IU-",68
44,"44066",87,66,65,0,1,"PODEMOS-IU-",5
37,"37167",177,159,158,3,1,"PODEMOS-IU-",18
5,"5088",29,23,23,0,0,"PODEMOS-IU-",0
5,"5167",225,181,175,1,6,"PODEMOS-IU-",32
39,"39014",901,709,704,5,5,"PODEMOS-IU-",80
49,"49191",266,216,214,1,2,"PODEMOS-IU-",6
5,"5244",41,32,32,0,0,"PODEMOS-IU-",3
37,"37319",93,67,65,1,2,"PODEMOS-IU-",5
40,"40182",173,126,124,1,2,"PODEMOS-IU-",19
28,"28128",445,352,352,2,0,"PODEMOS-IU-",38
19,"19323",34,29,29,0,0,"PODEMOS-IU-",3
16,"16239",118,89,88,0,1,"PODEMOS-IU-",12
6,"6110",137,106,105,0,1,"PODEMOS-IU-",2
37,"37245",335,240,240,5,0,"PODEMOS-IU-",8
26,"26142",784,651,641,5,10,"PODEMOS-IU-",73
2,"2072",1525,1146,1112,4,34,"PODEMOS-IU-",100
9,"9261",449,343,342,5,1,"PODEMOS-IU-",35
28,"28161",51559,41390,40922,255,468,"PODEMOS-IU-",6264
16,"16142",120,95,95,0,0,"PODEMOS-IU-",11
24,"24151",445,334,328,3,6,"PODEMOS-IU-",21
44,"44167",39,30,30,0,0,"PODEMOS-IU-",8
9,"9213",270,196,196,1,0,"PODEMOS-IU-",34
16,"16100",640,570,565,1,5,"PODEMOS-IU-",27
6,"6012",3233,2515,2492,15,23,"PODEMOS-IU-",201
19,"19043",99,87,84,2,3,"PODEMOS-IU-",3
50,"50119",872,684,680,4,4,"PODEMOS-IU-",25
44,"44136",51,43,43,1,0,"PODEMOS-IU-",0
9,"9066",54,41,40,1,1,"PODEMOS-IU-",4
26,"26004",66,54,54,0,0,"PODEMOS-IU-",0
34,"34176",127,106,104,2,2,"PODEMOS-IU-",3
44,"44068",643,518,511,9,7,"PODEMOS-IU-",51
30,"30024",60183,45738,45317,290,421,"PODEMOS-IU-",3816
24,"24071",967,755,741,7,14,"PODEMOS-IU-",90
24,"24153",233,187,183,1,4,"PODEMOS-IU-",15
42,"42185",25,20,20,0,0,"PODEMOS-IU-",0
50,"50051",800,615,608,3,7,"PODEMOS-IU-",31
24,"24006",487,393,387,3,6,"PODEMOS-IU-",17
26,"26029",36,29,28,0,1,"PODEMOS-IU-",4
50,"50149",33,25,25,1,0,"PODEMOS-IU-",0
19,"19326",2343,1789,1768,9,21,"PODEMOS-IU-",242
24,"24110",1154,895,880,5,15,"PODEMOS-IU-",159
26,"26030",17,17,17,0,0,"PODEMOS-IU-",1
37,"37108",99,80,78,2,2,"PODEMOS-IU-",6
2,"2051",1665,1253,1222,6,31,"PODEMOS-IU-",50
9,"9904",468,371,369,3,2,"PODEMOS-IU-",33
50,"50004",478,380,376,2,4,"PODEMOS-IU-",33
6,"6091",3668,2839,2776,26,63,"PODEMOS-IU-",158
35,"35005",1017,751,743,1,8,"PODEMOS-IU-",44
34,"34037",276,224,223,2,1,"PODEMOS-IU-",14
44,"44086",421,332,327,3,5,"PODEMOS-IU-",56
49,"49242",444,364,359,3,5,"PODEMOS-IU-",20
40,"40208",720,592,585,4,7,"PODEMOS-IU-",33
24,"24073",442,328,324,2,4,"PODEMOS-IU-",27
50,"50208",1748,1360,1344,11,16,"PODEMOS-IU-",115
37,"37248",152,125,121,1,4,"PODEMOS-IU-",5
5,"5132",881,634,626,2,8,"PODEMOS-IU-",70
50,"50062",1863,1441,1416,9,25,"PODEMOS-IU-",214
6,"6114",127,109,108,0,1,"PODEMOS-IU-",8
47,"47002",18,18,18,0,0,"PODEMOS-IU-",0
9,"9178",40,27,27,0,0,"PODEMOS-IU-",3
16,"16174",168,143,141,1,2,"PODEMOS-IU-",7
44,"44201",478,417,412,3,5,"PODEMOS-IU-",59
6,"6015",117934,87081,86114,785,967,"PODEMOS-IU-",8563
16,"16106",2708,2200,2163,17,37,"PODEMOS-IU-",125
19,"19282",143,114,114,1,0,"PODEMOS-IU-",8
28,"28058",141251,112674,111423,778,1251,"PODEMOS-IU-",20112
24,"24211",263,219,214,3,5,"PODEMOS-IU-",7
26,"26044",51,44,42,0,2,"PODEMOS-IU-",6
34,"34039",62,49,49,0,0,"PODEMOS-IU-",0
37,"37250",332,232,231,1,1,"PODEMOS-IU-",13
19,"19330",67,60,60,0,0,"PODEMOS-IU-",3
5,"5174",65,53,52,1,1,"PODEMOS-IU-",3
50,"50152",1368,1061,1043,6,18,"PODEMOS-IU-",58
24,"24115",53267,39733,39172,433,561,"PODEMOS-IU-",6010
44,"44110",37,33,33,0,0,"PODEMOS-IU-",0
49,"49160",43,29,26,0,3,"PODEMOS-IU-",1
50,"50123",436,344,338,1,6,"PODEMOS-IU-",26
37,"37287",309,215,214,3,1,"PODEMOS-IU-",8
45,"45092",223,204,204,1,0,"PODEMOS-IU-",3
37,"37325",90,70,70,0,0,"PODEMOS-IU-",5
28,"28059",4515,3573,3542,12,31,"PODEMOS-IU-",446
49,"49202",172,125,124,2,1,"PODEMOS-IU-",1
44,"44204",27,22,22,0,0,"PODEMOS-IU-",1
49,"49084",268,226,223,9,3,"PODEMOS-IU-",27
47,"47162",68,55,55,0,0,"PODEMOS-IU-",1
44,"44173",102,85,80,0,5,"PODEMOS-IU-",15
37,"37251",107,79,79,1,0,"PODEMOS-IU-",2
37,"37213",83,65,64,0,1,"PODEMOS-IU-",9
44,"44076",2110,1725,1691,22,34,"PODEMOS-IU-",165
44,"44174",409,306,300,3,6,"PODEMOS-IU-",14
19,"19152",550,413,405,3,8,"PODEMOS-IU-",34
28,"28135",985,762,756,1,6,"PODEMOS-IU-",138
49,"49085",918,673,660,5,13,"PODEMOS-IU-",51
37,"37056",40,33,33,0,0,"PODEMOS-IU-",0
42,"42130",51,46,45,0,1,"PODEMOS-IU-",1
49,"49272",77,55,51,0,4,"PODEMOS-IU-",4
26,"26011",7229,5355,5277,64,78,"PODEMOS-IU-",574
44,"44205",634,444,426,9,18,"PODEMOS-IU-",35
10,"10016",327,260,259,1,1,"PODEMOS-IU-",25
37,"37365",166,132,131,1,1,"PODEMOS-IU-",4
45,"45125",2263,1871,1842,10,29,"PODEMOS-IU-",204
6,"6096",207,168,167,1,1,"PODEMOS-IU-",16
37,"37329",39,36,36,0,0,"PODEMOS-IU-",1
37,"37341",48,36,36,0,0,"PODEMOS-IU-",4
45,"45202",3982,3094,3055,8,39,"PODEMOS-IU-",286
39,"39012",6737,5391,5314,52,77,"PODEMOS-IU-",626
6,"6129",573,455,451,2,4,"PODEMOS-IU-",31
5,"5139",66,59,59,0,0,"PODEMOS-IU-",0
24,"24202",7559,5449,5363,63,86,"PODEMOS-IU-",1175
30,"30031",500,435,433,3,2,"PODEMOS-IU-",22
37,"37141",152,120,119,2,1,"PODEMOS-IU-",17
47,"47068",30,23,23,0,0,"PODEMOS-IU-",1
16,"16027",701,540,531,2,9,"PODEMOS-IU-",57
10,"10208",121,94,94,2,0,"PODEMOS-IU-",3
47,"47038",101,79,79,0,0,"PODEMOS-IU-",14
10,"10181",680,548,542,2,6,"PODEMOS-IU-",42
19,"19185",27,19,19,0,0,"PODEMOS-IU-",4
40,"40075",153,128,127,0,1,"PODEMOS-IU-",11
28,"28137",1744,1385,1366,8,19,"PODEMOS-IU-",185
19,"19053",1929,1472,1458,9,14,"PODEMOS-IU-",138
5,"5258",107,96,96,2,0,"PODEMOS-IU-",3
6,"6120",3373,2757,2719,10,38,"PODEMOS-IU-",213
47,"47039",166,134,134,0,0,"PODEMOS-IU-",9
6,"6087",2030,1592,1571,16,21,"PODEMOS-IU-",97
19,"19005",91,63,63,0,0,"PODEMOS-IU-",14
39,"39079",8861,6827,6745,47,82,"PODEMOS-IU-",550
37,"37255",42,31,31,2,0,"PODEMOS-IU-",0
16,"16126",729,622,616,5,6,"PODEMOS-IU-",54
19,"19288",22,21,21,1,0,"PODEMOS-IU-",1
34,"34240",87,65,63,3,2,"PODEMOS-IU-",1
44,"44115",102,96,95,0,1,"PODEMOS-IU-",20
16,"16030",22,19,19,1,0,"PODEMOS-IU-",2
6,"6088",12505,9311,9140,93,171,"PODEMOS-IU-",1141
49,"49127",2430,1835,1799,30,36,"PODEMOS-IU-",153
37,"37106",249,173,173,1,0,"PODEMOS-IU-",10
34,"34241",18,17,14,4,3,"PODEMOS-IU-",0
2,"2048",1178,989,967,7,22,"PODEMOS-IU-",49
49,"49128",533,428,424,7,4,"PODEMOS-IU-",25
40,"40112",2772,2255,2223,21,32,"PODEMOS-IU-",196
10,"10047",937,772,760,3,12,"PODEMOS-IU-",91
45,"45054",3831,2980,2944,11,36,"PODEMOS-IU-",195
42,"42183",106,83,83,1,0,"PODEMOS-IU-",1
6,"6067",1915,1393,1370,7,23,"PODEMOS-IU-",63
19,"19007",435,328,319,1,9,"PODEMOS-IU-",27
10,"10090",494,364,357,6,7,"PODEMOS-IU-",14
34,"34243",320,260,258,1,2,"PODEMOS-IU-",19
45,"45161",15266,11185,11023,69,162,"PODEMOS-IU-",1860
24,"24139",2087,1558,1540,20,18,"PODEMOS-IU-",114
9,"9228",157,136,136,0,0,"PODEMOS-IU-",11
19,"19291",1131,875,864,1,11,"PODEMOS-IU-",109
47,"47137",31,23,23,0,0,"PODEMOS-IU-",3
47,"47230",288,236,233,1,3,"PODEMOS-IU-",17
28,"28173",519,417,412,4,5,"PODEMOS-IU-",39
42,"42022",206,161,161,1,0,"PODEMOS-IU-",4
10,"10158",337,269,267,0,2,"PODEMOS-IU-",12
5,"5040",64,51,51,1,0,"PODEMOS-IU-",2
44,"44210",743,600,594,8,6,"PODEMOS-IU-",76
45,"45147",590,506,496,2,10,"PODEMOS-IU-",59
9,"9281",135,104,102,1,2,"PODEMOS-IU-",11
37,"37145",244,187,185,3,2,"PODEMOS-IU-",2
6,"6123",4512,3358,3266,28,92,"PODEMOS-IU-",413
6,"6002",4314,3181,3086,44,95,"PODEMOS-IU-",385
16,"16089",377,308,308,1,0,"PODEMOS-IU-",22
40,"40079",226,179,175,1,4,"PODEMOS-IU-",22
16,"16259",27,22,21,0,1,"PODEMOS-IU-",0
45,"45072",661,525,517,3,8,"PODEMOS-IU-",71
24,"24155",442,374,371,6,3,"PODEMOS-IU-",45
50,"50041",17,14,14,0,0,"PODEMOS-IU-",2
34,"34038",268,198,197,0,1,"PODEMOS-IU-",11
44,"44020",22,18,18,0,0,"PODEMOS-IU-",0
16,"16263",966,763,755,2,8,"PODEMOS-IU-",47
16,"16118",1350,1126,1093,6,33,"PODEMOS-IU-",66
5,"5147",147,119,117,0,2,"PODEMOS-IU-",4
37,"37337",139,114,114,0,0,"PODEMOS-IU-",0
34,"34146",53,47,46,0,1,"PODEMOS-IU-",1
6,"6092",555,428,419,3,9,"PODEMOS-IU-",16
6,"6125",1679,1348,1324,5,24,"PODEMOS-IU-",71
49,"49132",313,252,249,0,3,"PODEMOS-IU-",5
19,"19176",230,184,183,0,1,"PODEMOS-IU-",6
9,"9432",174,145,137,0,8,"PODEMOS-IU-",31
47,"47200",71,62,62,0,0,"PODEMOS-IU-",6
9,"9250",259,215,214,1,1,"PODEMOS-IU-",18
13,"13094",290,227,227,1,0,"PODEMOS-IU-",9
9,"9231",59,43,43,1,0,"PODEMOS-IU-",0
39,"39084",874,718,712,4,6,"PODEMOS-IU-",40
19,"19032",146,102,101,2,1,"PODEMOS-IU-",12
9,"9472",52,45,44,0,1,"PODEMOS-IU-",2
10,"10176",347,266,261,2,5,"PODEMOS-IU-",27
28,"28146",1792,1308,1293,8,15,"PODEMOS-IU-",144
44,"44051",2588,2034,1997,26,37,"PODEMOS-IU-",168
9,"9072",320,259,258,1,1,"PODEMOS-IU-",32
9,"9347",135,108,108,0,0,"PODEMOS-IU-",13
5,"5070",30,28,28,0,0,"PODEMOS-IU-",1
16,"16211",322,233,229,0,4,"PODEMOS-IU-",10
40,"40013",56,47,47,0,0,"PODEMOS-IU-",1
19,"19015",84,74,73,0,1,"PODEMOS-IU-",2
24,"24212",1002,772,764,7,8,"PODEMOS-IU-",49
39,"39085",6964,5489,5445,28,44,"PODEMOS-IU-",507
9,"9128",78,63,61,1,2,"PODEMOS-IU-",2
24,"24010",8268,5968,5847,66,121,"PODEMOS-IU-",545
28,"28070",113,94,94,2,0,"PODEMOS-IU-",29
9,"9129",89,75,75,0,0,"PODEMOS-IU-",5
2,"2055",1057,770,755,6,15,"PODEMOS-IU-",54
52,"52001",54124,34068,33749,237,319,"PODEMOS-IU-",1291
6,"6094",1459,1017,1008,8,9,"PODEMOS-IU-",34
50,"50104",326,264,259,4,5,"PODEMOS-IU-",9
39,"39002",3414,2630,2578,23,52,"PODEMOS-IU-",248
45,"45154",1479,1163,1149,5,14,"PODEMOS-IU-",136
49,"49174",130,93,91,0,2,"PODEMOS-IU-",3
37,"37339",308,227,226,0,1,"PODEMOS-IU-",10
13,"13082",25882,17928,17721,101,207,"PODEMOS-IU-",1421
16,"16269",393,322,317,3,5,"PODEMOS-IU-",9
50,"50221",32,22,22,0,0,"PODEMOS-IU-",0
37,"37151",143,112,111,1,1,"PODEMOS-IU-",3
10,"10124",858,710,701,3,9,"PODEMOS-IU-",48
34,"34121",183,155,151,1,4,"PODEMOS-IU-",7
50,"50134",118,91,89,0,2,"PODEMOS-IU-",4
9,"9407",27,23,23,0,0,"PODEMOS-IU-",5
26,"26060",75,60,60,1,0,"PODEMOS-IU-",9
19,"19301",37,31,31,0,0,"PODEMOS-IU-",0
28,"28040",16648,11709,11551,66,158,"PODEMOS-IU-",1981
24,"24215",152,125,124,1,1,"PODEMOS-IU-",6
47,"47078",159,135,131,0,4,"PODEMOS-IU-",4
26,"26151",411,353,351,3,2,"PODEMOS-IU-",25
9,"9221",492,413,409,0,4,"PODEMOS-IU-",68
49,"49017",259,196,195,0,1,"PODEMOS-IU-",10
47,"47153",104,76,75,0,1,"PODEMOS-IU-",6
39,"39003",258,205,202,3,3,"PODEMOS-IU-",13
16,"16124",1826,1482,1455,6,27,"PODEMOS-IU-",199
39,"39031",1245,990,983,5,7,"PODEMOS-IU-",68
34,"34106",113,101,101,0,0,"PODEMOS-IU-",5
42,"42152",67,47,46,0,1,"PODEMOS-IU-",0
10,"10902",735,537,521,2,16,"PODEMOS-IU-",11
49,"49137",170,138,134,0,4,"PODEMOS-IU-",4
9,"9077",30,22,22,0,0,"PODEMOS-IU-",0
19,"19038",22,19,19,0,0,"PODEMOS-IU-",2
19,"19335",56,45,43,0,2,"PODEMOS-IU-",2
34,"34171",941,702,688,9,14,"PODEMOS-IU-",60
50,"50058",63,54,53,2,1,"PODEMOS-IU-",2
34,"34017",889,743,738,6,5,"PODEMOS-IU-",47
50,"50048",33,25,25,0,0,"PODEMOS-IU-",5
42,"42019",511,384,378,7,6,"PODEMOS-IU-",34
45,"45158",2546,2026,2001,9,25,"PODEMOS-IU-",187
5,"5191",124,105,105,0,0,"PODEMOS-IU-",19
44,"44187",193,155,151,1,4,"PODEMOS-IU-",7
5,"5155",46,36,36,0,0,"PODEMOS-IU-",5
49,"49224",169,117,115,0,2,"PODEMOS-IU-",16
47,"47186",244448,197042,195276,1561,1766,"PODEMOS-IU-",24010
45,"45037",1535,1121,1105,7,16,"PODEMOS-IU-",106
19,"19040",57,40,40,0,0,"PODEMOS-IU-",4
37,"37231",239,204,203,6,1,"PODEMOS-IU-",11
37,"37232",378,322,321,1,1,"PODEMOS-IU-",21
30,"30012",9069,7397,7266,53,131,"PODEMOS-IU-",1023
39,"39005",1406,1127,1110,12,17,"PODEMOS-IU-",83
9,"9302",98,75,73,0,2,"PODEMOS-IU-",11
28,"28151",3251,2483,2450,11,33,"PODEMOS-IU-",353
37,"37119",95,78,77,0,1,"PODEMOS-IU-",8
10,"10904",722,549,543,7,6,"PODEMOS-IU-",51
50,"50138",47,42,42,1,0,"PODEMOS-IU-",5
9,"9034",292,239,238,2,1,"PODEMOS-IU-",10
50,"50050",86,65,65,1,0,"PODEMOS-IU-",4
9,"9135",40,34,34,0,0,"PODEMOS-IU-",0
10,"10076",793,597,585,4,12,"PODEMOS-IU-",33
42,"42021",68,44,44,2,0,"PODEMOS-IU-",1
47,"47020",272,228,225,5,3,"PODEMOS-IU-",3
35,"35004",41728,23957,23683,219,274,"PODEMOS-IU-",4059
16,"16242",308,266,263,2,3,"PODEMOS-IU-",11
9,"9001",30,27,27,0,0,"PODEMOS-IU-",0
16,"16275",12,12,12,0,0,"PODEMOS-IU-",2
50,"50168",27,20,20,0,0,"PODEMOS-IU-",3
37,"37206",91,66,63,1,3,"PODEMOS-IU-",4
19,"19261",32,24,24,0,0,"PODEMOS-IU-",2
34,"34110",82,66,65,0,1,"PODEMOS-IU-",6
24,"24070",3941,3007,2947,27,60,"PODEMOS-IU-",597
9,"9340",76,56,56,1,0,"PODEMOS-IU-",2
24,"24123",716,514,507,2,7,"PODEMOS-IU-",39
16,"16172",349,278,275,3,3,"PODEMOS-IU-",4
50,"50298",5427,4373,4323,30,50,"PODEMOS-IU-",513
44,"44107",205,159,158,0,1,"PODEMOS-IU-",13
19,"19175",30,19,19,1,0,"PODEMOS-IU-",1
24,"24178",72,65,65,1,0,"PODEMOS-IU-",0
2,"2002",435,358,352,2,6,"PODEMOS-IU-",19
34,"34216",60,46,46,0,0,"PODEMOS-IU-",2
40,"40196",32,28,28,1,0,"PODEMOS-IU-",0
5,"5159",228,160,159,2,1,"PODEMOS-IU-",6
49,"49036",508,361,355,6,6,"PODEMOS-IU-",18
16,"16130",536,445,444,0,1,"PODEMOS-IU-",13
44,"44039",202,166,165,3,1,"PODEMOS-IU-",9
19,"19010",9,10,10,0,0,"PODEMOS-IU-",1
34,"34082",80,68,68,0,0,"PODEMOS-IU-",1
16,"16007",1159,975,968,10,7,"PODEMOS-IU-",26
45,"45165",62598,47784,47120,345,664,"PODEMOS-IU-",4768
19,"19031",10,8,8,0,0,"PODEMOS-IU-",0
49,"49145",210,133,131,1,2,"PODEMOS-IU-",7
34,"34069",2184,1737,1701,16,36,"PODEMOS-IU-",169
50,"50111",183,144,142,2,2,"PODEMOS-IU-",24
44,"44031",82,52,52,1,0,"PODEMOS-IU-",3
28,"28047",42847,33561,33215,216,346,"PODEMOS-IU-",5841
19,"19046",22148,17383,17137,125,246,"PODEMOS-IU-",2677
13,"13033",1560,1278,1262,9,16,"PODEMOS-IU-",51
26,"26007",481,391,383,0,8,"PODEMOS-IU-",83
34,"34130",198,165,161,2,4,"PODEMOS-IU-",8
16,"16147",56,32,32,0,0,"PODEMOS-IU-",2
9,"9125",552,424,421,3,3,"PODEMOS-IU-",24
50,"50053",650,505,497,4,8,"PODEMOS-IU-",25
9,"9384",295,222,216,1,6,"PODEMOS-IU-",15
50,"50122",67,55,54,0,1,"PODEMOS-IU-",8
49,"49109",562,445,444,5,1,"PODEMOS-IU-",12
6,"6104",656,530,524,6,6,"PODEMOS-IU-",27
40,"40093",76,68,67,0,1,"PODEMOS-IU-",8
40,"40058",309,277,271,0,6,"PODEMOS-IU-",7
9,"9088",64,42,42,4,0,"PODEMOS-IU-",4
40,"40130",128,102,96,0,6,"PODEMOS-IU-",7
19,"19224",102,91,90,1,1,"PODEMOS-IU-",3
44,"44223",73,58,58,0,0,"PODEMOS-IU-",7
50,"50257",163,136,134,1,2,"PODEMOS-IU-",18
49,"49067",336,236,232,0,4,"PODEMOS-IU-",4
42,"42161",135,104,104,0,0,"PODEMOS-IU-",1
49,"49186",235,181,178,4,3,"PODEMOS-IU-",9
19,"19314",45,38,38,1,0,"PODEMOS-IU-",1
37,"37125",227,171,169,0,2,"PODEMOS-IU-",6
24,"24103",264,162,161,1,1,"PODEMOS-IU-",10
40,"40200",38,32,31,0,1,"PODEMOS-IU-",1
50,"50074",6166,4547,4444,33,103,"PODEMOS-IU-",574
50,"50210",36,29,29,0,0,"PODEMOS-IU-",3
6,"6006",4494,3395,3325,24,70,"PODEMOS-IU-",373
24,"24226",193,136,134,2,2,"PODEMOS-IU-",6
9,"9253",106,88,85,2,3,"PODEMOS-IU-",11
50,"50055",3627,2627,2571,41,56,"PODEMOS-IU-",331
45,"45078",1328,1152,1133,6,19,"PODEMOS-IU-",50
5,"5240",3323,2389,2346,16,43,"PODEMOS-IU-",230
9,"9168",272,222,216,3,6,"PODEMOS-IU-",17
47,"47182",1335,1034,1022,6,12,"PODEMOS-IU-",96
42,"42028",76,65,65,1,0,"PODEMOS-IU-",12
35,"35010",3797,2601,2572,9,29,"PODEMOS-IU-",434
44,"44225",103,82,81,0,1,"PODEMOS-IU-",10
9,"9255",84,70,70,1,0,"PODEMOS-IU-",5
37,"37127",200,145,145,1,0,"PODEMOS-IU-",13
10,"10111",1306,1006,994,12,12,"PODEMOS-IU-",68
9,"9074",834,697,694,8,3,"PODEMOS-IU-",72
49,"49189",192,132,128,1,4,"PODEMOS-IU-",6
49,"49222",370,284,282,2,2,"PODEMOS-IU-",21
19,"19037",132,114,112,0,2,"PODEMOS-IU-",4
50,"50222",1570,1126,1105,17,21,"PODEMOS-IU-",78
37,"37030",81,68,65,0,3,"PODEMOS-IU-",2
2,"2057",1960,1522,1489,15,33,"PODEMOS-IU-",223
6,"6162",2895,2289,2254,11,35,"PODEMOS-IU-",102
28,"28116",759,621,618,7,3,"PODEMOS-IU-",100
9,"9423",28,26,26,0,0,"PODEMOS-IU-",2
49,"49113",166,139,139,1,0,"PODEMOS-IU-",4
50,"50146",190,152,149,0,3,"PODEMOS-IU-",10
6,"6042",981,714,705,4,9,"PODEMOS-IU-",101
16,"16014",563,444,443,4,1,"PODEMOS-IU-",39
34,"34224",42,30,29,0,1,"PODEMOS-IU-",0
13,"13902",449,362,360,2,2,"PODEMOS-IU-",25
49,"49165",55,53,50,0,3,"PODEMOS-IU-",4
24,"24119",695,515,501,8,14,"PODEMOS-IU-",57
10,"10099",559,412,401,3,11,"PODEMOS-IU-",37
44,"44005",46,31,31,1,0,"PODEMOS-IU-",0
5,"5140",106,91,89,0,2,"PODEMOS-IU-",3
42,"42181",391,319,317,0,2,"PODEMOS-IU-",29
49,"49237",143,95,93,0,2,"PODEMOS-IU-",2
49,"49248",174,142,139,2,3,"PODEMOS-IU-",12
16,"16904",451,386,383,3,3,"PODEMOS-IU-",30
19,"19199",19,17,16,0,1,"PODEMOS-IU-",2
49,"49152",483,327,322,2,5,"PODEMOS-IU-",29
6,"6109",3843,3228,3106,26,122,"PODEMOS-IU-",255
13,"13904",504,394,376,6,18,"PODEMOS-IU-",32
16,"16253",308,250,249,2,1,"PODEMOS-IU-",6
37,"37142",566,446,444,6,2,"PODEMOS-IU-",38
44,"44080",284,214,212,1,2,"PODEMOS-IU-",37
37,"37318",199,152,152,1,0,"PODEMOS-IU-",8
9,"9100",58,46,46,0,0,"PODEMOS-IU-",1
34,"34189",53,39,39,1,0,"PODEMOS-IU-",2
16,"16906",71,52,52,1,0,"PODEMOS-IU-",0
28,"28053",6840,5797,5739,32,58,"PODEMOS-IU-",892
37,"37008",4222,3431,3393,19,38,"PODEMOS-IU-",228
40,"40149",486,383,376,3,7,"PODEMOS-IU-",40
30,"30002",9735,7319,7227,33,92,"PODEMOS-IU-",623
34,"34227",72,63,61,4,2,"PODEMOS-IU-",4
6,"6144",512,422,416,1,6,"PODEMOS-IU-",51
26,"26028",139,120,117,1,3,"PODEMOS-IU-",14
47,"47114",3911,2864,2807,28,57,"PODEMOS-IU-",225
44,"44067",108,82,78,0,4,"PODEMOS-IU-",17
9,"9155",25,20,20,0,0,"PODEMOS-IU-",0
28,"28034",370,284,280,0,4,"PODEMOS-IU-",40
42,"42184",56,42,41,1,1,"PODEMOS-IU-",1
34,"34003",150,122,120,2,2,"PODEMOS-IU-",13
6,"6023",4170,3088,3045,18,43,"PODEMOS-IU-",249
50,"50160",2150,1652,1619,14,33,"PODEMOS-IU-",197
13,"13014",481,400,395,1,5,"PODEMOS-IU-",40
9,"9323",59,41,41,2,0,"PODEMOS-IU-",9
13,"13030",120,97,96,0,1,"PODEMOS-IU-",2
5,"5234",46,43,43,0,0,"PODEMOS-IU-",0
39,"39063",954,726,722,4,4,"PODEMOS-IU-",52
16,"16032",277,224,223,1,1,"PODEMOS-IU-",15
45,"45116",680,547,537,4,10,"PODEMOS-IU-",37
44,"44084",55,45,45,0,0,"PODEMOS-IU-",2
26,"26145",237,207,204,0,3,"PODEMOS-IU-",14
40,"40207",800,662,652,6,10,"PODEMOS-IU-",85
5,"5145",47,27,27,1,0,"PODEMOS-IU-",0
9,"9103",200,179,179,1,0,"PODEMOS-IU-",14
5,"5026",187,163,159,1,4,"PODEMOS-IU-",19
9,"9160",80,64,64,1,0,"PODEMOS-IU-",2
19,"19293",1905,1513,1499,10,14,"PODEMOS-IU-",247
37,"37322",2466,1764,1723,17,41,"PODEMOS-IU-",226
49,"49228",55,47,47,0,0,"PODEMOS-IU-",5
13,"13016",661,508,495,2,13,"PODEMOS-IU-",22
24,"24209",2609,1880,1857,13,23,"PODEMOS-IU-",227
6,"6080",1890,1482,1467,18,15,"PODEMOS-IU-",118
26,"26107",91,78,77,0,1,"PODEMOS-IU-",9
49,"49119",222,181,180,0,1,"PODEMOS-IU-",27
16,"16019",185,147,147,0,0,"PODEMOS-IU-",4
34,"34231",217,184,178,0,6,"PODEMOS-IU-",4
45,"45059",1696,1442,1415,4,27,"PODEMOS-IU-",78
37,"37025",244,209,206,0,3,"PODEMOS-IU-",6
9,"9105",97,81,76,1,5,"PODEMOS-IU-",6
19,"19114",33,25,25,1,0,"PODEMOS-IU-",0
10,"10201",179,157,156,1,1,"PODEMOS-IU-",3
39,"39027",3066,2511,2467,15,44,"PODEMOS-IU-",201
37,"37110",103,84,82,0,2,"PODEMOS-IU-",3
44,"44149",100,74,73,0,1,"PODEMOS-IU-",5
9,"9408",42,33,33,0,0,"PODEMOS-IU-",2
45,"45043",783,670,664,6,6,"PODEMOS-IU-",43
39,"39075",136968,104358,103487,690,871,"PODEMOS-IU-",9806
34,"34083",1664,1244,1229,10,15,"PODEMOS-IU-",113
5,"5148",23,17,17,0,0,"PODEMOS-IU-",1
38,"38043",19265,14000,13856,115,144,"PODEMOS-IU-",1995
45,"45014",4020,2910,2854,22,56,"PODEMOS-IU-",379
42,"42189",53,44,42,0,2,"PODEMOS-IU-",1
40,"40035",135,111,110,0,1,"PODEMOS-IU-",16
16,"16149",154,130,130,2,0,"PODEMOS-IU-",20
50,"50276",119,91,91,1,0,"PODEMOS-IU-",3
16,"16265",20,20,19,0,1,"PODEMOS-IU-",1
50,"50133",100,82,82,2,0,"PODEMOS-IU-",11
6,"6050",4042,3246,3163,27,83,"PODEMOS-IU-",235
45,"45091",374,275,274,1,1,"PODEMOS-IU-",18
24,"24158",296,226,220,2,6,"PODEMOS-IU-",17
10,"10204",419,342,339,4,3,"PODEMOS-IU-",29
6,"6017",257,211,210,1,1,"PODEMOS-IU-",11
28,"28167",8608,7086,7015,48,71,"PODEMOS-IU-",1279
13,"13021",417,343,343,0,0,"PODEMOS-IU-",25
44,"44075",326,275,263,0,12,"PODEMOS-IU-",8
42,"42053",21,15,15,0,0,"PODEMOS-IU-",0
5,"5058",72,52,52,0,0,"PODEMOS-IU-",3
39,"39020",23931,17782,17566,126,216,"PODEMOS-IU-",3499
37,"37150",36,31,31,0,0,"PODEMOS-IU-",0
37,"37138",219,180,176,1,4,"PODEMOS-IU-",8
45,"45138",1055,889,874,5,15,"PODEMOS-IU-",38
37,"37176",130,103,103,1,0,"PODEMOS-IU-",3
39,"39086",362,273,268,1,5,"PODEMOS-IU-",18
49,"49004",111,77,77,4,0,"PODEMOS-IU-",8
45,"45048",355,277,271,1,6,"PODEMOS-IU-",18
34,"34087",122,105,105,0,0,"PODEMOS-IU-",11
10,"10192",767,625,614,1,11,"PODEMOS-IU-",26
9,"9387",111,91,89,0,2,"PODEMOS-IU-",19
50,"50084",66,47,47,0,0,"PODEMOS-IU-",2
26,"26059",1122,861,841,7,20,"PODEMOS-IU-",70
24,"24228",626,432,426,3,6,"PODEMOS-IU-",51
47,"47205",355,263,258,3,5,"PODEMOS-IU-",14
19,"19318",23,18,18,0,0,"PODEMOS-IU-",1
10,"10179",277,220,219,0,1,"PODEMOS-IU-",29
45,"45085",1511,1141,1128,9,13,"PODEMOS-IU-",116
47,"47163",280,238,232,2,6,"PODEMOS-IU-",40
45,"45064",3998,3166,3117,17,49,"PODEMOS-IU-",603
44,"44206",103,83,82,0,1,"PODEMOS-IU-",17
49,"49176",610,426,426,4,0,"PODEMOS-IU-",10
47,"47206",78,64,64,0,0,"PODEMOS-IU-",3
40,"40016",54,43,43,1,0,"PODEMOS-IU-",3
45,"45003",550,435,431,4,4,"PODEMOS-IU-",29
40,"40084",53,40,39,0,1,"PODEMOS-IU-",7
10,"10166",313,211,202,0,9,"PODEMOS-IU-",13
38,"38017",30646,18576,18373,100,203,"PODEMOS-IU-",2761
24,"24162",1772,1382,1369,22,13,"PODEMOS-IU-",153
26,"26126",29,29,29,1,0,"PODEMOS-IU-",1
45,"45204",634,500,497,1,3,"PODEMOS-IU-",43
16,"16125",1599,1314,1295,9,19,"PODEMOS-IU-",74
10,"10127",4706,3508,3423,23,85,"PODEMOS-IU-",402
44,"44105",69,54,54,1,0,"PODEMOS-IU-",5
19,"19321",34,29,29,0,0,"PODEMOS-IU-",2
6,"6153",20240,15464,15210,134,254,"PODEMOS-IU-",1493
40,"40135",269,224,221,1,3,"PODEMOS-IU-",2
13,"13025",296,260,256,1,4,"PODEMOS-IU-",3
50,"50077",206,158,157,1,1,"PODEMOS-IU-",15
42,"42182",51,42,42,1,0,"PODEMOS-IU-",0
16,"16154",4752,3798,3732,37,66,"PODEMOS-IU-",266
47,"47165",6822,5456,5296,62,160,"PODEMOS-IU-",457
5,"5049",410,310,305,3,5,"PODEMOS-IU-",15
5,"5007",110,81,80,2,1,"PODEMOS-IU-",2
6,"6143",3370,2635,2589,23,46,"PODEMOS-IU-",204
24,"24203",95,72,72,0,0,"PODEMOS-IU-",6
9,"9209",4419,3407,3338,37,69,"PODEMOS-IU-",404
34,"34077",381,301,293,2,8,"PODEMOS-IU-",24
47,"47166",251,196,189,3,7,"PODEMOS-IU-",5
9,"9173",129,102,102,0,0,"PODEMOS-IU-",9
28,"28064",135,110,104,1,6,"PODEMOS-IU-",12
5,"5063",31,27,27,0,0,"PODEMOS-IU-",1
24,"24136",496,375,371,2,4,"PODEMOS-IU-",17
26,"26115",23,21,19,0,2,"PODEMOS-IU-",2
39,"39080",3505,2735,2701,8,34,"PODEMOS-IU-",207
16,"16031",36,25,25,0,0,"PODEMOS-IU-",0
28,"28140",3139,2547,2523,12,24,"PODEMOS-IU-",381
45,"45104",421,340,335,1,5,"PODEMOS-IU-",37
45,"45160",1095,913,905,2,8,"PODEMOS-IU-",73
34,"34063",87,77,77,1,0,"PODEMOS-IU-",1
5,"5143",62,51,51,0,0,"PODEMOS-IU-",1
44,"44027",149,120,119,0,1,"PODEMOS-IU-",22
10,"10103",426,330,327,0,3,"PODEMOS-IU-",24
40,"40184",248,205,203,0,2,"PODEMOS-IU-",8
5,"5194",132,111,111,0,0,"PODEMOS-IU-",3
37,"37182",78,57,57,0,0,"PODEMOS-IU-",5
35,"35023",11694,8785,8607,67,178,"PODEMOS-IU-",1113
49,"49130",158,131,131,5,0,"PODEMOS-IU-",7
24,"24058",195,127,125,1,2,"PODEMOS-IU-",6
28,"28141",6246,4943,4890,44,53,"PODEMOS-IU-",715
26,"26157",282,233,232,1,1,"PODEMOS-IU-",22
37,"37158",233,168,166,0,2,"PODEMOS-IU-",28
50,"50225",1532,1072,1064,10,8,"PODEMOS-IU-",89
50,"50227",110,74,73,2,1,"PODEMOS-IU-",6
10,"10049",3758,3167,3086,19,81,"PODEMOS-IU-",233
9,"9396",153,125,124,0,1,"PODEMOS-IU-",14
10,"10186",944,781,758,1,23,"PODEMOS-IU-",44
9,"9084",167,132,127,4,5,"PODEMOS-IU-",2
30,"30902",8225,5797,5715,22,82,"PODEMOS-IU-",641
9,"9137",180,149,147,1,2,"PODEMOS-IU-",18
45,"45163",8340,6486,6363,38,123,"PODEMOS-IU-",717
5,"5158",345,279,274,2,5,"PODEMOS-IU-",13
42,"42215",735,540,529,5,11,"PODEMOS-IU-",18
24,"24222",14431,11296,11135,117,161,"PODEMOS-IU-",1549
50,"50265",74,56,56,0,0,"PODEMOS-IU-",13
47,"47221",100,84,83,1,1,"PODEMOS-IU-",4
10,"10092",266,216,211,18,5,"PODEMOS-IU-",12
47,"47169",61,53,53,0,0,"PODEMOS-IU-",0
28,"28174",1840,1363,1349,10,14,"PODEMOS-IU-",154
9,"9447",43,40,40,0,0,"PODEMOS-IU-",2
26,"26132",106,87,87,0,0,"PODEMOS-IU-",11
16,"16277",109,82,82,0,0,"PODEMOS-IU-",3
6,"6158",13362,10282,10112,73,170,"PODEMOS-IU-",1335
5,"5160",296,236,232,1,4,"PODEMOS-IU-",8
47,"47232",100,76,76,1,0,"PODEMOS-IU-",2
24,"24047",720,531,523,2,8,"PODEMOS-IU-",46
45,"45196",1387,1099,1084,6,15,"PODEMOS-IU-",63
13,"13083",2392,1772,1714,13,58,"PODEMOS-IU-",142
16,"16137",37,27,25,0,2,"PODEMOS-IU-",2
44,"44087",68,56,54,0,2,"PODEMOS-IU-",6
40,"40054",107,91,88,0,3,"PODEMOS-IU-",10
42,"42127",38,27,27,1,0,"PODEMOS-IU-",0
50,"50200",475,416,407,4,9,"PODEMOS-IU-",33
49,"49133",291,213,211,0,2,"PODEMOS-IU-",11
28,"28903",35344,30490,30287,201,203,"PODEMOS-IU-",4898
16,"16049",144,111,108,1,3,"PODEMOS-IU-",2
42,"42094",603,484,475,10,9,"PODEMOS-IU-",48
37,"37338",78,66,64,0,2,"PODEMOS-IU-",6
34,"34116",55,45,45,0,0,"PODEMOS-IU-",1
24,"24225",992,762,751,5,11,"PODEMOS-IU-",65
47,"47180",57,46,46,1,0,"PODEMOS-IU-",3
34,"34902",123,98,98,4,0,"PODEMOS-IU-",3
9,"9348",133,105,104,0,1,"PODEMOS-IU-",11
37,"37263",338,251,246,0,5,"PODEMOS-IU-",30
5,"5072",94,86,85,1,1,"PODEMOS-IU-",3
13,"13036",766,626,617,0,9,"PODEMOS-IU-",36
6,"6028",4109,3613,3538,17,75,"PODEMOS-IU-",169
16,"16121",233,183,179,0,4,"PODEMOS-IU-",24
47,"47171",384,315,311,5,4,"PODEMOS-IU-",8
42,"42205",85,64,62,0,2,"PODEMOS-IU-",2
26,"26046",1571,1185,1157,18,28,"PODEMOS-IU-",117
5,"5266",102,79,78,0,1,"PODEMOS-IU-",0
28,"28009",14500,11656,11564,62,92,"PODEMOS-IU-",1435
42,"42015",32,23,23,1,0,"PODEMOS-IU-",0
49,"49221",234,138,130,1,8,"PODEMOS-IU-",7
19,"19299",102,78,78,1,0,"PODEMOS-IU-",6
44,"44258",53,44,44,0,0,"PODEMOS-IU-",1
44,"44003",17,14,14,0,0,"PODEMOS-IU-",0
40,"40095",464,379,369,2,10,"PODEMOS-IU-",14
34,"34168",45,39,39,0,0,"PODEMOS-IU-",2
26,"26110",150,128,124,1,4,"PODEMOS-IU-",11
13,"13098",1983,1537,1485,22,52,"PODEMOS-IU-",92
16,"16051",126,102,100,0,2,"PODEMOS-IU-",0
10,"10070",669,516,513,1,3,"PODEMOS-IU-",29
40,"40166",253,214,213,1,1,"PODEMOS-IU-",8
5,"5033",170,146,145,0,1,"PODEMOS-IU-",4
16,"16181",57,46,46,1,0,"PODEMOS-IU-",2
19,"19260",38,33,31,1,2,"PODEMOS-IU-",3
30,"30033",10363,8115,7979,54,136,"PODEMOS-IU-",756
10,"10057",126,97,96,2,1,"PODEMOS-IU-",12
50,"50100",306,238,235,3,3,"PODEMOS-IU-",17
49,"49099",98,75,74,0,1,"PODEMOS-IU-",2
16,"16040",85,72,72,1,0,"PODEMOS-IU-",7
6,"6008",613,540,532,0,8,"PODEMOS-IU-",25
34,"34223",205,160,157,1,3,"PODEMOS-IU-",4
6,"6130",186,159,154,0,5,"PODEMOS-IU-",14
5,"5087",149,112,111,1,1,"PODEMOS-IU-",5
49,"49262",370,287,286,1,1,"PODEMOS-IU-",29
44,"44123",99,69,69,1,0,"PODEMOS-IU-",6
49,"49100",286,210,208,2,2,"PODEMOS-IU-",7
49,"49125",1401,1031,1010,7,21,"PODEMOS-IU-",116
16,"16153",936,786,768,7,18,"PODEMOS-IU-",44
50,"50047",43,32,31,1,1,"PODEMOS-IU-",1
37,"37230",214,176,176,0,0,"PODEMOS-IU-",15
35,"35011",24705,17099,16823,129,276,"PODEMOS-IU-",2781
37,"37330",318,255,248,2,7,"PODEMOS-IU-",7
42,"42086",33,21,19,0,2,"PODEMOS-IU-",1
10,"10005",530,407,384,3,23,"PODEMOS-IU-",13
47,"47112",2570,2098,2075,13,23,"PODEMOS-IU-",101
26,"26179",41,33,32,0,1,"PODEMOS-IU-",0
9,"9411",154,118,118,0,0,"PODEMOS-IU-",24
28,"28073",12751,9940,9838,63,102,"PODEMOS-IU-",1595
50,"50137",964,790,781,9,9,"PODEMOS-IU-",74
30,"30042",2180,1727,1703,6,24,"PODEMOS-IU-",126
47,"47134",148,127,126,6,1,"PODEMOS-IU-",7
37,"37103",414,309,309,4,0,"PODEMOS-IU-",22
5,"5243",81,63,62,1,1,"PODEMOS-IU-",2
45,"45174",296,253,250,3,3,"PODEMOS-IU-",7
47,"47029",50,43,43,1,0,"PODEMOS-IU-",4
6,"6099",1162,833,813,6,20,"PODEMOS-IU-",66
16,"16128",51,44,44,0,0,"PODEMOS-IU-",2
2,"2060",1280,1039,1020,5,19,"PODEMOS-IU-",41
37,"37268",108,72,70,0,2,"PODEMOS-IU-",1
10,"10170",239,180,179,1,1,"PODEMOS-IU-",15
34,"34246",69,53,53,0,0,"PODEMOS-IU-",0
45,"45007",665,549,533,0,16,"PODEMOS-IU-",46
10,"10061",1598,1126,1114,5,12,"PODEMOS-IU-",69
16,"16206",196,146,144,3,2,"PODEMOS-IU-",8
24,"24088",995,813,802,12,11,"PODEMOS-IU-",71
16,"16057",64,53,53,0,0,"PODEMOS-IU-",7
26,"26124",776,635,624,5,11,"PODEMOS-IU-",40
40,"40088",268,200,200,0,0,"PODEMOS-IU-",14
40,"40031",540,429,424,6,5,"PODEMOS-IU-",71
34,"34126",254,220,219,3,1,"PODEMOS-IU-",9
9,"9463",250,203,201,6,2,"PODEMOS-IU-",25
24,"24165",327,236,233,1,3,"PODEMOS-IU-",10
34,"34242",93,66,64,1,2,"PODEMOS-IU-",3
37,"37219",165,101,97,2,4,"PODEMOS-IU-",9
40,"40068",22,21,21,0,0,"PODEMOS-IU-",0
37,"37321",149,121,121,0,0,"PODEMOS-IU-",10
45,"45162",632,481,471,2,10,"PODEMOS-IU-",29
45,"45024",1043,832,821,5,11,"PODEMOS-IU-",37
10,"10212",1645,1283,1238,7,45,"PODEMOS-IU-",271
34,"34141",176,154,152,0,2,"PODEMOS-IU-",7
49,"49209",474,338,334,4,4,"PODEMOS-IU-",17
9,"9122",88,64,64,0,0,"PODEMOS-IU-",2
47,"47148",423,342,339,2,3,"PODEMOS-IU-",15
19,"19189",115,93,92,0,1,"PODEMOS-IU-",6
47,"47061",243,203,197,3,6,"PODEMOS-IU-",15
45,"45025",1219,926,913,5,13,"PODEMOS-IU-",83
47,"47210",402,300,289,2,11,"PODEMOS-IU-",13
5,"5119",24,16,16,1,0,"PODEMOS-IU-",0
37,"37235",219,170,166,4,4,"PODEMOS-IU-",11
26,"26017",354,293,290,4,3,"PODEMOS-IU-",67
50,"50220",43,37,37,0,0,"PODEMOS-IU-",7
5,"5262",323,254,254,0,0,"PODEMOS-IU-",13
45,"45148",275,209,209,1,0,"PODEMOS-IU-",8
44,"44171",182,130,128,0,2,"PODEMOS-IU-",56
35,"35034",8396,4599,4546,55,53,"PODEMOS-IU-",862
49,"49024",637,465,461,2,4,"PODEMOS-IU-",35
28,"28122",570,457,448,3,9,"PODEMOS-IU-",53
30,"30025",5001,3951,3898,27,53,"PODEMOS-IU-",303
10,"10011",532,439,435,3,4,"PODEMOS-IU-",22
10,"10147",1283,1038,1007,4,31,"PODEMOS-IU-",167
5,"5046",39,37,37,0,0,"PODEMOS-IU-",0
10,"10187",430,316,311,0,5,"PODEMOS-IU-",51
47,"47211",48,43,43,1,0,"PODEMOS-IU-",1
50,"50231",257,210,207,3,3,"PODEMOS-IU-",28
35,"35009",20109,15017,14803,78,214,"PODEMOS-IU-",1965
47,"47146",278,232,230,3,2,"PODEMOS-IU-",34
37,"37233",56,46,46,2,0,"PODEMOS-IU-",5
49,"49193",435,303,287,1,16,"PODEMOS-IU-",15
16,"16123",66,43,43,0,0,"PODEMOS-IU-",5
34,"34084",155,127,126,1,1,"PODEMOS-IU-",4
9,"9041",26,26,26,1,0,"PODEMOS-IU-",1
28,"28008",1961,1477,1456,6,21,"PODEMOS-IU-",229
47,"47118",149,111,108,1,3,"PODEMOS-IU-",9
50,"50054",56,48,47,0,1,"PODEMOS-IU-",5
6,"6137",933,730,723,5,7,"PODEMOS-IU-",43
9,"9179",38,32,32,0,0,"PODEMOS-IU-",6
42,"42145",134,108,108,0,0,"PODEMOS-IU-",3
5,"5265",79,59,59,0,0,"PODEMOS-IU-",2
50,"50172",178,134,131,3,3,"PODEMOS-IU-",10
47,"47086",3823,3090,3046,24,44,"PODEMOS-IU-",194
40,"40164",185,136,134,3,2,"PODEMOS-IU-",3
44,"44002",46,42,42,0,0,"PODEMOS-IU-",6
13,"13020",4729,3461,3416,34,45,"PODEMOS-IU-",386
16,"16064",651,575,569,4,6,"PODEMOS-IU-",21
39,"39039",546,431,428,0,3,"PODEMOS-IU-",22
9,"9251",365,278,277,0,1,"PODEMOS-IU-",48
49,"49220",139,110,104,2,6,"PODEMOS-IU-",9
6,"6061",1084,915,905,8,10,"PODEMOS-IU-",54
10,"10177",1695,1358,1323,9,35,"PODEMOS-IU-",134
10,"10096",3326,2553,2501,14,52,"PODEMOS-IU-",391
42,"42209",135,107,100,5,7,"PODEMOS-IU-",10
44,"44012",310,240,238,5,2,"PODEMOS-IU-",15
24,"24120",311,209,209,0,0,"PODEMOS-IU-",25
24,"24198",547,402,399,4,3,"PODEMOS-IU-",33
50,"50296",382,288,272,1,16,"PODEMOS-IU-",45
38,"38046",9271,7297,7212,53,85,"PODEMOS-IU-",1453
16,"16065",372,306,305,2,1,"PODEMOS-IU-",11
49,"49233",85,58,58,0,0,"PODEMOS-IU-",1
9,"9144",44,37,37,2,0,"PODEMOS-IU-",1
37,"37004",24,19,19,0,0,"PODEMOS-IU-",2
24,"24096",108,69,69,0,0,"PODEMOS-IU-",7
26,"26176",53,48,48,0,0,"PODEMOS-IU-",3
6,"6140",611,515,506,1,9,"PODEMOS-IU-",8
6,"6010",1075,859,846,8,13,"PODEMOS-IU-",119
50,"50129",213,151,149,5,2,"PODEMOS-IU-",18
47,"47012",101,80,80,0,0,"PODEMOS-IU-",3
28,"28044",6193,5040,4991,31,49,"PODEMOS-IU-",908
13,"13089",1609,1336,1299,10,37,"PODEMOS-IU-",61
37,"37228",325,278,273,0,5,"PODEMOS-IU-",13
13,"13039",14212,10929,10761,107,168,"PODEMOS-IU-",1043
9,"9131",480,412,402,2,10,"PODEMOS-IU-",48
9,"9202",22,22,22,2,0,"PODEMOS-IU-",0
47,"47111",998,806,795,6,11,"PODEMOS-IU-",57
10,"10112",1518,1168,1151,4,17,"PODEMOS-IU-",64
9,"9482",35,28,28,0,0,"PODEMOS-IU-",3
49,"49236",70,55,55,0,0,"PODEMOS-IU-",2
37,"37152",402,308,302,1,6,"PODEMOS-IU-",19
9,"9241",247,192,188,2,4,"PODEMOS-IU-",30
45,"45065",261,207,205,2,2,"PODEMOS-IU-",15
5,"5075",99,79,79,1,0,"PODEMOS-IU-",2
42,"42194",146,111,111,0,0,"PODEMOS-IU-",5
50,"50232",160,116,114,2,2,"PODEMOS-IU-",28
9,"9257",86,74,71,0,3,"PODEMOS-IU-",8
50,"50038",1405,1112,1099,13,13,"PODEMOS-IU-",134
45,"45189",616,506,498,2,8,"PODEMOS-IU-",57
49,"49007",365,271,265,7,6,"PODEMOS-IU-",14
28,"28002",3281,2481,2455,24,26,"PODEMOS-IU-",286
28,"28138",63,49,49,0,0,"PODEMOS-IU-",12
50,"50147",751,564,559,3,5,"PODEMOS-IU-",66
24,"24130",418,331,326,0,5,"PODEMOS-IU-",30
26,"26087",170,136,135,3,1,"PODEMOS-IU-",14
49,"49157",192,153,149,0,4,"PODEMOS-IU-",17
28,"28063",254,203,202,2,1,"PODEMOS-IU-",44
34,"34225",5001,4070,4021,48,49,"PODEMOS-IU-",652
26,"26106",76,66,65,0,1,"PODEMOS-IU-",8
24,"24188",3820,3107,3056,33,51,"PODEMOS-IU-",256
45,"45036",634,490,482,0,8,"PODEMOS-IU-",29
47,"47156",150,128,128,2,0,"PODEMOS-IU-",11
47,"47060",231,198,195,4,3,"PODEMOS-IU-",17
34,"34055",263,214,213,3,1,"PODEMOS-IU-",7
44,"44061",75,66,65,2,1,"PODEMOS-IU-",3
5,"5142",90,83,81,0,2,"PODEMOS-IU-",0
37,"37184",290,199,195,0,4,"PODEMOS-IU-",5
28,"28067",4361,3548,3509,14,39,"PODEMOS-IU-",512
5,"5164",17,12,12,0,0,"PODEMOS-IU-",0
44,"44118",158,126,122,1,4,"PODEMOS-IU-",8
37,"37218",48,29,29,0,0,"PODEMOS-IU-",2
47,"47209",34,25,25,0,0,"PODEMOS-IU-",7
9,"9356",43,36,36,0,0,"PODEMOS-IU-",5
49,"49208",364,260,255,5,5,"PODEMOS-IU-",9
49,"49034",417,320,317,0,3,"PODEMOS-IU-",20
28,"28014",34047,26858,26575,178,283,"PODEMOS-IU-",3963
45,"45151",546,434,431,0,3,"PODEMOS-IU-",57
9,"9227",113,93,91,0,2,"PODEMOS-IU-",5
26,"26077",17,17,17,0,0,"PODEMOS-IU-",0
47,"47041",153,119,116,2,3,"PODEMOS-IU-",11
37,"37091",164,108,108,3,0,"PODEMOS-IU-",3
26,"26041",114,84,84,0,0,"PODEMOS-IU-",6
2,"2062",386,287,285,4,2,"PODEMOS-IU-",12
5,"5065",459,393,382,1,11,"PODEMOS-IU-",22
13,"13080",321,246,246,1,0,"PODEMOS-IU-",12
24,"24098",1149,882,863,7,19,"PODEMOS-IU-",152
9,"9265",47,38,36,2,2,"PODEMOS-IU-",2
13,"13091",544,485,476,4,9,"PODEMOS-IU-",13
47,"47224",97,74,74,0,0,"PODEMOS-IU-",7
16,"16018",381,313,312,2,1,"PODEMOS-IU-",14
44,"44191",722,567,561,7,6,"PODEMOS-IU-",113
44,"44096",153,120,112,1,8,"PODEMOS-IU-",24
9,"9247",22,18,18,0,0,"PODEMOS-IU-",1
28,"28181",20669,17314,17205,101,109,"PODEMOS-IU-",1763
5,"5151",80,64,64,1,0,"PODEMOS-IU-",1
24,"24129",111,91,91,1,0,"PODEMOS-IU-",4
37,"37092",1889,1459,1447,16,12,"PODEMOS-IU-",125
16,"16060",722,571,560,3,11,"PODEMOS-IU-",42
19,"19181",55,47,46,1,1,"PODEMOS-IU-",4
10,"10160",237,189,183,3,6,"PODEMOS-IU-",11
37,"37208",69,52,51,0,1,"PODEMOS-IU-",7
37,"37298",172,126,125,0,1,"PODEMOS-IU-",2
9,"9362",205,177,177,3,0,"PODEMOS-IU-",24
37,"37164",238,194,193,4,1,"PODEMOS-IU-",31
5,"5085",30,27,27,0,0,"PODEMOS-IU-",0
42,"42188",43,35,34,1,1,"PODEMOS-IU-",1
45,"45032",444,319,313,2,6,"PODEMOS-IU-",31
50,"50187",56,43,43,0,0,"PODEMOS-IU-",6
44,"44082",89,72,69,0,3,"PODEMOS-IU-",5
19,"19204",149,112,112,1,0,"PODEMOS-IU-",7
47,"47004",1136,950,939,5,11,"PODEMOS-IU-",38
50,"50039",467,366,364,3,2,"PODEMOS-IU-",65
24,"24218",444,343,341,6,2,"PODEMOS-IU-",36
30,"30040",705,600,596,1,4,"PODEMOS-IU-",41
13,"13079",12265,9441,9218,123,223,"PODEMOS-IU-",743
16,"16133",4387,3607,3544,38,63,"PODEMOS-IU-",670
50,"50279",73,61,60,2,1,"PODEMOS-IU-",6
37,"37186",96,79,79,0,0,"PODEMOS-IU-",0
45,"45045",1331,1001,990,2,11,"PODEMOS-IU-",70
5,"5043",75,62,62,0,0,"PODEMOS-IU-",5
5,"5198",71,51,51,0,0,"PODEMOS-IU-",0
16,"16048",409,331,330,1,1,"PODEMOS-IU-",17
2,"2065",443,373,370,0,3,"PODEMOS-IU-",33
26,"26127",186,162,159,1,3,"PODEMOS-IU-",4
44,"44024",28,25,24,0,1,"PODEMOS-IU-",0
16,"16194",220,181,173,1,8,"PODEMOS-IU-",18
10,"10149",434,308,304,2,4,"PODEMOS-IU-",19
45,"45061",2485,1850,1822,7,28,"PODEMOS-IU-",179
9,"9239",47,39,39,0,0,"PODEMOS-IU-",1
9,"9270",159,119,117,4,2,"PODEMOS-IU-",4
45,"45184",201,133,132,0,1,"PODEMOS-IU-",17
35,"35027",10499,7651,7530,57,121,"PODEMOS-IU-",1071
42,"42148",9,9,9,0,0,"PODEMOS-IU-",0
47,"47191",115,85,84,0,1,"PODEMOS-IU-",16
19,"19303",40,35,35,0,0,"PODEMOS-IU-",0
19,"19242",77,67,67,0,0,"PODEMOS-IU-",4
37,"37226",150,119,119,2,0,"PODEMOS-IU-",2
5,"5094",132,109,108,1,1,"PODEMOS-IU-",2
9,"9478",45,40,40,0,0,"PODEMOS-IU-",4
5,"5201",499,414,407,2,7,"PODEMOS-IU-",23
45,"45001",1837,1371,1340,12,31,"PODEMOS-IU-",108
26,"26111",250,209,205,2,4,"PODEMOS-IU-",32
45,"45098",2110,1675,1652,6,23,"PODEMOS-IU-",119
24,"24108",348,268,265,2,3,"PODEMOS-IU-",10
9,"9093",162,138,137,1,1,"PODEMOS-IU-",13
39,"39092",871,635,629,2,6,"PODEMOS-IU-",51
28,"28154",5525,4283,4222,24,61,"PODEMOS-IU-",568
9,"9416",60,44,44,0,0,"PODEMOS-IU-",14
40,"40052",72,56,56,0,0,"PODEMOS-IU-",6
24,"24105",1498,1188,1177,18,11,"PODEMOS-IU-",147
34,"34100",131,100,97,1,3,"PODEMOS-IU-",3
34,"34104",233,190,189,1,1,"PODEMOS-IU-",5
10,"10058",993,739,723,4,16,"PODEMOS-IU-",60
37,"37029",193,139,133,1,6,"PODEMOS-IU-",3
44,"44196",125,96,95,2,1,"PODEMOS-IU-",6
28,"28010",10538,8708,8635,54,73,"PODEMOS-IU-",1351
9,"9094",51,46,45,0,1,"PODEMOS-IU-",6
44,"44122",1284,995,984,15,11,"PODEMOS-IU-",90
45,"45141",849,677,665,4,12,"PODEMOS-IU-",57
19,"19003",29,28,28,2,0,"PODEMOS-IU-",4
9,"9149",34,27,27,0,0,"PODEMOS-IU-",1
42,"42135",70,46,45,0,1,"PODEMOS-IU-",5
24,"24175",1831,1433,1412,17,21,"PODEMOS-IU-",177
50,"50205",74,58,57,0,1,"PODEMOS-IU-",7
30,"30014",1585,1226,1202,3,24,"PODEMOS-IU-",109
39,"39055",1075,836,829,8,7,"PODEMOS-IU-",55
49,"49223",716,552,548,0,4,"PODEMOS-IU-",10
39,"39048",1765,1429,1420,4,9,"PODEMOS-IU-",161
47,"47133",2776,2317,2292,28,25,"PODEMOS-IU-",302
13,"13086",162,139,136,1,3,"PODEMOS-IU-",4
44,"44249",46,37,37,1,0,"PODEMOS-IU-",3
19,"19073",16,13,13,0,0,"PODEMOS-IU-",0
19,"19901",36,32,32,0,0,"PODEMOS-IU-",4
9,"9276",389,283,268,5,15,"PODEMOS-IU-",89
49,"49010",348,301,295,6,6,"PODEMOS-IU-",28
49,"49092",116,87,86,0,1,"PODEMOS-IU-",2
6,"6089",608,524,519,3,5,"PODEMOS-IU-",37
9,"9232",140,110,107,0,3,"PODEMOS-IU-",4
26,"26135",153,123,123,1,0,"PODEMOS-IU-",10
47,"47199",71,59,59,3,0,"PODEMOS-IU-",8
37,"37293",106,75,74,0,1,"PODEMOS-IU-",2
5,"5180",82,61,60,0,1,"PODEMOS-IU-",1
49,"49199",241,174,171,4,3,"PODEMOS-IU-",15
5,"5236",106,77,77,0,0,"PODEMOS-IU-",15
50,"50132",771,589,576,2,13,"PODEMOS-IU-",85
13,"13067",342,298,295,0,3,"PODEMOS-IU-",36
26,"26138",4545,3433,3374,27,59,"PODEMOS-IU-",357
47,"47144",75,63,63,1,0,"PODEMOS-IU-",3
37,"37196",72,56,53,0,3,"PODEMOS-IU-",1
10,"10053",279,226,224,5,2,"PODEMOS-IU-",6
34,"34155",120,104,103,0,1,"PODEMOS-IU-",5
37,"37002",126,81,81,0,0,"PODEMOS-IU-",1
2,"2086",2426,1738,1728,8,10,"PODEMOS-IU-",117
34,"34020",51,38,38,0,0,"PODEMOS-IU-",0
50,"50277",49,37,37,3,0,"PODEMOS-IU-",4
47,"47054",613,501,498,0,3,"PODEMOS-IU-",29
10,"10026",656,515,507,8,8,"PODEMOS-IU-",65
42,"42048",60,50,50,0,0,"PODEMOS-IU-",4
10,"10035",1806,1320,1282,12,38,"PODEMOS-IU-",203
19,"19060",157,128,125,0,3,"PODEMOS-IU-",41
49,"49095",279,221,217,0,4,"PODEMOS-IU-",18
45,"45157",2261,1627,1603,8,24,"PODEMOS-IU-",199
50,"50040",86,71,71,0,0,"PODEMOS-IU-",4
42,"42018",131,102,102,1,0,"PODEMOS-IU-",2
2,"2043",1173,975,962,1,13,"PODEMOS-IU-",40
50,"50182",3675,2846,2810,36,36,"PODEMOS-IU-",442
40,"40192",133,104,102,2,2,"PODEMOS-IU-",7
50,"50052",85,64,64,0,0,"PODEMOS-IU-",1
45,"45062",1074,888,867,4,21,"PODEMOS-IU-",31
44,"44008",1565,1158,1138,8,20,"PODEMOS-IU-",96
50,"50901",140,108,108,0,0,"PODEMOS-IU-",9
42,"42219",40,33,32,1,1,"PODEMOS-IU-",3
10,"10175",1361,1031,997,8,34,"PODEMOS-IU-",109
16,"16159",209,147,144,0,3,"PODEMOS-IU-",1
10,"10214",217,175,175,1,0,"PODEMOS-IU-",11
50,"50113",584,505,495,3,10,"PODEMOS-IU-",38
50,"50069",67,44,44,0,0,"PODEMOS-IU-",4
5,"5153",87,65,65,1,0,"PODEMOS-IU-",5
28,"28104",15318,12897,12797,87,100,"PODEMOS-IU-",1657
37,"37336",52,46,45,3,1,"PODEMOS-IU-",5
37,"37229",139,110,106,2,4,"PODEMOS-IU-",1
9,"9220",70,59,58,0,1,"PODEMOS-IU-",2
49,"49203",287,229,223,2,6,"PODEMOS-IU-",2
16,"16108",43,40,39,1,1,"PODEMOS-IU-",6
39,"39093",302,256,256,2,0,"PODEMOS-IU-",21
5,"5156",234,153,151,0,2,"PODEMOS-IU-",22
26,"26012",33,28,26,0,2,"PODEMOS-IU-",0
47,"47167",242,212,210,0,2,"PODEMOS-IU-",3
47,"47032",153,121,121,1,0,"PODEMOS-IU-",6
28,"28156",1084,885,880,6,5,"PODEMOS-IU-",126
34,"34170",51,35,35,0,0,"PODEMOS-IU-",1
30,"30007",6484,4774,4727,25,47,"PODEMOS-IU-",391
9,"9409",110,87,87,0,0,"PODEMOS-IU-",17
5,"5123",103,85,85,1,0,"PODEMOS-IU-",8
50,"50035",75,63,62,0,1,"PODEMOS-IU-",35
16,"16013",26,21,20,0,1,"PODEMOS-IU-",1
37,"37378",99,69,67,2,2,"PODEMOS-IU-",3
45,"45152",547,448,442,1,6,"PODEMOS-IU-",35
49,"49235",422,312,301,0,11,"PODEMOS-IU-",38
16,"16132",34,26,26,0,0,"PODEMOS-IU-",4
5,"5103",66,48,48,0,0,"PODEMOS-IU-",5
16,"16047",214,175,174,4,1,"PODEMOS-IU-",13
37,"37189",114,88,88,2,0,"PODEMOS-IU-",2
10,"10171",355,261,255,0,6,"PODEMOS-IU-",12
37,"37238",106,88,87,1,1,"PODEMOS-IU-",10
26,"26067",20,19,19,0,0,"PODEMOS-IU-",3
9,"9012",92,76,75,0,1,"PODEMOS-IU-",8
16,"16143",15,10,10,1,0,"PODEMOS-IU-",0
50,"50267",573,440,434,7,6,"PODEMOS-IU-",37
44,"44022",463,342,326,6,16,"PODEMOS-IU-",34
42,"42218",75,52,51,0,1,"PODEMOS-IU-",4
5,"5097",476,332,327,0,5,"PODEMOS-IU-",28
40,"40094",364,284,279,1,5,"PODEMOS-IU-",22
40,"40202",55,38,38,0,0,"PODEMOS-IU-",0
45,"45019",7545,5831,5740,52,91,"PODEMOS-IU-",841
6,"6124",1656,1323,1296,5,27,"PODEMOS-IU-",97
42,"42160",247,195,194,4,1,"PODEMOS-IU-",23
44,"44018",16,16,16,0,0,"PODEMOS-IU-",0
50,"50223",916,751,745,13,6,"PODEMOS-IU-",54
39,"39010",610,518,512,1,6,"PODEMOS-IU-",49
44,"44088",23,21,21,0,0,"PODEMOS-IU-",0
49,"49256",242,204,202,4,2,"PODEMOS-IU-",8
42,"42032",142,120,120,0,0,"PODEMOS-IU-",6
6,"6121",3268,2558,2531,26,27,"PODEMOS-IU-",205
42,"42012",29,23,23,0,0,"PODEMOS-IU-",1
9,"9010",32,27,27,1,0,"PODEMOS-IU-",0
44,"44100",175,142,141,2,1,"PODEMOS-IU-",28
45,"45009",464,303,301,2,2,"PODEMOS-IU-",22
34,"34230",17,13,13,0,0,"PODEMOS-IU-",1
37,"37128",242,187,184,1,3,"PODEMOS-IU-",18
19,"19021",976,744,724,5,20,"PODEMOS-IU-",43
26,"26086",15,15,15,0,0,"PODEMOS-IU-",0
28,"28028",1820,1493,1483,8,10,"PODEMOS-IU-",459
49,"49230",82,67,66,0,1,"PODEMOS-IU-",0
10,"10164",720,474,461,3,13,"PODEMOS-IU-",48
19,"19279",51,44,44,0,0,"PODEMOS-IU-",1
44,"44053",105,81,81,0,0,"PODEMOS-IU-",0
5,"5152",655,537,534,3,3,"PODEMOS-IU-",8
39,"39059",7577,5978,5916,47,62,"PODEMOS-IU-",550
16,"16903",996,816,806,9,10,"PODEMOS-IU-",26
19,"19165",41,36,36,0,0,"PODEMOS-IU-",8
24,"24089",101353,78253,77375,776,878,"PODEMOS-IU-",8486
45,"45055",998,844,828,4,16,"PODEMOS-IU-",50
10,"10189",2527,1958,1907,12,51,"PODEMOS-IU-",193
50,"50121",277,220,218,2,2,"PODEMOS-IU-",17
5,"5096",79,62,62,1,0,"PODEMOS-IU-",6
28,"28079",2374366,1872679,1859094,11998,13585,"PODEMOS-IU-",306581
39,"39083",1074,786,777,4,9,"PODEMOS-IU-",59
5,"5029",99,69,69,0,0,"PODEMOS-IU-",0
49,"49030",80,66,62,0,4,"PODEMOS-IU-",1
45,"45146",101,86,85,0,1,"PODEMOS-IU-",8
26,"26040",63,51,50,0,1,"PODEMOS-IU-",2
28,"28025",404,314,305,3,9,"PODEMOS-IU-",28
50,"50199",325,238,232,3,6,"PODEMOS-IU-",19
9,"9400",310,250,247,4,3,"PODEMOS-IU-",34
34,"34113",40,37,37,0,0,"PODEMOS-IU-",2
44,"44160",440,311,306,2,5,"PODEMOS-IU-",32
34,"34114",198,152,152,0,0,"PODEMOS-IU-",3
9,"9339",126,105,105,1,0,"PODEMOS-IU-",14
50,"50215",20,18,18,0,0,"PODEMOS-IU-",9
5,"5035",96,78,78,0,0,"PODEMOS-IU-",9
16,"16009",54,49,49,0,0,"PODEMOS-IU-",4
28,"28048",504,399,392,6,7,"PODEMOS-IU-",89
5,"5254",181,155,153,0,2,"PODEMOS-IU-",11
9,"9124",1432,1078,1054,7,24,"PODEMOS-IU-",85
44,"44070",55,45,45,0,0,"PODEMOS-IU-",1
19,"19265",135,107,107,1,0,"PODEMOS-IU-",11
34,"34901",1071,854,847,4,7,"PODEMOS-IU-",55
19,"19178",30,15,15,0,0,"PODEMOS-IU-",5
24,"24062",130,90,90,2,0,"PODEMOS-IU-",16
13,"13049",747,566,553,4,13,"PODEMOS-IU-",33
26,"26022",187,153,148,0,5,"PODEMOS-IU-",10
9,"9418",73,58,55,2,3,"PODEMOS-IU-",1
44,"44103",123,101,100,1,1,"PODEMOS-IU-",6
9,"9184",7,5,5,0,0,"PODEMOS-IU-",2
10,"10066",161,141,137,0,4,"PODEMOS-IU-",8
47,"47174",270,215,208,2,7,"PODEMOS-IU-",23
37,"37312",244,198,197,1,1,"PODEMOS-IU-",5
34,"34122",86,68,66,0,2,"PODEMOS-IU-",4
42,"42089",57,48,48,1,0,"PODEMOS-IU-",1
24,"24102",608,457,448,3,9,"PODEMOS-IU-",36
22,"22204",1119,836,832,9,4,"PODEMOS-IU-",115
22,"22229",108,80,80,2,0,"PODEMOS-IU-",12
22,"22078",438,326,323,3,3,"PODEMOS-IU-",75
22,"22083",445,379,372,5,7,"PODEMOS-IU-",24
22,"22126",87,66,66,0,0,"PODEMOS-IU-",2
22,"22015",300,232,226,5,6,"PODEMOS-IU-",32
22,"22096",320,274,272,2,2,"PODEMOS-IU-",31
22,"22068",65,46,44,1,2,"PODEMOS-IU-",5
22,"22075",119,87,87,1,0,"PODEMOS-IU-",10
22,"22012",102,81,80,1,1,"PODEMOS-IU-",7
22,"22039",805,667,662,5,5,"PODEMOS-IU-",111
22,"22020",119,91,87,1,4,"PODEMOS-IU-",9
22,"22214",118,98,97,1,1,"PODEMOS-IU-",15
22,"22168",23,21,20,0,1,"PODEMOS-IU-",1
22,"22074",275,223,221,10,2,"PODEMOS-IU-",41
22,"22252",118,100,99,0,1,"PODEMOS-IU-",10
22,"22011",97,78,75,2,3,"PODEMOS-IU-",11
22,"22107",100,68,67,0,1,"PODEMOS-IU-",8
22,"22042",117,96,95,1,1,"PODEMOS-IU-",11
22,"22905",287,226,224,2,2,"PODEMOS-IU-",12
22,"22025",1035,764,755,24,9,"PODEMOS-IU-",99
22,"22244",46,37,37,2,0,"PODEMOS-IU-",5
22,"22128",192,155,154,2,1,"PODEMOS-IU-",14
22,"22197",439,356,353,10,3,"PODEMOS-IU-",29
22,"22221",90,58,56,0,2,"PODEMOS-IU-",21
22,"22215",128,91,91,1,0,"PODEMOS-IU-",9
22,"22080",264,208,202,2,6,"PODEMOS-IU-",16
22,"22222",517,407,398,5,9,"PODEMOS-IU-",57
22,"22088",143,111,111,1,0,"PODEMOS-IU-",19
22,"22207",121,78,78,1,0,"PODEMOS-IU-",14
22,"22160",212,171,170,3,1,"PODEMOS-IU-",40
22,"22060",1172,906,901,13,5,"PODEMOS-IU-",116
22,"22106",20,15,15,0,0,"PODEMOS-IU-",3
22,"22200",239,181,178,0,3,"PODEMOS-IU-",32
22,"22066",748,576,567,6,9,"PODEMOS-IU-",155
22,"22017",822,664,660,5,4,"PODEMOS-IU-",46
22,"22206",182,145,145,0,0,"PODEMOS-IU-",19
22,"22254",1094,857,850,11,7,"PODEMOS-IU-",84
22,"22226",771,598,591,6,7,"PODEMOS-IU-",55
22,"22908",188,133,131,0,2,"PODEMOS-IU-",18
22,"22172",520,412,407,3,5,"PODEMOS-IU-",21
22,"22095",65,57,56,1,1,"PODEMOS-IU-",13
22,"22250",344,271,264,6,7,"PODEMOS-IU-",51
22,"22170",668,529,520,4,9,"PODEMOS-IU-",120
22,"22114",124,86,82,1,4,"PODEMOS-IU-",4
22,"22230",288,229,228,3,1,"PODEMOS-IU-",37
22,"22236",236,207,203,2,4,"PODEMOS-IU-",18
22,"22055",310,258,255,2,3,"PODEMOS-IU-",16
22,"22225",2610,1867,1843,15,24,"PODEMOS-IU-",262
22,"22201",266,192,192,2,0,"PODEMOS-IU-",30
22,"22067",71,52,52,0,0,"PODEMOS-IU-",16
22,"22077",362,301,293,3,8,"PODEMOS-IU-",20
22,"22105",101,82,82,4,0,"PODEMOS-IU-",13
22,"22063",159,133,132,2,1,"PODEMOS-IU-",24
22,"22176",170,136,135,0,1,"PODEMOS-IU-",14
22,"22008",155,127,125,0,2,"PODEMOS-IU-",11
22,"22029",119,103,103,0,0,"PODEMOS-IU-",9
22,"22124",182,148,148,1,0,"PODEMOS-IU-",20
22,"22110",707,531,528,2,3,"PODEMOS-IU-",82
22,"22024",222,179,177,1,2,"PODEMOS-IU-",39
22,"22079",114,89,88,1,1,"PODEMOS-IU-",10
22,"22208",194,159,156,1,3,"PODEMOS-IU-",39
22,"22040",144,124,120,1,4,"PODEMOS-IU-",23
22,"22195",234,193,192,0,1,"PODEMOS-IU-",24
22,"22049",74,63,63,0,0,"PODEMOS-IU-",2
22,"22234",745,587,578,11,9,"PODEMOS-IU-",64
22,"22227",199,155,154,1,1,"PODEMOS-IU-",21
22,"22087",58,47,47,0,0,"PODEMOS-IU-",1
22,"22193",269,220,217,2,3,"PODEMOS-IU-",23
22,"22149",308,247,246,3,1,"PODEMOS-IU-",38
22,"22103",676,520,517,6,3,"PODEMOS-IU-",46
22,"22245",306,266,263,0,3,"PODEMOS-IU-",23
22,"22045",73,57,56,0,1,"PODEMOS-IU-",16
22,"22084",555,438,433,5,5,"PODEMOS-IU-",95
22,"22111",146,115,115,1,0,"PODEMOS-IU-",7
22,"22906",174,137,134,5,3,"PODEMOS-IU-",17
22,"22136",749,579,576,5,3,"PODEMOS-IU-",65
22,"22119",1256,963,954,5,9,"PODEMOS-IU-",113
22,"22141",114,86,85,0,1,"PODEMOS-IU-",13
22,"22904",761,581,566,2,15,"PODEMOS-IU-",52
22,"22021",1884,1465,1450,13,15,"PODEMOS-IU-",161
22,"22239",88,71,71,0,0,"PODEMOS-IU-",4
22,"22164",43,33,31,0,2,"PODEMOS-IU-",2
22,"22094",98,72,71,2,1,"PODEMOS-IU-",11
22,"22016",566,423,420,4,3,"PODEMOS-IU-",61
22,"22050",93,79,79,2,0,"PODEMOS-IU-",8
22,"22057",364,286,284,3,2,"PODEMOS-IU-",46
22,"22184",168,142,139,2,3,"PODEMOS-IU-",9
22,"22113",470,369,369,2,0,"PODEMOS-IU-",48
22,"22046",714,592,587,13,5,"PODEMOS-IU-",50
22,"22246",71,50,50,0,0,"PODEMOS-IU-",9
22,"22117",2414,1798,1784,18,14,"PODEMOS-IU-",261
22,"22173",218,162,160,1,2,"PODEMOS-IU-",37
22,"22203",76,61,61,0,0,"PODEMOS-IU-",2
22,"22116",1369,1025,1003,8,22,"PODEMOS-IU-",82
22,"22177",97,81,81,1,0,"PODEMOS-IU-",9
22,"22131",83,65,65,0,0,"PODEMOS-IU-",5
22,"22061",6583,5027,4973,51,54,"PODEMOS-IU-",688
22,"22188",76,60,59,1,1,"PODEMOS-IU-",18
22,"22037",112,96,96,0,0,"PODEMOS-IU-",32
22,"22004",124,90,88,1,2,"PODEMOS-IU-",12
22,"22125",39429,29988,29612,337,376,"PODEMOS-IU-",4133
22,"22163",419,363,361,1,2,"PODEMOS-IU-",44
22,"22003",132,114,114,0,0,"PODEMOS-IU-",20
22,"22109",266,207,205,3,2,"PODEMOS-IU-",24
22,"22187",294,244,243,2,1,"PODEMOS-IU-",58
22,"22139",78,60,60,0,0,"PODEMOS-IU-",11
22,"22001",214,162,162,0,0,"PODEMOS-IU-",16
22,"22085",96,82,81,0,1,"PODEMOS-IU-",9
22,"22249",118,93,93,2,0,"PODEMOS-IU-",25
22,"22052",885,708,702,6,6,"PODEMOS-IU-",69
22,"22213",2923,2261,2221,24,40,"PODEMOS-IU-",241
22,"22251",334,269,263,4,6,"PODEMOS-IU-",12
22,"22019",175,151,151,0,0,"PODEMOS-IU-",19
22,"22099",465,365,362,3,3,"PODEMOS-IU-",39
22,"22081",243,187,186,0,1,"PODEMOS-IU-",11
22,"22027",306,230,225,3,5,"PODEMOS-IU-",28
22,"22090",85,66,66,1,0,"PODEMOS-IU-",14
22,"22076",288,228,226,1,2,"PODEMOS-IU-",22
22,"22133",108,85,83,1,2,"PODEMOS-IU-",14
22,"22248",104,83,82,0,1,"PODEMOS-IU-",12
22,"22036",88,76,75,0,1,"PODEMOS-IU-",8
22,"22122",65,58,58,3,0,"PODEMOS-IU-",11
22,"22157",183,136,134,1,2,"PODEMOS-IU-",26
22,"22182",233,178,174,1,4,"PODEMOS-IU-",31
22,"22903",622,538,533,3,5,"PODEMOS-IU-",60
22,"22907",1444,1149,1137,12,12,"PODEMOS-IU-",208
22,"22064",162,121,121,0,0,"PODEMOS-IU-",16
22,"22009",585,439,435,4,4,"PODEMOS-IU-",90
22,"22151",88,66,65,0,1,"PODEMOS-IU-",10
22,"22069",418,337,334,5,3,"PODEMOS-IU-",50
22,"22190",122,89,89,0,0,"PODEMOS-IU-",17
22,"22235",88,72,72,1,0,"PODEMOS-IU-",2
22,"22909",301,233,231,4,2,"PODEMOS-IU-",31
22,"22228",529,421,417,3,4,"PODEMOS-IU-",52
22,"22175",184,139,137,1,2,"PODEMOS-IU-",20
22,"22243",39,28,28,0,0,"PODEMOS-IU-",2
22,"22082",285,230,226,2,4,"PODEMOS-IU-",16
22,"22156",296,246,242,3,4,"PODEMOS-IU-",29
22,"22155",65,54,54,0,0,"PODEMOS-IU-",5
22,"22044",234,184,183,3,1,"PODEMOS-IU-",32
22,"22199",6926,5113,5051,44,62,"PODEMOS-IU-",843
22,"22051",91,78,78,1,0,"PODEMOS-IU-",10
22,"22032",107,74,74,2,0,"PODEMOS-IU-",12
22,"22165",452,360,356,1,4,"PODEMOS-IU-",25
22,"22135",174,132,132,5,0,"PODEMOS-IU-",19
22,"22054",1617,1196,1183,15,13,"PODEMOS-IU-",270
22,"22006",272,206,201,2,5,"PODEMOS-IU-",46
22,"22053",786,573,567,3,6,"PODEMOS-IU-",91
22,"22047",241,213,212,2,1,"PODEMOS-IU-",24
22,"22209",159,139,136,5,3,"PODEMOS-IU-",25
22,"22220",150,120,117,0,3,"PODEMOS-IU-",13
22,"22058",191,157,157,3,0,"PODEMOS-IU-",33
22,"22142",94,80,80,2,0,"PODEMOS-IU-",13
22,"22022",543,441,433,4,8,"PODEMOS-IU-",63
22,"22212",70,56,56,0,0,"PODEMOS-IU-",6
22,"22901",714,521,508,3,13,"PODEMOS-IU-",111
22,"22143",197,134,132,1,2,"PODEMOS-IU-",18
22,"22062",154,115,115,1,0,"PODEMOS-IU-",14
22,"22112",9516,7043,6956,84,87,"PODEMOS-IU-",918
22,"22018",308,234,232,2,2,"PODEMOS-IU-",23
22,"22041",152,121,119,2,2,"PODEMOS-IU-",10
22,"22144",257,207,204,1,3,"PODEMOS-IU-",27
22,"22086",209,157,155,1,2,"PODEMOS-IU-",22
22,"22162",129,99,99,0,0,"PODEMOS-IU-",5
22,"22202",145,127,126,0,1,"PODEMOS-IU-",21
22,"22181",88,60,59,1,1,"PODEMOS-IU-",9
22,"22137",1015,741,733,9,8,"PODEMOS-IU-",69
22,"22028",362,284,282,5,2,"PODEMOS-IU-",51
22,"22186",191,165,164,2,1,"PODEMOS-IU-",19
22,"22002",106,95,94,0,1,"PODEMOS-IU-",6
22,"22902",208,160,156,0,4,"PODEMOS-IU-",21
22,"22218",40,32,31,1,1,"PODEMOS-IU-",0
22,"22130",10128,7355,7294,61,61,"PODEMOS-IU-",1133
22,"22059",1139,867,855,10,12,"PODEMOS-IU-",164
22,"22102",181,153,151,1,2,"PODEMOS-IU-",19
22,"22048",12593,9614,9528,82,86,"PODEMOS-IU-",1066
22,"22253",57,48,47,0,1,"PODEMOS-IU-",3
22,"22072",194,141,140,0,1,"PODEMOS-IU-",32
22,"22127",529,434,432,4,2,"PODEMOS-IU-",53
22,"22158",11951,8877,8801,69,76,"PODEMOS-IU-",1233
22,"22167",473,392,384,4,8,"PODEMOS-IU-",41
22,"22115",347,262,261,1,1,"PODEMOS-IU-",41
22,"22035",226,174,174,0,0,"PODEMOS-IU-",29
22,"22217",372,296,290,5,6,"PODEMOS-IU-",19
22,"22223",74,63,63,1,0,"PODEMOS-IU-",21
22,"22189",178,143,143,0,0,"PODEMOS-IU-",17
22,"22205",459,347,345,1,2,"PODEMOS-IU-",46
22,"22023",389,313,305,6,8,"PODEMOS-IU-",12
22,"22174",462,381,377,0,4,"PODEMOS-IU-",29
22,"22247",30,21,21,0,0,"PODEMOS-IU-",3
22,"22013",275,218,217,6,1,"PODEMOS-IU-",18
22,"22129",163,117,116,0,1,"PODEMOS-IU-",7
22,"22150",461,368,362,1,6,"PODEMOS-IU-",53
22,"22232",87,66,65,2,1,"PODEMOS-IU-",4
22,"22014",233,185,182,3,3,"PODEMOS-IU-",17
22,"22007",756,576,571,5,5,"PODEMOS-IU-",54
22,"22242",63,47,45,1,2,"PODEMOS-IU-",3
22,"22233",80,50,50,0,0,"PODEMOS-IU-",2
22,"22089",276,216,216,2,0,"PODEMOS-IU-",35
22,"22178",103,84,84,2,0,"PODEMOS-IU-",4
22,"22043",93,68,67,1,1,"PODEMOS-IU-",10
31,"31096",101,85,84,3,1,"PODEMOS-IU-",7
31,"31216",3871,2861,2832,32,29,"PODEMOS-IU-",658
31,"31234",149,115,114,0,1,"PODEMOS-IU-",17
31,"31061",48,46,46,0,0,"PODEMOS-IU-",3
31,"31094",105,78,76,0,2,"PODEMOS-IU-",9
31,"31162",48,34,33,1,1,"PODEMOS-IU-",2
31,"31049",679,512,505,2,7,"PODEMOS-IU-",53
31,"31001",80,63,63,0,0,"PODEMOS-IU-",15
31,"31139",155,105,105,0,0,"PODEMOS-IU-",25
31,"31131",907,719,712,8,7,"PODEMOS-IU-",114
31,"31907",11205,9216,9140,121,76,"PODEMOS-IU-",2111
31,"31164",545,438,433,6,5,"PODEMOS-IU-",47
31,"31081",334,259,256,7,3,"PODEMOS-IU-",28
31,"31085",502,401,399,5,2,"PODEMOS-IU-",111
31,"31035",50,34,32,0,2,"PODEMOS-IU-",3
31,"31245",77,60,59,4,1,"PODEMOS-IU-",4
31,"31022",483,349,345,3,4,"PODEMOS-IU-",42
31,"31077",5407,4148,4081,39,67,"PODEMOS-IU-",506
31,"31102",136,75,75,2,0,"PODEMOS-IU-",7
31,"31169",2205,1597,1568,17,29,"PODEMOS-IU-",168
31,"31210",186,156,156,1,0,"PODEMOS-IU-",12
31,"31062",1075,870,861,10,9,"PODEMOS-IU-",117
31,"31109",1664,1290,1283,10,7,"PODEMOS-IU-",272
31,"31015",1990,1533,1508,17,25,"PODEMOS-IU-",247
31,"31211",17,13,13,1,0,"PODEMOS-IU-",1
31,"31167",831,651,636,3,15,"PODEMOS-IU-",116
31,"31257",903,690,679,6,11,"PODEMOS-IU-",162
31,"31179",483,348,344,2,4,"PODEMOS-IU-",45
31,"31076",2520,2110,2094,21,16,"PODEMOS-IU-",221
31,"31116",58,45,43,2,2,"PODEMOS-IU-",2
31,"31208",2562,2067,2036,16,31,"PODEMOS-IU-",364
31,"31008",63,51,49,1,2,"PODEMOS-IU-",8
31,"31163",2002,1507,1475,14,32,"PODEMOS-IU-",199
31,"31086",13640,11040,10966,116,74,"PODEMOS-IU-",2545
31,"31901",15510,12225,12133,114,92,"PODEMOS-IU-",2591
31,"31120",383,264,260,3,4,"PODEMOS-IU-",51
31,"31226",574,380,377,3,3,"PODEMOS-IU-",46
31,"31082",623,433,433,3,0,"PODEMOS-IU-",72
31,"31158",248,182,177,2,5,"PODEMOS-IU-",40
31,"31150",199,140,139,2,1,"PODEMOS-IU-",43
31,"31113",127,84,83,1,1,"PODEMOS-IU-",13
31,"31228",494,383,382,0,1,"PODEMOS-IU-",79
31,"31177",251,172,168,1,4,"PODEMOS-IU-",48
31,"31095",72,61,60,0,1,"PODEMOS-IU-",8
31,"31067",1896,1418,1397,17,21,"PODEMOS-IU-",212
31,"31041",1659,1245,1228,23,17,"PODEMOS-IU-",266
31,"31144",763,504,503,1,1,"PODEMOS-IU-",63
31,"31212",129,102,102,6,0,"PODEMOS-IU-",13
31,"31014",266,195,195,4,0,"PODEMOS-IU-",32
31,"31252",83,57,57,0,0,"PODEMOS-IU-",11
31,"31224",875,684,677,10,7,"PODEMOS-IU-",92
31,"31048",160,133,132,2,1,"PODEMOS-IU-",7
31,"31101",1412,1097,1087,11,10,"PODEMOS-IU-",245
31,"31137",198,106,103,3,3,"PODEMOS-IU-",16
31,"31256",96,64,64,0,0,"PODEMOS-IU-",8
31,"31250",2748,1995,1982,21,13,"PODEMOS-IU-",424
31,"31191",3018,2365,2337,22,28,"PODEMOS-IU-",487
31,"31051",234,183,182,2,1,"PODEMOS-IU-",30
31,"31253",119,106,105,0,1,"PODEMOS-IU-",22
31,"31168",241,203,199,2,4,"PODEMOS-IU-",23
31,"31009",672,510,503,4,7,"PODEMOS-IU-",108
31,"31129",384,260,259,0,1,"PODEMOS-IU-",17
31,"31157",3470,2507,2473,32,34,"PODEMOS-IU-",413
31,"31197",65,56,56,0,0,"PODEMOS-IU-",13
31,"31013",626,427,422,5,5,"PODEMOS-IU-",109
31,"31031",220,158,157,1,1,"PODEMOS-IU-",12
31,"31180",197,155,154,2,1,"PODEMOS-IU-",35
31,"31080",490,393,390,2,3,"PODEMOS-IU-",104
31,"31238",115,101,100,2,1,"PODEMOS-IU-",25
31,"31047",236,181,179,5,2,"PODEMOS-IU-",20
31,"31239",281,215,212,7,3,"PODEMOS-IU-",14
31,"31217",334,233,225,3,8,"PODEMOS-IU-",46
31,"31184",65,48,46,0,2,"PODEMOS-IU-",5
31,"31104",1751,1306,1280,1,26,"PODEMOS-IU-",271
31,"31171",669,516,502,3,14,"PODEMOS-IU-",122
31,"31046",53,39,39,0,0,"PODEMOS-IU-",4
31,"31902",4649,3620,3598,34,22,"PODEMOS-IU-",783
31,"31072",5320,4046,3958,40,88,"PODEMOS-IU-",450
31,"31203",30,22,22,1,0,"PODEMOS-IU-",1
31,"31037",90,72,72,0,0,"PODEMOS-IU-",12
31,"31055",263,199,197,3,2,"PODEMOS-IU-",30
31,"31020",433,273,272,1,1,"PODEMOS-IU-",24
31,"31006",1877,1453,1436,16,17,"PODEMOS-IU-",221
31,"31005",281,202,201,5,1,"PODEMOS-IU-",29
31,"31198",37,32,32,0,0,"PODEMOS-IU-",6
31,"31136",452,337,333,5,4,"PODEMOS-IU-",90
31,"31262",234,201,199,2,2,"PODEMOS-IU-",56
31,"31259",476,347,346,0,1,"PODEMOS-IU-",44
31,"31007",126,101,95,3,6,"PODEMOS-IU-",15
31,"31214",87,66,64,0,2,"PODEMOS-IU-",8
31,"31016",7752,6114,6064,47,50,"PODEMOS-IU-",1669
31,"31002",433,324,324,4,0,"PODEMOS-IU-",80
31,"31219",81,60,59,1,1,"PODEMOS-IU-",11
31,"31237",186,151,149,1,2,"PODEMOS-IU-",25
31,"31012",771,571,564,5,7,"PODEMOS-IU-",109
31,"31057",1741,1365,1344,12,21,"PODEMOS-IU-",161
31,"31024",99,54,54,1,0,"PODEMOS-IU-",5
31,"31213",100,69,68,0,1,"PODEMOS-IU-",6
31,"31036",895,665,659,8,6,"PODEMOS-IU-",114
31,"31249",1823,1381,1373,21,8,"PODEMOS-IU-",160
31,"31221",1235,944,938,11,6,"PODEMOS-IU-",132
31,"31089",228,187,184,0,3,"PODEMOS-IU-",32
31,"31071",15,13,13,0,0,"PODEMOS-IU-",2
31,"31121",65,51,51,0,0,"PODEMOS-IU-",12
31,"31225",35,29,29,1,0,"PODEMOS-IU-",4
31,"31073",296,218,217,3,1,"PODEMOS-IU-",25
31,"31248",270,158,154,6,4,"PODEMOS-IU-",17
31,"31058",202,163,160,2,3,"PODEMOS-IU-",20
31,"31231",108,73,70,1,3,"PODEMOS-IU-",6
31,"31241",125,100,100,2,0,"PODEMOS-IU-",21
31,"31223",959,718,711,8,7,"PODEMOS-IU-",103
31,"31246",128,105,101,3,4,"PODEMOS-IU-",11
31,"31243",302,241,237,5,4,"PODEMOS-IU-",44
31,"31054",454,322,318,4,4,"PODEMOS-IU-",46
31,"31140",115,83,83,2,0,"PODEMOS-IU-",11
31,"31050",6002,4111,4061,58,50,"PODEMOS-IU-",512
31,"31176",2930,2204,2134,33,70,"PODEMOS-IU-",309
31,"31153",2173,1591,1580,10,11,"PODEMOS-IU-",269
31,"31255",103,87,84,0,3,"PODEMOS-IU-",17
31,"31156",239,191,191,1,0,"PODEMOS-IU-",42
31,"31010",5728,4211,4153,30,58,"PODEMOS-IU-",888
31,"31034",31,27,26,0,1,"PODEMOS-IU-",8
31,"31038",1336,992,981,8,11,"PODEMOS-IU-",102
31,"31220",742,620,615,2,5,"PODEMOS-IU-",75
31,"31166",250,184,184,2,0,"PODEMOS-IU-",24
31,"31145",161,131,129,1,2,"PODEMOS-IU-",14
31,"31053",503,375,370,4,5,"PODEMOS-IU-",63
31,"31088",5675,4331,4285,59,46,"PODEMOS-IU-",895
31,"31052",103,79,78,0,1,"PODEMOS-IU-",25
31,"31056",185,141,134,3,7,"PODEMOS-IU-",31
31,"31242",264,194,194,2,0,"PODEMOS-IU-",41
31,"31032",1678,1285,1269,25,16,"PODEMOS-IU-",210
31,"31178",472,354,348,3,6,"PODEMOS-IU-",49
31,"31205",420,312,310,7,2,"PODEMOS-IU-",39
31,"31182",30,28,28,1,0,"PODEMOS-IU-",2
31,"31093",275,212,206,0,6,"PODEMOS-IU-",31
31,"31264",177,107,105,2,2,"PODEMOS-IU-",15
31,"31042",2695,2071,2043,21,28,"PODEMOS-IU-",179
31,"31186",288,220,216,1,4,"PODEMOS-IU-",44
31,"31063",83,63,60,2,3,"PODEMOS-IU-",2
31,"31098",1962,1562,1544,14,18,"PODEMOS-IU-",302
31,"31107",1680,1330,1312,16,18,"PODEMOS-IU-",108
31,"31075",118,96,95,2,1,"PODEMOS-IU-",29
31,"31265",78,52,47,1,5,"PODEMOS-IU-",14
31,"31092",685,514,511,6,3,"PODEMOS-IU-",81
31,"31185",470,335,332,6,3,"PODEMOS-IU-",35
31,"31138",954,699,698,8,1,"PODEMOS-IU-",100
31,"31159",1105,880,871,3,9,"PODEMOS-IU-",183
31,"31190",45,41,41,4,0,"PODEMOS-IU-",3
31,"31029",916,661,647,7,14,"PODEMOS-IU-",111
31,"31097",10521,7602,7550,76,52,"PODEMOS-IU-",1357
31,"31261",237,174,173,3,1,"PODEMOS-IU-",28
31,"31017",370,288,286,3,2,"PODEMOS-IU-",55
31,"31122",4946,3915,3882,59,33,"PODEMOS-IU-",822
31,"31254",1920,1457,1435,8,22,"PODEMOS-IU-",203
31,"31244",156,95,94,5,1,"PODEMOS-IU-",6
31,"31154",211,125,124,2,1,"PODEMOS-IU-",31
31,"31130",322,237,235,7,2,"PODEMOS-IU-",47
31,"31070",2628,1930,1881,16,49,"PODEMOS-IU-",381
31,"31115",160,116,116,3,0,"PODEMOS-IU-",29
31,"31200",748,555,546,5,9,"PODEMOS-IU-",89
31,"31260",1249,904,901,15,3,"PODEMOS-IU-",147
31,"31155",241,181,180,3,1,"PODEMOS-IU-",24
31,"31011",709,515,511,4,4,"PODEMOS-IU-",112
31,"31028",220,147,147,0,0,"PODEMOS-IU-",23
31,"31108",1829,1460,1437,16,23,"PODEMOS-IU-",150
31,"31151",57,42,42,1,0,"PODEMOS-IU-",6
31,"31110",84,72,72,3,0,"PODEMOS-IU-",11
31,"31146",29,25,25,1,0,"PODEMOS-IU-",1
31,"31133",35,28,28,0,0,"PODEMOS-IU-",1
31,"31090",141,86,86,0,0,"PODEMOS-IU-",10
31,"31117",589,420,419,5,1,"PODEMOS-IU-",33
31,"31079",67,60,60,0,0,"PODEMOS-IU-",9
31,"31087",181,136,135,6,1,"PODEMOS-IU-",22
31,"31251",3152,2437,2402,12,35,"PODEMOS-IU-",424
31,"31187",101,68,68,1,0,"PODEMOS-IU-",12
31,"31174",107,70,70,0,0,"PODEMOS-IU-",10
31,"31114",374,291,286,4,5,"PODEMOS-IU-",81
31,"31033",46,29,28,0,1,"PODEMOS-IU-",4
31,"31188",296,200,197,0,3,"PODEMOS-IU-",30
31,"31134",175,130,128,1,2,"PODEMOS-IU-",13
31,"31170",45,37,36,2,1,"PODEMOS-IU-",6
31,"31044",294,243,242,5,1,"PODEMOS-IU-",25
31,"31123",617,392,388,3,4,"PODEMOS-IU-",63
31,"31060",14185,10582,10485,103,97,"PODEMOS-IU-",2510
31,"31103",39,27,27,0,0,"PODEMOS-IU-",3
31,"31069",830,639,638,3,1,"PODEMOS-IU-",115
31,"31105",1478,1203,1189,21,14,"PODEMOS-IU-",78
31,"31181",134,94,93,1,1,"PODEMOS-IU-",9
31,"31193",1438,1129,1123,13,6,"PODEMOS-IU-",269
31,"31904",1561,1139,1130,7,9,"PODEMOS-IU-",249
31,"31125",274,211,207,7,4,"PODEMOS-IU-",45
31,"31906",2683,2040,2023,28,17,"PODEMOS-IU-",527
31,"31059",183,145,143,0,2,"PODEMOS-IU-",20
31,"31258",7879,6189,6140,57,49,"PODEMOS-IU-",1400
31,"31023",7609,6371,6319,70,52,"PODEMOS-IU-",1333
31,"31143",93,58,52,0,6,"PODEMOS-IU-",7
31,"31084",1948,1483,1472,9,11,"PODEMOS-IU-",186
31,"31078",2419,1924,1899,18,25,"PODEMOS-IU-",332
31,"31039",92,72,70,1,2,"PODEMOS-IU-",12
31,"31074",390,310,307,5,3,"PODEMOS-IU-",66
31,"31083",50,41,41,1,0,"PODEMOS-IU-",8
31,"31091",327,224,224,1,0,"PODEMOS-IU-",27
31,"31141",107,76,74,0,2,"PODEMOS-IU-",10
31,"31018",422,317,312,4,5,"PODEMOS-IU-",72
31,"31128",341,255,250,3,5,"PODEMOS-IU-",59
31,"31173",846,686,674,5,12,"PODEMOS-IU-",51
31,"31196",31,28,28,0,0,"PODEMOS-IU-",6
31,"31232",25574,19124,18913,236,211,"PODEMOS-IU-",3058
31,"31240",513,385,385,6,0,"PODEMOS-IU-",57
31,"31161",345,286,279,4,7,"PODEMOS-IU-",84
31,"31183",713,569,555,6,14,"PODEMOS-IU-",94
31,"31004",32,26,26,0,0,"PODEMOS-IU-",5
31,"31043",32,24,24,0,0,"PODEMOS-IU-",0
31,"31247",147,117,115,0,2,"PODEMOS-IU-",12
31,"31209",147,116,116,0,0,"PODEMOS-IU-",32
31,"31030",135,105,105,3,0,"PODEMOS-IU-",31
31,"31903",6862,4962,4915,31,47,"PODEMOS-IU-",1197
31,"31147",106,88,86,3,2,"PODEMOS-IU-",21
31,"31124",207,151,150,2,1,"PODEMOS-IU-",24
31,"31165",2763,2121,2091,21,30,"PODEMOS-IU-",372
31,"31905",2968,2253,2236,21,17,"PODEMOS-IU-",531
31,"31142",1390,994,982,8,12,"PODEMOS-IU-",128
31,"31148",92,67,65,4,2,"PODEMOS-IU-",16
31,"31003",117,97,97,1,0,"PODEMOS-IU-",12
31,"31099",49,43,43,0,0,"PODEMOS-IU-",3
31,"31235",157,121,118,0,3,"PODEMOS-IU-",19
31,"31126",351,255,254,2,1,"PODEMOS-IU-",47
31,"31064",1387,1174,1163,9,11,"PODEMOS-IU-",137
31,"31127",135,96,96,0,0,"PODEMOS-IU-",9
31,"31215",4669,3580,3508,35,72,"PODEMOS-IU-",454
31,"31152",1270,937,929,19,8,"PODEMOS-IU-",162
31,"31207",285,209,206,1,3,"PODEMOS-IU-",36
31,"31202",4345,3132,3085,36,47,"PODEMOS-IU-",588
31,"31230",95,79,79,0,0,"PODEMOS-IU-",10
31,"31132",148,121,121,2,0,"PODEMOS-IU-",13
31,"31021",60,47,47,3,0,"PODEMOS-IU-",7
31,"31189",1127,781,775,10,6,"PODEMOS-IU-",137
31,"31229",38,36,36,2,0,"PODEMOS-IU-",8
31,"31119",36,26,25,0,1,"PODEMOS-IU-",8
31,"31204",36,27,27,1,0,"PODEMOS-IU-",2
31,"31172",365,287,275,4,12,"PODEMOS-IU-",62
31,"31192",157,133,130,1,3,"PODEMOS-IU-",42
31,"31149",2271,1645,1628,9,17,"PODEMOS-IU-",153
31,"31227",8111,6198,6129,69,69,"PODEMOS-IU-",1417
31,"31045",509,395,390,5,5,"PODEMOS-IU-",114
31,"31025",763,562,557,6,5,"PODEMOS-IU-",106
31,"31175",64,50,50,0,0,"PODEMOS-IU-",11
31,"31066",812,636,628,10,8,"PODEMOS-IU-",89
31,"31111",91,69,69,1,0,"PODEMOS-IU-",16
31,"31201",151084,115375,114510,1072,865,"PODEMOS-IU-",21391
31,"31068",2816,2194,2136,17,58,"PODEMOS-IU-",301
31,"31106",718,585,581,3,4,"PODEMOS-IU-",74
31,"31199",141,96,94,0,2,"PODEMOS-IU-",12
31,"31100",256,181,178,1,3,"PODEMOS-IU-",35
31,"31026",132,116,112,0,4,"PODEMOS-IU-",11
31,"31263",231,154,154,0,0,"PODEMOS-IU-",13
31,"31194",326,251,250,1,1,"PODEMOS-IU-",66
31,"31233",93,72,70,1,2,"PODEMOS-IU-",4
31,"31027",814,623,610,8,13,"PODEMOS-IU-",61
31,"31236",1318,958,950,8,8,"PODEMOS-IU-",175
31,"31908",1064,810,803,2,7,"PODEMOS-IU-",196
31,"31206",2082,1610,1589,15,21,"PODEMOS-IU-",315
31,"31222",58,38,38,3,0,"PODEMOS-IU-",8
31,"31065",1859,1383,1366,16,17,"PODEMOS-IU-",183
31,"31160",105,87,86,1,1,"PODEMOS-IU-",22
31,"31135",112,76,75,2,1,"PODEMOS-IU-",2
31,"31118",158,120,116,2,4,"PODEMOS-IU-",27
31,"31019",1808,1392,1378,18,14,"PODEMOS-IU-",270
31,"31040",173,139,139,1,0,"PODEMOS-IU-",15
31,"31195",171,125,125,2,0,"PODEMOS-IU-",24
31,"31112",93,71,70,0,1,"PODEMOS-IU-",23
20,"20050",270,186,183,3,3,"PODEMOS-IU-",13
20,"20030",21198,15734,15654,100,80,"PODEMOS-IU-",2862
48,"48085",10637,8270,8223,54,47,"PODEMOS-IU-",1681
48,"48055",2596,2023,2005,12,18,"PODEMOS-IU-",260
48,"48074",3273,2480,2460,14,20,"PODEMOS-IU-",327
1,"1053",592,376,373,2,3,"PODEMOS-IU-",55
20,"20036",13192,9864,9806,67,58,"PODEMOS-IU-",1802
20,"20060",88,75,75,0,0,"PODEMOS-IU-",1
20,"20007",327,235,230,2,5,"PODEMOS-IU-",28
1,"1046",631,464,461,0,3,"PODEMOS-IU-",79
1,"1010",2315,1789,1770,14,19,"PODEMOS-IU-",278
20,"20028",2258,1579,1574,9,5,"PODEMOS-IU-",214
1,"1032",500,372,362,1,10,"PODEMOS-IU-",47
48,"48912",2331,1843,1833,7,10,"PODEMOS-IU-",303
48,"48060",3620,2615,2606,13,9,"PODEMOS-IU-",251
20,"20043",1734,1254,1248,5,6,"PODEMOS-IU-",89
1,"1054",1013,729,726,2,3,"PODEMOS-IU-",118
20,"20048",184,120,120,2,0,"PODEMOS-IU-",22
1,"1059",189037,133121,131768,792,1353,"PODEMOS-IU-",24073
20,"20067",30618,21972,21854,138,118,"PODEMOS-IU-",5195
1,"1063",1830,1363,1353,4,10,"PODEMOS-IU-",205
48,"48073",6837,4950,4921,33,29,"PODEMOS-IU-",525
48,"48087",432,357,356,0,1,"PODEMOS-IU-",45
48,"48003",14444,11233,11162,43,71,"PODEMOS-IU-",1716
48,"48067",1134,877,872,5,5,"PODEMOS-IU-",66
48,"48065",3303,2541,2524,15,17,"PODEMOS-IU-",356
1,"1006",176,127,127,2,0,"PODEMOS-IU-",27
20,"20061",4392,3278,3264,11,14,"PODEMOS-IU-",436
48,"48037",684,537,531,4,6,"PODEMOS-IU-",82
48,"48040",1309,979,973,5,6,"PODEMOS-IU-",136
48,"48095",2326,1691,1680,11,11,"PODEMOS-IU-",288
20,"20073",4698,3530,3515,29,15,"PODEMOS-IU-",502
20,"20012",148,113,112,0,1,"PODEMOS-IU-",7
48,"48038",1158,891,891,2,0,"PODEMOS-IU-",112
48,"48064",613,494,492,1,2,"PODEMOS-IU-",48
48,"48045",5194,4138,4098,25,40,"PODEMOS-IU-",708
20,"20079",18142,14055,13971,75,84,"PODEMOS-IU-",2031
48,"48053",904,738,728,5,10,"PODEMOS-IU-",44
20,"20074",11503,8767,8720,26,47,"PODEMOS-IU-",1326
20,"20040",15753,11440,11364,69,76,"PODEMOS-IU-",2263
20,"20009",11343,8168,8106,46,62,"PODEMOS-IU-",1599
48,"48023",580,493,489,0,4,"PODEMOS-IU-",41
48,"48907",340,283,281,1,2,"PODEMOS-IU-",13
20,"20038",380,296,295,0,1,"PODEMOS-IU-",22
20,"20017",8484,6294,6263,25,31,"PODEMOS-IU-",799
48,"48043",4539,3566,3556,22,10,"PODEMOS-IU-",580
20,"20077",5254,4083,4059,22,24,"PODEMOS-IU-",642
48,"48015",33109,24697,24475,161,222,"PODEMOS-IU-",4772
1,"1047",967,686,673,8,13,"PODEMOS-IU-",113
48,"48057",5745,4391,4376,13,15,"PODEMOS-IU-",341
1,"1057",243,202,199,0,3,"PODEMOS-IU-",13
20,"20068",188,142,142,1,0,"PODEMOS-IU-",7
48,"48080",9946,7574,7499,46,75,"PODEMOS-IU-",1619
1,"1056",205,134,134,0,0,"PODEMOS-IU-",9
20,"20041",234,156,151,2,5,"PODEMOS-IU-",14
1,"1042",907,723,721,4,2,"PODEMOS-IU-",119
48,"48039",256,218,217,1,1,"PODEMOS-IU-",14
48,"48018",867,605,603,3,2,"PODEMOS-IU-",42
20,"20042",3172,2247,2231,9,16,"PODEMOS-IU-",344
48,"48911",388,323,322,3,1,"PODEMOS-IU-",25
20,"20006",254,169,169,0,0,"PODEMOS-IU-",21
48,"48068",1528,1218,1211,5,7,"PODEMOS-IU-",127
20,"20065",2943,2145,2124,11,21,"PODEMOS-IU-",275
1,"1037",585,426,425,1,1,"PODEMOS-IU-",55
1,"1019",148,121,121,0,0,"PODEMOS-IU-",10
48,"48054",24938,19329,19197,124,132,"PODEMOS-IU-",3737
48,"48014",1242,915,910,4,5,"PODEMOS-IU-",152
20,"20902",14229,10567,10495,53,72,"PODEMOS-IU-",2048
20,"20011",1633,1297,1287,2,10,"PODEMOS-IU-",147
20,"20020",113,67,67,0,0,"PODEMOS-IU-",8
20,"20078",1145,882,879,4,3,"PODEMOS-IU-",73
1,"1009",1265,920,914,6,6,"PODEMOS-IU-",163
48,"48041",686,581,579,2,2,"PODEMOS-IU-",57
1,"1023",262,210,206,3,4,"PODEMOS-IU-",29
48,"48006",309,265,265,0,0,"PODEMOS-IU-",34
1,"1062",315,236,229,2,7,"PODEMOS-IU-",48
20,"20062",945,727,726,3,1,"PODEMOS-IU-",86
48,"48030",601,490,489,0,1,"PODEMOS-IU-",26
1,"1011",215,179,175,3,4,"PODEMOS-IU-",7
20,"20051",6775,5124,5091,24,33,"PODEMOS-IU-",839
20,"20904",89,50,49,0,1,"PODEMOS-IU-",0
48,"48048",543,421,419,1,2,"PODEMOS-IU-",41
1,"1055",840,608,602,10,6,"PODEMOS-IU-",73
1,"1902",730,551,545,6,6,"PODEMOS-IU-",91
20,"20010",1528,1156,1151,5,5,"PODEMOS-IU-",164
1,"1052",268,188,187,1,1,"PODEMOS-IU-",24
48,"48042",1365,1136,1130,7,6,"PODEMOS-IU-",153
48,"48028",691,576,573,1,3,"PODEMOS-IU-",31
1,"1027",430,295,293,2,2,"PODEMOS-IU-",45
48,"48011",9652,7293,7251,37,42,"PODEMOS-IU-",1510
1,"1002",8035,6227,6159,17,68,"PODEMOS-IU-",989
20,"20019",9912,7226,7195,51,31,"PODEMOS-IU-",1154
48,"48026",1139,920,913,4,7,"PODEMOS-IU-",88
48,"48079",395,313,312,2,1,"PODEMOS-IU-",31
20,"20081",7655,5629,5601,22,28,"PODEMOS-IU-",781
48,"48047",149,115,115,1,0,"PODEMOS-IU-",14
48,"48056",989,791,785,4,6,"PODEMOS-IU-",121
1,"1044",231,171,166,0,5,"PODEMOS-IU-",19
20,"20907",117,88,87,0,1,"PODEMOS-IU-",16
1,"1901",2474,1655,1631,13,24,"PODEMOS-IU-",362
1,"1001",2005,1438,1419,4,19,"PODEMOS-IU-",276
48,"48092",869,676,674,9,2,"PODEMOS-IU-",88
20,"20016",1524,997,997,1,0,"PODEMOS-IU-",127
48,"48021",1336,990,983,4,7,"PODEMOS-IU-",128
48,"48070",528,392,390,2,2,"PODEMOS-IU-",17
1,"1017",816,579,574,2,5,"PODEMOS-IU-",67
48,"48016",5437,4282,4248,21,34,"PODEMOS-IU-",693
48,"48013",79423,59100,58630,458,470,"PODEMOS-IU-",13160
48,"48076",284,226,224,1,2,"PODEMOS-IU-",22
20,"20032",8681,6491,6429,22,62,"PODEMOS-IU-",905
48,"48066",347,291,291,0,0,"PODEMOS-IU-",23
48,"48061",799,636,636,2,0,"PODEMOS-IU-",88
20,"20052",1070,833,827,2,6,"PODEMOS-IU-",117
1,"1004",1356,1007,998,3,9,"PODEMOS-IU-",170
1,"1058",1403,958,951,4,7,"PODEMOS-IU-",154
48,"48032",5773,4504,4476,5,28,"PODEMOS-IU-",595
48,"48033",204,160,159,1,1,"PODEMOS-IU-",15
1,"1030",143,118,117,1,1,"PODEMOS-IU-",13
20,"20013",5430,4144,4119,19,25,"PODEMOS-IU-",647
20,"20014",1156,772,765,4,7,"PODEMOS-IU-",126
1,"1041",152,107,103,2,4,"PODEMOS-IU-",13
20,"20031",183,125,125,2,0,"PODEMOS-IU-",9
1,"1036",14772,10850,10746,69,104,"PODEMOS-IU-",1887
1,"1008",802,576,570,3,6,"PODEMOS-IU-",71
48,"48906",753,611,608,1,3,"PODEMOS-IU-",51
48,"48002",7777,6034,5981,48,53,"PODEMOS-IU-",1479
1,"1016",421,236,229,3,7,"PODEMOS-IU-",29
48,"48004",326,261,260,3,1,"PODEMOS-IU-",8
48,"48081",1883,1532,1518,3,14,"PODEMOS-IU-",185
20,"20029",4272,3257,3239,18,18,"PODEMOS-IU-",487
48,"48094",3125,2407,2388,12,19,"PODEMOS-IU-",227
48,"48084",21858,15943,15796,116,147,"PODEMOS-IU-",3660
20,"20072",4752,3445,3412,24,33,"PODEMOS-IU-",664
48,"48009",772,628,622,2,6,"PODEMOS-IU-",62
1,"1022",761,577,569,5,8,"PODEMOS-IU-",91
20,"20044",364,263,262,0,1,"PODEMOS-IU-",34
48,"48049",545,448,448,0,0,"PODEMOS-IU-",44
48,"48902",18971,14015,13895,101,120,"PODEMOS-IU-",2890
20,"20022",854,621,621,7,0,"PODEMOS-IU-",43
20,"20026",204,182,159,3,23,"PODEMOS-IU-",6
48,"48090",6016,4700,4639,24,61,"PODEMOS-IU-",752
48,"48072",970,735,730,1,5,"PODEMOS-IU-",65
1,"1018",1408,998,993,6,5,"PODEMOS-IU-",170
20,"20080",7709,5629,5588,28,41,"PODEMOS-IU-",1086
48,"48027",22668,17326,17224,95,102,"PODEMOS-IU-",2839
48,"48046",12644,9809,9744,46,65,"PODEMOS-IU-",1180
1,"1061",152,129,129,2,0,"PODEMOS-IU-",22
48,"48025",860,694,694,3,0,"PODEMOS-IU-",72
48,"48007",385,281,279,1,2,"PODEMOS-IU-",21
48,"48904",3542,2832,2811,27,21,"PODEMOS-IU-",402
48,"48036",24038,18180,18050,94,130,"PODEMOS-IU-",3465
20,"20070",1083,831,823,2,8,"PODEMOS-IU-",61
48,"48005",113,80,80,0,0,"PODEMOS-IU-",16
48,"48915",347,259,259,4,0,"PODEMOS-IU-",10
20,"20066",439,327,326,0,1,"PODEMOS-IU-",12
1,"1031",1163,948,928,6,20,"PODEMOS-IU-",117
20,"20015",1237,975,967,8,8,"PODEMOS-IU-",62
48,"48051",216,157,157,0,0,"PODEMOS-IU-",26
48,"48010",474,368,368,0,0,"PODEMOS-IU-",56
1,"1020",320,239,238,1,1,"PODEMOS-IU-",27
48,"48069",13094,10021,9954,49,67,"PODEMOS-IU-",1460
20,"20023",446,299,299,1,0,"PODEMOS-IU-",47
48,"48086",2015,1504,1486,6,18,"PODEMOS-IU-",322
20,"20901",1412,1034,1030,2,4,"PODEMOS-IU-",191
20,"20053",4848,3479,3451,27,28,"PODEMOS-IU-",740
48,"48062",293,247,245,0,2,"PODEMOS-IU-",25
20,"20027",2758,1980,1958,19,22,"PODEMOS-IU-",234
48,"48012",2071,1685,1674,7,11,"PODEMOS-IU-",204
48,"48063",356,277,274,2,3,"PODEMOS-IU-",23
48,"48088",133,99,98,2,1,"PODEMOS-IU-",10
1,"1021",469,333,330,1,3,"PODEMOS-IU-",44
48,"48908",249,214,213,0,1,"PODEMOS-IU-",15
48,"48059",400,329,325,0,4,"PODEMOS-IU-",22
1,"1039",195,157,153,0,4,"PODEMOS-IU-",26
48,"48096",6510,5247,5185,36,62,"PODEMOS-IU-",828
20,"20004",227,156,154,4,2,"PODEMOS-IU-",18
20,"20071",15036,11090,11025,59,65,"PODEMOS-IU-",1616
20,"20054",459,313,312,1,1,"PODEMOS-IU-",12
48,"48019",3461,2647,2633,12,14,"PODEMOS-IU-",498
20,"20076",7025,5263,5237,31,26,"PODEMOS-IU-",909
48,"48910",2802,2082,2073,3,9,"PODEMOS-IU-",286
20,"20905",153,124,124,1,0,"PODEMOS-IU-",13
20,"20056",4075,2983,2942,12,41,"PODEMOS-IU-",355
48,"48077",3376,2656,2647,11,9,"PODEMOS-IU-",408
48,"48091",1090,862,857,9,5,"PODEMOS-IU-",99
48,"48075",2067,1591,1565,11,26,"PODEMOS-IU-",232
48,"48909",202,172,172,2,0,"PODEMOS-IU-",16
48,"48905",2490,1911,1891,16,20,"PODEMOS-IU-",259
48,"48082",37396,27913,27694,172,219,"PODEMOS-IU-",6003
48,"48044",62054,49055,48840,373,215,"PODEMOS-IU-",5970
48,"48017",13150,9546,9504,38,42,"PODEMOS-IU-",1185
48,"48071",6038,4711,4674,27,37,"PODEMOS-IU-",923
20,"20034",3154,2336,2315,20,21,"PODEMOS-IU-",367
48,"48024",999,813,811,2,2,"PODEMOS-IU-",71
48,"48093",888,720,715,2,5,"PODEMOS-IU-",80
20,"20021",186,112,112,0,0,"PODEMOS-IU-",12
48,"48001",5885,4359,4334,35,25,"PODEMOS-IU-",716
48,"48914",325,286,285,0,1,"PODEMOS-IU-",13
20,"20075",4346,3158,3134,19,24,"PODEMOS-IU-",454
1,"1034",150,111,111,2,0,"PODEMOS-IU-",11
20,"20049",4159,3024,3004,11,20,"PODEMOS-IU-",405
48,"48008",615,454,448,4,6,"PODEMOS-IU-",78
48,"48089",3463,2746,2732,10,14,"PODEMOS-IU-",489
48,"48029",8613,6697,6642,52,55,"PODEMOS-IU-",1585
48,"48035",404,334,331,2,3,"PODEMOS-IU-",42
1,"1014",366,283,277,7,6,"PODEMOS-IU-",28
20,"20906",130,99,98,1,1,"PODEMOS-IU-",17
48,"48078",37991,28582,28382,202,200,"PODEMOS-IU-",5798
1,"1043",2337,1669,1656,18,13,"PODEMOS-IU-",309
1,"1013",703,491,487,2,4,"PODEMOS-IU-",72
20,"20037",103,77,77,0,0,"PODEMOS-IU-",5
1,"1033",656,533,525,1,8,"PODEMOS-IU-",57
48,"48097",1316,979,976,4,3,"PODEMOS-IU-",181
20,"20039",2144,1704,1692,11,12,"PODEMOS-IU-",149
20,"20003",551,401,399,2,2,"PODEMOS-IU-",37
48,"48901",5151,4042,4012,22,30,"PODEMOS-IU-",815
48,"48903",1807,1471,1462,6,9,"PODEMOS-IU-",169
20,"20008",704,455,449,6,6,"PODEMOS-IU-",33
20,"20903",4803,3514,3481,24,33,"PODEMOS-IU-",730
48,"48031",308,236,236,0,0,"PODEMOS-IU-",12
48,"48022",2316,1645,1631,11,14,"PODEMOS-IU-",216
20,"20047",462,337,335,2,2,"PODEMOS-IU-",37
20,"20058",739,555,551,4,4,"PODEMOS-IU-",82
20,"20063",8061,6042,5999,36,43,"PODEMOS-IU-",919
20,"20005",1267,884,882,2,2,"PODEMOS-IU-",96
20,"20002",355,258,257,8,1,"PODEMOS-IU-",36
1,"1028",1068,774,772,7,2,"PODEMOS-IU-",127
1,"1060",201,174,166,1,8,"PODEMOS-IU-",17
20,"20046",1248,918,909,11,9,"PODEMOS-IU-",149
20,"20045",46866,33932,33700,191,232,"PODEMOS-IU-",7450
20,"20018",11218,8145,8109,41,36,"PODEMOS-IU-",624
48,"48034",12639,9519,9443,77,76,"PODEMOS-IU-",1991
48,"48052",1567,1309,1300,4,9,"PODEMOS-IU-",120
20,"20033",854,675,671,5,4,"PODEMOS-IU-",77
20,"20035",484,384,384,2,0,"PODEMOS-IU-",45
48,"48083",6946,5238,5201,35,37,"PODEMOS-IU-",1474
1,"1003",1179,908,903,6,5,"PODEMOS-IU-",102
48,"48050",187,153,149,0,4,"PODEMOS-IU-",11
20,"20024",391,274,274,1,0,"PODEMOS-IU-",26
1,"1049",132,100,100,1,0,"PODEMOS-IU-",10
48,"48913",1224,977,967,6,10,"PODEMOS-IU-",170
20,"20055",17378,12565,12482,55,83,"PODEMOS-IU-",2120
20,"20001",257,174,172,1,2,"PODEMOS-IU-",12
48,"48058",946,724,715,3,9,"PODEMOS-IU-",90
20,"20069",147441,111102,110598,762,504,"PODEMOS-IU-",19802
20,"20064",12436,8730,8652,59,78,"PODEMOS-IU-",1956
20,"20057",194,143,143,0,0,"PODEMOS-IU-",23
20,"20025",1116,835,830,2,5,"PODEMOS-IU-",65
48,"48020",272959,203643,202331,1472,1312,"PODEMOS-IU-",35637
1,"1051",3558,2448,2433,14,15,"PODEMOS-IU-",385
20,"20059",8867,6792,6759,21,33,"PODEMOS-IU-",713
4,"4085",371,305,303,2,2,"PODEMOS-IU",5
21,"21038",1076,786,771,8,15,"PODEMOS-IU",120
18,"18059",4253,3166,3123,22,43,"PODEMOS-IU",529
18,"18182",1917,1391,1381,7,10,"PODEMOS-IU",70
4,"4027",226,147,147,1,0,"PODEMOS-IU",5
4,"4103",1439,1120,1108,16,12,"PODEMOS-IU",39
29,"29068",7716,5347,5230,58,117,"PODEMOS-IU",592
4,"4066",13488,9324,9255,73,69,"PODEMOS-IU",589
18,"18086",339,291,289,0,2,"PODEMOS-IU",31
18,"18904",743,555,545,1,10,"PODEMOS-IU",59
14,"14048",1189,948,933,5,15,"PODEMOS-IU",93
41,"41012",3368,2416,2361,23,55,"PODEMOS-IU",271
41,"41008",1040,840,822,4,18,"PODEMOS-IU",92
4,"4090",312,253,249,0,4,"PODEMOS-IU",13
14,"14030",7797,6116,6036,54,80,"PODEMOS-IU",1055
41,"41064",5611,3763,3667,47,96,"PODEMOS-IU",342
4,"4004",400,320,315,2,5,"PODEMOS-IU",17
41,"41075",10279,7543,7370,96,173,"PODEMOS-IU",928
21,"21001",610,480,461,3,19,"PODEMOS-IU",95
14,"14052",9080,5999,5909,63,90,"PODEMOS-IU",636
11,"11022",48682,28113,27794,294,319,"PODEMOS-IU",3502
14,"14014",2509,2071,2030,7,41,"PODEMOS-IU",236
18,"18128",342,274,272,1,2,"PODEMOS-IU",33
21,"21057",995,631,629,3,2,"PODEMOS-IU",42
14,"14007",15042,10970,10758,86,212,"PODEMOS-IU",1197
29,"29012",9718,7243,7123,47,120,"PODEMOS-IU",917
4,"4075",5427,3989,3961,15,28,"PODEMOS-IU",213
11,"11003",1240,898,876,7,22,"PODEMOS-IU",59
23,"23006",4582,3607,3543,32,64,"PODEMOS-IU",174
29,"29085",138,100,98,0,2,"PODEMOS-IU",9
11,"11032",54469,33144,32810,461,334,"PODEMOS-IU",5390
4,"4006",7218,5002,4940,33,62,"PODEMOS-IU",301
18,"18005",362,268,265,0,3,"PODEMOS-IU",31
23,"23020",1524,1363,1348,12,15,"PODEMOS-IU",364
29,"29080",6895,5005,4934,59,71,"PODEMOS-IU",627
21,"21074",2698,1979,1945,15,34,"PODEMOS-IU",105
29,"29061",1033,840,821,5,19,"PODEMOS-IU",266
23,"23905",1840,1358,1341,9,17,"PODEMOS-IU",61
29,"29037",215,179,179,0,0,"PODEMOS-IU",13
23,"23066",4299,3603,3545,13,58,"PODEMOS-IU",219
14,"14040",3755,3047,3006,21,41,"PODEMOS-IU",1169
18,"18174",434,362,357,0,5,"PODEMOS-IU",20
18,"18107",924,694,680,3,14,"PODEMOS-IU",42
21,"21063",2620,2037,1992,11,45,"PODEMOS-IU",172
23,"23061",7691,5636,5531,51,105,"PODEMOS-IU",292
14,"14018",3611,2802,2741,25,61,"PODEMOS-IU",466
23,"23069",5262,4395,4329,15,66,"PODEMOS-IU",363
21,"21071",211,155,152,3,3,"PODEMOS-IU",10
18,"18014",6898,5262,5162,43,100,"PODEMOS-IU",705
29,"29070",43090,30294,29928,243,366,"PODEMOS-IU",4399
18,"18039",3382,2517,2490,20,27,"PODEMOS-IU",138
11,"11018",1446,1126,1100,6,26,"PODEMOS-IU",58
41,"41100",967,765,727,8,38,"PODEMOS-IU",67
11,"11901",5698,4167,4080,81,87,"PODEMOS-IU",495
18,"18042",418,344,340,7,4,"PODEMOS-IU",54
41,"41063",2713,1988,1944,17,44,"PODEMOS-IU",425
14,"14008",2785,1942,1910,15,32,"PODEMOS-IU",136
41,"41019",4895,3518,3462,36,56,"PODEMOS-IU",487
29,"29003",922,740,727,3,13,"PODEMOS-IU",104
18,"18050",1670,1231,1213,9,18,"PODEMOS-IU",164
41,"41022",4269,3158,3110,16,48,"PODEMOS-IU",661
41,"41090",3507,2766,2694,15,72,"PODEMOS-IU",465
29,"29067",430670,312817,309994,2768,2823,"PODEMOS-IU",48566
18,"18099",1581,1279,1245,5,34,"PODEMOS-IU",207
14,"14021",260397,195951,193914,2025,2037,"PODEMOS-IU",31569
23,"23056",3062,2332,2281,13,51,"PODEMOS-IU",366
23,"23033",1319,1076,1057,8,19,"PODEMOS-IU",47
29,"29087",371,266,263,2,3,"PODEMOS-IU",75
14,"14010",4001,3106,3068,15,38,"PODEMOS-IU",296
18,"18171",2111,1679,1638,8,41,"PODEMOS-IU",371
4,"4044",1533,1190,1176,8,14,"PODEMOS-IU",110
41,"41065",22550,16215,16010,189,205,"PODEMOS-IU",2744
4,"4033",125,98,95,0,3,"PODEMOS-IU",4
23,"23017",1480,1227,1202,6,25,"PODEMOS-IU",94
14,"14046",4443,3550,3486,38,64,"PODEMOS-IU",1271
41,"41046",3006,2464,2427,13,37,"PODEMOS-IU",610
41,"41036",3917,2944,2885,27,59,"PODEMOS-IU",1032
4,"4049",5603,4104,4054,27,50,"PODEMOS-IU",374
11,"11034",2331,1708,1670,17,38,"PODEMOS-IU",127
18,"18100",7981,5900,5769,44,131,"PODEMOS-IU",724
21,"21027",50,40,39,0,1,"PODEMOS-IU",4
4,"4079",54086,38415,38134,239,281,"PODEMOS-IU",3911
14,"14031",566,453,446,2,7,"PODEMOS-IU",30
18,"18137",1002,776,773,0,3,"PODEMOS-IU",25
41,"41026",4300,3561,3521,18,40,"PODEMOS-IU",1282
23,"23054",376,296,289,1,7,"PODEMOS-IU",10
29,"29904",417,337,335,2,2,"PODEMOS-IU",30
18,"18047",6074,4437,4353,33,84,"PODEMOS-IU",847
18,"18032",242,180,178,2,2,"PODEMOS-IU",30
23,"23005",29940,19587,19330,191,257,"PODEMOS-IU",1699
23,"23904",2604,1727,1701,7,26,"PODEMOS-IU",127
18,"18916",1778,1249,1236,9,13,"PODEMOS-IU",147
4,"4082",277,198,196,1,2,"PODEMOS-IU",19
18,"18083",228,189,188,1,1,"PODEMOS-IU",12
18,"18903",851,644,636,1,8,"PODEMOS-IU",28
41,"41078",2459,1910,1895,24,15,"PODEMOS-IU",316
41,"41051",2311,1770,1734,5,36,"PODEMOS-IU",199
21,"21004",1593,1114,1085,16,29,"PODEMOS-IU",159
23,"23902",2229,1843,1820,7,23,"PODEMOS-IU",87
29,"29071",979,718,712,14,6,"PODEMOS-IU",68
29,"29027",2309,1716,1692,18,24,"PODEMOS-IU",201
21,"21036",203,147,143,0,4,"PODEMOS-IU",12
4,"4018",252,215,213,1,2,"PODEMOS-IU",18
41,"41028",2071,1741,1713,18,28,"PODEMOS-IU",318
41,"41072",4037,3256,3221,19,35,"PODEMOS-IU",1205
21,"21013",10570,7195,7089,73,106,"PODEMOS-IU",1103
11,"11903",1791,1234,1211,16,23,"PODEMOS-IU",147
18,"18151",259,194,193,3,1,"PODEMOS-IU",38
14,"14060",3694,2878,2798,26,80,"PODEMOS-IU",347
29,"29006",665,491,483,5,8,"PODEMOS-IU",33
29,"29065",194,150,150,0,0,"PODEMOS-IU",7
21,"21021",12469,8238,8097,76,141,"PODEMOS-IU",839
4,"4043",511,423,421,3,2,"PODEMOS-IU",31
11,"11029",5423,3161,3105,55,56,"PODEMOS-IU",763
23,"23072",1885,1485,1468,5,17,"PODEMOS-IU",86
18,"18915",731,539,532,1,7,"PODEMOS-IU",42
18,"18119",1712,1352,1317,11,35,"PODEMOS-IU",131
29,"29093",2164,1704,1678,4,26,"PODEMOS-IU",185
21,"21019",584,441,425,10,16,"PODEMOS-IU",69
18,"18140",42374,29390,29025,221,365,"PODEMOS-IU",4039
18,"18076",790,607,604,1,3,"PODEMOS-IU",38
11,"11027",68637,48919,48441,519,478,"PODEMOS-IU",8309
29,"29095",3304,2536,2470,22,66,"PODEMOS-IU",367
21,"21064",6641,4689,4597,66,92,"PODEMOS-IU",557
18,"18144",803,650,640,2,10,"PODEMOS-IU",109
41,"41016",7767,5937,5829,56,108,"PODEMOS-IU",918
4,"4059",1025,742,731,3,11,"PODEMOS-IU",27
23,"23085",2182,1733,1717,7,16,"PODEMOS-IU",112
21,"21073",1891,1191,1156,17,35,"PODEMOS-IU",114
18,"18179",503,346,343,3,3,"PODEMOS-IU",19
23,"23016",384,316,311,0,5,"PODEMOS-IU",23
14,"14023",2007,1734,1711,9,23,"PODEMOS-IU",85
41,"41014",2486,1939,1878,6,61,"PODEMOS-IU",778
41,"41098",5152,4046,3986,24,60,"PODEMOS-IU",507
18,"18158",8010,5524,5449,23,75,"PODEMOS-IU",878
4,"4073",336,243,243,0,0,"PODEMOS-IU",10
18,"18141",384,269,264,0,5,"PODEMOS-IU",16
23,"23037",520,431,425,6,6,"PODEMOS-IU",35
41,"41035",1060,803,788,8,15,"PODEMOS-IU",48
14,"14009",2669,1863,1844,19,19,"PODEMOS-IU",165
18,"18145",10869,8532,8405,69,127,"PODEMOS-IU",1256
23,"23053",9449,6379,6325,25,54,"PODEMOS-IU",1724
18,"18089",14540,10725,10583,65,142,"PODEMOS-IU",1078
23,"23067",2421,1909,1873,13,36,"PODEMOS-IU",389
23,"23087",11185,8500,8363,65,137,"PODEMOS-IU",1740
11,"11036",687,457,447,7,10,"PODEMOS-IU",41
21,"21018",1719,1167,1139,9,28,"PODEMOS-IU",155
29,"29020",3280,2531,2485,23,46,"PODEMOS-IU",849
14,"14055",18446,13919,13711,148,208,"PODEMOS-IU",1288
41,"41099",3968,2666,2642,23,24,"PODEMOS-IU",336
14,"14070",1284,988,969,5,19,"PODEMOS-IU",35
29,"29028",1224,875,858,4,17,"PODEMOS-IU",124
23,"23009",12808,10348,10233,66,115,"PODEMOS-IU",767
41,"41018",9410,6987,6882,52,105,"PODEMOS-IU",1253
18,"18152",906,692,686,1,6,"PODEMOS-IU",27
14,"14049",16282,12515,12301,121,214,"PODEMOS-IU",1841
29,"29044",757,540,533,7,7,"PODEMOS-IU",25
23,"23008",1434,1155,1133,6,22,"PODEMOS-IU",133
29,"29015",32064,23769,23461,213,308,"PODEMOS-IU",2558
18,"18111",2849,2193,2160,24,33,"PODEMOS-IU",387
23,"23088",6020,4779,4703,56,76,"PODEMOS-IU",1053
23,"23073",4389,3400,3363,13,37,"PODEMOS-IU",217
18,"18909",539,432,426,1,6,"PODEMOS-IU",17
29,"29036",611,448,444,3,4,"PODEMOS-IU",78
4,"4015",118,97,97,2,0,"PODEMOS-IU",8
29,"29076",2335,1661,1614,11,47,"PODEMOS-IU",161
14,"14068",516,405,400,1,5,"PODEMOS-IU",39
41,"41033",4965,3634,3580,27,54,"PODEMOS-IU",201
21,"21016",993,770,744,6,26,"PODEMOS-IU",96
21,"21037",459,363,357,4,6,"PODEMOS-IU",44
14,"14902",1121,928,900,7,28,"PODEMOS-IU",99
29,"29001",4199,3380,3341,20,39,"PODEMOS-IU",881
21,"21009",835,575,557,0,18,"PODEMOS-IU",91
18,"18154",975,701,699,3,2,"PODEMOS-IU",34
18,"18913",781,590,577,5,13,"PODEMOS-IU",25
23,"23090",1219,1014,1004,5,10,"PODEMOS-IU",49
29,"29017",6428,4943,4871,32,72,"PODEMOS-IU",686
41,"41059",35105,27781,27472,261,309,"PODEMOS-IU",5151
41,"41087",10496,7661,7477,57,184,"PODEMOS-IU",1061
18,"18177",373,253,252,1,1,"PODEMOS-IU",19
41,"41003",2371,1801,1760,8,41,"PODEMOS-IU",164
21,"21025",3898,2765,2705,39,60,"PODEMOS-IU",327
18,"18168",781,613,604,6,9,"PODEMOS-IU",90
29,"29013",1602,1262,1238,12,24,"PODEMOS-IU",245
14,"14058",7859,5854,5745,51,109,"PODEMOS-IU",557
18,"18908",784,599,581,0,18,"PODEMOS-IU",83
18,"18034",486,376,374,4,2,"PODEMOS-IU",91
23,"23044",4719,3817,3749,18,68,"PODEMOS-IU",681
11,"11025",4388,3092,3045,30,47,"PODEMOS-IU",296
11,"11009",580,429,420,2,9,"PODEMOS-IU",42
29,"29092",579,434,426,5,8,"PODEMOS-IU",85
4,"4084",341,258,255,0,3,"PODEMOS-IU",21
21,"21075",335,256,249,0,7,"PODEMOS-IU",12
29,"29903",493,358,354,6,4,"PODEMOS-IU",42
18,"18153",8796,6686,6594,59,92,"PODEMOS-IU",1257
4,"4048",1496,1109,1102,4,7,"PODEMOS-IU",97
18,"18178",671,535,532,0,3,"PODEMOS-IU",31
21,"21035",9726,6628,6520,78,108,"PODEMOS-IU",646
41,"41904",1792,1171,1162,16,9,"PODEMOS-IU",126
23,"23045",2057,1519,1507,7,12,"PODEMOS-IU",351
18,"18088",1530,1152,1142,0,10,"PODEMOS-IU",287
4,"4024",3225,2558,2534,23,24,"PODEMOS-IU",243
23,"23024",12224,9586,9329,46,257,"PODEMOS-IU",1060
18,"18065",591,482,468,4,14,"PODEMOS-IU",192
29,"29902",2592,1841,1817,18,24,"PODEMOS-IU",173
4,"4046",848,653,649,5,4,"PODEMOS-IU",43
23,"23059",5728,4259,4187,18,72,"PODEMOS-IU",262
14,"14038",32692,24015,23679,213,336,"PODEMOS-IU",2422
41,"41015",5401,3984,3889,50,95,"PODEMOS-IU",417
41,"41074",2998,2364,2322,17,42,"PODEMOS-IU",626
18,"18159",999,828,824,1,4,"PODEMOS-IU",299
18,"18054",838,649,648,8,1,"PODEMOS-IU",62
18,"18098",5994,4293,4247,29,46,"PODEMOS-IU",379
21,"21045",227,181,178,1,3,"PODEMOS-IU",34
4,"4041",330,248,247,1,1,"PODEMOS-IU",19
41,"41040",11111,8768,8679,76,89,"PODEMOS-IU",1136
18,"18033",279,221,220,1,1,"PODEMOS-IU",24
18,"18101",9410,7280,7181,72,99,"PODEMOS-IU",1158
18,"18043",130,93,93,0,0,"PODEMOS-IU",21
4,"4031",2249,1778,1773,2,5,"PODEMOS-IU",88
18,"18901",488,335,329,2,6,"PODEMOS-IU",60
18,"18164",1794,1225,1205,9,20,"PODEMOS-IU",81
21,"21017",2325,1450,1419,22,31,"PODEMOS-IU",113
29,"29084",27218,19648,19352,173,296,"PODEMOS-IU",2070
11,"11012",97629,73036,72347,715,689,"PODEMOS-IU",18163
4,"4083",1740,1342,1326,4,16,"PODEMOS-IU",125
41,"41054",713,596,588,4,8,"PODEMOS-IU",75
23,"23095",8591,6634,6571,27,63,"PODEMOS-IU",415
21,"21079",687,503,500,5,3,"PODEMOS-IU",68
23,"23058",8817,6964,6873,48,91,"PODEMOS-IU",766
18,"18165",4251,3113,3073,20,40,"PODEMOS-IU",403
41,"41032",3843,3018,2944,17,74,"PODEMOS-IU",340
41,"41044",7698,5967,5898,59,69,"PODEMOS-IU",898
4,"4014",149,109,108,0,1,"PODEMOS-IU",7
41,"41007",12438,9009,8775,135,234,"PODEMOS-IU",1505
21,"21039",299,226,223,7,3,"PODEMOS-IU",19
23,"23007",3026,2317,2301,13,16,"PODEMOS-IU",147
18,"18087",182514,141305,139588,865,1717,"PODEMOS-IU",19909
18,"18181",202,150,148,0,2,"PODEMOS-IU",3
29,"29048",1370,1149,1135,10,14,"PODEMOS-IU",415
21,"21003",677,505,489,3,16,"PODEMOS-IU",92
23,"23065",1550,1199,1186,4,13,"PODEMOS-IU",69
11,"11019",1753,1353,1295,7,58,"PODEMOS-IU",134
21,"21053",3287,2375,2322,17,53,"PODEMOS-IU",219
23,"23052",1108,949,931,8,18,"PODEMOS-IU",58
4,"4061",622,501,494,4,7,"PODEMOS-IU",36
14,"14003",1258,989,968,12,21,"PODEMOS-IU",60
41,"41021",21397,15585,15334,201,251,"PODEMOS-IU",2727
29,"29098",1235,953,935,12,18,"PODEMOS-IU",97
29,"29030",774,660,657,3,3,"PODEMOS-IU",182
14,"14017",10945,8514,8386,90,128,"PODEMOS-IU",863
41,"41094",6447,4998,4912,43,86,"PODEMOS-IU",531
21,"21024",466,355,341,4,14,"PODEMOS-IU",73
23,"23032",523,443,439,1,4,"PODEMOS-IU",41
4,"4026",55,46,45,1,1,"PODEMOS-IU",3
29,"29075",12890,9033,8949,73,84,"PODEMOS-IU",1311
41,"41068",13936,10692,10530,73,162,"PODEMOS-IU",1437
14,"14071",884,641,634,2,7,"PODEMOS-IU",51
4,"4078",1110,819,814,2,5,"PODEMOS-IU",144
23,"23040",1443,1164,1149,3,15,"PODEMOS-IU",277
29,"29043",2474,1764,1720,25,44,"PODEMOS-IU",201
14,"14065",1813,1439,1421,11,18,"PODEMOS-IU",205
18,"18004",687,521,515,4,6,"PODEMOS-IU",18
4,"4063",1063,847,835,5,12,"PODEMOS-IU",29
29,"29081",261,212,210,2,2,"PODEMOS-IU",5
21,"21050",12522,8425,8312,84,113,"PODEMOS-IU",677
18,"18911",7869,5871,5765,49,106,"PODEMOS-IU",827
41,"41013",4807,3480,3425,30,55,"PODEMOS-IU",688
11,"11021",4926,3592,3486,50,106,"PODEMOS-IU",468
4,"4032",5698,4168,4138,20,30,"PODEMOS-IU",370
14,"14069",7376,5511,5398,47,113,"PODEMOS-IU",458
4,"4055",366,315,314,3,1,"PODEMOS-IU",22
29,"29047",1103,909,898,2,11,"PODEMOS-IU",249
41,"41070",6397,4987,4921,55,66,"PODEMOS-IU",979
21,"21047",1869,1242,1206,8,36,"PODEMOS-IU",176
21,"21010",14976,9475,9352,145,123,"PODEMOS-IU",1272
29,"29011",2871,1955,1926,11,29,"PODEMOS-IU",187
23,"23001",920,769,766,3,3,"PODEMOS-IU",49
18,"18150",6903,5149,5063,42,86,"PODEMOS-IU",812
18,"18010",532,420,416,2,4,"PODEMOS-IU",48
23,"23062",1418,1206,1190,5,16,"PODEMOS-IU",47
18,"18057",5540,4306,4246,30,60,"PODEMOS-IU",634
18,"18024",831,682,667,6,15,"PODEMOS-IU",105
29,"29008",15183,10716,10555,93,161,"PODEMOS-IU",919
29,"29023",2290,1569,1550,3,19,"PODEMOS-IU",155
41,"41097",3135,2355,2308,11,47,"PODEMOS-IU",152
23,"23004",421,356,355,2,1,"PODEMOS-IU",19
18,"18028",907,766,756,0,10,"PODEMOS-IU",75
29,"29045",1681,1263,1242,9,21,"PODEMOS-IU",110
23,"23035",1103,903,882,6,21,"PODEMOS-IU",49
18,"18134",6069,4431,4345,30,86,"PODEMOS-IU",812
18,"18187",512,388,387,0,1,"PODEMOS-IU",34
18,"18036",3970,3197,3149,26,48,"PODEMOS-IU",515
18,"18173",8972,6594,6459,58,135,"PODEMOS-IU",1082
4,"4050",751,522,519,1,3,"PODEMOS-IU",30
21,"21049",3282,2294,2214,21,80,"PODEMOS-IU",387
18,"18040",226,146,145,0,1,"PODEMOS-IU",31
23,"23074",2971,2410,2378,8,32,"PODEMOS-IU",250
41,"41006",2738,1971,1945,16,26,"PODEMOS-IU",195
18,"18192",1466,1171,1156,1,15,"PODEMOS-IU",139
23,"23071",1720,1348,1330,6,18,"PODEMOS-IU",78
18,"18109",599,452,448,3,4,"PODEMOS-IU",22
14,"14072",999,763,754,4,9,"PODEMOS-IU",110
41,"41056",3694,3044,3009,36,35,"PODEMOS-IU",366
4,"4072",314,245,240,0,5,"PODEMOS-IU",10
4,"4047",2230,1806,1785,8,21,"PODEMOS-IU",87
14,"14073",2772,2124,2069,18,55,"PODEMOS-IU",273
21,"21006",3329,2307,2262,20,45,"PODEMOS-IU",328
18,"18106",415,300,295,0,5,"PODEMOS-IU",21
21,"21026",253,189,183,1,6,"PODEMOS-IU",39
23,"23014",2552,2056,2020,11,36,"PODEMOS-IU",259
21,"21051",221,180,177,1,3,"PODEMOS-IU",17
18,"18135",4434,3169,3105,23,64,"PODEMOS-IU",258
11,"11028",32791,24276,24028,279,248,"PODEMOS-IU",7186
18,"18147",3644,2492,2441,18,51,"PODEMOS-IU",363
29,"29004",295,233,226,0,7,"PODEMOS-IU",25
14,"14039",2575,2037,1990,14,47,"PODEMOS-IU",213
11,"11033",21702,14645,14436,190,209,"PODEMOS-IU",1852
41,"41011",15454,11892,11591,160,301,"PODEMOS-IU",1918
11,"11002",4200,3287,3257,5,30,"PODEMOS-IU",1359
29,"29038",18683,12820,12666,168,154,"PODEMOS-IU",1707
29,"29041",3599,2570,2532,22,38,"PODEMOS-IU",615
11,"11023",9372,7032,6950,94,82,"PODEMOS-IU",1053
18,"18161",251,222,220,1,2,"PODEMOS-IU",18
4,"4034",165,107,106,1,1,"PODEMOS-IU",4
14,"14019",6408,5163,5086,58,77,"PODEMOS-IU",1027
41,"41017",15712,12048,11896,118,152,"PODEMOS-IU",1789
21,"21052",4429,2951,2891,19,60,"PODEMOS-IU",653
23,"23070",3808,2598,2565,34,33,"PODEMOS-IU",143
41,"41091",539730,412509,408312,3804,4197,"PODEMOS-IU",66407
41,"41052",3027,2357,2288,14,69,"PODEMOS-IU",354
29,"29053",1694,1263,1245,18,18,"PODEMOS-IU",171
18,"18046",1753,1206,1185,1,21,"PODEMOS-IU",72
21,"21008",2613,1803,1777,6,26,"PODEMOS-IU",132
21,"21041",112810,77371,76488,900,883,"PODEMOS-IU",11628
4,"4099",4931,3781,3719,24,62,"PODEMOS-IU",228
18,"18022",13804,9877,9714,92,163,"PODEMOS-IU",1544
11,"11016",15051,10188,10042,131,146,"PODEMOS-IU",1359
18,"18117",507,402,396,5,6,"PODEMOS-IU",47
4,"4022",357,261,261,0,0,"PODEMOS-IU",18
41,"41047",10411,8348,8242,84,106,"PODEMOS-IU",1288
4,"4062",4460,3466,3425,12,41,"PODEMOS-IU",212
21,"21005",15697,9910,9778,72,132,"PODEMOS-IU",1087
4,"4071",363,303,301,2,2,"PODEMOS-IU",17
14,"14042",18727,15069,14837,201,232,"PODEMOS-IU",2829
21,"21042",15579,8742,8579,138,163,"PODEMOS-IU",1092
41,"41004",57465,41004,40321,571,683,"PODEMOS-IU",6940
29,"29077",214,158,156,1,2,"PODEMOS-IU",13
29,"29014",222,151,150,6,1,"PODEMOS-IU",22
4,"4010",580,445,434,2,11,"PODEMOS-IU",29
18,"18070",289,224,222,3,2,"PODEMOS-IU",30
18,"18084",4458,3467,3417,17,50,"PODEMOS-IU",448
41,"41041",9760,7835,7646,44,189,"PODEMOS-IU",897
4,"4007",731,570,569,0,1,"PODEMOS-IU",53
14,"14033",1265,994,985,9,9,"PODEMOS-IU",101
11,"11013",2332,1747,1713,16,34,"PODEMOS-IU",193
18,"18115",2650,1988,1975,20,13,"PODEMOS-IU",355
18,"18185",542,454,453,2,1,"PODEMOS-IU",68
4,"4096",281,239,237,1,2,"PODEMOS-IU",21
4,"4008",464,386,383,4,3,"PODEMOS-IU",16
18,"18053",1561,1102,1099,3,3,"PODEMOS-IU",77
14,"14029",4029,3089,3039,15,50,"PODEMOS-IU",265
29,"29086",774,537,532,1,5,"PODEMOS-IU",48
29,"29074",781,606,597,2,9,"PODEMOS-IU",31
23,"23081",1483,1137,1109,7,28,"PODEMOS-IU",92
41,"41048",2198,1561,1512,22,49,"PODEMOS-IU",117
21,"21069",1667,1214,1198,13,16,"PODEMOS-IU",72
29,"29031",1559,1139,1113,13,26,"PODEMOS-IU",237
18,"18176",241,182,180,0,2,"PODEMOS-IU",27
14,"14054",13796,11042,10799,102,243,"PODEMOS-IU",1101
14,"14044",1620,1279,1264,12,15,"PODEMOS-IU",91
29,"29064",437,319,315,2,4,"PODEMOS-IU",25
23,"23028",6131,4696,4635,24,61,"PODEMOS-IU",520
18,"18044",164,113,112,0,1,"PODEMOS-IU",11
21,"21044",17955,11674,11479,136,195,"PODEMOS-IU",858
11,"11031",76294,54123,53583,589,540,"PODEMOS-IU",8317
21,"21012",286,238,233,4,5,"PODEMOS-IU",43
18,"18074",264,207,205,0,2,"PODEMOS-IU",13
11,"11902",3656,2427,2383,29,44,"PODEMOS-IU",154
21,"21033",561,428,427,4,1,"PODEMOS-IU",111
41,"41903",6769,5018,4919,73,99,"PODEMOS-IU",531
41,"41031",1215,866,848,3,18,"PODEMOS-IU",64
21,"21054",8157,6002,5869,60,133,"PODEMOS-IU",377
29,"29099",969,757,735,5,22,"PODEMOS-IU",68
41,"41081",29840,22819,22465,228,354,"PODEMOS-IU",4368
41,"41082",3359,2760,2718,11,42,"PODEMOS-IU",384
11,"11020",166423,117732,116448,1427,1284,"PODEMOS-IU",17739
18,"18064",366,307,306,0,1,"PODEMOS-IU",11
21,"21078",2646,1926,1895,14,31,"PODEMOS-IU",396
41,"41069",29569,21075,20657,361,418,"PODEMOS-IU",3284
11,"11008",17840,12434,12236,181,198,"PODEMOS-IU",1671
21,"21014",4065,3192,3148,22,44,"PODEMOS-IU",346
18,"18020",501,365,358,2,7,"PODEMOS-IU",21
14,"14002",10859,8215,8078,93,137,"PODEMOS-IU",1333
4,"4060",407,308,304,1,4,"PODEMOS-IU",22
14,"14901",915,795,782,8,13,"PODEMOS-IU",176
18,"18188",1648,1295,1276,4,19,"PODEMOS-IU",111
14,"14066",5756,4396,4310,36,86,"PODEMOS-IU",968
29,"29063",303,243,239,1,4,"PODEMOS-IU",26
29,"29062",651,576,567,4,9,"PODEMOS-IU",17
29,"29019",864,687,679,7,8,"PODEMOS-IU",190
11,"11014",17141,11836,11705,214,131,"PODEMOS-IU",2328
4,"4094",209,156,154,0,2,"PODEMOS-IU",3
11,"11035",13715,9510,9385,128,125,"PODEMOS-IU",1386
4,"4903",4308,3102,3075,17,27,"PODEMOS-IU",144
4,"4017",1276,907,900,4,7,"PODEMOS-IU",45
18,"18108",826,677,669,3,8,"PODEMOS-IU",75
18,"18189",772,619,611,4,8,"PODEMOS-IU",134
23,"23049",1747,1321,1305,11,16,"PODEMOS-IU",250
18,"18072",664,481,473,0,8,"PODEMOS-IU",41
29,"29901",44578,31840,31537,286,303,"PODEMOS-IU",4588
14,"14034",304,246,239,1,7,"PODEMOS-IU",14
18,"18095",2002,1566,1537,11,29,"PODEMOS-IU",214
41,"41043",667,475,453,3,22,"PODEMOS-IU",42
14,"14061",688,567,556,2,11,"PODEMOS-IU",51
29,"29094",59350,42199,41749,419,450,"PODEMOS-IU",4837
18,"18910",730,491,487,0,4,"PODEMOS-IU",53
41,"41037",3192,2505,2479,15,26,"PODEMOS-IU",687
4,"4095",690,508,502,2,6,"PODEMOS-IU",35
23,"23094",3729,3111,3077,16,34,"PODEMOS-IU",520
23,"23060",19153,14444,14281,87,163,"PODEMOS-IU",1143
18,"18015",425,333,333,0,0,"PODEMOS-IU",36
41,"41902",4600,3141,3092,48,49,"PODEMOS-IU",367
14,"14011",572,498,495,5,3,"PODEMOS-IU",23
18,"18102",8227,6100,5969,32,131,"PODEMOS-IU",874
18,"18001",230,173,170,1,3,"PODEMOS-IU",5
18,"18079",3469,2667,2623,16,44,"PODEMOS-IU",406
23,"23038",3785,3182,3162,16,20,"PODEMOS-IU",306
41,"41045",5854,4287,4200,58,87,"PODEMOS-IU",968
18,"18114",591,443,437,2,6,"PODEMOS-IU",54
21,"21034",1159,863,845,4,18,"PODEMOS-IU",101
29,"29021",159,121,120,0,1,"PODEMOS-IU",18
21,"21046",1714,1097,1071,13,26,"PODEMOS-IU",62
41,"41086",16209,11006,10881,116,125,"PODEMOS-IU",1602
4,"4097",242,184,184,0,0,"PODEMOS-IU",17
29,"29069",86694,58863,58127,561,736,"PODEMOS-IU",7186
29,"29026",1010,747,736,3,11,"PODEMOS-IU",139
23,"23096",2571,2099,2063,9,36,"PODEMOS-IU",208
29,"29025",41515,29572,29311,221,261,"PODEMOS-IU",4799
18,"18116",2853,2265,2233,15,32,"PODEMOS-IU",289
18,"18126",1450,1115,1087,11,28,"PODEMOS-IU",317
23,"23034",2490,2033,1999,15,34,"PODEMOS-IU",88
4,"4098",1455,1097,1087,9,10,"PODEMOS-IU",62
11,"11038",13613,10879,10676,101,203,"PODEMOS-IU",906
41,"41083",1128,865,859,6,6,"PODEMOS-IU",104
18,"18194",2045,1394,1370,11,24,"PODEMOS-IU",112
29,"29059",2643,2086,2042,8,44,"PODEMOS-IU",695
29,"29083",2062,1607,1574,9,33,"PODEMOS-IU",92
21,"21076",2142,1573,1551,24,22,"PODEMOS-IU",261
18,"18094",2304,1845,1798,16,47,"PODEMOS-IU",169
23,"23046",2331,1953,1926,3,27,"PODEMOS-IU",196
4,"4058",342,256,256,0,0,"PODEMOS-IU",36
21,"21066",495,401,396,4,5,"PODEMOS-IU",34
41,"41062",2175,1763,1746,8,17,"PODEMOS-IU",695
18,"18063",1217,712,702,6,10,"PODEMOS-IU",23
18,"18157",1148,914,898,8,16,"PODEMOS-IU",127
4,"4005",533,448,442,0,6,"PODEMOS-IU",20
18,"18069",497,374,366,4,8,"PODEMOS-IU",49
14,"14027",7876,6227,6103,81,124,"PODEMOS-IU",1485
41,"41101",6016,4524,4480,42,44,"PODEMOS-IU",663
18,"18006",4087,3109,3042,28,67,"PODEMOS-IU",261
18,"18029",1813,1183,1169,9,14,"PODEMOS-IU",93
21,"21062",1386,893,885,15,8,"PODEMOS-IU",42
29,"29035",1505,1151,1133,6,18,"PODEMOS-IU",261
14,"14015",2067,1575,1551,16,24,"PODEMOS-IU",247
18,"18048",2462,1873,1832,16,41,"PODEMOS-IU",244
18,"18184",2170,1688,1656,3,32,"PODEMOS-IU",253
14,"14005",6318,4464,4380,59,84,"PODEMOS-IU",1066
23,"23021",517,446,440,0,6,"PODEMOS-IU",28
18,"18007",741,533,527,6,6,"PODEMOS-IU",25
29,"29058",1538,1079,1062,5,17,"PODEMOS-IU",65
18,"18035",1190,965,952,4,13,"PODEMOS-IU",69
21,"21030",1879,1523,1504,14,19,"PODEMOS-IU",65
41,"41057",253,189,188,0,1,"PODEMOS-IU",19
4,"4012",187,163,162,1,1,"PODEMOS-IU",5
21,"21043",1857,1465,1424,7,41,"PODEMOS-IU",135
21,"21002",15922,11918,11773,119,145,"PODEMOS-IU",1947
18,"18122",16001,11761,11556,110,205,"PODEMOS-IU",967
14,"14012",6076,4579,4489,38,90,"PODEMOS-IU",642
14,"14064",300,231,227,6,4,"PODEMOS-IU",9
4,"4030",1066,783,776,5,7,"PODEMOS-IU",39
4,"4077",302,275,275,1,0,"PODEMOS-IU",9
21,"21068",962,562,550,14,12,"PODEMOS-IU",28
14,"14063",1000,767,757,4,10,"PODEMOS-IU",27
18,"18003",14413,11095,10883,92,212,"PODEMOS-IU",1667
23,"23025",2727,2125,2090,8,35,"PODEMOS-IU",128
18,"18127",16822,12735,12537,106,198,"PODEMOS-IU",2098
41,"41005",9250,6925,6809,69,116,"PODEMOS-IU",1154
23,"23043",518,398,397,0,1,"PODEMOS-IU",18
18,"18067",681,511,507,3,4,"PODEMOS-IU",18
18,"18082",827,587,577,5,10,"PODEMOS-IU",46
29,"29039",2728,2084,2050,14,34,"PODEMOS-IU",681
18,"18124",359,269,267,0,2,"PODEMOS-IU",15
23,"23086",11442,8618,8431,80,187,"PODEMOS-IU",1038
18,"18077",471,372,366,5,6,"PODEMOS-IU",49
23,"23050",90596,69591,68903,460,688,"PODEMOS-IU",7711
29,"29009",1441,1097,1073,8,24,"PODEMOS-IU",274
18,"18914",1657,1315,1278,5,37,"PODEMOS-IU",241
29,"29046",2540,1896,1855,13,41,"PODEMOS-IU",179
18,"18049",596,485,481,0,4,"PODEMOS-IU",57
4,"4001",1014,768,763,9,5,"PODEMOS-IU",44
41,"41034",23480,16510,16250,230,260,"PODEMOS-IU",2408
18,"18146",937,690,682,6,8,"PODEMOS-IU",67
18,"18051",1090,800,795,13,5,"PODEMOS-IU",40
14,"14062",963,753,745,4,8,"PODEMOS-IU",40
4,"4056",164,135,133,1,2,"PODEMOS-IU",8
23,"23030",1208,1022,1011,6,11,"PODEMOS-IU",31
23,"23003",8644,6604,6523,36,81,"PODEMOS-IU",336
41,"41029",13483,10357,10199,120,158,"PODEMOS-IU",1491
21,"21067",402,300,299,2,1,"PODEMOS-IU",55
23,"23084",907,685,670,0,15,"PODEMOS-IU",34
23,"23099",4822,3687,3633,28,54,"PODEMOS-IU",323
18,"18016",308,232,231,5,1,"PODEMOS-IU",15
23,"23080",1721,1370,1355,8,15,"PODEMOS-IU",74
4,"4019",232,181,179,0,2,"PODEMOS-IU",12
29,"29051",41793,29275,28764,249,511,"PODEMOS-IU",3682
41,"41076",2143,1419,1403,14,16,"PODEMOS-IU",225
14,"14016",1283,1005,994,4,11,"PODEMOS-IU",105
4,"4089",694,516,510,1,6,"PODEMOS-IU",31
4,"4065",368,287,284,2,3,"PODEMOS-IU",17
23,"23039",2154,1644,1605,6,39,"PODEMOS-IU",120
21,"21060",12235,8053,7929,93,124,"PODEMOS-IU",1022
41,"41024",22737,15687,15398,167,289,"PODEMOS-IU",1776
29,"29056",1061,783,772,4,11,"PODEMOS-IU",51
4,"4081",346,272,271,2,1,"PODEMOS-IU",16
29,"29034",467,374,373,1,1,"PODEMOS-IU",20
23,"23031",765,659,647,4,12,"PODEMOS-IU",85
23,"23101",352,273,271,0,2,"PODEMOS-IU",13
4,"4013",143321,101501,100814,750,687,"PODEMOS-IU",11253
4,"4087",156,117,116,1,1,"PODEMOS-IU",12
23,"23011",2134,1649,1614,11,35,"PODEMOS-IU",243
11,"11007",18020,11346,11152,176,194,"PODEMOS-IU",1613
23,"23082",1875,1402,1389,7,13,"PODEMOS-IU",87
29,"29091",9407,6859,6719,63,140,"PODEMOS-IU",1053
4,"4009",151,126,124,3,2,"PODEMOS-IU",10
21,"21061",5089,3358,3290,42,68,"PODEMOS-IU",173
41,"41071",5598,3993,3915,34,78,"PODEMOS-IU",808
18,"18907",1774,1426,1415,10,11,"PODEMOS-IU",87
29,"29057",341,236,233,0,3,"PODEMOS-IU",17
23,"23079",3639,2859,2818,20,41,"PODEMOS-IU",135
4,"4035",8433,6246,6196,33,50,"PODEMOS-IU",408
18,"18149",5401,4290,4212,28,78,"PODEMOS-IU",539
14,"14025",2857,2482,2436,14,46,"PODEMOS-IU",775
18,"18018",554,457,451,0,6,"PODEMOS-IU",45
4,"4023",120,95,95,2,0,"PODEMOS-IU",1
18,"18012",2143,1651,1634,8,17,"PODEMOS-IU",87
23,"23064",1678,1413,1404,10,9,"PODEMOS-IU",52
18,"18143",949,757,740,5,17,"PODEMOS-IU",193
41,"41901",2703,2242,2201,29,41,"PODEMOS-IU",221
21,"21031",1172,807,764,5,43,"PODEMOS-IU",67
23,"23055",46343,33603,33225,243,378,"PODEMOS-IU",4525
23,"23051",2727,2060,2023,5,37,"PODEMOS-IU",140
14,"14050",2352,1840,1801,11,39,"PODEMOS-IU",396
4,"4052",12767,9352,9269,90,83,"PODEMOS-IU",1119
14,"14053",5925,4442,4348,75,94,"PODEMOS-IU",667
18,"18013",4152,3168,3103,16,65,"PODEMOS-IU",304
14,"14043",7408,5721,5619,76,102,"PODEMOS-IU",559
18,"18163",315,246,241,1,5,"PODEMOS-IU",24
41,"41030",500,419,410,6,9,"PODEMOS-IU",58
29,"29082",34113,26248,26002,304,246,"PODEMOS-IU",4092
23,"23019",1479,1209,1183,3,26,"PODEMOS-IU",155
18,"18021",17869,13238,13004,110,234,"PODEMOS-IU",1987
18,"18123",288,219,219,2,0,"PODEMOS-IU",11
29,"29060",671,511,506,1,5,"PODEMOS-IU",13
41,"41058",17860,12850,12598,152,252,"PODEMOS-IU",1648
18,"18136",1782,1382,1359,12,23,"PODEMOS-IU",159
4,"4054",352,280,278,2,2,"PODEMOS-IU",20
41,"41049",9493,7463,7312,78,151,"PODEMOS-IU",1473
11,"11011",1736,1285,1249,7,36,"PODEMOS-IU",173
14,"14041",3115,2449,2376,45,73,"PODEMOS-IU",860
21,"21065",255,178,173,2,5,"PODEMOS-IU",7
23,"23063",3764,2812,2781,22,31,"PODEMOS-IU",292
21,"21077",1725,1307,1286,10,21,"PODEMOS-IU",71
18,"18180",627,442,435,4,7,"PODEMOS-IU",49
4,"4070",1545,1192,1182,7,10,"PODEMOS-IU",53
23,"23042",317,234,232,1,2,"PODEMOS-IU",12
4,"4037",1221,975,960,8,15,"PODEMOS-IU",58
23,"23012",4018,2835,2804,15,31,"PODEMOS-IU",144
29,"29002",1150,851,842,4,9,"PODEMOS-IU",85
18,"18096",344,265,265,2,0,"PODEMOS-IU",17
14,"14059",687,571,563,7,8,"PODEMOS-IU",30
4,"4051",406,343,339,1,4,"PODEMOS-IU",16
18,"18132",3124,2575,2548,17,27,"PODEMOS-IU",399
29,"29022",171,144,143,0,1,"PODEMOS-IU",26
4,"4068",174,134,134,0,0,"PODEMOS-IU",7
41,"41038",102179,76348,75425,819,923,"PODEMOS-IU",13183
14,"14045",3013,2508,2468,13,40,"PODEMOS-IU",170
41,"41093",19012,15637,15525,97,112,"PODEMOS-IU",2134
18,"18912",1367,990,984,5,6,"PODEMOS-IU",64
11,"11015",64073,43152,42713,710,439,"PODEMOS-IU",6986
41,"41010",4573,3407,3345,27,62,"PODEMOS-IU",725
29,"29089",3161,2477,2426,19,51,"PODEMOS-IU",944
41,"41085",4170,3337,3270,27,67,"PODEMOS-IU",442
29,"29100",2378,1711,1686,22,25,"PODEMOS-IU",143
11,"11001",4342,2928,2870,32,58,"PODEMOS-IU",239
14,"14047",1629,1300,1285,18,15,"PODEMOS-IU",140
29,"29090",1653,1215,1200,8,15,"PODEMOS-IU",84
21,"21056",2922,2307,2228,27,79,"PODEMOS-IU",359
4,"4053",12500,9437,9298,56,139,"PODEMOS-IU",512
29,"29007",28584,21525,21318,202,207,"PODEMOS-IU",3058
29,"29052",222,156,153,2,3,"PODEMOS-IU",12
23,"23002",17399,13575,13341,97,234,"PODEMOS-IU",1094
41,"41061",2144,1763,1712,7,51,"PODEMOS-IU",1040
41,"41077",8631,6441,6289,46,152,"PODEMOS-IU",1184
18,"18148",803,652,648,0,4,"PODEMOS-IU",40
21,"21029",1509,1183,1160,14,23,"PODEMOS-IU",85
4,"4074",2887,2062,2038,16,24,"PODEMOS-IU",218
18,"18066",2108,1537,1525,9,12,"PODEMOS-IU",242
29,"29005",4499,3202,3171,37,31,"PODEMOS-IU",284
29,"29024",372,265,250,3,15,"PODEMOS-IU",15
18,"18120",257,219,217,1,2,"PODEMOS-IU",11
18,"18121",130,104,103,3,1,"PODEMOS-IU",14
23,"23093",3131,2428,2380,22,48,"PODEMOS-IU",186
29,"29018",1996,1523,1481,11,42,"PODEMOS-IU",238
14,"14026",2014,1502,1474,10,28,"PODEMOS-IU",146
11,"11004",89545,60056,59323,741,733,"PODEMOS-IU",7321
18,"18170",324,225,224,1,1,"PODEMOS-IU",16
23,"23010",14241,10186,10015,68,171,"PODEMOS-IU",850
4,"4080",199,158,157,0,1,"PODEMOS-IU",12
18,"18030",567,448,442,4,6,"PODEMOS-IU",30
23,"23041",491,383,382,0,1,"PODEMOS-IU",14
18,"18183",624,442,441,1,1,"PODEMOS-IU",34
29,"29054",42393,30327,30108,218,219,"PODEMOS-IU",3757
41,"41066",1310,1027,1010,1,17,"PODEMOS-IU",124
18,"18023",15645,11708,11561,91,147,"PODEMOS-IU",1101
29,"29049",2926,2197,2165,9,32,"PODEMOS-IU",422
4,"4016",2128,1643,1621,4,22,"PODEMOS-IU",108
18,"18112",110,80,76,0,4,"PODEMOS-IU",9
41,"41073",1685,1172,1157,13,15,"PODEMOS-IU",114
18,"18045",1060,748,737,10,11,"PODEMOS-IU",38
4,"4902",45395,31127,30881,251,246,"PODEMOS-IU",2246
14,"14032",393,328,321,2,7,"PODEMOS-IU",11
18,"18038",1047,810,787,4,23,"PODEMOS-IU",110
41,"41042",5849,4730,4692,20,38,"PODEMOS-IU",958
14,"14013",16604,12618,12388,155,230,"PODEMOS-IU",1336
23,"23015",1332,1066,1048,4,18,"PODEMOS-IU",67
41,"41089",6629,4904,4814,48,90,"PODEMOS-IU",882
21,"21072",10227,7947,7739,98,208,"PODEMOS-IU",1189
41,"41050",5180,4217,4149,34,68,"PODEMOS-IU",528
23,"23092",27662,21206,20981,170,225,"PODEMOS-IU",2517
21,"21055",7218,5328,5215,41,113,"PODEMOS-IU",439
14,"14067",3870,3057,2998,24,59,"PODEMOS-IU",377
14,"14074",2237,1859,1839,8,20,"PODEMOS-IU",194
11,"11039",9945,6824,6726,111,98,"PODEMOS-IU",685
41,"41009",1167,820,805,4,15,"PODEMOS-IU",43
41,"41039",31500,23692,23345,234,347,"PODEMOS-IU",2478
41,"41027",3966,2830,2784,32,46,"PODEMOS-IU",509
29,"29050",398,274,269,2,5,"PODEMOS-IU",25
29,"29079",2335,1796,1765,7,31,"PODEMOS-IU",261
29,"29016",263,217,217,0,0,"PODEMOS-IU",18
4,"4904",1879,1328,1322,4,6,"PODEMOS-IU",47
23,"23018",2268,1738,1722,8,16,"PODEMOS-IU",209
4,"4021",180,146,143,0,3,"PODEMOS-IU",5
4,"4020",286,218,217,1,1,"PODEMOS-IU",2
18,"18193",14802,11165,10973,110,192,"PODEMOS-IU",1803
14,"14024",1859,1461,1418,10,43,"PODEMOS-IU",170
29,"29072",3277,2628,2592,16,36,"PODEMOS-IU",310
11,"11017",3194,2265,2221,38,44,"PODEMOS-IU",337
41,"41025",2019,1492,1439,7,53,"PODEMOS-IU",202
23,"23098",838,721,715,2,6,"PODEMOS-IU",35
4,"4088",2435,1708,1693,6,15,"PODEMOS-IU",138
23,"23026",3450,2625,2573,17,52,"PODEMOS-IU",108
23,"23075",3220,2559,2524,18,35,"PODEMOS-IU",209
41,"41095",39970,27911,27583,389,328,"PODEMOS-IU",3220
21,"21040",3181,2303,2227,21,76,"PODEMOS-IU",261
11,"11040",398,348,342,4,6,"PODEMOS-IU",16
23,"23077",611,483,479,0,4,"PODEMOS-IU",16
41,"41001",1565,1224,1213,8,11,"PODEMOS-IU",255
18,"18093",2756,1902,1885,8,17,"PODEMOS-IU",163
14,"14001",3443,2724,2675,24,49,"PODEMOS-IU",334
29,"29040",1936,1419,1395,7,24,"PODEMOS-IU",126
4,"4101",4375,3161,3112,34,49,"PODEMOS-IU",200
18,"18902",755,611,595,1,16,"PODEMOS-IU",72
18,"18167",1850,1330,1317,17,13,"PODEMOS-IU",167
21,"21007",6318,4614,4524,50,90,"PODEMOS-IU",927
41,"41002",1427,1057,1024,5,33,"PODEMOS-IU",75
14,"14056",23513,17065,16684,147,381,"PODEMOS-IU",1976
29,"29010",1632,1372,1319,4,53,"PODEMOS-IU",137
18,"18017",18148,12712,12523,96,189,"PODEMOS-IU",1394
4,"4011",2757,2171,2136,11,35,"PODEMOS-IU",240
11,"11026",4695,3656,3564,18,92,"PODEMOS-IU",353
21,"21902",1144,829,824,9,5,"PODEMOS-IU",116
4,"4102",14110,9871,9765,90,106,"PODEMOS-IU",652
14,"14028",307,258,257,0,1,"PODEMOS-IU",10
41,"41079",9293,7137,6979,80,158,"PODEMOS-IU",962
41,"41096",6134,4926,4845,44,81,"PODEMOS-IU",786
41,"41055",14804,10863,10720,79,143,"PODEMOS-IU",1301
18,"18011",4376,3286,3248,18,38,"PODEMOS-IU",454
14,"14051",1348,1064,1048,7,16,"PODEMOS-IU",45
14,"14057",6139,5054,4964,51,90,"PODEMOS-IU",1028
21,"21032",1801,1401,1378,8,23,"PODEMOS-IU",171
4,"4002",1039,798,792,7,6,"PODEMOS-IU",60
14,"14037",3182,2388,2319,22,69,"PODEMOS-IU",151
29,"29073",1645,1200,1185,13,15,"PODEMOS-IU",250
41,"41102",14750,10972,10677,110,295,"PODEMOS-IU",1612
18,"18105",3822,2688,2650,12,38,"PODEMOS-IU",333
41,"41092",7679,5668,5568,61,100,"PODEMOS-IU",601
11,"11037",5644,4567,4433,34,134,"PODEMOS-IU",2359
4,"4028",202,183,181,0,2,"PODEMOS-IU",16
4,"4003",17540,12174,12051,75,123,"PODEMOS-IU",769
23,"23029",806,651,637,0,14,"PODEMOS-IU",14
4,"4092",2789,2207,2173,6,34,"PODEMOS-IU",133
18,"18078",710,561,554,4,7,"PODEMOS-IU",97
21,"21028",370,300,293,1,7,"PODEMOS-IU",15
18,"18062",11041,8531,8355,71,176,"PODEMOS-IU",1141
23,"23091",679,575,571,3,4,"PODEMOS-IU",15
14,"14036",3676,2850,2766,40,84,"PODEMOS-IU",394
18,"18133",2109,1632,1618,12,14,"PODEMOS-IU",102
14,"14022",3886,3080,3043,18,37,"PODEMOS-IU",920
23,"23076",768,653,646,3,7,"PODEMOS-IU",35
18,"18025",279,214,212,0,2,"PODEMOS-IU",26
23,"23901",1139,946,934,3,12,"PODEMOS-IU",40
29,"29033",1089,776,761,2,15,"PODEMOS-IU",60
18,"18085",701,465,460,1,5,"PODEMOS-IU",18
11,"11006",24522,16656,16392,220,264,"PODEMOS-IU",1716
21,"21059",220,184,180,0,4,"PODEMOS-IU",20
41,"41023",7975,5918,5812,51,106,"PODEMOS-IU",690
4,"4086",1643,1226,1209,6,17,"PODEMOS-IU",49
21,"21020",353,242,236,3,6,"PODEMOS-IU",18
23,"23047",1579,1260,1247,13,13,"PODEMOS-IU",124
4,"4100",9266,6046,5988,49,58,"PODEMOS-IU",521
11,"11005",4520,3212,3128,23,84,"PODEMOS-IU",425
29,"29042",14447,10383,10199,98,184,"PODEMOS-IU",1174
18,"18138",2482,1698,1668,20,30,"PODEMOS-IU",372
4,"4064",2879,2196,2179,12,17,"PODEMOS-IU",219
4,"4036",223,188,186,1,2,"PODEMOS-IU",5
41,"41053",21618,16549,16150,194,399,"PODEMOS-IU",2423
41,"41084",2815,2177,2111,3,66,"PODEMOS-IU",225
18,"18068",1606,1293,1277,11,16,"PODEMOS-IU",194
14,"14035",5817,4373,4314,44,59,"PODEMOS-IU",242
41,"41088",512,383,377,1,6,"PODEMOS-IU",48
14,"14020",338,240,233,2,7,"PODEMOS-IU",16
41,"41080",1240,940,913,11,27,"PODEMOS-IU",78
29,"29096",2756,2061,2018,21,43,"PODEMOS-IU",308
18,"18162",929,730,719,4,11,"PODEMOS-IU",43
18,"18056",3418,2523,2478,22,45,"PODEMOS-IU",326
18,"18175",11786,8883,8730,58,153,"PODEMOS-IU",964
11,"11041",9858,6916,6763,70,153,"PODEMOS-IU",685
21,"21058",2556,1732,1709,21,23,"PODEMOS-IU",149
18,"18061",1000,827,822,1,5,"PODEMOS-IU",146
23,"23097",6356,4509,4462,17,47,"PODEMOS-IU",308
11,"11010",6351,4472,4385,140,87,"PODEMOS-IU",760
21,"21011",3473,2543,2513,14,30,"PODEMOS-IU",218
41,"41067",7227,5367,5271,56,96,"PODEMOS-IU",640
4,"4045",1704,1355,1326,12,29,"PODEMOS-IU",86
29,"29066",346,266,266,2,0,"PODEMOS-IU",46
18,"18027",2604,1902,1887,6,15,"PODEMOS-IU",369
4,"4091",326,267,266,3,1,"PODEMOS-IU",8
18,"18906",911,722,716,4,6,"PODEMOS-IU",46
4,"4093",1919,1346,1326,10,20,"PODEMOS-IU",126
4,"4076",1221,951,933,8,18,"PODEMOS-IU",72
11,"11024",6583,4774,4682,40,92,"PODEMOS-IU",651
18,"18037",528,435,426,2,9,"PODEMOS-IU",27
41,"41060",15100,11304,11105,113,199,"PODEMOS-IU",1386
23,"23057",732,613,611,4,2,"PODEMOS-IU",154
14,"14075",557,429,411,5,18,"PODEMOS-IU",37
18,"18905",15550,11394,11230,132,164,"PODEMOS-IU",1562
11,"11042",1155,870,852,7,18,"PODEMOS-IU",40
18,"18002",526,400,400,0,0,"PODEMOS-IU",12
41,"41020",12992,8679,8524,117,155,"PODEMOS-IU",1040
4,"4057",1260,970,953,10,17,"PODEMOS-IU",51
29,"29032",6657,5314,5190,30,124,"PODEMOS-IU",1075
21,"21070",6222,4413,4322,47,91,"PODEMOS-IU",842
4,"4067",520,387,379,1,8,"PODEMOS-IU",21
18,"18103",722,556,555,3,1,"PODEMOS-IU",20
21,"21022",186,132,129,0,3,"PODEMOS-IU",19
4,"4038",3110,2235,2203,23,32,"PODEMOS-IU",221
21,"21015",654,363,359,8,4,"PODEMOS-IU",48
21,"21048",313,243,237,4,6,"PODEMOS-IU",32
4,"4069",4757,3633,3588,25,45,"PODEMOS-IU",307
11,"11030",22973,16087,15853,165,234,"PODEMOS-IU",2420
4,"4901",494,381,378,0,3,"PODEMOS-IU",23
23,"23903",3499,2738,2714,7,24,"PODEMOS-IU",337
29,"29088",2694,2019,1951,31,68,"PODEMOS-IU",230
14,"14006",1321,1155,1127,4,28,"PODEMOS-IU",111
18,"18097",995,708,702,4,6,"PODEMOS-IU",89
14,"14004",1981,1522,1509,8,13,"PODEMOS-IU",98
29,"29029",380,294,287,2,7,"PODEMOS-IU",33
21,"21023",2051,1356,1332,5,24,"PODEMOS-IU",219
23,"23027",716,524,518,2,6,"PODEMOS-IU",9
18,"18071",5612,4271,4184,29,87,"PODEMOS-IU",689
29,"29097",4168,3086,3009,37,77,"PODEMOS-IU",351
29,"29055",1880,1493,1470,15,23,"PODEMOS-IU",198
4,"4029",8819,6149,6073,45,76,"PODEMOS-IU",419
23,"23048",820,644,636,1,8,"PODEMOS-IU",42
33,"33061",350,201,200,2,1,"PODEMOS-IX-",14
33,"33010",1724,1211,1202,15,9,"PODEMOS-IX-",160
33,"33035",11226,8326,8252,112,74,"PODEMOS-IX-",1258
33,"33076",12147,8532,8452,104,80,"PODEMOS-IX-",1090
33,"33032",11086,8028,7849,129,179,"PODEMOS-IX-",1592
33,"33034",10043,6765,6671,69,94,"PODEMOS-IX-",772
33,"33052",704,520,513,5,7,"PODEMOS-IX-",67
33,"33056",4877,3469,3420,30,49,"PODEMOS-IX-",471
33,"33069",3419,2557,2533,32,24,"PODEMOS-IX-",356
33,"33002",9474,6779,6662,74,117,"PODEMOS-IX-",1168
33,"33004",65515,48686,48245,511,441,"PODEMOS-IX-",9488
33,"33024",225188,169937,168490,1483,1447,"PODEMOS-IX-",30338
33,"33026",8270,5540,5474,69,66,"PODEMOS-IX-",895
33,"33066",42882,30942,30529,401,413,"PODEMOS-IX-",4963
33,"33055",1492,1156,1121,6,35,"PODEMOS-IX-",106
33,"33064",250,175,174,0,1,"PODEMOS-IX-",31
33,"33051",6811,4879,4809,63,70,"PODEMOS-IX-",564
33,"33063",374,284,283,3,1,"PODEMOS-IX-",19
33,"33047",1074,841,835,12,6,"PODEMOS-IX-",46
33,"33073",8186,5090,5023,65,67,"PODEMOS-IX-",432
33,"33044",177352,134444,133352,1391,1092,"PODEMOS-IX-",19257
33,"33074",3376,2345,2311,41,34,"PODEMOS-IX-",272
33,"33016",18904,14376,14235,168,141,"PODEMOS-IX-",2546
33,"33045",4382,3214,3156,23,58,"PODEMOS-IX-",417
33,"33020",13000,9476,9338,108,138,"PODEMOS-IX-",1846
33,"33065",1084,761,746,18,15,"PODEMOS-IX-",148
33,"33046",483,370,367,6,3,"PODEMOS-IX-",24
33,"33008",1705,1285,1273,9,12,"PODEMOS-IX-",133
33,"33003",612,373,369,6,4,"PODEMOS-IX-",32
33,"33011",10659,6448,6332,119,116,"PODEMOS-IX-",826
33,"33042",4243,3137,3103,36,34,"PODEMOS-IX-",508
33,"33062",388,250,245,9,5,"PODEMOS-IX-",25
33,"33036",11335,8356,8243,92,113,"PODEMOS-IX-",975
33,"33078",126,87,85,0,2,"PODEMOS-IX-",8
33,"33058",1664,1205,1176,5,29,"PODEMOS-IX-",288
33,"33049",6044,4152,4079,56,73,"PODEMOS-IX-",531
33,"33025",8996,6369,6309,81,60,"PODEMOS-IX-",1003
33,"33015",1428,1003,993,7,10,"PODEMOS-IX-",212
33,"33038",2234,1669,1644,16,25,"PODEMOS-IX-",350
33,"33030",873,678,671,1,7,"PODEMOS-IX-",135
33,"33071",563,413,407,2,6,"PODEMOS-IX-",24
33,"33040",4566,3205,3150,50,55,"PODEMOS-IX-",456
33,"33048",136,87,87,1,0,"PODEMOS-IX-",9
33,"33001",1504,875,864,15,11,"PODEMOS-IX-",59
33,"33057",1538,1129,1097,14,32,"PODEMOS-IX-",212
33,"33022",813,555,543,6,12,"PODEMOS-IX-",123
33,"33019",2882,1981,1939,8,42,"PODEMOS-IX-",216
33,"33077",1118,772,761,4,11,"PODEMOS-IX-",52
33,"33006",1480,1001,992,9,9,"PODEMOS-IX-",247
33,"33028",1158,635,630,6,5,"PODEMOS-IX-",61
33,"33070",3293,2499,2473,32,26,"PODEMOS-IX-",390
33,"33023",3271,2448,2397,35,51,"PODEMOS-IX-",358
33,"33067",747,608,596,9,12,"PODEMOS-IX-",84
33,"33031",33854,23523,23143,307,380,"PODEMOS-IX-",5869
33,"33037",33247,23529,23210,297,319,"PODEMOS-IX-",6018
33,"33017",2997,2096,2058,29,38,"PODEMOS-IX-",263
33,"33068",1047,624,620,8,4,"PODEMOS-IX-",57
33,"33005",1376,929,916,14,13,"PODEMOS-IX-",95
33,"33029",323,172,170,2,2,"PODEMOS-IX-",22
33,"33075",253,139,135,1,4,"PODEMOS-IX-",13
33,"33054",1611,1145,1124,8,21,"PODEMOS-IX-",138
33,"33007",1398,960,951,9,9,"PODEMOS-IX-",104
33,"33050",558,381,375,2,6,"PODEMOS-IX-",41
33,"33041",7112,5251,5194,63,57,"PODEMOS-IX-",882
33,"33072",1455,973,963,14,10,"PODEMOS-IX-",199
33,"33012",5105,3601,3566,46,35,"PODEMOS-IX-",442
33,"33043",658,462,455,4,7,"PODEMOS-IX-",47
33,"33021",4361,3098,3043,31,55,"PODEMOS-IX-",386
33,"33039",1641,1251,1243,6,8,"PODEMOS-IX-",197
33,"33027",769,505,497,14,8,"PODEMOS-IX-",71
33,"33018",2819,2072,2044,28,28,"PODEMOS-IX-",309
33,"33009",869,595,591,5,4,"PODEMOS-IX-",119
33,"33014",8771,6425,6368,51,57,"PODEMOS-IX-",1425
33,"33059",4403,3007,2942,42,65,"PODEMOS-IX-",326
33,"33053",1079,738,729,6,9,"PODEMOS-IX-",144
33,"33060",14132,9960,9794,135,166,"PODEMOS-IX-",2423
33,"33013",429,320,316,1,4,"PODEMOS-IX-",36
33,"33033",9439,6565,6468,78,97,"PODEMOS-IX-",1347
45,"45142",7800,6245,6143,67,102,"PP",1691
37,"37382",164,135,134,0,1,"PP",48
13,"13071",38130,27060,26802,237,258,"PP",4525
19,"19052",21,16,16,0,0,"PP",1
2,"2046",1132,975,953,10,22,"PP",294
42,"42020",4186,3027,2988,28,39,"PP",620
37,"37226",150,119,119,2,0,"PP",64
9,"9438",561,485,473,6,12,"PP",119
37,"37180",68,39,39,1,0,"PP",12
26,"26011",7229,5355,5277,64,78,"PP",1486
41,"41098",5152,4046,3986,24,60,"PP",910
42,"42022",206,161,161,1,0,"PP",67
43,"43158",77,61,61,1,0,"PP",2
18,"18086",339,291,289,0,2,"PP",21
41,"41019",4895,3518,3462,36,56,"PP",520
28,"28122",570,457,448,3,9,"PP",58
45,"45177",2023,1693,1651,11,42,"PP",378
9,"9392",49,41,41,0,0,"PP",9
46,"46152",87,69,69,0,0,"PP",20
19,"19216",130,100,99,1,1,"PP",24
23,"23905",1840,1358,1341,9,17,"PP",341
45,"45006",1326,983,972,6,11,"PP",184
48,"48056",989,791,785,4,6,"PP",10
46,"46067",1744,1451,1432,4,19,"PP",316
24,"24011",189,122,121,1,1,"PP",8
26,"26136",92,80,80,3,0,"PP",23
46,"46032",5692,4518,4476,22,42,"PP",712
45,"45096",987,829,813,3,16,"PP",183
35,"35022",51302,33009,32566,198,443,"PP",4461
6,"6022",2634,2156,2112,7,44,"PP",457
29,"29061",1033,840,821,5,19,"PP",112
46,"46216",5252,4291,4263,23,28,"PP",944
37,"37196",72,56,53,0,3,"PP",28
44,"44256",34,32,32,1,0,"PP",10
46,"46245",528,430,426,2,4,"PP",96
45,"45201",3620,2465,2419,10,46,"PP",314
5,"5079",68,56,56,0,0,"PP",28
47,"47082",810,679,668,8,11,"PP",250
36,"36038",66806,50974,50429,507,545,"PP",11817
20,"20030",21198,15734,15654,100,80,"PP",836
34,"34072",143,130,128,1,2,"PP",60
16,"16039",367,263,262,2,1,"PP",75
42,"42045",276,212,209,2,3,"PP",54
30,"30042",2180,1727,1703,6,24,"PP",450
9,"9447",43,40,40,0,0,"PP",15
35,"35028",10044,6188,6105,52,83,"PP",1163
49,"49098",204,157,153,2,4,"PP",82
3,"3028",964,804,795,6,9,"PP",178
6,"6029",1183,946,935,12,11,"PP",139
9,"9026",371,305,303,2,2,"PP",81
40,"40155",3835,3165,3121,43,44,"PP",514
42,"42149",387,311,308,3,3,"PP",75
26,"26176",53,48,48,0,0,"PP",22
28,"28041",4788,4012,3973,23,39,"PP",621
50,"50079",227,182,178,1,4,"PP",42
40,"40181",4166,3405,3337,21,68,"PP",587
43,"43014",14357,10596,10542,60,54,"PP",386
47,"47068",30,23,23,0,0,"PP",12
37,"37004",24,19,19,0,0,"PP",13
24,"24161",295,223,219,0,4,"PP",87
9,"9130",66,55,52,0,3,"PP",21
46,"46081",9993,7972,7882,51,90,"PP",1446
40,"40231",98,80,80,2,0,"PP",32
19,"19304",220,177,175,1,2,"PP",11
9,"9169",97,86,85,0,1,"PP",24
41,"41020",12992,8679,8524,117,155,"PP",947
4,"4058",342,256,256,0,0,"PP",42
19,"19211",356,301,300,0,1,"PP",100
22,"22126",87,66,66,0,0,"PP",30
13,"13024",891,636,628,2,8,"PP",184
37,"37069",971,721,704,2,17,"PP",187
37,"37006",117,81,81,2,0,"PP",27
50,"50086",178,121,119,2,2,"PP",15
7,"7013",7231,5372,5253,43,119,"PP",1656
14,"14060",3694,2878,2798,26,80,"PP",403
4,"4010",580,445,434,2,11,"PP",76
4,"4065",368,287,284,2,3,"PP",56
46,"46219",122,105,104,0,1,"PP",37
28,"28127",66441,56199,55932,327,267,"PP",13039
20,"20003",551,401,399,2,2,"PP",0
42,"42100",31,27,27,0,0,"PP",12
47,"47134",148,127,126,6,1,"PP",33
28,"28169",1553,1280,1273,15,7,"PP",211
37,"37050",67,54,54,0,0,"PP",24
24,"24201",1039,775,765,5,10,"PP",182
19,"19109",33,30,30,1,0,"PP",18
5,"5026",187,163,159,1,4,"PP",54
34,"34077",381,301,293,2,8,"PP",59
14,"14055",18446,13919,13711,148,208,"PP",2706
34,"34024",25,17,16,1,1,"PP",8
42,"42059",20,13,13,0,0,"PP",6
47,"47175",6704,5296,5222,52,74,"PP",908
38,"38005",5666,3795,3761,24,34,"PP",438
47,"47077",237,187,183,2,4,"PP",96
11,"11034",2331,1708,1670,17,38,"PP",225
16,"16111",163,125,122,1,3,"PP",31
6,"6066",1725,1297,1286,9,11,"PP",242
50,"50176",222,161,156,3,5,"PP",36
3,"3046",1619,1213,1190,17,23,"PP",302
37,"37215",134,97,96,3,1,"PP",25
37,"37147",172,130,127,3,3,"PP",42
10,"10090",494,364,357,6,7,"PP",100
44,"44206",103,83,82,0,1,"PP",20
49,"49078",142,113,113,1,0,"PP",43
50,"50169",336,261,259,2,2,"PP",79
26,"26087",170,136,135,3,1,"PP",53
19,"19209",41,35,34,0,1,"PP",8
28,"28064",135,110,104,1,6,"PP",25
40,"40118",47,38,37,2,1,"PP",7
40,"40168",28,22,22,0,0,"PP",8
24,"24039",1954,1563,1552,28,11,"PP",458
9,"9138",87,74,72,2,2,"PP",24
45,"45127",764,582,577,3,5,"PP",130
24,"24080",207,162,161,0,1,"PP",61
24,"24188",3820,3107,3056,33,51,"PP",837
46,"46057",474,319,313,1,6,"PP",89
47,"47152",68,59,59,0,0,"PP",14
9,"9421",242,197,196,2,1,"PP",56
37,"37213",83,65,64,0,1,"PP",28
49,"49015",201,157,155,0,2,"PP",66
18,"18163",315,246,241,1,5,"PP",67
9,"9159",61,52,51,0,1,"PP",18
46,"46110",21317,15839,15699,89,140,"PP",2438
19,"19184",62,45,45,0,0,"PP",21
34,"34074",683,545,540,4,5,"PP",167
50,"50045",1198,957,951,3,6,"PP",300
5,"5072",94,86,85,1,1,"PP",24
19,"19240",51,42,41,1,1,"PP",11
36,"36016",1064,707,696,7,11,"PP",423
3,"3045",213,178,173,4,5,"PP",50
34,"34152",125,104,101,0,3,"PP",37
28,"28086",5390,3992,3936,26,56,"PP",687
27,"27033",598,423,415,1,8,"PP",182
29,"29080",6895,5005,4934,59,71,"PP",1001
46,"46209",1901,1517,1500,5,17,"PP",299
44,"44215",168,121,120,1,1,"PP",16
49,"49107",116,82,81,1,1,"PP",24
42,"42012",29,23,23,0,0,"PP",9
19,"19197",27,22,22,0,0,"PP",4
29,"29040",1936,1419,1395,7,24,"PP",338
43,"43168",84,65,65,1,0,"PP",0
39,"39022",969,740,732,2,8,"PP",249
43,"43095",2564,1995,1984,14,11,"PP",90
3,"3015",12807,9782,9634,63,148,"PP",2262
50,"50197",96,78,78,1,0,"PP",32
45,"45116",680,547,537,4,10,"PP",130
22,"22067",71,52,52,0,0,"PP",3
18,"18032",242,180,178,2,2,"PP",43
37,"37366",41,30,30,0,0,"PP",15
37,"37152",402,308,302,1,6,"PP",116
37,"37353",122,95,95,1,0,"PP",37
3,"3901",1109,827,820,5,7,"PP",144
40,"40170",1307,1066,1054,7,12,"PP",327
9,"9151",445,358,354,3,4,"PP",83
49,"49191",266,216,214,1,2,"PP",62
37,"37376",2164,1606,1581,15,25,"PP",549
48,"48076",284,226,224,1,2,"PP",5
1,"1052",268,188,187,1,1,"PP",11
6,"6142",259,214,208,1,6,"PP",30
5,"5175",149,122,119,1,3,"PP",53
44,"44003",17,14,14,0,0,"PP",5
41,"41054",713,596,588,4,8,"PP",89
5,"5119",24,16,16,1,0,"PP",8
26,"26170",427,343,338,2,5,"PP",136
27,"27057",11097,7917,7735,88,182,"PP",2341
16,"16003",133,111,110,1,1,"PP",35
10,"10059",325,234,232,1,2,"PP",56
24,"24056",2762,2062,2013,24,49,"PP",443
9,"9243",73,57,55,0,2,"PP",16
10,"10019",1416,1120,1094,3,26,"PP",248
47,"47166",251,196,189,3,7,"PP",67
39,"39034",257,167,162,2,5,"PP",42
12,"12901",3357,2693,2675,19,18,"PP",491
10,"10905",632,491,485,4,6,"PP",111
10,"10069",785,609,596,2,13,"PP",168
20,"20062",945,727,726,3,1,"PP",16
41,"41071",5598,3993,3915,34,78,"PP",406
45,"45141",849,677,665,4,12,"PP",188
47,"47187",75,54,53,0,1,"PP",26
37,"37140",642,422,418,2,4,"PP",153
41,"41082",3359,2760,2718,11,42,"PP",348
22,"22176",170,136,135,0,1,"PP",47
18,"18087",182514,141305,139588,865,1717,"PP",32858
40,"40172",45,37,37,0,0,"PP",13
42,"42164",1589,1201,1172,10,29,"PP",278
18,"18181",202,150,148,0,2,"PP",64
5,"5053",80,57,57,2,0,"PP",31
9,"9035",284,213,210,1,3,"PP",37
5,"5060",109,88,88,0,0,"PP",50
44,"44209",815,606,592,2,14,"PP",176
7,"7021",230,183,178,3,5,"PP",53
3,"3070",2106,1554,1528,9,26,"PP",406
42,"42119",145,90,89,6,1,"PP",42
18,"18913",781,590,577,5,13,"PP",222
18,"18003",14413,11095,10883,92,212,"PP",1659
26,"26167",50,38,38,1,0,"PP",18
42,"42031",26,19,19,1,0,"PP",10
24,"24064",1515,1159,1141,11,18,"PP",200
24,"24073",442,328,324,2,4,"PP",93
26,"26141",100,73,73,0,0,"PP",41
5,"5243",81,63,62,1,1,"PP",22
6,"6045",476,368,362,3,6,"PP",83
19,"19321",34,29,29,0,0,"PP",5
47,"47116",403,321,320,3,1,"PP",110
45,"45083",551,470,465,5,5,"PP",115
24,"24099",155,121,121,1,0,"PP",49
47,"47138",219,182,177,1,5,"PP",58
37,"37348",100,79,79,0,0,"PP",38
49,"49024",637,465,461,2,4,"PP",140
49,"49094",213,138,138,0,0,"PP",55
26,"26132",106,87,87,0,0,"PP",26
47,"47019",91,74,73,0,1,"PP",27
32,"32034",1074,855,846,1,9,"PP",377
45,"45074",401,335,326,3,9,"PP",122
19,"19267",21,17,17,1,0,"PP",8
3,"3106",564,485,479,4,6,"PP",160
36,"36044",2539,1768,1708,18,60,"PP",508
1,"1003",1179,908,903,6,5,"PP",4
47,"47067",153,119,119,3,0,"PP",53
38,"38051",7326,5418,5352,27,66,"PP",977
40,"40103",146,125,123,0,2,"PP",34
9,"9480",109,87,85,1,2,"PP",33
37,"37206",91,66,63,1,3,"PP",22
46,"46207",6686,5220,5137,36,83,"PP",960
6,"6122",6562,4837,4723,43,114,"PP",922
1,"1055",840,608,602,10,6,"PP",93
9,"9127",52,45,45,1,0,"PP",25
47,"47191",115,85,84,0,1,"PP",24
19,"19217",42,38,38,0,0,"PP",13
14,"14023",2007,1734,1711,9,23,"PP",666
37,"37078",788,670,658,6,12,"PP",178
38,"38048",3957,2889,2842,12,47,"PP",543
50,"50216",240,189,181,3,8,"PP",61
46,"46131",49504,37495,37064,259,431,"PP",7313
5,"5179",199,181,175,0,6,"PP",87
42,"42195",92,53,53,1,0,"PP",24
44,"44070",55,45,45,0,0,"PP",24
49,"49006",142,111,111,1,0,"PP",38
5,"5016",6354,5090,5005,40,85,"PP",1524
9,"9219",27153,20116,19831,215,285,"PP",3309
13,"13006",572,437,430,5,7,"PP",152
2,"2042",818,631,620,1,11,"PP",123
1,"1002",8035,6227,6159,17,68,"PP",310
4,"4904",1879,1328,1322,4,6,"PP",386
26,"26172",25,23,23,0,0,"PP",5
37,"37364",757,549,536,7,13,"PP",188
22,"22016",566,423,420,4,3,"PP",71
9,"9478",45,40,40,0,0,"PP",16
38,"38026",33514,26298,26076,191,222,"PP",3243
37,"37028",137,111,107,1,4,"PP",55
19,"19195",37,29,28,2,1,"PP",5
26,"26150",100,83,83,0,0,"PP",32
19,"19222",96,73,72,2,1,"PP",23
16,"16218",187,149,148,2,1,"PP",65
34,"34028",134,110,107,3,3,"PP",48
24,"24156",220,146,144,2,2,"PP",55
10,"10098",381,310,309,1,1,"PP",88
30,"30017",11477,8952,8844,62,108,"PP",2128
46,"46133",472,374,374,2,0,"PP",84
9,"9029",144,120,118,3,2,"PP",26
45,"45064",3998,3166,3117,17,49,"PP",511
9,"9213",270,196,196,1,0,"PP",68
9,"9327",29,22,22,0,0,"PP",6
49,"49042",230,179,174,1,5,"PP",85
10,"10003",540,388,386,4,2,"PP",135
29,"29904",417,337,335,2,2,"PP",18
46,"46079",313,252,248,1,4,"PP",84
29,"29015",32064,23769,23461,213,308,"PP",4656
14,"14009",2669,1863,1844,19,19,"PP",390
39,"39051",73,65,64,0,1,"PP",16
6,"6001",659,539,534,7,5,"PP",126
5,"5061",261,214,208,0,6,"PP",32
42,"42086",33,21,19,0,2,"PP",5
5,"5132",881,634,626,2,8,"PP",197
43,"43133",5605,4202,4168,21,34,"PP",191
30,"30021",9441,6664,6591,32,73,"PP",1709
49,"49035",222,195,195,2,0,"PP",47
19,"19243",36,32,31,0,1,"PP",10
37,"37141",152,120,119,2,1,"PP",29
39,"39039",546,431,428,0,3,"PP",116
9,"9129",89,75,75,0,0,"PP",17
37,"37311",207,164,162,4,2,"PP",52
10,"10097",106,88,85,3,3,"PP",19
38,"38029",1493,839,823,5,16,"PP",124
13,"13011",4506,3111,3044,29,67,"PP",656
46,"46162",1177,954,938,4,16,"PP",228
22,"22058",191,157,157,3,0,"PP",28
5,"5180",82,61,60,0,1,"PP",40
19,"19244",74,54,54,0,0,"PP",22
50,"50195",53,42,41,0,1,"PP",11
15,"15088",3415,2349,2323,28,26,"PP",949
22,"22047",241,213,212,2,1,"PP",60
28,"28004",6564,4798,4767,26,31,"PP",857
50,"50278",177,137,137,2,0,"PP",37
9,"9444",63,43,43,2,0,"PP",25
49,"49021",14258,10333,10206,102,127,"PP",2414
36,"36004",10123,7396,7273,93,123,"PP",2072
2,"2012",1825,1541,1509,8,32,"PP",294
12,"12133",60,53,52,1,1,"PP",14
6,"6052",3969,3043,2970,21,73,"PP",782
37,"37017",222,177,177,1,0,"PP",73
9,"9001",30,27,27,0,0,"PP",9
24,"24070",3941,3007,2947,27,60,"PP",434
4,"4037",1221,975,960,8,15,"PP",225
32,"32082",1178,880,872,12,8,"PP",403
7,"7057",7404,5117,5028,50,89,"PP",1465
47,"47125",51,46,45,0,1,"PP",22
3,"3060",106,84,84,0,0,"PP",12
22,"22141",114,86,85,0,1,"PP",33
6,"6020",1739,1420,1387,5,33,"PP",292
4,"4077",302,275,275,1,0,"PP",167
40,"40173",142,122,117,1,5,"PP",23
6,"6086",1174,869,862,4,7,"PP",205
24,"24032",102,84,83,0,1,"PP",28
45,"45087",8198,6375,6281,36,94,"PP",1603
42,"42027",73,63,63,0,0,"PP",17
16,"16244",708,627,617,1,10,"PP",198
49,"49197",162,129,123,2,6,"PP",33
29,"29042",14447,10383,10199,98,184,"PP",2021
37,"37007",399,311,306,3,5,"PP",91
46,"46155",993,785,772,2,13,"PP",139
48,"48907",340,283,281,1,2,"PP",0
1,"1901",2474,1655,1631,13,24,"PP",207
39,"39101",236,173,171,1,2,"PP",24
42,"42023",60,49,48,0,1,"PP",24
14,"14024",1859,1461,1418,10,43,"PP",215
47,"47073",116,91,89,0,2,"PP",48
47,"47063",89,71,71,0,0,"PP",29
7,"7037",3357,2142,2120,16,22,"PP",346
16,"16132",34,26,26,0,0,"PP",4
13,"13093",3930,2960,2906,34,54,"PP",758
1,"1043",2337,1669,1656,18,13,"PP",256
37,"37361",81,63,61,0,2,"PP",31
26,"26052",148,113,113,1,0,"PP",48
45,"45196",1387,1099,1084,6,15,"PP",217
13,"13063",3652,2692,2649,32,43,"PP",671
37,"37144",338,275,273,1,2,"PP",94
49,"49108",454,325,322,2,3,"PP",127
16,"16009",54,49,49,0,0,"PP",25
49,"49128",533,428,424,7,4,"PP",146
44,"44007",152,120,117,0,3,"PP",44
42,"42111",279,209,208,3,1,"PP",70
16,"16093",57,47,47,0,0,"PP",15
49,"49026",201,163,162,0,1,"PP",61
50,"50276",119,91,91,1,0,"PP",18
29,"29022",171,144,143,0,1,"PP",18
29,"29077",214,158,156,1,2,"PP",19
18,"18153",8796,6686,6594,59,92,"PP",927
42,"42189",53,44,42,0,2,"PP",6
49,"49117",437,340,335,1,5,"PP",115
37,"37203",146,113,112,0,1,"PP",37
47,"47028",30,17,17,0,0,"PP",8
21,"21007",6318,4614,4524,50,90,"PP",580
19,"19215",144,121,119,0,2,"PP",55
22,"22106",20,15,15,0,0,"PP",3
47,"47164",350,290,286,2,4,"PP",95
43,"43147",521,446,442,4,4,"PP",28
44,"44130",27,24,24,0,0,"PP",13
18,"18907",1774,1426,1415,10,11,"PP",301
39,"39048",1765,1429,1420,4,9,"PP",354
18,"18108",826,677,669,3,8,"PP",129
50,"50151",603,490,489,3,1,"PP",91
46,"46246",1042,860,838,2,22,"PP",249
24,"24103",264,162,161,1,1,"PP",81
42,"42191",180,129,129,1,0,"PP",41
20,"20038",380,296,295,0,1,"PP",1
49,"49135",588,409,405,0,4,"PP",115
9,"9368",28,21,21,1,0,"PP",11
21,"21001",610,480,461,3,19,"PP",60
19,"19254",43,36,36,0,0,"PP",15
43,"43009",1391,1086,1078,3,8,"PP",23
46,"46251",2442,2017,1976,9,41,"PP",402
9,"9018",24647,18982,18715,184,267,"PP",4074
21,"21009",835,575,557,0,18,"PP",73
32,"32031",1014,764,756,5,8,"PP",381
12,"12140",1140,936,922,7,14,"PP",207
44,"44232",368,284,273,2,11,"PP",78
16,"16270",156,124,124,1,0,"PP",62
18,"18064",366,307,306,0,1,"PP",85
34,"34031",26,24,24,0,0,"PP",6
10,"10138",540,422,415,3,7,"PP",56
9,"9454",42,37,36,0,1,"PP",8
10,"10085",319,240,236,1,4,"PP",62
34,"34059",402,326,320,3,6,"PP",131
27,"27049",1342,934,921,11,13,"PP",431
48,"48004",326,261,260,3,1,"PP",0
34,"34104",233,190,189,1,1,"PP",97
50,"50222",1570,1126,1105,17,21,"PP",225
19,"19256",44,32,32,0,0,"PP",18
50,"50279",73,61,60,2,1,"PP",6
37,"37358",164,142,135,2,7,"PP",49
37,"37346",252,214,213,3,1,"PP",109
28,"28062",288,243,236,0,7,"PP",42
9,"9903",3139,2379,2352,27,27,"PP",587
22,"22035",226,174,174,0,0,"PP",22
47,"47071",398,345,341,2,4,"PP",79
22,"22124",182,148,148,1,0,"PP",34
24,"24107",214,170,170,2,0,"PP",58
9,"9298",75,62,62,1,0,"PP",25
30,"30011",4695,3665,3610,16,55,"PP",1047
49,"49039",327,255,246,6,9,"PP",60
44,"44023",18,14,14,0,0,"PP",10
4,"4094",209,156,154,0,2,"PP",78
46,"46101",816,696,687,3,9,"PP",135
18,"18174",434,362,357,0,5,"PP",54
42,"42154",99,81,81,1,0,"PP",20
44,"44155",1056,830,813,9,17,"PP",116
44,"44249",46,37,37,1,0,"PP",10
34,"34107",73,54,54,2,0,"PP",23
9,"9190",86,68,67,0,1,"PP",22
1,"1037",585,426,425,1,1,"PP",56
12,"12055",106,85,83,2,2,"PP",19
41,"41009",1167,820,805,4,15,"PP",136
44,"44055",77,58,56,0,2,"PP",21
47,"47113",142,117,117,1,0,"PP",42
46,"46213",15504,11420,11232,124,188,"PP",2174
37,"37021",69,52,51,1,1,"PP",26
22,"22036",88,76,75,0,1,"PP",28
40,"40149",486,383,376,3,7,"PP",145
18,"18079",3469,2667,2623,16,44,"PP",205
4,"4023",120,95,95,2,0,"PP",30
50,"50098",162,121,120,3,1,"PP",32
40,"40031",540,429,424,6,5,"PP",87
9,"9339",126,105,105,1,0,"PP",42
40,"40206",162,132,128,2,4,"PP",35
1,"1022",761,577,569,5,8,"PP",111
50,"50088",282,233,227,2,6,"PP",72
34,"34051",91,81,79,0,2,"PP",41
50,"50282",57,47,45,0,2,"PP",18
9,"9194",1969,1526,1511,14,15,"PP",465
46,"46211",1837,1490,1462,11,28,"PP",275
5,"5101",277,224,222,0,2,"PP",103
9,"9445",43,36,34,1,2,"PP",16
14,"14030",7797,6116,6036,54,80,"PP",786
44,"44148",76,64,63,0,1,"PP",18
47,"47161",3945,3370,3344,20,26,"PP",947
34,"34110",82,66,65,0,1,"PP",17
40,"40115",156,131,130,4,1,"PP",30
5,"5131",95,72,71,0,1,"PP",27
46,"46043",135,119,116,1,3,"PP",39
19,"19257",3283,2448,2424,21,24,"PP",767
18,"18033",279,221,220,1,1,"PP",54
18,"18101",9410,7280,7181,72,99,"PP",1245
19,"19279",51,44,44,0,0,"PP",14
5,"5041",995,776,767,3,9,"PP",289
19,"19097",14,13,13,0,0,"PP",7
47,"47158",858,672,663,8,9,"PP",114
18,"18025",279,214,212,0,2,"PP",23
38,"38022",18629,12903,12759,84,144,"PP",2121
49,"49170",98,75,75,1,0,"PP",18
37,"37024",88,69,69,0,0,"PP",29
32,"32009",10590,7661,7574,68,87,"PP",2278
12,"12058",64,56,56,0,0,"PP",24
28,"28154",5525,4283,4222,24,61,"PP",681
19,"19079",8,7,7,1,0,"PP",5
9,"9471",142,113,112,3,1,"PP",32
28,"28175",935,775,767,3,8,"PP",150
24,"24074",96,73,73,0,0,"PP",28
3,"3022",137,122,119,0,3,"PP",41
37,"37037",107,86,86,0,0,"PP",30
37,"37312",244,198,197,1,1,"PP",87
40,"40152",748,637,620,6,17,"PP",154
42,"42144",423,338,336,4,2,"PP",102
47,"47003",204,171,168,4,3,"PP",71
49,"49172",481,316,310,2,6,"PP",183
26,"26057",51,47,47,1,0,"PP",16
28,"28903",35344,30490,30287,201,203,"PP",5058
50,"50172",178,134,131,3,3,"PP",38
1,"1058",1403,958,951,4,7,"PP",44
44,"44032",17,13,13,0,0,"PP",1
14,"14053",5925,4442,4348,75,94,"PP",705
29,"29086",774,537,532,1,5,"PP",111
18,"18148",803,652,648,0,4,"PP",220
50,"50051",800,615,608,3,7,"PP",167
44,"44075",326,275,263,0,12,"PP",111
44,"44006",223,171,169,2,2,"PP",46
29,"29045",1681,1263,1242,9,21,"PP",286
44,"44042",114,84,84,0,0,"PP",31
10,"10041",1025,840,825,6,15,"PP",244
50,"50064",438,368,362,1,6,"PP",98
19,"19179",76,66,64,1,2,"PP",16
10,"10136",285,223,223,1,0,"PP",54
9,"9022",61,54,54,0,0,"PP",20
43,"43016",3445,2628,2608,11,20,"PP",88
44,"44052",74,50,49,0,1,"PP",24
49,"49027",126,88,88,0,0,"PP",45
15,"15042",2955,2057,2002,16,55,"PP",767
5,"5124",92,71,70,1,1,"PP",40
49,"49055",95,83,83,1,0,"PP",24
5,"5112",95,66,64,2,2,"PP",25
2,"2031",541,432,425,0,7,"PP",119
49,"49149",365,285,282,2,3,"PP",119
46,"46037",1109,927,918,4,9,"PP",173
19,"19002",57,45,45,0,0,"PP",14
42,"42098",9,8,8,0,0,"PP",2
43,"43156",3956,2993,2965,23,28,"PP",203
39,"39059",7577,5978,5916,47,62,"PP",1485
28,"28116",759,621,618,7,3,"PP",97
5,"5100",267,217,212,1,5,"PP",63
34,"34012",340,271,265,2,6,"PP",95
44,"44153",1749,1264,1243,11,21,"PP",303
50,"50115",3275,2399,2355,32,44,"PP",474
44,"44034",126,97,97,2,0,"PP",32
44,"44064",63,49,48,0,1,"PP",21
9,"9369",422,328,325,8,3,"PP",84
42,"42117",133,109,106,0,3,"PP",34
46,"46129",512,408,400,4,8,"PP",64
4,"4033",125,98,95,0,3,"PP",16
1,"1019",148,121,121,0,0,"PP",13
47,"47153",104,76,75,0,1,"PP",36
34,"34170",51,35,35,0,0,"PP",18
43,"43165",572,492,492,1,0,"PP",8
12,"12036",546,428,420,9,8,"PP",114
45,"45034",1291,1066,1039,7,27,"PP",248
22,"22184",168,142,139,2,3,"PP",49
19,"19078",50,38,37,0,1,"PP",2
2,"2010",1798,1494,1469,6,25,"PP",405
47,"47217",1973,1569,1541,19,28,"PP",278
50,"50185",136,103,102,0,1,"PP",15
13,"13010",881,680,666,4,14,"PP",210
37,"37088",199,151,149,1,2,"PP",58
9,"9208",179,130,127,1,3,"PP",56
19,"19314",45,38,38,1,0,"PP",12
24,"24217",133,106,105,1,1,"PP",42
50,"50048",33,25,25,0,0,"PP",2
9,"9078",37,31,31,0,0,"PP",9
46,"46192",790,599,586,8,13,"PP",85
2,"2072",1525,1146,1112,4,34,"PP",245
19,"19229",57,52,52,0,0,"PP",18
18,"18138",2482,1698,1668,20,30,"PP",180
50,"50177",276,226,223,0,3,"PP",77
43,"43110",251,184,184,1,0,"PP",5
14,"14041",3115,2449,2376,45,73,"PP",212
26,"26088",41,38,38,0,0,"PP",16
13,"13058",4050,3188,3128,24,60,"PP",837
29,"29096",2756,2061,2018,21,43,"PP",259
28,"28172",9751,7994,7928,38,66,"PP",1257
32,"32090",738,530,525,3,5,"PP",132
18,"18162",929,730,719,4,11,"PP",177
20,"20002",355,258,257,8,1,"PP",2
26,"26169",68,61,61,2,0,"PP",17
37,"37061",207,160,160,0,0,"PP",65
18,"18175",11786,8883,8730,58,153,"PP",1437
22,"22187",294,244,243,2,1,"PP",44
3,"3049",12143,9418,9302,47,116,"PP",2357
15,"15016",4569,3171,3146,18,25,"PP",908
6,"6089",608,524,519,3,5,"PP",101
11,"11025",4388,3092,3045,30,47,"PP",482
46,"46093",2134,1700,1687,8,13,"PP",442
46,"46224",154,124,124,2,0,"PP",33
41,"41029",13483,10357,10199,120,158,"PP",1408
12,"12125",222,189,187,0,2,"PP",62
13,"13055",615,475,465,5,10,"PP",97
12,"12902",2248,1678,1653,7,25,"PP",419
9,"9003",184,143,142,2,1,"PP",31
28,"28167",8608,7086,7015,48,71,"PP",804
10,"10036",306,240,237,2,3,"PP",48
6,"6046",1250,1010,995,7,15,"PP",256
38,"38042",3781,2799,2774,11,25,"PP",458
9,"9229",183,136,136,2,0,"PP",48
18,"18105",3822,2688,2650,12,38,"PP",238
22,"22229",108,80,80,2,0,"PP",12
6,"6131",1063,880,874,5,6,"PP",63
42,"42124",58,41,41,0,0,"PP",13
16,"16205",107,80,79,0,1,"PP",30
1,"1056",205,134,134,0,0,"PP",14
12,"12117",3545,2770,2698,11,72,"PP",574
50,"50246",38,28,28,0,0,"PP",11
3,"3011",8014,5870,5810,38,60,"PP",931
42,"42110",55,43,43,0,0,"PP",20
29,"29031",1559,1139,1113,13,26,"PP",101
26,"26161",8,7,7,0,0,"PP",6
3,"3125",336,259,257,1,2,"PP",64
49,"49012",73,45,45,0,0,"PP",15
47,"47159",831,703,693,0,10,"PP",213
10,"10038",83,70,69,0,1,"PP",27
15,"15082",15381,11803,11642,133,161,"PP",2904
48,"48081",1883,1532,1518,3,14,"PP",38
49,"49081",1322,1051,1030,11,21,"PP",245
38,"38003",1510,1058,1047,4,11,"PP",137
24,"24181",1414,1067,1055,14,12,"PP",315
41,"41051",2311,1770,1734,5,36,"PP",329
10,"10012",564,469,464,1,5,"PP",90
27,"27055",1197,857,851,2,6,"PP",332
40,"40034",75,63,62,1,1,"PP",23
18,"18178",671,535,532,0,3,"PP",143
19,"19193",23,20,20,0,0,"PP",3
37,"37249",38,28,28,0,0,"PP",13
24,"24115",53267,39733,39172,433,561,"PP",7666
19,"19064",64,56,56,0,0,"PP",25
18,"18068",1606,1293,1277,11,16,"PP",289
12,"12094",875,694,682,2,12,"PP",74
16,"16064",651,575,569,4,6,"PP",193
47,"47099",155,135,133,0,2,"PP",44
46,"46117",500,407,399,1,8,"PP",81
32,"32020",2460,1899,1876,6,23,"PP",1019
22,"22221",90,58,56,0,2,"PP",13
23,"23028",6131,4696,4635,24,61,"PP",873
38,"38035",10384,6657,6596,50,61,"PP",883
22,"22063",159,133,132,2,1,"PP",24
5,"5239",231,177,174,1,3,"PP",41
42,"42129",678,540,539,1,1,"PP",138
13,"13066",2604,2182,2146,6,36,"PP",638
18,"18168",781,613,604,6,9,"PP",89
27,"27901",2275,1542,1531,27,11,"PP",683
43,"43171",14705,11002,10956,62,46,"PP",570
24,"24198",547,402,399,4,3,"PP",55
42,"42115",95,77,77,1,0,"PP",31
43,"43163",26013,18942,18796,89,146,"PP",995
46,"46108",426,346,342,1,4,"PP",97
48,"48054",24938,19329,19197,124,132,"PP",1427
42,"42176",27,22,22,2,0,"PP",7
12,"12018",283,242,235,0,7,"PP",63
37,"37101",142,119,117,0,2,"PP",56
10,"10043",754,578,572,3,6,"PP",109
26,"26084",7187,5620,5558,36,62,"PP",1366
42,"42097",14,7,7,0,0,"PP",1
26,"26125",2663,2042,2011,32,31,"PP",583
15,"15075",12785,9638,9519,121,119,"PP",2115
49,"49150",123,90,90,3,0,"PP",35
43,"43148",90763,69756,69423,299,333,"PP",4755
29,"29903",493,358,354,6,4,"PP",57
34,"34184",49,39,38,0,1,"PP",25
19,"19241",35,24,23,2,1,"PP",12
43,"43026",765,614,613,3,1,"PP",20
48,"48085",10637,8270,8223,54,47,"PP",270
16,"16110",91,80,80,0,0,"PP",43
40,"40145",1105,906,899,2,7,"PP",237
42,"42043",3838,2897,2855,18,42,"PP",851
38,"38017",30646,18576,18373,100,203,"PP",2348
26,"26152",27,23,23,1,0,"PP",7
42,"42198",19,15,15,0,0,"PP",6
28,"28031",2140,1642,1614,11,28,"PP",395
13,"13076",461,377,369,0,8,"PP",145
42,"42208",20,16,16,0,0,"PP",6
50,"50261",205,171,167,1,4,"PP",18
21,"21040",3181,2303,2227,21,76,"PP",373
5,"5076",473,417,413,7,4,"PP",118
10,"10167",307,238,237,1,1,"PP",90
26,"26113",31,30,30,0,0,"PP",24
24,"24162",1772,1382,1369,22,13,"PP",243
49,"49075",134,118,114,1,4,"PP",51
37,"37318",199,152,152,1,0,"PP",53
24,"24028",365,297,290,2,7,"PP",77
7,"7044",8791,6335,6196,66,139,"PP",1379
16,"16029",102,81,81,1,0,"PP",15
22,"22239",88,71,71,0,0,"PP",28
49,"49088",82,59,59,0,0,"PP",34
48,"48087",432,357,356,0,1,"PP",22
15,"15056",5648,4033,3979,39,54,"PP",1282
12,"12105",816,639,625,5,14,"PP",246
2,"2060",1280,1039,1020,5,19,"PP",360
22,"22139",78,60,60,0,0,"PP",33
16,"16113",3067,2416,2383,15,33,"PP",649
37,"37218",48,29,29,0,0,"PP",16
38,"38030",1945,1430,1420,6,10,"PP",184
3,"3090",17881,13593,13437,108,156,"PP",2299
42,"42196",8,6,6,0,0,"PP",6
39,"39052",18957,15123,14985,106,138,"PP",3007
43,"43028",2766,2007,1988,7,19,"PP",63
42,"42155",142,92,92,0,0,"PP",49
38,"38020",15899,11057,10924,90,133,"PP",1476
46,"46021",23977,18032,17879,125,153,"PP",2349
45,"45008",142,121,121,0,0,"PP",46
44,"44239",22,19,19,0,0,"PP",10
14,"14032",393,328,321,2,7,"PP",104
47,"47020",272,228,225,5,3,"PP",81
34,"34080",5291,3802,3728,35,74,"PP",1020
9,"9395",122,95,94,0,1,"PP",41
42,"42048",60,50,50,0,0,"PP",23
50,"50160",2150,1652,1619,14,33,"PP",258
50,"50270",38,32,30,1,2,"PP",7
24,"24071",967,755,741,7,14,"PP",193
19,"19238",44,30,30,1,0,"PP",9
28,"28120",1209,991,974,3,17,"PP",171
2,"2086",2426,1738,1728,8,10,"PP",467
39,"39082",1622,1261,1252,16,9,"PP",402
19,"19160",905,618,613,3,5,"PP",98
38,"38011",21563,15380,15214,69,166,"PP",2106
15,"15049",1091,805,796,8,9,"PP",330
28,"28056",914,715,703,4,12,"PP",123
41,"41031",1215,866,848,3,18,"PP",99
10,"10010",2213,1499,1470,6,29,"PP",293
9,"9266",103,85,85,0,0,"PP",26
46,"46023",328,277,269,1,8,"PP",53
2,"2002",435,358,352,2,6,"PP",113
20,"20054",459,313,312,1,1,"PP",0
32,"32037",681,534,523,6,11,"PP",260
21,"21033",561,428,427,4,1,"PP",41
10,"10037",76855,60447,59702,451,745,"PP",13305
9,"9398",74,59,58,1,1,"PP",23
34,"34216",60,46,46,0,0,"PP",30
27,"27023",2470,1833,1797,20,36,"PP",939
34,"34068",29,24,23,0,1,"PP",11
4,"4091",326,267,266,3,1,"PP",30
42,"42050",27,21,21,1,0,"PP",9
47,"47104",2836,2339,2267,23,72,"PP",708
37,"37373",700,522,514,0,8,"PP",90
9,"9056",4812,3585,3533,36,52,"PP",878
19,"19281",18,17,17,3,0,"PP",3
45,"45120",121,96,96,0,0,"PP",20
47,"47212",358,312,311,3,1,"PP",96
2,"2016",538,405,401,4,4,"PP",106
19,"19264",34,28,28,0,0,"PP",5
46,"46106",1466,1156,1142,3,14,"PP",250
22,"22077",362,301,293,3,8,"PP",65
50,"50101",832,625,614,1,11,"PP",119
43,"43080",227,195,195,0,0,"PP",6
39,"39029",636,512,512,5,0,"PP",128
39,"39056",2268,1847,1830,7,17,"PP",404
16,"16209",111,97,97,0,0,"PP",34
45,"45056",2300,1526,1501,8,25,"PP",225
41,"41026",4300,3561,3521,18,40,"PP",157
37,"37175",404,321,319,8,2,"PP",132
24,"24077",215,178,178,0,0,"PP",58
44,"44074",444,353,346,3,7,"PP",112
50,"50092",300,234,230,1,4,"PP",51
12,"12101",356,297,289,2,8,"PP",71
18,"18145",10869,8532,8405,69,127,"PP",1413
4,"4017",1276,907,900,4,7,"PP",196
19,"19283",32,26,26,0,0,"PP",7
19,"19016",57,40,40,0,0,"PP",6
47,"47045",734,601,590,5,11,"PP",109
30,"30038",15674,11755,11675,59,80,"PP",2611
44,"44183",63,43,43,0,0,"PP",7
42,"42148",9,9,9,0,0,"PP",6
19,"19299",102,78,78,1,0,"PP",21
15,"15001",4689,3422,3362,52,60,"PP",1083
50,"50220",43,37,37,0,0,"PP",4
42,"42015",32,23,23,1,0,"PP",8
2,"2056",1643,1330,1308,4,22,"PP",368
40,"40083",72,53,51,3,2,"PP",27
19,"19017",57,50,49,0,1,"PP",22
19,"19196",90,77,70,1,7,"PP",18
47,"47225",74,61,60,0,1,"PP",23
42,"42131",52,37,37,0,0,"PP",19
2,"2020",431,359,356,3,3,"PP",114
24,"24079",872,671,665,4,6,"PP",225
40,"40224",19,16,16,0,0,"PP",10
18,"18193",14802,11165,10973,110,192,"PP",1744
37,"37228",325,278,273,0,5,"PP",92
18,"18122",16001,11761,11556,110,205,"PP",2317
19,"19119",75,68,66,2,2,"PP",15
15,"15065",7151,5281,5165,63,116,"PP",1559
18,"18020",501,365,358,2,7,"PP",56
16,"16083",45,29,28,0,1,"PP",6
5,"5190",53,47,47,1,0,"PP",16
49,"49176",610,426,426,4,0,"PP",265
46,"46241",389,318,313,4,5,"PP",51
13,"13085",2287,1911,1885,13,26,"PP",532
45,"45157",2261,1627,1603,8,24,"PP",356
16,"16189",262,220,220,1,0,"PP",69
46,"46184",26453,21076,20810,172,266,"PP",3105
48,"48055",2596,2023,2005,12,18,"PP",47
19,"19287",136,107,105,3,2,"PP",37
45,"45004",552,434,434,4,0,"PP",121
50,"50085",183,136,136,1,0,"PP",48
38,"38008",5658,4126,4056,19,70,"PP",817
37,"37117",1553,1245,1230,14,15,"PP",234
26,"26013",323,258,256,1,2,"PP",74
5,"5191",124,105,105,0,0,"PP",19
4,"4021",180,146,143,0,3,"PP",49
6,"6902",1663,1273,1252,4,21,"PP",251
16,"16272",199,162,161,1,1,"PP",63
50,"50137",964,790,781,9,9,"PP",212
3,"3007",169,145,141,0,4,"PP",18
18,"18054",838,649,648,8,1,"PP",157
32,"32061",1070,862,855,8,7,"PP",399
10,"10060",935,670,658,4,12,"PP",147
24,"24175",1831,1433,1412,17,21,"PP",327
26,"26014",447,313,309,2,4,"PP",79
44,"44146",170,148,146,3,2,"PP",34
49,"49090",193,153,151,0,2,"PP",55
16,"16273",303,236,231,2,5,"PP",92
46,"46243",124,105,104,0,1,"PP",32
37,"37119",95,78,77,0,1,"PP",16
16,"16170",653,514,500,3,14,"PP",131
4,"4051",406,343,339,1,4,"PP",92
44,"44027",149,120,119,0,1,"PP",31
34,"34158",286,194,194,0,0,"PP",48
2,"2085",309,264,263,4,1,"PP",81
47,"47081",41,36,36,0,0,"PP",5
22,"22099",465,365,362,3,3,"PP",83
1,"1054",1013,729,726,2,3,"PP",29
24,"24097",204,155,155,7,0,"PP",77
39,"39043",1523,1246,1220,10,26,"PP",430
28,"28055",907,671,666,5,5,"PP",160
48,"48089",3463,2746,2732,10,14,"PP",97
44,"44059",550,446,437,7,9,"PP",150
24,"24139",2087,1558,1540,20,18,"PP",496
3,"3009",46121,36093,35720,235,373,"PP",4728
37,"37031",336,261,258,3,3,"PP",104
26,"26166",147,136,136,2,0,"PP",59
43,"43070",238,194,193,1,1,"PP",4
46,"46103",1338,1056,1042,5,14,"PP",227
12,"12116",67,57,57,0,0,"PP",22
13,"13091",544,485,476,4,9,"PP",213
26,"26171",156,131,127,0,4,"PP",58
5,"5221",323,249,244,1,5,"PP",59
29,"29019",864,687,679,7,8,"PP",146
32,"32017",1202,821,815,6,6,"PP",412
9,"9104",47,39,39,0,0,"PP",23
22,"22102",181,153,151,1,2,"PP",38
46,"46114",574,457,452,1,5,"PP",134
9,"9054",89,69,68,1,1,"PP",23
40,"40151",43,32,32,0,0,"PP",16
10,"10023",791,619,614,1,5,"PP",133
41,"41003",2371,1801,1760,8,41,"PP",426
50,"50161",103,80,80,0,0,"PP",37
34,"34246",69,53,53,0,0,"PP",22
45,"45164",172,143,143,1,0,"PP",56
7,"7025",446,363,362,4,1,"PP",117
15,"15091",1103,773,758,16,15,"PP",288
43,"43104",1762,1410,1401,5,9,"PP",13
2,"2064",374,318,315,3,3,"PP",83
42,"42024",86,66,66,3,0,"PP",24
20,"20075",4346,3158,3134,19,24,"PP",103
50,"50081",491,390,384,5,6,"PP",112
37,"37161",121,88,88,0,0,"PP",43
45,"45059",1696,1442,1415,4,27,"PP",405
34,"34179",26,20,19,0,1,"PP",12
49,"49200",936,744,726,10,18,"PP",230
10,"10066",161,141,137,0,4,"PP",36
10,"10093",393,313,303,4,10,"PP",41
5,"5264",57,40,38,1,2,"PP",13
18,"18905",15550,11394,11230,132,164,"PP",1575
37,"37124",196,153,153,2,0,"PP",43
24,"24101",384,285,283,4,2,"PP",51
10,"10189",2527,1958,1907,12,51,"PP",375
9,"9039",56,44,44,0,0,"PP",25
50,"50257",163,136,134,1,2,"PP",21
45,"45071",1802,1488,1465,0,23,"PP",327
40,"40161",35,28,26,0,2,"PP",14
2,"2079",2823,2303,2253,22,50,"PP",371
9,"9025",108,73,72,0,1,"PP",26
43,"43130",177,145,145,0,0,"PP",8
16,"16081",49,42,42,0,0,"PP",9
26,"26149",45,36,36,0,0,"PP",7
37,"37339",308,227,226,0,1,"PP",84
44,"44258",53,44,44,0,0,"PP",21
50,"50055",3627,2627,2571,41,56,"PP",500
43,"43065",382,308,304,1,4,"PP",8
19,"19181",55,47,46,1,1,"PP",15
37,"37351",269,234,233,6,1,"PP",74
45,"45031",2824,2104,2068,20,36,"PP",431
16,"16011",23,18,18,0,0,"PP",4
10,"10068",711,576,556,2,20,"PP",167
36,"36035",14571,11096,10917,105,179,"PP",2668
50,"50230",1134,853,846,6,7,"PP",184
18,"18134",6069,4431,4345,30,86,"PP",706
24,"24226",193,136,134,2,2,"PP",59
39,"39011",1575,1249,1242,3,7,"PP",371
49,"49111",121,100,100,3,0,"PP",53
39,"39095",2240,1809,1778,12,31,"PP",382
50,"50249",284,229,227,1,2,"PP",59
39,"39077",236,175,173,0,2,"PP",62
43,"43123",71092,53689,53369,241,320,"PP",2972
13,"13038",1604,1251,1216,14,35,"PP",287
22,"22167",473,392,384,4,8,"PP",115
46,"46200",1848,1560,1539,6,21,"PP",327
6,"6041",457,381,374,5,7,"PP",83
38,"38037",12803,8628,8517,48,111,"PP",1895
42,"42163",46,37,37,0,0,"PP",10
24,"24105",1498,1188,1177,18,11,"PP",233
49,"49112",118,78,78,2,0,"PP",28
24,"24228",626,432,426,3,6,"PP",159
45,"45171",1326,1032,1013,6,19,"PP",250
10,"10193",1412,1158,1145,4,13,"PP",295
37,"37241",164,129,127,0,2,"PP",66
3,"3140",26027,19805,19438,230,367,"PP",3398
9,"9046",24,19,19,0,0,"PP",7
35,"35011",24705,17099,16823,129,276,"PP",2591
19,"19183",71,61,59,0,2,"PP",15
6,"6008",613,540,532,0,8,"PP",89
21,"21064",6641,4689,4597,66,92,"PP",689
12,"12122",767,655,646,3,9,"PP",261
19,"19270",25,21,21,0,0,"PP",9
14,"14040",3755,3047,3006,21,41,"PP",421
26,"26001",198,171,165,1,6,"PP",54
48,"48015",33109,24697,24475,161,222,"PP",1703
37,"37129",252,206,202,2,4,"PP",61
39,"39014",901,709,704,5,5,"PP",140
9,"9098",477,372,360,4,12,"PP",105
15,"15014",3836,2739,2698,38,41,"PP",1035
26,"26101",34,27,27,0,0,"PP",8
19,"19271",41,26,26,0,0,"PP",18
43,"43043",3289,2624,2613,14,11,"PP",113
5,"5206",29,21,20,1,1,"PP",5
37,"37008",4222,3431,3393,19,38,"PP",1046
37,"37280",71,41,40,0,1,"PP",25
3,"3017",379,321,311,1,10,"PP",29
10,"10020",1576,1259,1225,9,34,"PP",283
12,"12085",5079,3504,3459,13,45,"PP",733
10,"10033",403,306,302,6,4,"PP",117
26,"26142",784,651,641,5,10,"PP",227
10,"10115",3488,2878,2816,15,62,"PP",684
50,"50262",1163,930,912,15,18,"PP",122
21,"21054",8157,6002,5869,60,133,"PP",1715
39,"39024",1815,1436,1420,14,16,"PP",325
16,"16906",71,52,52,1,0,"PP",21
9,"9135",40,34,34,0,0,"PP",16
50,"50129",213,151,149,5,2,"PP",29
29,"29051",41793,29275,28764,249,511,"PP",5624
10,"10117",243,156,154,1,2,"PP",29
12,"12034",1400,1108,1080,7,28,"PP",206
21,"21030",1879,1523,1504,14,19,"PP",348
30,"30023",3875,3107,3068,20,39,"PP",676
3,"3040",258,223,217,1,6,"PP",59
16,"16908",163,135,133,0,2,"PP",19
10,"10198",1071,945,924,3,21,"PP",402
26,"26028",139,120,117,1,3,"PP",54
9,"9102",33,26,25,0,1,"PP",9
45,"45039",208,176,176,0,0,"PP",48
24,"24177",472,330,326,3,4,"PP",111
37,"37309",37,27,27,0,0,"PP",10
9,"9103",200,179,179,1,0,"PP",67
37,"37170",1370,1009,990,10,19,"PP",331
16,"16243",379,323,318,5,5,"PP",108
24,"24031",210,180,176,0,4,"PP",58
9,"9052",29,17,17,1,0,"PP",7
22,"22001",214,162,162,0,0,"PP",64
29,"29008",15183,10716,10555,93,161,"PP",2365
37,"37297",401,319,315,2,4,"PP",117
23,"23066",4299,3603,3545,13,58,"PP",941
9,"9123",43,39,38,0,1,"PP",13
24,"24060",574,371,369,1,2,"PP",106
41,"41030",500,419,410,6,9,"PP",46
10,"10064",1409,1103,1072,6,31,"PP",347
50,"50052",85,64,64,0,0,"PP",35
37,"37122",203,174,174,1,0,"PP",46
15,"15018",1087,771,761,8,10,"PP",164
37,"37235",219,170,166,4,4,"PP",40
26,"26018",10441,8400,8311,64,89,"PP",1858
19,"19027",131,98,96,0,2,"PP",23
5,"5055",540,448,445,1,3,"PP",189
3,"3082",12936,9025,8931,57,94,"PP",1561
24,"24194",266,199,199,1,0,"PP",17
44,"44010",184,137,137,1,0,"PP",36
12,"12099",586,449,434,3,15,"PP",119
6,"6114",127,109,108,0,1,"PP",17
34,"34025",53,37,37,2,0,"PP",17
6,"6103",4753,3656,3598,35,58,"PP",628
34,"34039",62,49,49,0,0,"PP",37
39,"39009",3307,2545,2526,11,19,"PP",537
50,"50228",250,217,214,3,3,"PP",78
49,"49243",109,86,83,0,3,"PP",30
22,"22025",1035,764,755,24,9,"PP",166
43,"43146",41,35,35,0,0,"PP",1
36,"36013",2242,1468,1452,15,16,"PP",594
6,"6148",957,762,746,12,16,"PP",102
37,"37286",203,147,142,2,5,"PP",26
43,"43007",640,510,509,0,1,"PP",12
40,"40177",140,114,113,1,1,"PP",55
6,"6050",4042,3246,3163,27,83,"PP",923
6,"6017",257,211,210,1,1,"PP",70
41,"41089",6629,4904,4814,48,90,"PP",487
2,"2078",899,705,691,3,14,"PP",125
9,"9348",133,105,104,0,1,"PP",46
43,"43073",84,68,67,0,1,"PP",0
44,"44012",310,240,238,5,2,"PP",73
42,"42219",40,33,32,1,1,"PP",13
41,"41033",4965,3634,3580,27,54,"PP",530
50,"50153",922,705,704,6,1,"PP",114
10,"10082",1810,1495,1476,9,19,"PP",253
23,"23005",29940,19587,19330,191,257,"PP",4063
32,"32049",689,468,462,3,6,"PP",196
19,"19239",91,64,63,1,1,"PP",19
16,"16150",94,75,75,1,0,"PP",22
6,"6083",46489,34360,33989,270,371,"PP",5400
13,"13067",342,298,295,0,3,"PP",67
47,"47066",1407,1131,1122,11,9,"PP",238
12,"12040",118683,91285,90499,666,786,"PP",16302
49,"49123",532,406,402,2,4,"PP",122
50,"50093",83,66,66,1,0,"PP",17
5,"5059",92,63,63,0,0,"PP",11
2,"2080",499,409,400,0,9,"PP",99
12,"12041",100,76,75,0,1,"PP",32
18,"18007",741,533,527,6,6,"PP",99
49,"49004",111,77,77,4,0,"PP",22
24,"24132",615,405,404,5,1,"PP",116
6,"6085",3410,2719,2663,28,56,"PP",325
21,"21038",1076,786,771,8,15,"PP",197
38,"38016",1178,654,648,6,6,"PP",120
46,"46139",4512,3612,3567,25,45,"PP",827
42,"42178",101,75,75,0,0,"PP",34
43,"43173",99,80,78,0,2,"PP",1
9,"9439",1054,867,851,8,16,"PP",151
40,"40004",445,348,341,0,7,"PP",94
16,"16026",93,70,68,1,2,"PP",21
1,"1033",656,533,525,1,8,"PP",78
9,"9014",192,143,142,0,1,"PP",45
10,"10126",1470,1114,1104,7,10,"PP",365
47,"47194",292,245,243,1,2,"PP",52
12,"12103",90,75,70,1,5,"PP",29
19,"19335",56,45,43,0,2,"PP",13
40,"40005",25,21,21,0,0,"PP",14
45,"45051",1634,1336,1290,9,46,"PP",273
9,"9206",55,47,47,1,0,"PP",20
16,"16014",563,444,443,4,1,"PP",109
43,"43125",890,700,698,12,2,"PP",42
4,"4049",5603,4104,4054,27,50,"PP",852
44,"44207",130,101,101,1,0,"PP",25
39,"39023",6523,5205,5144,22,61,"PP",983
19,"19901",36,32,32,0,0,"PP",9
37,"37059",117,106,100,0,6,"PP",30
47,"47228",439,353,352,1,1,"PP",101
28,"28138",63,49,49,0,0,"PP",13
38,"38049",2683,1781,1743,18,38,"PP",301
15,"15025",1000,639,631,6,8,"PP",270
6,"6120",3373,2757,2719,10,38,"PP",570
9,"9117",71,55,53,0,2,"PP",26
15,"15087",5692,3883,3838,53,45,"PP",1166
19,"19199",19,17,16,0,1,"PP",1
46,"46172",5412,3878,3832,18,46,"PP",678
2,"2084",305,221,215,1,6,"PP",47
21,"21005",15697,9910,9778,72,132,"PP",1437
44,"44208",26,22,22,0,0,"PP",6
9,"9338",231,193,189,2,4,"PP",29
19,"19006",757,556,548,7,8,"PP",92
9,"9191",33,24,24,0,0,"PP",13
7,"7056",5245,3883,3841,32,42,"PP",590
34,"34001",39,32,32,3,0,"PP",8
49,"49141",296,220,218,0,2,"PP",55
50,"50224",65,54,54,1,0,"PP",22
26,"26155",149,119,119,0,0,"PP",50
23,"23010",14241,10186,10015,68,171,"PP",1960
34,"34140",96,69,69,1,0,"PP",30
47,"47010",14572,12316,12186,102,130,"PP",1961
50,"50060",170,137,135,2,2,"PP",24
14,"14012",6076,4579,4489,38,90,"PP",829
9,"9280",27,22,22,0,0,"PP",12
43,"43127",759,630,626,3,4,"PP",15
36,"36051",14315,10396,10223,70,173,"PP",3390
49,"49251",161,125,124,0,1,"PP",40
47,"47157",495,428,426,3,2,"PP",102
6,"6112",383,334,334,1,0,"PP",77
3,"3123",7576,5900,5814,36,86,"PP",1179
39,"39054",4528,3614,3575,23,39,"PP",564
24,"24006",487,393,387,3,6,"PP",127
28,"28005",136050,108267,107316,772,951,"PP",16988
34,"34096",50,44,44,0,0,"PP",11
5,"5247",227,182,177,1,5,"PP",66
6,"6157",397,296,292,1,4,"PP",80
37,"37092",1889,1459,1447,16,12,"PP",259
16,"16117",1022,822,809,6,13,"PP",198
50,"50207",93,68,67,2,1,"PP",14
47,"47221",100,84,83,1,1,"PP",35
22,"22142",94,80,80,2,0,"PP",40
50,"50150",621,451,450,2,1,"PP",113
44,"44108",300,228,224,5,4,"PP",48
37,"37260",139,109,109,0,0,"PP",23
34,"34143",157,125,120,1,5,"PP",61
45,"45195",2072,1615,1583,4,32,"PP",345
3,"3114",1581,1263,1237,9,26,"PP",307
19,"19204",149,112,112,1,0,"PP",18
47,"47232",100,76,76,1,0,"PP",27
28,"28006",80622,64905,64483,400,422,"PP",13023
12,"12048",249,181,175,2,6,"PP",48
24,"24008",9025,6803,6702,79,101,"PP",2120
6,"6125",1679,1348,1324,5,24,"PP",316
10,"10080",360,256,246,0,10,"PP",64
34,"34083",1664,1244,1229,10,15,"PP",390
24,"24127",268,204,201,3,3,"PP",87
10,"10094",228,180,180,0,0,"PP",20
9,"9023",1178,982,966,14,16,"PP",174
15,"15030",199972,151737,150397,1576,1340,"PP",31438
42,"42094",603,484,475,10,9,"PP",112
27,"27014",3162,2181,2139,17,42,"PP",767
34,"34901",1071,854,847,4,7,"PP",344
13,"13034",58768,46017,45585,385,432,"PP",11147
10,"10175",1361,1031,997,8,34,"PP",204
26,"26044",51,44,42,0,2,"PP",13
43,"43023",214,186,186,1,0,"PP",1
15,"15051",4562,3302,3249,36,53,"PP",695
21,"21011",3473,2543,2513,14,30,"PP",385
39,"39085",6964,5489,5445,28,44,"PP",1061
4,"4093",1919,1346,1326,10,20,"PP",353
18,"18039",3382,2517,2490,20,27,"PP",419
23,"23049",1747,1321,1305,11,16,"PP",137
42,"42095",1857,1498,1473,21,25,"PP",282
15,"15901",3359,2237,2205,35,32,"PP",598
16,"16122",249,197,196,3,1,"PP",60
9,"9073",963,799,787,7,12,"PP",130
16,"16038",28,21,21,0,0,"PP",9
2,"2018",796,693,682,5,11,"PP",207
45,"45062",1074,888,867,4,21,"PP",328
50,"50164",388,279,272,2,7,"PP",50
26,"26046",1571,1185,1157,18,28,"PP",377
40,"40120",196,176,169,0,7,"PP",38
12,"12050",1230,987,972,10,15,"PP",259
5,"5188",41,36,34,0,2,"PP",18
23,"23016",384,316,311,0,5,"PP",50
1,"1047",967,686,673,8,13,"PP",125
20,"20008",704,455,449,6,6,"PP",10
26,"26164",51,37,37,1,0,"PP",12
19,"19167",129,104,102,0,2,"PP",35
13,"13083",2392,1772,1714,13,58,"PP",563
37,"37328",164,127,127,4,0,"PP",34
40,"40156",281,223,222,1,1,"PP",66
34,"34088",264,211,207,1,4,"PP",50
5,"5113",62,49,49,0,0,"PP",22
19,"19168",266,211,206,4,5,"PP",49
35,"35029",4357,2869,2832,32,37,"PP",342
24,"24012",285,204,202,2,2,"PP",45
7,"7063",1420,1139,1129,10,10,"PP",261
28,"28010",10538,8708,8635,54,73,"PP",1591
43,"43132",363,292,291,2,1,"PP",5
26,"26048",22,22,22,0,0,"PP",8
47,"47143",110,78,78,1,0,"PP",38
5,"5035",96,78,78,0,0,"PP",23
7,"7064",5528,3793,3765,23,28,"PP",543
4,"4060",407,308,304,1,4,"PP",133
24,"24173",908,679,667,3,12,"PP",220
24,"24054",417,318,311,0,7,"PP",122
38,"38028",22035,15684,15522,86,162,"PP",2680
40,"40123",141,108,104,1,4,"PP",26
26,"26126",29,29,29,1,0,"PP",21
16,"16027",701,540,531,2,9,"PP",116
3,"3057",177,148,147,0,1,"PP",34
44,"44218",31,25,25,2,0,"PP",12
49,"49263",45,37,37,0,0,"PP",22
49,"49138",208,159,154,2,5,"PP",60
49,"49101",147,99,96,0,3,"PP",40
32,"32004",1671,907,899,7,8,"PP",668
28,"28180",5317,4266,4222,26,44,"PP",673
29,"29027",2309,1716,1692,18,24,"PP",400
5,"5037",219,143,142,2,1,"PP",59
29,"29060",671,511,506,1,5,"PP",159
5,"5155",46,36,36,0,0,"PP",12
34,"34018",205,181,177,2,4,"PP",58
30,"30012",9069,7397,7266,53,131,"PP",1340
45,"45159",85,75,74,0,1,"PP",20
42,"42058",102,84,84,0,0,"PP",51
28,"28150",3187,2640,2604,20,36,"PP",507
50,"50223",916,751,745,13,6,"PP",156
10,"10102",503,407,403,3,4,"PP",93
6,"6132",829,598,593,0,5,"PP",85
40,"40229",28,24,24,0,0,"PP",10
27,"27019",8189,6148,6039,94,109,"PP",1534
22,"22242",63,47,45,1,2,"PP",21
4,"4063",1063,847,835,5,12,"PP",219
50,"50196",102,83,81,2,2,"PP",6
37,"37143",375,308,306,2,2,"PP",93
26,"26039",38,34,34,0,0,"PP",15
35,"35032",3348,2585,2542,20,43,"PP",797
44,"44094",123,112,112,0,0,"PP",40
18,"18056",3418,2523,2478,22,45,"PP",402
49,"49103",394,343,339,3,4,"PP",142
12,"12024",133,117,117,0,0,"PP",16
12,"12115",208,170,167,1,3,"PP",60
46,"46214",16415,12723,12610,74,113,"PP",2001
49,"49062",105,69,69,1,0,"PP",28
50,"50109",98,69,67,3,2,"PP",16
21,"21055",7218,5328,5215,41,113,"PP",1609
24,"24019",341,279,272,0,7,"PP",56
3,"3030",563,474,466,2,8,"PP",55
18,"18127",16822,12735,12537,106,198,"PP",1456
50,"50254",174,123,122,0,1,"PP",39
43,"43062",259,223,220,2,3,"PP",14
26,"26017",354,293,290,4,3,"PP",48
6,"6002",4314,3181,3086,44,95,"PP",658
22,"22160",212,171,170,3,1,"PP",30
26,"26106",76,66,65,0,1,"PP",16
5,"5025",82,70,70,0,0,"PP",33
23,"23025",2727,2125,2090,8,35,"PP",452
44,"44019",68,42,42,0,0,"PP",11
18,"18187",512,388,387,0,1,"PP",47
21,"21057",995,631,629,3,2,"PP",98
40,"40162",387,286,278,3,8,"PP",103
37,"37036",57,42,41,0,1,"PP",21
44,"44241",506,416,407,1,9,"PP",109
4,"4066",13488,9324,9255,73,69,"PP",2156
48,"48040",1309,979,973,5,6,"PP",18
24,"24142",24730,18823,18504,201,319,"PP",3100
39,"39027",3066,2511,2467,15,44,"PP",596
22,"22050",93,79,79,2,0,"PP",26
44,"44029",579,466,457,3,9,"PP",68
49,"49145",210,133,131,1,2,"PP",55
40,"40021",19,18,18,0,0,"PP",7
18,"18132",3124,2575,2548,17,27,"PP",263
9,"9139",98,82,82,2,0,"PP",25
28,"28144",6423,5274,5222,35,52,"PP",1000
45,"45028",3628,2916,2863,16,53,"PP",656
24,"24143",495,388,380,2,8,"PP",82
49,"49269",220,163,162,1,1,"PP",66
49,"49146",274,213,209,1,4,"PP",80
15,"15072",9436,6962,6860,60,102,"PP",1641
19,"19177",61,49,48,0,1,"PP",12
40,"40163",41,38,38,0,0,"PP",15
37,"37038",751,607,592,4,15,"PP",191
16,"16048",409,331,330,1,1,"PP",93
9,"9308",62,48,48,0,0,"PP",20
19,"19223",101,66,66,1,0,"PP",25
7,"7060",2665,1976,1964,14,12,"PP",452
16,"16049",144,111,108,1,3,"PP",29
18,"18097",995,708,702,4,6,"PP",132
5,"5123",103,85,85,1,0,"PP",32
48,"48072",970,735,730,1,5,"PP",11
3,"3095",4740,3702,3657,23,45,"PP",683
41,"41097",3135,2355,2308,11,47,"PP",328
23,"23059",5728,4259,4187,18,72,"PP",654
46,"46097",958,764,756,6,8,"PP",127
19,"19224",102,91,90,1,1,"PP",55
27,"27025",2743,2191,2138,31,53,"PP",839
1,"1059",189037,133121,131768,792,1353,"PP",20235
26,"26058",143,116,115,2,1,"PP",46
4,"4070",1545,1192,1182,7,10,"PP",349
44,"44033",244,174,172,0,2,"PP",43
44,"44224",21,15,15,0,0,"PP",3
52,"52001",54124,34068,33749,237,319,"PP",8085
24,"24024",638,463,452,8,11,"PP",163
50,"50258",53,33,33,3,0,"PP",8
45,"45078",1328,1152,1133,6,19,"PP",333
48,"48043",4539,3566,3556,22,10,"PP",139
16,"16177",82,64,63,0,1,"PP",21
5,"5200",40,27,26,0,1,"PP",17
50,"50202",131,90,88,1,2,"PP",27
16,"16051",126,102,100,0,2,"PP",44
49,"49221",234,138,130,1,8,"PP",40
6,"6040",987,747,739,6,8,"PP",122
45,"45110",1697,1339,1326,11,13,"PP",374
39,"39040",4267,3428,3385,24,43,"PP",744
24,"24026",1099,812,799,5,13,"PP",346
4,"4032",5698,4168,4138,20,30,"PP",743
29,"29092",579,434,426,5,8,"PP",38
45,"45079",349,272,272,1,0,"PP",77
26,"26060",75,60,60,1,0,"PP",23
23,"23030",1208,1022,1011,6,11,"PP",239
40,"40026",113,106,105,2,1,"PP",16
13,"13008",427,304,302,0,2,"PP",95
34,"34169",381,314,309,6,5,"PP",124
9,"9423",28,26,26,0,0,"PP",13
28,"28159",594,493,491,5,2,"PP",129
42,"42070",32,24,24,0,0,"PP",6
16,"16185",35,29,29,0,0,"PP",8
3,"3016",91,77,77,1,0,"PP",17
12,"12064",80,75,73,1,2,"PP",24
50,"50175",924,713,710,9,3,"PP",132
9,"9149",34,27,27,0,0,"PP",8
37,"37242",80,65,64,1,1,"PP",19
43,"43141",105,86,86,0,0,"PP",4
16,"16053",391,334,327,4,7,"PP",50
41,"41083",1128,865,859,6,6,"PP",106
39,"39041",1767,1437,1417,18,20,"PP",304
4,"4073",336,243,243,0,0,"PP",72
34,"34171",941,702,688,9,14,"PP",244
21,"21028",370,300,293,1,7,"PP",43
42,"42165",419,288,285,8,3,"PP",78
34,"34033",17,15,15,0,0,"PP",8
22,"22057",364,286,284,3,2,"PP",25
34,"34174",178,150,149,2,1,"PP",83
43,"43142",1083,850,842,8,8,"PP",23
19,"19322",26,21,21,1,0,"PP",6
6,"6109",3843,3228,3106,26,122,"PP",566
29,"29005",4499,3202,3171,37,31,"PP",708
22,"22186",191,165,164,2,1,"PP",29
37,"37356",87,66,66,0,0,"PP",32
37,"37046",10749,8133,7989,84,144,"PP",2195
9,"9901",340,256,255,1,1,"PP",76
11,"11012",97629,73036,72347,715,689,"PP",11664
21,"21017",2325,1450,1419,22,31,"PP",315
13,"13012",382,279,277,2,2,"PP",67
28,"28161",51559,41390,40922,255,468,"PP",5358
20,"20042",3172,2247,2231,9,16,"PP",75
6,"6099",1162,833,813,6,20,"PP",118
43,"43119",838,630,628,4,2,"PP",16
24,"24109",876,635,619,3,16,"PP",101
19,"19095",11,10,10,1,0,"PP",3
39,"39071",422,318,316,0,2,"PP",168
42,"42168",108,85,85,1,0,"PP",28
5,"5208",38,31,31,0,0,"PP",11
1,"1902",730,551,545,6,6,"PP",98
34,"34176",127,106,104,2,2,"PP",36
29,"29097",4168,3086,3009,37,77,"PP",360
21,"21031",1172,807,764,5,43,"PP",164
2,"2001",695,567,559,3,8,"PP",186
12,"12025",121,102,99,0,3,"PP",39
16,"16058",97,73,73,0,0,"PP",20
18,"18035",1190,965,952,4,13,"PP",304
44,"44008",1565,1158,1138,8,20,"PP",240
24,"24153",233,187,183,1,4,"PP",68
44,"44169",310,250,245,4,5,"PP",55
37,"37359",163,122,117,0,5,"PP",52
42,"42141",114,89,89,0,0,"PP",24
49,"49156",230,189,182,0,7,"PP",60
44,"44039",202,166,165,3,1,"PP",66
18,"18176",241,182,180,0,2,"PP",11
2,"2075",1718,1470,1448,4,22,"PP",458
18,"18036",3970,3197,3149,26,48,"PP",657
45,"45041",3897,2959,2904,28,55,"PP",517
34,"34178",119,105,104,0,1,"PP",56
19,"19220",2536,1833,1813,9,20,"PP",186
48,"48050",187,153,149,0,4,"PP",4
50,"50004",478,380,376,2,4,"PP",77
50,"50062",1863,1441,1416,9,25,"PP",230
38,"38002",972,678,640,3,38,"PP",90
19,"19191",13,12,12,0,0,"PP",3
34,"34038",268,198,197,0,1,"PP",81
24,"24033",205,146,146,3,0,"PP",64
37,"37360",215,158,153,3,5,"PP",48
6,"6048",824,714,702,2,12,"PP",171
14,"14004",1981,1522,1509,8,13,"PP",329
49,"49037",177,146,143,1,3,"PP",56
19,"19235",98,82,81,0,1,"PP",14
29,"29010",1632,1372,1319,4,53,"PP",213
18,"18914",1657,1315,1278,5,37,"PP",136
47,"47190",95,81,81,1,0,"PP",31
35,"35016",300503,203470,201240,1598,2230,"PP",33335
23,"23037",520,431,425,6,6,"PP",77
44,"44141",127,100,100,0,0,"PP",26
42,"42038",34,27,27,1,0,"PP",13
23,"23902",2229,1843,1820,7,23,"PP",261
6,"6016",2943,2283,2247,24,36,"PP",463
27,"27034",1025,647,636,4,11,"PP",224
10,"10081",184,142,140,4,2,"PP",49
21,"21072",10227,7947,7739,98,208,"PP",1451
49,"49082",343,288,286,8,2,"PP",77
2,"2041",321,253,251,3,2,"PP",127
42,"42082",7,7,7,0,0,"PP",2
37,"37054",238,200,196,3,4,"PP",61
23,"23903",3499,2738,2714,7,24,"PP",648
22,"22064",162,121,121,0,0,"PP",25
3,"3084",497,429,429,4,0,"PP",108
37,"37137",99,65,65,0,0,"PP",46
11,"11018",1446,1126,1100,6,26,"PP",267
14,"14037",3182,2388,2319,22,69,"PP",472
22,"22195",234,193,192,0,1,"PP",34
9,"9272",259,197,195,2,2,"PP",69
45,"45184",201,133,132,0,1,"PP",15
41,"41006",2738,1971,1945,16,26,"PP",252
24,"24116",390,283,279,1,4,"PP",78
38,"38015",4067,2951,2926,22,25,"PP",384
21,"21037",459,363,357,4,6,"PP",40
50,"50268",42,33,32,1,1,"PP",6
29,"29013",1602,1262,1238,12,24,"PP",186
41,"41062",2175,1763,1746,8,17,"PP",44
5,"5176",223,173,166,2,7,"PP",50
23,"23006",4582,3607,3543,32,64,"PP",612
10,"10205",1965,1344,1300,8,44,"PP",256
46,"46078",28394,20928,20748,156,180,"PP",2784
37,"37056",40,33,33,0,0,"PP",20
42,"42177",64,55,54,6,1,"PP",23
3,"3055",5247,4042,3991,24,51,"PP",1074
50,"50184",90,79,79,0,0,"PP",28
21,"21002",15922,11918,11773,119,145,"PP",1550
49,"49124",237,169,166,1,3,"PP",52
23,"23041",491,383,382,0,1,"PP",100
2,"2081",18331,14219,13987,108,232,"PP",3489
43,"43074",1812,1419,1412,4,7,"PP",32
19,"19106",76,57,57,0,0,"PP",12
34,"34185",68,53,51,1,2,"PP",16
37,"37177",265,209,208,0,1,"PP",63
45,"45188",2762,2144,2098,14,46,"PP",368
37,"37254",175,141,140,1,1,"PP",40
40,"40110",316,254,253,2,1,"PP",74
45,"45050",489,381,363,3,18,"PP",90
37,"37057",209,165,162,2,3,"PP",83
23,"23042",317,234,232,1,2,"PP",72
39,"39050",255,188,184,2,4,"PP",63
41,"41008",1040,840,822,4,18,"PP",69
37,"37178",99,82,82,0,0,"PP",37
19,"19107",315,273,270,2,3,"PP",81
44,"44237",368,299,293,2,6,"PP",101
9,"9335",87,71,71,0,0,"PP",20
36,"36018",3073,2184,2144,9,40,"PP",899
42,"42181",391,319,317,0,2,"PP",61
12,"12104",6814,5486,5406,35,80,"PP",1453
42,"42044",53,41,39,0,2,"PP",23
23,"23074",2971,2410,2378,8,32,"PP",505
43,"43027",164,137,137,0,0,"PP",5
43,"43150",1238,1034,1026,6,8,"PP",53
6,"6054",5454,4329,4190,46,139,"PP",1094
44,"44238",2294,1763,1743,10,20,"PP",106
9,"9017",90,72,70,2,2,"PP",23
40,"40148",228,185,180,0,5,"PP",64
34,"34189",53,39,39,1,0,"PP",19
9,"9173",129,102,102,0,0,"PP",39
5,"5103",66,48,48,0,0,"PP",26
6,"6154",2799,2075,2022,15,53,"PP",400
47,"47101",1644,1354,1337,9,17,"PP",375
47,"47070",30,26,25,0,1,"PP",15
45,"45192",2412,2103,2068,7,35,"PP",607
13,"13028",10273,8434,8273,42,161,"PP",2223
50,"50187",56,43,43,0,0,"PP",9
10,"10007",630,513,507,4,6,"PP",180
18,"18184",2170,1688,1656,3,32,"PP",283
9,"9174",781,625,608,3,17,"PP",179
43,"43151",109,98,98,0,0,"PP",3
20,"20032",8681,6491,6429,22,62,"PP",259
24,"24123",716,514,507,2,7,"PP",151
48,"48058",946,724,715,3,9,"PP",13
16,"16072",133,96,95,1,1,"PP",29
47,"47197",867,721,717,2,4,"PP",185
34,"34141",176,154,152,0,2,"PP",60
44,"44047",229,125,124,2,1,"PP",34
22,"22059",1139,867,855,10,12,"PP",151
46,"46113",2527,1906,1892,12,14,"PP",395
10,"10049",3758,3167,3086,19,81,"PP",705
42,"42140",14,13,12,0,1,"PP",6
40,"40044",139,105,103,2,2,"PP",34
19,"19247",142,118,117,2,1,"PP",21
9,"9281",135,104,102,1,2,"PP",17
43,"43120",421,302,297,2,5,"PP",17
19,"19112",53,41,40,1,1,"PP",15
4,"4089",694,516,510,1,6,"PP",185
50,"50099",3042,2299,2265,20,34,"PP",423
37,"37183",386,296,294,4,2,"PP",102
24,"24166",1359,1038,1011,11,27,"PP",274
21,"21045",227,181,178,1,3,"PP",20
13,"13031",2471,2044,2020,15,24,"PP",496
45,"45088",2332,1724,1695,16,29,"PP",317
19,"19294",25,19,18,0,1,"PP",5
43,"43006",676,531,525,4,6,"PP",31
5,"5107",55,43,43,2,0,"PP",21
22,"22075",119,87,87,1,0,"PP",15
34,"34199",1159,910,880,7,30,"PP",228
26,"26080",453,385,383,2,2,"PP",182
2,"2015",1433,1234,1214,7,20,"PP",268
24,"24168",439,365,360,3,5,"PP",118
12,"12079",419,346,336,2,10,"PP",87
46,"46206",557,461,455,6,6,"PP",79
20,"20005",1267,884,882,2,2,"PP",17
19,"19060",157,128,125,0,3,"PP",22
48,"48031",308,236,236,0,0,"PP",1
16,"16035",238,190,188,0,2,"PP",34
21,"21010",14976,9475,9352,145,123,"PP",1740
43,"43178",1421,1118,1113,7,5,"PP",53
18,"18084",4458,3467,3417,17,50,"PP",590
47,"47013",90,80,78,4,2,"PP",23
50,"50218",110,92,92,0,0,"PP",35
49,"49053",915,726,715,5,11,"PP",208
38,"38024",15310,10234,10088,82,146,"PP",2222
1,"1044",231,171,166,0,5,"PP",26
26,"26081",15,14,14,1,0,"PP",12
44,"44244",68,48,48,4,0,"PP",20
37,"37149",61,56,54,1,2,"PP",34
46,"46177",4778,3767,3711,17,56,"PP",541
28,"28176",13836,11415,11326,64,89,"PP",2853
28,"28079",2374366,1872679,1859094,11998,13585,"PP",389751
45,"45106",7395,5971,5861,40,110,"PP",1516
43,"43154",126,111,111,0,0,"PP",2
40,"40154",23,20,20,0,0,"PP",9
20,"20037",103,77,77,0,0,"PP",0
10,"10014",1829,1448,1419,12,29,"PP",356
28,"28146",1792,1308,1293,8,15,"PP",298
9,"9235",140,105,102,0,3,"PP",35
16,"16266",358,281,279,3,2,"PP",127
3,"3034",1391,1107,1090,7,17,"PP",318
47,"47204",235,182,178,0,4,"PP",54
5,"5110",706,550,546,4,4,"PP",191
37,"37188",160,115,112,3,3,"PP",38
50,"50277",49,37,37,3,0,"PP",15
2,"2019",2368,2009,1975,5,34,"PP",369
43,"43081",633,532,531,7,1,"PP",7
21,"21049",3282,2294,2214,21,80,"PP",312
24,"24171",349,201,198,4,3,"PP",61
50,"50192",233,189,183,0,6,"PP",33
42,"42054",19,15,15,0,0,"PP",4
10,"10056",532,434,428,3,6,"PP",109
43,"43131",4772,3432,3401,18,31,"PP",239
12,"12111",334,283,279,4,4,"PP",90
50,"50165",1783,1359,1330,20,29,"PP",156
22,"22007",756,576,571,5,5,"PP",163
5,"5073",289,239,238,0,1,"PP",103
3,"3129",1218,994,982,5,12,"PP",251
4,"4096",281,239,237,1,2,"PP",68
46,"46028",388,324,319,1,5,"PP",67
50,"50018",893,705,696,3,9,"PP",126
5,"5228",167,124,124,0,0,"PP",87
46,"46119",752,627,614,8,13,"PP",93
44,"44024",28,25,24,0,1,"PP",13
5,"5229",82,67,67,1,0,"PP",34
2,"2057",1960,1522,1489,15,33,"PP",258
43,"43903",2333,1717,1700,11,17,"PP",60
24,"24093",338,239,232,3,7,"PP",73
50,"50019",64,48,47,0,1,"PP",16
6,"6901",2117,1686,1655,17,31,"PP",292
40,"40225",1098,902,882,4,20,"PP",296
18,"18053",1561,1102,1099,3,3,"PP",180
50,"50136",534,416,405,2,11,"PP",138
47,"47144",75,63,63,1,0,"PP",20
36,"36028",4069,3012,2960,27,52,"PP",1126
15,"15035",11208,8175,8068,105,107,"PP",1471
2,"2022",344,252,252,1,0,"PP",96
19,"19258",84,69,66,1,3,"PP",30
43,"43059",250,214,214,1,0,"PP",2
24,"24134",3294,2540,2479,25,61,"PP",357
22,"22251",334,269,263,4,6,"PP",71
4,"4062",4460,3466,3425,12,41,"PP",1018
3,"3068",42,40,40,3,0,"PP",20
18,"18124",359,269,267,0,2,"PP",105
11,"11035",13715,9510,9385,128,125,"PP",1482
14,"14051",1348,1064,1048,7,16,"PP",300
9,"9355",87,69,67,1,2,"PP",49
5,"5192",93,81,78,0,3,"PP",28
48,"48067",1134,877,872,5,5,"PP",9
9,"9033",81,69,68,1,1,"PP",28
23,"23053",9449,6379,6325,25,54,"PP",725
28,"28118",61,52,51,0,1,"PP",13
19,"19123",36,33,32,2,1,"PP",10
29,"29028",1224,875,858,4,17,"PP",132
28,"28085",4141,3337,3296,13,41,"PP",676
3,"3069",3311,2356,2327,12,29,"PP",625
46,"46255",3209,2415,2381,18,34,"PP",448
18,"18902",755,611,595,1,16,"PP",120
37,"37157",78,64,64,0,0,"PP",10
10,"10103",426,330,327,0,3,"PP",86
22,"22127",529,434,432,4,2,"PP",63
46,"46244",59626,44018,43679,342,339,"PP",7622
24,"24137",1052,815,803,14,12,"PP",145
6,"6067",1915,1393,1370,7,23,"PP",312
42,"42156",29,23,23,0,0,"PP",7
15,"15038",2123,1441,1413,25,28,"PP",552
10,"10104",5151,3862,3782,22,80,"PP",928
16,"16088",101,85,85,1,0,"PP",22
44,"44126",317,226,222,1,4,"PP",63
3,"3102",7226,5600,5516,28,84,"PP",914
4,"4101",4375,3161,3112,34,49,"PP",546
10,"10145",125,106,104,1,2,"PP",35
23,"23024",12224,9586,9329,46,257,"PP",1938
46,"46002",1215,963,959,5,4,"PP",145
10,"10131",12808,9377,9254,67,123,"PP",2014
27,"27022",4683,3131,3059,30,72,"PP",1056
45,"45072",661,525,517,3,8,"PP",128
22,"22085",96,82,81,0,1,"PP",18
22,"22084",555,438,433,5,5,"PP",91
42,"42200",76,54,53,0,1,"PP",26
3,"3010",336,295,280,0,15,"PP",67
45,"45026",218,177,172,0,5,"PP",32
39,"39064",1341,1103,1094,5,9,"PP",319
38,"38032",13536,9924,9867,63,57,"PP",1354
4,"4102",14110,9871,9765,90,106,"PP",2104
18,"18095",2002,1566,1537,11,29,"PP",187
30,"30015",19372,14430,14283,91,147,"PP",3538
3,"3041",6093,4444,4398,13,46,"PP",925
19,"19127",90,63,63,0,0,"PP",35
45,"45119",3485,2478,2430,21,48,"PP",391
40,"40056",32,21,21,0,0,"PP",16
49,"49064",483,319,317,1,2,"PP",103
11,"11003",1240,898,876,7,22,"PP",214
43,"43161",17113,12944,12881,64,63,"PP",436
24,"24021",1602,1211,1194,7,17,"PP",303
15,"15040",2675,2011,1979,20,32,"PP",747
29,"29032",6657,5314,5190,30,124,"PP",679
21,"21058",2556,1732,1709,21,23,"PP",182
3,"3042",1462,1025,1008,3,17,"PP",229
1,"1013",703,491,487,2,4,"PP",37
41,"41096",6134,4926,4845,44,81,"PP",883
44,"44192",349,288,284,1,4,"PP",74
10,"10026",656,515,507,8,8,"PP",98
32,"32038",399,274,271,3,3,"PP",103
46,"46217",893,733,723,6,10,"PP",106
28,"28048",504,399,392,6,7,"PP",60
13,"13004",996,769,763,3,6,"PP",216
49,"49147",249,197,196,1,1,"PP",54
23,"23093",3131,2428,2380,22,48,"PP",315
46,"46157",2960,2329,2296,12,33,"PP",635
40,"40094",364,284,279,1,5,"PP",76
10,"10149",434,308,304,2,4,"PP",71
36,"36034",3319,2384,2347,16,37,"PP",784
19,"19266",229,194,192,1,2,"PP",80
47,"47214",1364,1112,1074,7,38,"PP",389
26,"26175",47,40,40,2,0,"PP",17
12,"12119",137,107,104,1,3,"PP",41
49,"49187",1202,930,921,8,9,"PP",264
49,"49067",336,236,232,0,4,"PP",80
9,"9200",58,40,40,0,0,"PP",12
30,"30018",8326,6544,6438,25,106,"PP",1445
28,"28049",57902,47976,47561,329,415,"PP",6228
47,"47182",1335,1034,1022,6,12,"PP",168
37,"37083",176,160,156,1,4,"PP",47
16,"16095",81,69,68,1,1,"PP",34
10,"10150",331,277,272,6,5,"PP",48
3,"3044",4557,3650,3600,17,50,"PP",1004
21,"21061",5089,3358,3290,42,68,"PP",594
11,"11902",3656,2427,2383,29,44,"PP",481
41,"41025",2019,1492,1439,7,53,"PP",305
36,"36036",2556,1953,1914,14,39,"PP",615
24,"24146",251,206,204,1,2,"PP",89
50,"50084",66,47,47,0,0,"PP",6
12,"12063",44,37,37,1,0,"PP",3
44,"44004",379,312,310,5,2,"PP",73
49,"49029",614,497,488,9,9,"PP",199
3,"3107",2769,2011,1986,10,25,"PP",345
10,"10030",472,323,318,1,5,"PP",87
46,"46220",48968,35430,34964,306,466,"PP",4714
22,"22090",85,66,66,1,0,"PP",11
44,"44163",114,92,92,0,0,"PP",15
45,"45125",2263,1871,1842,10,29,"PP",482
47,"47026",49,40,39,0,1,"PP",20
21,"21063",2620,2037,1992,11,45,"PP",211
48,"48075",2067,1591,1565,11,26,"PP",44
5,"5087",149,112,111,1,1,"PP",36
50,"50288",3444,2689,2668,24,21,"PP",443
50,"50116",170,132,131,0,1,"PP",35
16,"16097",139,121,120,1,1,"PP",31
10,"10031",164,136,135,0,1,"PP",34
50,"50028",77,59,58,1,1,"PP",6
38,"38038",164468,112475,111577,728,898,"PP",15816
36,"36006",11468,8959,8782,66,177,"PP",2951
44,"44164",20,18,18,0,0,"PP",11
32,"32042",1505,1097,1091,12,6,"PP",536
24,"24187",845,641,630,6,11,"PP",201
24,"24067",606,375,371,2,4,"PP",141
10,"10154",177,134,133,1,1,"PP",39
5,"5005",171,142,142,2,0,"PP",48
16,"16098",520,441,439,6,2,"PP",114
44,"44262",143,115,112,0,3,"PP",36
43,"43117",143,114,113,0,1,"PP",12
26,"26102",6057,4672,4579,37,93,"PP",1245
5,"5007",110,81,80,2,1,"PP",46
37,"37204",255,197,195,0,2,"PP",85
40,"40905",128,101,100,4,1,"PP",62
40,"40135",269,224,221,1,3,"PP",82
23,"23032",523,443,439,1,4,"PP",48
16,"16056",453,323,321,1,2,"PP",57
6,"6043",686,553,544,6,9,"PP",110
40,"40171",39,29,29,1,0,"PP",14
19,"19272",65,58,56,1,2,"PP",24
5,"5244",41,32,32,0,0,"PP",23
24,"24151",445,334,328,3,6,"PP",91
24,"24108",348,268,265,2,3,"PP",111
41,"41084",2815,2177,2111,3,66,"PP",299
9,"9428",103,86,86,0,0,"PP",35
2,"2073",4844,3828,3772,28,56,"PP",750
19,"19188",43,34,33,0,1,"PP",9
5,"5169",219,176,173,1,3,"PP",91
5,"5008",208,168,163,1,5,"PP",71
27,"27062",584,467,466,3,1,"PP",203
24,"24030",4201,3080,3024,25,56,"PP",678
37,"37320",88,67,67,1,0,"PP",24
28,"28130",28508,23566,23305,179,261,"PP",2608
20,"20053",4848,3479,3451,27,28,"PP",93
5,"5245",348,295,290,3,5,"PP",87
3,"3904",1420,1112,1095,5,17,"PP",185
39,"39072",324,206,204,4,2,"PP",101
47,"47220",154,119,119,1,0,"PP",45
10,"10158",337,269,267,0,2,"PP",59
23,"23034",2490,2033,1999,15,34,"PP",390
41,"41086",16209,11006,10881,116,125,"PP",1235
13,"13060",272,219,214,4,5,"PP",38
40,"40032",378,287,278,1,9,"PP",78
16,"16190",4957,4006,3945,36,61,"PP",1105
3,"3020",95,84,84,2,0,"PP",18
5,"5012",121,100,97,0,3,"PP",44
4,"4001",1014,768,763,9,5,"PP",149
30,"30024",60183,45738,45317,290,421,"PP",10595
23,"23035",1103,903,882,6,21,"PP",225
42,"42215",735,540,529,5,11,"PP",180
49,"49080",630,499,493,4,6,"PP",137
44,"44265",181,153,148,1,5,"PP",75
1,"1027",430,295,293,2,2,"PP",20
12,"12098",533,446,440,4,6,"PP",130
15,"15081",982,755,741,11,14,"PP",416
48,"48080",9946,7574,7499,46,75,"PP",289
40,"40140",79,58,58,0,0,"PP",22
27,"27002",1546,1136,1103,9,33,"PP",385
9,"9105",97,81,76,1,5,"PP",20
20,"20055",17378,12565,12482,55,83,"PP",442
41,"41087",10496,7661,7477,57,184,"PP",1136
5,"5172",116,95,93,0,2,"PP",27
42,"42216",26,20,20,1,0,"PP",7
44,"44171",182,130,128,0,2,"PP",23
3,"3052",967,805,790,4,15,"PP",221
9,"9055",48,34,34,1,0,"PP",17
9,"9906",1200,975,958,8,17,"PP",300
41,"41903",6769,5018,4919,73,99,"PP",656
24,"24034",3457,2627,2588,31,39,"PP",344
12,"12006",174,149,149,2,0,"PP",26
5,"5095",236,193,191,0,2,"PP",47
27,"27003",1772,1271,1241,6,30,"PP",585
28,"28027",1200,920,906,4,14,"PP",188
50,"50181",1000,770,754,7,16,"PP",163
24,"24036",272,181,179,4,2,"PP",34
26,"26148",150,128,124,1,4,"PP",37
20,"20026",204,182,159,3,23,"PP",0
37,"37362",4729,3769,3720,36,49,"PP",836
29,"29011",2871,1955,1926,11,29,"PP",264
40,"40071",43,37,31,0,6,"PP",19
3,"3053",7469,5950,5865,26,85,"PP",1271
23,"23070",3808,2598,2565,34,33,"PP",627
50,"50034",787,568,556,3,12,"PP",116
9,"9434",1280,1089,1077,12,12,"PP",191
5,"5135",398,324,320,2,4,"PP",106
19,"19103",251,218,216,1,2,"PP",65
38,"38045",3549,2149,2109,6,40,"PP",266
34,"34233",128,118,117,2,1,"PP",72
48,"48083",6946,5238,5201,35,37,"PP",174
49,"49084",268,226,223,9,3,"PP",63
42,"42083",26,22,22,0,0,"PP",7
3,"3054",336,277,272,2,5,"PP",67
45,"45138",1055,889,874,5,15,"PP",304
15,"15084",3059,2236,2217,20,19,"PP",1155
29,"29046",2540,1896,1855,13,41,"PP",331
22,"22234",745,587,578,11,9,"PP",103
49,"49202",172,125,124,2,1,"PP",38
6,"6051",1543,1206,1188,3,18,"PP",314
2,"2007",1013,820,813,6,7,"PP",150
18,"18074",264,207,205,0,2,"PP",49
4,"4083",1740,1342,1326,4,16,"PP",285
42,"42003",66,55,55,0,0,"PP",12
23,"23071",1720,1348,1330,6,18,"PP",319
41,"41035",1060,803,788,8,15,"PP",183
22,"22235",88,72,72,1,0,"PP",31
9,"9389",64,50,50,0,0,"PP",18
22,"22197",439,356,353,10,3,"PP",67
44,"44143",394,327,327,2,0,"PP",72
5,"5256",112,94,92,1,2,"PP",26
42,"42084",20,16,16,0,0,"PP",9
10,"10166",313,211,202,0,9,"PP",77
28,"28136",680,569,563,0,6,"PP",119
19,"19286",742,610,603,4,7,"PP",126
37,"37214",116,87,87,4,0,"PP",24
41,"41007",12438,9009,8775,135,234,"PP",816
20,"20029",4272,3257,3239,18,18,"PP",58
34,"34047",1738,1439,1420,8,19,"PP",577
3,"3119",17223,13244,13116,75,128,"PP",2492
5,"5019",44838,36021,35637,287,384,"PP",9084
23,"23073",4389,3400,3363,13,37,"PP",661
47,"47133",2776,2317,2292,28,25,"PP",362
37,"37330",318,255,248,2,7,"PP",77
14,"14070",1284,988,969,5,19,"PP",326
9,"9224",159,135,132,0,3,"PP",48
46,"46049",268,231,228,1,3,"PP",72
32,"32051",1407,1158,1153,12,5,"PP",719
26,"26074",107,97,96,2,1,"PP",33
50,"50242",93,72,70,0,2,"PP",20
13,"13026",415,342,340,1,2,"PP",84
1,"1036",14772,10850,10746,69,104,"PP",742
37,"37331",188,130,130,1,0,"PP",52
5,"5063",31,27,27,0,0,"PP",19
9,"9391",361,286,283,3,3,"PP",96
12,"12011",4582,3511,3431,27,80,"PP",565
24,"24082",860,690,678,12,12,"PP",128
3,"3058",4967,4031,3967,24,64,"PP",1338
44,"44177",101,75,75,1,0,"PP",18
42,"42135",70,46,45,0,1,"PP",16
50,"50128",27,24,24,0,0,"PP",9
14,"14072",999,763,754,4,9,"PP",100
5,"5259",106,87,87,0,0,"PP",40
29,"29017",6428,4943,4871,32,72,"PP",680
46,"46051",8384,6550,6452,24,98,"PP",1777
34,"34241",18,17,14,4,3,"PP",7
45,"45145",2613,1950,1921,13,29,"PP",445
3,"3059",20590,15909,15766,96,143,"PP",3332
10,"10170",239,180,179,1,1,"PP",57
13,"13074",944,826,813,1,13,"PP",220
26,"26117",2097,1680,1647,17,33,"PP",540
42,"42139",21,15,15,1,0,"PP",9
5,"5024",198,142,139,2,3,"PP",60
18,"18151",259,194,193,3,1,"PP",27
37,"37333",202,138,137,4,1,"PP",47
28,"28140",3139,2547,2523,12,24,"PP",414
5,"5143",62,51,51,0,0,"PP",27
39,"39081",437,356,347,2,9,"PP",163
28,"28141",6246,4943,4890,44,53,"PP",826
19,"19202",17,13,13,0,0,"PP",2
6,"6123",4512,3358,3266,28,92,"PP",520
46,"46204",6657,5262,5204,27,58,"PP",839
46,"46174",949,789,770,4,19,"PP",123
22,"22113",470,369,369,2,0,"PP",79
9,"9228",157,136,136,0,0,"PP",59
44,"44085",49,31,31,0,0,"PP",18
43,"43029",314,253,252,0,1,"PP",2
37,"37334",73,49,49,0,0,"PP",21
46,"46053",537,459,457,2,2,"PP",53
37,"37221",394,299,299,2,0,"PP",102
5,"5262",323,254,254,0,0,"PP",86
19,"19009",247,190,187,0,3,"PP",65
40,"40185",815,624,618,4,6,"PP",247
5,"5106",28,22,22,0,0,"PP",11
26,"26160",732,578,574,4,4,"PP",200
36,"36022",9061,6640,6482,47,158,"PP",1324
30,"30035",19268,14248,14103,92,145,"PP",3465
3,"3061",1054,830,816,3,14,"PP",225
13,"13077",3399,2447,2380,30,67,"PP",450
42,"42011",17,11,11,0,0,"PP",4
40,"40186",34,29,29,0,0,"PP",14
29,"29054",42393,30327,30108,218,219,"PP",6791
7,"7026",30991,19827,19602,161,225,"PP",3211
43,"43177",284,243,242,0,1,"PP",4
24,"24210",527,387,386,0,1,"PP",91
19,"19162",67,50,48,0,2,"PP",9
5,"5069",74,63,62,0,1,"PP",33
38,"38901",1456,1024,1010,9,14,"PP",138
26,"26007",481,391,383,0,8,"PP",80
37,"37261",217,166,163,0,3,"PP",59
18,"18119",1712,1352,1317,11,35,"PP",303
47,"47043",309,276,273,1,3,"PP",92
44,"44243",27,24,23,0,1,"PP",5
39,"39084",874,718,712,4,6,"PP",234
23,"23080",1721,1370,1355,8,15,"PP",300
50,"50275",110,55,55,0,0,"PP",18
5,"5265",79,59,59,0,0,"PP",20
18,"18016",308,232,231,5,1,"PP",52
11,"11029",5423,3161,3105,55,56,"PP",355
41,"41014",2486,1939,1878,6,61,"PP",116
13,"13080",321,246,246,1,0,"PP",74
3,"3033",102,87,85,0,2,"PP",29
50,"50044",222,161,161,3,0,"PP",20
47,"47106",44,35,35,0,0,"PP",15
23,"23048",820,644,636,1,8,"PP",216
6,"6160",3019,2252,2209,10,43,"PP",529
21,"21048",313,243,237,4,6,"PP",25
13,"13082",25882,17928,17721,101,207,"PP",4372
46,"46250",581614,454786,451184,2675,3602,"PP",83662
48,"48032",5773,4504,4476,5,28,"PP",200
40,"40082",106,83,81,0,2,"PP",34
29,"29056",1061,783,772,4,11,"PP",187
34,"34102",202,173,171,2,2,"PP",75
22,"22004",124,90,88,1,2,"PP",17
9,"9236",35,29,29,1,0,"PP",21
46,"46239",453,372,366,2,6,"PP",100
23,"23082",1875,1402,1389,7,13,"PP",445
9,"9074",834,697,694,8,3,"PP",120
5,"5033",170,146,145,0,1,"PP",76
16,"16269",393,322,317,3,5,"PP",129
39,"39002",3414,2630,2578,23,52,"PP",519
9,"9451",238,211,207,2,4,"PP",45
47,"47110",438,352,347,4,5,"PP",67
46,"46058",1734,1349,1325,9,24,"PP",251
34,"34103",97,84,81,0,3,"PP",34
37,"37029",193,139,133,1,6,"PP",48
12,"12082",9573,7672,7570,55,102,"PP",1770
43,"43107",383,308,308,1,0,"PP",2
47,"47046",125,107,104,1,3,"PP",37
19,"19301",37,31,31,0,0,"PP",13
9,"9075",103,87,87,1,0,"PP",20
50,"50135",88,74,74,3,0,"PP",15
30,"30040",705,600,596,1,4,"PP",241
47,"47047",202,164,161,3,3,"PP",72
39,"39003",258,205,202,3,3,"PP",48
49,"49099",98,75,74,0,1,"PP",22
50,"50046",167,134,130,3,4,"PP",50
49,"49137",170,138,134,0,4,"PP",60
4,"4097",242,184,184,0,0,"PP",43
28,"28179",1450,1115,1100,3,15,"PP",197
49,"49057",105,85,81,2,4,"PP",37
5,"5230",65,58,58,4,0,"PP",30
44,"44247",287,216,215,6,1,"PP",37
16,"16216",278,243,240,0,3,"PP",57
22,"22008",155,127,125,0,2,"PP",38
39,"39032",1426,1156,1141,8,15,"PP",323
19,"19303",40,35,35,0,0,"PP",18
16,"16271",595,513,511,2,2,"PP",173
12,"12113",87,65,64,0,1,"PP",17
16,"16002",195,166,164,1,2,"PP",46
10,"10018",1630,1149,1112,12,37,"PP",177
37,"37191",104,65,65,1,0,"PP",37
22,"22170",668,529,520,4,9,"PP",114
9,"9410",2999,2175,2135,27,40,"PP",343
50,"50252",5057,3661,3613,36,48,"PP",1023
39,"39033",540,430,423,1,7,"PP",79
1,"1006",176,127,127,2,0,"PP",18
40,"40087",87,70,70,0,0,"PP",46
15,"15004",4873,3689,3623,31,66,"PP",860
15,"15067",7953,6004,5925,51,79,"PP",1361
16,"16128",51,44,44,0,0,"PP",18
9,"9079",48,42,42,1,0,"PP",31
1,"1008",802,576,570,3,6,"PP",81
47,"47049",91,66,64,0,2,"PP",22
49,"49226",239,207,200,3,7,"PP",61
37,"37345",150,134,133,0,1,"PP",51
40,"40053",83,62,62,1,0,"PP",18
7,"7902",1091,776,743,10,33,"PP",191
6,"6903",2027,1607,1594,16,13,"PP",234
9,"9244",45,35,35,0,0,"PP",10
47,"47050",3898,3084,3047,36,37,"PP",472
18,"18023",15645,11708,11561,91,147,"PP",1983
9,"9302",98,75,73,0,2,"PP",24
14,"14022",3886,3080,3043,18,37,"PP",297
46,"46062",4572,3571,3510,20,61,"PP",865
48,"48902",18971,14015,13895,101,120,"PP",667
2,"2025",7355,5864,5693,30,171,"PP",1313
40,"40160",93,72,72,0,0,"PP",41
44,"44157",64,38,38,1,0,"PP",15
10,"10184",740,607,597,5,10,"PP",190
7,"7001",3628,2792,2753,18,39,"PP",538
37,"37194",237,182,181,0,1,"PP",50
19,"19174",91,69,69,0,0,"PP",28
45,"45162",632,481,471,2,10,"PP",139
50,"50139",322,257,256,0,1,"PP",66
6,"6101",442,359,354,2,5,"PP",132
39,"39091",1885,1512,1503,6,9,"PP",352
42,"42157",10,10,10,0,0,"PP",7
7,"7003",12374,7550,7442,51,108,"PP",1183
28,"28015",20440,17084,16953,103,131,"PP",2448
6,"6134",530,337,331,3,6,"PP",101
46,"46215",1397,1104,1093,12,11,"PP",104
9,"9195",55,45,45,1,0,"PP",12
50,"50110",336,268,266,1,2,"PP",67
18,"18128",342,274,272,1,2,"PP",101
1,"1011",215,179,175,3,4,"PP",50
50,"50140",157,108,108,0,0,"PP",24
15,"15008",5631,4320,4267,64,53,"PP",1190
6,"6003",766,625,610,3,15,"PP",100
22,"22013",275,218,217,6,1,"PP",59
22,"22175",184,139,137,1,2,"PP",32
5,"5159",228,160,159,2,1,"PP",97
37,"37236",127,90,86,0,4,"PP",27
47,"47053",126,100,97,0,3,"PP",30
9,"9416",60,44,44,0,0,"PP",6
24,"24223",2540,1971,1929,37,42,"PP",509
19,"19309",21,18,17,0,1,"PP",2
9,"9086",661,521,518,5,3,"PP",109
37,"37349",103,69,68,0,1,"PP",35
16,"16133",4387,3607,3544,38,63,"PP",737
46,"46065",1576,1246,1228,6,18,"PP",177
46,"46247",961,695,687,3,8,"PP",231
9,"9250",259,215,214,1,1,"PP",73
48,"48071",6038,4711,4674,27,37,"PP",124
40,"40092",113,86,84,2,2,"PP",36
40,"40199",101,79,78,0,1,"PP",27
48,"48905",2490,1911,1891,16,20,"PP",57
42,"42160",247,195,194,4,1,"PP",45
4,"4068",174,134,134,0,0,"PP",48
3,"3013",1070,882,869,3,13,"PP",292
43,"43138",2648,1926,1896,8,30,"PP",132
21,"21023",2051,1356,1332,5,24,"PP",210
10,"10027",76,66,66,0,0,"PP",12
12,"12091",176,131,130,0,1,"PP",42
16,"16279",174,125,125,0,0,"PP",31
13,"13096",7533,5766,5696,43,70,"PP",1427
45,"45168",62790,50868,50335,359,533,"PP",11198
21,"21060",12235,8053,7929,93,124,"PP",1291
46,"46188",693,591,585,3,6,"PP",97
45,"45167",1385,1143,1130,2,13,"PP",363
2,"2067",1129,866,852,4,14,"PP",185
3,"3074",1750,1433,1427,3,6,"PP",413
46,"46066",1285,1058,1043,6,15,"PP",216
28,"28157",682,530,516,1,14,"PP",118
49,"49110",345,222,220,2,2,"PP",77
50,"50143",546,409,401,5,8,"PP",100
4,"4031",2249,1778,1773,2,5,"PP",370
15,"15011",15481,11249,11037,105,212,"PP",2930
16,"16135",118,86,85,0,1,"PP",36
12,"12120",161,138,138,0,0,"PP",52
13,"13098",1983,1537,1485,22,52,"PP",396
5,"5045",80,65,65,0,0,"PP",30
45,"45169",186,135,134,0,1,"PP",48
30,"30019",25846,18755,18517,172,238,"PP",4833
20,"20049",4159,3024,3004,11,20,"PP",63
29,"29003",922,740,727,3,13,"PP",109
29,"29002",1150,851,842,4,9,"PP",180
40,"40132",46,32,31,1,1,"PP",19
9,"9045",274,199,196,1,3,"PP",73
40,"40201",43,39,37,0,2,"PP",23
24,"24104",245,173,172,1,1,"PP",50
12,"12121",1044,941,915,4,26,"PP",273
45,"45033",298,224,221,1,3,"PP",69
16,"16902",127,101,101,0,0,"PP",28
9,"9422",32,27,26,2,1,"PP",7
32,"32069",4256,3358,3309,39,49,"PP",922
39,"39012",6737,5391,5314,52,77,"PP",847
19,"19135",93,76,72,0,4,"PP",28
34,"34122",86,68,66,0,2,"PP",22
16,"16903",996,816,806,9,10,"PP",322
46,"46160",1907,1508,1485,5,23,"PP",176
5,"5048",106,98,94,1,4,"PP",42
50,"50146",190,152,149,0,3,"PP",33
18,"18136",1782,1382,1359,12,23,"PP",232
5,"5127",608,499,496,0,3,"PP",192
12,"12032",23649,17680,17505,118,175,"PP",3618
37,"37354",5467,3960,3910,31,50,"PP",766
22,"22136",749,579,576,5,3,"PP",143
9,"9258",171,142,141,2,1,"PP",62
44,"44105",69,54,54,1,0,"PP",18
37,"37355",162,137,135,0,2,"PP",63
48,"48910",2802,2082,2073,3,9,"PP",118
46,"46161",1472,1200,1172,7,28,"PP",223
26,"26180",223,182,177,3,5,"PP",62
13,"13904",504,394,376,6,18,"PP",91
40,"40100",263,219,215,1,4,"PP",77
9,"9259",227,198,197,2,1,"PP",64
48,"48016",5437,4282,4248,21,34,"PP",296
32,"32043",2512,1805,1789,16,16,"PP",657
19,"19186",78,67,67,0,0,"PP",21
24,"24068",443,343,336,1,7,"PP",64
15,"15078",78678,60510,59882,621,628,"PP",15154
45,"45037",1535,1121,1105,7,16,"PP",285
46,"46071",470,382,366,0,16,"PP",73
42,"42166",57,49,49,0,0,"PP",25
39,"39099",3149,2562,2540,22,22,"PP",498
46,"46010",950,727,718,6,9,"PP",107
10,"10197",108,84,84,0,0,"PP",28
14,"14001",3443,2724,2675,24,49,"PP",574
43,"43044",3949,3060,3032,31,28,"PP",270
46,"46072",3542,3008,2961,33,47,"PP",581
9,"9051",163,134,133,1,1,"PP",50
22,"22021",1884,1465,1450,13,15,"PP",262
9,"9155",25,20,20,0,0,"PP",7
19,"19142",249,178,177,1,1,"PP",22
24,"24902",335,266,263,1,3,"PP",85
18,"18140",42374,29390,29025,221,365,"PP",5263
34,"34126",254,220,219,3,1,"PP",96
48,"48912",2331,1843,1833,7,10,"PP",52
50,"50235",2412,1826,1807,22,19,"PP",300
50,"50149",33,25,25,1,0,"PP",8
46,"46163",1856,1522,1501,4,21,"PP",250
7,"7046",16718,10573,10469,94,104,"PP",1980
14,"14002",10859,8215,8078,93,137,"PP",1066
3,"3080",1328,1077,1064,4,13,"PP",274
50,"50264",147,122,120,0,2,"PP",16
19,"19143",1754,1422,1402,11,20,"PP",337
29,"29041",3599,2570,2532,22,38,"PP",272
9,"9378",29,21,20,0,1,"PP",5
46,"46073",1077,867,862,10,5,"PP",202
19,"19326",2343,1789,1768,9,21,"PP",177
37,"37133",101,84,80,0,4,"PP",21
21,"21069",1667,1214,1198,13,16,"PP",227
18,"18002",526,400,400,0,0,"PP",57
24,"24112",299,226,223,1,3,"PP",34
49,"49241",240,199,199,1,0,"PP",76
47,"47001",52,47,46,0,1,"PP",24
48,"48020",272959,203643,202331,1472,1312,"PP",19826
10,"10078",370,289,278,4,11,"PP",64
41,"41059",35105,27781,27472,261,309,"PP",3462
39,"39102",2255,1711,1698,11,13,"PP",479
12,"12037",17,17,17,1,0,"PP",3
37,"37051",80,59,58,0,1,"PP",24
29,"29009",1441,1097,1073,8,24,"PP",108
46,"46135",9827,7928,7883,44,45,"PP",1509
30,"30026",16252,11142,10977,65,165,"PP",2299
16,"16104",55,46,46,0,0,"PP",7
43,"43121",591,463,462,0,1,"PP",3
42,"42036",40,34,33,2,1,"PP",6
48,"48914",325,286,285,0,1,"PP",0
34,"34231",217,184,178,0,6,"PP",84
9,"9326",154,129,127,4,2,"PP",18
42,"42127",38,27,27,1,0,"PP",13
1,"1028",1068,774,772,7,2,"PP",157
26,"26032",45,37,37,1,0,"PP",9
49,"49120",53,39,39,0,0,"PP",18
1,"1030",143,118,117,1,1,"PP",29
34,"34131",58,51,51,0,0,"PP",40
5,"5056",94,83,83,0,0,"PP",29
46,"46197",1926,1473,1455,9,18,"PP",161
12,"12100",1281,1118,1102,5,16,"PP",274
42,"42037",29,19,18,0,1,"PP",9
42,"42128",46,41,41,0,0,"PP",19
12,"12039",792,688,680,3,8,"PP",216
40,"40211",69,58,58,1,0,"PP",18
18,"18038",1047,810,787,4,23,"PP",112
4,"4045",1704,1355,1326,12,29,"PP",159
15,"15020",3593,2491,2469,18,22,"PP",719
19,"19331",2643,2043,2009,11,34,"PP",368
9,"9270",159,119,117,4,2,"PP",38
49,"49122",778,586,573,6,13,"PP",151
45,"45046",2369,1860,1832,5,28,"PP",398
5,"5057",2401,1949,1917,19,32,"PP",587
39,"39076",3483,2770,2734,21,36,"PP",508
42,"42039",210,147,141,2,6,"PP",35
44,"44204",27,22,22,0,0,"PP",2
44,"44111",78,64,64,1,0,"PP",8
42,"42041",31,23,23,1,0,"PP",4
18,"18040",226,146,145,0,1,"PP",18
29,"29068",7716,5347,5230,58,117,"PP",733
7,"7051",5414,3610,3575,37,35,"PP",670
37,"37016",574,464,455,3,9,"PP",121
35,"35018",13056,8699,8618,73,81,"PP",1038
15,"15022",5574,3846,3798,41,48,"PP",1013
50,"50154",116,98,98,0,0,"PP",32
34,"34134",40,31,31,1,0,"PP",15
12,"12130",420,345,341,0,4,"PP",238
19,"19285",20,18,18,0,0,"PP",5
38,"38047",1756,1276,1259,6,17,"PP",241
21,"21074",2698,1979,1945,15,34,"PP",531
49,"49246",217,180,177,2,3,"PP",92
45,"45049",423,340,335,1,5,"PP",95
43,"43050",2634,1881,1868,13,13,"PP",147
10,"10206",201,146,144,1,2,"PP",43
50,"50155",90,70,69,0,1,"PP",17
6,"6019",2012,1539,1495,14,44,"PP",217
50,"50066",2835,2199,2177,19,22,"PP",326
15,"15023",6318,4501,4436,40,65,"PP",1142
18,"18042",418,344,340,7,4,"PP",80
29,"29048",1370,1149,1135,10,14,"PP",82
21,"21003",677,505,489,3,16,"PP",20
46,"46170",3408,2769,2720,16,49,"PP",574
22,"22155",65,54,54,0,0,"PP",17
2,"2082",95,83,83,0,0,"PP",15
43,"43051",9092,6577,6502,26,75,"PP",368
49,"49125",1401,1031,1010,7,21,"PP",190
50,"50067",13788,10562,10413,107,149,"PP",2433
40,"40214",196,167,163,1,4,"PP",48
24,"24119",695,515,501,8,14,"PP",111
22,"22200",239,181,178,0,3,"PP",30
46,"46232",872,714,706,3,8,"PP",149
14,"14071",884,641,634,2,7,"PP",118
12,"12043",560,460,450,2,10,"PP",110
43,"43174",144,128,127,0,1,"PP",0
50,"50157",286,226,220,0,6,"PP",61
2,"2083",209,183,183,0,0,"PP",57
18,"18044",164,113,112,0,1,"PP",25
28,"28003",170,148,148,1,0,"PP",28
37,"37255",42,31,31,2,0,"PP",16
21,"21004",1593,1114,1085,16,29,"PP",137
32,"32080",286,223,220,1,3,"PP",136
16,"16030",22,19,19,1,0,"PP",2
24,"24003",608,430,418,0,12,"PP",136
50,"50214",18,10,10,0,0,"PP",5
45,"45099",3635,2741,2684,23,57,"PP",432
18,"18045",1060,748,737,10,11,"PP",113
6,"6121",3268,2558,2531,26,27,"PP",557
9,"9443",152,115,112,0,3,"PP",40
37,"37257",49,40,40,1,0,"PP",19
37,"37369",125,95,93,0,2,"PP",29
24,"24122",1319,983,969,3,14,"PP",289
10,"10211",447,345,343,2,2,"PP",54
19,"19246",42,30,30,0,0,"PP",12
26,"26157",282,233,232,1,1,"PP",81
4,"4052",12767,9352,9269,90,83,"PP",1415
49,"49009",389,305,304,2,1,"PP",126
46,"46173",1319,1084,1062,6,22,"PP",252
3,"3091",241,201,196,0,5,"PP",87
15,"15027",1555,1227,1204,18,23,"PP",437
18,"18150",6903,5149,5063,42,86,"PP",812
16,"16032",277,224,223,1,1,"PP",65
12,"12077",4790,3594,3565,39,29,"PP",806
37,"37023",1586,1316,1298,12,18,"PP",238
12,"12134",135,102,100,0,2,"PP",18
50,"50245",76,58,58,0,0,"PP",11
4,"4053",12500,9437,9298,56,139,"PP",2603
26,"26158",246,207,206,2,1,"PP",94
22,"22039",805,667,662,5,5,"PP",155
49,"49255",396,324,323,3,1,"PP",148
14,"14013",16604,12618,12388,155,230,"PP",2826
26,"26042",799,605,596,5,9,"PP",176
10,"10092",266,216,211,18,5,"PP",44
19,"19203",29,25,25,0,0,"PP",4
29,"29020",3280,2531,2485,23,46,"PP",251
32,"32055",1230,908,889,5,19,"PP",404
6,"6025",5096,3981,3904,28,77,"PP",832
18,"18152",906,692,686,1,6,"PP",75
5,"5184",240,207,204,1,3,"PP",77
22,"22040",144,124,120,1,4,"PP",38
44,"44211",35,24,24,0,0,"PP",3
16,"16034",155,124,122,1,2,"PP",44
42,"42051",15,10,10,0,0,"PP",8
37,"37372",134,104,104,0,0,"PP",35
9,"9287",199,169,168,1,1,"PP",22
42,"42188",43,35,34,1,1,"PP",11
50,"50247",842,621,616,7,5,"PP",138
3,"3062",221,182,180,1,2,"PP",22
22,"22115",347,262,261,1,1,"PP",77
43,"43055",1988,1631,1622,7,9,"PP",36
15,"15092",6250,4358,4297,28,61,"PP",1486
44,"44212",41,32,32,0,0,"PP",11
3,"3002",3631,2841,2801,16,40,"PP",604
49,"49132",313,252,249,0,3,"PP",99
9,"9449",92,75,74,1,1,"PP",19
50,"50072",195,164,161,3,3,"PP",41
40,"40119",166,133,132,1,1,"PP",40
50,"50248",502,390,377,6,13,"PP",80
45,"45060",158,118,118,0,0,"PP",12
40,"40221",48,42,42,0,0,"PP",10
19,"19061",53,45,45,0,0,"PP",18
9,"9405",129,99,97,1,2,"PP",34
47,"47075",4775,3849,3784,38,65,"PP",1162
1,"1046",631,464,461,0,3,"PP",56
34,"34010",553,454,449,3,5,"PP",168
10,"10054",524,435,422,1,13,"PP",99
5,"5030",43,36,36,0,0,"PP",4
16,"16211",322,233,229,0,4,"PP",67
18,"18120",257,219,217,1,2,"PP",30
12,"12017",148,120,116,0,4,"PP",41
24,"24130",418,331,326,0,5,"PP",94
44,"44120",219,158,152,1,6,"PP",43
42,"42053",21,15,15,0,0,"PP",12
15,"15032",3413,2487,2414,28,73,"PP",1021
22,"22165",452,360,356,1,4,"PP",113
37,"37150",36,31,31,0,0,"PP",22
50,"50074",6166,4547,4444,33,103,"PP",677
6,"6028",4109,3613,3538,17,75,"PP",891
40,"40223",228,181,181,0,0,"PP",39
47,"47172",135,119,119,0,0,"PP",26
22,"22043",93,68,67,1,1,"PP",15
47,"47142",124,94,92,0,2,"PP",33
16,"16123",66,43,43,0,0,"PP",8
45,"45063",380,294,289,0,5,"PP",91
32,"32003",889,667,654,3,13,"PP",319
46,"46240",206,175,169,2,6,"PP",46
46,"46149",344,260,256,2,4,"PP",87
37,"37377",218,181,176,2,5,"PP",59
4,"4059",1025,742,731,3,11,"PP",128
19,"19067",69,53,50,1,3,"PP",5
12,"12051",448,324,319,2,5,"PP",192
49,"49017",259,196,195,0,1,"PP",114
5,"5074",665,571,565,2,6,"PP",210
6,"6129",573,455,451,2,4,"PP",99
16,"16040",85,72,72,1,0,"PP",34
15,"15034",2724,1832,1811,8,21,"PP",418
24,"24014",7180,5189,5097,46,92,"PP",1134
16,"16124",1826,1482,1455,6,27,"PP",395
43,"43108",1778,1374,1365,6,9,"PP",54
9,"9184",7,5,5,0,0,"PP",1
7,"7031",24784,16683,16527,160,156,"PP",2686
9,"9456",137,104,104,0,0,"PP",32
19,"19302",52,43,41,1,2,"PP",11
37,"37030",81,68,65,0,3,"PP",25
26,"26127",186,162,159,1,3,"PP",62
46,"46120",1183,958,936,3,22,"PP",170
46,"46181",16908,12749,12597,82,152,"PP",2148
50,"50076",75,64,63,0,1,"PP",11
10,"10903",796,623,614,4,9,"PP",99
49,"49019",228,170,164,0,6,"PP",42
46,"46090",1633,1413,1392,5,21,"PP",330
6,"6031",461,316,301,1,15,"PP",99
40,"40086",660,570,548,3,22,"PP",139
14,"14020",338,240,233,2,7,"PP",35
24,"24095",307,237,235,0,2,"PP",61
47,"47048",175,148,148,0,0,"PP",51
47,"47080",35,23,21,0,2,"PP",5
26,"26168",5515,4130,4077,36,53,"PP",781
12,"12142",145,123,121,1,2,"PP",37
43,"43036",865,605,602,1,3,"PP",16
40,"40124",234,175,168,3,7,"PP",30
26,"26051",210,178,176,1,2,"PP",71
6,"6032",78,65,64,0,1,"PP",10
43,"43134",273,224,223,5,1,"PP",3
14,"14021",260397,195951,193914,2025,2037,"PP",39514
24,"24136",496,375,371,2,4,"PP",144
40,"40018",75,60,60,0,0,"PP",26
39,"39062",1841,1511,1500,9,11,"PP",423
28,"28151",3251,2483,2450,11,33,"PP",401
9,"9460",167,149,149,5,0,"PP",68
50,"50078",231,173,171,0,2,"PP",46
2,"2024",3374,2657,2613,23,44,"PP",489
9,"9413",408,313,310,2,3,"PP",87
19,"19173",51,47,47,0,0,"PP",9
45,"45069",1817,1460,1438,4,22,"PP",371
42,"42021",68,44,44,2,0,"PP",16
46,"46153",435,364,356,1,8,"PP",51
19,"19023",127,98,96,0,2,"PP",28
43,"43906",2103,1595,1587,14,8,"PP",77
28,"28087",3259,2643,2623,16,20,"PP",622
37,"37158",233,168,166,0,2,"PP",40
29,"29063",303,243,239,1,4,"PP",85
12,"12056",257,218,216,1,2,"PP",47
19,"19219",9,7,7,0,0,"PP",0
9,"9464",33,27,27,0,0,"PP",14
48,"48038",1158,891,891,2,0,"PP",20
39,"39035",9169,7135,7045,40,90,"PP",1594
49,"49143",194,141,135,2,6,"PP",61
45,"45163",8340,6486,6363,38,123,"PP",1200
44,"44060",37,28,28,0,0,"PP",10
37,"37310",172,125,124,3,1,"PP",36
9,"9466",112,87,85,2,2,"PP",43
44,"44127",57,45,45,0,0,"PP",12
39,"39007",393,300,298,1,2,"PP",59
5,"5235",139,106,101,0,5,"PP",38
16,"16173",190,141,141,0,0,"PP",53
50,"50170",364,286,279,1,7,"PP",63
13,"13001",1195,947,943,5,4,"PP",243
45,"45073",287,226,225,1,1,"PP",94
34,"34023",5098,4016,3973,48,43,"PP",806
42,"42108",10,7,7,0,0,"PP",6
29,"29088",2694,2019,1951,31,68,"PP",330
3,"3103",245,212,211,4,1,"PP",43
15,"15039",1224,874,850,11,24,"PP",345
4,"4067",520,387,379,1,8,"PP",89
39,"39037",2019,1572,1560,2,12,"PP",484
46,"46258",2636,2100,2079,9,21,"PP",550
44,"44031",82,52,52,1,0,"PP",17
34,"34163",46,40,40,1,0,"PP",18
50,"50256",74,46,45,0,1,"PP",24
22,"22051",91,78,78,1,0,"PP",22
21,"21022",186,132,129,0,3,"PP",25
46,"46095",578,467,458,1,9,"PP",125
46,"46156",2024,1642,1628,7,14,"PP",441
49,"49066",449,319,314,4,5,"PP",118
10,"10107",1030,840,828,5,12,"PP",215
46,"46259",462,395,394,2,1,"PP",74
12,"12059",228,191,188,0,3,"PP",39
40,"40129",164,129,128,2,1,"PP",52
50,"50082",84,63,63,0,0,"PP",18
24,"24023",262,208,206,3,2,"PP",71
40,"40093",76,68,67,0,1,"PP",28
18,"18028",907,766,756,0,10,"PP",240
10,"10067",10245,7850,7701,80,149,"PP",1905
46,"46005",23013,17487,17286,112,201,"PP",2433
38,"38004",4490,3242,3202,18,40,"PP",430
44,"44223",73,58,58,0,0,"PP",19
5,"5199",37,31,31,0,0,"PP",18
42,"42204",54,45,43,2,2,"PP",12
40,"40130",128,102,96,0,6,"PP",42
46,"46260",2647,2136,2113,8,23,"PP",378
50,"50173",149,107,105,0,2,"PP",35
50,"50083",84,70,68,0,2,"PP",10
9,"9476",60,50,50,0,0,"PP",13
9,"9143",27,18,18,0,0,"PP",8
37,"37040",382,319,316,1,3,"PP",93
19,"19086",1392,1095,1083,7,12,"PP",298
29,"29091",9407,6859,6719,63,140,"PP",1503
37,"37276",126,101,101,0,0,"PP",40
49,"49271",181,147,144,1,3,"PP",43
10,"10110",2224,1618,1559,5,59,"PP",352
37,"37164",238,194,193,4,1,"PP",44
22,"22178",103,84,84,2,0,"PP",18
23,"23029",806,651,637,0,14,"PP",192
28,"28092",153428,121511,120211,807,1300,"PP",18336
9,"9201",28,20,19,0,1,"PP",10
40,"40903",77,63,62,0,1,"PP",31
37,"37240",939,694,686,3,8,"PP",156
45,"45032",444,319,313,2,6,"PP",53
47,"47088",105,90,90,0,0,"PP",32
49,"49272",77,55,51,0,4,"PP",24
1,"1061",152,129,129,2,0,"PP",1
4,"4072",314,245,240,0,5,"PP",72
19,"19226",41,32,32,0,0,"PP",9
5,"5086",76,64,61,0,3,"PP",32
9,"9314",92,75,74,1,1,"PP",20
10,"10112",1518,1168,1151,4,17,"PP",402
26,"26024",210,171,169,1,2,"PP",62
37,"37042",41,32,31,1,1,"PP",17
46,"46190",50023,37273,36976,250,297,"PP",5065
47,"47184",541,447,441,0,6,"PP",173
45,"45080",3,3,3,0,0,"PP",2
22,"22055",310,258,255,2,3,"PP",60
9,"9315",393,291,286,4,5,"PP",54
21,"21027",50,40,39,0,1,"PP",12
10,"10113",2258,1695,1657,6,38,"PP",279
13,"13009",1397,1145,1123,4,22,"PP",384
44,"44132",58,47,47,0,0,"PP",18
37,"37044",450,342,335,6,7,"PP",118
46,"46009",3140,2582,2536,14,46,"PP",471
20,"20020",113,67,67,0,0,"PP",1
46,"46191",1949,1541,1505,7,36,"PP",380
18,"18173",8972,6594,6459,58,135,"PP",941
26,"26026",1265,1061,1049,2,12,"PP",363
48,"48046",12644,9809,9744,46,65,"PP",268
42,"42071",163,111,108,2,3,"PP",44
5,"5088",29,23,23,0,0,"PP",8
9,"9152",248,197,195,0,2,"PP",72
19,"19040",57,40,40,0,0,"PP",6
47,"47185",87,77,77,0,0,"PP",19
44,"44133",15,12,12,0,0,"PP",5
37,"37045",28,19,18,0,1,"PP",8
28,"28095",1677,1310,1293,4,17,"PP",246
26,"26181",14,14,14,0,0,"PP",10
24,"24029",695,521,520,4,1,"PP",100
9,"9154",124,101,101,3,0,"PP",39
41,"41056",3694,3044,3009,36,35,"PP",216
6,"6044",29204,21778,21492,203,286,"PP",4362
9,"9100",58,46,46,0,0,"PP",20
23,"23098",838,721,715,2,6,"PP",199
24,"24069",39,27,27,0,0,"PP",23
16,"16143",15,10,10,1,0,"PP",3
27,"27030",3134,2209,2162,27,47,"PP",924
43,"43020",2276,1831,1819,12,12,"PP",72
28,"28162",2771,2264,2243,6,21,"PP",430
16,"16057",64,53,53,0,0,"PP",16
15,"15047",2269,1531,1497,25,34,"PP",520
13,"13013",7050,5475,5371,39,104,"PP",1332
38,"38010",3974,2814,2777,20,37,"PP",446
42,"42076",201,157,151,0,6,"PP",50
6,"6145",899,744,723,1,21,"PP",186
48,"48048",543,421,419,1,2,"PP",4
46,"46011",7523,5320,5235,28,85,"PP",935
26,"26183",66,50,50,0,0,"PP",15
41,"41001",1565,1224,1213,8,11,"PP",190
9,"9429",55,41,41,0,0,"PP",19
43,"43144",1236,1025,1021,8,4,"PP",34
47,"47093",797,628,615,6,13,"PP",188
18,"18141",384,269,264,0,5,"PP",124
40,"40139",258,207,202,0,5,"PP",58
34,"34036",238,199,198,1,1,"PP",43
24,"24154",955,702,691,3,11,"PP",181
47,"47188",99,77,77,0,0,"PP",29
19,"19190",2302,1788,1767,13,21,"PP",404
37,"37049",127,89,89,0,0,"PP",36
14,"14034",304,246,239,1,7,"PP",84
48,"48913",1224,977,967,6,10,"PP",24
22,"22060",1172,906,901,13,5,"PP",178
4,"4078",1110,819,814,2,5,"PP",120
42,"42079",21,18,18,1,0,"PP",9
6,"6113",2677,2117,2076,13,41,"PP",383
37,"37172",853,601,590,4,11,"PP",207
16,"16019",185,147,147,0,0,"PP",64
40,"40105",44,39,38,0,1,"PP",14
6,"6014",6535,4757,4679,36,78,"PP",1344
23,"23002",17399,13575,13341,97,234,"PP",2482
22,"22024",222,179,177,1,2,"PP",23
2,"2003",133957,105024,104115,786,909,"PP",21288
13,"13017",247,189,188,2,1,"PP",53
12,"12070",499,434,430,3,4,"PP",132
46,"46105",16132,11703,11582,64,121,"PP",2029
19,"19147",45,36,36,0,0,"PP",9
20,"20905",153,124,124,1,0,"PP",0
16,"16062",25,21,21,0,0,"PP",3
37,"37173",1420,1077,1058,13,19,"PP",338
19,"19099",289,217,214,0,3,"PP",54
10,"10121",7914,5924,5809,36,115,"PP",1384
42,"42081",136,95,93,0,2,"PP",26
19,"19237",40,33,33,0,0,"PP",6
4,"4044",1533,1190,1176,8,14,"PP",354
35,"35017",27216,17531,17102,133,429,"PP",2547
9,"9164",150,116,114,0,2,"PP",34
24,"24114",2893,2017,1989,17,28,"PP",397
34,"34041",84,73,72,3,1,"PP",26
2,"2005",545,443,436,5,7,"PP",128
3,"3116",1159,901,884,3,17,"PP",216
16,"16063",113,86,83,0,3,"PP",29
6,"6115",1243,898,876,3,22,"PP",169
26,"26070",155,133,132,0,1,"PP",68
2,"2006",561,482,480,2,2,"PP",189
6,"6049",974,732,712,7,20,"PP",143
38,"38014",1341,991,981,6,10,"PP",148
46,"46198",871,707,693,4,14,"PP",98
34,"34181",422,324,321,3,3,"PP",61
10,"10204",419,342,339,4,3,"PP",105
5,"5097",476,332,327,0,5,"PP",136
13,"13021",417,343,343,0,0,"PP",119
15,"15052",4104,2928,2878,30,50,"PP",935
12,"12072",1082,901,889,15,12,"PP",282
9,"9011",73,50,49,0,1,"PP",14
3,"3024",3948,3210,3164,14,46,"PP",961
29,"29902",2592,1841,1817,18,24,"PP",239
14,"14038",32692,24015,23679,213,336,"PP",4579
5,"5099",457,392,389,2,3,"PP",125
23,"23040",1443,1164,1149,3,15,"PP",187
40,"40036",502,413,406,11,7,"PP",138
49,"49040",112,97,97,0,0,"PP",26
27,"27006",2458,1713,1666,27,47,"PP",598
10,"10125",862,655,639,4,16,"PP",156
40,"40179",626,540,529,2,11,"PP",154
3,"3025",1292,1009,991,7,18,"PP",269
16,"16196",602,522,510,3,12,"PP",140
49,"49041",414,309,307,4,2,"PP",73
18,"18076",790,607,604,1,3,"PP",68
43,"43001",694,543,543,5,0,"PP",14
4,"4084",341,258,255,0,3,"PP",74
47,"47098",556,480,475,4,5,"PP",135
46,"46109",6174,4763,4639,30,124,"PP",847
40,"40144",18,16,16,0,0,"PP",7
6,"6151",1054,791,778,2,13,"PP",121
50,"50269",279,189,186,1,3,"PP",74
9,"9274",1045,875,867,8,8,"PP",224
43,"43149",684,533,533,4,0,"PP",18
27,"27007",2756,2148,2084,29,64,"PP",1063
16,"16067",119,96,93,2,3,"PP",44
6,"6053",590,461,444,7,17,"PP",63
32,"32023",1132,867,862,7,5,"PP",323
3,"3026",1316,1040,1024,5,16,"PP",198
19,"19242",77,67,67,0,0,"PP",33
9,"9170",209,164,159,0,5,"PP",49
46,"46201",62,47,47,0,0,"PP",5
4,"4085",371,305,303,2,2,"PP",107
16,"16154",4752,3798,3732,37,66,"PP",1115
5,"5062",166,136,133,0,3,"PP",62
46,"46080",985,799,788,5,11,"PP",197
22,"22068",65,46,44,1,2,"PP",10
12,"12075",107,89,87,0,2,"PP",13
11,"11023",9372,7032,6950,94,82,"PP",667
46,"46202",17660,13782,13645,93,137,"PP",2247
2,"2011",578,461,459,2,2,"PP",156
42,"42087",51,45,44,1,1,"PP",7
22,"22201",266,192,192,2,0,"PP",31
50,"50186",37,28,28,0,0,"PP",7
50,"50271",248,197,189,2,8,"PP",55
18,"18183",624,442,441,1,1,"PP",88
46,"46020",3792,3028,2973,11,55,"PP",696
34,"34049",329,251,247,5,4,"PP",83
49,"49167",179,140,136,2,4,"PP",43
24,"24205",981,744,732,8,12,"PP",238
27,"27009",2022,1514,1488,17,26,"PP",806
36,"36020",2184,1621,1599,13,22,"PP",781
3,"3029",244,174,167,1,7,"PP",39
46,"46112",542,460,454,0,6,"PP",142
4,"4088",2435,1708,1693,6,15,"PP",323
37,"37293",106,75,74,0,1,"PP",27
21,"21042",15579,8742,8579,138,163,"PP",1493
9,"9019",144,113,109,1,4,"PP",39
26,"26077",17,17,17,0,0,"PP",4
19,"19110",56,47,47,0,0,"PP",16
10,"10130",1747,1352,1321,12,31,"PP",283
45,"45101",3709,3052,3002,14,50,"PP",1058
37,"37294",11787,9201,9083,76,118,"PP",2017
44,"44240",149,121,121,0,0,"PP",32
37,"37062",77,65,63,0,2,"PP",29
29,"29052",222,156,153,2,3,"PP",31
37,"37296",298,241,239,2,2,"PP",79
14,"14043",7408,5721,5619,76,102,"PP",780
6,"6156",1171,919,901,10,18,"PP",220
20,"20033",854,675,671,5,4,"PP",13
50,"50013",200,166,166,3,0,"PP",35
10,"10009",263,196,193,2,3,"PP",90
43,"43078",843,653,644,4,9,"PP",25
30,"30004",1126,884,876,5,8,"PP",241
6,"6057",537,442,433,1,9,"PP",153
10,"10132",365,276,271,2,5,"PP",48
43,"43152",434,357,356,0,1,"PP",4
14,"14044",1620,1279,1264,12,15,"PP",158
19,"19059",74,53,46,0,7,"PP",23
34,"34052",167,144,143,2,1,"PP",62
26,"26079",620,526,521,0,5,"PP",227
24,"24167",716,516,505,4,11,"PP",106
34,"34053",200,176,171,5,5,"PP",68
18,"18083",228,189,188,1,1,"PP",52
19,"19249",28,28,28,0,0,"PP",15
50,"50189",678,544,534,5,10,"PP",137
6,"6058",1980,1519,1493,13,26,"PP",313
50,"50100",306,238,235,3,3,"PP",63
16,"16206",196,146,144,3,2,"PP",40
22,"22076",288,228,226,1,2,"PP",70
28,"28174",1840,1363,1349,10,14,"PP",286
19,"19208",41,34,34,0,0,"PP",10
5,"5108",40,28,28,0,0,"PP",8
18,"18048",2462,1873,1832,16,41,"PP",168
47,"47105",175,152,149,1,3,"PP",48
9,"9179",38,32,32,0,0,"PP",16
6,"6059",1759,1300,1285,12,15,"PP",323
28,"28037",1578,1196,1180,5,16,"PP",212
45,"45105",380,284,275,2,9,"PP",95
50,"50015",81,61,59,1,2,"PP",9
27,"27013",3684,2997,2935,26,62,"PP",882
37,"37186",96,79,79,0,0,"PP",39
6,"6159",2339,1577,1507,25,70,"PP",332
19,"19250",15,13,13,0,0,"PP",2
46,"46116",13608,10792,10731,76,61,"PP",1884
44,"44213",65,46,46,0,0,"PP",18
12,"12080",1900,1604,1575,10,29,"PP",286
2,"2017",777,588,584,0,4,"PP",180
36,"36024",16395,12372,12165,102,207,"PP",4854
10,"10013",266,203,202,2,1,"PP",65
12,"12138",19179,14217,14006,124,211,"PP",2277
50,"50191",445,341,337,2,4,"PP",95
43,"43008",307,202,200,1,2,"PP",13
47,"47076",17721,14605,14438,134,167,"PP",2461
44,"44051",2588,2034,1997,26,37,"PP",692
40,"40048",35,29,29,0,0,"PP",12
47,"47109",171,130,130,1,0,"PP",30
3,"3128",4295,3007,2982,24,25,"PP",646
28,"28039",125,103,103,2,0,"PP",23
19,"19252",60,49,47,0,2,"PP",17
13,"13036",766,626,617,0,9,"PP",196
15,"15064",2127,1608,1577,29,31,"PP",484
24,"24052",139,99,99,0,0,"PP",25
10,"10015",627,488,475,0,13,"PP",117
4,"4095",690,508,502,2,6,"PP",116
12,"12139",302,219,217,3,2,"PP",52
6,"6128",4415,3345,3288,34,57,"PP",671
45,"45109",2786,2273,2206,9,67,"PP",696
39,"39086",362,273,268,1,5,"PP",78
49,"49016",229,189,187,2,2,"PP",54
42,"42055",165,124,122,2,2,"PP",43
28,"28040",16648,11709,11551,66,158,"PP",1595
49,"49175",205,150,149,2,1,"PP",65
37,"37189",114,88,88,2,0,"PP",26
19,"19255",72,51,51,0,0,"PP",23
22,"22079",114,89,88,1,1,"PP",12
27,"27016",6973,5139,5064,66,75,"PP",1793
37,"37303",181,137,137,1,0,"PP",36
6,"6063",2938,2299,2264,11,35,"PP",418
47,"47111",998,806,795,6,11,"PP",185
24,"24053",406,279,276,6,3,"PP",114
29,"29025",41515,29572,29311,221,261,"PP",4787
49,"49018",288,225,222,1,3,"PP",87
19,"19169",33,26,25,0,1,"PP",4
29,"29082",34113,26248,26002,304,246,"PP",4542
47,"47206",78,64,64,0,0,"PP",24
42,"42193",16,7,7,0,0,"PP",5
38,"38027",5545,3937,3896,22,41,"PP",715
40,"40016",54,43,43,1,0,"PP",18
43,"43109",2704,1937,1922,16,15,"PP",93
9,"9030",119,90,89,1,1,"PP",27
12,"12084",17723,13501,13281,118,220,"PP",3053
9,"9354",33,29,29,2,0,"PP",8
39,"39060",6693,5459,5394,29,65,"PP",927
3,"3037",341,289,284,1,5,"PP",47
49,"49178",747,574,564,4,10,"PP",112
37,"37155",68,52,52,0,0,"PP",12
10,"10141",289,224,223,0,1,"PP",65
3,"3099",42876,32576,32172,192,404,"PP",8474
37,"37379",173,152,152,0,0,"PP",38
37,"37192",355,234,227,5,7,"PP",51
42,"42103",554,448,442,2,6,"PP",186
10,"10142",840,641,639,5,2,"PP",109
22,"22213",2923,2261,2221,24,40,"PP",418
19,"19259",28,24,24,0,0,"PP",2
2,"2023",515,442,435,1,7,"PP",144
20,"20041",234,156,151,2,5,"PP",3
49,"49179",346,233,232,0,1,"PP",90
34,"34062",150,108,107,1,1,"PP",38
24,"24176",299,243,238,3,5,"PP",100
28,"28119",2245,1839,1821,10,18,"PP",374
34,"34019",110,92,91,2,1,"PP",33
49,"49020",261,215,210,2,5,"PP",61
5,"5117",193,169,167,0,2,"PP",72
49,"49061",145,111,108,0,3,"PP",37
16,"16004",227,193,191,0,2,"PP",76
23,"23021",517,446,440,0,6,"PP",81
50,"50168",27,20,20,0,0,"PP",5
10,"10144",920,731,723,4,8,"PP",247
4,"4064",2879,2196,2179,12,17,"PP",661
49,"49022",280,243,241,1,2,"PP",64
28,"28045",35264,27864,27597,180,267,"PP",4859
28,"28014",34047,26858,26575,178,283,"PP",4366
44,"44056",457,352,341,4,11,"PP",116
41,"41093",19012,15637,15525,97,112,"PP",3361
16,"16044",43,31,30,0,1,"PP",14
37,"37307",148,110,107,2,3,"PP",51
5,"5118",68,44,43,0,1,"PP",16
3,"3134",141,119,117,0,2,"PP",32
23,"23055",46343,33603,33225,243,378,"PP",5539
2,"2026",832,682,673,6,9,"PP",134
6,"6068",431,324,317,4,7,"PP",53
26,"26131",34,34,34,1,0,"PP",20
18,"18024",831,682,667,6,15,"PP",143
48,"48039",256,218,217,1,1,"PP",5
44,"44251",242,197,187,0,10,"PP",78
24,"24059",821,575,572,3,3,"PP",127
16,"16172",349,278,275,3,3,"PP",101
47,"47052",6752,5665,5589,57,76,"PP",828
9,"9037",106,97,97,0,0,"PP",12
10,"10146",1513,1128,1104,6,24,"PP",263
24,"24179",299,239,238,3,1,"PP",104
13,"13047",5780,4553,4461,32,92,"PP",1097
23,"23056",3062,2332,2281,13,51,"PP",338
13,"13092",1715,1434,1425,1,9,"PP",449
19,"19263",22,13,12,0,1,"PP",3
6,"6069",3005,2172,2133,24,39,"PP",341
12,"12089",4546,3353,3304,12,49,"PP",812
3,"3135",192,157,155,0,2,"PP",21
47,"47022",59,56,54,1,2,"PP",23
2,"2027",283,239,238,3,1,"PP",57
44,"44061",75,66,65,2,1,"PP",14
37,"37080",212,173,169,0,4,"PP",48
38,"38033",3594,2512,2467,11,45,"PP",510
22,"22086",209,157,155,1,2,"PP",32
18,"18096",344,265,265,2,0,"PP",39
34,"34218",445,352,345,2,7,"PP",134
16,"16092",154,113,112,0,1,"PP",37
9,"9417",42,32,32,0,0,"PP",21
36,"36033",12244,9553,9358,80,195,"PP",2310
30,"30016",152709,110165,109114,717,1051,"PP",22237
47,"47117",286,240,235,0,5,"PP",60
11,"11041",9858,6916,6763,70,153,"PP",1152
40,"40058",309,277,271,0,6,"PP",127
23,"23027",716,524,518,2,6,"PP",104
9,"9140",115,88,88,2,0,"PP",26
37,"37162",209,156,153,1,3,"PP",50
50,"50286",75,58,55,0,3,"PP",11
15,"15073",21760,14900,14630,181,270,"PP",4083
4,"4902",45395,31127,30881,251,246,"PP",7014
47,"47118",149,111,108,1,3,"PP",36
46,"46218",1031,907,885,6,22,"PP",242
7,"7006",5332,3769,3722,25,47,"PP",423
2,"2030",2978,2357,2315,13,42,"PP",424
37,"37313",534,413,411,1,2,"PP",137
42,"42113",521,382,380,3,2,"PP",163
4,"4903",4308,3102,3075,17,27,"PP",934
48,"48073",6837,4950,4921,33,29,"PP",117
39,"39067",759,582,575,3,7,"PP",142
28,"28125",3216,2459,2444,11,15,"PP",503
50,"50201",444,357,354,1,3,"PP",55
16,"16234",23,16,16,0,0,"PP",2
10,"10028",82,60,59,0,1,"PP",12
15,"15074",3919,2865,2808,33,57,"PP",1201
22,"22088",143,111,111,1,0,"PP",24
9,"9044",53,49,47,1,2,"PP",8
19,"19133",81,70,70,0,0,"PP",13
19,"19268",43,42,42,0,0,"PP",11
16,"16236",865,669,665,2,4,"PP",179
42,"42206",8,4,4,0,0,"PP",2
22,"22089",276,216,216,2,0,"PP",39
13,"13007",1233,1005,967,11,38,"PP",251
43,"43140",2438,1847,1837,16,10,"PP",79
24,"24065",2175,1695,1660,18,35,"PP",367
12,"12093",165,128,126,0,2,"PP",38
6,"6073",700,506,492,11,14,"PP",72
16,"16096",280,239,234,3,5,"PP",49
29,"29036",611,448,444,3,4,"PP",76
36,"36037",2554,1839,1793,6,46,"PP",591
37,"37315",86,68,67,0,1,"PP",32
3,"3076",8736,6571,6467,40,104,"PP",1515
13,"13054",4914,3946,3890,31,56,"PP",1347
19,"19269",94,75,75,0,0,"PP",10
9,"9202",22,22,22,2,0,"PP",17
29,"29037",215,179,179,0,0,"PP",56
23,"23062",1418,1206,1190,5,16,"PP",316
24,"24066",449,329,324,3,5,"PP",125
47,"47216",114,102,98,0,4,"PP",27
43,"43018",385,335,334,3,1,"PP",4
37,"37087",910,755,747,3,8,"PP",152
46,"46130",857,680,669,6,11,"PP",137
12,"12001",1033,834,825,8,9,"PP",215
44,"44065",57,37,36,0,1,"PP",27
28,"28052",3949,2890,2818,8,72,"PP",662
34,"34076",545,475,473,2,2,"PP",212
50,"50204",2394,1876,1855,21,21,"PP",210
40,"40062",57,49,49,0,0,"PP",21
46,"46100",281,210,205,0,5,"PP",43
5,"5167",225,181,175,1,6,"PP",36
9,"9425",476,366,362,1,4,"PP",96
29,"29038",18683,12820,12666,168,154,"PP",1804
43,"43093",3884,2956,2933,14,23,"PP",108
11,"11011",1736,1285,1249,7,36,"PP",224
21,"21065",255,178,173,2,5,"PP",53
22,"22226",771,598,591,6,7,"PP",104
49,"49077",159,104,103,0,1,"PP",52
38,"38039",11112,8233,8161,54,72,"PP",1450
3,"3048",4971,3808,3739,19,69,"PP",973
10,"10156",100,78,78,0,0,"PP",14
13,"13057",1105,934,919,3,15,"PP",308
21,"21029",1509,1183,1160,14,23,"PP",226
45,"45129",109,84,83,0,1,"PP",12
19,"19230",548,437,430,1,7,"PP",50
47,"47091",74,64,63,1,1,"PP",15
37,"37009",196,142,141,1,1,"PP",63
46,"46041",327,251,250,2,1,"PP",43
4,"4036",223,188,186,1,2,"PP",54
42,"42033",50,45,44,1,1,"PP",24
37,"37047",228,93,92,1,1,"PP",43
9,"9211",1362,1065,1050,16,15,"PP",398
34,"34228",76,62,62,0,0,"PP",26
16,"16101",139,123,122,0,1,"PP",29
50,"50119",872,684,680,4,4,"PP",141
42,"42121",55,42,42,0,0,"PP",9
2,"2037",22952,16040,15815,101,225,"PP",3315
45,"45131",264,226,225,0,1,"PP",70
18,"18912",1367,990,984,5,6,"PP",131
23,"23065",1550,1199,1186,4,13,"PP",253
50,"50206",453,371,370,5,1,"PP",98
37,"37282",194,148,146,1,2,"PP",43
50,"50120",55,43,43,2,0,"PP",3
2,"2038",266,217,216,1,1,"PP",81
27,"27001",2209,1290,1251,25,39,"PP",628
3,"3050",19334,14377,14253,71,124,"PP",2721
45,"45132",2376,1915,1908,13,7,"PP",523
49,"49079",103,91,79,1,12,"PP",31
9,"9380",73,53,53,0,0,"PP",25
9,"9904",468,371,369,3,2,"PP",111
46,"46134",2380,1836,1825,5,11,"PP",241
6,"6079",644,492,487,3,5,"PP",104
50,"50089",8584,6951,6912,34,39,"PP",922
3,"3081",1494,1163,1141,5,22,"PP",227
44,"44009",799,621,611,7,10,"PP",112
9,"9215",365,267,264,1,3,"PP",64
10,"10159",317,241,240,0,1,"PP",38
16,"16103",239,203,203,0,0,"PP",78
4,"4079",54086,38415,38134,239,281,"PP",7813
44,"44040",191,164,158,2,6,"PP",45
44,"44138",118,90,89,2,1,"PP",31
9,"9006",59,37,36,1,1,"PP",10
5,"5094",132,109,108,1,1,"PP",63
4,"4002",1039,798,792,7,6,"PP",127
5,"5133",67,48,48,0,0,"PP",20
18,"18106",415,300,295,0,5,"PP",59
47,"47222",86,71,71,0,0,"PP",16
13,"13018",766,644,634,0,10,"PP",147
6,"6047",837,677,669,6,8,"PP",157
45,"45135",4173,3402,3349,18,53,"PP",727
43,"43097",399,341,341,1,0,"PP",10
29,"29044",757,540,533,7,7,"PP",176
22,"22105",101,82,82,4,0,"PP",22
13,"13064",1836,1455,1446,18,9,"PP",236
46,"46045",1243,1033,1018,3,15,"PP",210
24,"24157",2545,2028,1972,25,56,"PP",528
22,"22062",154,115,115,1,0,"PP",35
37,"37098",304,214,210,0,4,"PP",50
4,"4004",400,320,315,2,5,"PP",56
30,"30027",49767,39111,38724,245,387,"PP",8098
47,"47034",72,57,57,1,0,"PP",25
23,"23069",5262,4395,4329,15,66,"PP",689
24,"24197",736,556,552,7,4,"PP",145
47,"47129",855,715,696,3,19,"PP",160
5,"5015",68,48,48,1,0,"PP",17
50,"50123",436,344,338,1,6,"PP",52
47,"47130",99,76,76,2,0,"PP",21
9,"9058",395,325,317,1,8,"PP",47
46,"46137",242,200,200,3,0,"PP",44
30,"30028",6400,4364,4289,30,75,"PP",778
50,"50210",36,29,29,0,0,"PP",9
47,"47035",902,715,707,5,8,"PP",233
47,"47224",97,74,74,0,0,"PP",11
20,"20058",739,555,551,4,4,"PP",28
37,"37099",61,46,46,1,0,"PP",19
50,"50211",237,177,173,0,4,"PP",62
49,"49203",287,229,223,2,6,"PP",103
12,"12008",224,197,194,1,3,"PP",68
45,"45001",1837,1371,1340,12,31,"PP",299
2,"2043",1173,975,962,1,13,"PP",247
18,"18109",599,452,448,3,4,"PP",123
9,"9060",128,111,111,1,0,"PP",46
42,"42130",51,46,45,0,1,"PP",26
27,"27037",1017,759,748,10,11,"PP",366
28,"28135",985,762,756,1,6,"PP",168
23,"23072",1885,1485,1468,5,17,"PP",382
40,"40073",385,339,335,6,4,"PP",135
38,"38046",9271,7297,7212,53,85,"PP",1000
29,"29047",1103,909,898,2,11,"PP",77
49,"49085",918,673,660,5,13,"PP",220
20,"20059",8867,6792,6759,21,33,"PP",135
47,"47132",39,33,33,0,0,"PP",11
22,"22109",266,207,205,3,2,"PP",41
32,"32050",2280,1788,1775,19,13,"PP",936
42,"42004",2294,1807,1767,22,40,"PP",456
15,"15086",2785,2015,1987,14,28,"PP",899
2,"2045",3617,3020,2969,38,51,"PP",473
50,"50009",97,72,71,1,1,"PP",28
44,"44175",113,84,82,1,2,"PP",26
40,"40180",277,231,224,3,7,"PP",94
9,"9061",148,129,129,0,0,"PP",87
47,"47037",163,134,128,2,6,"PP",50
22,"22110",707,531,528,2,3,"PP",108
37,"37102",379,297,291,3,6,"PP",96
50,"50126",2262,1736,1708,20,28,"PP",472
44,"44176",153,124,124,0,0,"PP",35
27,"27039",4430,3437,3353,53,84,"PP",1394
47,"47038",101,79,79,0,0,"PP",22
24,"24040",412,322,320,2,2,"PP",75
29,"29016",263,217,217,0,0,"PP",72
47,"47008",22,15,15,0,0,"PP",6
24,"24081",122,91,88,0,3,"PP",46
6,"6087",2030,1592,1571,16,21,"PP",384
21,"21077",1725,1307,1286,10,21,"PP",323
2,"2047",107,89,88,1,1,"PP",51
18,"18114",591,443,437,2,6,"PP",57
37,"37217",59,48,46,1,2,"PP",14
19,"19156",933,756,745,1,11,"PP",210
29,"29049",2926,2197,2165,9,32,"PP",293
43,"43101",145,122,122,1,0,"PP",2
5,"5141",95,82,82,0,0,"PP",35
34,"34092",260,210,206,0,4,"PP",113
22,"22111",146,115,115,1,0,"PP",23
26,"26002",827,643,639,5,4,"PP",184
50,"50011",116,100,99,0,1,"PP",12
29,"29050",398,274,269,2,5,"PP",49
48,"48088",133,99,98,2,1,"PP",1
36,"36050",7650,5616,5506,48,110,"PP",1323
24,"24083",1005,800,791,7,9,"PP",147
18,"18115",2650,1988,1975,20,13,"PP",244
15,"15089",4324,3258,3200,33,58,"PP",1165
44,"44178",53,39,39,0,0,"PP",14
49,"49091",248,185,183,4,2,"PP",61
19,"19290",851,581,577,5,4,"PP",98
43,"43103",905,746,740,8,6,"PP",28
19,"19007",435,328,319,1,9,"PP",110
44,"44084",55,45,45,0,0,"PP",20
26,"26004",66,54,54,0,0,"PP",35
43,"43176",746,588,586,7,2,"PP",14
19,"19008",37,32,32,1,0,"PP",7
38,"38021",1599,1079,1057,8,22,"PP",171
24,"24086",266,211,210,0,1,"PP",97
45,"45009",464,303,301,2,2,"PP",122
47,"47137",31,23,23,0,0,"PP",13
16,"16116",77,59,59,0,0,"PP",18
21,"21902",1144,829,824,9,5,"PP",68
46,"46235",21270,15754,15592,101,162,"PP",2222
49,"49092",116,87,86,0,1,"PP",35
38,"38052",1280,893,887,4,6,"PP",169
6,"6090",824,602,578,4,24,"PP",113
46,"46144",628,511,505,1,6,"PP",166
24,"24087",586,469,460,4,9,"PP",178
16,"16204",241,198,196,1,2,"PP",40
15,"15059",10255,7423,7262,122,161,"PP",2497
22,"22114",124,86,82,1,4,"PP",27
9,"9068",24,18,18,0,0,"PP",3
5,"5263",163,121,120,0,1,"PP",40
38,"38053",3763,2628,2588,21,40,"PP",515
6,"6091",3668,2839,2776,26,63,"PP",697
46,"46145",22099,16685,16499,128,186,"PP",2594
19,"19010",9,10,10,0,0,"PP",4
37,"37336",52,46,45,3,1,"PP",14
4,"4014",149,109,108,0,1,"PP",11
22,"22245",306,266,263,0,3,"PP",91
24,"24088",995,813,802,12,11,"PP",280
37,"37223",112,78,76,0,2,"PP",22
12,"12015",114,99,98,0,1,"PP",21
43,"43031",1446,1180,1178,7,2,"PP",28
45,"45012",631,516,509,2,7,"PP",185
9,"9071",40,32,32,0,0,"PP",13
6,"6092",555,428,419,3,9,"PP",74
37,"37110",103,84,82,0,2,"PP",20
46,"46146",1641,1314,1281,11,33,"PP",209
30,"30037",19254,14416,14217,67,199,"PP",3210
32,"32056",1520,1125,1116,6,9,"PP",636
13,"13079",12265,9441,9218,123,223,"PP",1998
5,"5148",23,17,17,0,0,"PP",7
46,"46147",17133,12260,12120,59,140,"PP",2468
34,"34902",123,98,98,4,0,"PP",53
19,"19013",114,99,99,0,0,"PP",21
45,"45152",547,448,442,1,6,"PP",91
12,"12109",653,544,533,3,11,"PP",124
42,"42145",134,108,108,0,0,"PP",27
43,"43901",8750,6057,6004,43,53,"PP",231
10,"10053",279,226,224,5,2,"PP",107
34,"34204",52,41,41,1,0,"PP",24
2,"2054",383,314,309,1,5,"PP",122
20,"20068",188,142,142,1,0,"PP",0
48,"48002",7777,6034,5981,48,53,"PP",153
47,"47141",118,103,102,0,1,"PP",56
16,"16121",233,183,179,0,4,"PP",39
28,"28069",56,47,45,2,2,"PP",7
37,"37225",99,90,86,1,4,"PP",36
18,"18121",130,104,103,3,1,"PP",23
48,"48094",3125,2407,2388,12,19,"PP",42
12,"12110",219,168,166,1,2,"PP",36
46,"46148",1509,1208,1195,7,13,"PP",249
28,"28147",990,779,769,2,10,"PP",135
45,"45016",4442,3621,3583,21,38,"PP",661
36,"36056",4961,3719,3635,30,84,"PP",1409
20,"20069",147441,111102,110598,762,504,"PP",9263
26,"26124",776,635,624,5,11,"PP",278
29,"29057",341,236,233,0,3,"PP",46
5,"5267",107,71,70,3,1,"PP",17
43,"43902",2743,1996,1980,16,16,"PP",71
24,"24214",634,473,471,3,2,"PP",131
50,"50221",32,22,22,0,0,"PP",2
35,"35001",4571,3523,3463,8,60,"PP",1070
32,"32059",1703,1248,1228,12,20,"PP",569
19,"19300",788,664,652,2,12,"PP",111
45,"45156",3338,2805,2750,9,55,"PP",578
37,"37229",139,110,106,2,4,"PP",32
48,"48095",2326,1691,1680,11,11,"PP",92
23,"23085",2182,1733,1717,7,16,"PP",239
10,"10057",126,97,96,2,1,"PP",9
9,"9076",24,17,17,1,0,"PP",6
50,"50194",81,59,59,1,0,"PP",23
21,"21051",221,180,177,1,3,"PP",29
42,"42152",67,47,46,0,1,"PP",15
2,"2021",1014,836,827,5,9,"PP",230
36,"36058",4942,3470,3402,37,68,"PP",906
34,"34060",135,111,110,0,1,"PP",48
16,"16167",292,235,229,1,6,"PP",48
18,"18123",288,219,219,2,0,"PP",42
5,"5154",34,25,25,1,0,"PP",12
42,"42153",12,10,10,1,0,"PP",7
28,"28072",6088,5001,4961,23,40,"PP",938
41,"41045",5854,4287,4200,58,87,"PP",355
23,"23086",11442,8618,8431,80,187,"PP",1183
32,"32033",676,480,468,4,12,"PP",255
16,"16126",729,622,616,5,6,"PP",168
37,"37118",120,93,90,2,3,"PP",20
19,"19121",264,219,217,0,2,"PP",46
43,"43904",2861,2083,2058,27,25,"PP",83
45,"45021",2605,1987,1950,23,37,"PP",369
47,"47145",586,446,440,2,6,"PP",139
9,"9242",66,53,53,1,0,"PP",22
18,"18022",13804,9877,9714,92,163,"PP",970
37,"37231",239,204,203,6,1,"PP",49
10,"10182",124,91,90,0,1,"PP",21
37,"37344",235,171,168,1,3,"PP",42
15,"15005",25263,17634,17347,257,287,"PP",3346
12,"12114",194,161,160,2,1,"PP",43
24,"24218",444,343,341,6,2,"PP",99
44,"44250",19,15,15,0,0,"PP",3
3,"3038",335,275,267,1,8,"PP",41
37,"37232",378,322,321,1,1,"PP",150
9,"9412",765,564,558,7,6,"PP",172
43,"43085",235,198,194,0,4,"PP",3
9,"9082",36,34,34,0,0,"PP",27
27,"27051",8012,5936,5832,70,104,"PP",1701
47,"47146",278,232,230,3,2,"PP",24
34,"34109",63,42,41,0,1,"PP",23
15,"15069",6588,4914,4830,58,84,"PP",1127
27,"27052",862,645,640,4,5,"PP",214
34,"34066",57,52,48,1,4,"PP",20
45,"45161",15266,11185,11023,69,162,"PP",1263
10,"10062",393,339,334,0,5,"PP",30
28,"28044",6193,5040,4991,31,49,"PP",779
49,"49227",313,255,254,1,1,"PP",71
5,"5040",64,51,51,1,0,"PP",20
23,"23088",6020,4779,4703,56,76,"PP",638
32,"32063",1819,1313,1287,6,26,"PP",445
30,"30901",10529,8488,8375,37,113,"PP",1969
44,"44190",65,45,43,0,2,"PP",14
9,"9414",181,148,146,0,2,"PP",55
24,"24098",1149,882,863,7,19,"PP",111
49,"49063",310,246,240,2,6,"PP",74
32,"32064",480,348,346,2,2,"PP",180
10,"10186",944,781,758,1,23,"PP",205
19,"19126",1687,1306,1285,9,21,"PP",205
47,"47115",276,231,223,1,8,"PP",93
34,"34112",39,30,30,0,0,"PP",9
27,"27053",501,384,373,1,11,"PP",100
4,"4027",226,147,147,1,0,"PP",45
9,"9084",167,132,127,4,5,"PP",52
41,"41049",9493,7463,7312,78,151,"PP",791
37,"37159",79,68,68,0,0,"PP",23
18,"18059",4253,3166,3123,22,43,"PP",346
40,"40128",122,95,93,2,2,"PP",22
32,"32065",630,478,474,5,4,"PP",176
22,"22901",714,521,508,3,13,"PP",71
24,"24100",754,602,598,7,4,"PP",162
43,"43113",397,325,323,2,2,"PP",7
50,"50141",109,90,90,1,0,"PP",47
29,"29065",194,150,150,0,0,"PP",64
10,"10065",200,149,149,0,0,"PP",24
50,"50902",79,69,69,0,0,"PP",25
24,"24224",574,435,427,3,8,"PP",142
37,"37001",172,133,133,0,0,"PP",52
34,"34114",198,152,152,0,0,"PP",88
9,"9362",205,177,177,3,0,"PP",36
39,"39093",302,256,256,2,0,"PP",76
48,"48011",9652,7293,7251,37,42,"PP",316
19,"19032",146,102,101,2,1,"PP",22
13,"13094",290,227,227,1,0,"PP",85
12,"12118",76,64,63,0,1,"PP",24
37,"37082",745,546,536,2,10,"PP",160
9,"9141",602,501,493,4,8,"PP",127
9,"9418",73,58,55,2,3,"PP",20
46,"46248",4886,3672,3613,25,59,"PP",743
37,"37350",404,310,307,0,3,"PP",128
24,"24225",992,762,751,5,11,"PP",223
12,"12028",12955,10391,10301,68,90,"PP",2082
49,"49232",84,71,70,0,1,"PP",23
6,"6105",604,406,400,2,6,"PP",93
9,"9090",50,45,45,2,0,"PP",18
42,"42161",135,104,104,0,0,"PP",53
5,"5044",250,189,189,1,0,"PP",104
1,"1016",421,236,229,3,7,"PP",34
46,"46158",1040,805,796,4,9,"PP",167
34,"34120",63965,50687,50117,471,570,"PP",13583
49,"49233",85,58,58,0,0,"PP",31
9,"9253",106,88,85,2,3,"PP",25
5,"5163",1705,1360,1345,4,15,"PP",503
37,"37003",107,82,82,1,0,"PP",41
19,"19034",23,23,22,0,1,"PP",2
18,"18135",4434,3169,3105,23,64,"PP",482
37,"37126",30,26,26,0,0,"PP",15
48,"48013",79423,59100,58630,458,470,"PP",4306
19,"19036",248,213,210,1,3,"PP",66
49,"49069",327,211,207,0,4,"PP",112
44,"44195",84,66,65,1,1,"PP",17
1,"1018",1408,998,993,6,5,"PP",85
37,"37086",104,88,88,0,0,"PP",40
20,"20079",18142,14055,13971,75,84,"PP",520
5,"5165",370,293,285,4,8,"PP",74
40,"40095",464,379,369,2,10,"PP",122
28,"28158",678,547,540,1,7,"PP",147
37,"37005",67,48,48,2,0,"PP",29
50,"50144",31,26,25,0,1,"PP",8
6,"6107",1570,1117,1106,9,11,"PP",170
16,"16181",57,46,46,1,0,"PP",20
35,"35010",3797,2601,2572,9,29,"PP",319
40,"40202",55,38,38,0,0,"PP",23
43,"43116",463,381,379,2,2,"PP",2
37,"37128",242,187,184,1,3,"PP",42
24,"24229",388,312,307,2,5,"PP",120
48,"48908",249,214,213,0,1,"PP",0
34,"34123",1637,1376,1354,8,22,"PP",491
9,"9424",34,24,24,0,0,"PP",17
27,"27059",2055,1508,1471,13,37,"PP",687
19,"19319",4583,3640,3585,24,55,"PP",411
39,"39013",535,434,431,1,3,"PP",176
22,"22019",175,151,151,0,0,"PP",22
16,"16904",451,386,383,3,3,"PP",85
46,"46070",17700,13558,13437,115,121,"PP",2250
2,"2070",384,318,318,2,0,"PP",24
47,"47154",146,122,118,2,4,"PP",53
47,"47123",461,391,390,3,1,"PP",110
37,"37279",726,570,562,6,8,"PP",182
10,"10114",962,754,737,2,17,"PP",69
22,"22137",1015,741,733,9,8,"PP",133
10,"10073",721,553,546,4,7,"PP",182
28,"28160",8629,6922,6856,34,66,"PP",1257
22,"22020",119,91,87,1,4,"PP",24
40,"40204",151,109,104,1,5,"PP",40
45,"45036",634,490,482,0,8,"PP",148
47,"47059",97,75,75,0,0,"PP",15
3,"3078",474,372,371,2,1,"PP",109
16,"16905",1278,1028,1012,11,16,"PP",183
41,"41028",2071,1741,1713,18,28,"PP",192
49,"49115",169,137,136,0,1,"PP",46
27,"27061",1016,784,763,9,21,"PP",263
19,"19323",34,29,29,0,0,"PP",8
9,"9261",449,343,342,5,1,"PP",100
39,"39015",824,646,644,2,2,"PP",171
24,"24189",5816,4434,4382,49,52,"PP",912
50,"50118",2110,1622,1605,19,17,"PP",296
47,"47030",941,759,740,3,19,"PP",214
37,"37132",325,232,231,0,1,"PP",88
9,"9101",74,57,57,0,0,"PP",32
9,"9262",158,137,136,1,1,"PP",52
37,"37245",335,240,240,5,0,"PP",102
49,"49116",360,255,248,5,7,"PP",97
45,"45038",3505,2749,2705,16,44,"PP",410
23,"23099",4822,3687,3633,28,54,"PP",853
35,"35013",6584,5067,4974,49,93,"PP",1543
10,"10076",793,597,585,4,12,"PP",128
23,"23033",1319,1076,1057,8,19,"PP",264
16,"16017",340,281,271,2,10,"PP",65
5,"5170",50,38,38,0,0,"PP",12
37,"37010",923,739,735,2,4,"PP",176
9,"9214",641,454,445,5,9,"PP",109
40,"40104",284,229,224,2,5,"PP",33
24,"24110",1154,895,880,5,15,"PP",161
42,"42034",44,36,36,1,0,"PP",4
7,"7047",2371,1775,1747,13,28,"PP",305
47,"47126",44,42,42,1,0,"PP",21
19,"19189",115,93,92,0,1,"PP",23
47,"47062",157,134,134,0,0,"PP",72
49,"49240",185,141,136,0,5,"PP",51
21,"21032",1801,1401,1378,8,23,"PP",247
3,"3021",5578,4720,4626,35,94,"PP",1063
19,"19045",127,107,107,1,0,"PP",41
49,"49118",194,151,151,1,0,"PP",63
23,"23901",1139,946,934,3,12,"PP",153
39,"39017",553,416,409,0,7,"PP",128
44,"44200",39,25,25,0,0,"PP",18
28,"28164",3202,2553,2530,19,23,"PP",391
50,"50033",65,50,50,1,0,"PP",12
22,"22103",676,520,517,6,3,"PP",66
49,"49119",222,181,180,0,1,"PP",38
27,"27064",1503,1078,1039,12,39,"PP",496
37,"37248",152,125,121,1,4,"PP",54
26,"26031",98,89,87,0,2,"PP",30
32,"32047",1746,1272,1252,6,20,"PP",658
47,"47128",56,49,46,0,3,"PP",24
47,"47160",392,317,314,2,3,"PP",104
45,"45043",783,670,664,6,6,"PP",253
4,"4043",511,423,421,3,2,"PP",110
16,"16148",546,481,479,1,2,"PP",244
39,"39018",4272,3533,3476,17,57,"PP",417
14,"14005",6318,4464,4380,59,84,"PP",506
18,"18144",803,650,640,2,10,"PP",122
2,"2077",54,45,44,0,1,"PP",13
37,"37014",1153,414,411,4,3,"PP",134
22,"22149",308,247,246,3,1,"PP",43
49,"49121",368,269,266,1,3,"PP",78
44,"44203",9,9,9,0,0,"PP",2
34,"34132",107,84,83,0,1,"PP",29
12,"12128",1362,1099,1076,9,23,"PP",176
9,"9269",29,25,23,1,2,"PP",8
16,"16023",507,401,398,2,3,"PP",72
20,"20906",130,99,98,1,1,"PP",0
48,"48022",2316,1645,1631,11,14,"PP",44
37,"37250",332,232,231,1,1,"PP",63
42,"42175",21,15,15,0,0,"PP",9
20,"20907",117,88,87,0,1,"PP",1
26,"26034",612,509,497,5,12,"PP",131
19,"19332",85,70,70,1,0,"PP",17
9,"9110",77,57,57,0,0,"PP",19
47,"47162",68,55,55,0,0,"PP",19
34,"34133",105,88,86,1,2,"PP",45
49,"49003",869,627,624,3,3,"PP",254
44,"44112",408,303,293,2,10,"PP",77
23,"23904",2604,1727,1701,7,26,"PP",332
3,"3085",269,243,237,0,6,"PP",86
37,"37138",219,180,176,1,4,"PP",58
10,"10083",96,74,73,0,1,"PP",15
22,"22028",362,284,282,5,2,"PP",72
6,"6117",1401,1089,1067,6,22,"PP",288
45,"45185",7600,6094,5999,19,95,"PP",1320
37,"37139",187,162,157,2,5,"PP",40
13,"13068",1037,802,783,2,19,"PP",169
26,"26036",17013,12543,12354,95,189,"PP",3208
24,"24118",104,66,66,0,0,"PP",14
27,"27902",7150,5067,4953,74,114,"PP",1339
48,"48024",999,813,811,2,2,"PP",8
28,"28168",1329,976,969,3,7,"PP",195
44,"44113",72,51,50,0,1,"PP",2
40,"40109",72,59,54,1,5,"PP",35
22,"22151",88,66,65,0,1,"PP",27
44,"44014",2499,2015,1963,25,52,"PP",440
32,"32078",1108,794,781,15,13,"PP",423
24,"24001",168,105,104,0,1,"PP",28
12,"12042",574,486,479,8,7,"PP",230
34,"34135",399,320,315,4,5,"PP",114
34,"34136",149,105,102,0,3,"PP",47
41,"41064",5611,3763,3667,47,96,"PP",371
50,"50156",209,174,171,1,3,"PP",22
37,"37367",185,150,148,4,2,"PP",72
5,"5178",345,287,283,1,4,"PP",115
15,"15024",4346,3210,3151,19,59,"PP",1019
44,"44114",238,188,184,1,4,"PP",45
44,"44016",436,334,331,1,3,"PP",80
10,"10086",303,249,244,3,5,"PP",71
36,"36048",5244,3859,3786,33,73,"PP",987
34,"34137",24,23,22,2,1,"PP",6
12,"12132",484,415,412,4,3,"PP",68
4,"4050",751,522,519,1,3,"PP",91
45,"45052",3134,2670,2652,23,18,"PP",428
14,"14010",4001,3106,3068,15,38,"PP",600
49,"49126",273,161,160,1,1,"PP",58
44,"44115",102,96,95,0,1,"PP",23
50,"50068",1947,1402,1389,11,13,"PP",305
49,"49007",365,271,265,7,6,"PP",64
26,"26154",10,10,10,1,0,"PP",2
45,"45190",458,378,365,2,13,"PP",81
34,"34139",160,119,118,0,1,"PP",44
20,"20001",257,174,172,1,2,"PP",1
18,"18149",5401,4290,4212,28,78,"PP",799
19,"19201",60,45,45,0,0,"PP",13
24,"24121",616,491,484,4,7,"PP",111
29,"29072",3277,2628,2592,16,36,"PP",469
42,"42046",46,35,33,2,2,"PP",5
42,"42183",106,83,83,1,0,"PP",40
19,"19200",64,56,56,0,0,"PP",7
45,"45054",3831,2980,2944,11,36,"PP",767
45,"45053",7834,6440,6333,46,107,"PP",1351
46,"46082",4958,3801,3759,21,42,"PP",570
42,"42184",56,42,41,1,1,"PP",9
26,"26040",63,51,50,0,1,"PP",29
19,"19055",44,34,34,1,0,"PP",14
44,"44116",76,62,62,0,0,"PP",19
49,"49010",348,301,295,6,6,"PP",65
49,"49129",821,628,616,5,12,"PP",153
5,"5065",459,393,382,1,11,"PP",115
41,"41067",7227,5367,5271,56,96,"PP",1007
12,"12045",328,275,271,2,4,"PP",40
1,"1041",152,107,103,2,4,"PP",33
15,"15028",1393,1076,1063,8,13,"PP",205
37,"37022",245,200,196,2,4,"PP",96
26,"26041",114,84,84,0,0,"PP",41
45,"45194",65,49,48,0,1,"PP",11
42,"42185",25,20,20,0,0,"PP",12
12,"12046",182,161,161,1,0,"PP",39
23,"23011",2134,1649,1614,11,35,"PP",198
2,"2901",2185,1633,1613,9,20,"PP",401
20,"20004",227,156,154,4,2,"PP",0
6,"6124",1656,1323,1296,5,27,"PP",263
43,"43128",905,751,747,4,4,"PP",12
16,"16159",209,147,144,0,3,"PP",49
18,"18047",6074,4437,4353,33,84,"PP",528
46,"46175",428,367,354,3,13,"PP",94
9,"9283",44,33,33,0,0,"PP",14
5,"5183",123,104,96,0,8,"PP",49
34,"34006",79,73,70,3,3,"PP",34
29,"29076",2335,1661,1614,11,47,"PP",215
50,"50071",127,89,88,0,1,"PP",48
48,"48030",601,490,489,0,1,"PP",2
40,"40010",111,95,94,0,1,"PP",40
34,"34146",53,47,46,0,1,"PP",15
5,"5067",74,61,60,0,1,"PP",18
46,"46176",2045,1450,1434,12,16,"PP",285
9,"9125",552,424,421,3,3,"PP",167
23,"23014",2552,2056,2020,11,36,"PP",433
14,"14015",2067,1575,1551,16,24,"PP",312
37,"37025",244,209,206,0,3,"PP",72
22,"22041",152,121,119,2,2,"PP",39
4,"4056",164,135,133,1,2,"PP",56
49,"49013",229,176,175,4,1,"PP",51
14,"14016",1283,1005,994,4,11,"PP",200
3,"3094",9626,7206,7138,42,68,"PP",1584
44,"44021",104,86,85,2,1,"PP",21
12,"12049",421,339,329,2,10,"PP",37
16,"16036",122,98,97,1,1,"PP",13
50,"50163",3787,3041,3022,31,19,"PP",447
6,"6126",2142,1619,1594,9,25,"PP",339
22,"22164",43,33,31,0,2,"PP",11
9,"9072",320,259,258,1,1,"PP",42
19,"19210",18,18,17,0,1,"PP",13
4,"4057",1260,970,953,10,17,"PP",237
28,"28177",10722,9093,9029,64,64,"PP",1649
41,"41070",6397,4987,4921,55,66,"PP",554
9,"9289",1379,1002,994,9,8,"PP",308
40,"40222",163,143,142,1,1,"PP",33
9,"9128",78,63,61,1,2,"PP",19
3,"3003",455,395,388,0,7,"PP",105
37,"37263",338,251,246,0,5,"PP",78
46,"46178",4943,3684,3641,21,43,"PP",579
10,"10218",1083,810,796,3,14,"PP",177
45,"45200",4478,3666,3565,35,101,"PP",732
40,"40014",56,44,43,2,1,"PP",11
28,"28080",49801,41938,41705,248,233,"PP",11061
18,"18157",1148,914,898,8,16,"PP",189
48,"48033",204,160,159,1,1,"PP",1
7,"7062",7902,4889,4828,58,61,"PP",779
37,"37151",143,112,111,1,1,"PP",52
26,"26165",337,289,284,0,5,"PP",70
42,"42192",38,26,26,1,0,"PP",6
49,"49136",312,227,220,3,7,"PP",98
39,"39030",1895,1374,1358,6,16,"PP",261
47,"47173",885,708,704,7,4,"PP",122
46,"46088",150,129,127,0,2,"PP",24
37,"37265",208,184,181,1,3,"PP",37
34,"34154",76,59,58,0,1,"PP",28
44,"44216",26922,20603,20279,204,324,"PP",4639
5,"5189",396,325,321,1,4,"PP",93
22,"22044",234,184,183,3,1,"PP",33
46,"46180",651,525,519,0,6,"PP",67
45,"45065",261,207,205,2,2,"PP",57
37,"37378",99,69,67,2,2,"PP",29
28,"28071",64,56,54,0,2,"PP",16
45,"45018",551,399,397,3,2,"PP",52
35,"35030",9949,6611,6462,65,149,"PP",1121
24,"24133",356,267,267,4,0,"PP",89
23,"23018",2268,1738,1722,8,16,"PP",181
22,"22168",23,21,20,0,1,"PP",2
37,"37154",129,106,102,3,4,"PP",61
7,"7065",2302,1633,1603,10,30,"PP",354
42,"42057",147,95,93,3,2,"PP",49
29,"29083",2062,1607,1574,9,33,"PP",420
3,"3098",518,412,400,1,12,"PP",58
3,"3006",494,413,409,1,4,"PP",92
16,"16041",339,271,267,2,4,"PP",80
50,"50166",236,200,198,1,2,"PP",68
44,"44123",99,69,69,1,0,"PP",25
28,"28012",918,727,711,6,16,"PP",129
39,"39089",134,99,98,0,1,"PP",24
21,"21016",993,770,744,6,26,"PP",66
9,"9301",648,545,536,7,9,"PP",130
40,"40228",494,397,391,5,6,"PP",174
9,"9133",38,33,33,0,0,"PP",8
37,"37380",56,46,45,1,1,"PP",6
18,"18161",251,222,220,1,2,"PP",62
37,"37156",4276,2621,2572,27,49,"PP",759
9,"9134",220,155,151,1,4,"PP",22
3,"3008",159,127,126,0,1,"PP",36
50,"50077",206,158,157,1,1,"PP",45
24,"24017",538,427,424,2,3,"PP",152
50,"50167",215,181,179,1,2,"PP",51
22,"22011",97,78,75,2,3,"PP",25
16,"16043",88,71,71,1,0,"PP",24
37,"37381",139,97,95,1,2,"PP",35
5,"5038",113,89,88,0,1,"PP",55
14,"14052",9080,5999,5909,63,90,"PP",1092
40,"40125",75,61,61,2,0,"PP",25
50,"50253",382,318,315,2,3,"PP",124
45,"45115",2586,2158,2114,8,44,"PP",497
20,"20073",4698,3530,3515,29,15,"PP",84
20,"20012",148,113,112,0,1,"PP",1
29,"29062",651,576,567,4,9,"PP",183
19,"19218",45,34,34,1,0,"PP",9
42,"42060",29,20,19,0,1,"PP",12
32,"32091",1703,1312,1306,4,6,"PP",560
43,"43135",341,283,280,4,3,"PP",4
47,"47177",100,80,79,0,1,"PP",30
44,"44028",171,140,138,1,2,"PP",66
40,"40230",95,70,67,0,3,"PP",15
42,"42107",67,48,48,0,0,"PP",22
21,"21019",584,441,425,10,16,"PP",44
16,"16171",1749,1449,1422,6,27,"PP",474
21,"21020",353,242,236,3,6,"PP",50
19,"19307",26,23,23,0,0,"PP",6
28,"28183",1124,857,842,4,15,"PP",156
29,"29087",371,266,263,2,3,"PP",39
22,"22049",74,63,63,0,0,"PP",28
49,"49105",136,105,103,1,2,"PP",45
11,"11002",4200,3287,3257,5,30,"PP",126
10,"10105",2476,1798,1760,21,38,"PP",412
46,"46257",5428,4237,4190,23,47,"PP",656
44,"44221",384,320,315,2,5,"PP",106
32,"32092",482,337,334,2,3,"PP",129
34,"34067",129,87,87,0,0,"PP",22
18,"18904",743,555,545,1,10,"PP",91
45,"45118",2088,1562,1540,11,22,"PP",338
47,"47084",1101,880,871,7,9,"PP",289
35,"35034",8396,4599,4546,55,53,"PP",631
40,"40233",396,323,320,2,3,"PP",88
5,"5196",57,45,42,0,3,"PP",8
21,"21021",12469,8238,8097,76,141,"PP",1225
19,"19221",35,26,26,0,0,"PP",12
6,"6037",1668,1137,1125,6,12,"PP",316
49,"49025",159,126,124,0,2,"PP",42
28,"28017",1280,1017,1012,9,5,"PP",144
41,"41078",2459,1910,1895,24,15,"PP",264
48,"48041",686,581,579,2,2,"PP",7
26,"26020",454,347,337,4,10,"PP",127
19,"19080",65,51,51,0,0,"PP",17
14,"14025",2857,2482,2436,14,46,"PP",296
18,"18165",4251,3113,3073,20,40,"PP",346
3,"3012",1133,910,897,7,13,"PP",226
23,"23026",3450,2625,2573,17,52,"PP",736
13,"13003",449,346,343,0,3,"PP",106
42,"42202",20,12,11,0,1,"PP",5
4,"4069",4757,3633,3588,25,45,"PP",816
19,"19081",27,19,19,0,0,"PP",13
47,"47085",16381,12697,12540,129,157,"PP",2784
48,"48042",1365,1136,1130,7,6,"PP",78
18,"18062",11041,8531,8355,71,176,"PP",1417
9,"9473",87,76,73,0,3,"PP",27
34,"34027",1046,791,783,13,8,"PP",189
37,"37275",101,69,67,0,2,"PP",27
49,"49148",264,146,136,1,10,"PP",42
29,"29001",4199,3380,3341,20,39,"PP",344
11,"11006",24522,16656,16392,220,264,"PP",2487
16,"16050",220,182,179,1,3,"PP",58
24,"24145",618,443,435,3,8,"PP",83
3,"3014",238879,176118,174768,1105,1350,"PP",33055
29,"29090",1653,1215,1200,8,15,"PP",320
6,"6039",1807,1506,1474,13,32,"PP",217
12,"12060",430,368,365,1,3,"PP",106
14,"14027",7876,6227,6103,81,124,"PP",769
3,"3138",3183,2390,2359,16,31,"PP",479
46,"46189",473,412,408,2,4,"PP",57
22,"22053",786,573,567,3,6,"PP",115
19,"19225",851,664,650,3,14,"PP",76
47,"47087",368,292,288,3,4,"PP",90
34,"34168",45,39,39,0,0,"PP",19
14,"14028",307,258,257,0,1,"PP",54
22,"22054",1617,1196,1183,15,13,"PP",206
23,"23095",8591,6634,6571,27,63,"PP",1613
4,"4071",363,303,301,2,2,"PP",62
47,"47183",139,118,118,1,0,"PP",35
44,"44131",27,22,22,0,0,"PP",5
9,"9148",79,63,63,5,0,"PP",18
26,"26177",301,250,246,2,4,"PP",96
37,"37165",31,22,21,0,1,"PP",7
19,"19088",95,82,82,2,0,"PP",23
13,"13901",864,687,673,1,14,"PP",171
26,"26139",55,43,43,0,0,"PP",16
46,"46099",772,620,614,1,6,"PP",122
14,"14029",4029,3089,3039,15,50,"PP",690
37,"37278",789,618,613,8,5,"PP",94
3,"3109",2976,2375,2345,11,30,"PP",605
48,"48045",5194,4138,4098,25,40,"PP",139
28,"28021",576,387,386,3,1,"PP",88
29,"29004",295,233,226,0,7,"PP",53
44,"44226",124,87,83,2,4,"PP",19
28,"28093",2142,1751,1728,9,23,"PP",385
6,"6141",1688,1308,1291,16,17,"PP",345
24,"24027",1219,913,886,8,27,"PP",172
45,"45081",19138,15010,14829,110,181,"PP",2329
49,"49031",145,107,103,0,4,"PP",55
29,"29094",59350,42199,41749,419,450,"PP",7889
44,"44227",72,61,61,0,0,"PP",30
6,"6009",228,190,187,2,3,"PP",38
1,"1020",320,239,238,1,1,"PP",23
10,"10195",7557,5790,5691,38,99,"PP",1485
39,"39042",5930,4722,4676,26,46,"PP",1050
9,"9316",108,89,89,0,0,"PP",39
26,"26062",86,74,72,1,2,"PP",35
18,"18066",2108,1537,1525,9,12,"PP",160
11,"11010",6351,4472,4385,140,87,"PP",477
42,"42073",73,58,57,0,1,"PP",16
50,"50001",88,71,70,0,1,"PP",45
47,"47124",388,322,319,2,3,"PP",96
29,"29095",3304,2536,2470,22,66,"PP",326
49,"49153",151,110,108,0,2,"PP",40
16,"16142",120,95,95,0,0,"PP",32
49,"49032",287,224,222,0,2,"PP",88
6,"6143",3370,2635,2589,23,46,"PP",333
5,"5089",455,354,340,1,14,"PP",127
28,"28023",5090,4252,4212,31,40,"PP",697
42,"42211",81,74,73,2,1,"PP",25
37,"37357",258,0,0,0,0,"PP",0
42,"42167",236,183,182,3,1,"PP",44
40,"40205",229,185,180,1,5,"PP",66
5,"5090",77,70,69,0,1,"PP",29
18,"18067",681,511,507,3,4,"PP",101
42,"42212",62,48,47,1,1,"PP",17
50,"50002",125,96,91,1,5,"PP",39
44,"44136",51,43,43,1,0,"PP",27
16,"16188",77,56,56,0,0,"PP",15
32,"32016",724,543,535,3,8,"PP",137
5,"5092",146,118,116,0,2,"PP",40
44,"44229",143,110,108,4,2,"PP",25
40,"40068",22,21,21,0,0,"PP",13
5,"5130",94,86,86,0,0,"PP",26
46,"46194",15813,11654,11511,83,143,"PP",1912
3,"3019",15465,12156,11988,80,168,"PP",2355
20,"20023",446,299,299,1,0,"PP",7
22,"22188",76,60,59,1,1,"PP",7
50,"50179",264,231,228,0,3,"PP",78
13,"13015",5226,4010,3959,20,51,"PP",1195
5,"5093",353,275,269,0,6,"PP",101
9,"9323",59,41,41,2,0,"PP",12
41,"41002",1427,1057,1024,5,33,"PP",188
16,"16060",722,571,560,3,11,"PP",168
44,"44137",188,148,146,0,2,"PP",61
27,"27063",1715,1236,1198,10,38,"PP",404
5,"5054",1203,946,927,5,19,"PP",272
24,"24155",442,374,371,6,3,"PP",116
47,"47189",151,126,123,0,3,"PP",45
50,"50265",74,56,56,0,0,"PP",17
44,"44231",36,33,32,0,1,"PP",11
13,"13016",661,508,495,2,13,"PP",141
43,"43145",4209,3409,3391,9,18,"PP",103
24,"24113",351,277,272,2,5,"PP",104
9,"9431",120,98,98,3,0,"PP",39
9,"9162",132,102,102,1,0,"PP",30
49,"49158",203,163,155,0,8,"PP",47
18,"18070",289,224,222,3,2,"PP",45
46,"46196",140,115,114,0,1,"PP",42
9,"9007",55,37,37,0,0,"PP",21
38,"38013",3019,2023,1991,12,32,"PP",442
10,"10120",156,110,108,0,2,"PP",32
50,"50090",134,108,108,0,0,"PP",45
15,"15050",1748,1038,1027,15,11,"PP",335
4,"4080",199,158,157,0,1,"PP",43
22,"22190",122,89,89,0,0,"PP",9
29,"29100",2378,1711,1686,22,25,"PP",250
9,"9163",578,490,481,5,9,"PP",155
14,"14036",3676,2850,2766,40,84,"PP",295
18,"18071",5612,4271,4184,29,87,"PP",598
37,"37052",278,201,199,2,2,"PP",73
16,"16193",58,51,51,2,0,"PP",13
10,"10122",220,171,164,0,7,"PP",41
12,"12071",1267,1021,1006,11,15,"PP",283
47,"47096",126,106,105,0,1,"PP",36
50,"50006",908,705,689,3,16,"PP",113
9,"9907",1507,1198,1174,16,24,"PP",177
50,"50182",3675,2846,2810,36,36,"PP",421
47,"47004",1136,950,939,5,11,"PP",188
18,"18179",503,346,343,3,3,"PP",91
13,"13020",4729,3461,3416,34,45,"PP",655
28,"28102",891,681,666,4,15,"PP",105
9,"9329",117,90,89,8,1,"PP",14
9,"9908",427,294,290,6,4,"PP",95
10,"10123",575,470,465,2,5,"PP",92
45,"45092",223,204,204,1,0,"PP",79
9,"9167",53,39,36,0,3,"PP",16
10,"10001",283,233,232,3,1,"PP",34
20,"20027",2758,1980,1958,19,22,"PP",10
37,"37288",276,225,224,5,1,"PP",62
3,"3117",377,320,313,1,7,"PP",72
9,"9330",1480,1180,1161,8,19,"PP",323
48,"48053",904,738,728,5,10,"PP",57
34,"34045",73,67,65,0,2,"PP",38
40,"40143",83,73,73,2,0,"PP",33
39,"39049",306,209,208,4,1,"PP",49
6,"6150",780,637,635,2,2,"PP",82
15,"15053",7548,5364,5309,44,55,"PP",1425
10,"10084",1294,899,869,5,30,"PP",167
19,"19105",2540,2013,1988,13,25,"PP",326
16,"16066",2298,1932,1885,17,47,"PP",563
44,"44043",88,67,65,1,2,"PP",19
26,"26072",285,252,247,1,5,"PP",83
2,"2008",1123,857,842,9,15,"PP",178
18,"18180",627,442,435,4,7,"PP",32
24,"24160",645,481,475,1,6,"PP",151
15,"15054",31802,22002,21676,368,326,"PP",4330
43,"43075",86,71,69,0,2,"PP",0
14,"14039",2575,2037,1990,14,47,"PP",376
22,"22199",6926,5113,5051,44,62,"PP",805
26,"26073",94,72,68,0,4,"PP",23
47,"47007",4036,3261,3217,25,44,"PP",523
45,"45095",660,528,519,3,9,"PP",158
16,"16197",66,45,45,0,0,"PP",13
9,"9334",48,37,35,0,2,"PP",8
36,"36017",17419,12867,12610,120,257,"PP",4543
10,"10004",690,529,517,8,12,"PP",124
13,"13025",296,260,256,1,4,"PP",111
38,"38018",4455,3242,3198,24,44,"PP",511
49,"49043",265,210,208,1,2,"PP",65
47,"47195",430,335,320,2,15,"PP",61
28,"28032",5042,4039,3992,23,47,"PP",563
49,"49248",174,142,139,2,3,"PP",54
10,"10127",4706,3508,3423,23,85,"PP",626
5,"5102",1681,1358,1329,4,29,"PP",499
37,"37179",196,172,169,0,3,"PP",48
4,"4086",1643,1226,1209,6,17,"PP",451
26,"26075",321,266,265,0,1,"PP",81
32,"32024",4835,3484,3439,23,45,"PP",1384
18,"18078",710,561,554,4,7,"PP",93
19,"19108",102,92,89,0,3,"PP",25
21,"21041",112810,77371,76488,900,883,"PP",10605
49,"49044",78,64,64,1,0,"PP",18
48,"48057",5745,4391,4376,13,15,"PP",48
40,"40041",967,773,764,9,9,"PP",228
13,"13027",3223,2343,2309,22,34,"PP",634
24,"24042",61,47,47,1,0,"PP",17
4,"4087",156,117,116,1,1,"PP",24
12,"12076",76,64,64,1,0,"PP",19
43,"43004",6274,4744,4691,39,53,"PP",268
46,"46203",3544,2851,2810,21,41,"PP",366
41,"41010",4573,3407,3345,27,62,"PP",376
16,"16202",741,573,568,4,5,"PP",134
10,"10129",348,263,250,0,13,"PP",53
6,"6055",1998,1552,1523,9,29,"PP",416
27,"27010",4402,3015,2940,49,75,"PP",1172
16,"16071",20,18,18,0,0,"PP",6
15,"15057",12051,8814,8660,89,154,"PP",2639
49,"49046",242,178,175,0,3,"PP",70
26,"26076",116,93,91,0,2,"PP",31
42,"42089",57,48,48,1,0,"PP",16
49,"49047",100,72,72,0,0,"PP",27
43,"43005",3643,2765,2749,22,16,"PP",103
47,"47102",264,217,211,1,6,"PP",45
13,"13029",90,77,77,0,0,"PP",19
9,"9020",237,184,180,5,4,"PP",70
2,"2013",135,113,110,0,3,"PP",30
23,"23045",2057,1519,1507,7,12,"PP",232
46,"46022",15325,11197,11072,70,125,"PP",1852
22,"22203",76,61,61,0,0,"PP",14
44,"44048",53,47,47,0,0,"PP",14
28,"28035",1394,1057,1043,3,14,"PP",214
45,"45102",3585,2724,2676,20,48,"PP",643
47,"47198",66,47,47,0,0,"PP",20
12,"12078",333,238,235,1,3,"PP",98
9,"9176",59,50,47,2,3,"PP",20
49,"49050",504,351,351,3,0,"PP",131
18,"18185",542,454,453,2,1,"PP",70
16,"16073",188,159,155,0,4,"PP",38
9,"9021",51,36,35,1,1,"PP",13
4,"4090",312,253,249,0,4,"PP",56
16,"16074",28,23,23,0,0,"PP",8
41,"41012",3368,2416,2361,23,55,"PP",342
22,"22204",1119,836,832,9,4,"PP",211
45,"45103",362,306,299,0,7,"PP",121
37,"37184",290,199,195,0,4,"PP",77
22,"22205",459,347,345,1,2,"PP",55
15,"15060",5843,4360,4281,65,79,"PP",1152
3,"3031",41857,28648,28362,163,286,"PP",6047
19,"19114",33,25,25,1,0,"PP",9
49,"49171",610,477,473,8,4,"PP",161
16,"16078",41517,31810,31486,340,324,"PP",7492
4,"4092",2789,2207,2173,6,34,"PP",502
37,"37067",3254,2742,2714,29,28,"PP",534
15,"15061",5199,3694,3601,40,93,"PP",1309
47,"47200",71,62,62,0,0,"PP",31
5,"5225",353,300,297,2,3,"PP",132
9,"9346",89,69,68,1,1,"PP",27
48,"48061",799,636,636,2,0,"PP",23
32,"32028",1550,1176,1171,10,5,"PP",698
44,"44150",26,21,21,0,0,"PP",5
28,"28038",5155,4142,4090,20,52,"PP",668
22,"22206",182,145,145,0,0,"PP",22
5,"5109",441,363,356,5,7,"PP",135
10,"10135",1241,995,981,5,14,"PP",401
39,"39057",2367,1831,1796,14,35,"PP",416
19,"19116",12,9,9,1,0,"PP",6
19,"19251",39,31,31,0,0,"PP",16
14,"14046",4443,3550,3486,38,64,"PP",239
6,"6060",5723,4401,4323,31,78,"PP",863
24,"24170",1839,1417,1391,7,26,"PP",268
50,"50102",820,653,642,9,11,"PP",142
37,"37187",555,437,433,0,4,"PP",120
45,"45107",3423,2806,2770,18,36,"PP",490
9,"9181",277,220,219,2,1,"PP",88
27,"27015",4020,2809,2730,33,79,"PP",1169
6,"6061",1084,915,905,8,10,"PP",191
37,"37301",79,69,67,0,2,"PP",26
10,"10137",404,346,344,3,2,"PP",94
50,"50017",1779,1386,1373,14,13,"PP",184
6,"6161",288,226,222,1,4,"PP",58
45,"45108",482,385,382,0,3,"PP",114
39,"39058",800,574,573,1,1,"PP",113
9,"9182",76,65,64,0,1,"PP",34
9,"9027",48,41,39,0,2,"PP",12
11,"11032",54469,33144,32810,461,334,"PP",4212
29,"29024",372,265,250,3,15,"PP",45
37,"37302",262,182,181,2,1,"PP",59
3,"3035",632,529,525,2,4,"PP",118
43,"43082",351,303,297,1,6,"PP",11
19,"19118",10,10,10,1,0,"PP",0
14,"14048",1189,948,933,5,15,"PP",141
9,"9351",62,51,50,1,1,"PP",23
6,"6096",207,168,167,1,1,"PP",59
40,"40049",40,30,29,0,1,"PP",19
37,"37071",76,67,67,0,0,"PP",15
30,"30010",6857,5533,5457,38,76,"PP",1484
6,"6162",2895,2289,2254,11,35,"PP",495
34,"34208",47,38,38,0,0,"PP",14
19,"19019",14,10,10,0,0,"PP",5
10,"10099",559,412,401,3,11,"PP",78
6,"6030",169,147,146,1,1,"PP",44
10,"10017",772,595,591,3,4,"PP",215
36,"36027",4380,3262,3206,26,56,"PP",1283
29,"29026",1010,747,736,3,11,"PP",147
5,"5036",116,100,100,0,0,"PP",53
34,"34210",103,90,90,1,0,"PP",44
40,"40157",43,33,33,2,0,"PP",10
43,"43010",337,286,284,2,2,"PP",8
43,"43157",345,303,303,0,0,"PP",14
44,"44154",248,200,195,2,5,"PP",45
46,"46029",20423,15450,15274,100,176,"PP",2598
37,"37304",159,105,105,0,0,"PP",56
27,"27018",3232,2114,2089,24,25,"PP",668
41,"41091",539730,412509,408312,3804,4197,"PP",72179
22,"22081",243,187,186,0,1,"PP",69
24,"24016",507,314,311,2,3,"PP",97
46,"46121",111,96,94,2,2,"PP",30
46,"46030",796,653,633,7,20,"PP",119
9,"9032",103,72,72,0,0,"PP",11
36,"36029",16086,12196,12005,126,191,"PP",2686
37,"37073",620,481,471,6,10,"PP",159
13,"13042",888,699,686,2,13,"PP",168
5,"5116",96,77,75,0,2,"PP",43
43,"43084",521,424,423,2,1,"PP",7
45,"45113",1797,1300,1281,6,19,"PP",400
45,"45114",560,441,436,0,5,"PP",103
11,"11036",687,457,447,7,10,"PP",96
34,"34211",175,160,160,0,0,"PP",82
47,"47176",202,138,138,1,0,"PP",47
46,"46031",10521,7735,7607,62,128,"PP",1069
16,"16086",881,751,747,3,4,"PP",253
44,"44026",95,76,75,2,1,"PP",21
13,"13089",1609,1336,1299,10,37,"PP",374
19,"19260",38,33,31,1,2,"PP",7
42,"42106",14,12,12,0,0,"PP",5
5,"5905",222,165,164,1,1,"PP",90
15,"15037",4031,2700,2677,13,23,"PP",809
34,"34063",87,77,77,1,0,"PP",31
24,"24057",1306,1018,997,7,21,"PP",254
43,"43086",5263,4046,4021,17,25,"PP",91
3,"3133",41499,26593,26308,151,285,"PP",5919
34,"34214",178,141,141,1,0,"PP",36
36,"36030",3946,2847,2810,26,37,"PP",852
9,"9192",55,48,47,2,1,"PP",20
20,"20043",1734,1254,1248,5,6,"PP",30
18,"18903",851,644,636,1,8,"PP",133
15,"15006",5169,3527,3436,32,91,"PP",1240
34,"34215",162,143,142,3,1,"PP",41
13,"13045",616,482,479,4,3,"PP",139
9,"9036",37,33,32,3,1,"PP",12
47,"47178",166,144,143,4,1,"PP",54
28,"28046",4776,3944,3912,22,32,"PP",760
43,"43013",4392,3341,3321,14,20,"PP",142
9,"9360",25,22,22,0,0,"PP",8
41,"41077",8631,6441,6289,46,152,"PP",709
22,"22217",372,296,290,5,6,"PP",80
37,"37195",37,29,29,1,0,"PP",4
15,"15070",8797,6312,6173,108,139,"PP",1027
44,"44252",75,56,56,1,0,"PP",18
20,"20044",364,263,262,0,1,"PP",4
16,"16276",21,18,18,1,0,"PP",6
3,"3071",3988,3125,3088,28,37,"PP",655
47,"47179",373,275,273,1,2,"PP",88
48,"48070",528,392,390,2,2,"PP",4
50,"50284",132,105,104,1,1,"PP",30
44,"44191",722,567,561,7,6,"PP",118
49,"49184",170,122,121,0,1,"PP",68
37,"37197",87,63,63,0,0,"PP",24
10,"10025",379,328,317,3,11,"PP",84
16,"16091",64,46,46,1,0,"PP",10
39,"39065",232,190,189,5,1,"PP",35
10,"10147",1283,1038,1007,4,31,"PP",171
2,"2028",118,99,98,4,1,"PP",20
9,"9197",137,108,107,0,1,"PP",42
16,"16228",176,150,150,1,0,"PP",82
37,"37081",871,725,717,4,8,"PP",220
28,"28047",42847,33561,33215,216,346,"PP",5272
6,"6070",7686,6083,5948,44,135,"PP",960
45,"45166",1564,1298,1279,6,19,"PP",318
46,"46126",5574,4565,4528,25,37,"PP",692
27,"27024",1451,1122,1102,5,20,"PP",509
45,"45121",7273,5362,5291,27,71,"PP",1013
13,"13050",479,399,394,2,5,"PP",118
37,"37002",126,81,81,0,0,"PP",21
24,"24182",411,302,295,4,7,"PP",98
18,"18906",911,722,716,4,6,"PP",246
22,"22220",150,120,117,0,3,"PP",27
44,"44062",31,24,23,1,1,"PP",13
40,"40164",185,136,134,3,2,"PP",61
20,"20047",462,337,335,2,2,"PP",4
26,"26096",260,221,212,2,9,"PP",70
24,"24063",355,261,261,2,0,"PP",88
45,"45122",5516,4611,4561,28,50,"PP",925
14,"14057",6139,5054,4964,51,90,"PP",849
3,"3043",2899,2466,2434,21,32,"PP",485
40,"40059",108,90,89,0,1,"PP",45
9,"9043",186,128,128,1,0,"PP",44
19,"19132",93,72,72,0,0,"PP",29
44,"44194",104,80,80,1,0,"PP",13
44,"44063",65,55,55,1,0,"PP",17
18,"18029",1813,1183,1169,9,14,"PP",150
10,"10151",198,161,157,2,4,"PP",52
24,"24183",752,549,543,8,6,"PP",141
20,"20048",184,120,120,2,0,"PP",1
49,"49188",110,87,86,0,1,"PP",21
45,"45124",2069,1757,1718,14,39,"PP",493
18,"18908",784,599,581,0,18,"PP",74
22,"22222",517,407,398,5,9,"PP",59
42,"42069",1491,1073,1048,20,25,"PP",277
13,"13053",14075,10930,10798,98,132,"PP",2192
39,"39068",649,515,509,7,6,"PP",87
5,"5125",56,47,43,0,4,"PP",11
28,"28050",4367,3411,3384,14,27,"PP",564
14,"14059",687,571,563,7,8,"PP",125
10,"10152",446,354,350,2,4,"PP",84
34,"34073",180,149,145,2,4,"PP",51
6,"6140",611,515,506,1,9,"PP",253
28,"28020",169,110,109,0,1,"PP",26
46,"46038",307,243,241,0,2,"PP",66
9,"9372",204,176,175,1,1,"PP",47
16,"16237",98,83,83,0,0,"PP",27
23,"23061",7691,5636,5531,51,105,"PP",1084
2,"2033",1870,1503,1463,11,40,"PP",388
49,"49190",50,45,45,1,0,"PP",15
47,"47122",2016,1655,1617,15,38,"PP",462
7,"7009",741,554,544,4,10,"PP",116
32,"32041",759,510,502,2,8,"PP",277
37,"37202",989,838,828,7,10,"PP",148
18,"18909",539,432,426,1,6,"PP",98
22,"22225",2610,1867,1843,15,24,"PP",436
44,"44066",87,66,65,0,1,"PP",14
20,"20050",270,186,183,3,3,"PP",1
10,"10032",1596,1263,1243,5,20,"PP",388
1,"1063",1830,1363,1353,4,10,"PP",115
26,"26179",41,33,32,0,1,"PP",11
37,"37167",177,159,158,3,1,"PP",28
34,"34124",63,58,58,0,0,"PP",25
46,"46222",394,325,324,1,1,"PP",29
50,"50117",125,100,100,3,0,"PP",30
20,"20051",6775,5124,5091,24,33,"PP",204
12,"12095",950,763,756,9,7,"PP",177
7,"7010",5070,3815,3777,47,38,"PP",618
39,"39070",123,101,99,0,2,"PP",18
37,"37243",90,71,70,0,1,"PP",38
6,"6076",824,631,620,0,11,"PP",159
41,"41101",6016,4524,4480,42,44,"PP",797
21,"21066",495,401,396,4,5,"PP",63
9,"9375",42,38,38,0,0,"PP",15
14,"14062",963,753,745,4,8,"PP",209
46,"46132",2196,1877,1853,10,24,"PP",473
18,"18911",7869,5871,5765,49,106,"PP",783
2,"2036",95,75,75,0,0,"PP",23
19,"19274",950,753,741,7,12,"PP",129
19,"19231",10,7,7,0,0,"PP",2
43,"43143",51,45,44,0,1,"PP",0
34,"34079",1715,1421,1402,10,19,"PP",343
40,"40065",469,376,373,1,3,"PP",128
36,"36040",2517,1895,1853,18,42,"PP",675
9,"9377",629,494,488,4,6,"PP",161
47,"47219",40,38,34,0,4,"PP",10
10,"10157",245,185,185,1,0,"PP",58
32,"32044",809,625,617,2,8,"PP",235
3,"3903",2577,1996,1973,11,23,"PP",381
46,"46042",3348,2825,2774,11,51,"PP",783
39,"39100",849,650,644,9,6,"PP",204
29,"29007",28584,21525,21318,202,207,"PP",3614
32,"32045",2360,1712,1689,18,23,"PP",720
24,"24191",108,89,89,0,0,"PP",32
47,"47031",196,155,155,3,0,"PP",54
21,"21068",962,562,550,14,12,"PP",84
41,"41901",2703,2242,2201,29,41,"PP",105
34,"34081",60,48,48,0,0,"PP",27
37,"37207",325,260,258,1,2,"PP",72
15,"15080",1640,1177,1150,9,27,"PP",424
13,"13061",5639,4119,4071,56,48,"PP",881
16,"16102",1163,951,943,16,8,"PP",283
28,"28131",13432,10500,10387,81,113,"PP",2048
39,"39045",351,280,277,1,3,"PP",86
37,"37283",119,96,96,0,0,"PP",27
14,"14003",1258,989,968,12,21,"PP",229
40,"40174",324,254,250,2,4,"PP",120
50,"50032",242,179,176,1,3,"PP",29
41,"41902",4600,3141,3092,48,49,"PP",358
2,"2039",952,798,789,9,9,"PP",225
24,"24193",365,286,285,0,1,"PP",75
19,"19234",45,32,32,0,0,"PP",8
6,"6146",1048,837,819,4,18,"PP",130
50,"50121",277,220,218,2,2,"PP",47
32,"32046",1098,793,782,5,11,"PP",364
36,"36043",4682,3345,3303,17,42,"PP",978
26,"26107",91,78,77,0,1,"PP",25
37,"37323",476,380,377,7,3,"PP",133
5,"5249",96,69,69,0,0,"PP",14
41,"41032",3843,3018,2944,17,74,"PP",393
21,"21070",6222,4413,4322,47,91,"PP",526
28,"28132",12068,9067,8954,63,113,"PP",1068
24,"24196",1918,1446,1422,9,24,"PP",320
22,"22232",87,66,65,2,1,"PP",23
34,"34232",735,595,584,8,11,"PP",185
5,"5134",49,41,40,0,1,"PP",18
5,"5251",56,39,39,0,0,"PP",12
44,"44267",71,53,52,0,1,"PP",22
18,"18005",362,268,265,0,3,"PP",20
38,"38044",2199,1443,1429,10,14,"PP",264
48,"48082",37396,27913,27694,172,219,"PP",1600
15,"15083",1036,784,768,7,16,"PP",430
26,"26109",73,66,66,0,0,"PP",26
18,"18915",731,539,532,1,7,"PP",69
13,"13065",2813,1993,1971,13,22,"PP",661
7,"7017",882,652,646,6,6,"PP",119
20,"20057",194,143,143,0,0,"PP",0
28,"28059",4515,3573,3542,12,31,"PP",617
22,"22233",80,50,50,0,0,"PP",15
10,"10163",339,275,269,0,6,"PP",89
5,"5253",78,62,60,0,2,"PP",21
5,"5252",58,38,38,0,0,"PP",21
45,"45137",1567,1155,1139,11,16,"PP",163
40,"40072",224,198,194,3,4,"PP",23
37,"37212",101,85,83,0,2,"PP",19
43,"43024",1556,1154,1137,3,17,"PP",51
36,"36045",24478,18627,18327,157,300,"PP",3891
4,"4005",533,448,442,0,6,"PP",161
46,"46229",911,755,752,5,3,"PP",173
50,"50035",75,63,62,0,1,"PP",1
50,"50296",382,288,272,1,16,"PP",26
22,"22107",100,68,67,0,1,"PP",14
2,"2044",1049,746,737,5,9,"PP",164
41,"41034",23480,16510,16250,230,260,"PP",1652
28,"28060",1565,1262,1247,5,15,"PP",167
37,"37100",77,60,59,1,1,"PP",31
24,"24199",405,302,297,3,5,"PP",92
50,"50036",100,80,80,0,0,"PP",20
49,"49204",57,42,42,0,0,"PP",25
44,"44076",2110,1725,1691,22,34,"PP",425
50,"50212",32,29,29,1,0,"PP",3
15,"15085",3220,2284,2239,23,45,"PP",931
7,"7019",164,124,124,0,0,"PP",60
9,"9221",492,413,409,0,4,"PP",70
28,"28061",22564,18245,18064,117,181,"PP",3080
47,"47226",149,124,123,0,1,"PP",28
37,"37329",39,36,36,0,0,"PP",18
19,"19154",59,48,47,0,1,"PP",29
44,"44077",74,55,54,0,1,"PP",8
3,"3056",8629,6838,6737,38,101,"PP",1127
24,"24202",7559,5449,5363,63,86,"PP",778
19,"19003",29,28,28,2,0,"PP",3
5,"5140",106,91,89,0,2,"PP",37
49,"49205",367,286,282,5,4,"PP",138
39,"39079",8861,6827,6745,47,82,"PP",1689
46,"46140",377,312,312,2,0,"PP",40
50,"50213",93,76,75,0,1,"PP",43
47,"47227",55,46,46,0,0,"PP",11
9,"9390",569,464,459,5,5,"PP",156
44,"44045",368,302,298,8,4,"PP",66
24,"24203",95,72,72,0,0,"PP",30
19,"19004",59,52,52,0,0,"PP",27
10,"10045",970,739,735,6,4,"PP",154
46,"46141",437,367,360,5,7,"PP",127
49,"49206",794,584,570,7,14,"PP",221
34,"34240",87,65,63,3,2,"PP",23
26,"26114",74,62,60,0,2,"PP",18
41,"41037",3192,2505,2479,15,26,"PP",177
47,"47039",166,134,134,0,0,"PP",32
19,"19289",23,19,19,0,0,"PP",4
36,"36049",7019,5414,5283,48,131,"PP",1526
7,"7022",11615,8055,7934,91,121,"PP",1626
42,"42008",56,41,41,0,0,"PP",24
3,"3121",21787,15670,15453,81,217,"PP",3347
27,"27040",3035,2285,2234,19,51,"PP",1145
39,"39080",3505,2735,2701,8,34,"PP",754
6,"6088",12505,9311,9140,93,171,"PP",1639
26,"26003",389,329,328,1,1,"PP",165
13,"13073",497,394,390,1,4,"PP",105
43,"43102",463,384,379,2,5,"PP",6
22,"22112",9516,7043,6956,84,87,"PP",1416
45,"45007",665,549,533,0,16,"PP",86
9,"9065",138,118,117,1,1,"PP",40
40,"40183",116,103,103,0,0,"PP",79
42,"42009",77,69,69,2,0,"PP",27
47,"47040",61,45,44,0,1,"PP",27
41,"41038",102179,76348,75425,819,923,"PP",7915
9,"9227",113,93,91,0,2,"PP",24
45,"45146",101,86,85,0,1,"PP",40
23,"23076",768,653,646,3,7,"PP",152
10,"10171",355,261,255,0,6,"PP",80
32,"32054",86475,64472,63712,676,760,"PP",15920
20,"20064",12436,8730,8652,59,78,"PP",380
49,"49209",474,338,334,4,4,"PP",148
5,"5261",33,26,26,0,0,"PP",15
40,"40078",151,123,122,2,1,"PP",35
34,"34243",320,260,258,1,2,"PP",120
5,"5144",66,51,51,0,0,"PP",22
26,"26118",72,63,60,1,3,"PP",19
24,"24207",278,242,235,0,7,"PP",66
10,"10172",696,517,513,0,4,"PP",128
5,"5145",47,27,27,1,0,"PP",11
9,"9396",153,125,124,0,1,"PP",61
2,"2051",1665,1253,1222,6,31,"PP",379
29,"29053",1694,1263,1245,18,18,"PP",245
50,"50217",431,346,344,0,2,"PP",77
44,"44086",421,332,327,3,5,"PP",77
34,"34098",783,614,605,3,9,"PP",128
43,"43030",482,373,372,2,1,"PP",10
16,"16263",966,763,755,2,8,"PP",175
23,"23079",3639,2859,2818,20,41,"PP",725
35,"35024",14243,9496,9394,65,102,"PP",1146
48,"48091",1090,862,857,9,5,"PP",17
14,"14075",557,429,411,5,18,"PP",66
20,"20065",2943,2145,2124,11,21,"PP",103
49,"49214",664,519,510,2,9,"PP",181
50,"50042",16,16,16,0,0,"PP",9
47,"47139",1004,790,776,2,14,"PP",150
18,"18015",425,333,333,0,0,"PP",73
34,"34099",52,45,41,0,4,"PP",11
5,"5027",260,217,211,3,6,"PP",74
45,"45013",1671,1320,1298,4,22,"PP",477
26,"26121",30,21,21,1,0,"PP",8
37,"37337",139,114,114,0,0,"PP",46
20,"20066",439,327,326,0,1,"PP",1
19,"19011",236,181,181,0,0,"PP",52
48,"48001",5885,4359,4334,35,25,"PP",220
14,"14901",915,795,782,8,13,"PP",60
46,"46055",1284,1031,1021,2,10,"PP",158
44,"44181",66,58,57,0,1,"PP",26
36,"36054",11074,8032,7873,77,159,"PP",2140
50,"50133",100,82,82,2,0,"PP",16
24,"24211",263,219,214,3,5,"PP",77
20,"20067",30618,21972,21854,138,118,"PP",1004
46,"46238",13105,9717,9610,57,107,"PP",1611
19,"19015",84,74,73,0,1,"PP",21
4,"4016",2128,1643,1621,4,22,"PP",377
40,"40189",479,392,380,2,12,"PP",76
18,"18017",18148,12712,12523,96,189,"PP",2564
48,"48093",888,720,715,2,5,"PP",27
46,"46056",175,156,156,3,0,"PP",36
37,"37112",152,104,103,0,1,"PP",49
26,"26122",116,98,97,0,1,"PP",27
39,"39001",2065,1669,1643,16,26,"PP",313
3,"3064",5004,3782,3736,20,46,"PP",833
2,"2055",1057,770,755,6,15,"PP",138
9,"9406",246,203,200,4,3,"PP",29
48,"48003",14444,11233,11162,43,71,"PP",297
44,"44089",52,44,44,0,0,"PP",12
24,"24091",585,433,423,1,10,"PP",130
22,"22248",104,83,82,0,1,"PP",14
45,"45017",260,218,213,1,5,"PP",49
22,"22119",1256,963,954,5,9,"PP",260
3,"3065",169399,128218,127256,967,962,"PP",24814
26,"26010",85,68,68,1,0,"PP",33
43,"43033",768,609,607,3,2,"PP",21
42,"42016",20,13,13,0,0,"PP",6
6,"6095",9511,7338,7152,116,186,"PP",1291
37,"37340",142,101,101,0,0,"PP",52
9,"9408",42,33,33,0,0,"PP",13
18,"18018",554,457,451,0,6,"PP",80
50,"50075",72,59,59,1,0,"PP",41
40,"40191",204,166,165,1,1,"PP",54
27,"27048",2019,1499,1467,23,32,"PP",464
15,"15902",4522,3220,3159,47,61,"PP",1195
3,"3066",41802,31046,30696,285,350,"PP",5093
5,"5153",87,65,65,1,0,"PP",25
43,"43058",96,77,77,0,0,"PP",0
20,"20070",1083,831,823,2,8,"PP",3
40,"40051",34,33,31,0,2,"PP",16
44,"44090",66,49,49,0,0,"PP",22
42,"42056",28,25,24,0,1,"PP",16
16,"16001",64,51,51,0,0,"PP",23
1,"1051",3558,2448,2433,14,15,"PP",136
37,"37342",255,200,199,1,1,"PP",54
9,"9077",30,22,22,0,0,"PP",9
48,"48096",6510,5247,5185,36,62,"PP",170
6,"6097",2283,1803,1762,10,41,"PP",405
22,"22250",344,271,264,6,7,"PP",40
45,"45020",1239,987,973,4,14,"PP",318
3,"3067",93,87,87,0,0,"PP",22
39,"39088",59,51,51,0,0,"PP",7
2,"2059",313,252,250,3,2,"PP",54
2,"2058",313,218,214,1,4,"PP",46
45,"45158",2546,2026,2001,9,25,"PP",597
50,"50047",43,32,31,1,1,"PP",5
46,"46151",757,586,579,0,7,"PP",94
48,"48006",309,265,265,0,0,"PP",1
13,"13087",23207,17321,17032,202,289,"PP",3213
46,"46060",9287,7184,7110,40,74,"PP",1249
4,"4022",357,261,261,0,0,"PP",50
37,"37343",66,50,48,1,2,"PP",10
3,"3100",496,402,395,2,7,"PP",84
35,"35003",5582,3441,3391,26,50,"PP",588
45,"45901",780,593,587,3,6,"PP",131
41,"41047",10411,8348,8242,84,106,"PP",1394
22,"22009",585,439,435,4,4,"PP",63
3,"3132",515,417,414,4,3,"PP",51
46,"46061",343,285,280,4,5,"PP",44
40,"40088",268,200,200,0,0,"PP",76
36,"36060",30432,22488,22196,199,292,"PP",5122
34,"34213",52,42,42,0,0,"PP",18
19,"19022",571,443,434,7,9,"PP",143
50,"50050",86,65,65,1,0,"PP",8
13,"13044",2569,1984,1951,12,33,"PP",509
37,"37233",56,46,46,2,0,"PP",9
16,"16274",103,86,85,0,1,"PP",22
1,"1009",1265,920,914,6,6,"PP",28
40,"40194",39191,31175,30785,250,390,"PP",7764
10,"10061",1598,1126,1114,5,12,"PP",179
28,"28075",5952,4797,4758,25,39,"PP",675
45,"45024",1043,832,821,5,11,"PP",289
26,"26130",201,164,163,0,1,"PP",79
20,"20074",11503,8767,8720,26,47,"PP",191
19,"19306",22,19,19,0,0,"PP",13
3,"3101",4911,3827,3772,20,55,"PP",482
47,"47147",102,85,85,0,0,"PP",40
7,"7035",1596,1242,1234,13,8,"PP",269
10,"10185",573,463,460,3,3,"PP",138
48,"48903",1807,1471,1462,6,9,"PP",92
9,"9083",27,24,23,0,1,"PP",13
37,"37121",556,448,444,3,4,"PP",135
46,"46063",1783,1368,1345,9,23,"PP",278
49,"49183",93,73,71,2,2,"PP",34
7,"7036",27950,20870,20707,154,163,"PP",2962
43,"43038",21861,16504,16406,112,98,"PP",958
23,"23090",1219,1014,1004,5,10,"PP",312
29,"29064",437,319,315,2,4,"PP",80
9,"9248",78,64,64,0,0,"PP",17
46,"46094",20691,15841,15672,88,169,"PP",2351
6,"6135",1096,915,902,3,13,"PP",233
9,"9361",112,94,94,1,0,"PP",38
18,"18164",1794,1225,1205,9,20,"PP",334
5,"5081",37,29,29,0,0,"PP",15
24,"24020",434,302,299,1,3,"PP",75
35,"35006",31309,23434,23019,221,415,"PP",3271
28,"28078",40,37,37,0,0,"PP",13
49,"49229",113,88,87,0,1,"PP",31
28,"28155",485,414,409,0,5,"PP",88
5,"5042",141,117,116,0,1,"PP",66
37,"37123",162,122,117,3,5,"PP",54
48,"48010",474,368,368,0,0,"PP",0
44,"44001",65,51,50,0,1,"PP",13
49,"49230",82,67,66,0,1,"PP",24
22,"22014",233,185,182,3,3,"PP",41
26,"26134",83,70,67,0,3,"PP",23
16,"16278",63,51,51,0,0,"PP",13
43,"43063",536,401,397,1,4,"PP",30
20,"20076",7025,5263,5237,31,26,"PP",192
35,"35007",518,405,401,0,4,"PP",63
9,"9088",64,42,42,4,0,"PP",12
10,"10108",203,131,130,1,1,"PP",42
34,"34165",59,51,50,1,1,"PP",33
44,"44002",46,42,42,0,0,"PP",13
50,"50142",24,18,18,0,0,"PP",1
4,"4029",8819,6149,6073,45,76,"PP",1401
47,"47054",613,501,498,0,3,"PP",187
43,"43114",375,306,305,0,1,"PP",5
20,"20077",5254,4083,4059,22,24,"PP",127
7,"7039",4970,3557,3489,36,68,"PP",790
26,"26021",2752,2132,2105,10,27,"PP",713
44,"44100",175,142,141,2,1,"PP",24
37,"37125",227,171,169,0,2,"PP",48
35,"35008",6207,4733,4654,42,79,"PP",847
47,"47151",28,22,22,0,0,"PP",13
22,"22131",83,65,65,0,0,"PP",10
46,"46249",9159,7113,7012,73,101,"PP",1348
20,"20017",8484,6294,6263,25,31,"PP",148
16,"16280",165,130,128,3,2,"PP",58
28,"28091",5474,4027,3977,26,50,"PP",833
6,"6072",2225,1777,1752,20,25,"PP",375
13,"13097",2205,1764,1742,6,22,"PP",459
32,"32068",1419,998,987,4,11,"PP",457
9,"9255",84,70,70,1,0,"PP",32
22,"22904",761,581,566,2,15,"PP",148
46,"46068",345,308,307,4,1,"PP",53
19,"19318",23,18,18,0,0,"PP",2
1,"1017",816,579,574,2,5,"PP",45
16,"16012",77,65,65,0,0,"PP",20
42,"42162",2325,1721,1699,16,22,"PP",605
22,"22018",308,234,232,2,2,"PP",48
6,"6007",1433,1078,1071,5,7,"PP",148
22,"22135",174,132,132,5,0,"PP",32
5,"5046",39,37,37,0,0,"PP",18
7,"7008",6047,4570,4513,31,57,"PP",761
40,"40097",125,96,95,1,1,"PP",27
39,"39096",670,523,518,2,5,"PP",170
44,"44102",27,22,22,0,0,"PP",10
23,"23096",2571,2099,2063,9,36,"PP",248
15,"15013",6299,4549,4486,45,63,"PP",1242
16,"16052",537,429,429,2,0,"PP",86
46,"46069",157,130,129,0,1,"PP",25
49,"49113",166,139,139,1,0,"PP",61
9,"9095",112,70,68,1,2,"PP",29
7,"7042",10785,7256,7191,60,65,"PP",990
45,"45172",641,504,496,4,8,"PP",180
45,"45035",293,228,223,1,5,"PP",44
24,"24106",218,164,162,0,2,"PP",54
49,"49114",40,33,32,1,1,"PP",12
3,"3077",1374,1131,1114,9,17,"PP",324
46,"46039",2121,1730,1698,19,32,"PP",439
27,"27028",78798,58316,57546,629,770,"PP",14886
6,"6108",2249,1726,1684,22,42,"PP",317
40,"40029",24,21,21,0,0,"PP",8
16,"16141",130,105,105,0,0,"PP",23
24,"24230",410,312,309,5,3,"PP",121
50,"50233",104,82,82,0,0,"PP",33
12,"12123",43,35,34,1,1,"PP",11
22,"22907",1444,1149,1137,12,12,"PP",209
23,"23097",6356,4509,4462,17,47,"PP",757
47,"47090",2435,1956,1921,12,35,"PP",509
18,"18034",486,376,374,4,2,"PP",53
22,"22908",188,133,131,0,2,"PP",25
42,"42032",142,120,120,0,0,"PP",52
24,"24901",860,642,630,7,12,"PP",154
5,"5168",3500,2774,2730,25,44,"PP",1017
26,"26143",242,190,189,0,1,"PP",57
15,"15015",2883,2079,2049,21,30,"PP",548
9,"9050",52,36,36,0,0,"PP",10
49,"49193",435,303,287,1,16,"PP",93
47,"47060",231,198,195,4,3,"PP",56
40,"40101",923,737,728,8,9,"PP",105
6,"6011",24665,18486,18253,178,233,"PP",3597
12,"12124",1840,1477,1460,8,17,"PP",544
5,"5051",162,135,131,0,4,"PP",48
37,"37131",171,138,137,0,1,"PP",47
19,"19042",21,19,18,1,1,"PP",1
35,"35014",11908,7101,6947,63,154,"PP",1155
45,"45086",493,373,368,0,5,"PP",92
19,"19277",16,13,13,0,0,"PP",3
15,"15017",19860,14930,14706,204,224,"PP",2484
49,"49239",617,437,420,7,17,"PP",109
26,"26145",237,207,204,0,3,"PP",84
39,"39016",23868,19029,18839,108,190,"PP",3791
37,"37246",5155,4153,4107,33,46,"PP",1041
2,"2074",5891,4435,4375,41,60,"PP",893
28,"28163",429,361,345,4,16,"PP",62
34,"34127",80,64,64,1,0,"PP",34
34,"34129",170,134,132,2,2,"PP",65
37,"37247",173,144,143,1,1,"PP",52
9,"9430",22,20,20,0,0,"PP",7
22,"22023",389,313,305,6,8,"PP",72
26,"26066",259,216,212,3,4,"PP",82
37,"37011",99,75,73,0,2,"PP",24
10,"10200",341,262,261,0,1,"PP",88
46,"46165",7298,5744,5697,38,47,"PP",1040
26,"26146",86,69,69,1,0,"PP",28
37,"37134",212,156,148,0,8,"PP",35
45,"45180",2834,2269,2239,11,30,"PP",596
47,"47127",138,92,89,1,3,"PP",35
40,"40208",720,592,585,4,7,"PP",218
42,"42172",28,25,25,1,0,"PP",14
7,"7048",18412,11528,11412,112,116,"PP",1717
45,"45089",1432,1159,1134,5,25,"PP",173
49,"49242",444,364,359,3,5,"PP",134
22,"22143",197,134,132,1,2,"PP",39
12,"12127",67,50,50,1,0,"PP",3
37,"37136",633,448,434,8,14,"PP",101
10,"10202",588,469,459,0,10,"PP",95
37,"37135",1163,934,924,8,10,"PP",295
37,"37013",107,73,72,0,1,"PP",36
7,"7049",1480,1092,1075,10,17,"PP",242
9,"9433",58,51,50,1,1,"PP",16
19,"19329",59,49,49,0,0,"PP",13
43,"43048",763,614,609,7,5,"PP",73
44,"44011",48,32,32,1,0,"PP",7
19,"19047",55,47,47,0,0,"PP",12
47,"47064",37,32,29,0,3,"PP",9
40,"40001",706,597,590,7,7,"PP",189
19,"19048",19,13,13,0,0,"PP",4
50,"50238",86,66,66,2,0,"PP",16
49,"49002",58,49,43,0,6,"PP",15
40,"40107",92,76,74,0,2,"PP",31
49,"49244",49,32,32,1,0,"PP",17
1,"1031",1163,948,928,6,20,"PP",224
46,"46076",591,497,487,0,10,"PP",180
29,"29067",430670,312817,309994,2768,2823,"PP",52863
41,"41061",2144,1763,1712,7,51,"PP",117
27,"27066",12633,9139,8911,84,228,"PP",2300
50,"50239",63,47,47,0,0,"PP",24
37,"37363",107,81,80,0,1,"PP",33
37,"37251",107,79,79,1,0,"PP",20
18,"18146",937,690,682,6,8,"PP",114
15,"15021",5244,3884,3806,70,78,"PP",1086
9,"9112",104,76,76,1,0,"PP",28
40,"40212",27,22,20,0,2,"PP",6
48,"48023",580,493,489,0,4,"PP",12
30,"30029",12055,9003,8882,58,121,"PP",2052
39,"39020",23931,17782,17566,126,216,"PP",2361
16,"16151",64,52,52,0,0,"PP",25
19,"19104",18,16,16,0,0,"PP",8
37,"37252",101,80,79,1,1,"PP",40
16,"16025",25,21,21,0,0,"PP",7
9,"9113",460,369,364,3,5,"PP",71
3,"3086",166,143,143,1,0,"PP",16
14,"14008",2785,1942,1910,15,32,"PP",415
46,"46169",32294,24909,24676,157,233,"PP",3478
45,"45186",2945,2319,2280,11,39,"PP",494
4,"4047",2230,1806,1785,8,21,"PP",614
22,"22029",119,103,103,0,0,"PP",32
29,"29069",86694,58863,58127,561,736,"PP",10714
47,"47163",280,238,232,2,6,"PP",41
37,"37253",133,107,103,0,4,"PP",24
43,"43124",472,379,373,1,6,"PP",13
4,"4048",1496,1109,1102,4,7,"PP",237
9,"9114",76,63,63,0,0,"PP",21
41,"41063",2713,1988,1944,17,44,"PP",171
12,"12131",59,50,50,0,0,"PP",30
19,"19334",44,37,37,0,0,"PP",9
23,"23007",3026,2317,2301,13,16,"PP",391
18,"18147",3644,2492,2441,18,51,"PP",438
28,"28170",2487,1840,1810,10,30,"PP",314
23,"23008",1434,1155,1133,6,22,"PP",149
48,"48025",860,694,694,3,0,"PP",4
10,"10208",121,94,94,2,0,"PP",23
9,"9115",91,71,66,2,5,"PP",33
19,"19053",1929,1472,1458,9,14,"PP",442
45,"45189",616,506,498,2,8,"PP",102
9,"9276",389,283,268,5,15,"PP",29
22,"22156",296,246,242,3,4,"PP",36
37,"37019",140,118,117,1,1,"PP",65
41,"41065",22550,16215,16010,189,205,"PP",1567
50,"50243",311,252,247,1,5,"PP",67
43,"43052",934,765,756,2,9,"PP",13
26,"26038",81,61,61,0,0,"PP",14
37,"37020",425,341,339,4,2,"PP",106
49,"49249",63,52,52,1,0,"PP",30
7,"7055",7897,5264,5176,47,88,"PP",1226
32,"32052",1819,1399,1379,15,20,"PP",725
28,"28171",4382,3202,3134,11,68,"PP",822
10,"10088",196,139,138,0,1,"PP",42
5,"5181",46,39,39,0,0,"PP",12
9,"9279",167,131,128,2,3,"PP",50
10,"10089",1328,1014,982,20,32,"PP",124
9,"9119",45,26,26,0,0,"PP",7
28,"28109",1622,1205,1192,3,13,"PP",294
24,"24164",362,221,220,1,1,"PP",58
39,"39053",213,146,145,2,1,"PP",31
16,"16031",36,25,25,0,0,"PP",9
5,"5064",102,83,81,2,2,"PP",53
34,"34003",150,122,120,2,2,"PP",50
47,"47167",242,212,210,0,2,"PP",68
22,"22158",11951,8877,8801,69,76,"PP",1608
35,"35023",11694,8785,8607,67,178,"PP",1413
21,"21006",3329,2307,2262,20,45,"PP",230
50,"50069",67,44,44,0,0,"PP",8
45,"45055",998,844,828,4,16,"PP",249
39,"39025",8703,6954,6854,39,100,"PP",1246
39,"39026",1720,1322,1312,5,10,"PP",383
10,"10212",1645,1283,1238,7,45,"PP",193
22,"22037",112,96,96,0,0,"PP",15
46,"46083",15374,11259,11096,56,163,"PP",1952
40,"40113",408,339,335,6,4,"PP",53
19,"19057",72,59,58,0,1,"PP",7
40,"40009",40,34,34,0,0,"PP",12
28,"28111",622,492,487,1,5,"PP",112
21,"21008",2613,1803,1777,6,26,"PP",258
1,"1042",907,723,721,4,2,"PP",29
10,"10213",534,447,441,5,6,"PP",139
37,"37146",102,86,86,1,0,"PP",47
24,"24007",753,569,563,4,6,"PP",80
15,"15029",5403,3682,3622,62,60,"PP",1263
24,"24124",346,231,226,2,5,"PP",76
10,"10214",217,175,175,1,0,"PP",70
37,"37259",36,29,29,0,0,"PP",16
48,"48060",3620,2615,2606,13,9,"PP",44
40,"40220",62,48,48,0,0,"PP",16
32,"32084",902,636,631,2,5,"PP",279
44,"44020",22,18,18,0,0,"PP",10
41,"41068",13936,10692,10530,73,162,"PP",1225
14,"14014",2509,2071,2030,7,41,"PP",424
35,"35025",1773,1247,1235,9,12,"PP",370
12,"12136",2606,2262,2223,17,39,"PP",689
5,"5185",90,71,70,0,1,"PP",33
46,"46085",11075,8106,8011,54,95,"PP",1707
43,"43129",4611,3528,3495,21,33,"PP",121
4,"4055",366,315,314,3,1,"PP",87
22,"22163",419,363,361,1,2,"PP",62
6,"6026",815,661,653,5,8,"PP",230
34,"34009",30,26,26,0,0,"PP",14
9,"9288",88,73,71,1,2,"PP",28
28,"28007",126831,103108,102202,710,906,"PP",17728
50,"50162",137,112,110,2,2,"PP",27
5,"5186",1558,1255,1247,9,8,"PP",449
37,"37148",404,321,315,2,6,"PP",96
49,"49257",310,205,202,2,3,"PP",45
10,"10216",1522,1195,1167,9,28,"PP",356
26,"26045",11,11,11,0,0,"PP",4
35,"35027",10499,7651,7530,57,121,"PP",1543
16,"16161",52,47,47,0,0,"PP",24
40,"40013",56,47,47,0,0,"PP",34
32,"32001",5105,3760,3715,37,45,"PP",859
32,"32086",2563,1699,1686,19,13,"PP",686
24,"24010",8268,5968,5847,66,121,"PP",1558
20,"20007",327,235,230,2,5,"PP",0
10,"10217",521,436,432,0,4,"PP",163
10,"10096",3326,2553,2501,14,52,"PP",468
14,"14017",10945,8514,8386,90,128,"PP",1117
46,"46087",109,98,98,1,0,"PP",24
3,"3096",5779,4433,4352,30,81,"PP",800
29,"29079",2335,1796,1765,7,31,"PP",275
40,"40121",249,196,193,4,3,"PP",92
19,"19065",114,92,91,0,1,"PP",25
34,"34058",185,161,161,1,0,"PP",65
44,"44121",53,38,38,2,0,"PP",10
43,"43057",38,31,31,1,0,"PP",0
19,"19212",674,528,519,2,9,"PP",168
37,"37264",55,42,42,0,0,"PP",16
15,"15033",2422,1887,1866,13,21,"PP",655
50,"50250",56,45,45,0,0,"PP",6
9,"9294",102,86,85,0,1,"PP",13
32,"32087",1675,1313,1288,18,25,"PP",632
1,"1049",132,100,100,1,0,"PP",10
16,"16163",60,50,50,0,0,"PP",16
10,"10016",327,260,259,1,1,"PP",42
21,"21014",4065,3192,3148,22,44,"PP",547
28,"28082",6063,4939,4889,46,50,"PP",757
48,"48034",12639,9519,9443,77,76,"PP",1067
46,"46252",128,106,106,2,0,"PP",48
16,"16165",55,49,48,1,1,"PP",14
44,"44246",1590,1173,1150,11,23,"PP",238
40,"40015",24,24,24,1,0,"PP",19
39,"39087",41381,32335,31995,194,340,"PP",5749
47,"47174",270,215,208,2,7,"PP",51
10,"10139",95,78,77,1,1,"PP",23
16,"16166",239,176,174,3,2,"PP",41
5,"5114",1264,1061,1030,3,31,"PP",291
19,"19071",8155,6327,6242,35,85,"PP",990
50,"50251",8207,6352,6242,46,110,"PP",1441
18,"18159",999,828,824,1,4,"PP",60
21,"21015",654,363,359,8,4,"PP",29
4,"4061",622,501,494,4,7,"PP",43
47,"47079",54,48,48,0,0,"PP",20
45,"45204",634,500,497,1,3,"PP",109
32,"32089",1220,872,857,15,15,"PP",368
22,"22045",73,57,56,0,1,"PP",10
22,"22046",714,592,587,13,5,"PP",138
48,"48036",24038,18180,18050,94,130,"PP",880
34,"34156",50,43,43,0,0,"PP",26
23,"23019",1479,1209,1183,3,26,"PP",199
37,"37267",182,153,150,1,3,"PP",46
9,"9458",484,408,401,5,7,"PP",61
16,"16042",1108,948,938,3,10,"PP",234
29,"29084",27218,19648,19352,173,296,"PP",3481
40,"40017",84,74,71,2,3,"PP",22
37,"37074",140,107,106,1,1,"PP",37
7,"7901",594,454,446,6,8,"PP",115
21,"21053",3287,2375,2322,17,53,"PP",405
20,"20011",1633,1297,1287,2,10,"PP",21
34,"34157",2364,1881,1846,13,35,"PP",562
35,"35031",7412,5593,5519,41,74,"PP",1049
23,"23020",1524,1363,1348,12,15,"PP",231
28,"28181",20669,17314,17205,101,109,"PP",4266
32,"32006",1434,1033,1019,8,14,"PP",581
48,"48007",385,281,279,1,2,"PP",3
4,"4100",9266,6046,5988,49,58,"PP",1450
49,"49180",138,95,95,0,0,"PP",29
45,"45023",2248,1799,1784,16,15,"PP",259
32,"32035",1370,881,872,5,9,"PP",480
41,"41076",2143,1419,1403,14,16,"PP",215
34,"34020",51,38,38,0,0,"PP",6
44,"44219",173,142,136,1,6,"PP",55
22,"22173",218,162,160,1,2,"PP",26
9,"9136",173,130,128,0,2,"PP",33
6,"6034",167,115,115,1,0,"PP",32
32,"32007",1412,1011,1001,9,10,"PP",365
6,"6133",1799,1476,1453,12,23,"PP",337
9,"9304",192,164,161,2,3,"PP",61
16,"16275",12,12,12,0,0,"PP",5
9,"9358",248,186,179,1,7,"PP",83
19,"19076",19,18,18,0,0,"PP",9
34,"34159",370,247,244,5,3,"PP",57
35,"35033",6403,4565,4502,34,63,"PP",854
9,"9137",180,149,147,1,2,"PP",38
22,"22174",462,381,377,0,4,"PP",119
47,"47083",83,66,65,1,1,"PP",27
6,"6035",865,678,670,4,8,"PP",271
38,"38001",20907,12323,12197,70,126,"PP",1494
49,"49023",909,682,674,5,8,"PP",232
42,"42062",20,14,13,0,1,"PP",4
12,"12057",578,485,473,3,12,"PP",130
40,"40020",155,125,119,4,6,"PP",32
26,"26093",48,38,38,0,0,"PP",5
47,"47211",48,43,43,1,0,"PP",19
22,"22128",192,155,154,2,1,"PP",34
4,"4103",1439,1120,1108,16,12,"PP",296
50,"50198",49,43,43,1,0,"PP",10
28,"28901",868,653,639,6,14,"PP",123
46,"46003",953,828,811,5,17,"PP",180
37,"37272",133,106,106,1,0,"PP",37
39,"39036",971,794,787,5,7,"PP",160
28,"28016",78,62,61,1,1,"PP",13
26,"26173",6,6,6,0,0,"PP",3
37,"37160",606,431,418,6,13,"PP",143
26,"26056",403,334,328,2,6,"PP",129
1,"1057",243,202,199,0,3,"PP",17
40,"40234",376,307,299,2,8,"PP",79
9,"9472",52,45,44,0,1,"PP",12
26,"26174",132,116,116,5,0,"PP",48
42,"42063",47,31,28,0,3,"PP",14
22,"22902",208,160,156,0,4,"PP",43
36,"36001",2401,1739,1715,19,24,"PP",721
18,"18061",1000,827,822,1,5,"PP",194
9,"9309",292,224,223,3,1,"PP",59
19,"19130",61365,49363,48747,383,616,"PP",11054
2,"2029",3327,2586,2556,15,30,"PP",483
3,"3105",5471,4099,4003,14,96,"PP",1013
39,"39038",1506,1093,1076,2,17,"PP",197
5,"5198",71,51,51,0,0,"PP",24
5,"5083",141,104,103,2,1,"PP",37
22,"22177",97,81,81,1,0,"PP",22
20,"20016",1524,997,997,1,0,"PP",8
22,"22052",885,708,702,6,6,"PP",172
43,"43064",2017,1569,1558,9,11,"PP",91
10,"10109",1730,1208,1181,12,27,"PP",296
40,"40024",827,657,645,4,12,"PP",194
45,"45077",562,442,437,0,5,"PP",104
37,"37163",32,27,27,0,0,"PP",7
21,"21024",466,355,341,4,14,"PP",42
40,"40131",50,47,47,0,0,"PP",14
16,"16094",120,89,88,0,1,"PP",35
9,"9311",59,47,46,0,1,"PP",6
11,"11901",5698,4167,4080,81,87,"PP",506
26,"26022",187,153,148,0,5,"PP",85
36,"36003",10038,7747,7632,79,115,"PP",2048
6,"6139",502,429,421,5,8,"PP",76
43,"43091",123,93,93,1,0,"PP",2
9,"9366",75,60,60,2,0,"PP",16
40,"40025",128,109,106,1,3,"PP",59
26,"26059",1122,861,841,7,20,"PP",280
20,"20018",11218,8145,8109,41,36,"PP",155
37,"37041",73,55,55,0,0,"PP",23
18,"18170",324,225,224,1,1,"PP",35
21,"21025",3898,2765,2705,39,60,"PP",716
11,"11008",17840,12434,12236,181,198,"PP",1495
32,"32012",716,497,487,7,10,"PP",189
10,"10111",1306,1006,994,12,12,"PP",246
49,"49273",166,111,110,0,1,"PP",55
15,"15012",3611,2695,2616,36,79,"PP",1067
11,"11903",1791,1234,1211,16,23,"PP",179
34,"34121",183,155,151,1,4,"PP",66
24,"24148",1616,1252,1237,11,15,"PP",427
46,"46008",2624,2036,1996,9,40,"PP",299
15,"15044",1209,889,876,4,13,"PP",372
1,"1062",315,236,229,2,7,"PP",36
6,"6074",4755,3719,3638,27,81,"PP",866
36,"36005",8122,5895,5776,65,119,"PP",1755
38,"38007",1625,1124,1104,2,20,"PP",321
43,"43067",528,450,445,1,5,"PP",4
47,"47089",132,116,115,1,1,"PP",52
19,"19089",25,19,19,1,0,"PP",2
9,"9482",35,28,28,0,0,"PP",11
15,"15045",3629,2263,2237,9,26,"PP",982
40,"40028",105,96,96,1,0,"PP",39
41,"41100",967,765,727,8,38,"PP",131
4,"4034",165,107,106,1,1,"PP",36
44,"44005",46,31,31,1,0,"PP",10
49,"49275",51218,38135,37628,388,507,"PP",9305
47,"47058",202,154,153,3,1,"PP",43
3,"3110",312,271,269,1,2,"PP",58
44,"44036",23,20,20,0,0,"PP",6
4,"4074",2887,2062,2038,16,24,"PP",366
24,"24150",224,176,174,2,2,"PP",70
38,"38009",4299,3105,3069,16,36,"PP",709
45,"45082",1143,976,967,7,9,"PP",294
36,"36039",15610,11844,11592,103,252,"PP",2755
22,"22095",65,57,56,1,1,"PP",11
43,"43068",483,367,365,5,2,"PP",36
46,"46902",356,300,296,8,4,"PP",36
42,"42075",78,60,60,1,0,"PP",22
19,"19091",23,19,19,0,0,"PP",7
47,"47186",244448,197042,195276,1561,1766,"PP",45949
26,"26063",118,96,95,2,1,"PP",33
44,"44228",99,83,83,0,0,"PP",33
4,"4075",5427,3989,3961,15,28,"PP",1040
7,"7045",1300,1038,1030,6,8,"PP",166
19,"19187",42,36,36,0,0,"PP",9
37,"37281",39,34,33,0,1,"PP",12
9,"9902",446,345,341,0,4,"PP",81
50,"50178",276,193,193,4,0,"PP",16
28,"28096",19809,15584,15392,118,192,"PP",2409
34,"34035",100,84,82,1,2,"PP",32
40,"40138",2127,1729,1696,18,33,"PP",445
21,"21067",402,300,299,2,1,"PP",22
50,"50003",119,95,95,1,0,"PP",18
13,"13014",481,400,395,1,5,"PP",107
13,"13059",196,169,168,0,1,"PP",47
43,"43045",146,128,127,0,1,"PP",3
27,"27031",15212,10826,10649,125,177,"PP",2986
39,"39044",3868,3019,2985,8,34,"PP",606
5,"5209",75,58,57,0,1,"PP",35
48,"48049",545,448,448,0,0,"PP",2
36,"36009",4445,3081,2997,26,84,"PP",1194
28,"28097",125,100,100,0,0,"PP",12
28,"28025",404,314,305,3,9,"PP",129
26,"26105",2211,1744,1723,19,21,"PP",436
34,"34177",176,154,152,2,2,"PP",66
3,"3113",4342,3194,3154,23,40,"PP",624
46,"46225",348,279,273,2,6,"PP",68
19,"19278",24,24,24,0,0,"PP",17
46,"46013",17712,14181,14075,88,106,"PP",2202
50,"50236",101,82,80,1,2,"PP",37
5,"5210",79,57,57,0,0,"PP",27
46,"46104",1891,1515,1481,17,34,"PP",336
43,"43071",891,713,706,6,7,"PP",54
26,"26067",20,19,19,0,0,"PP",8
50,"50180",106,84,84,1,0,"PP",23
28,"28026",6703,5422,5367,21,55,"PP",1100
46,"46074",2678,2158,2135,13,23,"PP",310
37,"37284",314,241,237,2,4,"PP",87
14,"14065",1813,1439,1421,11,18,"PP",284
42,"42080",150,116,116,1,0,"PP",37
45,"45134",1609,1305,1291,6,14,"PP",308
11,"11016",15051,10188,10042,131,146,"PP",1560
29,"29099",969,757,735,5,22,"PP",126
28,"28100",4409,3425,3382,20,43,"PP",477
47,"47002",18,18,18,0,0,"PP",7
6,"6147",338,262,258,2,4,"PP",31
46,"46014",3130,2488,2462,7,26,"PP",456
3,"3115",255,222,221,2,1,"PP",52
48,"48051",216,157,157,0,0,"PP",5
43,"43072",93,74,74,0,0,"PP",7
21,"21034",1159,863,845,4,18,"PP",112
20,"20056",4075,2983,2942,12,41,"PP",68
41,"41088",512,383,377,1,6,"PP",46
37,"37174",983,788,768,0,20,"PP",270
41,"41004",57465,41004,40321,571,683,"PP",4695
23,"23038",3785,3182,3162,16,20,"PP",698
50,"50091",40,35,35,0,0,"PP",17
21,"21035",9726,6628,6520,78,108,"PP",1403
46,"46015",7477,5857,5808,33,49,"PP",1034
44,"44041",58,48,44,1,4,"PP",4
49,"49160",43,29,26,0,3,"PP",3
41,"41005",9250,6925,6809,69,116,"PP",891
16,"16194",220,181,173,1,8,"PP",25
50,"50267",573,440,434,7,6,"PP",87
9,"9166",98,77,77,1,0,"PP",33
24,"24158",296,226,220,2,6,"PP",66
50,"50007",49,34,34,0,0,"PP",7
5,"5213",95,77,75,0,2,"PP",40
47,"47097",307,258,256,4,2,"PP",66
6,"6149",10203,8194,8051,72,143,"PP",1530
5,"5214",27,22,22,0,0,"PP",8
26,"26071",8662,6409,6288,52,121,"PP",1359
44,"44234",70,57,57,1,0,"PP",17
49,"49162",175,134,131,1,3,"PP",38
24,"24159",1746,1393,1368,6,25,"PP",470
47,"47005",502,420,414,2,6,"PP",109
47,"47192",94,82,81,2,1,"PP",27
28,"28030",1815,1438,1395,10,43,"PP",265
32,"32021",874,616,615,4,1,"PP",186
44,"44174",409,306,300,3,6,"PP",106
13,"13022",332,264,256,1,8,"PP",58
44,"44235",89,67,66,2,1,"PP",25
22,"22066",748,576,567,6,9,"PP",89
9,"9332",140,103,102,0,1,"PP",36
29,"29014",222,151,150,6,1,"PP",21
9,"9013",44,37,37,0,0,"PP",16
13,"13023",8950,6359,6271,76,88,"PP",2180
34,"34046",44,31,31,0,0,"PP",11
47,"47006",186,153,149,1,4,"PP",31
42,"42085",178,133,133,3,0,"PP",69
43,"43002",1875,1367,1348,11,19,"PP",45
44,"44144",325,249,247,1,2,"PP",49
28,"28106",78429,59182,58471,417,711,"PP",6065
21,"21075",335,256,249,0,7,"PP",57
40,"40039",180,147,144,1,3,"PP",69
12,"12074",761,659,645,7,14,"PP",194
21,"21039",299,226,223,7,3,"PP",22
48,"48086",2015,1504,1486,6,18,"PP",43
6,"6152",1285,952,935,4,17,"PP",148
44,"44044",83,65,64,2,1,"PP",27
37,"37058",56,41,41,0,0,"PP",20
42,"42006",152,115,112,2,3,"PP",39
15,"15055",4485,3097,3057,39,40,"PP",665
49,"49165",55,53,50,0,3,"PP",20
37,"37291",269,212,209,2,3,"PP",50
44,"44145",972,741,732,11,9,"PP",183
40,"40040",2495,1913,1895,20,18,"PP",555
46,"46019",8948,7150,7067,40,83,"PP",1230
10,"10128",5628,4238,4126,43,112,"PP",861
36,"36019",1463,1041,1030,14,11,"PP",249
23,"23043",518,398,397,0,1,"PP",109
46,"46111",11326,8603,8492,55,111,"PP",1356
10,"10006",1230,1006,995,8,11,"PP",250
45,"45098",2110,1675,1652,6,23,"PP",679
16,"16199",28,23,23,1,0,"PP",9
9,"9064",305,251,249,3,2,"PP",76
24,"24163",4073,3269,3231,36,38,"PP",665
48,"48027",22668,17326,17224,95,102,"PP",968
44,"44046",43,32,32,0,0,"PP",9
47,"47009",99,84,84,0,0,"PP",26
5,"5219",37,30,30,0,0,"PP",9
23,"23044",4719,3817,3749,18,68,"PP",724
47,"47196",28,24,24,0,0,"PP",16
34,"34050",185,156,156,2,0,"PP",65
5,"5142",90,83,81,0,2,"PP",32
49,"49208",364,260,255,5,5,"PP",135
50,"50215",20,18,18,0,0,"PP",3
14,"14042",18727,15069,14837,201,232,"PP",2219
50,"50272",13174,10143,10042,103,101,"PP",1243
22,"22202",145,127,126,0,1,"PP",28
16,"16255",136,108,108,0,0,"PP",37
24,"24165",327,236,233,1,3,"PP",52
34,"34192",82,68,68,0,0,"PP",36
5,"5220",363,312,308,5,4,"PP",116
5,"5105",336,272,266,2,6,"PP",65
41,"41011",15454,11892,11591,160,301,"PP",1113
32,"32026",2659,1988,1957,26,31,"PP",529
50,"50012",96,79,79,1,0,"PP",17
12,"12106",1163,980,951,7,29,"PP",162
22,"22074",275,223,221,10,2,"PP",31
44,"44179",325,233,231,7,2,"PP",49
21,"21044",17955,11674,11479,136,195,"PP",3759
26,"26078",86,71,70,1,1,"PP",19
37,"37335",389,308,301,3,7,"PP",119
23,"23046",2331,1953,1926,3,27,"PP",305
24,"24046",899,678,663,7,15,"PP",149
49,"49169",34,28,26,0,2,"PP",9
19,"19248",76,56,56,0,0,"PP",13
40,"40150",61,53,53,1,0,"PP",22
5,"5222",152,111,109,0,2,"PP",41
32,"32027",1000,762,747,5,15,"PP",377
39,"39055",1075,836,829,8,7,"PP",285
37,"37109",177,149,149,3,0,"PP",63
47,"47012",101,80,80,0,0,"PP",31
42,"42093",35,29,29,2,0,"PP",16
42,"42092",62,42,41,1,1,"PP",11
13,"13032",1084,842,831,9,11,"PP",215
37,"37298",172,126,125,0,1,"PP",47
46,"46115",352,261,260,0,1,"PP",104
3,"3032",99,87,87,0,0,"PP",24
14,"14045",3013,2508,2468,13,40,"PP",369
13,"13033",1560,1278,1262,9,16,"PP",233
10,"10011",532,439,435,3,4,"PP",59
46,"46024",444,339,335,1,4,"PP",75
18,"18188",1648,1295,1276,4,19,"PP",241
41,"41013",4807,3480,3425,30,55,"PP",277
30,"30006",829,731,727,4,4,"PP",266
19,"19115",32,23,23,0,0,"PP",11
37,"37185",537,416,405,1,11,"PP",122
34,"34202",28,20,20,1,0,"PP",6
24,"24050",105,88,87,3,1,"PP",29
50,"50190",675,565,553,5,12,"PP",130
9,"9024",150,116,114,0,2,"PP",44
37,"37299",229,175,168,0,7,"PP",61
24,"24169",2809,2165,2146,18,19,"PP",364
37,"37068",340,256,256,3,0,"PP",95
15,"15062",5652,3803,3728,25,75,"PP",1471
11,"11030",22973,16087,15853,165,234,"PP",2635
13,"13035",955,739,720,6,19,"PP",138
47,"47014",47,43,43,1,0,"PP",21
32,"32029",436,340,337,1,3,"PP",211
5,"5226",65,52,52,0,0,"PP",30
14,"14047",1629,1300,1285,18,15,"PP",206
11,"11031",76294,54123,53583,589,540,"PP",7474
34,"34057",462,345,330,3,15,"PP",116
49,"49174",130,93,91,0,2,"PP",37
44,"44152",67,48,48,2,0,"PP",15
50,"50016",44,31,31,0,0,"PP",10
12,"12081",602,488,481,0,7,"PP",142
36,"36025",2137,1387,1381,7,6,"PP",637
10,"10055",696,527,512,1,15,"PP",138
44,"44245",245,176,171,1,5,"PP",58
41,"41043",667,475,453,3,22,"PP",45
34,"34205",55,44,44,0,0,"PP",18
46,"46118",3670,2930,2894,25,36,"PP",644
47,"47205",355,263,258,3,5,"PP",103
36,"36026",19924,14342,14132,171,210,"PP",4287
28,"28115",62352,53136,52912,268,224,"PP",15643
41,"41016",7767,5937,5829,56,108,"PP",918
37,"37070",528,422,417,2,5,"PP",125
30,"30009",12689,10036,9909,50,127,"PP",2834
46,"46027",932,769,755,1,14,"PP",164
9,"9238",941,573,567,8,6,"PP",160
16,"16213",34,29,28,0,1,"PP",10
48,"48064",613,494,492,1,2,"PP",2
14,"14049",16282,12515,12301,121,214,"PP",1975
23,"23084",907,685,670,0,15,"PP",104
42,"42017",131,104,104,2,0,"PP",27
10,"10901",1177,818,805,1,13,"PP",166
37,"37072",145,136,134,3,2,"PP",53
34,"34015",39,32,31,0,1,"PP",18
50,"50106",127,97,96,0,1,"PP",20
5,"5075",99,79,79,1,0,"PP",41
24,"24216",671,504,502,3,2,"PP",200
22,"22080",264,208,202,2,6,"PP",64
49,"49177",260,165,162,2,3,"PP",47
24,"24174",469,360,354,5,6,"PP",111
22,"22212",70,56,56,0,0,"PP",6
24,"24055",676,513,508,6,5,"PP",143
6,"6064",850,658,647,2,11,"PP",82
13,"13041",249,179,171,2,8,"PP",36
5,"5115",516,397,395,3,2,"PP",158
36,"36059",4663,3196,3115,31,81,"PP",1319
16,"16085",135,109,109,1,0,"PP",32
18,"18088",1530,1152,1142,0,10,"PP",106
43,"43011",1079,912,909,1,3,"PP",47
37,"37305",218,180,178,3,2,"PP",63
47,"47207",260,213,211,2,2,"PP",83
18,"18089",14540,10725,10583,65,142,"PP",2219
47,"47208",56,37,37,0,0,"PP",13
50,"50020",802,606,600,7,6,"PP",126
48,"48097",1316,979,976,4,3,"PP",31
6,"6065",298,258,255,1,3,"PP",110
44,"44187",193,155,151,1,4,"PP",50
50,"50280",301,246,240,1,6,"PP",57
40,"40159",132,101,101,0,0,"PP",36
19,"19122",81,64,64,1,0,"PP",18
39,"39061",3488,2833,2798,18,35,"PP",744
47,"47209",34,25,25,0,0,"PP",6
22,"22252",118,100,99,0,1,"PP",17
46,"46182",1310,988,977,5,11,"PP",137
50,"50297",502835,394653,391387,3269,3266,"PP",67396
34,"34108",502,424,415,6,9,"PP",105
42,"42105",46,37,37,1,0,"PP",25
19,"19305",135,104,103,3,1,"PP",31
18,"18093",2756,1902,1885,8,17,"PP",384
12,"12087",25,19,18,2,1,"PP",13
22,"22214",118,98,97,1,1,"PP",46
50,"50281",68,55,52,0,3,"PP",18
47,"47114",3911,2864,2807,28,57,"PP",709
11,"11037",5644,4567,4433,34,134,"PP",284
19,"19124",380,271,268,0,3,"PP",56
2,"2062",386,287,285,4,2,"PP",69
28,"28152",16839,14205,14151,87,54,"PP",3033
40,"40126",67,53,51,0,2,"PP",24
40,"40195",813,630,623,5,7,"PP",260
48,"48069",13094,10021,9954,49,67,"PP",502
36,"36031",562,455,450,2,5,"PP",138
30,"30014",1585,1226,1202,3,24,"PP",235
13,"13046",693,558,547,0,11,"PP",160
5,"5234",46,43,43,0,0,"PP",28
19,"19262",123,98,97,0,1,"PP",40
39,"39063",954,726,722,4,4,"PP",182
50,"50022",504,396,386,11,10,"PP",109
14,"14054",13796,11042,10799,102,243,"PP",2904
47,"47021",72,63,63,0,0,"PP",16
37,"37079",80,69,68,2,1,"PP",26
5,"5120",32,25,25,1,0,"PP",13
36,"36901",4152,3400,3338,15,62,"PP",637
6,"6102",1019,852,842,2,10,"PP",209
9,"9306",98,82,81,1,1,"PP",26
5,"5080",44,31,29,0,2,"PP",16
9,"9467",60,46,46,0,0,"PP",23
16,"16225",59,40,40,0,0,"PP",15
6,"6036",4958,3785,3728,22,57,"PP",743
12,"12026",835,656,639,4,17,"PP",212
23,"23057",732,613,611,4,2,"PP",74
20,"20045",46866,33932,33700,191,232,"PP",2445
11,"11040",398,348,342,4,6,"PP",33
47,"47023",3057,2577,2557,21,20,"PP",487
43,"43088",2026,1565,1562,9,3,"PP",52
26,"26094",69,56,56,0,0,"PP",29
24,"24061",1736,1350,1328,10,22,"PP",267
10,"10148",32986,23987,23589,201,398,"PP",5196
13,"13048",506,388,384,3,4,"PP",121
22,"22130",10128,7355,7294,61,61,"PP",1384
16,"16174",168,143,141,1,2,"PP",37
4,"4028",202,183,181,0,2,"PP",33
50,"50200",475,416,407,4,9,"PP",51
13,"13049",747,566,553,4,13,"PP",152
44,"44099",649,457,450,2,7,"PP",60
50,"50903",2238,1750,1732,11,18,"PP",294
19,"19265",135,107,107,1,0,"PP",48
43,"43162",4418,3467,3453,20,14,"PP",221
7,"7005",6975,4824,4775,43,49,"PP",728
11,"11042",1155,870,852,7,18,"PP",163
43,"43089",281,209,208,0,1,"PP",6
5,"5238",739,589,586,1,3,"PP",197
37,"37238",106,88,87,1,1,"PP",20
47,"47213",108,84,84,0,0,"PP",36
47,"47024",232,189,188,0,1,"PP",67
16,"16231",50,40,40,0,0,"PP",16
46,"46127",2740,2174,2147,11,27,"PP",453
28,"28124",59,52,52,0,0,"PP",13
34,"34221",170,138,136,2,2,"PP",40
32,"32039",1142,895,890,7,5,"PP",428
6,"6138",1013,783,767,3,16,"PP",127
45,"45030",478,368,364,3,4,"PP",85
41,"41052",3027,2357,2288,14,69,"PP",230
13,"13005",23187,18379,18119,174,260,"PP",3402
47,"47025",114,98,98,0,0,"PP",44
26,"26098",99,77,77,1,0,"PP",29
43,"43115",128,112,111,1,1,"PP",3
37,"37239",206,184,181,3,3,"PP",64
5,"5240",3323,2389,2346,16,43,"PP",702
50,"50026",421,340,328,4,12,"PP",70
50,"50287",252,200,196,7,4,"PP",47
34,"34222",109,81,79,1,2,"PP",46
27,"27026",2315,1620,1599,17,21,"PP",540
2,"2032",265,208,203,3,5,"PP",50
40,"40166",253,214,213,1,1,"PP",102
28,"28126",47,35,35,0,0,"PP",8
37,"37085",5002,3994,3951,40,43,"PP",706
19,"19134",30,24,24,0,0,"PP",4
24,"24025",289,234,226,4,8,"PP",101
50,"50232",160,116,114,2,2,"PP",27
21,"21026",253,189,183,1,6,"PP",13
9,"9256",333,260,256,2,4,"PP",93
40,"40061",65,50,48,2,2,"PP",22
26,"26100",56,46,46,0,0,"PP",9
34,"34223",205,160,157,1,3,"PP",66
9,"9094",51,46,45,0,1,"PP",22
47,"47027",2775,2246,2222,14,24,"PP",451
24,"24185",452,339,332,3,7,"PP",92
50,"50203",1057,849,837,9,12,"PP",116
27,"27027",1806,1392,1354,18,38,"PP",457
19,"19136",12,12,12,0,0,"PP",4
37,"37317",288,240,238,2,2,"PP",99
9,"9047",54,46,45,0,1,"PP",19
46,"46221",345,294,294,0,0,"PP",56
6,"6075",475,379,369,2,10,"PP",60
42,"42118",21,13,13,1,0,"PP",10
5,"5242",686,588,585,11,3,"PP",405
49,"49152",483,327,322,2,5,"PP",101
49,"49236",70,55,55,0,0,"PP",20
50,"50289",51,40,38,1,2,"PP",11
3,"3902",10578,7654,7530,56,124,"PP",1796
23,"23063",3764,2812,2781,22,31,"PP",465
10,"10155",1082,825,819,4,6,"PP",184
46,"46040",995,807,794,7,13,"PP",154
27,"27060",2463,1695,1669,12,26,"PP",697
15,"15046",6163,4625,4497,49,128,"PP",1737
16,"16239",118,89,88,0,1,"PP",12
37,"37089",62,51,50,0,1,"PP",21
18,"18102",8227,6100,5969,32,131,"PP",823
28,"28053",6840,5797,5739,32,58,"PP",786
12,"12002",115,99,97,0,2,"PP",11
37,"37205",217,177,174,0,3,"PP",38
46,"46223",7781,6057,5995,42,62,"PP",1022
19,"19139",26,20,20,1,0,"PP",7
12,"12003",943,745,731,6,14,"PP",216
26,"26064",2337,1764,1724,14,40,"PP",460
22,"22096",320,274,272,2,2,"PP",67
16,"16242",308,266,263,2,3,"PP",125
37,"37090",66,51,51,1,0,"PP",26
7,"7012",1909,1358,1343,15,15,"PP",260
45,"45130",302,241,235,2,6,"PP",92
48,"48078",37991,28582,28382,202,200,"PP",2062
48,"48018",867,605,603,3,2,"PP",3
44,"44168",184,137,136,4,1,"PP",55
26,"26104",11,9,9,0,0,"PP",4
41,"41057",253,189,188,0,1,"PP",46
26,"26065",58,49,47,0,2,"PP",17
48,"48079",395,313,312,2,1,"PP",4
5,"5246",52,39,39,0,0,"PP",24
50,"50292",129,113,113,1,0,"PP",30
10,"10035",1806,1320,1282,12,38,"PP",271
12,"12097",65,54,54,1,0,"PP",18
5,"5010",145,119,118,1,1,"PP",51
36,"36041",13621,10098,9939,97,159,"PP",2827
4,"4038",3110,2235,2203,23,32,"PP",401
36,"36042",18072,13314,13091,130,223,"PP",3035
19,"19145",41,38,38,0,0,"PP",26
42,"42171",114,80,79,0,1,"PP",33
16,"16146",87,68,68,0,0,"PP",34
16,"16018",381,313,312,2,1,"PP",77
42,"42035",741,537,523,7,14,"PP",167
20,"20904",89,50,49,0,1,"PP",0
35,"35015",10728,6233,6108,54,125,"PP",753
14,"14064",300,231,227,6,4,"PP",57
47,"47032",153,121,121,1,0,"PP",42
50,"50293",392,295,293,6,2,"PP",52
16,"16061",941,790,763,8,27,"PP",190
22,"22230",288,229,228,3,1,"PP",51
19,"19327",397,333,332,0,1,"PP",125
37,"37096",203,162,160,1,2,"PP",74
16,"16910",78,54,54,1,0,"PP",15
40,"40176",375,325,322,6,3,"PP",90
37,"37209",410,288,283,3,5,"PP",48
37,"37097",44,29,29,0,0,"PP",14
23,"23067",2421,1909,1873,13,36,"PP",326
10,"10161",82,50,50,1,0,"PP",13
46,"46166",8202,6482,6399,39,83,"PP",1125
37,"37324",335,276,274,1,2,"PP",107
7,"7015",21976,14458,14297,205,161,"PP",2458
40,"40070",148,110,107,1,3,"PP",23
50,"50209",2747,1993,1975,29,18,"PP",339
16,"16020",9,5,5,0,0,"PP",3
44,"44172",295,220,218,4,2,"PP",92
50,"50122",67,55,54,0,1,"PP",11
9,"9057",148,120,116,0,4,"PP",30
6,"6082",393,314,305,5,9,"PP",63
45,"45136",5825,4314,4260,22,54,"PP",1150
10,"10040",434,321,314,1,7,"PP",64
39,"39019",2229,1785,1751,15,34,"PP",354
43,"43098",354,291,291,1,0,"PP",12
12,"12007",731,649,642,8,7,"PP",230
19,"19150",126,102,100,0,2,"PP",40
50,"50295",49,46,46,0,0,"PP",7
34,"34086",99,92,90,2,2,"PP",21
46,"46046",884,654,643,3,11,"PP",149
18,"18916",1778,1249,1236,9,13,"PP",189
37,"37325",90,70,70,0,0,"PP",33
41,"41904",1792,1171,1162,16,9,"PP",47
16,"16247",63,53,53,1,0,"PP",18
36,"36015",4076,2903,2834,37,69,"PP",847
42,"42001",251,186,186,2,0,"PP",46
44,"44268",32,30,30,0,0,"PP",8
9,"9059",136704,109424,108039,1134,1385,"PP",25808
16,"16248",862,730,720,10,10,"PP",173
19,"19151",1083,785,770,5,15,"PP",164
26,"26110",150,128,124,1,4,"PP",56
49,"49245",253,183,182,2,1,"PP",55
34,"34236",147,111,111,0,0,"PP",60
43,"43099",286,234,234,0,0,"PP",6
45,"45093",154,124,123,0,1,"PP",54
19,"19152",550,413,405,3,8,"PP",127
4,"4006",7218,5002,4940,33,62,"PP",1451
50,"50124",399,316,316,3,0,"PP",101
6,"6084",1065,904,890,8,14,"PP",257
16,"16109",41,33,33,3,0,"PP",14
36,"36047",2287,1601,1585,14,16,"PP",644
12,"12009",17859,13054,12911,98,143,"PP",2519
27,"27038",923,688,677,12,11,"PP",234
4,"4007",731,570,569,0,1,"PP",81
34,"34237",573,479,472,4,7,"PP",212
19,"19153",22,22,22,0,0,"PP",0
32,"32022",1238,924,916,5,8,"PP",311
43,"43100",3489,2820,2816,15,4,"PP",98
50,"50125",345,264,261,3,3,"PP",84
6,"6119",681,551,547,1,4,"PP",89
16,"16250",65,41,41,0,0,"PP",17
45,"45003",550,435,431,4,4,"PP",106
4,"4008",464,386,383,4,3,"PP",148
5,"5216",213,166,165,0,1,"PP",64
18,"18010",532,420,416,2,4,"PP",42
40,"40075",153,128,127,0,1,"PP",46
13,"13070",766,620,604,6,16,"PP",177
22,"22032",107,74,74,2,0,"PP",9
5,"5257",135,104,104,0,0,"PP",35
37,"37216",294,248,247,2,1,"PP",93
5,"5258",107,96,96,2,0,"PP",37
19,"19155",66,56,56,0,0,"PP",14
28,"28137",1744,1385,1366,8,19,"PP",215
41,"41036",3917,2944,2885,27,59,"PP",215
42,"42007",109,89,89,1,0,"PP",46
18,"18011",4376,3286,3248,18,38,"PP",503
5,"5021",1871,1469,1440,15,29,"PP",448
19,"19288",22,21,21,1,0,"PP",5
46,"46050",186,157,154,1,3,"PP",26
5,"5022",1571,1295,1282,5,13,"PP",550
42,"42134",2652,2028,1989,17,39,"PP",522
37,"37104",25,18,18,0,0,"PP",11
30,"30032",2851,2256,2218,14,38,"PP",712
43,"43003",350,266,264,3,2,"PP",7
32,"32053",1363,1114,1098,14,16,"PP",578
14,"14011",572,498,495,5,3,"PP",124
44,"44082",89,72,69,0,3,"PP",13
12,"12012",2613,2217,2180,6,37,"PP",549
7,"7023",3757,2777,2735,43,42,"PP",496
47,"47135",82,69,67,1,2,"PP",23
10,"10210",492,362,358,3,4,"PP",76
19,"19245",1145,904,880,8,24,"PP",248
24,"24043",122,71,69,0,2,"PP",18
37,"37106",249,173,173,1,0,"PP",72
47,"47229",231,174,168,0,6,"PP",50
20,"20063",8061,6042,5999,36,43,"PP",110
50,"50159",641,527,526,8,1,"PP",126
43,"43053",188,153,149,0,4,"PP",5
46,"46234",327,264,263,5,1,"PP",72
28,"28065",130679,106997,105975,762,1022,"PP",14360
2,"2049",796,582,574,1,8,"PP",113
50,"50040",86,71,71,0,0,"PP",22
13,"13075",199,157,157,0,0,"PP",52
16,"16258",172,128,128,2,0,"PP",41
6,"6023",4170,3088,3045,18,43,"PP",613
27,"27042",1648,1247,1233,21,14,"PP",699
45,"45147",590,506,496,2,10,"PP",110
49,"49252",304,244,241,6,3,"PP",76
47,"47041",153,119,116,2,3,"PP",37
19,"19293",1905,1513,1499,10,14,"PP",193
44,"44117",319,263,256,5,7,"PP",41
14,"14074",2237,1859,1839,8,20,"PP",369
47,"47011",557,478,476,5,2,"PP",197
12,"12107",351,312,306,1,6,"PP",89
18,"18117",507,402,396,5,6,"PP",91
27,"27043",1219,814,797,6,17,"PP",332
19,"19161",211,165,163,2,2,"PP",27
24,"24209",2609,1880,1857,13,23,"PP",526
26,"26119",177,150,147,2,3,"PP",30
42,"42142",45,35,35,0,0,"PP",15
34,"34005",792,659,645,5,14,"PP",208
9,"9177",1127,883,877,6,6,"PP",222
45,"45011",275,241,238,2,3,"PP",98
46,"46236",937,764,755,5,9,"PP",126
5,"5147",147,119,117,0,2,"PP",59
46,"46054",11390,8717,8604,52,113,"PP",1332
10,"10174",171,129,127,0,2,"PP",42
16,"16118",1350,1126,1093,6,33,"PP",403
28,"28067",4361,3548,3509,14,39,"PP",554
13,"13078",8936,6820,6733,46,87,"PP",1533
41,"41041",9760,7835,7646,44,189,"PP",1299
4,"4015",118,97,97,2,0,"PP",14
9,"9070",33,28,25,0,3,"PP",7
9,"9400",310,250,247,4,3,"PP",61
40,"40080",48,39,39,0,0,"PP",18
9,"9231",59,43,43,1,0,"PP",14
19,"19163",60,46,44,0,2,"PP",12
45,"45151",546,434,431,0,3,"PP",133
48,"48092",869,676,674,9,2,"PP",18
16,"16264",390,338,328,2,10,"PP",113
22,"22246",71,50,50,0,0,"PP",13
12,"12016",1550,1281,1260,11,21,"PP",363
47,"47044",323,282,279,1,3,"PP",67
44,"44182",198,172,171,2,1,"PP",48
37,"37338",78,66,64,0,2,"PP",28
49,"49220",139,110,104,2,6,"PP",27
16,"16265",20,20,19,0,1,"PP",9
19,"19298",55,47,47,0,0,"PP",8
50,"50219",4283,3274,3213,53,61,"PP",369
5,"5149",100,82,79,0,3,"PP",42
10,"10176",347,266,261,2,5,"PP",34
41,"41042",5849,4730,4692,20,38,"PP",491
42,"42190",92,74,73,1,1,"PP",14
24,"24090",326,213,213,2,0,"PP",66
49,"49097",74,43,43,0,0,"PP",15
7,"7029",4366,3270,3229,25,41,"PP",501
5,"5266",102,79,78,0,1,"PP",47
4,"4018",252,215,213,1,2,"PP",43
29,"29023",2290,1569,1550,3,19,"PP",356
27,"27047",1525,1026,1008,5,18,"PP",344
28,"28070",113,94,94,2,0,"PP",12
5,"5151",80,64,64,1,0,"PP",31
9,"9407",27,23,23,0,0,"PP",5
10,"10178",729,567,559,4,8,"PP",144
28,"28009",14500,11656,11564,62,92,"PP",2028
24,"24092",745,606,601,6,5,"PP",187
37,"37114",78,64,59,0,5,"PP",29
3,"3004",599,465,458,4,7,"PP",81
29,"29081",261,212,210,2,2,"PP",64
23,"23017",1480,1227,1202,6,25,"PP",264
3,"3097",996,833,816,4,17,"PP",153
22,"22122",65,58,58,3,0,"PP",9
41,"41044",7698,5967,5898,59,69,"PP",837
7,"7030",1590,1234,1202,8,32,"PP",229
40,"40084",53,40,39,0,1,"PP",10
19,"19213",70,53,52,0,1,"PP",17
12,"12052",539,453,439,5,14,"PP",117
44,"44184",38,28,26,0,2,"PP",7
18,"18051",1090,800,795,13,5,"PP",147
32,"32032",7932,5956,5831,55,125,"PP",1977
9,"9455",43,37,36,0,1,"PP",10
13,"13039",14212,10929,10761,107,168,"PP",2642
34,"34155",120,104,103,0,1,"PP",26
46,"46059",1240,1038,1030,3,8,"PP",132
12,"12020",120,107,107,0,0,"PP",47
24,"24094",1326,982,966,4,16,"PP",254
49,"49224",169,117,115,0,2,"PP",39
5,"5902",293,246,242,1,4,"PP",98
35,"35002",24129,16979,16736,116,243,"PP",2479
10,"10902",735,537,521,2,16,"PP",163
34,"34106",113,101,101,0,0,"PP",49
49,"49262",370,287,286,1,1,"PP",105
46,"46242",330,279,279,0,0,"PP",109
5,"5903",138,94,92,0,2,"PP",33
39,"39004",1483,1181,1163,4,18,"PP",265
19,"19171",5302,4297,4238,24,59,"PP",570
6,"6098",534,421,411,8,10,"PP",101
5,"5904",112,81,81,3,0,"PP",29
40,"40193",221,163,161,5,2,"PP",38
27,"27050",2842,2100,2072,19,28,"PP",1059
32,"32005",827,628,622,4,6,"PP",336
49,"49139",153,111,110,1,1,"PP",35
46,"46091",115,99,99,0,0,"PP",41
37,"37032",549,431,430,3,1,"PP",109
48,"48901",5151,4042,4012,22,30,"PP",194
49,"49225",127,81,81,0,0,"PP",38
12,"12022",328,273,269,1,4,"PP",75
39,"39005",1406,1127,1110,12,17,"PP",312
44,"44124",73,58,57,0,1,"PP",10
45,"45160",1095,913,905,2,8,"PP",247
23,"23087",11185,8500,8363,65,137,"PP",1552
49,"49102",183,136,135,2,1,"PP",46
5,"5156",234,153,151,0,2,"PP",53
16,"16087",226,191,184,3,7,"PP",84
26,"26129",936,770,759,1,11,"PP",250
39,"39006",1721,1332,1315,3,17,"PP",418
28,"28074",140580,113723,112489,776,1234,"PP",15229
26,"26016",28,24,23,0,1,"PP",11
50,"50225",1532,1072,1064,10,8,"PP",241
24,"24219",492,374,371,5,3,"PP",131
22,"22253",57,48,47,0,1,"PP",14
49,"49265",120,93,92,1,1,"PP",28
49,"49142",249,175,173,0,2,"PP",47
16,"16005",232,175,172,0,3,"PP",48
22,"22048",12593,9614,9528,82,86,"PP",1942
13,"13090",1023,814,796,5,18,"PP",208
46,"46256",7211,5263,5209,27,54,"PP",1088
36,"36061",8617,6498,6391,59,107,"PP",2636
45,"45025",1219,926,913,5,13,"PP",115
44,"44096",153,120,112,1,8,"PP",34
22,"22012",102,81,80,1,1,"PP",22
43,"43907",4359,3370,3346,22,24,"PP",178
2,"2063",1375,1067,1047,1,20,"PP",239
1,"1010",2315,1789,1770,14,19,"PP",110
37,"37347",464,368,359,2,9,"PP",81
19,"19308",60,57,57,1,0,"PP",13
40,"40196",32,28,28,1,0,"PP",16
50,"50080",34,29,29,0,0,"PP",5
16,"16007",1159,975,968,10,7,"PP",362
36,"36032",3537,2676,2626,16,50,"PP",1013
46,"46033",196,169,168,3,1,"PP",65
32,"32036",1261,954,938,9,16,"PP",504
20,"20014",1156,772,765,4,7,"PP",9
50,"50255",197,162,160,2,2,"PP",17
28,"28088",286,193,193,2,0,"PP",30
5,"5160",296,236,232,1,4,"PP",116
46,"46064",525,427,424,4,3,"PP",77
45,"45027",327,276,273,0,3,"PP",92
50,"50053",650,505,497,4,8,"PP",155
23,"23091",679,575,571,3,4,"PP",166
22,"22129",163,117,116,0,1,"PP",50
46,"46186",19529,15294,15125,69,169,"PP",2324
6,"6004",1549,1276,1257,6,19,"PP",263
47,"47149",45,39,39,1,0,"PP",11
43,"43137",1905,1515,1499,15,16,"PP",58
20,"20015",1237,975,967,8,8,"PP",0
10,"10188",478,387,379,0,8,"PP",92
50,"50054",56,48,47,0,1,"PP",7
42,"42064",85,71,71,0,0,"PP",17
45,"45075",124,93,90,0,3,"PP",21
18,"18133",2109,1632,1618,12,14,"PP",525
16,"16134",4383,3544,3491,34,53,"PP",688
13,"13095",72,60,60,1,0,"PP",16
27,"27056",1206,896,880,9,16,"PP",295
9,"9251",365,278,277,0,1,"PP",70
24,"24102",608,457,448,3,9,"PP",126
6,"6038",790,583,574,4,9,"PP",112
47,"47055",192,157,154,1,3,"PP",40
51,"51001",59934,38342,37884,322,458,"PP",8123
4,"4030",1066,783,776,5,7,"PP",191
39,"39010",610,518,512,1,6,"PP",111
48,"48012",2071,1685,1674,7,11,"PP",38
35,"35009",20109,15017,14803,78,214,"PP",2116
9,"9199",94,72,70,0,2,"PP",26
16,"16176",31,22,22,0,0,"PP",1
37,"37039",282,222,222,1,0,"PP",69
28,"28019",1269,990,981,4,9,"PP",151
1,"1032",500,372,362,1,10,"PP",59
44,"44101",51,43,42,1,1,"PP",9
46,"46006",4468,3731,3683,22,48,"PP",823
47,"47119",87,66,65,1,1,"PP",25
12,"12029",673,566,556,3,10,"PP",116
16,"16137",37,27,25,0,2,"PP",8
10,"10191",523,406,398,3,8,"PP",89
43,"43041",228,179,177,3,2,"PP",12
37,"37352",201,159,158,0,1,"PP",34
49,"49234",399,339,333,2,6,"PP",128
22,"22133",108,85,83,1,2,"PP",12
16,"16139",324,249,249,2,0,"PP",96
18,"18030",567,448,442,4,6,"PP",97
28,"28051",1640,1301,1292,9,9,"PP",244
50,"50174",83,58,58,0,0,"PP",27
10,"10192",767,625,614,1,11,"PP",214
43,"43042",2198,1820,1816,8,4,"PP",69
10,"10070",669,516,513,1,3,"PP",197
22,"22905",287,226,224,2,2,"PP",62
42,"42029",131,98,97,2,1,"PP",49
40,"40134",697,560,548,7,12,"PP",158
46,"46262",213,170,165,1,5,"PP",51
5,"5204",583,486,482,4,4,"PP",173
5,"5166",160,128,123,1,5,"PP",48
2,"2069",11414,9019,8883,54,136,"PP",2331
44,"44196",125,96,95,2,1,"PP",22
50,"50057",1332,1001,986,10,15,"PP",224
42,"42030",89,72,72,0,0,"PP",32
26,"26140",239,199,194,1,5,"PP",72
19,"19228",29,22,22,0,0,"PP",1
50,"50147",751,564,559,3,5,"PP",96
41,"41055",14804,10863,10720,79,143,"PP",1783
32,"32070",512,307,304,8,3,"PP",133
5,"5205",79,66,66,0,0,"PP",19
39,"39098",1379,1154,1144,7,10,"PP",352
47,"47155",3410,2694,2660,21,34,"PP",417
50,"50058",63,54,53,2,1,"PP",15
4,"4035",8433,6246,6196,33,50,"PP",1336
12,"12033",1951,1528,1506,10,22,"PP",358
12,"12065",171,150,147,0,3,"PP",54
15,"15077",8155,5554,5433,59,121,"PP",2380
37,"37130",178,150,150,2,0,"PP",78
6,"6010",1075,859,846,8,13,"PP",142
9,"9427",1364,1002,972,13,30,"PP",379
6,"6110",137,106,105,0,1,"PP",29
48,"48911",388,323,322,3,1,"PP",2
50,"50059",754,599,589,6,10,"PP",96
1,"1021",469,333,330,1,3,"PP",51
45,"45175",614,512,504,3,8,"PP",185
49,"49238",268,222,216,2,6,"PP",71
23,"23064",1678,1413,1404,10,9,"PP",404
47,"47156",150,128,128,2,0,"PP",45
19,"19324",160,128,123,1,5,"PP",36
50,"50148",290,229,227,2,2,"PP",64
6,"6111",493,374,370,2,4,"PP",63
12,"12067",523,423,416,1,7,"PP",128
3,"3018",12439,9387,9283,50,104,"PP",1883
19,"19092",395,317,309,1,8,"PP",91
3,"3079",18403,14632,14382,114,250,"PP",2684
20,"20902",14229,10567,10495,53,72,"PP",654
11,"11013",2332,1747,1713,16,34,"PP",206
5,"5052",87,77,77,0,0,"PP",37
45,"45176",3841,2992,2952,16,40,"PP",385
50,"50291",93,78,77,1,1,"PP",27
16,"16145",425,362,357,8,5,"PP",73
47,"47061",243,203,197,3,6,"PP",57
44,"44107",205,159,158,0,1,"PP",39
50,"50061",193,173,169,1,4,"PP",53
9,"9321",1597,1293,1280,4,13,"PP",361
40,"40207",800,662,652,6,10,"PP",105
45,"45040",1276,842,828,4,14,"PP",261
50,"50031",139,97,90,0,7,"PP",31
48,"48019",3461,2647,2633,12,14,"PP",104
46,"46164",12073,8987,8836,63,151,"PP",1466
43,"43046",90,73,73,1,0,"PP",0
34,"34037",276,224,223,2,1,"PP",91
10,"10118",281,242,242,2,0,"PP",56
29,"29098",1235,953,935,12,18,"PP",135
5,"5171",67,57,51,1,6,"PP",25
9,"9905",389,308,303,2,5,"PP",76
37,"37012",145,116,114,0,2,"PP",41
4,"4041",330,248,247,1,1,"PP",101
2,"2076",318,256,250,1,6,"PP",65
32,"32018",1179,950,936,3,14,"PP",276
50,"50237",102,81,81,3,0,"PP",25
10,"10119",574,458,455,0,3,"PP",101
19,"19098",18,18,17,0,1,"PP",2
39,"39046",1343,1002,988,8,14,"PP",163
34,"34130",198,165,161,2,4,"PP",49
42,"42173",29702,22141,21776,301,365,"PP",4806
9,"9381",33,25,25,0,0,"PP",17
45,"45182",987,815,800,7,15,"PP",192
48,"48021",1336,990,983,4,7,"PP",25
9,"9432",174,145,137,0,8,"PP",30
40,"40210",98,70,70,0,0,"PP",24
28,"28058",141251,112674,111423,778,1251,"PP",12224
40,"40106",183,153,151,2,2,"PP",58
50,"50063",61,54,54,0,0,"PP",16
19,"19192",1759,1367,1360,3,7,"PP",345
45,"45045",1331,1001,990,2,11,"PP",257
27,"27065",12076,8393,8183,128,210,"PP",3293
50,"50152",1368,1061,1043,6,18,"PP",324
9,"9010",32,27,27,1,0,"PP",8
19,"19330",67,60,60,0,0,"PP",13
45,"45183",2337,1743,1704,7,39,"PP",235
7,"7050",3442,2303,2275,28,28,"PP",943
9,"9109",1066,686,650,11,36,"PP",107
14,"14006",1321,1155,1127,4,28,"PP",392
5,"5174",65,53,52,1,1,"PP",28
6,"6116",1512,1158,1144,3,14,"PP",266
40,"40002",34,30,30,0,0,"PP",12
29,"29901",44578,31840,31537,286,303,"PP",6148
19,"19194",94,76,76,0,0,"PP",13
26,"26033",163,143,142,3,1,"PP",26
46,"46077",7344,5873,5761,49,112,"PP",767
4,"4046",848,653,649,5,4,"PP",151
46,"46168",1982,1543,1522,5,21,"PP",263
46,"46026",1202,1012,997,1,15,"PP",269
19,"19049",9,8,8,0,0,"PP",0
14,"14007",15042,10970,10758,86,212,"PP",1878
21,"21036",203,147,143,0,4,"PP",35
46,"46138",360,305,303,2,2,"PP",68
19,"19284",10,9,9,1,0,"PP",0
5,"5017",86,74,73,0,1,"PP",42
9,"9012",92,76,75,0,1,"PP",26
16,"16195",458,368,364,3,4,"PP",76
19,"19050",15,13,13,0,0,"PP",4
39,"39021",467,392,385,2,7,"PP",111
6,"6118",157,125,125,1,0,"PP",26
6,"6018",740,543,536,5,7,"PP",93
35,"35019",32841,21136,20850,125,286,"PP",3688
26,"26035",16,14,13,0,1,"PP",4
37,"37365",166,132,131,1,1,"PP",67
26,"26151",411,353,351,3,2,"PP",107
49,"49005",128,87,85,1,2,"PP",24
13,"13069",618,488,469,3,19,"PP",92
16,"16152",32,28,28,1,0,"PP",15
49,"49164",139,103,102,2,1,"PP",21
35,"35020",5933,4140,4088,14,52,"PP",537
5,"5177",139,117,117,0,0,"PP",26
37,"37290",134,113,112,0,1,"PP",34
34,"34089",140,119,114,2,5,"PP",45
9,"9440",80,66,66,0,0,"PP",18
32,"32079",1287,1016,1006,6,10,"PP",347
19,"19198",17,17,17,0,0,"PP",4
12,"12010",237,203,198,1,5,"PP",50
1,"1034",150,111,111,2,0,"PP",3
16,"16153",936,786,768,7,18,"PP",267
3,"3088",5810,4380,4313,31,67,"PP",804
7,"7053",1164,956,948,4,8,"PP",187
40,"40215",83,69,69,0,0,"PP",27
47,"47165",6822,5456,5296,62,160,"PP",1236
10,"10087",1606,1239,1223,5,16,"PP",302
6,"6021",908,708,698,9,10,"PP",257
37,"37142",566,446,444,6,2,"PP",91
47,"47069",118,96,92,1,4,"PP",32
9,"9442",370,305,301,5,4,"PP",98
3,"3089",9497,6952,6794,55,158,"PP",1291
40,"40006",22,18,18,0,0,"PP",8
4,"4009",151,126,124,3,2,"PP",53
49,"49207",217,151,148,4,3,"PP",60
16,"16253",308,250,249,2,1,"PP",109
45,"45144",740,605,598,7,7,"PP",180
44,"44017",272,221,219,0,2,"PP",45
28,"28033",4082,3172,3140,13,32,"PP",650
12,"12044",452,403,400,4,3,"PP",122
22,"22157",183,136,134,1,2,"PP",18
49,"49008",431,293,289,2,4,"PP",91
43,"43126",1211,1005,999,4,6,"PP",36
30,"30002",9735,7319,7227,33,92,"PP",1874
27,"27041",2238,1640,1615,10,25,"PP",711
9,"9394",662,495,490,10,5,"PP",113
3,"3122",43704,31952,31681,218,271,"PP",4276
40,"40112",2772,2255,2223,21,32,"PP",488
40,"40043",1791,1472,1447,9,25,"PP",526
23,"23075",3220,2559,2524,18,35,"PP",566
50,"50244",191,153,150,1,3,"PP",29
41,"41066",1310,1027,1010,1,17,"PP",102
1,"1039",195,157,153,0,4,"PP",19
24,"24005",345,255,250,2,5,"PP",123
40,"40008",45,37,37,0,0,"PP",16
37,"37370",308,256,254,2,2,"PP",103
10,"10008",1291,1015,997,16,18,"PP",295
49,"49168",93,74,74,0,0,"PP",29
34,"34004",5533,4345,4286,41,59,"PP",1224
48,"48029",8613,6697,6642,52,55,"PP",356
36,"36021",12099,9105,8974,85,131,"PP",2181
19,"19058",7375,6122,6061,34,61,"PP",914
15,"15058",28606,22203,22022,261,181,"PP",4582
49,"49048",114,85,85,0,0,"PP",39
19,"19111",162,142,142,0,0,"PP",44
18,"18082",827,587,577,5,10,"PP",121
12,"12135",36194,27266,26961,192,305,"PP",4613
37,"37371",258,176,175,0,1,"PP",59
4,"4054",352,280,278,2,2,"PP",88
5,"5066",439,373,367,2,6,"PP",67
42,"42049",109,73,72,1,1,"PP",41
43,"43054",2792,2145,2134,21,11,"PP",60
46,"46084",1503,1225,1195,1,30,"PP",291
40,"40079",226,179,175,1,4,"PP",55
4,"4013",143321,101501,100814,750,687,"PP",22011
3,"3124",460,401,390,2,11,"PP",82
42,"42187",59,51,49,1,2,"PP",13
23,"23012",4018,2835,2804,15,31,"PP",499
45,"45058",352,270,269,5,1,"PP",85
3,"3093",19713,15195,14988,108,207,"PP",2375
3,"3001",345,285,282,1,3,"PP",95
22,"22162",129,99,99,0,0,"PP",30
9,"9448",201,161,161,1,0,"PP",76
47,"47074",141,122,122,2,0,"PP",24
34,"34147",160,125,124,1,1,"PP",56
24,"24125",421,298,289,2,9,"PP",109
39,"39028",3870,3131,3094,19,37,"PP",783
28,"28112",154,137,137,1,0,"PP",22
29,"29021",159,121,120,0,1,"PP",32
45,"45197",1894,1525,1499,6,26,"PP",436
44,"44119",119,83,82,0,1,"PP",10
16,"16160",60,44,43,1,1,"PP",23
35,"35026",82764,55647,54846,499,801,"PP",8612
47,"47170",43,34,32,0,2,"PP",7
49,"49133",291,213,211,0,2,"PP",65
24,"24009",278,154,151,2,3,"PP",44
37,"37026",175,148,148,2,0,"PP",37
26,"26162",112,95,94,0,1,"PP",30
15,"15031",23779,17963,17787,213,176,"PP",2791
46,"46086",80,69,69,0,0,"PP",5
37,"37375",673,583,573,4,10,"PP",126
6,"6027",645,572,568,0,4,"PP",172
9,"9450",25,17,17,0,0,"PP",5
49,"49134",166,111,111,2,0,"PP",29
49,"49258",110,93,92,0,1,"PP",31
28,"28008",1961,1477,1456,6,21,"PP",269
24,"24051",394,290,283,3,7,"PP",113
22,"22042",117,96,95,1,1,"PP",25
18,"18154",975,701,699,3,2,"PP",233
50,"50073",2117,1735,1706,13,29,"PP",417
49,"49259",79,62,61,0,1,"PP",34
42,"42205",85,64,62,0,2,"PP",23
10,"10177",1695,1358,1323,9,35,"PP",229
16,"16212",230,198,196,2,2,"PP",57
19,"19166",152,125,122,0,3,"PP",39
45,"45153",1560,1243,1230,4,13,"PP",273
32,"32002",2022,1510,1485,8,25,"PP",468
16,"16082",271,207,206,3,1,"PP",46
41,"41015",5401,3984,3889,50,95,"PP",455
24,"24131",677,468,463,1,5,"PP",138
18,"18050",1670,1231,1213,9,18,"PP",199
46,"46179",2116,1723,1678,18,45,"PP",392
34,"34206",814,668,660,13,8,"PP",203
47,"47016",70,62,61,0,1,"PP",21
9,"9183",47,41,41,0,0,"PP",20
21,"21013",10570,7195,7089,73,106,"PP",1194
49,"49056",288,232,230,2,2,"PP",61
28,"28178",1134,949,935,1,14,"PP",143
45,"45202",3982,3094,3055,8,39,"PP",712
50,"50105",279,216,213,4,3,"PP",60
44,"44053",105,81,81,0,0,"PP",29
40,"40122",525,442,434,2,8,"PP",110
12,"12112",110,97,96,1,1,"PP",27
49,"49261",1505,1168,1149,8,19,"PP",279
11,"11033",21702,14645,14436,190,209,"PP",2215
3,"3005",7903,6247,6195,37,52,"PP",1599
16,"16215",237,157,153,1,4,"PP",22
9,"9132",171,136,130,1,6,"PP",57
10,"10058",993,739,723,4,16,"PP",130
9,"9297",313,268,267,6,1,"PP",87
10,"10100",783,584,566,7,18,"PP",89
12,"12141",92,81,81,0,0,"PP",25
19,"19214",72,56,55,0,1,"PP",15
23,"23052",1108,949,931,8,18,"PP",222
24,"24015",2209,1714,1672,19,42,"PP",527
9,"9353",76,64,63,2,1,"PP",11
12,"12053",2030,1656,1636,10,20,"PP",447
34,"34017",889,743,738,6,5,"PP",288
45,"45067",2289,1860,1820,17,40,"PP",645
4,"4098",1455,1097,1087,9,10,"PP",194
19,"19073",16,13,13,0,0,"PP",2
28,"28084",16103,12519,12378,82,141,"PP",1508
45,"45205",7342,5347,5275,30,72,"PP",696
37,"37268",108,72,70,0,2,"PP",24
18,"18901",488,335,329,2,6,"PP",74
28,"28043",6166,4404,4320,30,84,"PP",773
41,"41018",9410,6987,6882,52,105,"PP",570
4,"4099",4931,3781,3719,24,62,"PP",926
1,"1053",592,376,373,2,3,"PP",19
10,"10904",722,549,543,7,6,"PP",100
15,"15036",56248,40194,39764,508,430,"PP",9057
48,"48037",684,537,531,4,6,"PP",8
9,"9411",154,118,118,0,0,"PP",28
19,"19074",65,60,60,0,0,"PP",8
49,"49264",540,372,369,1,3,"PP",164
50,"50138",47,42,42,1,0,"PP",13
30,"30043",25401,20378,19992,131,386,"PP",4957
20,"20072",4752,3445,3412,24,33,"PP",142
43,"43159",81,63,62,0,1,"PP",0
46,"46183",6028,4620,4534,29,86,"PP",992
19,"19075",61,44,43,0,1,"PP",21
9,"9463",250,203,201,6,2,"PP",47
40,"40019",29,26,26,0,0,"PP",12
46,"46092",263,182,179,1,3,"PP",67
37,"37034",75,66,66,0,0,"PP",18
2,"2061",618,504,500,7,4,"PP",191
48,"48008",615,454,448,4,6,"PP",11
37,"37270",183,143,140,1,3,"PP",52
49,"49104",335,245,240,1,5,"PP",112
3,"3039",89,70,70,0,0,"PP",17
43,"43160",1322,1051,1045,0,6,"PP",40
11,"11001",4342,2928,2870,32,58,"PP",339
26,"26053",195,161,160,3,1,"PP",43
26,"26054",292,235,231,2,4,"PP",93
34,"34022",1019,856,849,8,7,"PP",286
16,"16046",223,162,161,1,1,"PP",65
20,"20013",5430,4144,4119,19,25,"PP",106
44,"44220",113,92,89,0,3,"PP",32
11,"11038",13613,10879,10676,101,203,"PP",2218
37,"37035",165,134,134,0,0,"PP",49
24,"24141",101,78,78,0,0,"PP",17
11,"11039",9945,6824,6726,111,98,"PP",1879
34,"34160",134,114,112,0,2,"PP",17
39,"39092",871,635,629,2,6,"PP",201
44,"44158",1166,921,904,7,17,"PP",193
32,"32008",8572,6301,6216,65,85,"PP",1498
50,"50283",69,53,52,3,1,"PP",17
37,"37271",351,286,280,0,6,"PP",90
46,"46185",364,315,310,1,5,"PP",22
48,"48904",3542,2832,2811,27,21,"PP",161
26,"26055",39,35,35,1,0,"PP",18
28,"28089",3842,3087,3048,12,39,"PP",517
6,"6136",1510,1189,1160,7,29,"PP",221
50,"50171",96,78,78,1,0,"PP",27
28,"28902",523,418,415,2,3,"PP",100
41,"41022",4269,3158,3110,16,48,"PP",242
5,"5197",100,84,83,0,1,"PP",37
46,"46004",1919,1641,1616,14,25,"PP",214
5,"5237",155,131,129,1,2,"PP",64
47,"47180",57,46,46,1,0,"PP",12
15,"15009",10615,8066,7919,93,147,"PP",2007
15,"15041",9581,7223,7082,96,141,"PP",2473
32,"32066",551,399,396,1,3,"PP",298
44,"44160",440,311,306,2,5,"PP",99
24,"24062",130,90,90,2,0,"PP",25
41,"41079",9293,7137,6979,80,158,"PP",556
46,"46096",257,220,217,0,3,"PP",21
24,"24144",639,469,462,2,7,"PP",132
3,"3137",657,484,480,5,4,"PP",105
14,"14026",2014,1502,1474,10,28,"PP",297
16,"16175",5079,4279,4207,40,72,"PP",1038
19,"19033",48,42,41,0,1,"PP",12
28,"28090",9128,7590,7516,54,74,"PP",1314
11,"11005",4520,3212,3128,23,84,"PP",494
9,"9310",15,14,13,1,1,"PP",1
47,"47086",3823,3090,3046,24,44,"PP",777
19,"19082",99,76,75,0,1,"PP",3
40,"40902",117,96,96,1,0,"PP",52
5,"5084",69,46,46,0,0,"PP",16
2,"2066",223,172,169,1,3,"PP",53
44,"44161",430,320,316,1,4,"PP",110
42,"42065",23,18,18,2,0,"PP",9
29,"29012",9718,7243,7123,47,120,"PP",1280
34,"34182",753,609,604,6,5,"PP",253
41,"41090",3507,2766,2694,15,72,"PP",414
43,"43090",1169,749,742,2,7,"PP",38
46,"46128",1581,1324,1287,2,37,"PP",307
34,"34029",659,557,551,5,6,"PP",266
43,"43139",1999,1552,1539,10,13,"PP",33
11,"11007",18020,11346,11152,176,194,"PP",1687
22,"22181",88,60,59,1,1,"PP",13
44,"44225",103,82,81,0,1,"PP",15
46,"46261",1709,1367,1340,14,27,"PP",302
41,"41081",29840,22819,22465,228,354,"PP",1655
48,"48044",62054,49055,48840,373,215,"PP",7464
9,"9312",89,75,74,2,1,"PP",30
19,"19037",132,114,112,0,2,"PP",37
40,"40060",68,46,46,0,0,"PP",33
24,"24184",183,121,119,0,2,"PP",33
14,"14069",7376,5511,5398,47,113,"PP",1153
42,"42028",76,65,65,1,0,"PP",17
48,"48014",1242,915,910,4,5,"PP",42
37,"37277",77,56,56,0,0,"PP",26
41,"41099",3968,2666,2642,23,24,"PP",242
5,"5126",62,53,52,0,1,"PP",27
18,"18100",7981,5900,5769,44,131,"PP",826
49,"49030",80,66,62,0,4,"PP",39
34,"34032",37,34,34,1,0,"PP",8
32,"32014",1045,775,769,5,6,"PP",401
29,"29093",2164,1704,1678,4,26,"PP",333
22,"22182",233,178,174,1,4,"PP",26
20,"20019",9912,7226,7195,51,31,"PP",247
5,"5002",1890,1497,1468,8,29,"PP",355
37,"37166",199,146,144,0,2,"PP",61
39,"39069",1928,1650,1627,9,23,"PP",189
22,"22094",98,72,71,2,1,"PP",15
9,"9483",189,153,150,1,3,"PP",46
6,"6042",981,714,705,4,9,"PP",170
9,"9485",56,50,50,2,0,"PP",25
7,"7043",3430,2465,2438,24,27,"PP",553
16,"16055",679,478,477,4,1,"PP",117
23,"23031",765,659,647,4,12,"PP",60
20,"20021",186,112,112,0,0,"PP",0
43,"43019",1336,1020,1008,4,12,"PP",50
19,"19185",27,19,19,0,0,"PP",6
47,"47029",50,43,43,1,0,"PP",19
42,"42120",132,89,87,0,2,"PP",29
9,"9048",1380,1070,1039,8,31,"PP",271
34,"34034",115,96,95,3,1,"PP",27
14,"14031",566,453,446,2,7,"PP",95
36,"36007",1618,1163,1133,7,30,"PP",463
34,"34227",72,63,61,4,2,"PP",25
49,"49154",109,64,63,0,1,"PP",8
16,"16100",640,570,565,1,5,"PP",192
44,"44198",181,151,145,1,6,"PP",40
40,"40136",106,82,81,0,1,"PP",24
49,"49033",666,515,508,1,7,"PP",190
48,"48047",149,115,115,1,0,"PP",0
50,"50263",176,119,116,0,3,"PP",15
18,"18001",230,173,170,1,3,"PP",21
44,"44067",108,82,78,0,4,"PP",19
22,"22227",199,155,154,1,1,"PP",26
43,"43167",384,334,333,2,1,"PP",14
47,"47092",102,86,85,0,1,"PP",34
50,"50030",201,138,136,1,2,"PP",36
49,"49155",80,66,65,1,1,"PP",28
36,"36008",21884,16428,16170,165,258,"PP",3203
45,"45085",1511,1141,1128,9,13,"PP",247
43,"43021",345,270,269,3,1,"PP",6
44,"44038",98,83,80,0,3,"PP",19
42,"42078",1005,769,756,6,13,"PP",266
49,"49034",417,320,317,0,3,"PP",124
12,"12068",41,26,25,1,1,"PP",10
37,"37091",164,108,108,3,0,"PP",49
39,"39073",10200,8230,8150,65,80,"PP",1653
11,"11014",17141,11836,11705,214,131,"PP",1659
23,"23101",352,273,271,0,2,"PP",52
44,"44199",39,39,38,5,1,"PP",8
46,"46205",14233,11274,11145,55,129,"PP",1963
11,"11027",68637,48919,48441,519,478,"PP",8112
16,"16909",661,540,535,1,5,"PP",107
23,"23001",920,769,766,3,3,"PP",146
10,"10199",159,123,123,1,0,"PP",25
19,"19233",82,72,72,1,0,"PP",10
12,"12126",24347,19023,18749,152,274,"PP",3810
9,"9325",177,117,117,2,0,"PP",51
47,"47094",123,110,109,1,1,"PP",33
11,"11015",64073,43152,42713,710,439,"PP",6119
38,"38043",19265,14000,13856,115,144,"PP",1847
5,"5013",847,708,701,0,7,"PP",211
39,"39074",7041,5612,5551,31,61,"PP",1501
13,"13062",559,478,471,1,7,"PP",133
44,"44071",585,449,447,6,2,"PP",112
36,"36010",2828,2217,2184,15,33,"PP",500
18,"18177",373,253,252,1,1,"PP",80
50,"50005",239,204,201,2,3,"PP",74
12,"12038",156,110,109,1,1,"PP",46
10,"10201",179,157,156,1,1,"PP",31
40,"40141",833,644,627,5,17,"PP",200
26,"26068",79,62,62,1,0,"PP",11
2,"2004",606,504,499,5,5,"PP",141
14,"14035",5817,4373,4314,44,59,"PP",1271
16,"16106",2708,2200,2163,17,37,"PP",668
46,"46227",888,708,693,6,15,"PP",76
21,"21071",211,155,152,3,3,"PP",22
34,"34180",64,55,55,2,0,"PP",23
49,"49038",94,68,68,1,0,"PP",21
4,"4081",346,272,271,2,1,"PP",34
9,"9009",158,139,137,4,2,"PP",31
32,"32076",1974,1492,1472,17,20,"PP",786
26,"26069",230,187,186,0,1,"PP",83
48,"48052",1567,1309,1300,4,9,"PP",21
27,"27004",1149,741,722,2,19,"PP",336
24,"24037",337,234,234,1,0,"PP",83
18,"18072",664,481,473,0,8,"PP",67
19,"19282",143,114,114,1,0,"PP",58
28,"28134",63352,51185,50776,336,409,"PP",7992
9,"9218",347,277,271,0,6,"PP",80
46,"46107",1849,1501,1480,5,21,"PP",344
37,"37287",309,215,214,3,1,"PP",73
44,"44142",28,21,21,0,0,"PP",5
34,"34042",292,244,243,3,1,"PP",90
43,"43155",22619,16724,16624,101,100,"PP",740
13,"13081",590,449,440,0,9,"PP",121
47,"47015",176,136,135,0,1,"PP",52
28,"28029",562,459,456,2,3,"PP",97
37,"37327",179,154,150,0,4,"PP",33
50,"50065",55,43,43,1,0,"PP",8
9,"9350",430,340,339,9,1,"PP",130
16,"16108",43,40,39,1,1,"PP",4
47,"47131",165,127,127,3,0,"PP",34
43,"43172",337,261,257,2,4,"PP",5
45,"45094",367,290,288,4,2,"PP",72
37,"37289",218,159,158,0,1,"PP",66
12,"12073",132,110,107,1,3,"PP",42
10,"10002",359,284,279,2,5,"PP",54
49,"49163",215,151,148,1,3,"PP",55
9,"9168",272,222,216,3,6,"PP",46
24,"24038",3048,2360,2315,23,45,"PP",536
49,"49086",111,94,93,1,1,"PP",32
20,"20039",2144,1704,1692,11,12,"PP",10
42,"42042",49,42,42,1,0,"PP",13
3,"3118",2426,1741,1718,8,23,"PP",439
47,"47193",1609,1347,1332,9,15,"PP",269
46,"46048",3509,2758,2720,11,38,"PP",462
26,"26112",223,177,174,0,3,"PP",64
44,"44236",59,44,44,0,0,"PP",23
20,"20060",88,75,75,0,0,"PP",0
50,"50094",1518,1172,1155,20,17,"PP",264
34,"34238",305,261,260,2,1,"PP",95
18,"18112",110,80,76,0,4,"PP",16
2,"2009",19456,15229,15007,152,222,"PP",3466
10,"10207",464,349,340,3,9,"PP",99
22,"22236",236,207,203,2,4,"PP",53
37,"37018",110,86,85,1,1,"PP",26
9,"9409",110,87,87,0,0,"PP",16
28,"28042",1266,1020,1010,2,10,"PP",228
9,"9016",84,55,54,0,1,"PP",19
18,"18077",471,372,366,5,6,"PP",56
49,"49166",1192,916,899,10,17,"PP",224
16,"16068",127,104,104,4,0,"PP",35
24,"24041",527,371,364,4,7,"PP",99
10,"10005",530,407,384,3,23,"PP",95
40,"40146",238,205,202,0,3,"PP",62
16,"16070",28,26,26,1,0,"PP",8
37,"37292",94,76,73,1,3,"PP",31
5,"5218",105,82,81,0,1,"PP",37
10,"10209",265,184,184,2,0,"PP",37
34,"34091",122,103,102,4,1,"PP",44
16,"16254",203,168,166,1,2,"PP",56
28,"28108",3642,2878,2841,16,37,"PP",426
28,"28002",3281,2481,2455,24,26,"PP",429
26,"26115",23,21,19,0,2,"PP",12
38,"38050",2436,1564,1529,12,35,"PP",240
37,"37060",280,224,224,0,0,"PP",46
11,"11024",6583,4774,4682,40,92,"PP",780
18,"18012",2143,1651,1634,8,17,"PP",471
10,"10047",937,772,760,3,12,"PP",106
50,"50096",36,22,22,0,0,"PP",2
19,"19157",56,40,37,0,3,"PP",11
42,"42088",60,53,53,0,0,"PP",24
34,"34093",81,70,70,0,0,"PP",41
9,"9226",56,47,47,0,0,"PP",16
21,"21079",687,503,500,5,3,"PP",75
37,"37181",264,185,184,1,1,"PP",69
21,"21043",1857,1465,1424,7,41,"PP",143
28,"28034",370,284,280,0,4,"PP",75
6,"6056",454,378,376,1,2,"PP",91
16,"16203",10167,7720,7591,49,129,"PP",1534
50,"50130",362,252,249,1,3,"PP",39
41,"41039",31500,23692,23345,234,347,"PP",3945
46,"46052",508,436,426,3,10,"PP",88
13,"13030",120,97,96,0,1,"PP",18
23,"23077",611,483,479,0,4,"PP",96
26,"26005",2480,1687,1661,5,26,"PP",498
22,"22243",39,28,28,0,0,"PP",7
42,"42010",21,18,16,0,2,"PP",8
7,"7024",7294,4213,4160,44,53,"PP",701
7,"7002",6612,4721,4672,43,49,"PP",1117
24,"24222",14431,11296,11135,117,161,"PP",1751
47,"47148",423,342,339,2,3,"PP",107
34,"34196",88,74,74,4,0,"PP",29
27,"27011",2358,1582,1558,12,24,"PP",491
47,"47103",255,215,214,3,1,"PP",55
26,"26006",1825,1496,1470,8,26,"PP",455
47,"47199",71,59,59,3,0,"PP",19
7,"7058",2857,2258,2233,18,25,"PP",471
16,"16158",511,428,417,4,11,"PP",126
28,"28143",77,62,62,0,0,"PP",16
9,"9345",117,96,95,1,1,"PP",27
11,"11028",32791,24276,24028,279,248,"PP",1679
37,"37063",60,45,45,1,0,"PP",16
38,"38023",125528,88323,87456,598,867,"PP",10487
24,"24047",720,531,523,2,8,"PP",168
10,"10133",1154,971,955,3,16,"PP",91
6,"6158",13362,10282,10112,73,170,"PP",1859
34,"34201",171,139,139,0,0,"PP",71
20,"20035",484,384,384,2,0,"PP",5
43,"43153",11092,8327,8291,34,36,"PP",410
49,"49052",179,125,123,1,2,"PP",42
19,"19296",27,24,24,0,0,"PP",9
44,"44049",796,592,578,9,14,"PP",163
34,"34055",263,214,213,3,1,"PP",67
20,"20036",13192,9864,9806,67,58,"PP",454
40,"40046",82,69,69,1,0,"PP",17
28,"28145",2640,2014,1987,11,27,"PP",278
30,"30007",6484,4774,4727,25,47,"PP",1165
47,"47140",110,91,90,0,1,"PP",48
16,"16079",26,17,17,0,0,"PP",1
44,"44050",3115,2333,2299,27,34,"PP",544
21,"21047",1869,1242,1206,8,36,"PP",251
26,"26082",100,85,85,0,0,"PP",31
37,"37300",547,392,391,5,1,"PP",98
34,"34056",1949,1537,1511,7,26,"PP",519
48,"48062",293,247,245,0,2,"PP",0
28,"28113",36716,29939,29607,224,332,"PP",3744
46,"46025",2455,2002,1981,6,21,"PP",346
9,"9180",133,104,99,1,5,"PP",32
22,"22078",438,326,323,3,3,"PP",45
22,"22247",30,21,21,0,0,"PP",1
22,"22207",121,78,78,1,0,"PP",12
19,"19117",1611,1279,1257,7,22,"PP",147
48,"48063",356,277,274,2,3,"PP",2
34,"34167",110,88,88,0,0,"PP",34
16,"16107",98,76,75,1,1,"PP",26
34,"34234",68,59,57,0,2,"PP",23
34,"34903",183,128,128,1,0,"PP",46
50,"50104",326,264,259,4,5,"PP",78
32,"32058",5225,3915,3857,35,58,"PP",1367
9,"9091",701,545,533,5,12,"PP",205
50,"50134",118,91,89,0,2,"PP",34
40,"40190",48,40,39,0,1,"PP",13
18,"18192",1466,1171,1156,1,15,"PP",192
22,"22208",194,159,156,1,3,"PP",23
10,"10029",380,320,315,1,5,"PP",45
14,"14018",3611,2802,2741,25,61,"PP",548
47,"47215",48,44,44,0,0,"PP",25
6,"6062",576,435,430,0,5,"PP",117
22,"22006",272,206,201,2,5,"PP",31
10,"10219",1212,814,806,8,8,"PP",174
29,"29058",1538,1079,1062,5,17,"PP",141
7,"7041",2097,1662,1634,20,28,"PP",364
37,"37115",110,81,81,2,0,"PP",37
42,"42151",38,31,30,0,1,"PP",10
24,"24215",152,125,124,1,1,"PP",59
44,"44122",1284,995,984,15,11,"PP",261
19,"19018",141,112,110,0,2,"PP",36
9,"9131",480,412,402,2,10,"PP",68
3,"3036",86,77,75,2,2,"PP",16
39,"39031",1245,990,983,5,7,"PP",244
46,"46150",1797,1275,1257,9,18,"PP",331
45,"45203",2713,2092,2053,16,39,"PP",335
10,"10180",4168,2735,2680,18,55,"PP",512
28,"28149",6172,5089,5038,31,51,"PP",689
37,"37190",193,144,144,1,0,"PP",77
18,"18194",2045,1394,1370,11,24,"PP",163
19,"19038",22,19,19,0,0,"PP",8
28,"28011",420,315,311,1,4,"PP",60
32,"32060",765,577,567,2,10,"PP",148
41,"41046",3006,2464,2427,13,37,"PP",186
43,"43035",235,205,203,7,2,"PP",6
20,"20071",15036,11090,11025,59,65,"PP",292
28,"28073",12751,9940,9838,63,102,"PP",1244
40,"40158",15,13,13,1,0,"PP",7
5,"5231",151,126,126,0,0,"PP",49
49,"49059",88,72,71,0,1,"PP",26
47,"47112",2570,2098,2075,13,23,"PP",693
28,"28117",98,89,87,2,2,"PP",27
34,"34061",96,77,77,2,0,"PP",26
41,"41074",2998,2364,2322,17,42,"PP",342
45,"45068",171,142,142,0,0,"PP",17
28,"28013",41563,32024,31693,194,331,"PP",5288
5,"5077",158,133,131,1,2,"PP",60
22,"22172",520,412,407,3,5,"PP",103
19,"19021",976,744,724,5,20,"PP",150
28,"28129",8578,6925,6853,45,72,"PP",1197
10,"10183",958,748,735,3,13,"PP",212
19,"19172",50,35,35,1,0,"PP",11
16,"16169",51,36,32,0,4,"PP",6
50,"50205",74,58,57,0,1,"PP",8
26,"26015",180,145,142,1,3,"PP",66
32,"32062",766,582,579,1,3,"PP",325
30,"30013",7467,5621,5553,26,68,"PP",973
43,"43012",3647,3028,3019,15,9,"PP",120
26,"26091",147,132,131,1,1,"PP",80
10,"10021",5045,3932,3840,32,92,"PP",518
16,"16219",81,64,63,0,1,"PP",7
50,"50021",25,23,23,1,0,"PP",11
42,"42197",68,56,56,0,0,"PP",32
24,"24018",174,141,139,0,2,"PP",66
35,"35004",41728,23957,23683,219,274,"PP",3156
45,"45070",1406,1201,1188,4,13,"PP",309
41,"41048",2198,1561,1512,22,49,"PP",235
24,"24221",750,563,553,6,10,"PP",161
29,"29030",774,660,657,3,3,"PP",17
12,"12088",57,54,54,0,0,"PP",23
19,"19261",32,24,24,0,0,"PP",13
46,"46124",785,680,675,5,5,"PP",141
24,"24178",72,65,65,1,0,"PP",17
32,"32073",1281,941,932,9,9,"PP",361
26,"26144",188,161,160,1,1,"PP",84
9,"9340",76,56,56,1,0,"PP",25
41,"41094",6447,4998,4912,43,86,"PP",737
16,"16089",377,308,308,1,0,"PP",76
10,"10063",161,141,141,1,0,"PP",52
45,"45117",715,571,556,1,15,"PP",117
15,"15007",3179,2333,2304,22,29,"PP",933
9,"9415",275,206,204,0,2,"PP",73
42,"42158",94,78,78,0,0,"PP",24
34,"34230",17,13,13,0,0,"PP",8
2,"2040",563,516,513,3,3,"PP",153
34,"34161",22,17,16,0,1,"PP",5
16,"16147",56,32,32,0,0,"PP",6
10,"10024",675,518,505,4,13,"PP",163
7,"7004",4033,2898,2860,28,38,"PP",485
9,"9038",111,95,95,0,0,"PP",18
49,"49065",1073,789,777,3,12,"PP",344
4,"4901",494,381,378,0,3,"PP",76
16,"16047",214,175,174,4,1,"PP",57
3,"3136",410,329,323,3,6,"PP",86
19,"19129",27,25,25,0,0,"PP",12
5,"5161",550,444,434,2,10,"PP",149
50,"50111",183,144,142,2,2,"PP",23
44,"44222",122,102,102,1,0,"PP",36
37,"37237",304,238,234,0,4,"PP",49
18,"18027",2604,1902,1887,6,15,"PP",168
45,"45165",62598,47784,47120,345,664,"PP",9832
12,"12027",17473,12829,12683,90,146,"PP",2260
22,"22087",58,47,47,0,0,"PP",16
9,"9198",100,80,79,0,1,"PP",19
9,"9041",26,26,26,1,0,"PP",10
22,"22015",300,232,226,5,6,"PP",59
6,"6071",238,197,193,0,4,"PP",42
37,"37198",203,163,162,3,1,"PP",50
29,"29089",3161,2477,2426,19,51,"PP",199
28,"28156",1084,885,880,6,5,"PP",146
41,"41024",22737,15687,15398,167,289,"PP",2337
34,"34071",161,138,138,0,0,"PP",66
50,"50114",132,111,111,1,0,"PP",17
40,"40165",74,56,54,1,2,"PP",14
29,"29034",467,374,373,1,1,"PP",121
46,"46036",558,391,379,2,12,"PP",99
32,"32011",918,526,521,6,5,"PP",393
41,"41080",1240,940,913,11,27,"PP",156
16,"16024",123,96,95,0,1,"PP",25
6,"6094",1459,1017,1008,8,9,"PP",185
34,"34011",386,326,321,2,5,"PP",111
7,"7018",379,287,286,1,1,"PP",32
5,"5136",84,64,64,2,0,"PP",20
22,"22150",461,368,362,1,6,"PP",67
40,"40108",110,91,90,0,1,"PP",32
49,"49068",435,287,286,1,1,"PP",139
38,"38036",6831,4947,4829,58,118,"PP",520
12,"12092",126,108,106,1,2,"PP",43
13,"13052",6313,4844,4762,38,82,"PP",1479
34,"34087",122,105,105,0,0,"PP",44
32,"32040",1418,1083,1075,3,8,"PP",555
45,"45002",2608,1840,1821,7,19,"PP",322
42,"42116",42,30,30,1,0,"PP",8
37,"37201",237,188,187,1,1,"PP",51
5,"5201",499,414,407,2,7,"PP",155
14,"14058",7859,5854,5745,51,109,"PP",1111
50,"50241",595,434,423,3,11,"PP",131
5,"5139",66,59,59,0,0,"PP",37
12,"12031",3942,2976,2931,24,45,"PP",433
50,"50231",257,210,207,3,3,"PP",49
45,"45140",1089,887,870,5,17,"PP",208
5,"5047",4118,3334,3248,25,86,"PP",819
9,"9257",86,74,71,0,3,"PP",21
18,"18065",591,482,468,4,14,"PP",30
30,"30020",6431,4991,4940,19,51,"PP",1483
22,"22223",74,63,63,1,0,"PP",3
10,"10153",283,204,199,0,5,"PP",85
44,"44261",722,584,578,8,6,"PP",147
16,"16238",464,387,383,2,4,"PP",115
34,"34224",42,30,29,0,1,"PP",15
20,"20080",7709,5629,5588,28,41,"PP",236
9,"9223",43,39,39,1,0,"PP",13
18,"18171",2111,1679,1638,8,41,"PP",178
22,"22906",174,137,134,5,3,"PP",31
10,"10194",524,440,435,4,5,"PP",89
40,"40099",52,46,44,0,2,"PP",21
40,"40203",958,801,788,6,13,"PP",136
19,"19090",90,73,72,1,1,"PP",21
3,"3047",9711,6910,6791,36,119,"PP",1495
5,"5049",410,310,305,3,5,"PP",57
34,"34225",5001,4070,4021,48,49,"PP",659
18,"18137",1002,776,773,0,3,"PP",262
28,"28094",959,736,729,6,7,"PP",110
47,"47218",979,757,745,5,12,"PP",141
43,"43118",425,357,356,0,1,"PP",7
2,"2071",1058,912,906,2,6,"PP",262
16,"16099",184,126,121,0,5,"PP",38
50,"50029",604,475,467,7,8,"PP",84
16,"16015",351,251,250,4,1,"PP",94
10,"10075",236,186,182,1,4,"PP",44
49,"49127",2430,1835,1799,30,36,"PP",412
48,"48017",13150,9546,9504,38,42,"PP",130
38,"38040",5446,3513,3462,13,51,"PP",1046
6,"6077",321,260,256,4,4,"PP",34
40,"40007",68,58,58,0,0,"PP",26
12,"12096",744,588,580,7,8,"PP",107
43,"43094",2120,1659,1646,9,13,"PP",61
16,"16016",216,175,174,3,1,"PP",38
37,"37169",176,138,137,1,1,"PP",29
5,"5207",645,543,540,3,3,"PP",161
44,"44037",449,334,331,1,3,"PP",116
18,"18103",722,556,555,3,1,"PP",125
5,"5182",731,494,490,6,4,"PP",182
9,"9120",38,32,31,2,1,"PP",10
40,"40184",248,205,203,0,2,"PP",93
44,"44147",398,293,286,3,7,"PP",67
22,"22228",529,421,417,3,4,"PP",60
44,"44068",643,518,511,9,7,"PP",162
14,"14063",1000,767,757,4,10,"PP",202
34,"34229",58,42,40,1,2,"PP",27
19,"19325",144,87,87,1,0,"PP",48
19,"19043",99,87,84,2,3,"PP",23
49,"49194",340,236,233,3,3,"PP",65
9,"9122",88,64,64,0,0,"PP",28
28,"28153",795,566,564,5,2,"PP",68
21,"21056",2922,2307,2228,27,79,"PP",334
22,"22244",46,37,37,2,0,"PP",10
41,"41058",17860,12850,12598,152,252,"PP",2296
6,"6013",265,227,221,0,6,"PP",17
41,"41040",11111,8768,8679,76,89,"PP",1662
30,"30005",30193,22648,22419,136,229,"PP",5702
37,"37171",397,297,292,1,5,"PP",134
45,"45133",2808,2233,2187,14,46,"PP",439
49,"49210",448,372,370,3,2,"PP",95
44,"44180",72,61,61,0,0,"PP",24
9,"9267",113,102,101,2,1,"PP",50
50,"50014",119,85,85,0,0,"PP",13
45,"45042",183,141,137,0,4,"PP",48
26,"26030",17,17,17,0,0,"PP",9
22,"22061",6583,5027,4973,51,54,"PP",1030
19,"19280",3611,2805,2767,25,38,"PP",319
6,"6080",1890,1482,1467,18,15,"PP",287
10,"10160",237,189,183,3,6,"PP",36
18,"18004",687,521,515,4,6,"PP",150
10,"10079",858,694,684,1,10,"PP",218
48,"48915",347,259,259,4,0,"PP",4
46,"46075",147,136,134,2,2,"PP",23
46,"46136",2619,2030,2003,24,27,"PP",354
9,"9217",349,268,266,5,2,"PP",73
4,"4003",17540,12174,12051,75,123,"PP",3109
16,"16022",78,70,70,0,0,"PP",16
42,"42174",179,132,128,1,4,"PP",15
16,"16246",452,348,340,1,8,"PP",143
46,"46228",2417,1953,1913,13,40,"PP",355
28,"28133",6116,4581,4486,22,95,"PP",966
5,"5096",79,62,62,1,0,"PP",15
32,"32019",11512,8281,8161,96,120,"PP",3024
32,"32048",864,550,544,1,6,"PP",163
49,"49083",50,41,41,1,0,"PP",29
24,"24076",1286,998,981,8,17,"PP",184
27,"27035",180,127,123,0,4,"PP",26
9,"9386",55,49,49,0,0,"PP",25
23,"23004",421,356,355,2,1,"PP",45
49,"49201",285,243,243,7,0,"PP",57
40,"40178",90,63,63,1,0,"PP",32
44,"44173",102,85,80,0,5,"PP",24
34,"34151",147,99,97,1,2,"PP",45
20,"20006",254,169,169,0,0,"PP",1
24,"24213",170,140,139,0,1,"PP",52
50,"50025",4516,3417,3364,35,53,"PP",724
45,"45047",2668,1922,1882,11,40,"PP",390
26,"26083",354,295,291,1,4,"PP",136
47,"47065",817,658,653,2,5,"PP",231
28,"28114",143,104,104,0,0,"PP",34
30,"30039",20191,14552,14380,96,172,"PP",3216
26,"26047",1879,1569,1549,10,20,"PP",533
10,"10042",88,59,59,0,0,"PP",15
16,"16065",372,306,305,2,1,"PP",95
5,"5152",655,537,534,3,3,"PP",226
19,"19001",41,33,33,0,0,"PP",22
19,"19066",50,43,43,0,0,"PP",19
24,"24117",412,336,335,0,1,"PP",165
12,"12102",521,442,434,2,8,"PP",89
46,"46230",14084,10694,10599,67,95,"PP",1525
9,"9388",33,28,28,0,0,"PP",3
50,"50240",965,720,702,9,18,"PP",126
26,"26012",33,28,26,0,2,"PP",9
5,"5138",289,224,223,2,1,"PP",96
44,"44205",634,444,426,9,18,"PP",113
20,"20009",11343,8168,8106,46,62,"PP",355
5,"5901",253,173,171,1,2,"PP",49
19,"19051",61,54,54,0,0,"PP",21
45,"45187",3976,3365,3308,24,57,"PP",818
46,"46018",567,483,479,3,4,"PP",114
47,"47017",198,162,160,1,2,"PP",88
46,"46231",2401,1780,1770,8,10,"PP",244
29,"29070",43090,30294,29928,243,366,"PP",4610
9,"9062",40,39,39,0,0,"PP",15
30,"30031",500,435,433,3,2,"PP",193
26,"26037",131,99,98,1,1,"PP",30
29,"29059",2643,2086,2042,8,44,"PP",215
39,"39078",1406,1101,1090,7,11,"PP",246
44,"44217",31,25,25,0,0,"PP",5
21,"21076",2142,1573,1551,24,22,"PP",192
9,"9063",214,185,184,0,1,"PP",78
7,"7054",22958,14097,13908,123,189,"PP",3296
49,"49087",483,322,320,2,2,"PP",170
45,"45005",227,180,174,5,6,"PP",67
44,"44080",284,214,212,1,2,"PP",36
10,"10168",320,209,202,1,7,"PP",47
19,"19005",91,63,63,0,0,"PP",18
16,"16112",1468,1108,1096,6,12,"PP",369
50,"50038",1405,1112,1099,13,13,"PP",230
28,"28063",254,203,202,2,1,"PP",42
44,"44165",173,136,135,2,1,"PP",39
50,"50107",988,837,828,11,9,"PP",214
9,"9337",114,93,93,0,0,"PP",22
23,"23009",12808,10348,10233,66,115,"PP",2421
5,"5193",180,156,156,2,0,"PP",72
43,"43175",537,426,419,5,7,"PP",39
40,"40077",932,747,730,9,17,"PP",142
40,"40216",774,670,665,11,5,"PP",166
13,"13088",589,439,429,1,10,"PP",102
40,"40076",6537,5130,5012,22,118,"PP",1052
6,"6155",1825,1316,1292,21,24,"PP",191
5,"5260",97,81,80,1,1,"PP",48
43,"43077",455,342,339,2,3,"PP",25
34,"34190",49,36,36,3,0,"PP",19
4,"4011",2757,2171,2136,11,35,"PP",361
16,"16156",82,65,65,0,0,"PP",21
37,"37033",92,69,69,2,0,"PP",19
7,"7034",1064,906,900,6,6,"PP",210
37,"37219",165,101,97,2,4,"PP",32
16,"16129",90,78,77,0,1,"PP",22
44,"44125",65,50,50,0,0,"PP",19
50,"50188",27,24,24,0,0,"PP",8
40,"40218",84,62,62,0,0,"PP",32
14,"14073",2772,2124,2069,18,55,"PP",283
50,"50070",49,28,28,0,0,"PP",3
28,"28173",519,417,412,4,5,"PP",87
16,"16157",190,163,161,1,2,"PP",43
46,"46154",797,645,630,1,15,"PP",160
9,"9265",47,38,36,2,2,"PP",16
18,"18057",5540,4306,4246,30,60,"PP",595
16,"16045",185,142,141,0,1,"PP",45
10,"10050",1015,831,823,2,8,"PP",322
45,"45148",275,209,209,1,0,"PP",75
43,"43136",10463,7789,7749,36,40,"PP",266
40,"40127",35,28,28,0,0,"PP",13
45,"45010",389,280,280,3,0,"PP",47
39,"39083",1074,786,777,4,9,"PP",173
20,"20024",391,274,274,1,0,"PP",3
12,"12069",53,45,44,1,1,"PP",12
48,"48090",6016,4700,4639,24,61,"PP",233
49,"49036",508,361,355,6,6,"PP",123
16,"16033",1644,1345,1320,11,25,"PP",380
26,"26043",349,272,268,2,4,"PP",72
10,"10051",433,338,332,0,6,"PP",182
36,"36053",5784,4407,4327,28,80,"PP",1167
22,"22002",106,95,94,0,1,"PP",26
26,"26120",1460,1130,1109,3,21,"PP",337
10,"10052",166,124,123,0,1,"PP",51
49,"49095",279,221,217,0,4,"PP",64
7,"7059",3035,2257,2226,13,31,"PP",491
49,"49256",242,204,202,4,2,"PP",80
24,"24049",1415,1146,1134,8,12,"PP",270
40,"40022",193,162,159,2,3,"PP",46
46,"46237",7148,5537,5472,36,65,"PP",845
44,"44087",68,56,54,0,2,"PP",22
45,"45150",414,326,320,2,6,"PP",65
27,"27045",944,700,698,13,2,"PP",163
43,"43056",806,616,613,5,3,"PP",36
50,"50043",246,172,170,2,2,"PP",30
34,"34100",131,100,97,1,3,"PP",28
14,"14902",1121,928,900,7,28,"PP",104
19,"19165",41,36,36,0,0,"PP",5
29,"29055",1880,1493,1470,15,23,"PP",179
22,"22116",1369,1025,1003,8,22,"PP",267
27,"27046",1448,1074,1063,7,11,"PP",340
37,"37113",409,330,329,3,1,"PP",86
45,"45015",662,506,500,2,6,"PP",89
1,"1001",2005,1438,1419,4,19,"PP",100
5,"5070",30,28,28,0,0,"PP",9
23,"23015",1332,1066,1048,4,18,"PP",209
9,"9419",67,53,52,0,1,"PP",34
18,"18189",772,619,611,4,8,"PP",112
37,"37314",82,72,68,0,4,"PP",32
27,"27005",2551,1908,1868,26,40,"PP",640
16,"16162",39,31,30,0,1,"PP",13
22,"22027",306,230,225,3,5,"PP",50
32,"32077",1104,820,815,10,5,"PP",312
4,"4082",277,198,196,1,2,"PP",64
23,"23039",2154,1644,1605,6,39,"PP",389
11,"11019",1753,1353,1295,7,58,"PP",301
24,"24227",1548,1148,1128,5,20,"PP",294
30,"30008",14450,10832,10675,60,157,"PP",2309
32,"32030",944,690,685,7,5,"PP",167
6,"6106",413,267,263,3,4,"PP",49
46,"46159",23051,17496,17359,104,137,"PP",2775
22,"22017",822,664,660,5,4,"PP",140
37,"37127",200,145,145,1,0,"PP",32
24,"24172",415,240,237,1,3,"PP",89
49,"49260",700,558,548,8,10,"PP",174
23,"23050",90596,69591,68903,460,688,"PP",15364
18,"18099",1581,1279,1245,5,34,"PP",212
46,"46007",12284,9370,9265,65,105,"PP",1567
45,"45155",319,261,253,1,8,"PP",63
18,"18158",8010,5524,5449,23,75,"PP",483
50,"50193",663,536,516,1,20,"PP",84
23,"23051",2727,2060,2023,5,37,"PP",410
36,"36057",238171,181891,180030,1636,1861,"PP",32576
3,"3130",43,23,23,0,0,"PP",7
41,"41073",1685,1172,1157,13,15,"PP",195
26,"26178",71,57,56,1,1,"PP",13
26,"26049",153,115,115,1,0,"PP",49
6,"6130",186,159,154,0,5,"PP",30
45,"45019",7545,5831,5740,52,91,"PP",890
18,"18021",17869,13238,13004,110,234,"PP",1848
1,"1004",1356,1007,998,3,9,"PP",85
42,"42207",47,41,41,0,0,"PP",5
42,"42194",146,111,111,0,0,"PP",34
14,"14050",2352,1840,1801,11,39,"PP",377
46,"46253",114,85,85,2,0,"PP",10
13,"13040",841,690,666,2,24,"PP",192
49,"49223",716,552,548,0,4,"PP",319
44,"44092",70,56,55,1,1,"PP",21
12,"12021",4377,3528,3473,23,55,"PP",577
37,"37230",214,176,176,0,0,"PP",46
44,"44185",93,73,72,1,1,"PP",22
22,"22125",39429,29988,29612,337,376,"PP",5354
44,"44093",79,73,73,4,0,"PP",21
21,"21052",4429,2951,2891,19,60,"PP",314
24,"24002",233,183,183,1,0,"PP",57
45,"45143",1190,940,925,3,15,"PP",274
18,"18910",730,491,487,0,4,"PP",115
22,"22082",285,230,226,2,4,"PP",67
35,"35012",10765,6327,6270,32,57,"PP",1282
3,"3111",5565,4183,4149,29,34,"PP",1098
16,"16187",55,43,43,0,0,"PP",15
34,"34125",79,59,58,0,1,"PP",32
10,"10034",336,269,267,0,2,"PP",86
43,"43060",2684,2158,2152,8,6,"PP",71
37,"37244",128,99,97,1,2,"PP",32
19,"19041",167,133,129,1,4,"PP",15
26,"26128",96,74,74,1,0,"PP",17
48,"48068",1528,1218,1211,5,7,"PP",13
5,"5039",48,47,47,0,0,"PP",27
43,"43037",17902,12787,12695,63,92,"PP",728
18,"18126",1450,1115,1087,11,28,"PP",89
46,"46001",783,612,607,4,5,"PP",151
28,"28054",11891,9476,9395,64,81,"PP",1713
40,"40054",107,91,88,0,3,"PP",23
5,"5078",100,87,86,0,1,"PP",43
46,"46904",805,643,628,13,15,"PP",72
37,"37182",78,57,57,0,0,"PP",21
4,"4024",3225,2558,2534,23,24,"PP",437
35,"35005",1017,751,743,1,8,"PP",235
50,"50298",5427,4373,4323,30,50,"PP",852
24,"24058",195,127,125,1,2,"PP",48
5,"5158",345,279,274,2,5,"PP",110
40,"40089",214,176,170,1,6,"PP",70
42,"42061",272,207,204,2,3,"PP",49
19,"19044",284,226,223,1,3,"PP",111
49,"49266",70,51,49,2,2,"PP",21
16,"16224",77,61,60,1,1,"PP",16
28,"28076",425,354,349,3,5,"PP",94
49,"49228",55,47,47,0,0,"PP",24
16,"16131",127,90,90,1,0,"PP",16
40,"40219",565,451,432,2,19,"PP",174
45,"45057",224,188,184,0,4,"PP",55
19,"19024",8525,6587,6485,33,102,"PP",840
9,"9446",12,8,8,0,0,"PP",5
49,"49131",238,182,178,0,4,"PP",63
6,"6024",1133,963,941,5,22,"PP",197
38,"38012",2310,1705,1687,6,18,"PP",194
18,"18014",6898,5262,5162,43,100,"PP",905
28,"28099",1923,1490,1475,7,15,"PP",321
36,"36902",5052,3813,3724,21,89,"PP",1432
34,"34113",40,37,37,0,0,"PP",19
19,"19031",10,8,8,0,0,"PP",3
42,"42159",40,36,35,0,1,"PP",11
39,"39008",13900,10895,10767,81,128,"PP",1764
9,"9196",135,108,107,0,1,"PP",33
37,"37273",88,67,67,0,0,"PP",39
3,"3072",348,297,295,2,2,"PP",34
34,"34069",2184,1737,1701,16,36,"PP",359
16,"16227",108,85,85,1,0,"PP",32
41,"41060",15100,11304,11105,113,199,"PP",1634
11,"11004",89545,60056,59323,741,733,"PP",8833
44,"44128",59,46,45,0,1,"PP",11
9,"9382",30,24,23,0,1,"PP",12
24,"24022",306,227,224,1,3,"PP",81
45,"45029",188,160,159,0,1,"PP",51
43,"43040",326,278,276,0,2,"PP",10
26,"26135",153,123,123,1,0,"PP",41
20,"20046",1248,918,909,11,9,"PP",18
50,"50229",65,57,56,0,1,"PP",12
39,"39094",841,676,670,3,6,"PP",139
9,"9363",922,733,725,3,8,"PP",287
47,"47181",165,143,143,0,0,"PP",42
22,"22903",622,538,533,3,5,"PP",136
16,"16010",137,104,101,0,3,"PP",53
19,"19311",87,71,71,2,0,"PP",25
10,"10190",521,372,361,2,11,"PP",79
20,"20078",1145,882,879,4,3,"PP",9
45,"45091",374,275,274,1,1,"PP",51
13,"13051",336,272,271,1,1,"PP",69
18,"18085",701,465,460,1,5,"PP",72
9,"9292",75,62,62,2,0,"PP",11
42,"42096",251,164,160,3,4,"PP",64
5,"5227",340,237,234,0,3,"PP",68
46,"46016",1075,887,880,8,7,"PP",130
9,"9437",270,227,224,2,3,"PP",84
5,"5058",72,52,52,0,0,"PP",22
20,"20031",183,125,125,2,0,"PP",0
26,"26123",124,112,110,0,2,"PP",51
5,"5164",17,12,12,0,0,"PP",7
50,"50056",405,332,330,4,2,"PP",63
10,"10164",720,474,461,3,13,"PP",88
37,"37055",118,96,95,0,1,"PP",49
28,"28104",15318,12897,12797,87,100,"PP",1965
9,"9273",51,46,46,3,0,"PP",17
45,"45170",199,154,150,1,4,"PP",46
41,"41053",21618,16549,16150,194,399,"PP",2036
23,"23060",19153,14444,14281,87,163,"PP",2307
7,"7052",4816,3276,3258,39,18,"PP",544
45,"45048",355,277,271,1,6,"PP",92
40,"40003",121,91,89,1,2,"PP",48
5,"5018",24,18,17,0,1,"PP",6
18,"18006",4087,3109,3042,28,67,"PP",592
13,"13084",841,683,673,6,10,"PP",178
32,"32088",1610,1040,1019,11,21,"PP",339
30,"30030",320172,249965,247884,1497,2081,"PP",60166
37,"37316",716,576,565,4,11,"PP",213
22,"22209",159,139,136,5,3,"PP",17
16,"16013",26,21,20,0,1,"PP",3
13,"13902",449,362,360,2,2,"PP",56
10,"10071",124,85,84,0,1,"PP",27
16,"16140",19,16,16,0,0,"PP",1
44,"44103",123,101,100,1,1,"PP",30
42,"42132",135,114,113,1,1,"PP",42
48,"48909",202,172,172,2,0,"PP",0
41,"41017",15712,12048,11896,118,152,"PP",1765
2,"2034",1324,1088,1083,10,5,"PP",247
26,"26025",89,77,77,0,0,"PP",19
39,"39097",679,437,435,2,2,"PP",181
19,"19039",59,56,55,1,1,"PP",23
20,"20081",7655,5629,5601,22,28,"PP",128
45,"45173",9729,7664,7558,46,106,"PP",1756
9,"9373",406,284,268,3,16,"PP",133
44,"44197",50,35,35,0,0,"PP",8
16,"16186",412,358,354,1,4,"PP",112
45,"45128",2552,1874,1839,9,35,"PP",371
48,"48066",347,291,291,0,0,"PP",3
32,"32074",993,737,734,4,3,"PP",319
9,"9374",90,79,78,1,1,"PP",25
45,"45174",296,253,250,3,3,"PP",83
13,"13072",729,542,531,3,11,"PP",153
32,"32015",830,543,541,4,2,"PP",277
49,"49192",124,102,102,2,0,"PP",30
49,"49076",328,260,258,6,2,"PP",96
37,"37256",195,152,150,0,2,"PP",44
26,"26027",143,101,98,1,3,"PP",40
21,"21078",2646,1926,1895,14,31,"PP",222
2,"2048",1178,989,967,7,22,"PP",309
28,"28024",168,146,145,1,1,"PP",44
9,"9318",58,37,37,0,0,"PP",14
4,"4076",1221,951,933,8,18,"PP",190
46,"46193",8964,7206,7156,27,50,"PP",1012
41,"41085",4170,3337,3270,27,67,"PP",549
37,"37319",93,67,65,1,2,"PP",15
50,"50108",52,43,42,0,1,"PP",11
46,"46903",6285,5035,4996,27,39,"PP",759
32,"32025",1013,773,761,7,12,"PP",347
48,"48028",691,576,573,1,3,"PP",5
5,"5194",132,111,111,0,0,"PP",33
24,"24206",1611,1286,1268,7,18,"PP",259
10,"10077",637,501,499,3,2,"PP",95
22,"22909",301,233,231,4,2,"PP",61
32,"32072",3687,2715,2682,22,33,"PP",843
20,"20903",4803,3514,3481,24,33,"PP",110
19,"19096",101,81,79,1,2,"PP",35
44,"44210",743,600,594,8,6,"PP",115
12,"12004",4177,3225,3187,13,38,"PP",733
6,"6012",3233,2515,2492,15,23,"PP",450
27,"27021",1649,1080,1048,14,32,"PP",393
29,"29075",12890,9033,8949,73,84,"PP",2091
45,"45179",495,383,382,3,1,"PP",132
50,"50901",140,108,108,0,0,"PP",19
28,"28121",205,166,165,1,1,"PP",41
12,"12014",167,131,127,1,4,"PP",33
37,"37222",86,64,62,0,2,"PP",20
50,"50041",17,14,14,0,0,"PP",0
12,"12129",1801,1382,1356,17,26,"PP",184
3,"3092",6688,5444,5370,36,74,"PP",779
3,"3051",344,312,307,2,5,"PP",81
7,"7014",7778,4724,4669,50,55,"PP",564
29,"29043",2474,1764,1720,25,44,"PP",312
42,"42125",75,62,62,2,0,"PP",14
16,"16245",400,329,318,0,11,"PP",105
46,"46044",4198,3399,3337,13,62,"PP",771
22,"22189",178,143,143,0,0,"PP",27
23,"23003",8644,6604,6523,36,81,"PP",1302
9,"9124",1432,1078,1054,7,24,"PP",287
43,"43169",450,396,396,3,0,"PP",3
6,"6015",117934,87081,86114,785,967,"PP",18793
50,"50266",121,85,80,0,5,"PP",24
44,"44201",478,417,412,3,5,"PP",49
19,"19046",22148,17383,17137,125,246,"PP",2303
37,"37285",366,273,272,1,1,"PP",103
16,"16119",179,128,128,0,0,"PP",32
19,"19148",42,35,33,0,2,"PP",13
3,"3083",5487,3993,3934,28,59,"PP",588
5,"5173",59,52,52,0,0,"PP",12
43,"43122",111,98,97,0,1,"PP",1
32,"32075",4382,3546,3489,35,57,"PP",1359
45,"45090",368,287,286,1,1,"PP",74
44,"44110",37,33,33,0,0,"PP",23
13,"13019",5095,3758,3717,25,41,"PP",800
10,"10203",4428,3212,3152,25,60,"PP",779
28,"28166",347,287,286,1,1,"PP",52
40,"40035",135,111,110,0,1,"PP",21
40,"40142",52,42,40,0,2,"PP",15
9,"9328",74,51,50,0,1,"PP",15
49,"49173",344,220,216,1,4,"PP",114
45,"45199",3107,2221,2184,8,37,"PP",284
6,"6127",2809,2285,2258,13,27,"PP",673
46,"46208",1070,875,866,2,9,"PP",168
21,"21012",286,238,233,4,5,"PP",68
49,"49054",849,641,629,5,12,"PP",162
43,"43032",466,379,379,1,0,"PP",12
38,"38025",7088,5166,5089,39,77,"PP",791
42,"42209",135,107,100,5,7,"PP",33
13,"13056",11657,9236,9142,85,94,"PP",1604
37,"37015",205,131,130,2,1,"PP",47
7,"7007",414,326,324,2,2,"PP",55
14,"14068",516,405,400,1,5,"PP",62
34,"34904",300,220,220,0,0,"PP",57
15,"15043",4978,3631,3572,39,59,"PP",1117
38,"38006",41302,23632,23415,133,217,"PP",3422
43,"43066",155,121,121,1,0,"PP",2
5,"5215",159,126,124,0,2,"PP",61
19,"19333",105,74,73,1,1,"PP",20
40,"40213",95,83,80,1,3,"PP",29
13,"13037",790,633,620,3,13,"PP",223
2,"2068",324,274,273,0,1,"PP",56
29,"29035",1505,1151,1133,6,18,"PP",129
40,"40037",34,19,19,0,0,"PP",9
34,"34242",93,66,64,1,2,"PP",24
6,"6033",1269,1026,1010,4,16,"PP",275
9,"9239",47,39,39,0,0,"PP",13
49,"49222",370,284,282,2,2,"PP",45
49,"49247",417,301,294,0,7,"PP",115
27,"27058",3322,2551,2512,22,39,"PP",1231
14,"14019",6408,5163,5086,58,77,"PP",659
11,"11021",4926,3592,3486,50,106,"PP",444
40,"40074",245,219,214,5,5,"PP",90
28,"28001",80,64,64,0,0,"PP",19
50,"50037",127,93,93,0,0,"PP",30
37,"37266",70,58,56,0,2,"PP",22
18,"18111",2849,2193,2160,24,33,"PP",220
26,"26061",1552,1228,1194,14,34,"PP",365
15,"15066",4008,2931,2886,30,45,"PP",1243
9,"9275",166,130,130,2,0,"PP",51
30,"30001",4539,3615,3567,16,48,"PP",1377
45,"45097",1044,901,890,4,11,"PP",234
11,"11022",48682,28113,27794,294,319,"PP",3971
24,"24120",311,209,209,0,0,"PP",72
48,"48026",1139,920,913,4,7,"PP",6
42,"42182",51,42,42,1,0,"PP",27
26,"26153",10,9,9,0,0,"PP",1
9,"9441",92,81,81,1,0,"PP",42
50,"50131",210,157,156,0,1,"PP",48
28,"28066",7515,6105,6039,40,66,"PP",1160
37,"37103",414,309,309,4,0,"PP",108
10,"10101",179,140,138,2,2,"PP",35
46,"46254",943,751,734,4,17,"PP",222
49,"49237",143,95,93,0,2,"PP",43
14,"14061",688,567,556,2,11,"PP",106
9,"9317",19,19,19,1,0,"PP",7
16,"16240",100,77,76,0,1,"PP",21
44,"44167",39,30,30,0,0,"PP",7
41,"41075",10279,7543,7370,96,173,"PP",1475
50,"50039",467,366,364,3,2,"PP",77
5,"5023",175,158,155,2,3,"PP",64
29,"29018",1996,1523,1481,11,42,"PP",224
10,"10048",204,156,154,0,2,"PP",63
5,"5121",262,201,199,0,2,"PP",67
43,"43039",105,85,85,0,0,"PP",0
6,"6144",512,422,416,1,6,"PP",75
43,"43905",14941,10510,10446,40,64,"PP",832
43,"43061",38,28,28,0,0,"PP",2
27,"27020",3380,2764,2713,32,51,"PP",1596
24,"24044",152,116,114,0,2,"PP",39
5,"5157",235,175,174,2,1,"PP",51
30,"30034",1075,852,831,4,21,"PP",247
19,"19159",87,77,76,0,1,"PP",37
37,"37145",244,187,185,3,2,"PP",60
50,"50273",32,24,24,0,0,"PP",11
37,"37107",10483,7732,7633,78,99,"PP",2540
45,"45193",589,512,507,6,5,"PP",174
41,"41021",21397,15585,15334,201,251,"PP",1573
37,"37234",317,224,222,1,2,"PP",60
26,"26092",109,84,82,1,2,"PP",39
40,"40055",32,26,25,0,1,"PP",10
40,"40091",108,93,93,1,0,"PP",34
49,"49130",158,131,131,5,0,"PP",40
2,"2014",350,285,280,1,5,"PP",74
18,"18116",2853,2265,2233,15,32,"PP",692
16,"16130",536,445,444,0,1,"PP",104
30,"30902",8225,5797,5715,22,82,"PP",1226
26,"26050",130,97,97,0,0,"PP",39
45,"45061",2485,1850,1822,7,28,"PP",364
37,"37322",2466,1764,1723,17,41,"PP",325
10,"10173",558,445,439,0,6,"PP",82
18,"18069",497,374,366,4,8,"PP",87
27,"27012",1276,776,768,9,8,"PP",278
37,"37065",271,187,184,0,3,"PP",87
9,"9178",40,27,27,0,0,"PP",11
32,"32083",821,592,587,7,5,"PP",320
44,"44118",158,126,122,1,4,"PP",34
47,"47169",61,53,53,0,0,"PP",35
9,"9249",50,39,39,0,0,"PP",11
41,"41069",29569,21075,20657,361,418,"PP",2878
45,"45104",421,340,335,1,5,"PP",55
43,"43079",356,306,305,1,1,"PP",5
21,"21046",1714,1097,1071,13,26,"PP",273
46,"46098",2403,1807,1772,8,35,"PP",340
37,"37193",365,277,276,3,1,"PP",60
9,"9268",88,71,71,0,0,"PP",20
49,"49216",147,122,114,0,8,"PP",26
40,"40012",238,178,175,4,3,"PP",67
10,"10134",553,396,392,2,4,"PP",146
49,"49219",7221,5301,5186,62,115,"PP",1226
37,"37262",69,60,60,0,0,"PP",38
12,"12137",37,27,27,0,0,"PP",3
34,"34149",21,18,18,0,0,"PP",9
42,"42052",17,15,15,0,0,"PP",8
24,"24129",111,91,91,1,0,"PP",31
44,"44022",463,342,326,6,16,"PP",58
10,"10095",314,260,255,2,5,"PP",46
7,"7061",9564,6678,6583,67,95,"PP",1336
5,"5187",1728,1394,1364,7,30,"PP",359
6,"6093",4345,3356,3281,18,75,"PP",766
37,"37199",129,97,97,0,0,"PP",22
44,"44193",69,57,56,1,1,"PP",12
48,"48906",753,611,608,1,3,"PP",8
34,"34116",55,45,45,0,0,"PP",25
16,"16217",94,77,77,0,0,"PP",33
47,"47171",384,315,311,5,4,"PP",105
26,"26163",124,106,104,1,2,"PP",38
10,"10091",350,293,291,1,2,"PP",80
22,"22069",418,337,334,5,3,"PP",68
10,"10046",187,154,152,0,2,"PP",29
29,"29071",979,718,712,14,6,"PP",185
27,"27029",1427,1068,1047,13,21,"PP",381
45,"45154",1479,1163,1149,5,14,"PP",210
9,"9144",44,37,37,2,0,"PP",18
21,"21073",1891,1191,1156,17,35,"PP",296
10,"10165",253,212,210,1,2,"PP",83
45,"45139",145,118,117,1,1,"PP",42
1,"1060",201,174,166,1,8,"PP",47
43,"43164",306,228,228,0,0,"PP",20
21,"21050",12522,8425,8312,84,113,"PP",1699
21,"21062",1386,893,885,15,8,"PP",183
11,"11020",166423,117732,116448,1427,1284,"PP",18189
50,"50027",224,170,165,1,5,"PP",38
10,"10143",141,118,113,1,5,"PP",33
5,"5211",430,364,357,6,7,"PP",170
40,"40030",428,357,350,3,7,"PP",88
5,"5034",14,12,12,0,0,"PP",3
46,"46210",344,265,258,2,7,"PP",64
9,"9295",54,38,38,0,0,"PP",26
28,"28148",88647,70218,69546,570,672,"PP",10894
15,"15076",2514,1709,1683,19,26,"PP",513
27,"27017",961,667,654,1,13,"PP",281
45,"45111",53,43,41,0,2,"PP",12
28,"28083",9665,7794,7737,56,57,"PP",964
49,"49151",593,453,444,5,9,"PP",127
44,"44035",105,86,84,1,2,"PP",38
37,"37116",69,51,51,0,0,"PP",19
19,"19227",73,55,53,0,2,"PP",9
7,"7032",20888,14257,14096,108,161,"PP",2383
3,"3131",179,147,139,0,8,"PP",39
10,"10140",1082,868,855,8,13,"PP",211
45,"45112",1841,1250,1220,7,30,"PP",301
43,"43083",144,116,113,1,3,"PP",12
46,"46171",16429,12527,12373,61,154,"PP",1895
16,"16006",110,99,98,1,1,"PP",37
46,"46212",1590,1209,1192,4,17,"PP",231
40,"40052",72,56,56,0,0,"PP",11
28,"28022",36550,31559,31436,207,123,"PP",8151
50,"50227",110,74,73,2,1,"PP",18
49,"49093",280,239,238,2,1,"PP",68
47,"47042",50,41,39,0,2,"PP",15
40,"40033",67,57,57,1,0,"PP",16
48,"48077",3376,2656,2647,11,9,"PP",115
47,"47100",119,104,102,2,2,"PP",33
40,"40063",6944,5479,5352,39,127,"PP",1277
50,"50234",242,194,187,3,7,"PP",62
43,"43166",1628,1292,1285,3,7,"PP",62
44,"44106",153,115,111,2,4,"PP",25
10,"10169",494,405,395,1,10,"PP",155
37,"37168",407,305,300,0,5,"PP",95
34,"34175",87,67,66,0,1,"PP",31
44,"44135",102,85,85,0,0,"PP",29
39,"39090",772,619,609,1,10,"PP",137
27,"27054",1145,907,890,5,17,"PP",431
5,"5254",181,155,153,0,2,"PP",67
43,"43047",4209,2878,2856,23,22,"PP",178
5,"5233",226,198,197,0,1,"PP",99
24,"24152",447,301,296,1,5,"PP",122
28,"28182",198,169,169,1,0,"PP",25
29,"29073",1645,1200,1185,13,15,"PP",161
29,"29085",138,100,98,0,2,"PP",15
9,"9175",119,93,93,0,0,"PP",50
37,"37269",430,331,325,2,6,"PP",97
9,"9066",54,41,40,1,1,"PP",8
47,"47051",321,274,272,1,2,"PP",57
37,"37120",97,83,81,1,2,"PP",34
46,"46123",1948,1469,1446,5,23,"PP",261
22,"22215",128,91,91,1,0,"PP",13
19,"19232",58,49,49,0,0,"PP",21
26,"26029",36,29,28,0,1,"PP",9
15,"15048",5048,3791,3730,38,61,"PP",1052
1,"1023",262,210,206,3,4,"PP",49
5,"5195",206,157,157,0,0,"PP",58
22,"22254",1094,857,850,11,7,"PP",208
36,"36055",13551,9908,9682,105,226,"PP",2712
19,"19175",30,19,19,1,0,"PP",14
15,"15090",1125,811,800,7,11,"PP",409
4,"4026",55,46,45,1,1,"PP",19
19,"19138",223,176,172,4,4,"PP",27
47,"47018",36,31,29,0,2,"PP",15
49,"49058",298,244,242,1,2,"PP",80
43,"43076",460,378,377,2,1,"PP",1
2,"2050",90,75,75,0,0,"PP",18
37,"37208",69,52,51,0,1,"PP",29
12,"12005",8052,6056,5935,50,121,"PP",1160
50,"50199",325,238,232,3,6,"PP",47
9,"9307",112,87,86,0,1,"PP",25
49,"49268",368,282,279,2,3,"PP",147
41,"41095",39970,27911,27583,389,328,"PP",3147
16,"16192",43,30,29,0,1,"PP",4
5,"5236",106,77,77,0,0,"PP",22
46,"46034",1811,1407,1389,13,18,"PP",188
40,"40057",1405,1176,1163,10,13,"PP",259
43,"43049",727,589,584,2,5,"PP",5
50,"50087",29,18,18,0,0,"PP",8
45,"45084",2121,1708,1676,16,32,"PP",349
5,"5082",495,399,394,1,5,"PP",142
29,"29006",665,491,483,5,8,"PP",123
12,"12090",104,85,83,1,2,"PP",42
23,"23058",8817,6964,6873,48,91,"PP",1372
43,"43015",119,101,101,0,0,"PP",0
46,"46187",1304,991,982,8,9,"PP",227
7,"7038",2025,1581,1556,14,25,"PP",430
44,"44257",154,110,109,1,1,"PP",37
37,"37274",118473,91137,90221,811,916,"PP",25196
47,"47150",259,206,202,0,4,"PP",64
3,"3073",222,200,196,3,4,"PP",47
45,"45076",564,389,388,2,1,"PP",141
40,"40901",414,331,328,8,3,"PP",91
28,"28018",4068,3367,3344,15,23,"PP",656
40,"40200",38,32,31,0,1,"PP",8
32,"32085",10634,7655,7551,66,104,"PP",2489
7,"7028",920,686,676,8,10,"PP",121
24,"24212",1002,772,764,7,8,"PP",241
30,"30041",13970,9796,9682,80,114,"PP",2131
6,"6153",20240,15464,15210,134,254,"PP",2944
13,"13903",493,412,406,1,6,"PP",179
9,"9172",168,132,132,1,0,"PP",40
9,"9247",22,18,18,0,0,"PP",11
47,"47231",4458,3677,3651,47,26,"PP",583
47,"47168",30,29,29,0,0,"PP",11
44,"44230",152,112,111,1,1,"PP",24
34,"34186",47,41,41,0,0,"PP",17
45,"45123",3160,2434,2392,16,42,"PP",218
48,"48074",3273,2480,2460,14,20,"PP",110
37,"37200",196,145,145,0,0,"PP",34
43,"43017",116,98,98,1,0,"PP",0
26,"26099",1216,993,973,14,20,"PP",296
50,"50183",319,242,241,4,1,"PP",71
16,"16249",1938,1544,1529,13,15,"PP",438
19,"19087",17,14,14,0,0,"PP",2
44,"44013",11250,8525,8420,95,105,"PP",1682
26,"26023",435,351,347,5,4,"PP",115
43,"43069",178,146,146,0,0,"PP",7
15,"15071",7805,5476,5401,62,75,"PP",1642
45,"45181",2337,1846,1818,7,28,"PP",533
45,"45022",393,290,288,3,2,"PP",88
18,"18037",528,435,426,2,9,"PP",97
41,"41072",4037,3256,3221,19,35,"PP",159
43,"43034",468,393,393,0,0,"PP",16
10,"10179",277,220,219,0,1,"PP",58
4,"4019",232,181,179,0,2,"PP",51
40,"40904",341,302,300,4,2,"PP",91
24,"24149",146,123,123,0,0,"PP",49
50,"50260",32,28,28,0,0,"PP",11
7,"7020",3692,2833,2808,42,25,"PP",378
45,"45126",239,173,168,0,5,"PP",33
32,"32013",2017,1388,1380,5,8,"PP",743
15,"15079",1466,1076,1052,11,24,"PP",461
49,"49100",286,210,208,2,2,"PP",70
16,"16125",1599,1314,1295,9,19,"PP",324
20,"20010",1528,1156,1151,5,5,"PP",46
16,"16251",1809,1469,1443,11,26,"PP",525
20,"20061",4392,3278,3264,11,14,"PP",72
42,"42090",88,69,68,2,1,"PP",27
49,"49181",335,227,224,2,3,"PP",111
36,"36052",7234,5292,5151,44,141,"PP",1842
42,"42018",131,102,102,1,0,"PP",41
3,"3027",172,156,153,0,3,"PP",25
18,"18182",1917,1391,1381,7,10,"PP",263
10,"10072",835,632,625,3,7,"PP",135
40,"40111",52,44,44,0,0,"PP",20
18,"18046",1753,1206,1185,1,21,"PP",199
41,"41027",3966,2830,2784,32,46,"PP",329
49,"49157",192,153,149,0,4,"PP",44
9,"9160",80,64,64,1,0,"PP",28
5,"5128",342,274,267,1,7,"PP",50
2,"2035",1946,1592,1576,15,16,"PP",330
30,"30033",10363,8115,7979,54,136,"PP",1978
9,"9277",107,92,89,0,3,"PP",10
45,"45191",521,449,446,0,3,"PP",126
19,"19054",167,144,141,2,3,"PP",54
24,"24004",494,408,403,7,5,"PP",175
44,"44109",102,71,70,1,1,"PP",15
5,"5001",179,153,152,2,1,"PP",52
16,"16901",630,498,492,4,6,"PP",175
49,"49185",156,126,120,1,6,"PP",55
10,"10116",3728,2849,2776,27,73,"PP",439
44,"44189",48,36,36,0,0,"PP",13
24,"24190",146,109,109,1,0,"PP",52
23,"23054",376,296,289,1,7,"PP",61
9,"9356",43,36,36,0,0,"PP",15
26,"26089",111800,87863,86778,700,1085,"PP",20936
28,"28110",2003,1596,1571,7,25,"PP",336
21,"21018",1719,1167,1139,9,28,"PP",138
37,"37321",149,121,121,0,0,"PP",41
38,"38041",6970,5288,5258,38,30,"PP",569
42,"42213",25,16,16,0,0,"PP",8
3,"3023",1379,1216,1199,6,17,"PP",291
18,"18013",4152,3168,3103,16,65,"PP",666
37,"37258",137,99,98,1,1,"PP",35
44,"44264",248,175,171,0,4,"PP",25
34,"34220",149,133,132,0,1,"PP",39
38,"38031",29154,22871,22598,143,273,"PP",4852
43,"43106",793,656,651,2,5,"PP",34
16,"16198",1299,1044,1027,11,17,"PP",216
10,"10022",412,319,316,1,3,"PP",113
49,"49011",212,166,165,7,1,"PP",60
20,"20034",3154,2336,2315,20,21,"PP",54
48,"48009",772,628,622,2,6,"PP",8
40,"40182",173,126,124,1,2,"PP",46
34,"34245",310,244,240,3,4,"PP",94
16,"16259",27,22,21,0,1,"PP",8
28,"28107",442,336,325,3,11,"PP",58
37,"37306",242,184,181,2,3,"PP",65
46,"46226",31,27,27,0,0,"PP",1
18,"18143",949,757,740,5,17,"PP",85
20,"20025",1116,835,830,2,5,"PP",1
34,"34082",80,68,68,0,0,"PP",21
5,"5224",100,91,90,1,1,"PP",43
36,"36023",8279,6187,6085,46,102,"PP",1614
23,"23047",1579,1260,1247,13,13,"PP",252
37,"37176",130,103,103,1,0,"PP",37
5,"5104",33,24,23,0,1,"PP",8
38,"38019",13758,8870,8776,46,94,"PP",1269
45,"45100",179,150,148,1,2,"PP",44
9,"9108",432,332,326,1,6,"PP",52
11,"11017",3194,2265,2221,38,44,"PP",303
26,"26108",290,241,237,0,4,"PP",91
6,"6081",1042,825,811,4,14,"PP",109
39,"39047",1976,1564,1538,8,26,"PP",358
42,"42217",34,26,26,0,0,"PP",7
5,"5014",5291,4096,4044,29,52,"PP",1079
37,"37224",189,168,165,0,3,"PP",79
22,"22144",257,207,204,1,3,"PP",63
49,"49159",269,214,213,1,1,"PP",66
47,"47223",152,123,120,2,3,"PP",33
49,"49235",422,312,301,0,11,"PP",78
36,"36014",1872,1373,1345,14,28,"PP",660
18,"18107",924,694,680,3,14,"PP",137
5,"5217",54,44,43,0,1,"PP",21
44,"44025",5825,4337,4197,50,140,"PP",629
15,"15093",4048,2761,2720,41,41,"PP",1119
10,"10181",680,548,542,2,6,"PP",108
40,"40192",133,104,102,2,2,"PP",38
29,"29029",380,294,287,2,7,"PP",97
42,"42218",75,52,51,0,1,"PP",17
42,"42019",511,384,378,7,6,"PP",103
13,"13086",162,139,136,1,3,"PP",52
44,"44054",94,79,79,0,0,"PP",31
48,"48059",400,329,325,0,4,"PP",6
34,"34048",63,54,53,2,1,"PP",16
27,"27008",1345,965,946,17,19,"PP",398
46,"46122",2730,2103,2071,19,32,"PP",335
19,"19146",46,41,41,1,0,"PP",7
47,"47056",83,71,71,0,0,"PP",29
48,"48084",21858,15943,15796,116,147,"PP",948
19,"19317",127,98,97,0,1,"PP",34
3,"3139",23061,16378,16178,128,200,"PP",2825
46,"46017",32990,23940,23694,155,246,"PP",4313
50,"50259",84,58,58,0,0,"PP",29
41,"41102",14750,10972,10677,110,295,"PP",1315
2,"2052",466,394,394,3,0,"PP",110
10,"10215",413,305,301,2,4,"PP",69
10,"10106",127,108,106,0,2,"PP",26
11,"11009",580,429,420,2,9,"PP",102
4,"4020",286,218,217,1,1,"PP",93
9,"9085",472,371,365,3,6,"PP",82
37,"37341",48,36,36,0,0,"PP",12
37,"37077",252,216,213,2,3,"PP",60
22,"22249",118,93,93,2,0,"PP",13
19,"19120",108,90,90,1,0,"PP",26
16,"16084",50,36,32,0,4,"PP",7
10,"10044",1404,1092,1077,7,15,"PP",153
19,"19070",67,53,51,0,2,"PP",21
9,"9352",107,86,86,2,0,"PP",36
24,"24084",152,113,113,0,0,"PP",43
29,"29074",781,606,597,2,9,"PP",101
37,"37108",99,80,78,2,2,"PP",37
11,"11026",4695,3656,3564,18,92,"PP",703
22,"22117",2414,1798,1784,18,14,"PP",432
9,"9189",126,102,96,0,6,"PP",39
18,"18094",2304,1845,1798,16,47,"PP",582
19,"19125",40,28,28,0,0,"PP",11
26,"26009",391,317,314,2,3,"PP",107
16,"16149",154,130,130,2,0,"PP",24
45,"45014",4020,2910,2854,22,56,"PP",428
9,"9343",93,73,72,1,1,"PP",40
9,"9225",81,62,62,0,0,"PP",21
19,"19020",46,35,34,1,1,"PP",11
24,"24096",108,69,69,0,0,"PP",20
44,"44097",126,91,90,2,1,"PP",19
7,"7033",28373,17884,17684,201,200,"PP",2837
16,"16155",488,411,408,3,3,"PP",124
44,"44149",100,74,73,0,1,"PP",16
27,"27032",3194,2268,2223,20,45,"PP",823
32,"32071",1378,963,954,7,9,"PP",448
9,"9209",4419,3407,3338,37,69,"PP",832
20,"20901",1412,1034,1030,2,4,"PP",30
7,"7011",28642,19567,19396,147,171,"PP",3122
3,"3104",27091,21366,21119,250,247,"PP",3286
44,"44260",138,91,90,1,1,"PP",20
20,"20028",2258,1579,1574,9,5,"PP",50
9,"9347",135,108,108,0,0,"PP",32
22,"22022",543,441,433,4,8,"PP",72
46,"46012",929,727,707,3,20,"PP",183
45,"45066",7770,6064,5962,21,102,"PP",1524
15,"15068",4849,3435,3392,55,43,"PP",1065
28,"28068",11554,9122,9022,44,100,"PP",1778
20,"20022",854,621,621,7,0,"PP",6
44,"44018",16,16,16,0,0,"PP",14
9,"9303",75,67,67,0,0,"PP",34
32,"32010",360,276,273,3,3,"PP",119
12,"12013",137,113,113,0,0,"PP",30
44,"44151",182,139,138,1,1,"PP",40
18,"18043",130,93,93,0,0,"PP",35
9,"9067",407,285,278,2,7,"PP",104
3,"3120",2421,1823,1786,9,37,"PP",406
46,"46125",846,681,675,1,6,"PP",142
37,"37027",235,188,184,2,4,"PP",52
6,"6137",933,730,723,5,7,"PP",142
9,"9232",140,110,107,0,3,"PP",37
47,"47210",402,300,289,2,11,"PP",95
45,"45198",1790,1488,1464,5,24,"PP",432
49,"49014",116,89,88,2,1,"PP",34
50,"50095",12136,9020,8928,99,92,"PP",1423
23,"23081",1483,1137,1109,7,28,"PP",155
48,"48005",113,80,80,0,0,"PP",0
29,"29039",2728,2084,2050,14,34,"PP",256
16,"16277",109,82,82,0,0,"PP",37
46,"46142",761,580,565,4,15,"PP",185
42,"42014",60,44,44,1,0,"PP",17
24,"24180",1101,844,833,8,11,"PP",293
32,"32081",2035,1592,1565,14,27,"PP",626
50,"50208",1748,1360,1344,11,16,"PP",303
28,"28036",2675,2135,2093,17,42,"PP",247
40,"40045",120,92,92,1,0,"PP",21
19,"19176",230,184,183,0,1,"PP",72
34,"34217",1251,1053,1042,7,11,"PP",214
26,"26111",250,209,205,2,4,"PP",38
30,"30022",17056,12158,11954,126,204,"PP",2955
46,"46263",239,204,200,3,4,"PP",28
12,"12083",89,73,71,1,2,"PP",18
32,"32057",514,367,365,5,2,"PP",107
19,"19310",7,6,6,0,0,"PP",2
34,"34094",61,44,44,0,0,"PP",14
48,"48035",404,334,331,2,3,"PP",2
15,"15002",24007,18075,17857,216,218,"PP",3555
43,"43105",156,132,132,3,0,"PP",4
23,"23092",27662,21206,20981,170,225,"PP",4045
49,"49096",157,129,123,2,6,"PP",37
49,"49071",715,500,499,3,1,"PP",218
24,"24089",101353,78253,77375,776,878,"PP",18655
47,"47203",58,48,48,0,0,"PP",22
26,"26008",1822,1436,1420,14,16,"PP",396
29,"29033",1089,776,761,2,15,"PP",192
50,"50010",66,56,55,2,1,"PP",21
46,"46047",532,447,441,4,6,"PP",73
46,"46102",19635,15330,15207,95,123,"PP",2146
18,"18167",1850,1330,1317,17,13,"PP",220
20,"20040",15753,11440,11364,69,76,"PP",314
15,"15003",1701,1234,1210,10,24,"PP",563
14,"14067",3870,3057,2998,24,59,"PP",637
7,"7027",22047,14986,14853,139,133,"PP",2299
39,"39066",877,711,705,5,6,"PP",142
1,"1014",366,283,277,7,6,"PP",49
37,"37211",212,164,163,1,1,"PP",58
27,"27044",2719,1848,1797,29,51,"PP",790
13,"13002",1419,1021,995,5,26,"PP",316
12,"12061",380,277,274,2,3,"PP",51
43,"43111",2098,1496,1483,8,13,"PP",71
4,"4012",187,163,162,1,1,"PP",39
50,"50290",358,272,266,6,6,"PP",68
10,"10187",430,316,311,0,5,"PP",66
40,"40906",2131,1830,1814,10,16,"PP",316
6,"6006",4494,3395,3325,24,70,"PP",502
46,"46199",5842,4451,4414,23,37,"PP",798
9,"9220",70,59,58,0,1,"PP",20
3,"3075",149,125,125,0,0,"PP",24
49,"49250",1194,954,939,8,15,"PP",266
16,"16115",47,35,35,0,0,"PP",10
6,"6078",506,415,410,1,5,"PP",154
35,"35021",15014,10909,10792,71,117,"PP",2082
26,"26103",827,655,645,3,10,"PP",199
5,"5162",75,58,58,0,0,"PP",15
49,"49186",235,181,178,4,3,"PP",80
32,"32067",1193,827,818,10,9,"PP",365
3,"3112",637,526,520,0,6,"PP",179
22,"22083",445,379,372,5,7,"PP",128
43,"43092",7235,5200,5174,21,26,"PP",294
30,"30003",25046,17860,17668,99,192,"PP",3927
48,"48065",3303,2541,2524,15,17,"PP",91
26,"26095",95,78,78,1,0,"PP",11
40,"40047",32,25,25,0,0,"PP",10
5,"5043",75,62,62,0,0,"PP",24
46,"46233",3781,2901,2847,22,54,"PP",614
44,"44129",36,29,29,0,0,"PP",6
44,"44159",37,32,32,1,0,"PP",12
7,"7016",2931,2201,2178,31,23,"PP",336
10,"10162",528,430,424,2,6,"PP",78
14,"14033",1265,994,985,9,9,"PP",139
34,"34101",45,39,38,0,1,"PP",16
14,"14056",23513,17065,16684,147,381,"PP",2517
49,"49231",293,212,209,0,3,"PP",79
36,"36002",3076,2225,2185,19,40,"PP",812
49,"49199",241,174,171,4,3,"PP",59
49,"49028",105,94,93,1,1,"PP",53
43,"43025",590,476,472,0,4,"PP",26
34,"34070",135,101,101,1,0,"PP",48
5,"5029",99,69,69,0,0,"PP",39
19,"19291",1131,875,864,1,11,"PP",200
18,"18063",1217,712,702,6,10,"PP",175
47,"47230",288,236,233,1,3,"PP",69
19,"19170",189,116,116,0,0,"PP",35
16,"16191",858,707,701,8,6,"PP",217
28,"28128",445,352,352,2,0,"PP",82
22,"22218",40,32,31,1,1,"PP",4
37,"37368",17,15,11,0,4,"PP",5
42,"42013",37,29,29,0,0,"PP",11
22,"22072",194,141,140,0,1,"PP",21
5,"5122",119,90,88,1,2,"PP",38
50,"50113",584,505,495,3,10,"PP",131
50,"50132",771,589,576,2,13,"PP",99
26,"26138",4545,3433,3374,27,59,"PP",1071
42,"42123",158,118,118,2,0,"PP",47
5,"5129",116,82,76,1,6,"PP",37
44,"44088",23,21,21,0,0,"PP",9
41,"41050",5180,4217,4149,34,68,"PP",850
26,"26147",34,30,29,0,1,"PP",8
9,"9034",292,239,238,2,1,"PP",90
41,"41023",7975,5918,5812,51,106,"PP",977
3,"3127",351,290,277,2,13,"PP",66
50,"50008",5185,3753,3711,35,42,"PP",440
40,"40188",83,71,71,0,0,"PP",33
10,"10196",294,231,231,2,0,"PP",63
28,"28101",229,183,182,2,1,"PP",37
26,"26086",15,15,15,0,0,"PP",11
24,"24078",336,259,255,0,4,"PP",72
19,"19102",92,80,80,0,0,"PP",18
3,"3063",27121,19869,19713,131,156,"PP",2947
28,"28028",1820,1493,1483,8,10,"PP",245
49,"49109",562,445,444,5,1,"PP",208
26,"26019",350,270,256,3,14,"PP",75
19,"19182",39,32,32,0,0,"PP",4
9,"9216",374,283,281,2,2,"PP",73
47,"47078",159,135,131,0,4,"PP",46
20,"20052",1070,833,827,2,6,"PP",19
5,"5241",3041,2242,2204,24,38,"PP",576
16,"16008",83,65,65,0,0,"PP",23
36,"36046",4043,3157,3084,27,73,"PP",978
46,"46167",345,255,255,0,0,"PP",69
50,"50023",208,165,164,2,1,"PP",76
45,"45149",539,448,440,0,8,"PP",149
22,"22193",269,220,217,2,3,"PP",72
40,"40069",74,65,65,0,0,"PP",25
6,"6100",852,681,677,3,4,"PP",211
43,"43170",878,706,704,7,2,"PP",18
5,"5232",106,87,84,1,3,"PP",29
50,"50285",650,466,462,7,4,"PP",90
6,"6104",656,530,524,6,6,"PP",67
12,"12108",438,382,379,4,3,"PP",115
9,"9246",609,449,441,2,8,"PP",123
2,"2053",2885,2313,2282,13,31,"PP",441
28,"28057",1549,1246,1239,5,7,"PP",197
22,"22003",132,114,114,0,0,"PP",30
9,"9403",103,90,89,0,1,"PP",40
46,"46143",4230,3255,3200,20,55,"PP",679
13,"13043",209,167,167,1,0,"PP",64
5,"5212",197,138,136,0,2,"PP",63
46,"46195",1982,1562,1554,2,8,"PP",266
44,"44263",377,296,285,3,11,"PP",43
5,"5085",30,27,27,0,0,"PP",17
9,"9230",33,28,28,0,0,"PP",25
47,"47057",273,204,200,0,4,"PP",53
9,"9093",162,138,137,1,1,"PP",34
40,"40198",24,20,20,0,0,"PP",12
9,"9365",27,19,19,1,0,"PP",10
23,"23094",3729,3111,3077,16,34,"PP",352
49,"49267",97,73,68,1,5,"PP",28
2,"2065",443,373,370,0,3,"PP",113
9,"9241",247,192,188,2,4,"PP",21
9,"9384",295,222,216,1,6,"PP",72
19,"19178",30,15,15,0,0,"PP",1
41,"41092",7679,5668,5568,61,100,"PP",557
10,"10039",402,302,301,0,1,"PP",93
44,"44156",46,36,33,1,3,"PP",17
9,"9387",111,91,89,0,2,"PP",16
42,"42026",22,20,20,0,0,"PP",4
50,"50024",556,427,426,6,1,"PP",76
37,"37332",70,53,53,0,0,"PP",22
49,"49189",192,132,128,1,4,"PP",62
46,"46035",6855,5500,5422,34,78,"PP",715
43,"43112",250,204,204,1,0,"PP",1
40,"40081",119,96,95,2,1,"PP",33
42,"42025",1134,824,813,6,11,"PP",211
19,"19297",32,27,27,0,0,"PP",10
28,"28123",61103,52177,51832,338,345,"PP",4771
43,"43096",98,82,82,0,0,"PP",1
44,"44266",102,89,86,1,3,"PP",49
50,"50294",64,49,47,0,2,"PP",20
30,"30036",15256,10884,10703,56,181,"PP",2742
21,"21059",220,184,180,0,4,"PP",10
46,"46089",2170,1692,1672,6,20,"PP",350
42,"42201",23,20,20,0,0,"PP",6
19,"19113",446,352,342,3,10,"PP",75
49,"49270",137,111,111,0,0,"PP",25
15,"15010",1819,1194,1181,16,13,"PP",476
6,"6005",1691,1246,1225,15,21,"PP",163
47,"47095",41,36,34,2,2,"PP",9
47,"47033",204,167,167,2,0,"PP",49
18,"18049",596,485,481,0,4,"PP",144
37,"37374",1147,946,923,4,23,"PP",297
42,"42068",78,62,61,2,1,"PP",15
34,"34084",155,127,126,1,1,"PP",45
47,"47036",205,162,157,1,5,"PP",55
47,"47121",521,429,422,5,7,"PP",104
28,"28165",1910,1443,1430,11,13,"PP",383
43,"43022",1435,1130,1123,8,7,"PP",102
38,"38034",3998,3033,2993,19,40,"PP",409
29,"29066",346,266,266,2,0,"PP",61
39,"39075",136968,104358,103487,690,871,"PP",24625
14,"14066",5756,4396,4310,36,86,"PP",648
10,"10124",858,710,701,3,9,"PP",181
7,"7040",288348,192799,191053,1586,1746,"PP",28287
30,"30025",5001,3951,3898,27,53,"PP",775
15,"15019",26006,18323,18075,280,248,"PP",4459
50,"50274",66,48,47,0,1,"PP",17
18,"18098",5994,4293,4247,29,46,"PP",823
17,"17224",302,233,231,2,2,"PP",7
8,"8197",7896,6197,6174,28,23,"PP",360
8,"8285",10321,8169,8120,52,49,"PP",145
17,"17207",2411,2006,1992,8,14,"PP",40
8,"8238",14851,12472,12428,50,44,"PP",502
17,"17178",1056,804,798,3,6,"PP",20
8,"8229",521,435,433,3,2,"PP",13
8,"8241",69,56,56,0,0,"PP",2
17,"17077",567,434,434,2,0,"PP",10
8,"8083",1672,1478,1471,7,7,"PP",11
8,"8044",4136,3193,3175,11,18,"PP",106
8,"8307",49310,38223,38022,162,201,"PP",1311
17,"17093",922,716,715,2,1,"PP",20
17,"17153",188,162,162,0,0,"PP",1
17,"17165",634,516,512,3,4,"PP",16
17,"17100",195,157,154,0,3,"PP",1
17,"17016",719,584,581,1,3,"PP",20
17,"17142",2673,2250,2241,14,9,"PP",84
17,"17197",131,113,113,1,0,"PP",0
8,"8214",6966,5648,5633,21,15,"PP",216
17,"17074",532,436,426,2,10,"PP",19
8,"8189",122,106,106,0,0,"PP",2
8,"8122",1716,1260,1254,8,6,"PP",31
17,"17030",650,479,477,4,2,"PP",28
8,"8200",62161,48645,48330,261,315,"PP",2330
8,"8278",4893,4034,4018,17,16,"PP",54
17,"17181",3467,2664,2648,10,16,"PP",92
8,"8199",651,542,542,4,0,"PP",21
8,"8119",6838,5352,5326,31,26,"PP",196
17,"17168",379,332,329,0,3,"PP",4
8,"8152",116,94,94,0,0,"PP",2
17,"17136",195,156,155,0,1,"PP",5
8,"8166",962,753,745,7,8,"PP",20
17,"17200",623,512,510,1,2,"PP",10
8,"8161",11625,8521,8470,44,51,"PP",361
8,"8267",6748,5389,5362,28,27,"PP",176
8,"8249",272,248,248,2,0,"PP",7
8,"8040",11004,8468,8431,24,37,"PP",367
8,"8117",2480,2055,2050,16,5,"PP",65
8,"8287",1057,877,871,7,6,"PP",15
17,"17151",185,150,150,1,0,"PP",10
17,"17061",183,148,148,0,0,"PP",5
17,"17155",14861,10307,10234,52,73,"PP",387
8,"8298",26980,20900,20817,91,83,"PP",518
17,"17161",1018,859,855,1,4,"PP",14
8,"8059",344,292,290,2,2,"PP",10
17,"17171",172,143,141,0,2,"PP",1
17,"17038",380,312,308,3,4,"PP",4
17,"17065",324,254,253,0,1,"PP",0
8,"8198",4640,3713,3691,23,22,"PP",107
8,"8175",3368,2496,2486,16,10,"PP",109
8,"8230",7666,6202,6168,30,34,"PP",297
8,"8039",402,334,334,2,0,"PP",1
17,"17046",710,574,571,3,3,"PP",12
17,"17194",78,62,62,0,0,"PP",1
8,"8105",9724,7557,7505,49,52,"PP",414
8,"8070",266,232,232,0,0,"PP",3
8,"8025",1535,1221,1214,7,7,"PP",50
8,"8139",177,156,156,0,0,"PP",1
8,"8305",27533,21656,21539,96,117,"PP",757
8,"8135",6735,5445,5421,36,24,"PP",318
17,"17184",1264,1068,1060,5,8,"PP",14
8,"8035",12871,9574,9538,31,36,"PP",437
8,"8258",813,661,657,6,4,"PP",10
8,"8303",256,215,213,1,2,"PP",1
17,"17210",580,449,445,2,4,"PP",14
8,"8221",12699,10571,10537,53,34,"PP",582
8,"8063",467,406,405,3,1,"PP",3
17,"17010",327,264,263,2,1,"PP",0
8,"8022",12219,9089,9038,42,51,"PP",210
17,"17086",1745,1223,1210,7,13,"PP",85
17,"17185",2275,1777,1768,7,9,"PP",27
8,"8194",25674,17691,17585,115,106,"PP",1033
8,"8211",33731,27698,27561,126,137,"PP",1351
8,"8057",61,50,50,0,0,"PP",1
8,"8100",2092,1792,1782,16,10,"PP",38
17,"17089",5695,4211,4194,13,17,"PP",122
17,"17013",2774,2180,2173,15,7,"PP",84
17,"17054",347,271,271,0,0,"PP",5
17,"17110",1329,1064,1054,5,10,"PP",50
8,"8295",11184,8566,8529,43,37,"PP",387
17,"17004",533,445,441,3,4,"PP",3
8,"8089",34019,26317,26191,170,126,"PP",1438
8,"8162",2124,1659,1651,7,8,"PP",72
8,"8206",737,625,624,3,1,"PP",6
17,"17023",27144,20301,20146,120,155,"PP",847
8,"8216",25,19,19,0,0,"PP",0
8,"8215",2589,2044,2034,19,10,"PP",51
17,"17125",131,98,97,1,1,"PP",3
8,"8239",460,380,378,2,2,"PP",8
8,"8016",1812,1454,1448,6,6,"PP",33
8,"8290",1534,1289,1284,9,5,"PP",29
17,"17043",167,135,134,0,1,"PP",0
8,"8302",9373,7001,6934,61,67,"PP",296
17,"17203",165,135,135,0,0,"PP",1
8,"8026",193,161,161,1,0,"PP",4
8,"8062",1004,829,826,11,3,"PP",20
17,"17190",838,681,677,0,4,"PP",14
17,"17009",4051,3263,3248,14,15,"PP",56
8,"8056",42727,33215,33054,220,161,"PP",2421
8,"8202",12843,10074,10025,57,49,"PP",304
17,"17098",303,245,245,2,0,"PP",5
8,"8053",2865,2105,2098,17,7,"PP",79
8,"8090",137,113,113,2,0,"PP",6
17,"17174",162,132,132,4,0,"PP",0
8,"8264",4535,3623,3613,13,10,"PP",202
8,"8195",76,69,69,0,0,"PP",1
17,"17139",1394,1163,1154,3,9,"PP",9
8,"8079",334,284,282,0,2,"PP",1
8,"8030",5209,4318,4305,16,13,"PP",146
17,"17901",983,790,789,3,1,"PP",12
8,"8181",8061,6442,6402,28,40,"PP",228
8,"8073",62572,48770,48527,255,243,"PP",2793
8,"8048",569,442,442,2,0,"PP",10
8,"8179",611,496,493,2,3,"PP",13
17,"17075",334,282,281,5,1,"PP",12
17,"17050",674,585,582,5,3,"PP",7
8,"8074",11054,8273,8235,34,38,"PP",406
17,"17211",831,694,691,1,3,"PP",10
17,"17080",144,124,124,2,0,"PP",4
17,"17102",548,439,435,3,4,"PP",12
17,"17192",146,121,120,0,1,"PP",9
17,"17134",223,189,189,1,0,"PP",1
17,"17126",318,279,279,0,0,"PP",2
17,"17157",124,107,107,0,0,"PP",1
8,"8294",2063,1644,1643,10,1,"PP",35
8,"8227",2410,1882,1877,10,5,"PP",54
8,"8233",1846,1485,1478,8,7,"PP",13
17,"17005",460,336,331,0,5,"PP",8
8,"8086",14017,10746,10677,89,69,"PP",405
17,"17147",7959,6164,6130,45,34,"PP",177
8,"8136",11614,9159,9079,84,80,"PP",518
8,"8212",491,406,402,1,4,"PP",9
8,"8148",2334,1803,1794,6,9,"PP",72
17,"17073",1939,1695,1693,7,2,"PP",43
17,"17228",285,229,229,1,0,"PP",6
17,"17082",436,341,339,0,2,"PP",11
8,"8240",9453,7807,7776,21,31,"PP",217
17,"17170",180,147,147,2,0,"PP",1
8,"8134",842,649,646,3,3,"PP",24
8,"8188",115,95,95,0,0,"PP",3
17,"17079",65381,50872,50631,242,241,"PP",1863
17,"17218",570,468,465,5,3,"PP",10
8,"8219",15629,12910,12865,58,45,"PP",484
17,"17114",23269,17558,17474,91,84,"PP",421
17,"17029",199,160,157,1,3,"PP",4
8,"8142",139,126,126,1,0,"PP",0
17,"17120",820,604,598,3,6,"PP",25
8,"8125",25485,19719,19627,101,92,"PP",852
8,"8014",2000,1578,1567,5,11,"PP",45
8,"8169",48284,37528,37326,218,202,"PP",1894
8,"8293",228,187,187,1,0,"PP",1
8,"8129",484,406,405,3,1,"PP",4
8,"8120",7048,5892,5881,49,11,"PP",298
8,"8155",6960,5427,5390,39,37,"PP",168
17,"17204",596,461,460,2,1,"PP",18
8,"8006",11774,9039,8981,33,58,"PP",356
17,"17001",580,459,454,3,5,"PP",6
8,"8126",8865,7125,7098,33,27,"PP",262
17,"17084",231,181,180,1,1,"PP",5
17,"17096",164,113,113,1,0,"PP",2
17,"17191",166,145,144,2,1,"PP",0
8,"8015",156003,117736,117183,704,553,"PP",7567
17,"17186",3824,3115,3098,15,17,"PP",86
8,"8109",208,184,183,0,1,"PP",6
8,"8031",2336,1886,1882,11,4,"PP",75
8,"8066",1463,1185,1181,9,4,"PP",63
8,"8268",971,746,737,3,9,"PP",20
17,"17034",7205,5337,5291,16,46,"PP",196
8,"8055",541,443,442,2,1,"PP",8
8,"8242",222,180,180,0,0,"PP",10
8,"8093",24,20,20,0,0,"PP",0
17,"17234",179,147,146,2,1,"PP",3
17,"17041",218,166,165,3,1,"PP",5
17,"17105",247,194,194,1,0,"PP",3
8,"8099",753,565,561,2,4,"PP",8
17,"17209",615,519,517,2,2,"PP",7
8,"8263",21151,16360,16269,116,91,"PP",717
17,"17132",1333,1088,1080,9,8,"PP",22
8,"8156",11155,8956,8923,60,33,"PP",354
8,"8280",95,78,78,1,0,"PP",1
17,"17092",3467,2660,2633,17,27,"PP",84
17,"17052",134,104,104,1,0,"PP",3
8,"8065",1180,967,964,4,3,"PP",27
8,"8193",984,792,790,5,2,"PP",41
8,"8275",248,223,222,1,1,"PP",2
17,"17177",567,459,457,2,2,"PP",8
8,"8047",3737,2903,2876,16,27,"PP",123
17,"17117",14471,10565,10504,52,61,"PP",360
17,"17006",1186,880,878,10,2,"PP",26
8,"8184",54876,41661,41447,248,214,"PP",1921
17,"17033",5587,4157,4130,13,27,"PP",139
17,"17024",285,228,227,0,1,"PP",9
8,"8185",197,172,171,2,1,"PP",6
8,"8068",6878,5456,5437,25,19,"PP",256
17,"17146",3127,2404,2381,11,23,"PP",74
17,"17111",958,772,771,3,1,"PP",14
17,"17166",547,460,459,2,1,"PP",5
8,"8138",4432,3435,3413,10,22,"PP",71
8,"8114",18648,14251,14170,69,81,"PP",657
17,"17143",144,115,115,0,0,"PP",3
8,"8036",163,134,133,0,1,"PP",1
8,"8115",3825,2994,2975,12,19,"PP",107
8,"8080",39,30,30,0,0,"PP",2
17,"17214",723,584,580,7,4,"PP",18
8,"8279",155280,121081,120515,802,566,"PP",5127
8,"8106",7469,5816,5795,34,21,"PP",257
17,"17169",2497,2047,2042,8,5,"PP",37
8,"8001",9079,7383,7341,40,42,"PP",358
17,"17195",342,296,295,3,1,"PP",3
17,"17091",398,310,305,2,5,"PP",4
17,"17055",143,126,125,0,1,"PP",2
8,"8225",94,81,81,1,0,"PP",1
8,"8121",87292,67638,67328,362,310,"PP",3377
8,"8306",527,390,388,2,2,"PP",15
17,"17076",122,101,100,1,1,"PP",3
17,"17164",3932,3078,3054,8,24,"PP",41
8,"8196",19444,15361,15263,90,98,"PP",701
8,"8274",4674,3710,3698,12,12,"PP",119
17,"17124",1599,1258,1254,6,4,"PP",26
8,"8107",11900,9303,9187,43,116,"PP",417
8,"8289",4457,3605,3594,20,11,"PP",94
8,"8113",52518,39750,39592,198,158,"PP",1464
8,"8222",1819,1484,1476,11,8,"PP",53
17,"17223",800,623,616,5,7,"PP",18
8,"8011",1745,1414,1407,10,7,"PP",18
8,"8163",19497,14616,14548,67,68,"PP",811
8,"8027",720,592,588,3,4,"PP",25
17,"17083",2961,2321,2300,12,21,"PP",61
8,"8284",12482,8959,8887,41,72,"PP",314
17,"17039",1740,1385,1380,8,5,"PP",28
8,"8108",5192,4204,4189,26,15,"PP",239
17,"17064",326,263,261,2,2,"PP",6
8,"8071",241,200,200,0,0,"PP",3
17,"17036",2643,2076,2071,12,5,"PP",53
8,"8232",1786,1444,1434,9,10,"PP",42
8,"8149",984,770,768,3,2,"PP",14
17,"17121",229,184,184,1,0,"PP",1
8,"8091",5413,4301,4283,20,18,"PP",126
8,"8111",215,200,199,4,1,"PP",6
8,"8137",274,232,229,0,3,"PP",7
8,"8140",4778,3756,3737,19,19,"PP",126
8,"8141",4573,3611,3595,26,16,"PP",105
8,"8273",2353,1944,1934,9,10,"PP",51
8,"8251",5127,3972,3940,17,32,"PP",166
17,"17137",3467,2925,2912,15,13,"PP",55
8,"8092",3714,2912,2889,8,23,"PP",80
8,"8046",13478,10989,10939,67,50,"PP",337
17,"17159",626,487,483,1,4,"PP",11
8,"8192",5679,4605,4589,20,16,"PP",95
8,"8127",2240,1694,1683,13,11,"PP",59
8,"8145",2701,2156,2144,7,12,"PP",42
8,"8277",171,150,150,0,0,"PP",4
8,"8041",10692,7805,7732,48,73,"PP",446
8,"8228",288,239,239,2,0,"PP",9
8,"8101",174954,129953,129198,680,755,"PP",8619
8,"8252",24729,19751,19642,125,109,"PP",995
8,"8067",5728,4535,4513,21,22,"PP",122
17,"17226",895,673,669,3,4,"PP",48
8,"8013",1280,1040,1031,5,9,"PP",25
17,"17063",173,157,156,2,1,"PP",3
17,"17154",99,84,83,0,1,"PP",0
8,"8172",20417,16196,16144,88,52,"PP",610
8,"8076",16497,12734,12667,82,67,"PP",543
17,"17145",1432,1113,1103,7,10,"PP",28
8,"8902",3937,3176,3164,17,12,"PP",110
8,"8021",61,47,45,0,2,"PP",1
8,"8217",25355,20935,20855,110,80,"PP",992
8,"8042",2362,1910,1904,7,6,"PP",97
8,"8082",1143,868,861,4,7,"PP",37
8,"8143",2719,2121,2109,10,12,"PP",72
17,"17213",5535,3998,3985,20,13,"PP",132
17,"17042",408,313,311,0,2,"PP",6
8,"8009",9480,7649,7620,35,29,"PP",330
8,"8903",197,177,176,0,1,"PP",2
17,"17175",564,381,381,1,0,"PP",10
17,"17118",12916,9521,9460,37,61,"PP",288
8,"8146",1358,1086,1079,2,7,"PP",36
17,"17021",122,98,98,0,0,"PP",0
17,"17070",110,94,94,0,0,"PP",0
8,"8246",1672,1412,1406,7,6,"PP",18
8,"8183",4563,3628,3613,9,15,"PP",54
8,"8164",934,784,776,1,8,"PP",15
8,"8270",18837,14541,14497,66,44,"PP",826
17,"17018",494,405,402,1,3,"PP",8
8,"8144",713,565,563,5,2,"PP",28
8,"8291",4919,3865,3854,28,11,"PP",131
17,"17144",210,171,170,0,1,"PP",4
8,"8078",219,176,172,1,4,"PP",2
8,"8153",559,460,458,2,2,"PP",4
17,"17230",499,397,393,0,4,"PP",15
17,"17138",845,650,646,0,4,"PP",32
8,"8061",1590,1236,1233,8,3,"PP",52
17,"17160",14733,10833,10766,43,67,"PP",364
17,"17109",698,558,553,1,5,"PP",4
17,"17060",408,311,311,1,0,"PP",23
17,"17049",3204,2634,2615,9,19,"PP",46
8,"8104",653,516,516,2,0,"PP",13
17,"17069",364,286,284,2,2,"PP",18
17,"17206",155,118,115,0,3,"PP",5
8,"8301",49135,38575,38398,272,177,"PP",1790
8,"8064",1920,1516,1506,6,10,"PP",24
8,"8257",103,86,86,1,0,"PP",1
8,"8008",179,139,138,0,1,"PP",2
17,"17187",625,530,529,4,1,"PP",12
8,"8005",6380,5122,5106,18,16,"PP",187
17,"17903",889,726,721,4,5,"PP",10
17,"17158",468,337,336,1,1,"PP",16
8,"8223",1886,1434,1425,4,9,"PP",45
17,"17035",550,460,460,3,0,"PP",9
17,"17094",1068,772,766,1,6,"PP",26
8,"8123",19489,16197,16135,58,62,"PP",436
8,"8304",816,686,678,1,8,"PP",12
17,"17133",1273,1048,1043,7,5,"PP",15
8,"8132",361,281,281,2,0,"PP",9
8,"8247",980,832,828,3,4,"PP",11
8,"8077",34578,27617,27501,134,116,"PP",1985
17,"17216",155,127,124,0,3,"PP",1
8,"8203",2472,1884,1873,4,11,"PP",68
8,"8052",139,111,110,0,1,"PP",5
8,"8112",12935,9822,9765,74,57,"PP",282
17,"17099",78,59,59,0,0,"PP",7
17,"17087",222,177,176,0,1,"PP",7
8,"8177",39,31,31,0,0,"PP",1
17,"17037",114,98,98,6,0,"PP",1
8,"8170",442,338,338,0,0,"PP",5
8,"8147",17282,13644,13560,94,84,"PP",455
8,"8081",353,299,297,2,2,"PP",3
17,"17025",1170,972,967,6,5,"PP",23
8,"8118",17542,14101,14059,56,42,"PP",521
8,"8075",4059,3127,3119,14,8,"PP",134
8,"8262",6919,5090,5060,33,30,"PP",143
17,"17051",207,174,173,3,1,"PP",5
8,"8004",209,194,191,0,3,"PP",0
8,"8283",6113,4832,4813,33,19,"PP",100
8,"8265",1590,1339,1334,6,5,"PP",12
8,"8159",14323,11399,11359,57,40,"PP",454
8,"8151",448,378,377,2,1,"PP",11
17,"17032",1742,1235,1224,6,11,"PP",15
17,"17088",578,468,468,1,0,"PP",8
8,"8049",1320,981,977,5,4,"PP",23
8,"8260",18400,14471,14406,87,65,"PP",607
8,"8102",28794,22420,22317,92,103,"PP",923
8,"8128",577,454,451,0,3,"PP",8
8,"8017",2827,2192,2182,16,10,"PP",41
17,"17148",1531,1165,1153,4,12,"PP",24
8,"8243",156,139,139,0,0,"PP",2
8,"8032",2087,1607,1598,9,9,"PP",55
17,"17215",2227,1936,1925,12,11,"PP",42
8,"8084",1167,941,936,6,5,"PP",31
17,"17044",6930,5514,5493,26,21,"PP",121
17,"17152",11026,7610,7564,70,46,"PP",422
17,"17106",143,124,123,0,1,"PP",4
8,"8103",640,507,505,4,2,"PP",12
17,"17149",364,314,314,0,0,"PP",2
8,"8226",926,811,807,1,4,"PP",11
8,"8054",9155,7468,7428,43,40,"PP",293
8,"8167",6048,4833,4822,48,11,"PP",173
17,"17057",968,826,822,1,4,"PP",18
8,"8281",4840,4009,3998,23,11,"PP",143
17,"17129",144,120,120,1,0,"PP",9
8,"8209",6896,5269,5244,25,25,"PP",321
8,"8282",6711,5696,5677,27,19,"PP",227
17,"17014",63,51,50,0,1,"PP",1
17,"17107",269,221,219,2,2,"PP",6
8,"8012",1721,1340,1331,8,9,"PP",26
8,"8051",18437,14951,14887,85,64,"PP",509
17,"17189",1476,1278,1275,2,3,"PP",8
8,"8180",27072,21218,21100,126,118,"PP",1072
8,"8096",43555,34070,33871,194,199,"PP",1490
17,"17205",211,184,184,1,0,"PP",0
17,"17902",1306,1076,1074,3,2,"PP",24
8,"8276",233,180,180,0,0,"PP",2
8,"8224",878,697,695,1,2,"PP",11
8,"8110",13592,10111,10058,50,53,"PP",422
8,"8210",4584,3455,3435,23,20,"PP",93
8,"8234",3373,2742,2734,25,8,"PP",121
17,"17015",12819,10133,10078,38,55,"PP",247
17,"17212",142,117,117,2,0,"PP",2
17,"17183",255,216,216,0,0,"PP",8
8,"8292",1062,835,831,3,4,"PP",27
17,"17167",2609,2122,2102,14,20,"PP",53
17,"17056",1766,1438,1433,9,5,"PP",27
8,"8154",701,587,586,5,1,"PP",11
8,"8024",357,301,298,1,3,"PP",8
17,"17066",27323,18373,18269,98,104,"PP",1027
8,"8191",5270,4176,4162,19,14,"PP",135
8,"8269",2712,2258,2250,19,8,"PP",45
17,"17071",1128,978,978,3,0,"PP",14
17,"17140",639,539,527,4,12,"PP",14
17,"17115",278,226,222,2,4,"PP",5
17,"17201",143,120,120,0,0,"PP",2
17,"17221",4152,3260,3247,11,13,"PP",176
8,"8255",137,105,105,1,0,"PP",0
8,"8176",161,132,131,2,1,"PP",14
17,"17182",272,220,220,3,0,"PP",6
8,"8085",976,812,811,2,1,"PP",25
8,"8019",1117818,875679,872180,4327,3499,"PP",53767
17,"17067",697,581,578,4,3,"PP",9
8,"8088",12248,9945,9904,57,41,"PP",318
17,"17208",976,772,768,5,4,"PP",11
17,"17128",316,255,252,1,3,"PP",3
8,"8130",108,89,86,2,3,"PP",0
8,"8043",3378,2579,2569,20,10,"PP",113
17,"17062",5978,4358,4334,26,24,"PP",138
8,"8069",3280,2691,2680,17,11,"PP",98
17,"17123",345,304,303,4,1,"PP",3
8,"8259",6904,5626,5601,27,25,"PP",160
8,"8023",6915,5339,5299,26,40,"PP",202
8,"8002",220,184,183,2,1,"PP",2
17,"17150",1426,1199,1192,8,7,"PP",21
17,"17019",1784,1472,1462,3,10,"PP",14
17,"17199",6955,5328,5308,23,20,"PP",134
8,"8220",2411,2119,2115,13,4,"PP",23
8,"8288",1676,1196,1182,6,14,"PP",34
8,"8271",67,57,57,0,0,"PP",0
8,"8160",316,252,247,2,5,"PP",2
8,"8286",2919,2210,2199,15,11,"PP",77
17,"17095",19938,13998,13918,69,80,"PP",688
17,"17196",242,198,198,1,0,"PP",9
8,"8905",2308,1943,1938,7,5,"PP",45
17,"17176",123,110,110,1,0,"PP",2
17,"17026",543,450,449,4,1,"PP",8
8,"8171",2066,1607,1597,7,10,"PP",31
8,"8058",1787,1357,1340,5,17,"PP",53
17,"17220",805,673,665,2,8,"PP",13
8,"8116",558,459,459,0,0,"PP",8
8,"8254",1753,1485,1482,3,3,"PP",11
8,"8174",392,330,330,4,0,"PP",5
17,"17047",4968,3447,3429,22,18,"PP",160
8,"8157",8547,6949,6918,39,31,"PP",300
17,"17020",3671,3021,3006,11,15,"PP",40
8,"8201",447,327,324,5,3,"PP",8
17,"17217",353,312,311,1,1,"PP",2
8,"8187",153380,120687,120090,637,597,"PP",4810
17,"17232",149,117,116,0,1,"PP",4
8,"8244",6041,4994,4970,33,24,"PP",161
8,"8045",71,52,49,0,3,"PP",0
8,"8038",1525,1228,1220,2,8,"PP",25
17,"17103",5084,3575,3543,13,32,"PP",114
8,"8060",135,111,109,0,2,"PP",7
8,"8205",61279,51629,51497,360,132,"PP",2546
17,"17193",4312,3202,3179,15,23,"PP",107
8,"8250",7182,5461,5421,38,40,"PP",225
8,"8253",128,113,113,0,0,"PP",0
17,"17003",102,75,75,0,0,"PP",2
17,"17112",194,154,152,2,2,"PP",5
8,"8213",6547,5270,5245,23,25,"PP",172
8,"8231",21132,15940,15880,75,60,"PP",595
17,"17135",395,309,307,0,2,"PP",8
8,"8178",451,389,388,3,1,"PP",11
8,"8097",1080,891,880,2,11,"PP",8
17,"17172",457,352,349,1,3,"PP",1
17,"17008",3594,2763,2741,16,22,"PP",51
8,"8018",2551,1998,1984,6,14,"PP",48
8,"8299",377,318,317,0,1,"PP",3
8,"8190",258,216,215,1,1,"PP",4
8,"8029",3560,3027,3019,13,8,"PP",118
8,"8050",136,115,114,0,1,"PP",0
8,"8007",6775,5447,5419,21,28,"PP",128
17,"17162",156,114,111,1,3,"PP",2
17,"17233",2328,1924,1912,6,12,"PP",36
8,"8003",7183,5761,5742,39,19,"PP",256
8,"8208",5760,4660,4643,25,17,"PP",184
8,"8010",4207,3327,3304,13,23,"PP",72
8,"8204",3115,2548,2534,22,14,"PP",56
17,"17180",8500,6462,6431,28,31,"PP",137
17,"17011",651,544,544,4,0,"PP",10
8,"8207",2014,1736,1730,9,6,"PP",24
8,"8296",1843,1520,1514,10,6,"PP",59
8,"8131",741,585,585,4,0,"PP",11
17,"17078",336,252,251,3,1,"PP",8
8,"8098",2409,1916,1912,9,4,"PP",79
8,"8261",2378,1821,1815,14,6,"PP",67
17,"17085",291,248,246,0,2,"PP",5
17,"17028",297,238,237,1,1,"PP",6
8,"8308",137,118,118,0,0,"PP",1
17,"17007",1752,1430,1422,2,8,"PP",30
17,"17090",544,469,468,0,1,"PP",10
8,"8272",165,133,133,0,0,"PP",3
17,"17031",182,130,129,0,1,"PP",5
17,"17048",6251,4565,4537,20,28,"PP",215
17,"17116",354,283,282,0,1,"PP",2
8,"8034",784,648,646,1,2,"PP",10
17,"17081",248,192,190,0,2,"PP",4
17,"17163",2824,2358,2351,13,7,"PP",31
8,"8236",1557,1204,1202,2,2,"PP",53
8,"8028",1088,783,780,2,3,"PP",42
8,"8158",3108,2458,2453,13,5,"PP",82
17,"17225",207,161,161,0,0,"PP",7
8,"8245",77805,57956,57666,313,290,"PP",3441
17,"17202",3813,2876,2851,8,25,"PP",115
8,"8124",37130,29069,28915,146,154,"PP",1282
8,"8266",43383,35117,34994,178,123,"PP",1751
17,"17141",6072,4251,4221,14,30,"PP",206
8,"8218",8104,6419,6389,34,30,"PP",227
8,"8133",128,98,98,5,0,"PP",5
17,"17227",139,106,106,0,0,"PP",0
17,"17198",433,332,329,0,3,"PP",9
8,"8235",3829,3176,3167,14,9,"PP",76
8,"8182",2892,2217,2204,18,13,"PP",62
8,"8904",10514,7733,7697,38,36,"PP",376
17,"17173",182,156,156,0,0,"PP",6
8,"8020",5172,4337,4327,26,10,"PP",121
8,"8256",691,571,568,3,3,"PP",12
8,"8094",1586,1310,1306,10,4,"PP",37
17,"17002",564,491,488,3,3,"PP",13
8,"8297",135,111,111,1,0,"PP",2
8,"8248",5616,4378,4365,32,13,"PP",137
17,"17012",1171,916,914,10,2,"PP",26
8,"8300",5892,4912,4880,24,32,"PP",185
8,"8095",67,53,52,0,1,"PP",1
17,"17130",322,268,268,0,0,"PP",2
8,"8168",394,287,287,1,0,"PP",41
8,"8165",1664,1315,1311,9,4,"PP",40
17,"17027",2866,2375,2364,8,11,"PP",58
17,"17058",170,139,139,0,0,"PP",6
8,"8150",251,211,211,0,0,"PP",1
8,"8237",1662,1334,1327,7,7,"PP",24
17,"17188",169,139,138,1,1,"PP",2
17,"17101",562,415,413,2,2,"PP",9
17,"17119",73,58,58,2,0,"PP",1
8,"8087",149,135,133,0,2,"PP",6
17,"17022",7008,5386,5354,22,32,"PP",113
17,"17068",246,194,193,0,1,"PP",2
8,"8901",240,203,201,1,2,"PP",4
17,"17222",105,95,95,1,0,"PP",0
8,"8033",13218,10480,10435,50,45,"PP",382
17,"17097",199,172,170,1,2,"PP",3
8,"8037",1930,1618,1610,10,8,"PP",24
8,"8072",10699,8226,8193,45,33,"PP",330
17,"17040",551,465,459,4,6,"PP",8
25,"25222",66,57,57,0,0,"PP",4
25,"25048",1632,1274,1264,7,10,"PP",40
25,"25901",287,209,207,1,2,"PP",5
25,"25140",773,573,571,5,2,"PP",13
25,"25009",605,505,491,5,14,"PP",30
25,"25017",232,184,181,0,3,"PP",6
25,"25004",575,470,467,2,3,"PP",11
25,"25247",147,100,100,2,0,"PP",10
25,"25068",531,402,399,6,3,"PP",10
25,"25210",1079,867,853,4,14,"PP",43
25,"25202",108,75,75,0,0,"PP",1
25,"25122",1925,1505,1497,23,8,"PP",51
25,"25181",175,136,135,0,1,"PP",12
25,"25094",139,116,116,0,0,"PP",7
25,"25253",145,122,121,0,1,"PP",4
25,"25250",330,261,258,1,3,"PP",11
25,"25058",4358,3269,3254,7,15,"PP",98
25,"25126",284,233,232,1,1,"PP",5
25,"25164",357,264,261,4,3,"PP",12
25,"25209",1550,1192,1172,4,20,"PP",37
25,"25211",672,513,512,6,1,"PP",19
25,"25204",1191,936,930,5,6,"PP",38
25,"25191",321,248,244,3,4,"PP",17
25,"25024",352,273,272,0,1,"PP",1
25,"25156",784,608,605,4,3,"PP",22
25,"25165",276,221,219,1,2,"PP",5
25,"25118",327,241,239,2,2,"PP",11
25,"25193",767,614,606,6,8,"PP",16
25,"25061",80,59,58,0,1,"PP",0
25,"25012",2342,1748,1739,10,9,"PP",69
25,"25216",241,199,199,2,0,"PP",8
25,"25030",123,90,90,1,0,"PP",4
25,"25192",724,564,558,4,6,"PP",22
25,"25906",210,157,155,0,2,"PP",3
25,"25089",97,72,71,1,1,"PP",0
25,"25163",236,181,179,3,2,"PP",8
25,"25006",317,246,245,3,1,"PP",14
25,"25142",365,300,299,2,1,"PP",9
25,"25014",249,203,200,2,3,"PP",4
25,"25151",736,592,584,1,8,"PP",15
25,"25032",67,53,53,0,0,"PP",0
25,"25239",595,367,366,3,1,"PP",9
25,"25158",1606,1291,1277,5,14,"PP",30
25,"25251",713,562,558,4,4,"PP",30
25,"25037",366,286,284,3,2,"PP",14
25,"25157",162,137,137,4,0,"PP",0
25,"25036",184,144,143,0,1,"PP",8
25,"25064",98,88,88,0,0,"PP",1
25,"25152",144,106,106,1,0,"PP",3
25,"25001",139,104,103,1,1,"PP",0
25,"25111",113,90,89,0,1,"PP",2
25,"25141",152,118,118,1,0,"PP",6
25,"25189",2164,1591,1583,11,8,"PP",54
25,"25113",1116,912,908,8,4,"PP",30
25,"25230",1555,1221,1208,8,13,"PP",62
25,"25148",219,168,168,1,0,"PP",3
25,"25121",635,436,429,1,7,"PP",28
25,"25180",228,176,174,1,2,"PP",3
25,"25905",369,308,307,1,1,"PP",19
25,"25056",213,163,163,3,0,"PP",0
25,"25119",2245,1798,1792,10,6,"PP",54
25,"25238",205,163,163,2,0,"PP",2
25,"25019",4646,3224,3199,22,25,"PP",206
25,"25149",1378,1108,1102,3,6,"PP",44
25,"25217",10819,8163,8120,64,43,"PP",253
25,"25200",323,253,252,0,1,"PP",6
25,"25033",1121,899,890,5,9,"PP",18
25,"25029",1607,1270,1265,6,5,"PP",47
25,"25183",535,419,416,4,3,"PP",10
25,"25254",711,576,571,5,5,"PP",41
25,"25052",1562,1273,1264,3,9,"PP",34
25,"25219",149,118,118,1,0,"PP",5
25,"25913",86,77,77,0,0,"PP",1
25,"25103",136,103,102,2,1,"PP",3
25,"25046",407,349,347,1,2,"PP",16
25,"25232",1356,1066,1061,2,5,"PP",53
25,"25166",172,137,136,1,1,"PP",16
25,"25245",430,346,342,1,4,"PP",13
25,"25023",4527,3621,3601,23,20,"PP",156
25,"25055",163,130,129,0,1,"PP",4
25,"25130",183,142,140,0,2,"PP",0
25,"25021",2541,1891,1882,14,9,"PP",61
25,"25131",402,321,320,1,1,"PP",13
25,"25011",5260,3908,3871,30,37,"PP",187
25,"25105",103,89,88,1,1,"PP",1
25,"25228",3115,2468,2459,19,9,"PP",83
25,"25137",8686,6327,6296,46,31,"PP",252
25,"25041",528,399,396,4,3,"PP",9
25,"25902",542,449,439,3,10,"PP",26
25,"25123",189,151,151,0,0,"PP",0
25,"25085",141,118,117,2,1,"PP",5
25,"25911",424,332,331,1,1,"PP",8
25,"25051",1510,1176,1172,6,4,"PP",21
25,"25022",107,88,88,0,0,"PP",2
25,"25104",122,91,91,0,0,"PP",6
25,"25231",494,410,408,2,2,"PP",24
25,"25909",140,108,107,2,1,"PP",1
25,"25031",57,39,39,0,0,"PP",6
25,"25908",221,159,158,1,1,"PP",6
25,"25194",415,325,325,3,0,"PP",24
25,"25015",335,262,260,8,2,"PP",9
25,"25069",425,329,327,1,2,"PP",4
25,"25146",221,172,170,3,2,"PP",7
25,"25049",155,113,111,0,2,"PP",2
25,"25903",229,189,188,0,1,"PP",3
25,"25027",977,765,763,4,2,"PP",29
25,"25047",972,784,781,8,3,"PP",30
25,"25062",695,578,573,3,5,"PP",12
25,"25225",541,427,420,4,7,"PP",19
25,"25007",1392,1089,1083,4,6,"PP",42
25,"25127",214,172,172,0,0,"PP",1
25,"25110",2731,2121,2106,14,15,"PP",46
25,"25169",167,118,117,0,1,"PP",5
25,"25057",214,162,161,0,1,"PP",13
25,"25175",176,135,135,1,0,"PP",11
25,"25003",3721,2828,2815,19,13,"PP",115
25,"25910",91,70,67,2,3,"PP",1
25,"25172",1779,1407,1405,3,2,"PP",74
25,"25218",86,79,79,0,0,"PP",0
25,"25035",366,306,302,2,4,"PP",9
25,"25143",84,72,71,0,1,"PP",4
25,"25205",562,451,447,7,4,"PP",24
25,"25039",261,216,216,1,0,"PP",6
25,"25212",224,195,195,2,0,"PP",11
25,"25114",95,79,79,0,0,"PP",0
25,"25190",257,215,215,0,0,"PP",1
25,"25045",54,31,31,5,0,"PP",6
25,"25070",811,677,675,4,2,"PP",17
25,"25234",4201,3087,3072,13,15,"PP",118
25,"25097",84,72,72,1,0,"PP",4
25,"25076",134,94,93,0,1,"PP",0
25,"25244",362,296,294,2,2,"PP",8
25,"25185",679,493,491,6,2,"PP",12
25,"25002",467,357,356,2,1,"PP",16
25,"25044",178,145,144,6,1,"PP",14
25,"25093",629,489,487,4,2,"PP",16
25,"25010",196,156,155,2,1,"PP",0
25,"25100",184,145,144,1,1,"PP",2
25,"25215",505,299,299,4,0,"PP",10
25,"25249",176,139,138,1,1,"PP",7
25,"25020",274,221,221,2,0,"PP",14
25,"25240",1385,1116,1110,10,6,"PP",68
25,"25092",127,101,99,1,2,"PP",1
25,"25074",180,157,155,2,2,"PP",6
25,"25206",250,189,188,2,1,"PP",2
25,"25077",440,331,330,1,1,"PP",6
25,"25168",488,408,407,6,1,"PP",33
25,"25197",141,109,108,0,1,"PP",1
25,"25233",285,231,229,2,2,"PP",10
25,"25904",162,147,147,3,0,"PP",4
25,"25078",1001,807,805,5,2,"PP",27
25,"25038",1482,1111,1094,11,17,"PP",128
25,"25170",261,230,228,4,2,"PP",4
25,"25071",42,32,31,0,1,"PP",1
25,"25186",207,174,173,7,1,"PP",8
25,"25060",69,49,49,1,0,"PP",2
25,"25224",126,98,98,0,0,"PP",0
25,"25075",131,102,102,0,0,"PP",0
25,"25013",2108,1570,1557,12,13,"PP",98
25,"25907",497,389,386,2,3,"PP",11
25,"25072",5874,4468,4450,24,18,"PP",204
25,"25098",232,172,170,2,2,"PP",2
25,"25128",127,87,87,0,0,"PP",1
25,"25059",813,621,612,3,9,"PP",67
25,"25176",307,262,259,1,3,"PP",20
25,"25139",491,390,388,3,2,"PP",5
25,"25082",295,229,229,2,0,"PP",2
25,"25138",547,440,436,1,4,"PP",21
25,"25171",2127,1639,1630,8,9,"PP",28
25,"25161",343,243,243,0,0,"PP",7
25,"25203",8798,6279,6231,26,48,"PP",322
25,"25208",333,252,249,0,3,"PP",3
25,"25101",543,454,449,1,5,"PP",6
25,"25005",274,202,202,2,0,"PP",3
25,"25179",171,134,134,1,0,"PP",0
25,"25136",96,79,79,2,0,"PP",6
25,"25207",6430,4899,4867,41,32,"PP",136
25,"25912",843,685,684,4,1,"PP",125
25,"25088",95,85,83,0,2,"PP",1
25,"25226",242,184,183,4,1,"PP",1
25,"25154",118,94,94,0,0,"PP",3
25,"25252",557,424,422,4,2,"PP",14
25,"25227",664,517,517,1,0,"PP",6
25,"25150",165,136,133,0,3,"PP",9
25,"25177",358,270,268,1,2,"PP",14
25,"25248",880,714,713,4,1,"PP",23
25,"25086",521,414,411,2,3,"PP",4
25,"25073",546,420,418,2,2,"PP",9
25,"25134",603,492,490,1,2,"PP",15
25,"25196",112,94,93,0,1,"PP",5
25,"25115",801,638,637,4,1,"PP",14
25,"25242",689,539,531,0,8,"PP",26
25,"25040",10614,7791,7734,58,57,"PP",394
25,"25167",226,185,185,2,0,"PP",14
25,"25079",285,228,227,0,1,"PP",10
25,"25221",117,92,92,0,0,"PP",4
25,"25053",1092,879,873,8,6,"PP",37
25,"25129",159,115,115,2,0,"PP",3
25,"25096",888,663,661,2,2,"PP",27
25,"25042",208,160,160,1,0,"PP",10
25,"25124",157,114,114,0,0,"PP",9
25,"25173",1649,1278,1262,5,16,"PP",55
25,"25008",1088,867,857,7,10,"PP",55
25,"25067",706,537,532,4,5,"PP",35
25,"25135",1000,773,769,2,4,"PP",32
25,"25223",911,732,723,6,9,"PP",13
25,"25109",214,179,176,3,3,"PP",8
25,"25182",1043,842,839,9,3,"PP",44
25,"25099",1291,981,978,2,3,"PP",32
25,"25133",686,528,527,2,1,"PP",14
25,"25050",3269,2457,2446,23,11,"PP",77
25,"25153",192,152,150,1,2,"PP",13
25,"25081",287,221,220,2,1,"PP",7
25,"25145",76,66,66,1,0,"PP",1
25,"25155",618,493,489,2,4,"PP",16
25,"25025",1378,996,983,8,13,"PP",80
25,"25063",95,61,61,0,0,"PP",10
25,"25125",389,303,300,1,3,"PP",19
25,"25016",2083,1590,1587,8,3,"PP",56
25,"25102",661,517,511,8,6,"PP",25
25,"25132",143,118,118,0,0,"PP",5
25,"25034",2288,1733,1719,9,14,"PP",63
25,"25255",395,321,318,2,3,"PP",11
25,"25043",801,613,606,1,7,"PP",9
25,"25243",3730,2637,2606,20,31,"PP",221
25,"25087",56,49,49,0,0,"PP",0
25,"25174",390,324,324,0,0,"PP",9
25,"25201",110,89,89,0,0,"PP",5
25,"25220",994,822,816,3,6,"PP",36
25,"25120",92704,68713,68361,445,352,"PP",4687
25,"25112",268,214,212,2,2,"PP",9
33,"33032",11086,8028,7849,129,179,"PP-FORO",1009
33,"33043",658,462,455,4,7,"PP-FORO",88
33,"33028",1158,635,630,6,5,"PP-FORO",146
33,"33009",869,595,591,5,4,"PP-FORO",136
33,"33052",704,520,513,5,7,"PP-FORO",79
33,"33031",33854,23523,23143,307,380,"PP-FORO",2958
33,"33016",18904,14376,14235,168,141,"PP-FORO",2727
33,"33050",558,381,375,2,6,"PP-FORO",114
33,"33055",1492,1156,1121,6,35,"PP-FORO",224
33,"33002",9474,6779,6662,74,117,"PP-FORO",1290
33,"33010",1724,1211,1202,15,9,"PP-FORO",201
33,"33073",8186,5090,5023,65,67,"PP-FORO",1253
33,"33036",11335,8356,8243,92,113,"PP-FORO",1832
33,"33007",1398,960,951,9,9,"PP-FORO",231
33,"33019",2882,1981,1939,8,42,"PP-FORO",488
33,"33030",873,678,671,1,7,"PP-FORO",177
33,"33033",9439,6565,6468,78,97,"PP-FORO",908
33,"33011",10659,6448,6332,119,116,"PP-FORO",1778
33,"33070",3293,2499,2473,32,26,"PP-FORO",609
33,"33034",10043,6765,6671,69,94,"PP-FORO",1490
33,"33049",6044,4152,4079,56,73,"PP-FORO",779
33,"33057",1538,1129,1097,14,32,"PP-FORO",140
33,"33026",8270,5540,5474,69,66,"PP-FORO",1019
33,"33015",1428,1003,993,7,10,"PP-FORO",193
33,"33077",1118,772,761,4,11,"PP-FORO",331
33,"33025",8996,6369,6309,81,60,"PP-FORO",1119
33,"33037",33247,23529,23210,297,319,"PP-FORO",3072
33,"33006",1480,1001,992,9,9,"PP-FORO",128
33,"33039",1641,1251,1243,6,8,"PP-FORO",206
33,"33058",1664,1205,1176,5,29,"PP-FORO",122
33,"33020",13000,9476,9338,108,138,"PP-FORO",1296
33,"33018",2819,2072,2044,28,28,"PP-FORO",566
33,"33014",8771,6425,6368,51,57,"PP-FORO",1064
33,"33003",612,373,369,6,4,"PP-FORO",100
33,"33017",2997,2096,2058,29,38,"PP-FORO",522
33,"33078",126,87,85,0,2,"PP-FORO",22
33,"33051",6811,4879,4809,63,70,"PP-FORO",961
33,"33068",1047,624,620,8,4,"PP-FORO",126
33,"33071",563,413,407,2,6,"PP-FORO",95
33,"33074",3376,2345,2311,41,34,"PP-FORO",583
33,"33008",1705,1285,1273,9,12,"PP-FORO",344
33,"33047",1074,841,835,12,6,"PP-FORO",307
33,"33035",11226,8326,8252,112,74,"PP-FORO",1363
33,"33048",136,87,87,1,0,"PP-FORO",22
33,"33042",4243,3137,3103,36,34,"PP-FORO",550
33,"33005",1376,929,916,14,13,"PP-FORO",238
33,"33056",4877,3469,3420,30,49,"PP-FORO",740
33,"33041",7112,5251,5194,63,57,"PP-FORO",1085
33,"33075",253,139,135,1,4,"PP-FORO",33
33,"33046",483,370,367,6,3,"PP-FORO",128
33,"33072",1455,973,963,14,10,"PP-FORO",166
33,"33060",14132,9960,9794,135,166,"PP-FORO",1223
33,"33044",177352,134444,133352,1391,1092,"PP-FORO",27089
33,"33040",4566,3205,3150,50,55,"PP-FORO",609
33,"33029",323,172,170,2,2,"PP-FORO",39
33,"33024",225188,169937,168490,1483,1447,"PP-FORO",26611
33,"33062",388,250,245,9,5,"PP-FORO",37
33,"33001",1504,875,864,15,11,"PP-FORO",251
33,"33038",2234,1669,1644,16,25,"PP-FORO",212
33,"33054",1611,1145,1124,8,21,"PP-FORO",212
33,"33021",4361,3098,3043,31,55,"PP-FORO",660
33,"33061",350,201,200,2,1,"PP-FORO",51
33,"33069",3419,2557,2533,32,24,"PP-FORO",462
33,"33076",12147,8532,8452,104,80,"PP-FORO",2007
33,"33045",4382,3214,3156,23,58,"PP-FORO",622
33,"33066",42882,30942,30529,401,413,"PP-FORO",5056
33,"33027",769,505,497,14,8,"PP-FORO",111
33,"33067",747,608,596,9,12,"PP-FORO",93
33,"33059",4403,3007,2942,42,65,"PP-FORO",913
33,"33023",3271,2448,2397,35,51,"PP-FORO",497
33,"33012",5105,3601,3566,46,35,"PP-FORO",989
33,"33004",65515,48686,48245,511,441,"PP-FORO",7875
33,"33064",250,175,174,0,1,"PP-FORO",31
33,"33022",813,555,543,6,12,"PP-FORO",63
33,"33065",1084,761,746,18,15,"PP-FORO",164
33,"33053",1079,738,729,6,9,"PP-FORO",98
33,"33063",374,284,283,3,1,"PP-FORO",114
33,"33013",429,320,316,1,4,"PP-FORO",94
42,"42012",29,23,23,0,0,"PPSO",0
42,"42060",29,20,19,0,1,"PPSO",1
42,"42216",26,20,20,1,0,"PPSO",0
42,"42031",26,19,19,1,0,"PPSO",0
42,"42016",20,13,13,0,0,"PPSO",0
42,"42152",67,47,46,0,1,"PPSO",3
42,"42164",1589,1201,1172,10,29,"PPSO",72
42,"42201",23,20,20,0,0,"PPSO",0
42,"42006",152,115,112,2,3,"PPSO",3
42,"42127",38,27,27,1,0,"PPSO",0
42,"42190",92,74,73,1,1,"PPSO",4
42,"42079",21,18,18,1,0,"PPSO",4
42,"42045",276,212,209,2,3,"PPSO",14
42,"42011",17,11,11,0,0,"PPSO",1
42,"42185",25,20,20,0,0,"PPSO",2
42,"42088",60,53,53,0,0,"PPSO",4
42,"42001",251,186,186,2,0,"PPSO",4
42,"42003",66,55,55,0,0,"PPSO",14
42,"42098",9,8,8,0,0,"PPSO",2
42,"42050",27,21,21,1,0,"PPSO",2
42,"42084",20,16,16,0,0,"PPSO",2
42,"42111",279,209,208,3,1,"PPSO",19
42,"42131",52,37,37,0,0,"PPSO",1
42,"42118",21,13,13,1,0,"PPSO",0
42,"42207",47,41,41,0,0,"PPSO",0
42,"42193",16,7,7,0,0,"PPSO",0
42,"42140",14,13,12,0,1,"PPSO",1
42,"42115",95,77,77,1,0,"PPSO",14
42,"42027",73,63,63,0,0,"PPSO",3
42,"42010",21,18,16,0,2,"PPSO",0
42,"42206",8,4,4,0,0,"PPSO",0
42,"42036",40,34,33,2,1,"PPSO",0
42,"42116",42,30,30,1,0,"PPSO",2
42,"42078",1005,769,756,6,13,"PPSO",46
42,"42187",59,51,49,1,2,"PPSO",5
42,"42192",38,26,26,1,0,"PPSO",1
42,"42062",20,14,13,0,1,"PPSO",0
42,"42110",55,43,43,0,0,"PPSO",0
42,"42070",32,24,24,0,0,"PPSO",0
42,"42009",77,69,69,2,0,"PPSO",2
42,"42121",55,42,42,0,0,"PPSO",1
42,"42217",34,26,26,0,0,"PPSO",0
42,"42054",19,15,15,0,0,"PPSO",0
42,"42025",1134,824,813,6,11,"PPSO",19
42,"42056",28,25,24,0,1,"PPSO",2
42,"42184",56,42,41,1,1,"PPSO",5
42,"42043",3838,2897,2855,18,42,"PPSO",244
42,"42041",31,23,23,1,0,"PPSO",1
42,"42071",163,111,108,2,3,"PPSO",5
42,"42213",25,16,16,0,0,"PPSO",0
42,"42100",31,27,27,0,0,"PPSO",0
42,"42044",53,41,39,0,2,"PPSO",5
42,"42086",33,21,19,0,2,"PPSO",0
42,"42130",51,46,45,0,1,"PPSO",3
42,"42172",28,25,25,1,0,"PPSO",6
42,"42106",14,12,12,0,0,"PPSO",2
42,"42153",12,10,10,1,0,"PPSO",0
42,"42073",73,58,57,0,1,"PPSO",2
42,"42135",70,46,45,0,1,"PPSO",1
42,"42039",210,147,141,2,6,"PPSO",1
42,"42154",99,81,81,1,0,"PPSO",2
42,"42176",27,22,22,2,0,"PPSO",0
42,"42177",64,55,54,6,1,"PPSO",4
42,"42028",76,65,65,1,0,"PPSO",0
42,"42085",178,133,133,3,0,"PPSO",6
42,"42004",2294,1807,1767,22,40,"PPSO",145
42,"42042",49,42,42,1,0,"PPSO",0
42,"42191",180,129,129,1,0,"PPSO",1
42,"42015",32,23,23,1,0,"PPSO",7
42,"42037",29,19,18,0,1,"PPSO",1
42,"42178",101,75,75,0,0,"PPSO",2
42,"42033",50,45,44,1,1,"PPSO",3
42,"42202",20,12,11,0,1,"PPSO",0
42,"42162",2325,1721,1699,16,22,"PPSO",142
42,"42094",603,484,475,10,9,"PPSO",17
42,"42208",20,16,16,0,0,"PPSO",3
42,"42151",38,31,30,0,1,"PPSO",0
42,"42096",251,164,160,3,4,"PPSO",3
42,"42113",521,382,380,3,2,"PPSO",9
42,"42053",21,15,15,0,0,"PPSO",1
42,"42158",94,78,78,0,0,"PPSO",1
42,"42195",92,53,53,1,0,"PPSO",1
42,"42165",419,288,285,8,3,"PPSO",2
42,"42194",146,111,111,0,0,"PPSO",9
42,"42035",741,537,523,7,14,"PPSO",18
42,"42132",135,114,113,1,1,"PPSO",3
42,"42105",46,37,37,1,0,"PPSO",0
42,"42061",272,207,204,2,3,"PPSO",10
42,"42166",57,49,49,0,0,"PPSO",2
42,"42209",135,107,100,5,7,"PPSO",3
42,"42103",554,448,442,2,6,"PPSO",15
42,"42083",26,22,22,0,0,"PPSO",6
42,"42049",109,73,72,1,1,"PPSO",1
42,"42068",78,62,61,2,1,"PPSO",18
42,"42218",75,52,51,0,1,"PPSO",2
42,"42175",21,15,15,0,0,"PPSO",0
42,"42075",78,60,60,1,0,"PPSO",0
42,"42212",62,48,47,1,1,"PPSO",4
42,"42182",51,42,42,1,0,"PPSO",3
42,"42171",114,80,79,0,1,"PPSO",6
42,"42007",109,89,89,1,0,"PPSO",4
42,"42024",86,66,66,3,0,"PPSO",3
42,"42117",133,109,106,0,3,"PPSO",13
42,"42097",14,7,7,0,0,"PPSO",0
42,"42046",46,35,33,2,2,"PPSO",0
42,"42089",57,48,48,1,0,"PPSO",6
42,"42189",53,44,42,0,2,"PPSO",4
42,"42149",387,311,308,3,3,"PPSO",14
42,"42188",43,35,34,1,1,"PPSO",0
42,"42159",40,36,35,0,1,"PPSO",1
42,"42204",54,45,43,2,2,"PPSO",8
42,"42168",108,85,85,1,0,"PPSO",2
42,"42020",4186,3027,2988,28,39,"PPSO",480
42,"42032",142,120,120,0,0,"PPSO",4
42,"42181",391,319,317,0,2,"PPSO",27
42,"42058",102,84,84,0,0,"PPSO",1
42,"42057",147,95,93,3,2,"PPSO",2
42,"42018",131,102,102,1,0,"PPSO",14
42,"42160",247,195,194,4,1,"PPSO",1
42,"42163",46,37,37,0,0,"PPSO",1
42,"42030",89,72,72,0,0,"PPSO",11
42,"42059",20,13,13,0,0,"PPSO",3
42,"42123",158,118,118,2,0,"PPSO",11
42,"42142",45,35,35,0,0,"PPSO",1
42,"42014",60,44,44,1,0,"PPSO",0
42,"42055",165,124,122,2,2,"PPSO",2
42,"42019",511,384,378,7,6,"PPSO",55
42,"42219",40,33,32,1,1,"PPSO",0
42,"42029",131,98,97,2,1,"PPSO",6
42,"42157",10,10,10,0,0,"PPSO",0
42,"42161",135,104,104,0,0,"PPSO",2
42,"42119",145,90,89,6,1,"PPSO",2
42,"42095",1857,1498,1473,21,25,"PPSO",56
42,"42125",75,62,62,2,0,"PPSO",2
42,"42145",134,108,108,0,0,"PPSO",14
42,"42021",68,44,44,2,0,"PPSO",8
42,"42051",15,10,10,0,0,"PPSO",1
42,"42120",132,89,87,0,2,"PPSO",9
42,"42087",51,45,44,1,1,"PPSO",3
42,"42211",81,74,73,2,1,"PPSO",2
42,"42017",131,104,104,2,0,"PPSO",7
42,"42196",8,6,6,0,0,"PPSO",0
42,"42107",67,48,48,0,0,"PPSO",0
42,"42069",1491,1073,1048,20,25,"PPSO",25
42,"42013",37,29,29,0,0,"PPSO",1
42,"42023",60,49,48,0,1,"PPSO",1
42,"42008",56,41,41,0,0,"PPSO",0
42,"42139",21,15,15,1,0,"PPSO",0
42,"42080",150,116,116,1,0,"PPSO",9
42,"42065",23,18,18,2,0,"PPSO",0
42,"42082",7,7,7,0,0,"PPSO",0
42,"42156",29,23,23,0,0,"PPSO",0
42,"42108",10,7,7,0,0,"PPSO",0
42,"42090",88,69,68,2,1,"PPSO",6
42,"42063",47,31,28,0,3,"PPSO",0
42,"42200",76,54,53,0,1,"PPSO",1
42,"42052",17,15,15,0,0,"PPSO",3
42,"42174",179,132,128,1,4,"PPSO",4
42,"42144",423,338,336,4,2,"PPSO",5
42,"42048",60,50,50,0,0,"PPSO",2
42,"42134",2652,2028,1989,17,39,"PPSO",30
42,"42173",29702,22141,21776,301,365,"PPSO",699
42,"42124",58,41,41,0,0,"PPSO",0
42,"42022",206,161,161,1,0,"PPSO",10
42,"42128",46,41,41,0,0,"PPSO",1
42,"42167",236,183,182,3,1,"PPSO",10
42,"42183",106,83,83,1,0,"PPSO",7
42,"42197",68,56,56,0,0,"PPSO",4
42,"42092",62,42,41,1,1,"PPSO",0
42,"42034",44,36,36,1,0,"PPSO",2
42,"42076",201,157,151,0,6,"PPSO",15
42,"42141",114,89,89,0,0,"PPSO",8
42,"42215",735,540,529,5,11,"PPSO",13
42,"42198",19,15,15,0,0,"PPSO",1
42,"42081",136,95,93,0,2,"PPSO",8
42,"42129",678,540,539,1,1,"PPSO",23
42,"42205",85,64,62,0,2,"PPSO",3
42,"42064",85,71,71,0,0,"PPSO",1
42,"42148",9,9,9,0,0,"PPSO",2
42,"42155",142,92,92,0,0,"PPSO",4
42,"42026",22,20,20,0,0,"PPSO",2
42,"42093",35,29,29,2,0,"PPSO",0
42,"42038",34,27,27,1,0,"PPSO",6
26,"26102",6057,4672,4579,37,93,"PR+",71
26,"26135",153,123,123,1,0,"PR+",2
26,"26086",15,15,15,0,0,"PR+",0
26,"26059",1122,861,841,7,20,"PR+",12
26,"26005",2480,1687,1661,5,26,"PR+",6
26,"26106",76,66,65,0,1,"PR+",1
26,"26021",2752,2132,2105,10,27,"PR+",11
26,"26093",48,38,38,0,0,"PR+",1
26,"26073",94,72,68,0,4,"PR+",1
26,"26087",170,136,135,3,1,"PR+",0
26,"26046",1571,1185,1157,18,28,"PR+",31
26,"26002",827,643,639,5,4,"PR+",1
26,"26082",100,85,85,0,0,"PR+",4
26,"26051",210,178,176,1,2,"PR+",3
26,"26131",34,34,34,1,0,"PR+",0
26,"26041",114,84,84,0,0,"PR+",2
26,"26025",89,77,77,0,0,"PR+",0
26,"26112",223,177,174,0,3,"PR+",8
26,"26130",201,164,163,0,1,"PR+",1
26,"26153",10,9,9,0,0,"PR+",0
26,"26170",427,343,338,2,5,"PR+",0
26,"26098",99,77,77,1,0,"PR+",0
26,"26110",150,128,124,1,4,"PR+",1
26,"26058",143,116,115,2,1,"PR+",2
26,"26015",180,145,142,1,3,"PR+",10
26,"26024",210,171,169,1,2,"PR+",2
26,"26066",259,216,212,3,4,"PR+",2
26,"26034",612,509,497,5,12,"PR+",5
26,"26047",1879,1569,1549,10,20,"PR+",10
26,"26172",25,23,23,0,0,"PR+",2
26,"26178",71,57,56,1,1,"PR+",6
26,"26014",447,313,309,2,4,"PR+",10
26,"26168",5515,4130,4077,36,53,"PR+",71
26,"26142",784,651,641,5,10,"PR+",9
26,"26171",156,131,127,0,4,"PR+",3
26,"26108",290,241,237,0,4,"PR+",11
26,"26104",11,9,9,0,0,"PR+",0
26,"26118",72,63,60,1,3,"PR+",1
26,"26001",198,171,165,1,6,"PR+",3
26,"26145",237,207,204,0,3,"PR+",6
26,"26160",732,578,574,4,4,"PR+",5
26,"26050",130,97,97,0,0,"PR+",5
26,"26127",186,162,159,1,3,"PR+",1
26,"26054",292,235,231,2,4,"PR+",2
26,"26049",153,115,115,1,0,"PR+",0
26,"26126",29,29,29,1,0,"PR+",0
26,"26029",36,29,28,0,1,"PR+",0
26,"26026",1265,1061,1049,2,12,"PR+",14
26,"26068",79,62,62,1,0,"PR+",1
26,"26065",58,49,47,0,2,"PR+",0
26,"26173",6,6,6,0,0,"PR+",1
26,"26027",143,101,98,1,3,"PR+",2
26,"26077",17,17,17,0,0,"PR+",0
26,"26038",81,61,61,0,0,"PR+",1
26,"26167",50,38,38,1,0,"PR+",0
26,"26074",107,97,96,2,1,"PR+",1
26,"26067",20,19,19,0,0,"PR+",0
26,"26007",481,391,383,0,8,"PR+",7
26,"26063",118,96,95,2,1,"PR+",2
26,"26039",38,34,34,0,0,"PR+",0
26,"26152",27,23,23,1,0,"PR+",1
26,"26011",7229,5355,5277,64,78,"PR+",19
26,"26048",22,22,22,0,0,"PR+",0
26,"26144",188,161,160,1,1,"PR+",0
26,"26157",282,233,232,1,1,"PR+",12
26,"26143",242,190,189,0,1,"PR+",3
26,"26053",195,161,160,3,1,"PR+",0
26,"26062",86,74,72,1,2,"PR+",2
26,"26096",260,221,212,2,9,"PR+",4
26,"26003",389,329,328,1,1,"PR+",0
26,"26122",116,98,97,0,1,"PR+",2
26,"26013",323,258,256,1,2,"PR+",1
26,"26158",246,207,206,2,1,"PR+",3
26,"26037",131,99,98,1,1,"PR+",1
26,"26141",100,73,73,0,0,"PR+",0
26,"26161",8,7,7,0,0,"PR+",0
26,"26140",239,199,194,1,5,"PR+",0
26,"26088",41,38,38,0,0,"PR+",1
26,"26028",139,120,117,1,3,"PR+",2
26,"26036",17013,12543,12354,95,189,"PR+",95
26,"26072",285,252,247,1,5,"PR+",0
26,"26009",391,317,314,2,3,"PR+",1
26,"26179",41,33,32,0,1,"PR+",1
26,"26031",98,89,87,0,2,"PR+",1
26,"26180",223,182,177,3,5,"PR+",1
26,"26083",354,295,291,1,4,"PR+",16
26,"26101",34,27,27,0,0,"PR+",1
26,"26114",74,62,60,0,2,"PR+",0
26,"26064",2337,1764,1724,14,40,"PR+",9
26,"26147",34,30,29,0,1,"PR+",0
26,"26091",147,132,131,1,1,"PR+",1
26,"26100",56,46,46,0,0,"PR+",0
26,"26183",66,50,50,0,0,"PR+",0
26,"26017",354,293,290,4,3,"PR+",0
26,"26070",155,133,132,0,1,"PR+",2
26,"26132",106,87,87,0,0,"PR+",1
26,"26125",2663,2042,2011,32,31,"PR+",6
26,"26032",45,37,37,1,0,"PR+",2
26,"26016",28,24,23,0,1,"PR+",0
26,"26055",39,35,35,1,0,"PR+",0
26,"26040",63,51,50,0,1,"PR+",0
26,"26092",109,84,82,1,2,"PR+",2
26,"26020",454,347,337,4,10,"PR+",6
26,"26056",403,334,328,2,6,"PR+",2
26,"26044",51,44,42,0,2,"PR+",0
26,"26120",1460,1130,1109,3,21,"PR+",7
26,"26052",148,113,113,1,0,"PR+",3
26,"26146",86,69,69,1,0,"PR+",4
26,"26149",45,36,36,0,0,"PR+",3
26,"26175",47,40,40,2,0,"PR+",0
26,"26045",11,11,11,0,0,"PR+",0
26,"26113",31,30,30,0,0,"PR+",0
26,"26166",147,136,136,2,0,"PR+",2
26,"26174",132,116,116,5,0,"PR+",0
26,"26075",321,266,265,0,1,"PR+",3
26,"26124",776,635,624,5,11,"PR+",2
26,"26095",95,78,78,1,0,"PR+",3
26,"26134",83,70,67,0,3,"PR+",1
26,"26103",827,655,645,3,10,"PR+",3
26,"26004",66,54,54,0,0,"PR+",4
26,"26151",411,353,351,3,2,"PR+",1
26,"26012",33,28,26,0,2,"PR+",0
26,"26071",8662,6409,6288,52,121,"PR+",50
26,"26078",86,71,70,1,1,"PR+",0
26,"26010",85,68,68,1,0,"PR+",1
26,"26105",2211,1744,1723,19,21,"PR+",23
26,"26123",124,112,110,0,2,"PR+",0
26,"26094",69,56,56,0,0,"PR+",1
26,"26022",187,153,148,0,5,"PR+",3
26,"26117",2097,1680,1647,17,33,"PR+",5
26,"26080",453,385,383,2,2,"PR+",5
26,"26163",124,106,104,1,2,"PR+",0
26,"26139",55,43,43,0,0,"PR+",4
26,"26162",112,95,94,0,1,"PR+",4
26,"26033",163,143,142,3,1,"PR+",6
26,"26164",51,37,37,1,0,"PR+",0
26,"26019",350,270,256,3,14,"PR+",4
26,"26181",14,14,14,0,0,"PR+",0
26,"26154",10,10,10,1,0,"PR+",0
26,"26006",1825,1496,1470,8,26,"PR+",12
26,"26057",51,47,47,1,0,"PR+",0
26,"26061",1552,1228,1194,14,34,"PR+",6
26,"26155",149,119,119,0,0,"PR+",0
26,"26081",15,14,14,1,0,"PR+",0
26,"26035",16,14,13,0,1,"PR+",0
26,"26109",73,66,66,0,0,"PR+",0
26,"26177",301,250,246,2,4,"PR+",1
26,"26121",30,21,21,1,0,"PR+",0
26,"26018",10441,8400,8311,64,89,"PR+",70
26,"26176",53,48,48,0,0,"PR+",0
26,"26129",936,770,759,1,11,"PR+",25
26,"26138",4545,3433,3374,27,59,"PR+",37
26,"26089",111800,87863,86778,700,1085,"PR+",1153
26,"26008",1822,1436,1420,14,16,"PR+",7
26,"26030",17,17,17,0,0,"PR+",0
26,"26165",337,289,284,0,5,"PR+",0
26,"26136",92,80,80,3,0,"PR+",0
26,"26111",250,209,205,2,4,"PR+",3
26,"26119",177,150,147,2,3,"PR+",0
26,"26099",1216,993,973,14,20,"PR+",4
26,"26169",68,61,61,2,0,"PR+",0
26,"26069",230,187,186,0,1,"PR+",0
26,"26128",96,74,74,1,0,"PR+",0
26,"26060",75,60,60,1,0,"PR+",1
26,"26084",7187,5620,5558,36,62,"PR+",51
26,"26107",91,78,77,0,1,"PR+",1
26,"26043",349,272,268,2,4,"PR+",5
26,"26023",435,351,347,5,4,"PR+",0
26,"26042",799,605,596,5,9,"PR+",5
26,"26148",150,128,124,1,4,"PR+",1
26,"26150",100,83,83,0,0,"PR+",3
26,"26115",23,21,19,0,2,"PR+",0
26,"26079",620,526,521,0,5,"PR+",2
26,"26076",116,93,91,0,2,"PR+",2
39,"39073",10200,8230,8150,65,80,"PRC",884
39,"39046",1343,1002,988,8,14,"PRC",297
39,"39071",422,318,316,0,2,"PRC",90
39,"39078",1406,1101,1090,7,11,"PRC",252
39,"39047",1976,1564,1538,8,26,"PRC",424
39,"39068",649,515,509,7,6,"PRC",124
39,"39079",8861,6827,6745,47,82,"PRC",722
39,"39092",871,635,629,2,6,"PRC",77
39,"39080",3505,2735,2701,8,34,"PRC",332
39,"39085",6964,5489,5445,28,44,"PRC",860
39,"39066",877,711,705,5,6,"PRC",134
39,"39021",467,392,385,2,7,"PRC",34
39,"39051",73,65,64,0,1,"PRC",15
39,"39003",258,205,202,3,3,"PRC",63
39,"39023",6523,5205,5144,22,61,"PRC",919
39,"39067",759,582,575,3,7,"PRC",169
39,"39057",2367,1831,1796,14,35,"PRC",333
39,"39022",969,740,732,2,8,"PRC",110
39,"39102",2255,1711,1698,11,13,"PRC",291
39,"39096",670,523,518,2,5,"PRC",75
39,"39087",41381,32335,31995,194,340,"PRC",5135
39,"39043",1523,1246,1220,10,26,"PRC",186
39,"39045",351,280,277,1,3,"PRC",70
39,"39065",232,190,189,5,1,"PRC",41
39,"39061",3488,2833,2798,18,35,"PRC",373
39,"39044",3868,3019,2985,8,34,"PRC",439
39,"39013",535,434,431,1,3,"PRC",53
39,"39029",636,512,512,5,0,"PRC",116
39,"39034",257,167,162,2,5,"PRC",37
39,"39012",6737,5391,5314,52,77,"PRC",907
39,"39002",3414,2630,2578,23,52,"PRC",413
39,"39095",2240,1809,1778,12,31,"PRC",178
39,"39059",7577,5978,5916,47,62,"PRC",1028
39,"39040",4267,3428,3385,24,43,"PRC",491
39,"39005",1406,1127,1110,12,17,"PRC",119
39,"39017",553,416,409,0,7,"PRC",112
39,"39070",123,101,99,0,2,"PRC",19
39,"39074",7041,5612,5551,31,61,"PRC",1046
39,"39086",362,273,268,1,5,"PRC",39
39,"39004",1483,1181,1163,4,18,"PRC",297
39,"39093",302,256,256,2,0,"PRC",36
39,"39097",679,437,435,2,2,"PRC",67
39,"39041",1767,1437,1417,18,20,"PRC",234
39,"39049",306,209,208,4,1,"PRC",30
39,"39077",236,175,173,0,2,"PRC",28
39,"39011",1575,1249,1242,3,7,"PRC",260
39,"39020",23931,17782,17566,126,216,"PRC",1748
39,"39027",3066,2511,2467,15,44,"PRC",468
39,"39036",971,794,787,5,7,"PRC",116
39,"39006",1721,1332,1315,3,17,"PRC",193
39,"39033",540,430,423,1,7,"PRC",112
39,"39064",1341,1103,1094,5,9,"PRC",246
39,"39075",136968,104358,103487,690,871,"PRC",11292
39,"39099",3149,2562,2540,22,22,"PRC",605
39,"39015",824,646,644,2,2,"PRC",135
39,"39090",772,619,609,1,10,"PRC",144
39,"39056",2268,1847,1830,7,17,"PRC",439
39,"39101",236,173,171,1,2,"PRC",61
39,"39076",3483,2770,2734,21,36,"PRC",491
39,"39091",1885,1512,1503,6,9,"PRC",347
39,"39018",4272,3533,3476,17,57,"PRC",520
39,"39032",1426,1156,1141,8,15,"PRC",188
39,"39010",610,518,512,1,6,"PRC",130
39,"39069",1928,1650,1627,9,23,"PRC",648
39,"39050",255,188,184,2,4,"PRC",15
39,"39063",954,726,722,4,4,"PRC",152
39,"39058",800,574,573,1,1,"PRC",119
39,"39030",1895,1374,1358,6,16,"PRC",258
39,"39055",1075,836,829,8,7,"PRC",65
39,"39025",8703,6954,6854,39,100,"PRC",1181
39,"39024",1815,1436,1420,14,16,"PRC",295
39,"39083",1074,786,777,4,9,"PRC",278
39,"39084",874,718,712,4,6,"PRC",138
39,"39028",3870,3131,3094,19,37,"PRC",450
39,"39089",134,99,98,0,1,"PRC",48
39,"39009",3307,2545,2526,11,19,"PRC",488
39,"39019",2229,1785,1751,15,34,"PRC",354
39,"39088",59,51,51,0,0,"PRC",8
39,"39035",9169,7135,7045,40,90,"PRC",1322
39,"39081",437,356,347,2,9,"PRC",60
39,"39042",5930,4722,4676,26,46,"PRC",705
39,"39082",1622,1261,1252,16,9,"PRC",256
39,"39001",2065,1669,1643,16,26,"PRC",329
39,"39037",2019,1572,1560,2,12,"PRC",217
39,"39014",901,709,704,5,5,"PRC",152
39,"39008",13900,10895,10767,81,128,"PRC",1416
39,"39026",1720,1322,1312,5,10,"PRC",231
39,"39062",1841,1511,1500,9,11,"PRC",264
39,"39072",324,206,204,4,2,"PRC",27
39,"39038",1506,1093,1076,2,17,"PRC",190
39,"39098",1379,1154,1144,7,10,"PRC",352
39,"39052",18957,15123,14985,106,138,"PRC",1913
39,"39094",841,676,670,3,6,"PRC",207
39,"39054",4528,3614,3575,23,39,"PRC",679
39,"39053",213,146,145,2,1,"PRC",40
39,"39031",1245,990,983,5,7,"PRC",181
39,"39060",6693,5459,5394,29,65,"PRC",1010
39,"39100",849,650,644,9,6,"PRC",138
39,"39016",23868,19029,18839,108,190,"PRC",2336
39,"39007",393,300,298,1,2,"PRC",96
39,"39039",546,431,428,0,3,"PRC",94
39,"39048",1765,1429,1420,4,9,"PRC",250
24,"24003",608,430,418,0,12,"PREPAL",0
37,"37005",67,48,48,2,0,"PREPAL",0
49,"49263",45,37,37,0,0,"PREPAL",0
37,"37360",215,158,153,3,5,"PREPAL",1
24,"24141",101,78,78,0,0,"PREPAL",0
24,"24230",410,312,309,5,3,"PREPAL",1
49,"49043",265,210,208,1,2,"PREPAL",0
49,"49272",77,55,51,0,4,"PREPAL",0
49,"49224",169,117,115,0,2,"PREPAL",1
24,"24079",872,671,665,4,6,"PREPAL",5
24,"24105",1498,1188,1177,18,11,"PREPAL",3
37,"37321",149,121,121,0,0,"PREPAL",0
37,"37121",556,448,444,3,4,"PREPAL",0
37,"37343",66,50,48,1,2,"PREPAL",0
24,"24094",1326,982,966,4,16,"PREPAL",10
37,"37079",80,69,68,2,1,"PREPAL",0
37,"37127",200,145,145,1,0,"PREPAL",0
37,"37377",218,181,176,2,5,"PREPAL",1
37,"37235",219,170,166,4,4,"PREPAL",0
37,"37136",633,448,434,8,14,"PREPAL",1
49,"49165",55,53,50,0,3,"PREPAL",0
37,"37201",237,188,187,1,1,"PREPAL",1
49,"49138",208,159,154,2,5,"PREPAL",1
37,"37147",172,130,127,3,3,"PREPAL",0
49,"49036",508,361,355,6,6,"PREPAL",0
37,"37172",853,601,590,4,11,"PREPAL",4
49,"49114",40,33,32,1,1,"PREPAL",0
24,"24021",1602,1211,1194,7,17,"PREPAL",4
49,"49236",70,55,55,0,0,"PREPAL",0
37,"37141",152,120,119,2,1,"PREPAL",0
24,"24041",527,371,364,4,7,"PREPAL",0
37,"37253",133,107,103,0,4,"PREPAL",0
37,"37247",173,144,143,1,1,"PREPAL",0
37,"37097",44,29,29,0,0,"PREPAL",0
49,"49150",123,90,90,3,0,"PREPAL",0
49,"49063",310,246,240,2,6,"PREPAL",1
37,"37195",37,29,29,1,0,"PREPAL",0
24,"24120",311,209,209,0,0,"PREPAL",4
49,"49011",212,166,165,7,1,"PREPAL",1
24,"24151",445,334,328,3,6,"PREPAL",0
37,"37230",214,176,176,0,0,"PREPAL",0
49,"49157",192,153,149,0,4,"PREPAL",1
24,"24117",412,336,335,0,1,"PREPAL",0
24,"24104",245,173,172,1,1,"PREPAL",0
37,"37011",99,75,73,0,2,"PREPAL",0
49,"49260",700,558,548,8,10,"PREPAL",0
49,"49235",422,312,301,0,11,"PREPAL",1
37,"37042",41,32,31,1,1,"PREPAL",0
37,"37207",325,260,258,1,2,"PREPAL",1
37,"37313",534,413,411,1,2,"PREPAL",1
49,"49002",58,49,43,0,6,"PREPAL",0
37,"37142",566,446,444,6,2,"PREPAL",0
24,"24107",214,170,170,2,0,"PREPAL",0
24,"24154",955,702,691,3,11,"PREPAL",1
37,"37170",1370,1009,990,10,19,"PREPAL",0
24,"24221",750,563,553,6,10,"PREPAL",2
24,"24058",195,127,125,1,2,"PREPAL",1
37,"37357",258,0,0,0,0,"PREPAL",0
24,"24066",449,329,324,3,5,"PREPAL",4
24,"24015",2209,1714,1672,19,42,"PREPAL",12
37,"37117",1553,1245,1230,14,15,"PREPAL",4
37,"37306",242,184,181,2,3,"PREPAL",1
49,"49121",368,269,266,1,3,"PREPAL",0
24,"24129",111,91,91,1,0,"PREPAL",1
24,"24226",193,136,134,2,2,"PREPAL",0
24,"24155",442,374,371,6,3,"PREPAL",1
37,"37208",69,52,51,0,1,"PREPAL",0
37,"37122",203,174,174,1,0,"PREPAL",0
49,"49139",153,111,110,1,1,"PREPAL",0
37,"37109",177,149,149,3,0,"PREPAL",0
49,"49007",365,271,265,7,6,"PREPAL",2
37,"37239",206,184,181,3,3,"PREPAL",0
37,"37008",4222,3431,3393,19,38,"PREPAL",1
49,"49098",204,157,153,2,4,"PREPAL",3
49,"49124",237,169,166,1,3,"PREPAL",1
37,"37017",222,177,177,1,0,"PREPAL",0
49,"49246",217,180,177,2,3,"PREPAL",1
37,"37015",205,131,130,2,1,"PREPAL",1
37,"37287",309,215,214,3,1,"PREPAL",1
37,"37300",547,392,391,5,1,"PREPAL",0
37,"37179",196,172,169,0,3,"PREPAL",0
37,"37058",56,41,41,0,0,"PREPAL",0
24,"24067",606,375,371,2,4,"PREPAL",0
37,"37222",86,64,62,0,2,"PREPAL",0
24,"24142",24730,18823,18504,201,319,"PREPAL",151
37,"37354",5467,3960,3910,31,50,"PREPAL",4
24,"24149",146,123,123,0,0,"PREPAL",0
24,"24157",2545,2028,1972,25,56,"PREPAL",34
49,"49038",94,68,68,1,0,"PREPAL",0
37,"37325",90,70,70,0,0,"PREPAL",0
37,"37149",61,56,54,1,2,"PREPAL",0
49,"49156",230,189,182,0,7,"PREPAL",2
37,"37368",17,15,11,0,4,"PREPAL",0
24,"24901",860,642,630,7,12,"PREPAL",3
24,"24193",365,286,285,0,1,"PREPAL",1
37,"37310",172,125,124,3,1,"PREPAL",0
37,"37009",196,142,141,1,1,"PREPAL",0
37,"37158",233,168,166,0,2,"PREPAL",0
37,"37191",104,65,65,1,0,"PREPAL",0
24,"24006",487,393,387,3,6,"PREPAL",6
24,"24178",72,65,65,1,0,"PREPAL",0
24,"24007",753,569,563,4,6,"PREPAL",0
24,"24167",716,516,505,4,11,"PREPAL",5
49,"49119",222,181,180,0,1,"PREPAL",0
24,"24033",205,146,146,3,0,"PREPAL",0
49,"49219",7221,5301,5186,62,115,"PREPAL",9
49,"49173",344,220,216,1,4,"PREPAL",0
49,"49027",126,88,88,0,0,"PREPAL",1
37,"37107",10483,7732,7633,78,99,"PREPAL",12
37,"37062",77,65,63,0,2,"PREPAL",0
49,"49175",205,150,149,2,1,"PREPAL",1
49,"49028",105,94,93,1,1,"PREPAL",0
24,"24073",442,328,324,2,4,"PREPAL",3
49,"49050",504,351,351,3,0,"PREPAL",1
37,"37272",133,106,106,1,0,"PREPAL",1
49,"49179",346,233,232,0,1,"PREPAL",0
37,"37244",128,99,97,1,2,"PREPAL",0
37,"37257",49,40,40,1,0,"PREPAL",0
24,"24113",351,277,272,2,5,"PREPAL",2
49,"49145",210,133,131,1,2,"PREPAL",0
49,"49241",240,199,199,1,0,"PREPAL",1
49,"49166",1192,916,899,10,17,"PREPAL",1
24,"24136",496,375,371,2,4,"PREPAL",1
37,"37202",989,838,828,7,10,"PREPAL",9
24,"24083",1005,800,791,7,9,"PREPAL",2
37,"37282",194,148,146,1,2,"PREPAL",0
37,"37262",69,60,60,0,0,"PREPAL",0
37,"37366",41,30,30,0,0,"PREPAL",0
49,"49125",1401,1031,1010,7,21,"PREPAL",5
49,"49190",50,45,45,1,0,"PREPAL",0
37,"37375",673,583,573,4,10,"PREPAL",1
24,"24076",1286,998,981,8,17,"PREPAL",7
49,"49194",340,236,233,3,3,"PREPAL",2
49,"49067",336,236,232,0,4,"PREPAL",2
37,"37082",745,546,536,2,10,"PREPAL",0
49,"49239",617,437,420,7,17,"PREPAL",0
49,"49031",145,107,103,0,4,"PREPAL",1
37,"37275",101,69,67,0,2,"PREPAL",0
37,"37091",164,108,108,3,0,"PREPAL",0
24,"24024",638,463,452,8,11,"PREPAL",1
49,"49148",264,146,136,1,10,"PREPAL",0
49,"49178",747,574,564,4,10,"PREPAL",1
24,"24055",676,513,508,6,5,"PREPAL",3
24,"24112",299,226,223,1,3,"PREPAL",0
37,"37036",57,42,41,0,1,"PREPAL",0
37,"37050",67,54,54,0,0,"PREPAL",0
37,"37335",389,308,301,3,7,"PREPAL",1
49,"49039",327,255,246,6,9,"PREPAL",2
37,"37002",126,81,81,0,0,"PREPAL",1
37,"37080",212,173,169,0,4,"PREPAL",0
49,"49032",287,224,222,0,2,"PREPAL",3
49,"49158",203,163,155,0,8,"PREPAL",2
49,"49149",365,285,282,2,3,"PREPAL",2
24,"24183",752,549,543,8,6,"PREPAL",2
49,"49203",287,229,223,2,6,"PREPAL",0
49,"49188",110,87,86,0,1,"PREPAL",0
24,"24012",285,204,202,2,2,"PREPAL",1
37,"37033",92,69,69,2,0,"PREPAL",0
24,"24122",1319,983,969,3,14,"PREPAL",0
49,"49168",93,74,74,0,0,"PREPAL",0
24,"24228",626,432,426,3,6,"PREPAL",3
49,"49080",630,499,493,4,6,"PREPAL",1
24,"24181",1414,1067,1055,14,12,"PREPAL",3
37,"37181",264,185,184,1,1,"PREPAL",0
24,"24160",645,481,475,1,6,"PREPAL",3
37,"37211",212,164,163,1,1,"PREPAL",0
49,"49151",593,453,444,5,9,"PREPAL",0
37,"37026",175,148,148,2,0,"PREPAL",0
37,"37174",983,788,768,0,20,"PREPAL",0
49,"49159",269,214,213,1,1,"PREPAL",0
37,"37014",1153,414,411,4,3,"PREPAL",0
49,"49126",273,161,160,1,1,"PREPAL",0
24,"24212",1002,772,764,7,8,"PREPAL",9
37,"37129",252,206,202,2,4,"PREPAL",1
24,"24001",168,105,104,0,1,"PREPAL",2
37,"37031",336,261,258,3,3,"PREPAL",0
49,"49143",194,141,135,2,6,"PREPAL",0
24,"24081",122,91,88,0,3,"PREPAL",0
49,"49262",370,287,286,1,1,"PREPAL",0
24,"24150",224,176,174,2,2,"PREPAL",4
37,"37355",162,137,135,0,2,"PREPAL",0
49,"49191",266,216,214,1,2,"PREPAL",0
49,"49267",97,73,68,1,5,"PREPAL",0
24,"24087",586,469,460,4,9,"PREPAL",5
37,"37260",139,109,109,0,0,"PREPAL",0
37,"37271",351,286,280,0,6,"PREPAL",1
37,"37255",42,31,31,2,0,"PREPAL",0
24,"24029",695,521,520,4,1,"PREPAL",3
24,"24082",860,690,678,12,12,"PREPAL",10
37,"37045",28,19,18,0,1,"PREPAL",0
49,"49012",73,45,45,0,0,"PREPAL",0
37,"37376",2164,1606,1581,15,25,"PREPAL",1
37,"37231",239,204,203,6,1,"PREPAL",2
37,"37168",407,305,300,0,5,"PREPAL",0
37,"37046",10749,8133,7989,84,144,"PREPAL",6
49,"49021",14258,10333,10206,102,127,"PREPAL",46
49,"49116",360,255,248,5,7,"PREPAL",1
24,"24184",183,121,119,0,2,"PREPAL",0
24,"24109",876,635,619,3,16,"PREPAL",6
24,"24014",7180,5189,5097,46,92,"PREPAL",12
49,"49046",242,178,175,0,3,"PREPAL",0
37,"37057",209,165,162,2,3,"PREPAL",0
37,"37228",325,278,273,0,5,"PREPAL",0
49,"49025",159,126,124,0,2,"PREPAL",0
37,"37047",228,93,92,1,1,"PREPAL",2
37,"37241",164,129,127,0,2,"PREPAL",0
24,"24165",327,236,233,1,3,"PREPAL",0
24,"24118",104,66,66,0,0,"PREPAL",1
37,"37128",242,187,184,1,3,"PREPAL",0
37,"37254",175,141,140,1,1,"PREPAL",0
37,"37102",379,297,291,3,6,"PREPAL",0
37,"37346",252,214,213,3,1,"PREPAL",1
37,"37182",78,57,57,0,0,"PREPAL",0
37,"37246",5155,4153,4107,33,46,"PREPAL",9
49,"49035",222,195,195,2,0,"PREPAL",0
37,"37098",304,214,210,0,4,"PREPAL",0
24,"24102",608,457,448,3,9,"PREPAL",0
37,"37258",137,99,98,1,1,"PREPAL",0
37,"37049",127,89,89,0,0,"PREPAL",0
37,"37296",298,241,239,2,2,"PREPAL",0
24,"24098",1149,882,863,7,19,"PREPAL",6
24,"24046",899,678,663,7,15,"PREPAL",2
24,"24162",1772,1382,1369,22,13,"PREPAL",9
37,"37007",399,311,306,3,5,"PREPAL",0
24,"24047",720,531,523,2,8,"PREPAL",8
37,"37063",60,45,45,1,0,"PREPAL",0
24,"24222",14431,11296,11135,117,161,"PREPAL",76
37,"37159",79,68,68,0,0,"PREPAL",0
24,"24179",299,239,238,3,1,"PREPAL",1
37,"37012",145,116,114,0,2,"PREPAL",0
49,"49044",78,64,64,1,0,"PREPAL",0
24,"24121",616,491,484,4,7,"PREPAL",0
24,"24099",155,121,121,1,0,"PREPAL",0
24,"24088",995,813,802,12,11,"PREPAL",2
49,"49107",116,82,81,1,1,"PREPAL",0
49,"49214",664,519,510,2,9,"PREPAL",3
37,"37248",152,125,121,1,4,"PREPAL",1
24,"24189",5816,4434,4382,49,52,"PREPAL",29
37,"37315",86,68,67,0,1,"PREPAL",0
49,"49141",296,220,218,0,2,"PREPAL",2
37,"37341",48,36,36,0,0,"PREPAL",0
49,"49222",370,284,282,2,2,"PREPAL",1
49,"49009",389,305,304,2,1,"PREPAL",0
24,"24185",452,339,332,3,7,"PREPAL",2
24,"24224",574,435,427,3,8,"PREPAL",0
49,"49033",666,515,508,1,7,"PREPAL",4
37,"37112",152,104,103,0,1,"PREPAL",0
37,"37337",139,114,114,0,0,"PREPAL",0
24,"24050",105,88,87,3,1,"PREPAL",0
37,"37261",217,166,163,0,3,"PREPAL",0
37,"37206",91,66,63,1,3,"PREPAL",0
37,"37299",229,175,168,0,7,"PREPAL",0
37,"37362",4729,3769,3720,36,49,"PREPAL",5
49,"49133",291,213,211,0,2,"PREPAL",2
49,"49096",157,129,123,2,6,"PREPAL",1
37,"37250",332,232,231,1,1,"PREPAL",1
24,"24229",388,312,307,2,5,"PREPAL",0
37,"37225",99,90,86,1,4,"PREPAL",0
49,"49232",84,71,70,0,1,"PREPAL",0
37,"37137",99,65,65,0,0,"PREPAL",0
49,"49083",50,41,41,1,0,"PREPAL",0
37,"37212",101,85,83,0,2,"PREPAL",0
37,"37309",37,27,27,0,0,"PREPAL",0
49,"49093",280,239,238,2,1,"PREPAL",1
37,"37020",425,341,339,4,2,"PREPAL",0
37,"37297",401,319,315,2,4,"PREPAL",1
24,"24198",547,402,399,4,3,"PREPAL",0
37,"37351",269,234,233,6,1,"PREPAL",1
37,"37028",137,111,107,1,4,"PREPAL",0
49,"49004",111,77,77,4,0,"PREPAL",1
49,"49024",637,465,461,2,4,"PREPAL",0
49,"49184",170,122,121,0,1,"PREPAL",0
24,"24025",289,234,226,4,8,"PREPAL",2
37,"37200",196,145,145,0,0,"PREPAL",0
49,"49056",288,232,230,2,2,"PREPAL",0
37,"37264",55,42,42,0,0,"PREPAL",0
37,"37056",40,33,33,0,0,"PREPAL",0
37,"37353",122,95,95,1,0,"PREPAL",0
24,"24069",39,27,27,0,0,"PREPAL",0
49,"49037",177,146,143,1,3,"PREPAL",0
24,"24096",108,69,69,0,0,"PREPAL",0
37,"37245",335,240,240,5,0,"PREPAL",0
37,"37189",114,88,88,2,0,"PREPAL",0
49,"49185",156,126,120,1,6,"PREPAL",0
37,"37289",218,159,158,0,1,"PREPAL",0
49,"49234",399,339,333,2,6,"PREPAL",1
49,"49030",80,66,62,0,4,"PREPAL",0
37,"37018",110,86,85,1,1,"PREPAL",0
37,"37006",117,81,81,2,0,"PREPAL",0
24,"24201",1039,775,765,5,10,"PREPAL",9
37,"37068",340,256,256,3,0,"PREPAL",0
49,"49018",288,225,222,1,3,"PREPAL",2
49,"49164",139,103,102,2,1,"PREPAL",0
37,"37330",318,255,248,2,7,"PREPAL",1
37,"37367",185,150,148,4,2,"PREPAL",0
24,"24106",218,164,162,0,2,"PREPAL",0
49,"49258",110,93,92,0,1,"PREPAL",0
37,"37072",145,136,134,3,2,"PREPAL",0
37,"37342",255,200,199,1,1,"PREPAL",1
49,"49075",134,118,114,1,4,"PREPAL",0
24,"24202",7559,5449,5363,63,86,"PREPAL",18
24,"24133",356,267,267,4,0,"PREPAL",0
37,"37317",288,240,238,2,2,"PREPAL",0
49,"49252",304,244,241,6,3,"PREPAL",2
49,"49228",55,47,47,0,0,"PREPAL",0
37,"37103",414,309,309,4,0,"PREPAL",1
37,"37180",68,39,39,1,0,"PREPAL",0
49,"49237",143,95,93,0,2,"PREPAL",0
49,"49249",63,52,52,1,0,"PREPAL",0
37,"37243",90,71,70,0,1,"PREPAL",0
49,"49127",2430,1835,1799,30,36,"PREPAL",8
49,"49192",124,102,102,2,0,"PREPAL",0
49,"49020",261,215,210,2,5,"PREPAL",0
49,"49115",169,137,136,0,1,"PREPAL",0
37,"37256",195,152,150,0,2,"PREPAL",0
49,"49154",109,64,63,0,1,"PREPAL",1
24,"24108",348,268,265,2,3,"PREPAL",0
37,"37280",71,41,40,0,1,"PREPAL",0
37,"37139",187,162,157,2,5,"PREPAL",0
37,"37276",126,101,101,0,0,"PREPAL",0
37,"37252",101,80,79,1,1,"PREPAL",0
37,"37152",402,308,302,1,6,"PREPAL",1
37,"37218",48,29,29,0,0,"PREPAL",0
24,"24148",1616,1252,1237,11,15,"PREPAL",13
37,"37157",78,64,64,0,0,"PREPAL",0
49,"49251",161,125,124,0,1,"PREPAL",2
49,"49091",248,185,183,4,2,"PREPAL",1
49,"49193",435,303,287,1,16,"PREPAL",6
37,"37132",325,232,231,0,1,"PREPAL",2
24,"24005",345,255,250,2,5,"PREPAL",1
49,"49112",118,78,78,2,0,"PREPAL",0
49,"49117",437,340,335,1,5,"PREPAL",0
24,"24084",152,113,113,0,0,"PREPAL",1
37,"37120",97,83,81,1,2,"PREPAL",0
37,"37022",245,200,196,2,4,"PREPAL",0
37,"37133",101,84,80,0,4,"PREPAL",0
24,"24027",1219,913,886,8,27,"PREPAL",0
37,"37221",394,299,299,2,0,"PREPAL",0
49,"49266",70,51,49,2,2,"PREPAL",0
24,"24019",341,279,272,0,7,"PREPAL",0
37,"37234",317,224,222,1,2,"PREPAL",0
37,"37027",235,188,184,2,4,"PREPAL",1
49,"49048",114,85,85,0,0,"PREPAL",0
37,"37327",179,154,150,0,4,"PREPAL",0
37,"37379",173,152,152,0,0,"PREPAL",1
24,"24124",346,231,226,2,5,"PREPAL",2
49,"49170",98,75,75,1,0,"PREPAL",0
49,"49210",448,372,370,3,2,"PREPAL",0
49,"49118",194,151,151,1,0,"PREPAL",2
37,"37134",212,156,148,0,8,"PREPAL",0
37,"37092",1889,1459,1447,16,12,"PREPAL",1
37,"37284",314,241,237,2,4,"PREPAL",0
24,"24032",102,84,83,0,1,"PREPAL",0
24,"24100",754,602,598,7,4,"PREPAL",0
49,"49064",483,319,317,1,2,"PREPAL",6
49,"49255",396,324,323,3,1,"PREPAL",2
49,"49094",213,138,138,0,0,"PREPAL",0
37,"37065",271,187,184,0,3,"PREPAL",0
37,"37369",125,95,93,0,2,"PREPAL",1
24,"24017",538,427,424,2,3,"PREPAL",6
37,"37143",375,308,306,2,2,"PREPAL",1
37,"37320",88,67,67,1,0,"PREPAL",0
24,"24074",96,73,73,0,0,"PREPAL",1
24,"24206",1611,1286,1268,7,18,"PREPAL",0
37,"37052",278,201,199,2,2,"PREPAL",0
37,"37123",162,122,117,3,5,"PREPAL",0
37,"37349",103,69,68,0,1,"PREPAL",0
24,"24114",2893,2017,1989,17,28,"PREPAL",11
24,"24156",220,146,144,2,2,"PREPAL",1
37,"37324",335,276,274,1,2,"PREPAL",0
24,"24036",272,181,179,4,2,"PREPAL",0
37,"37286",203,147,142,2,5,"PREPAL",0
49,"49257",310,205,202,2,3,"PREPAL",2
37,"37067",3254,2742,2714,29,28,"PREPAL",10
37,"37338",78,66,64,0,2,"PREPAL",0
37,"37038",751,607,592,4,15,"PREPAL",2
49,"49014",116,89,88,2,1,"PREPAL",0
49,"49201",285,243,243,7,0,"PREPAL",0
37,"37087",910,755,747,3,8,"PREPAL",2
24,"24010",8268,5968,5847,66,121,"PREPAL",35
37,"37238",106,88,87,1,1,"PREPAL",0
37,"37154",129,106,102,3,4,"PREPAL",0
24,"24051",394,290,283,3,7,"PREPAL",1
24,"24145",618,443,435,3,8,"PREPAL",1
37,"37347",464,368,359,2,9,"PREPAL",1
37,"37055",118,96,95,0,1,"PREPAL",0
49,"49202",172,125,124,2,1,"PREPAL",0
37,"37083",176,160,156,1,4,"PREPAL",0
37,"37138",219,180,176,1,4,"PREPAL",0
49,"49015",201,157,155,0,2,"PREPAL",0
24,"24171",349,201,198,4,3,"PREPAL",0
49,"49233",85,58,58,0,0,"PREPAL",0
37,"37114",78,64,59,0,5,"PREPAL",0
24,"24052",139,99,99,0,0,"PREPAL",0
37,"37364",757,549,536,7,13,"PREPAL",1
24,"24146",251,206,204,1,2,"PREPAL",1
49,"49111",121,100,100,3,0,"PREPAL",0
37,"37188",160,115,112,3,3,"PREPAL",0
37,"37016",574,464,455,3,9,"PREPAL",0
24,"24092",745,606,601,6,5,"PREPAL",2
49,"49268",368,282,279,2,3,"PREPAL",1
49,"49016",229,189,187,2,2,"PREPAL",0
49,"49041",414,309,307,4,2,"PREPAL",0
37,"37365",166,132,131,1,1,"PREPAL",0
24,"24132",615,405,404,5,1,"PREPAL",3
49,"49136",312,227,220,3,7,"PREPAL",1
37,"37177",265,209,208,0,1,"PREPAL",0
49,"49071",715,500,499,3,1,"PREPAL",0
37,"37278",789,618,613,8,5,"PREPAL",0
37,"37290",134,113,112,0,1,"PREPAL",1
49,"49057",105,85,81,2,4,"PREPAL",0
49,"49273",166,111,110,0,1,"PREPAL",1
49,"49247",417,301,294,0,7,"PREPAL",0
49,"49137",170,138,134,0,4,"PREPAL",1
24,"24080",207,162,161,0,1,"PREPAL",0
49,"49248",174,142,139,2,3,"PREPAL",1
49,"49006",142,111,111,1,0,"PREPAL",0
37,"37044",450,342,335,6,7,"PREPAL",0
49,"49010",348,301,295,6,6,"PREPAL",3
49,"49042",230,179,174,1,5,"PREPAL",1
24,"24040",412,322,320,2,2,"PREPAL",1
49,"49181",335,227,224,2,3,"PREPAL",0
49,"49152",483,327,322,2,5,"PREPAL",1
37,"37030",81,68,65,0,3,"PREPAL",0
49,"49169",34,28,26,0,2,"PREPAL",0
37,"37291",269,212,209,2,3,"PREPAL",0
37,"37304",159,105,105,0,0,"PREPAL",0
37,"37267",182,153,150,1,3,"PREPAL",0
24,"24163",4073,3269,3231,36,38,"PREPAL",15
24,"24134",3294,2540,2479,25,61,"PREPAL",19
37,"37217",59,48,46,1,2,"PREPAL",0
24,"24175",1831,1433,1412,17,21,"PREPAL",3
37,"37318",199,152,152,1,0,"PREPAL",0
24,"24028",365,297,290,2,7,"PREPAL",4
24,"24095",307,237,235,0,2,"PREPAL",0
24,"24016",507,314,311,2,3,"PREPAL",0
24,"24188",3820,3107,3056,33,51,"PREPAL",16
37,"37074",140,107,106,1,1,"PREPAL",0
37,"37021",69,52,51,1,1,"PREPAL",0
37,"37344",235,171,168,1,3,"PREPAL",1
49,"49085",918,673,660,5,13,"PREPAL",0
49,"49264",540,372,369,1,3,"PREPAL",2
24,"24057",1306,1018,997,7,21,"PREPAL",1
37,"37156",4276,2621,2572,27,49,"PREPAL",4
37,"37232",378,322,321,1,1,"PREPAL",0
37,"37281",39,34,33,0,1,"PREPAL",0
37,"37269",430,331,325,2,6,"PREPAL",1
37,"37034",75,66,66,0,0,"PREPAL",1
49,"49078",142,113,113,1,0,"PREPAL",0
37,"37090",66,51,51,1,0,"PREPAL",0
37,"37106",249,173,173,1,0,"PREPAL",0
37,"37358",164,142,135,2,7,"PREPAL",0
24,"24207",278,242,235,0,7,"PREPAL",0
49,"49227",313,255,254,1,1,"PREPAL",0
49,"49265",120,93,92,1,1,"PREPAL",1
24,"24139",2087,1558,1540,20,18,"PREPAL",3
49,"49240",185,141,136,0,5,"PREPAL",0
49,"49079",103,91,79,1,12,"PREPAL",0
37,"37178",99,82,82,0,0,"PREPAL",0
37,"37145",244,187,185,3,2,"PREPAL",1
37,"37144",338,275,273,1,2,"PREPAL",0
24,"24115",53267,39733,39172,433,561,"PREPAL",59
49,"49109",562,445,444,5,1,"PREPAL",0
49,"49244",49,32,32,1,0,"PREPAL",0
49,"49271",181,147,144,1,3,"PREPAL",0
37,"37171",397,297,292,1,5,"PREPAL",0
37,"37146",102,86,86,1,0,"PREPAL",0
24,"24059",821,575,572,3,3,"PREPAL",0
49,"49229",113,88,87,0,1,"PREPAL",0
37,"37359",163,122,117,0,5,"PREPAL",1
49,"49197",162,129,123,2,6,"PREPAL",1
49,"49259",79,62,61,0,1,"PREPAL",1
37,"37322",2466,1764,1723,17,41,"PREPAL",1
24,"24131",677,468,463,1,5,"PREPAL",3
24,"24060",574,371,369,1,2,"PREPAL",6
37,"37024",88,69,69,0,0,"PREPAL",0
24,"24020",434,302,299,1,3,"PREPAL",3
37,"37372",134,104,104,0,0,"PREPAL",0
37,"37037",107,86,86,0,0,"PREPAL",0
49,"49199",241,174,171,4,3,"PREPAL",0
24,"24068",443,343,336,1,7,"PREPAL",7
49,"49256",242,204,202,4,2,"PREPAL",1
49,"49081",1322,1051,1030,11,21,"PREPAL",2
37,"37273",88,67,67,0,0,"PREPAL",0
37,"37081",871,725,717,4,8,"PREPAL",1
49,"49066",449,319,314,4,5,"PREPAL",1
49,"49243",109,86,83,0,3,"PREPAL",0
37,"37237",304,238,234,0,4,"PREPAL",0
37,"37173",1420,1077,1058,13,19,"PREPAL",3
49,"49172",481,316,310,2,6,"PREPAL",0
37,"37224",189,168,165,0,3,"PREPAL",0
24,"24009",278,154,151,2,3,"PREPAL",0
49,"49013",229,176,175,4,1,"PREPAL",1
24,"24211",263,219,214,3,5,"PREPAL",1
24,"24023",262,208,206,3,2,"PREPAL",0
37,"37161",121,88,88,0,0,"PREPAL",1
24,"24169",2809,2165,2146,18,19,"PREPAL",1
49,"49270",137,111,111,0,0,"PREPAL",0
49,"49034",417,320,317,0,3,"PREPAL",0
49,"49205",367,286,282,5,4,"PREPAL",0
24,"24062",130,90,90,2,0,"PREPAL",0
49,"49177",260,165,162,2,3,"PREPAL",1
24,"24161",295,223,219,0,4,"PREPAL",0
37,"37266",70,58,56,0,2,"PREPAL",0
37,"37054",238,200,196,3,4,"PREPAL",0
37,"37003",107,82,82,1,0,"PREPAL",0
49,"49003",869,627,624,3,3,"PREPAL",1
24,"24078",336,259,255,0,4,"PREPAL",0
49,"49123",532,406,402,2,4,"PREPAL",3
37,"37126",30,26,26,0,0,"PREPAL",0
24,"24213",170,140,139,0,1,"PREPAL",1
49,"49101",147,99,96,0,3,"PREPAL",1
24,"24116",390,283,279,1,4,"PREPAL",0
37,"37118",120,93,90,2,3,"PREPAL",0
37,"37004",24,19,19,0,0,"PREPAL",0
37,"37340",142,101,101,0,0,"PREPAL",0
37,"37352",201,159,158,0,1,"PREPAL",0
24,"24199",405,302,297,3,5,"PREPAL",3
24,"24159",1746,1393,1368,6,25,"PREPAL",7
37,"37288",276,225,224,5,1,"PREPAL",0
37,"37041",73,55,55,0,0,"PREPAL",0
37,"37240",939,694,686,3,8,"PREPAL",3
24,"24227",1548,1148,1128,5,20,"PREPAL",5
37,"37029",193,139,133,1,6,"PREPAL",0
49,"49017",259,196,195,0,1,"PREPAL",0
37,"37070",528,422,417,2,5,"PREPAL",0
37,"37164",238,194,193,4,1,"PREPAL",0
37,"37277",77,56,56,0,0,"PREPAL",0
49,"49204",57,42,42,0,0,"PREPAL",0
49,"49029",614,497,488,9,9,"PREPAL",2
37,"37086",104,88,88,0,0,"PREPAL",0
37,"37165",31,22,21,0,1,"PREPAL",1
24,"24039",1954,1563,1552,28,11,"PREPAL",17
24,"24153",233,187,183,1,4,"PREPAL",4
49,"49176",610,426,426,4,0,"PREPAL",0
24,"24093",338,239,232,3,7,"PREPAL",2
49,"49275",51218,38135,37628,388,507,"PREPAL",161
24,"24119",695,515,501,8,14,"PREPAL",1
49,"49087",483,322,320,2,2,"PREPAL",1
24,"24191",108,89,89,0,0,"PREPAL",1
37,"37166",199,146,144,0,2,"PREPAL",0
37,"37270",183,143,140,1,3,"PREPAL",0
37,"37371",258,176,175,0,1,"PREPAL",0
49,"49104",335,245,240,1,5,"PREPAL",1
49,"49134",166,111,111,2,0,"PREPAL",1
24,"24090",326,213,213,2,0,"PREPAL",0
49,"49105",136,105,103,1,2,"PREPAL",0
24,"24187",845,641,630,6,11,"PREPAL",1
37,"37259",36,29,29,0,0,"PREPAL",0
37,"37032",549,431,430,3,1,"PREPAL",0
37,"37356",87,66,66,0,0,"PREPAL",0
24,"24166",1359,1038,1011,11,27,"PREPAL",5
37,"37203",146,113,112,0,1,"PREPAL",0
37,"37150",36,31,31,0,0,"PREPAL",0
49,"49059",88,72,71,0,1,"PREPAL",1
37,"37089",62,51,50,0,1,"PREPAL",0
49,"49153",151,110,108,0,2,"PREPAL",0
49,"49225",127,81,81,0,0,"PREPAL",1
49,"49077",159,104,103,0,1,"PREPAL",0
37,"37192",355,234,227,5,7,"PREPAL",1
37,"37319",93,67,65,1,2,"PREPAL",0
49,"49250",1194,954,939,8,15,"PREPAL",0
37,"37197",87,63,63,0,0,"PREPAL",0
24,"24004",494,408,403,7,5,"PREPAL",2
24,"24902",335,266,263,1,3,"PREPAL",0
24,"24152",447,301,296,1,5,"PREPAL",0
24,"24164",362,221,220,1,1,"PREPAL",2
37,"37169",176,138,137,1,1,"PREPAL",0
49,"49155",80,66,65,1,1,"PREPAL",2
49,"49047",100,72,72,0,0,"PREPAL",2
24,"24137",1052,815,803,14,12,"PREPAL",15
24,"24190",146,109,109,1,0,"PREPAL",1
24,"24044",152,116,114,0,2,"PREPAL",3
24,"24196",1918,1446,1422,9,24,"PREPAL",3
24,"24070",3941,3007,2947,27,60,"PREPAL",5
24,"24018",174,141,139,0,2,"PREPAL",0
24,"24123",716,514,507,2,7,"PREPAL",3
24,"24110",1154,895,880,5,15,"PREPAL",0
37,"37294",11787,9201,9083,76,118,"PREPAL",14
24,"24002",233,183,183,1,0,"PREPAL",0
37,"37035",165,134,134,0,0,"PREPAL",0
37,"37378",99,69,67,2,2,"PREPAL",0
37,"37186",96,79,79,0,0,"PREPAL",0
37,"37350",404,310,307,0,3,"PREPAL",1
24,"24216",671,504,502,3,2,"PREPAL",3
24,"24170",1839,1417,1391,7,26,"PREPAL",4
24,"24077",215,178,178,0,0,"PREPAL",0
37,"37183",386,296,294,4,2,"PREPAL",0
49,"49187",1202,930,921,8,9,"PREPAL",0
37,"37108",99,80,78,2,2,"PREPAL",0
37,"37334",73,49,49,0,0,"PREPAL",0
37,"37339",308,227,226,0,1,"PREPAL",0
37,"37069",971,721,704,2,17,"PREPAL",1
24,"24203",95,72,72,0,0,"PREPAL",0
37,"37314",82,72,68,0,4,"PREPAL",0
37,"37251",107,79,79,1,0,"PREPAL",0
37,"37196",72,56,53,0,3,"PREPAL",0
24,"24103",264,162,161,1,1,"PREPAL",0
49,"49183",93,73,71,2,2,"PREPAL",0
37,"37336",52,46,45,3,1,"PREPAL",1
49,"49102",183,136,135,2,1,"PREPAL",1
49,"49082",343,288,286,8,2,"PREPAL",1
49,"49163",215,151,148,1,3,"PREPAL",0
49,"49132",313,252,249,0,3,"PREPAL",4
24,"24034",3457,2627,2588,31,39,"PREPAL",1
49,"49200",936,744,726,10,18,"PREPAL",5
37,"37209",410,288,283,3,5,"PREPAL",0
24,"24101",384,285,283,4,2,"PREPAL",0
37,"37013",107,73,72,0,1,"PREPAL",2
49,"49147",249,197,196,1,1,"PREPAL",1
37,"37135",1163,934,924,8,10,"PREPAL",0
49,"49120",53,39,39,0,0,"PREPAL",0
24,"24089",101353,78253,77375,776,878,"PREPAL",463
37,"37101",142,119,117,0,2,"PREPAL",0
37,"37274",118473,91137,90221,811,916,"PREPAL",120
24,"24144",639,469,462,2,7,"PREPAL",9
49,"49269",220,163,162,1,1,"PREPAL",1
37,"37124",196,153,153,2,0,"PREPAL",1
37,"37198",203,163,162,3,1,"PREPAL",1
37,"37061",207,160,160,0,0,"PREPAL",1
37,"37303",181,137,137,1,0,"PREPAL",0
37,"37283",119,96,96,0,0,"PREPAL",0
49,"49100",286,210,208,2,2,"PREPAL",0
37,"37190",193,144,144,1,0,"PREPAL",0
24,"24031",210,180,176,0,4,"PREPAL",0
49,"49261",1505,1168,1149,8,19,"PREPAL",3
37,"37039",282,222,222,1,0,"PREPAL",0
49,"49110",345,222,220,2,2,"PREPAL",1
24,"24037",337,234,234,1,0,"PREPAL",0
49,"49122",778,586,573,6,13,"PREPAL",1
37,"37099",61,46,46,1,0,"PREPAL",0
49,"49206",794,584,570,7,14,"PREPAL",1
37,"37204",255,197,195,0,2,"PREPAL",0
37,"37113",409,330,329,3,1,"PREPAL",0
37,"37130",178,150,150,2,0,"PREPAL",1
37,"37088",199,151,149,1,2,"PREPAL",0
37,"37085",5002,3994,3951,40,43,"PREPAL",7
37,"37268",108,72,70,0,2,"PREPAL",0
37,"37040",382,319,316,1,3,"PREPAL",0
49,"49245",253,183,182,2,1,"PREPAL",0
24,"24209",2609,1880,1857,13,23,"PREPAL",0
24,"24038",3048,2360,2315,23,45,"PREPAL",4
24,"24205",981,744,732,8,12,"PREPAL",5
37,"37361",81,63,61,0,2,"PREPAL",0
37,"37100",77,60,59,1,1,"PREPAL",0
24,"24172",415,240,237,1,3,"PREPAL",1
24,"24053",406,279,276,6,3,"PREPAL",1
37,"37265",208,184,181,1,3,"PREPAL",1
37,"37115",110,81,81,2,0,"PREPAL",0
24,"24026",1099,812,799,5,13,"PREPAL",8
37,"37316",716,576,565,4,11,"PREPAL",2
49,"49005",128,87,85,1,2,"PREPAL",0
37,"37329",39,36,36,0,0,"PREPAL",0
49,"49128",533,428,424,7,4,"PREPAL",0
37,"37333",202,138,137,4,1,"PREPAL",2
49,"49129",821,628,616,5,12,"PREPAL",0
37,"37071",76,67,67,0,0,"PREPAL",0
49,"49058",298,244,242,1,2,"PREPAL",3
49,"49099",98,75,74,0,1,"PREPAL",0
24,"24173",908,679,667,3,12,"PREPAL",3
49,"49023",909,682,674,5,8,"PREPAL",0
49,"49223",716,552,548,0,4,"PREPAL",0
49,"49209",474,338,334,4,4,"PREPAL",0
49,"49022",280,243,241,1,2,"PREPAL",0
24,"24223",2540,1971,1929,37,42,"PREPAL",18
24,"24177",472,330,326,3,4,"PREPAL",1
24,"24225",992,762,751,5,11,"PREPAL",6
49,"49130",158,131,131,5,0,"PREPAL",0
24,"24182",411,302,295,4,7,"PREPAL",5
24,"24071",967,755,741,7,14,"PREPAL",0
49,"49076",328,260,258,6,2,"PREPAL",0
37,"37023",1586,1316,1298,12,18,"PREPAL",1
37,"37059",117,106,100,0,6,"PREPAL",0
37,"37019",140,118,117,1,1,"PREPAL",0
37,"37301",79,69,67,0,2,"PREPAL",0
49,"49174",130,93,91,0,2,"PREPAL",0
37,"37305",218,180,178,3,2,"PREPAL",0
49,"49180",138,95,95,0,0,"PREPAL",0
24,"24218",444,343,341,6,2,"PREPAL",1
37,"37328",164,127,127,4,0,"PREPAL",0
24,"24064",1515,1159,1141,11,18,"PREPAL",0
24,"24042",61,47,47,1,0,"PREPAL",0
49,"49242",444,364,359,3,5,"PREPAL",3
49,"49069",327,211,207,0,4,"PREPAL",0
37,"37160",606,431,418,6,13,"PREPAL",0
37,"37332",70,53,53,0,0,"PREPAL",0
24,"24043",122,71,69,0,2,"PREPAL",0
37,"37381",139,97,95,1,2,"PREPAL",3
49,"49238",268,222,216,2,6,"PREPAL",0
49,"49062",105,69,69,1,0,"PREPAL",0
37,"37382",164,135,134,0,1,"PREPAL",0
24,"24061",1736,1350,1328,10,22,"PREPAL",13
37,"37233",56,46,46,2,0,"PREPAL",0
49,"49052",179,125,123,1,2,"PREPAL",0
37,"37374",1147,946,923,4,23,"PREPAL",2
49,"49053",915,726,715,5,11,"PREPAL",2
37,"37110",103,84,82,0,2,"PREPAL",0
49,"49103",394,343,339,3,4,"PREPAL",0
37,"37194",237,182,181,0,1,"PREPAL",0
37,"37078",788,670,658,6,12,"PREPAL",0
37,"37242",80,65,64,1,1,"PREPAL",0
49,"49092",116,87,86,0,1,"PREPAL",1
49,"49113",166,139,139,1,0,"PREPAL",0
49,"49135",588,409,405,0,4,"PREPAL",1
24,"24091",585,433,423,1,10,"PREPAL",2
49,"49162",175,134,131,1,3,"PREPAL",1
49,"49221",234,138,130,1,8,"PREPAL",1
37,"37187",555,437,433,0,4,"PREPAL",0
37,"37345",150,134,133,0,1,"PREPAL",0
49,"49084",268,226,223,9,3,"PREPAL",0
24,"24086",266,211,210,0,1,"PREPAL",0
49,"49055",95,83,83,1,0,"PREPAL",0
49,"49068",435,287,286,1,1,"PREPAL",0
49,"49019",228,170,164,0,6,"PREPAL",1
37,"37167",177,159,158,3,1,"PREPAL",0
49,"49207",217,151,148,4,3,"PREPAL",1
37,"37373",700,522,514,0,8,"PREPAL",0
37,"37249",38,28,28,0,0,"PREPAL",0
49,"49189",192,132,128,1,4,"PREPAL",1
37,"37148",404,321,315,2,6,"PREPAL",0
37,"37215",134,97,96,3,1,"PREPAL",0
49,"49220",139,110,104,2,6,"PREPAL",1
37,"37151",143,112,111,1,1,"PREPAL",0
49,"49061",145,111,108,0,3,"PREPAL",1
24,"24143",495,388,380,2,8,"PREPAL",0
24,"24127",268,204,201,3,3,"PREPAL",0
24,"24008",9025,6803,6702,79,101,"PREPAL",21
49,"49230",82,67,66,0,1,"PREPAL",0
37,"37185",537,416,405,1,11,"PREPAL",1
49,"49142",249,175,173,0,2,"PREPAL",1
37,"37216",294,248,247,2,1,"PREPAL",0
37,"37226",150,119,119,2,0,"PREPAL",0
24,"24056",2762,2062,2013,24,49,"PREPAL",28
24,"24217",133,106,105,1,1,"PREPAL",0
37,"37119",95,78,77,0,1,"PREPAL",0
37,"37077",252,216,213,2,3,"PREPAL",0
24,"24097",204,155,155,7,0,"PREPAL",2
37,"37199",129,97,97,0,0,"PREPAL",0
37,"37073",620,481,471,6,10,"PREPAL",0
49,"49231",293,212,209,0,3,"PREPAL",2
37,"37219",165,101,97,2,4,"PREPAL",1
24,"24054",417,318,311,0,7,"PREPAL",4
24,"24130",418,331,326,0,5,"PREPAL",4
37,"37302",262,182,181,2,1,"PREPAL",0
49,"49065",1073,789,777,3,12,"PREPAL",3
37,"37223",112,78,76,0,2,"PREPAL",0
37,"37140",642,422,418,2,4,"PREPAL",1
49,"49086",111,94,93,1,1,"PREPAL",0
37,"37214",116,87,87,4,0,"PREPAL",0
37,"37162",209,156,153,1,3,"PREPAL",0
37,"37213",83,65,64,0,1,"PREPAL",0
37,"37176",130,103,103,1,0,"PREPAL",0
24,"24063",355,261,261,2,0,"PREPAL",1
49,"49040",112,97,97,0,0,"PREPAL",0
37,"37155",68,52,52,0,0,"PREPAL",0
24,"24214",634,473,471,3,2,"PREPAL",2
37,"37010",923,739,735,2,4,"PREPAL",2
24,"24011",189,122,121,1,1,"PREPAL",0
37,"37263",338,251,246,0,5,"PREPAL",0
37,"37292",94,76,73,1,3,"PREPAL",0
24,"24125",421,298,289,2,9,"PREPAL",2
49,"49054",849,641,629,5,12,"PREPAL",1
49,"49226",239,207,200,3,7,"PREPAL",0
24,"24030",4201,3080,3024,25,56,"PREPAL",5
49,"49131",238,182,178,0,4,"PREPAL",1
37,"37025",244,209,206,0,3,"PREPAL",0
37,"37193",365,277,276,3,1,"PREPAL",0
24,"24219",492,374,371,5,3,"PREPAL",5
24,"24215",152,125,124,1,1,"PREPAL",1
49,"49088",82,59,59,0,0,"PREPAL",1
49,"49167",179,140,136,2,4,"PREPAL",0
24,"24176",299,243,238,3,5,"PREPAL",4
37,"37312",244,198,197,1,1,"PREPAL",0
37,"37293",106,75,74,0,1,"PREPAL",1
24,"24022",306,227,224,1,3,"PREPAL",0
49,"49026",201,163,162,0,1,"PREPAL",1
37,"37307",148,110,107,2,3,"PREPAL",0
37,"37104",25,18,18,0,0,"PREPAL",0
37,"37363",107,81,80,0,1,"PREPAL",0
37,"37116",69,51,51,0,0,"PREPAL",0
37,"37229",139,110,106,2,4,"PREPAL",0
37,"37175",404,321,319,8,2,"PREPAL",1
37,"37131",171,138,137,0,1,"PREPAL",0
37,"37331",188,130,130,1,0,"PREPAL",0
37,"37380",56,46,45,1,1,"PREPAL",0
37,"37279",726,570,562,6,8,"PREPAL",0
49,"49146",274,213,209,1,4,"PREPAL",1
37,"37001",172,133,133,0,0,"PREPAL",0
24,"24065",2175,1695,1660,18,35,"PREPAL",12
37,"37311",207,164,162,4,2,"PREPAL",0
49,"49095",279,221,217,0,4,"PREPAL",1
37,"37163",32,27,27,0,0,"PREPAL",0
24,"24197",736,556,552,7,4,"PREPAL",0
24,"24158",296,226,220,2,6,"PREPAL",0
37,"37348",100,79,79,0,0,"PREPAL",0
49,"49097",74,43,43,0,0,"PREPAL",0
37,"37285",366,273,272,1,1,"PREPAL",0
49,"49108",454,325,322,2,3,"PREPAL",1
37,"37051",80,59,58,0,1,"PREPAL",1
24,"24168",439,365,360,3,5,"PREPAL",2
37,"37298",172,126,125,0,1,"PREPAL",0
49,"49008",431,293,289,2,4,"PREPAL",0
24,"24049",1415,1146,1134,8,12,"PREPAL",0
37,"37370",308,256,254,2,2,"PREPAL",0
49,"49208",364,260,255,5,5,"PREPAL",2
37,"37323",476,380,377,7,3,"PREPAL",2
37,"37236",127,90,86,0,4,"PREPAL",0
24,"24174",469,360,354,5,6,"PREPAL",1
37,"37096",203,162,160,1,2,"PREPAL",0
24,"24194",266,199,199,1,0,"PREPAL",0
49,"49160",43,29,26,0,3,"PREPAL",0
24,"24210",527,387,386,0,1,"PREPAL",0
49,"49090",193,153,151,0,2,"PREPAL",0
37,"37184",290,199,195,0,4,"PREPAL",0
24,"24180",1101,844,833,8,11,"PREPAL",1
37,"37205",217,177,174,0,3,"PREPAL",1
49,"49171",610,477,473,8,4,"PREPAL",0
37,"37125",227,171,169,0,2,"PREPAL",2
49,"49186",235,181,178,4,3,"PREPAL",0
49,"49216",147,122,114,0,8,"PREPAL",0
37,"37060",280,224,224,0,0,"PREPAL",0
25,"25002",467,357,356,2,1,"PSC",41
17,"17188",169,139,138,1,1,"PSC",8
43,"43151",109,98,98,0,0,"PSC",7
43,"43071",891,713,706,6,7,"PSC",122
8,"8139",177,156,156,0,0,"PSC",18
17,"17038",380,312,308,3,4,"PSC",25
17,"17009",4051,3263,3248,14,15,"PSC",320
43,"43042",2198,1820,1816,8,4,"PSC",199
25,"25075",131,102,102,0,0,"PSC",6
17,"17161",1018,859,855,1,4,"PSC",59
8,"8220",2411,2119,2115,13,4,"PSC",101
17,"17091",398,310,305,2,5,"PSC",16
8,"8160",316,252,247,2,5,"PSC",20
17,"17084",231,181,180,1,1,"PSC",20
25,"25166",172,137,136,1,1,"PSC",3
8,"8306",527,390,388,2,2,"PSC",43
17,"17123",345,304,303,4,1,"PSC",16
8,"8087",149,135,133,0,2,"PSC",15
17,"17125",131,98,97,1,1,"PSC",3
17,"17115",278,226,222,2,4,"PSC",19
25,"25110",2731,2121,2106,14,15,"PSC",355
17,"17221",4152,3260,3247,11,13,"PSC",627
25,"25044",178,145,144,6,1,"PSC",13
43,"43169",450,396,396,3,0,"PSC",35
25,"25006",317,246,245,3,1,"PSC",49
8,"8246",1672,1412,1406,7,6,"PSC",76
17,"17060",408,311,311,1,0,"PSC",36
8,"8106",7469,5816,5795,34,21,"PSC",1119
17,"17132",1333,1088,1080,9,8,"PSC",130
8,"8303",256,215,213,1,2,"PSC",18
8,"8270",18837,14541,14497,66,44,"PSC",3063
25,"25910",91,70,67,2,3,"PSC",6
8,"8299",377,318,317,0,1,"PSC",25
8,"8089",34019,26317,26191,170,126,"PSC",8040
25,"25232",1356,1066,1061,2,5,"PSC",195
43,"43072",93,74,74,0,0,"PSC",7
8,"8115",3825,2994,2975,12,19,"PSC",710
25,"25126",284,233,232,1,1,"PSC",39
8,"8126",8865,7125,7098,33,27,"PSC",1523
17,"17152",11026,7610,7564,70,46,"PSC",1657
17,"17086",1745,1223,1210,7,13,"PSC",288
25,"25239",595,367,366,3,1,"PSC",49
43,"43024",1556,1154,1137,3,17,"PSC",285
43,"43073",84,68,67,0,1,"PSC",4
25,"25172",1779,1407,1405,3,2,"PSC",153
17,"17159",626,487,483,1,4,"PSC",44
25,"25064",98,88,88,0,0,"PSC",11
8,"8015",156003,117736,117183,704,553,"PSC",34120
8,"8307",49310,38223,38022,162,201,"PSC",9295
17,"17105",247,194,194,1,0,"PSC",14
43,"43075",86,71,69,0,2,"PSC",11
17,"17134",223,189,189,1,0,"PSC",11
43,"43154",126,111,111,0,0,"PSC",10
8,"8149",984,770,768,3,2,"PSC",65
8,"8229",521,435,433,3,2,"PSC",35
8,"8250",7182,5461,5421,38,40,"PSC",1798
43,"43094",2120,1659,1646,9,13,"PSC",284
17,"17154",99,84,83,0,1,"PSC",11
43,"43030",482,373,372,2,1,"PSC",60
17,"17080",144,124,124,2,0,"PSC",12
17,"17120",820,604,598,3,6,"PSC",67
43,"43178",1421,1118,1113,7,5,"PSC",195
25,"25003",3721,2828,2815,19,13,"PSC",311
17,"17213",5535,3998,3985,20,13,"PSC",664
17,"17215",2227,1936,1925,12,11,"PSC",287
25,"25254",711,576,571,5,5,"PSC",85
8,"8141",4573,3611,3595,26,16,"PSC",591
8,"8109",208,184,183,0,1,"PSC",5
8,"8285",10321,8169,8120,52,49,"PSC",1181
8,"8256",691,571,568,3,3,"PSC",71
17,"17093",922,716,715,2,1,"PSC",60
43,"43026",765,614,613,3,1,"PSC",54
25,"25231",494,410,408,2,2,"PSC",31
8,"8158",3108,2458,2453,13,5,"PSC",522
17,"17042",408,313,311,0,2,"PSC",40
25,"25092",127,101,99,1,2,"PSC",10
25,"25192",724,564,558,4,6,"PSC",61
17,"17192",146,121,120,0,1,"PSC",9
43,"43096",98,82,82,0,0,"PSC",8
25,"25118",327,241,239,2,2,"PSC",27
25,"25152",144,106,106,1,0,"PSC",8
8,"8122",1716,1260,1254,8,6,"PSC",215
17,"17176",123,110,110,1,0,"PSC",21
17,"17190",838,681,677,0,4,"PSC",52
25,"25140",773,573,571,5,2,"PSC",73
25,"25161",343,243,243,0,0,"PSC",29
8,"8039",402,334,334,2,0,"PSC",33
17,"17153",188,162,162,0,0,"PSC",10
43,"43110",251,184,184,1,0,"PSC",40
8,"8049",1320,981,977,5,4,"PSC",60
25,"25030",123,90,90,1,0,"PSC",8
25,"25225",541,427,420,4,7,"PSC",33
43,"43112",250,204,204,1,0,"PSC",20
43,"43014",14357,10596,10542,60,54,"PSC",2067
43,"43167",384,334,333,2,1,"PSC",34
8,"8184",54876,41661,41447,248,214,"PSC",11730
17,"17024",285,228,227,0,1,"PSC",25
25,"25109",214,179,176,3,3,"PSC",7
8,"8280",95,78,78,1,0,"PSC",2
17,"17031",182,130,129,0,1,"PSC",7
43,"43057",38,31,31,1,0,"PSC",3
25,"25058",4358,3269,3254,7,15,"PSC",360
8,"8143",2719,2121,2109,10,12,"PSC",515
17,"17062",5978,4358,4334,26,24,"PSC",712
8,"8097",1080,891,880,2,11,"PSC",134
43,"43037",17902,12787,12695,63,92,"PSC",3268
8,"8233",1846,1485,1478,8,7,"PSC",130
43,"43021",345,270,269,3,1,"PSC",30
43,"43138",2648,1926,1896,8,30,"PSC",347
43,"43117",143,114,113,0,1,"PSC",14
25,"25112",268,214,212,2,2,"PSC",22
8,"8164",934,784,776,1,8,"PSC",87
17,"17040",551,465,459,4,6,"PSC",31
43,"43107",383,308,308,1,0,"PSC",33
8,"8265",1590,1339,1334,6,5,"PSC",130
8,"8234",3373,2742,2734,25,8,"PSC",388
8,"8161",11625,8521,8470,44,51,"PSC",2006
25,"25226",242,184,183,4,1,"PSC",22
17,"17138",845,650,646,0,4,"PSC",180
8,"8021",61,47,45,0,2,"PSC",6
17,"17071",1128,978,978,3,0,"PSC",80
17,"17230",499,397,393,0,4,"PSC",62
17,"17203",165,135,135,0,0,"PSC",17
8,"8240",9453,7807,7776,21,31,"PSC",1587
17,"17146",3127,2404,2381,11,23,"PSC",457
17,"17171",172,143,141,0,2,"PSC",14
17,"17011",651,544,544,4,0,"PSC",42
8,"8027",720,592,588,3,4,"PSC",100
8,"8105",9724,7557,7505,49,52,"PSC",2883
8,"8050",136,115,114,0,1,"PSC",5
25,"25015",335,262,260,8,2,"PSC",19
43,"43901",8750,6057,6004,43,53,"PSC",1192
25,"25168",488,408,407,6,1,"PSC",29
17,"17162",156,114,111,1,3,"PSC",5
8,"8134",842,649,646,3,3,"PSC",89
17,"17090",544,469,468,0,1,"PSC",41
25,"25146",221,172,170,3,2,"PSC",10
8,"8044",4136,3193,3175,11,18,"PSC",723
43,"43023",214,186,186,1,0,"PSC",33
17,"17013",2774,2180,2173,15,7,"PSC",478
8,"8028",1088,783,780,2,3,"PSC",192
17,"17034",7205,5337,5291,16,46,"PSC",986
25,"25114",95,79,79,0,0,"PSC",1
8,"8123",19489,16197,16135,58,62,"PSC",3721
25,"25201",110,89,89,0,0,"PSC",9
17,"17143",144,115,115,0,0,"PSC",10
8,"8291",4919,3865,3854,28,11,"PSC",801
8,"8903",197,177,176,0,1,"PSC",7
17,"17233",2328,1924,1912,6,12,"PSC",190
43,"43031",1446,1180,1178,7,2,"PSC",153
17,"17054",347,271,271,0,0,"PSC",38
8,"8214",6966,5648,5633,21,15,"PSC",881
25,"25150",165,136,133,0,3,"PSC",5
25,"25908",221,159,158,1,1,"PSC",22
25,"25212",224,195,195,2,0,"PSC",20
8,"8029",3560,3027,3019,13,8,"PSC",460
8,"8099",753,565,561,2,4,"PSC",110
25,"25137",8686,6327,6296,46,31,"PSC",1098
17,"17199",6955,5328,5308,23,20,"PSC",727
8,"8286",2919,2210,2199,15,11,"PSC",533
17,"17006",1186,880,878,10,2,"PSC",93
25,"25180",228,176,174,1,2,"PSC",18
43,"43150",1238,1034,1026,6,8,"PSC",104
8,"8162",2124,1659,1651,7,8,"PSC",329
8,"8086",14017,10746,10677,89,69,"PSC",2589
25,"25062",695,578,573,3,5,"PSC",62
8,"8253",128,113,113,0,0,"PSC",1
43,"43092",7235,5200,5174,21,26,"PSC",1110
43,"43036",865,605,602,1,3,"PSC",123
8,"8111",215,200,199,4,1,"PSC",11
17,"17168",379,332,329,0,3,"PSC",17
25,"25171",2127,1639,1630,8,9,"PSC",325
8,"8008",179,139,138,0,1,"PSC",11
17,"17177",567,459,457,2,2,"PSC",46
17,"17026",543,450,449,4,1,"PSC",39
25,"25102",661,517,511,8,6,"PSC",77
8,"8025",1535,1221,1214,7,7,"PSC",201
43,"43065",382,308,304,1,4,"PSC",38
25,"25912",843,685,684,4,1,"PSC",138
17,"17089",5695,4211,4194,13,17,"PSC",704
43,"43043",3289,2624,2613,14,11,"PSC",559
8,"8033",13218,10480,10435,50,45,"PSC",1971
17,"17085",291,248,246,0,2,"PSC",10
43,"43100",3489,2820,2816,15,4,"PSC",632
25,"25069",425,329,327,1,2,"PSC",25
25,"25038",1482,1111,1094,11,17,"PSC",135
8,"8267",6748,5389,5362,28,27,"PSC",1267
17,"17058",170,139,139,0,0,"PSC",9
17,"17186",3824,3115,3098,15,17,"PSC",624
43,"43149",684,533,533,4,0,"PSC",174
25,"25218",86,79,79,0,0,"PSC",2
25,"25143",84,72,71,0,1,"PSC",9
17,"17129",144,120,120,1,0,"PSC",11
25,"25067",706,537,532,4,5,"PSC",69
43,"43002",1875,1367,1348,11,19,"PSC",403
43,"43076",460,378,377,2,1,"PSC",43
17,"17209",615,519,517,2,2,"PSC",79
17,"17225",207,161,161,0,0,"PSC",11
25,"25079",285,228,227,0,1,"PSC",18
8,"8026",193,161,161,1,0,"PSC",7
17,"17098",303,245,245,2,0,"PSC",35
8,"8130",108,89,86,2,3,"PSC",3
8,"8096",43555,34070,33871,194,199,"PSC",8756
8,"8193",984,792,790,5,2,"PSC",86
8,"8298",26980,20900,20817,91,83,"PSC",2909
25,"25098",232,172,170,2,2,"PSC",28
43,"43175",537,426,419,5,7,"PSC",44
8,"8041",10692,7805,7732,48,73,"PSC",2617
17,"17151",185,150,150,1,0,"PSC",12
43,"43136",10463,7789,7749,36,40,"PSC",1378
25,"25209",1550,1192,1172,4,20,"PSC",170
25,"25074",180,157,155,2,2,"PSC",19
17,"17049",3204,2634,2615,9,19,"PSC",390
25,"25165",276,221,219,1,2,"PSC",19
25,"25185",679,493,491,6,2,"PSC",68
17,"17070",110,94,94,0,0,"PSC",10
17,"17185",2275,1777,1768,7,9,"PSC",260
43,"43066",155,121,121,1,0,"PSC",20
25,"25129",159,115,115,2,0,"PSC",6
43,"43049",727,589,584,2,5,"PSC",51
17,"17204",596,461,460,2,1,"PSC",79
8,"8258",813,661,657,6,4,"PSC",35
8,"8068",6878,5456,5437,25,19,"PSC",1135
17,"17050",674,585,582,5,3,"PSC",47
25,"25099",1291,981,978,2,3,"PSC",90
8,"8182",2892,2217,2204,18,13,"PSC",598
8,"8054",9155,7468,7428,43,40,"PSC",1723
8,"8273",2353,1944,1934,9,10,"PSC",175
8,"8012",1721,1340,1331,8,9,"PSC",124
8,"8290",1534,1289,1284,9,5,"PSC",168
25,"25055",163,130,129,0,1,"PSC",10
17,"17051",207,174,173,3,1,"PSC",11
17,"17137",3467,2925,2912,15,13,"PSC",271
17,"17100",195,157,154,0,3,"PSC",15
17,"17088",578,468,468,1,0,"PSC",35
8,"8052",139,111,110,0,1,"PSC",5
17,"17234",179,147,146,2,1,"PSC",20
8,"8277",171,150,150,0,0,"PSC",9
25,"25197",141,109,108,0,1,"PSC",5
17,"17173",182,156,156,0,0,"PSC",14
8,"8116",558,459,459,0,0,"PSC",33
8,"8266",43383,35117,34994,178,123,"PSC",9704
8,"8257",103,86,86,1,0,"PSC",9
43,"43163",26013,18942,18796,89,146,"PSC",4901
8,"8005",6380,5122,5106,18,16,"PSC",682
17,"17032",1742,1235,1224,6,11,"PSC",182
43,"43078",843,653,644,4,9,"PSC",124
8,"8228",288,239,239,2,0,"PSC",26
17,"17124",1599,1258,1254,6,4,"PSC",227
17,"17003",102,75,75,0,0,"PSC",3
25,"25005",274,202,202,2,0,"PSC",31
43,"43131",4772,3432,3401,18,31,"PSC",904
25,"25025",1378,996,983,8,13,"PSC",267
8,"8241",69,56,56,0,0,"PSC",7
25,"25204",1191,936,930,5,6,"PSC",140
8,"8108",5192,4204,4189,26,15,"PSC",944
8,"8264",4535,3623,3613,13,10,"PSC",518
43,"43077",455,342,339,2,3,"PSC",127
25,"25016",2083,1590,1587,8,3,"PSC",218
43,"43905",14941,10510,10446,40,64,"PSC",2445
17,"17106",143,124,123,0,1,"PSC",14
17,"17197",131,113,113,1,0,"PSC",14
8,"8278",4893,4034,4018,17,16,"PSC",300
25,"25903",229,189,188,0,1,"PSC",18
17,"17004",533,445,441,3,4,"PSC",30
25,"25142",365,300,299,2,1,"PSC",30
43,"43141",105,86,86,0,0,"PSC",19
8,"8259",6904,5626,5601,27,25,"PSC",978
8,"8206",737,625,624,3,1,"PSC",95
17,"17014",63,51,50,0,1,"PSC",7
8,"8098",2409,1916,1912,9,4,"PSC",335
8,"8204",3115,2548,2534,22,14,"PSC",581
25,"25901",287,209,207,1,2,"PSC",20
25,"25130",183,142,140,0,2,"PSC",15
43,"43130",177,145,145,0,0,"PSC",18
8,"8136",11614,9159,9079,84,80,"PSC",2695
25,"25104",122,91,91,0,0,"PSC",8
17,"17135",395,309,307,0,2,"PSC",31
43,"43109",2704,1937,1922,16,15,"PSC",405
43,"43084",521,424,423,2,1,"PSC",67
17,"17126",318,279,279,0,0,"PSC",20
17,"17167",2609,2122,2102,14,20,"PSC",284
8,"8075",4059,3127,3119,14,8,"PSC",588
17,"17066",27323,18373,18269,98,104,"PSC",3731
8,"8067",5728,4535,4513,21,22,"PSC",693
25,"25181",175,136,135,0,1,"PSC",8
8,"8056",42727,33215,33054,220,161,"PSC",8439
25,"25155",618,493,489,2,4,"PSC",61
43,"43158",77,61,61,1,0,"PSC",4
8,"8226",926,811,807,1,4,"PSC",87
8,"8251",5127,3972,3940,17,32,"PSC",1050
8,"8076",16497,12734,12667,82,67,"PSC",3309
8,"8191",5270,4176,4162,19,14,"PSC",936
25,"25240",1385,1116,1110,10,6,"PSC",150
43,"43020",2276,1831,1819,12,12,"PSC",444
17,"17206",155,118,115,0,3,"PSC",5
43,"43099",286,234,234,0,0,"PSC",35
8,"8091",5413,4301,4283,20,18,"PSC",991
8,"8120",7048,5892,5881,49,11,"PSC",467
43,"43009",1391,1086,1078,3,8,"PSC",167
25,"25191",321,248,244,3,4,"PSC",25
8,"8284",12482,8959,8887,41,72,"PSC",1898
8,"8006",11774,9039,8981,33,58,"PSC",1443
17,"17047",4968,3447,3429,22,18,"PSC",571
25,"25071",42,32,31,0,1,"PSC",0
25,"25078",1001,807,805,5,2,"PSC",79
17,"17118",12916,9521,9460,37,61,"PSC",1895
25,"25120",92704,68713,68361,445,352,"PSC",14649
8,"8244",6041,4994,4970,33,24,"PSC",1055
43,"43119",838,630,628,4,2,"PSC",112
8,"8144",713,565,563,5,2,"PSC",65
25,"25148",219,168,168,1,0,"PSC",5
43,"43105",156,132,132,3,0,"PSC",7
43,"43048",763,614,609,7,5,"PSC",91
8,"8095",67,53,52,0,1,"PSC",4
43,"43160",1322,1051,1045,0,6,"PSC",241
25,"25061",80,59,58,0,1,"PSC",7
8,"8156",11155,8956,8923,60,33,"PSC",1861
25,"25907",497,389,386,2,3,"PSC",27
8,"8070",266,232,232,0,0,"PSC",16
25,"25219",149,118,118,1,0,"PSC",4
17,"17048",6251,4565,4537,20,28,"PSC",949
17,"17170",180,147,147,2,0,"PSC",9
8,"8263",21151,16360,16269,116,91,"PSC",4497
25,"25085",141,118,117,2,1,"PSC",8
25,"25011",5260,3908,3871,30,37,"PSC",526
8,"8271",67,57,57,0,0,"PSC",2
43,"43062",259,223,220,2,3,"PSC",51
43,"43046",90,73,73,1,0,"PSC",6
8,"8237",1662,1334,1327,7,7,"PSC",157
8,"8131",741,585,585,4,0,"PSC",67
25,"25034",2288,1733,1719,9,14,"PSC",139
8,"8062",1004,829,826,11,3,"PSC",106
43,"43145",4209,3409,3391,9,18,"PSC",688
25,"25043",801,613,606,1,7,"PSC",62
43,"43177",284,243,242,0,1,"PSC",33
8,"8175",3368,2496,2486,16,10,"PSC",308
43,"43137",1905,1515,1499,15,16,"PSC",308
8,"8185",197,172,171,2,1,"PSC",14
8,"8042",2362,1910,1904,7,6,"PSC",372
17,"17057",968,826,822,1,4,"PSC",91
17,"17087",222,177,176,0,1,"PSC",15
17,"17207",2411,2006,1992,8,14,"PSC",107
8,"8071",241,200,200,0,0,"PSC",19
25,"25035",366,306,302,2,4,"PSC",32
25,"25023",4527,3621,3601,23,20,"PSC",543
8,"8203",2472,1884,1873,4,11,"PSC",283
25,"25221",117,92,92,0,0,"PSC",8
8,"8167",6048,4833,4822,48,11,"PSC",1460
25,"25123",189,151,151,0,0,"PSC",16
43,"43039",105,85,85,0,0,"PSC",4
43,"43132",363,292,291,2,1,"PSC",21
43,"43015",119,101,101,0,0,"PSC",1
8,"8020",5172,4337,4327,26,10,"PSC",764
43,"43040",326,278,276,0,2,"PSC",18
25,"25113",1116,912,908,8,4,"PSC",106
8,"8090",137,113,113,2,0,"PSC",8
25,"25233",285,231,229,2,2,"PSC",38
17,"17144",210,171,170,0,1,"PSC",15
8,"8300",5892,4912,4880,24,32,"PSC",944
25,"25124",157,114,114,0,0,"PSC",7
17,"17164",3932,3078,3054,8,24,"PSC",426
43,"43090",1169,749,742,2,7,"PSC",186
17,"17092",3467,2660,2633,17,27,"PSC",531
8,"8901",240,203,201,1,2,"PSC",6
25,"25911",424,332,331,1,1,"PSC",28
17,"17212",142,117,117,2,0,"PSC",7
25,"25036",184,144,143,0,1,"PSC",36
43,"43032",466,379,379,1,0,"PSC",76
43,"43902",2743,1996,1980,16,16,"PSC",643
8,"8065",1180,967,964,4,3,"PSC",119
8,"8902",3937,3176,3164,17,12,"PSC",570
17,"17194",78,62,62,0,0,"PSC",2
8,"8275",248,223,222,1,1,"PSC",10
8,"8215",2589,2044,2034,19,10,"PSC",251
25,"25177",358,270,268,1,2,"PSC",26
8,"8014",2000,1578,1567,5,11,"PSC",211
8,"8074",11054,8273,8235,34,38,"PSC",2080
25,"25027",977,765,763,4,2,"PSC",57
17,"17175",564,381,381,1,0,"PSC",97
43,"43156",3956,2993,2965,23,28,"PSC",636
8,"8192",5679,4605,4589,20,16,"PSC",702
8,"8031",2336,1886,1882,11,4,"PSC",332
17,"17166",547,460,459,2,1,"PSC",18
8,"8293",228,187,187,1,0,"PSC",14
8,"8135",6735,5445,5421,36,24,"PSC",1724
25,"25169",167,118,117,0,1,"PSC",15
43,"43018",385,335,334,3,1,"PSC",51
8,"8179",611,496,493,2,3,"PSC",93
17,"17119",73,58,58,2,0,"PSC",9
8,"8048",569,442,442,2,0,"PSC",47
8,"8092",3714,2912,2889,8,23,"PSC",437
25,"25070",811,677,675,4,2,"PSC",71
17,"17157",124,107,107,0,0,"PSC",10
8,"8153",559,460,458,2,2,"PSC",40
8,"8032",2087,1607,1598,9,9,"PSC",294
8,"8084",1167,941,936,6,5,"PSC",117
8,"8145",2701,2156,2144,7,12,"PSC",390
8,"8904",10514,7733,7697,38,36,"PSC",2907
43,"43035",235,205,203,7,2,"PSC",36
25,"25093",629,489,487,4,2,"PSC",59
17,"17196",242,198,198,1,0,"PSC",19
43,"43133",5605,4202,4168,21,34,"PSC",835
43,"43101",145,122,122,1,0,"PSC",15
8,"8016",1812,1454,1448,6,6,"PSC",267
43,"43134",273,224,223,5,1,"PSC",41
25,"25251",713,562,558,4,4,"PSC",71
25,"25059",813,621,612,3,9,"PSC",201
8,"8093",24,20,20,0,0,"PSC",0
8,"8181",8061,6442,6402,28,40,"PSC",1276
25,"25206",250,189,188,2,1,"PSC",3
25,"25193",767,614,606,6,8,"PSC",55
8,"8260",18400,14471,14406,87,65,"PSC",4030
43,"43174",144,128,127,0,1,"PSC",8
25,"25094",139,116,116,0,0,"PSC",9
8,"8208",5760,4660,4643,25,17,"PSC",1020
25,"25906",210,157,155,0,2,"PSC",32
8,"8172",20417,16196,16144,88,52,"PSC",3376
8,"8287",1057,877,871,7,6,"PSC",77
17,"17016",719,584,581,1,3,"PSC",54
43,"43004",6274,4744,4691,39,53,"PSC",752
25,"25224",126,98,98,0,0,"PSC",5
17,"17027",2866,2375,2364,8,11,"PSC",297
8,"8155",6960,5427,5390,39,37,"PSC",1240
17,"17140",639,539,527,4,12,"PSC",69
43,"43143",51,45,44,0,1,"PSC",5
8,"8077",34578,27617,27501,134,116,"PSC",8613
8,"8069",3280,2691,2680,17,11,"PSC",423
8,"8261",2378,1821,1815,14,6,"PSC",339
17,"17010",327,264,263,2,1,"PSC",12
25,"25228",3115,2468,2459,19,9,"PSC",355
25,"25131",402,321,320,1,1,"PSC",57
25,"25032",67,53,53,0,0,"PSC",3
25,"25253",145,122,121,0,1,"PSC",2
43,"43070",238,194,193,1,1,"PSC",29
8,"8078",219,176,172,1,4,"PSC",10
25,"25230",1555,1221,1208,8,13,"PSC",199
25,"25097",84,72,72,1,0,"PSC",3
8,"8113",52518,39750,39592,198,158,"PSC",7357
43,"43095",2564,1995,1984,14,11,"PSC",338
8,"8035",12871,9574,9538,31,36,"PSC",1792
8,"8202",12843,10074,10025,57,49,"PSC",2060
17,"17079",65381,50872,50631,242,241,"PSC",8743
8,"8165",1664,1315,1311,9,4,"PSC",282
43,"43907",4359,3370,3346,22,24,"PSC",1192
43,"43120",421,302,297,2,5,"PSC",60
25,"25073",546,420,418,2,2,"PSC",37
17,"17069",364,286,284,2,2,"PSC",21
8,"8211",33731,27698,27561,126,137,"PSC",7914
17,"17220",805,673,665,2,8,"PSC",34
17,"17210",580,449,445,2,4,"PSC",39
25,"25033",1121,899,890,5,9,"PSC",101
8,"8254",1753,1485,1482,3,3,"PSC",78
25,"25086",521,414,411,2,3,"PSC",42
43,"43153",11092,8327,8291,34,36,"PSC",1859
43,"43104",1762,1410,1401,5,9,"PSC",196
25,"25909",140,108,107,2,1,"PSC",11
25,"25053",1092,879,873,8,6,"PSC",117
8,"8019",1117818,875679,872180,4327,3499,"PSC",198950
17,"17030",650,479,477,4,2,"PSC",74
17,"17217",353,312,311,1,1,"PSC",23
17,"17021",122,98,98,0,0,"PSC",19
8,"8308",137,118,118,0,0,"PSC",7
8,"8238",14851,12472,12428,50,44,"PSC",2214
17,"17001",580,459,454,3,5,"PSC",58
17,"17182",272,220,220,3,0,"PSC",61
25,"25012",2342,1748,1739,10,9,"PSC",306
43,"43055",1988,1631,1622,7,9,"PSC",238
17,"17155",14861,10307,10234,52,73,"PSC",2516
43,"43017",116,98,98,1,0,"PSC",9
8,"8189",122,106,106,0,0,"PSC",4
43,"43064",2017,1569,1558,9,11,"PSC",208
43,"43007",640,510,509,0,1,"PSC",56
17,"17222",105,95,95,1,0,"PSC",5
8,"8177",39,31,31,0,0,"PSC",6
8,"8055",541,443,442,2,1,"PSC",48
25,"25045",54,31,31,5,0,"PSC",4
25,"25154",118,94,94,0,0,"PSC",13
8,"8004",209,194,191,0,3,"PSC",9
25,"25176",307,262,259,1,3,"PSC",11
25,"25024",352,273,272,0,1,"PSC",31
17,"17183",255,216,216,0,0,"PSC",18
8,"8274",4674,3710,3698,12,12,"PSC",1067
25,"25902",542,449,439,3,10,"PSC",34
8,"8064",1920,1516,1506,6,10,"PSC",201
43,"43025",590,476,472,0,4,"PSC",144
25,"25167",226,185,185,2,0,"PSC",9
25,"25089",97,72,71,1,1,"PSC",2
25,"25203",8798,6279,6231,26,48,"PSC",1252
25,"25202",108,75,75,0,0,"PSC",11
25,"25145",76,66,66,1,0,"PSC",5
17,"17023",27144,20301,20146,120,155,"PSC",5451
25,"25125",389,303,300,1,3,"PSC",27
25,"25234",4201,3087,3072,13,15,"PSC",626
43,"43123",71092,53689,53369,241,320,"PSC",12057
8,"8082",1143,868,861,4,7,"PSC",201
8,"8188",115,95,95,0,0,"PSC",5
25,"25037",366,286,284,3,2,"PSC",27
17,"17074",532,436,426,2,10,"PSC",57
8,"8047",3737,2903,2876,16,27,"PSC",707
43,"43033",768,609,607,3,2,"PSC",77
17,"17224",302,233,231,2,2,"PSC",25
43,"43116",463,381,379,2,2,"PSC",49
8,"8232",1786,1444,1434,9,10,"PSC",236
25,"25179",171,134,134,1,0,"PSC",8
43,"43124",472,379,373,1,6,"PSC",60
43,"43165",572,492,492,1,0,"PSC",61
25,"25057",214,162,161,0,1,"PSC",30
25,"25060",69,49,49,1,0,"PSC",3
17,"17208",976,772,768,5,4,"PSC",66
43,"43045",146,128,127,0,1,"PSC",9
8,"8294",2063,1644,1643,10,1,"PSC",164
43,"43108",1778,1374,1365,6,9,"PSC",204
8,"8190",258,216,215,1,1,"PSC",32
17,"17065",324,254,253,0,1,"PSC",14
17,"17005",460,336,331,0,5,"PSC",55
25,"25904",162,147,147,3,0,"PSC",17
8,"8007",6775,5447,5419,21,28,"PSC",652
8,"8199",651,542,542,4,0,"PSC",84
25,"25250",330,261,258,1,3,"PSC",36
43,"43010",337,286,284,2,2,"PSC",45
8,"8207",2014,1736,1730,9,6,"PSC",123
25,"25017",232,184,181,0,3,"PSC",23
25,"25183",535,419,416,4,3,"PSC",50
8,"8225",94,81,81,1,0,"PSC",0
43,"43051",9092,6577,6502,26,75,"PSC",1891
43,"43011",1079,912,909,1,3,"PSC",97
17,"17226",895,673,669,3,4,"PSC",114
25,"25128",127,87,87,0,0,"PSC",14
8,"8024",357,301,298,1,3,"PSC",41
43,"43126",1211,1005,999,4,6,"PSC",154
17,"17158",468,337,336,1,1,"PSC",43
8,"8268",971,746,737,3,9,"PSC",137
8,"8217",25355,20935,20855,110,80,"PSC",6632
17,"17036",2643,2076,2071,12,5,"PSC",315
43,"43044",3949,3060,3032,31,28,"PSC",756
25,"25194",415,325,325,3,0,"PSC",30
25,"25009",605,505,491,5,14,"PSC",58
8,"8085",976,812,811,2,1,"PSC",82
17,"17007",1752,1430,1422,2,8,"PSC",106
8,"8304",816,686,678,1,8,"PSC",84
17,"17067",697,581,578,4,3,"PSC",64
17,"17216",155,127,124,0,3,"PSC",7
43,"43069",178,146,146,0,0,"PSC",24
8,"8905",2308,1943,1938,7,5,"PSC",343
17,"17169",2497,2047,2042,8,5,"PSC",330
25,"25139",491,390,388,3,2,"PSC",40
17,"17191",166,145,144,2,1,"PSC",10
8,"8296",1843,1520,1514,10,6,"PSC",209
8,"8051",18437,14951,14887,85,64,"PSC",3216
8,"8209",6896,5269,5244,25,25,"PSC",1053
43,"43005",3643,2765,2749,22,16,"PSC",511
17,"17160",14733,10833,10766,43,67,"PSC",2559
8,"8138",4432,3435,3413,10,22,"PSC",456
8,"8010",4207,3327,3304,13,23,"PSC",478
17,"17028",297,238,237,1,1,"PSC",8
8,"8210",4584,3455,3435,23,20,"PSC",509
17,"17019",1784,1472,1462,3,10,"PSC",181
25,"25121",635,436,429,1,7,"PSC",139
25,"25021",2541,1891,1882,14,9,"PSC",345
25,"25173",1649,1278,1262,5,16,"PSC",364
25,"25220",994,822,816,3,6,"PSC",64
43,"43098",354,291,291,1,0,"PSC",18
25,"25076",134,94,93,0,1,"PSC",9
8,"8053",2865,2105,2098,17,7,"PSC",465
8,"8061",1590,1236,1233,8,3,"PSC",279
25,"25164",357,264,261,4,3,"PSC",21
25,"25042",208,160,160,1,0,"PSC",19
43,"43128",905,751,747,4,4,"PSC",172
43,"43038",21861,16504,16406,112,98,"PSC",3278
8,"8289",4457,3605,3594,20,11,"PSC",565
17,"17165",634,516,512,3,4,"PSC",64
25,"25122",1925,1505,1497,23,8,"PSC",161
17,"17020",3671,3021,3006,11,15,"PSC",297
25,"25174",390,324,324,0,0,"PSC",49
8,"8249",272,248,248,2,0,"PSC",23
17,"17061",183,148,148,0,0,"PSC",1
8,"8132",361,281,281,2,0,"PSC",34
8,"8011",1745,1414,1407,10,7,"PSC",100
43,"43113",397,325,323,2,2,"PSC",51
8,"8080",39,30,30,0,0,"PSC",7
17,"17211",831,694,691,1,3,"PSC",45
43,"43097",399,341,341,1,0,"PSC",62
17,"17172",457,352,349,1,3,"PSC",36
8,"8247",980,832,828,3,4,"PSC",55
25,"25245",430,346,342,1,4,"PSC",92
8,"8255",137,105,105,1,0,"PSC",8
43,"43001",694,543,543,5,0,"PSC",83
25,"25252",557,424,422,4,2,"PSC",40
25,"25050",3269,2457,2446,23,11,"PSC",280
17,"17195",342,296,295,3,1,"PSC",38
43,"43173",99,80,78,0,2,"PSC",10
8,"8150",251,211,211,0,0,"PSC",8
43,"43162",4418,3467,3453,20,14,"PSC",768
17,"17193",4312,3202,3179,15,23,"PSC",573
43,"43080",227,195,195,0,0,"PSC",19
25,"25247",147,100,100,2,0,"PSC",25
17,"17012",1171,916,914,10,2,"PSC",141
8,"8107",11900,9303,9187,43,116,"PSC",2211
8,"8046",13478,10989,10939,67,50,"PSC",1947
17,"17063",173,157,156,2,1,"PSC",8
17,"17202",3813,2876,2851,8,25,"PSC",536
17,"17097",199,172,170,1,2,"PSC",13
25,"25151",736,592,584,1,8,"PSC",50
8,"8013",1280,1040,1031,5,9,"PSC",136
8,"8292",1062,835,831,3,4,"PSC",165
25,"25134",603,492,490,1,2,"PSC",60
43,"43147",521,446,442,4,4,"PSC",41
43,"43008",307,202,200,1,2,"PSC",41
17,"17223",800,623,616,5,7,"PSC",109
8,"8205",61279,51629,51497,360,132,"PSC",8570
43,"43093",3884,2956,2933,14,23,"PSC",564
8,"8301",49135,38575,38398,272,177,"PSC",13126
25,"25056",213,163,163,3,0,"PSC",13
43,"43082",351,303,297,1,6,"PSC",34
8,"8295",11184,8566,8529,43,37,"PSC",2185
25,"25135",1000,773,769,2,4,"PSC",91
43,"43140",2438,1847,1837,16,10,"PSC",471
17,"17145",1432,1113,1103,7,10,"PSC",118
8,"8022",12219,9089,9038,42,51,"PSC",1269
8,"8152",116,94,94,0,0,"PSC",5
25,"25249",176,139,138,1,1,"PSC",15
43,"43041",228,179,177,3,2,"PSC",37
25,"25136",96,79,79,2,0,"PSC",0
8,"8057",61,50,50,0,0,"PSC",1
43,"43148",90763,69756,69423,299,333,"PSC",16657
17,"17033",5587,4157,4130,13,27,"PSC",662
8,"8235",3829,3176,3167,14,9,"PSC",361
8,"8114",18648,14251,14170,69,81,"PSC",4165
25,"25031",57,39,39,0,0,"PSC",4
8,"8288",1676,1196,1182,6,14,"PSC",292
43,"43111",2098,1496,1483,8,13,"PSC",321
8,"8127",2240,1694,1683,13,11,"PSC",375
8,"8170",442,338,338,0,0,"PSC",39
43,"43083",144,116,113,1,3,"PSC",10
8,"8058",1787,1357,1340,5,17,"PSC",316
8,"8083",1672,1478,1471,7,7,"PSC",103
17,"17902",1306,1076,1074,3,2,"PSC",130
8,"8180",27072,21218,21100,126,118,"PSC",6446
25,"25157",162,137,137,4,0,"PSC",13
17,"17147",7959,6164,6130,45,34,"PSC",1147
17,"17044",6930,5514,5493,26,21,"PSC",771
8,"8072",10699,8226,8193,45,33,"PSC",1507
43,"43171",14705,11002,10956,62,46,"PSC",3012
8,"8239",460,380,378,2,2,"PSC",35
17,"17015",12819,10133,10078,38,55,"PSC",1058
25,"25905",369,308,307,1,1,"PSC",31
25,"25138",547,440,436,1,4,"PSC",54
17,"17128",316,255,252,1,3,"PSC",26
8,"8243",156,139,139,0,0,"PSC",5
8,"8119",6838,5352,5326,31,26,"PSC",1229
43,"43155",22619,16724,16624,101,100,"PSC",3400
17,"17056",1766,1438,1433,9,5,"PSC",128
43,"43118",425,357,356,0,1,"PSC",44
25,"25119",2245,1798,1792,10,6,"PSC",206
25,"25052",1562,1273,1264,3,9,"PSC",136
8,"8017",2827,2192,2182,16,10,"PSC",370
43,"43159",81,63,62,0,1,"PSC",6
43,"43085",235,198,194,0,4,"PSC",28
8,"8200",62161,48645,48330,261,315,"PSC",15854
17,"17096",164,113,113,1,0,"PSC",4
43,"43052",934,765,756,2,9,"PSC",128
8,"8003",7183,5761,5742,39,19,"PSC",925
8,"8176",161,132,131,2,1,"PSC",4
8,"8212",491,406,402,1,4,"PSC",26
25,"25255",395,321,318,2,3,"PSC",39
8,"8129",484,406,405,3,1,"PSC",22
8,"8140",4778,3756,3737,19,19,"PSC",776
8,"8197",7896,6197,6174,28,23,"PSC",946
43,"43079",356,306,305,1,1,"PSC",41
17,"17018",494,405,402,1,3,"PSC",45
25,"25115",801,638,637,4,1,"PSC",79
25,"25182",1043,842,839,9,3,"PSC",167
17,"17198",433,332,329,0,3,"PSC",48
43,"43906",2103,1595,1587,14,8,"PSC",234
17,"17107",269,221,219,2,2,"PSC",14
17,"17141",6072,4251,4221,14,30,"PSC",785
25,"25163",236,181,179,3,2,"PSC",9
43,"43168",84,65,65,1,0,"PSC",9
17,"17150",1426,1199,1192,8,7,"PSC",134
17,"17189",1476,1278,1275,2,3,"PSC",109
43,"43013",4392,3341,3321,14,20,"PSC",473
25,"25216",241,199,199,2,0,"PSC",12
17,"17109",698,558,553,1,5,"PSC",33
43,"43053",188,153,149,0,4,"PSC",24
8,"8297",135,111,111,1,0,"PSC",9
43,"43006",676,531,525,4,6,"PSC",96
17,"17218",570,468,465,5,3,"PSC",28
8,"8196",19444,15361,15263,90,98,"PSC",5243
17,"17174",162,132,132,4,0,"PSC",8
17,"17181",3467,2664,2648,10,16,"PSC",439
17,"17117",14471,10565,10504,52,61,"PSC",2403
43,"43115",128,112,111,1,1,"PSC",10
8,"8157",8547,6949,6918,39,31,"PSC",1804
17,"17200",623,512,510,1,2,"PSC",47
43,"43172",337,261,257,2,4,"PSC",49
43,"43074",1812,1419,1412,4,7,"PSC",235
17,"17142",2673,2250,2241,14,9,"PSC",351
8,"8079",334,284,282,0,2,"PSC",30
17,"17121",229,184,184,1,0,"PSC",16
17,"17232",149,117,116,0,1,"PSC",17
43,"43121",591,463,462,0,1,"PSC",48
8,"8163",19497,14616,14548,67,68,"PSC",4030
25,"25215",505,299,299,4,0,"PSC",42
8,"8276",233,180,180,0,0,"PSC",13
43,"43058",96,77,77,0,0,"PSC",5
43,"43063",536,401,397,1,4,"PSC",71
17,"17064",326,263,261,2,2,"PSC",41
25,"25186",207,174,173,7,1,"PSC",9
25,"25063",95,61,61,0,0,"PSC",20
17,"17149",364,314,314,0,0,"PSC",13
8,"8227",2410,1882,1877,10,5,"PSC",296
8,"8302",9373,7001,6934,61,67,"PSC",2234
17,"17081",248,192,190,0,2,"PSC",18
43,"43089",281,209,208,0,1,"PSC",47
25,"25189",2164,1591,1583,11,8,"PSC",256
43,"43114",375,306,305,0,1,"PSC",31
8,"8230",7666,6202,6168,30,34,"PSC",1198
43,"43122",111,98,97,0,1,"PSC",18
8,"8038",1525,1228,1220,2,8,"PSC",176
8,"8133",128,98,98,5,0,"PSC",8
43,"43139",1999,1552,1539,10,13,"PSC",171
8,"8001",9079,7383,7341,40,42,"PSC",2224
25,"25013",2108,1570,1557,12,13,"PSC",392
17,"17082",436,341,339,0,2,"PSC",25
17,"17073",1939,1695,1693,7,2,"PSC",159
8,"8222",1819,1484,1476,11,8,"PSC",198
25,"25211",672,513,512,6,1,"PSC",61
17,"17077",567,434,434,2,0,"PSC",59
43,"43060",2684,2158,2152,8,6,"PSC",311
25,"25190",257,215,215,0,0,"PSC",43
43,"43003",350,266,264,3,2,"PSC",43
17,"17083",2961,2321,2300,12,21,"PSC",466
25,"25248",880,714,713,4,1,"PSC",65
25,"25205",562,451,447,7,4,"PSC",69
8,"8059",344,292,290,2,2,"PSC",17
43,"43091",123,93,93,1,0,"PSC",7
8,"8100",2092,1792,1782,16,10,"PSC",118
25,"25077",440,331,330,1,1,"PSC",44
17,"17901",983,790,789,3,1,"PSC",79
43,"43102",463,384,379,2,5,"PSC",95
43,"43161",17113,12944,12881,64,63,"PSC",2404
43,"43170",878,706,704,7,2,"PSC",121
43,"43146",41,35,35,0,0,"PSC",3
8,"8281",4840,4009,3998,23,11,"PSC",556
43,"43034",468,393,393,0,0,"PSC",63
25,"25096",888,663,661,2,2,"PSC",75
8,"8117",2480,2055,2050,16,5,"PSC",270
8,"8063",467,406,405,3,1,"PSC",34
8,"8009",9480,7649,7620,35,29,"PSC",1240
25,"25227",664,517,517,1,0,"PSC",53
25,"25196",112,94,93,0,1,"PSC",14
8,"8066",1463,1185,1181,9,4,"PSC",224
8,"8198",4640,3713,3691,23,22,"PSC",516
25,"25103",136,103,102,2,1,"PSC",4
17,"17094",1068,772,766,1,6,"PSC",82
8,"8101",174954,129953,129198,680,755,"PSC",46673
25,"25913",86,77,77,0,0,"PSC",5
17,"17116",354,283,282,0,1,"PSC",19
43,"43059",250,214,214,1,0,"PSC",23
17,"17076",122,101,100,1,1,"PSC",6
17,"17163",2824,2358,2351,13,7,"PSC",222
8,"8023",6915,5339,5299,26,40,"PSC",870
25,"25072",5874,4468,4450,24,18,"PSC",716
17,"17112",194,154,152,2,2,"PSC",14
17,"17095",19938,13998,13918,69,80,"PSC",3738
43,"43027",164,137,137,0,0,"PSC",11
43,"43054",2792,2145,2134,21,11,"PSC",268
25,"25039",261,216,216,1,0,"PSC",35
43,"43904",2861,2083,2058,27,25,"PSC",415
25,"25101",543,454,449,1,5,"PSC",35
43,"43016",3445,2628,2608,11,20,"PSC",758
25,"25170",261,230,228,4,2,"PSC",28
43,"43019",1336,1020,1008,4,12,"PSC",172
17,"17114",23269,17558,17474,91,84,"PSC",2871
8,"8148",2334,1803,1794,6,9,"PSC",403
8,"8146",1358,1086,1079,2,7,"PSC",247
25,"25217",10819,8163,8120,64,43,"PSC",1233
17,"17139",1394,1163,1154,3,9,"PSC",138
25,"25081",287,221,220,2,1,"PSC",35
25,"25200",323,253,252,0,1,"PSC",29
17,"17110",1329,1064,1054,5,10,"PSC",247
8,"8045",71,52,49,0,3,"PSC",0
8,"8036",163,134,133,0,1,"PSC",10
8,"8030",5209,4318,4305,16,13,"PSC",584
25,"25133",686,528,527,2,1,"PSC",52
25,"25175",176,135,135,1,0,"PSC",9
17,"17201",143,120,120,0,0,"PSC",5
17,"17133",1273,1048,1043,7,5,"PSC",80
17,"17099",78,59,59,0,0,"PSC",7
8,"8103",640,507,505,4,2,"PSC",49
43,"43176",746,588,586,7,2,"PSC",65
8,"8279",155280,121081,120515,802,566,"PSC",30917
8,"8034",784,648,646,1,2,"PSC",51
8,"8218",8104,6419,6389,34,30,"PSC",1549
8,"8060",135,111,109,0,2,"PSC",8
8,"8183",4563,3628,3613,9,15,"PSC",441
25,"25001",139,104,103,1,1,"PSC",15
8,"8245",77805,57956,57666,313,290,"PSC",21795
17,"17228",285,229,229,1,0,"PSC",24
25,"25051",1510,1176,1172,6,4,"PSC",146
17,"17025",1170,972,967,6,5,"PSC",95
17,"17037",114,98,98,6,0,"PSC",4
17,"17022",7008,5386,5354,22,32,"PSC",895
17,"17008",3594,2763,2741,16,22,"PSC",323
25,"25208",333,252,249,0,3,"PSC",27
8,"8219",15629,12910,12865,58,45,"PSC",2146
17,"17184",1264,1068,1060,5,8,"PSC",91
25,"25149",1378,1108,1102,3,6,"PSC",177
43,"43081",633,532,531,7,1,"PSC",67
25,"25158",1606,1291,1277,5,14,"PSC",139
8,"8128",577,454,451,0,3,"PSC",48
17,"17101",562,415,413,2,2,"PSC",68
17,"17029",199,160,157,1,3,"PSC",13
8,"8171",2066,1607,1597,7,10,"PSC",134
8,"8178",451,389,388,3,1,"PSC",40
17,"17102",548,439,435,3,4,"PSC",46
25,"25223",911,732,723,6,9,"PSC",60
43,"43047",4209,2878,2856,23,22,"PSC",869
25,"25153",192,152,150,1,2,"PSC",13
43,"43164",306,228,228,0,0,"PSC",69
25,"25048",1632,1274,1264,7,10,"PSC",196
8,"8272",165,133,133,0,0,"PSC",6
25,"25100",184,145,144,1,1,"PSC",12
8,"8223",1886,1434,1425,4,9,"PSC",169
25,"25068",531,402,399,6,3,"PSC",44
8,"8088",12248,9945,9904,57,41,"PSC",1566
43,"43152",434,357,356,0,1,"PSC",65
25,"25141",152,118,118,1,0,"PSC",7
25,"25111",113,90,89,0,1,"PSC",5
17,"17178",1056,804,798,3,6,"PSC",102
17,"17078",336,252,251,3,1,"PSC",12
17,"17214",723,584,580,7,4,"PSC",56
25,"25008",1088,867,857,7,10,"PSC",84
17,"17111",958,772,771,3,1,"PSC",71
17,"17035",550,460,460,3,0,"PSC",29
8,"8081",353,299,297,2,2,"PSC",10
43,"43106",793,656,651,2,5,"PSC",106
8,"8037",1930,1618,1610,10,8,"PSC",114
8,"8195",76,69,69,0,0,"PSC",8
17,"17039",1740,1385,1380,8,5,"PSC",217
8,"8282",6711,5696,5677,27,19,"PSC",897
8,"8002",220,184,183,2,1,"PSC",13
8,"8040",11004,8468,8431,24,37,"PSC",1461
8,"8187",153380,120687,120090,637,597,"PSC",32186
25,"25222",66,57,57,0,0,"PSC",5
25,"25040",10614,7791,7734,58,57,"PSC",1521
25,"25022",107,88,88,0,0,"PSC",3
8,"8224",878,697,695,1,2,"PSC",96
25,"25014",249,203,200,2,3,"PSC",11
17,"17136",195,156,155,0,1,"PSC",12
43,"43142",1083,850,842,8,8,"PSC",109
43,"43067",528,450,445,1,5,"PSC",55
8,"8137",274,232,229,0,3,"PSC",24
17,"17148",1531,1165,1153,4,12,"PSC",194
43,"43125",890,700,698,12,2,"PSC",179
8,"8151",448,378,377,2,1,"PSC",24
25,"25156",784,608,605,4,3,"PSC",74
25,"25242",689,539,531,0,8,"PSC",65
8,"8305",27533,21656,21539,96,117,"PSC",4423
17,"17103",5084,3575,3543,13,32,"PSC",767
8,"8242",222,180,180,0,0,"PSC",17
43,"43088",2026,1565,1562,9,3,"PSC",183
25,"25132",143,118,118,0,0,"PSC",11
43,"43129",4611,3528,3495,21,33,"PSC",479
8,"8102",28794,22420,22317,92,103,"PSC",4075
25,"25004",575,470,467,2,3,"PSC",56
8,"8194",25674,17691,17585,115,106,"PSC",5619
25,"25029",1607,1270,1265,6,5,"PSC",169
8,"8231",21132,15940,15880,75,60,"PSC",4331
8,"8262",6919,5090,5060,33,30,"PSC",1148
8,"8252",24729,19751,19642,125,109,"PSC",6050
25,"25088",95,85,83,0,2,"PSC",5
17,"17052",134,104,104,1,0,"PSC",5
25,"25049",155,113,111,0,2,"PSC",7
25,"25238",205,163,163,2,0,"PSC",7
43,"43050",2634,1881,1868,13,13,"PSC",467
8,"8118",17542,14101,14059,56,42,"PSC",2578
8,"8166",962,753,745,7,8,"PSC",136
25,"25243",3730,2637,2606,20,31,"PSC",719
43,"43903",2333,1717,1700,11,17,"PSC",267
8,"8121",87292,67638,67328,362,310,"PSC",17082
8,"8073",62572,48770,48527,255,243,"PSC",17570
25,"25127",214,172,172,0,0,"PSC",16
8,"8213",6547,5270,5245,23,25,"PSC",902
43,"43022",1435,1130,1123,8,7,"PSC",269
8,"8142",139,126,126,1,0,"PSC",15
8,"8043",3378,2579,2569,20,10,"PSC",617
17,"17046",710,574,571,3,3,"PSC",56
17,"17187",625,530,529,4,1,"PSC",63
43,"43127",759,630,626,3,4,"PSC",59
17,"17180",8500,6462,6431,28,31,"PSC",884
8,"8125",25485,19719,19627,101,92,"PSC",5809
8,"8283",6113,4832,4813,33,19,"PSC",610
43,"43061",38,28,28,0,0,"PSC",0
17,"17130",322,268,268,0,0,"PSC",7
25,"25105",103,89,88,1,1,"PSC",2
25,"25207",6430,4899,4867,41,32,"PSC",657
8,"8112",12935,9822,9765,74,57,"PSC",1668
8,"8169",48284,37528,37326,218,202,"PSC",12495
25,"25020",274,221,221,2,0,"PSC",22
43,"43135",341,283,280,4,3,"PSC",25
17,"17205",211,184,184,1,0,"PSC",17
8,"8269",2712,2258,2250,19,8,"PSC",194
25,"25244",362,296,294,2,2,"PSC",56
43,"43157",345,303,303,0,0,"PSC",35
8,"8201",447,327,324,5,3,"PSC",26
17,"17041",218,166,165,3,1,"PSC",18
25,"25210",1079,867,853,4,14,"PSC",122
17,"17227",139,106,106,0,0,"PSC",8
17,"17075",334,282,281,5,1,"PSC",17
8,"8236",1557,1204,1202,2,2,"PSC",163
8,"8094",1586,1310,1306,10,4,"PSC",191
17,"17002",564,491,488,3,3,"PSC",29
8,"8159",14323,11399,11359,57,40,"PSC",2940
17,"17903",889,726,721,4,5,"PSC",89
25,"25087",56,49,49,0,0,"PSC",8
17,"17055",143,126,125,0,1,"PSC",7
43,"43028",2766,2007,1988,7,19,"PSC",448
43,"43068",483,367,365,5,2,"PSC",104
43,"43056",806,616,613,5,3,"PSC",57
8,"8221",12699,10571,10537,53,34,"PSC",2088
25,"25046",407,349,347,1,2,"PSC",34
8,"8110",13592,10111,10058,50,53,"PSC",2540
43,"43166",1628,1292,1285,3,7,"PSC",261
8,"8104",653,516,516,2,0,"PSC",35
43,"43086",5263,4046,4021,17,25,"PSC",654
43,"43144",1236,1025,1021,8,4,"PSC",158
8,"8147",17282,13644,13560,94,84,"PSC",3104
8,"8248",5616,4378,4365,32,13,"PSC",716
17,"17043",167,135,134,0,1,"PSC",13
43,"43103",905,746,740,8,6,"PSC",136
25,"25047",972,784,781,8,3,"PSC",72
8,"8216",25,19,19,0,0,"PSC",3
8,"8168",394,287,287,1,0,"PSC",28
25,"25007",1392,1089,1083,4,6,"PSC",180
25,"25010",196,156,155,2,1,"PSC",9
25,"25019",4646,3224,3199,22,25,"PSC",647
8,"8018",2551,1998,1984,6,14,"PSC",415
43,"43012",3647,3028,3019,15,9,"PSC",583
8,"8154",701,587,586,5,1,"PSC",87
17,"17068",246,194,193,0,1,"PSC",23
8,"8124",37130,29069,28915,146,154,"PSC",9210
8,"8174",392,330,330,4,0,"PSC",29
43,"43029",314,253,252,0,1,"PSC",21
25,"25082",295,229,229,2,0,"PSC",27
25,"25041",528,399,396,4,3,"PSC",52
36,"36038",66806,50974,50429,507,545,"PSdeG-PSOE",16349
32,"32064",480,348,346,2,2,"PSdeG-PSOE",74
32,"32052",1819,1399,1379,15,20,"PSdeG-PSOE",347
15,"15005",25263,17634,17347,257,287,"PSdeG-PSOE",5596
32,"32048",864,550,544,1,6,"PSdeG-PSOE",236
36,"36028",4069,3012,2960,27,52,"PSdeG-PSOE",914
32,"32056",1520,1125,1116,6,9,"PSdeG-PSOE",326
27,"27035",180,127,123,0,4,"PSdeG-PSOE",53
32,"32069",4256,3358,3309,39,49,"PSdeG-PSOE",1289
15,"15076",2514,1709,1683,19,26,"PSdeG-PSOE",459
27,"27058",3322,2551,2512,22,39,"PSdeG-PSOE",792
15,"15073",21760,14900,14630,181,270,"PSdeG-PSOE",3663
15,"15017",19860,14930,14706,204,224,"PSdeG-PSOE",4973
27,"27020",3380,2764,2713,32,51,"PSdeG-PSOE",646
15,"15012",3611,2695,2616,36,79,"PSdeG-PSOE",668
36,"36006",11468,8959,8782,66,177,"PSdeG-PSOE",2313
32,"32088",1610,1040,1019,11,21,"PSdeG-PSOE",379
15,"15093",4048,2761,2720,41,41,"PSdeG-PSOE",675
36,"36055",13551,9908,9682,105,226,"PSdeG-PSOE",2814
36,"36054",11074,8032,7873,77,159,"PSdeG-PSOE",2389
32,"32062",766,582,579,1,3,"PSdeG-PSOE",162
27,"27014",3162,2181,2139,17,42,"PSdeG-PSOE",743
36,"36027",4380,3262,3206,26,56,"PSdeG-PSOE",907
15,"15084",3059,2236,2217,20,19,"PSdeG-PSOE",519
32,"32081",2035,1592,1565,14,27,"PSdeG-PSOE",523
15,"15075",12785,9638,9519,121,119,"PSdeG-PSOE",2853
27,"27048",2019,1499,1467,23,32,"PSdeG-PSOE",666
27,"27062",584,467,466,3,1,"PSdeG-PSOE",187
36,"36035",14571,11096,10917,105,179,"PSdeG-PSOE",3563
15,"15082",15381,11803,11642,133,161,"PSdeG-PSOE",3244
15,"15054",31802,22002,21676,368,326,"PSdeG-PSOE",6996
36,"36036",2556,1953,1914,14,39,"PSdeG-PSOE",565
32,"32073",1281,941,932,9,9,"PSdeG-PSOE",343
15,"15062",5652,3803,3728,25,75,"PSdeG-PSOE",906
15,"15051",4562,3302,3249,36,53,"PSdeG-PSOE",1114
15,"15004",4873,3689,3623,31,66,"PSdeG-PSOE",1219
36,"36005",8122,5895,5776,65,119,"PSdeG-PSOE",1978
32,"32004",1671,907,899,7,8,"PSdeG-PSOE",95
27,"27053",501,384,373,1,11,"PSdeG-PSOE",216
36,"36061",8617,6498,6391,59,107,"PSdeG-PSOE",1645
15,"15078",78678,60510,59882,621,628,"PSdeG-PSOE",17606
32,"32078",1108,794,781,15,13,"PSdeG-PSOE",198
36,"36019",1463,1041,1030,14,11,"PSdeG-PSOE",470
36,"36050",7650,5616,5506,48,110,"PSdeG-PSOE",1922
32,"32076",1974,1492,1472,17,20,"PSdeG-PSOE",365
32,"32011",918,526,521,6,5,"PSdeG-PSOE",54
32,"32014",1045,775,769,5,6,"PSdeG-PSOE",204
36,"36053",5784,4407,4327,28,80,"PSdeG-PSOE",1093
32,"32041",759,510,502,2,8,"PSdeG-PSOE",152
27,"27055",1197,857,851,2,6,"PSdeG-PSOE",328
15,"15079",1466,1076,1052,11,24,"PSdeG-PSOE",312
15,"15044",1209,889,876,4,13,"PSdeG-PSOE",253
27,"27029",1427,1068,1047,13,21,"PSdeG-PSOE",358
27,"27026",2315,1620,1599,17,21,"PSdeG-PSOE",582
15,"15045",3629,2263,2237,9,26,"PSdeG-PSOE",569
27,"27007",2756,2148,2084,29,64,"PSdeG-PSOE",560
15,"15023",6318,4501,4436,40,65,"PSdeG-PSOE",1547
15,"15028",1393,1076,1063,8,13,"PSdeG-PSOE",355
15,"15010",1819,1194,1181,16,13,"PSdeG-PSOE",353
27,"27025",2743,2191,2138,31,53,"PSdeG-PSOE",550
15,"15031",23779,17963,17787,213,176,"PSdeG-PSOE",6434
27,"27034",1025,647,636,4,11,"PSdeG-PSOE",275
15,"15055",4485,3097,3057,39,40,"PSdeG-PSOE",1113
27,"27023",2470,1833,1797,20,36,"PSdeG-PSOE",491
32,"32034",1074,855,846,1,9,"PSdeG-PSOE",271
15,"15022",5574,3846,3798,41,48,"PSdeG-PSOE",1224
15,"15034",2724,1832,1811,8,21,"PSdeG-PSOE",895
27,"27064",1503,1078,1039,12,39,"PSdeG-PSOE",279
27,"27049",1342,934,921,11,13,"PSdeG-PSOE",290
36,"36031",562,455,450,2,5,"PSdeG-PSOE",101
15,"15083",1036,784,768,7,16,"PSdeG-PSOE",146
32,"32006",1434,1033,1019,8,14,"PSdeG-PSOE",255
15,"15046",6163,4625,4497,49,128,"PSdeG-PSOE",1171
32,"32084",902,636,631,2,5,"PSdeG-PSOE",232
36,"36037",2554,1839,1793,6,46,"PSdeG-PSOE",481
15,"15085",3220,2284,2239,23,45,"PSdeG-PSOE",624
32,"32001",5105,3760,3715,37,45,"PSdeG-PSOE",971
36,"36013",2242,1468,1452,15,16,"PSdeG-PSOE",367
32,"32070",512,307,304,8,3,"PSdeG-PSOE",109
15,"15040",2675,2011,1979,20,32,"PSdeG-PSOE",608
32,"32023",1132,867,862,7,5,"PSdeG-PSOE",348
32,"32057",514,367,365,5,2,"PSdeG-PSOE",178
32,"32008",8572,6301,6216,65,85,"PSdeG-PSOE",2091
27,"27016",6973,5139,5064,66,75,"PSdeG-PSOE",1689
27,"27059",2055,1508,1471,13,37,"PSdeG-PSOE",373
32,"32013",2017,1388,1380,5,8,"PSdeG-PSOE",328
36,"36009",4445,3081,2997,26,84,"PSdeG-PSOE",852
15,"15043",4978,3631,3572,39,59,"PSdeG-PSOE",1104
27,"27045",944,700,698,13,2,"PSdeG-PSOE",403
36,"36044",2539,1768,1708,18,60,"PSdeG-PSOE",477
27,"27017",961,667,654,1,13,"PSdeG-PSOE",217
36,"36030",3946,2847,2810,26,37,"PSdeG-PSOE",853
15,"15086",2785,2015,1987,14,28,"PSdeG-PSOE",527
27,"27032",3194,2268,2223,20,45,"PSdeG-PSOE",724
32,"32090",738,530,525,3,5,"PSdeG-PSOE",109
32,"32019",11512,8281,8161,96,120,"PSdeG-PSOE",2496
32,"32028",1550,1176,1171,10,5,"PSdeG-PSOE",215
15,"15003",1701,1234,1210,10,24,"PSdeG-PSOE",362
32,"32007",1412,1011,1001,9,10,"PSdeG-PSOE",310
15,"15053",7548,5364,5309,44,55,"PSdeG-PSOE",1734
15,"15016",4569,3171,3146,18,25,"PSdeG-PSOE",1410
15,"15047",2269,1531,1497,25,34,"PSdeG-PSOE",502
36,"36058",4942,3470,3402,37,68,"PSdeG-PSOE",1192
15,"15007",3179,2333,2304,22,29,"PSdeG-PSOE",803
36,"36034",3319,2384,2347,16,37,"PSdeG-PSOE",714
32,"32018",1179,950,936,3,14,"PSdeG-PSOE",494
27,"27028",78798,58316,57546,629,770,"PSdeG-PSOE",19735
32,"32075",4382,3546,3489,35,57,"PSdeG-PSOE",955
36,"36902",5052,3813,3724,21,89,"PSdeG-PSOE",1226
15,"15042",2955,2057,2002,16,55,"PSdeG-PSOE",565
32,"32061",1070,862,855,8,7,"PSdeG-PSOE",273
32,"32077",1104,820,815,10,5,"PSdeG-PSOE",290
15,"15092",6250,4358,4297,28,61,"PSdeG-PSOE",1635
32,"32060",765,577,567,2,10,"PSdeG-PSOE",266
27,"27010",4402,3015,2940,49,75,"PSdeG-PSOE",821
36,"36016",1064,707,696,7,11,"PSdeG-PSOE",120
32,"32012",716,497,487,7,10,"PSdeG-PSOE",159
27,"27902",7150,5067,4953,74,114,"PSdeG-PSOE",1400
15,"15008",5631,4320,4267,64,53,"PSdeG-PSOE",1344
27,"27001",2209,1290,1251,25,39,"PSdeG-PSOE",293
15,"15056",5648,4033,3979,39,54,"PSdeG-PSOE",1336
27,"27027",1806,1392,1354,18,38,"PSdeG-PSOE",502
27,"27050",2842,2100,2072,19,28,"PSdeG-PSOE",578
36,"36017",17419,12867,12610,120,257,"PSdeG-PSOE",3777
15,"15089",4324,3258,3200,33,58,"PSdeG-PSOE",928
36,"36048",5244,3859,3786,33,73,"PSdeG-PSOE",1115
15,"15025",1000,639,631,6,8,"PSdeG-PSOE",221
15,"15091",1103,773,758,16,15,"PSdeG-PSOE",213
27,"27030",3134,2209,2162,27,47,"PSdeG-PSOE",643
32,"32072",3687,2715,2682,22,33,"PSdeG-PSOE",983
32,"32032",7932,5956,5831,55,125,"PSdeG-PSOE",1605
27,"27033",598,423,415,1,8,"PSdeG-PSOE",140
27,"27024",1451,1122,1102,5,20,"PSdeG-PSOE",403
15,"15061",5199,3694,3601,40,93,"PSdeG-PSOE",1076
32,"32054",86475,64472,63712,676,760,"PSdeG-PSOE",23209
15,"15002",24007,18075,17857,216,218,"PSdeG-PSOE",5386
27,"27008",1345,965,946,17,19,"PSdeG-PSOE",337
32,"32026",2659,1988,1957,26,31,"PSdeG-PSOE",791
36,"36049",7019,5414,5283,48,131,"PSdeG-PSOE",1339
15,"15030",199972,151737,150397,1576,1340,"PSdeG-PSOE",49567
27,"27044",2719,1848,1797,29,51,"PSdeG-PSOE",518
27,"27006",2458,1713,1666,27,47,"PSdeG-PSOE",549
15,"15090",1125,811,800,7,11,"PSdeG-PSOE",136
36,"36052",7234,5292,5151,44,141,"PSdeG-PSOE",1625
15,"15020",3593,2491,2469,18,22,"PSdeG-PSOE",824
15,"15067",7953,6004,5925,51,79,"PSdeG-PSOE",1807
15,"15024",4346,3210,3151,19,59,"PSdeG-PSOE",1040
36,"36025",2137,1387,1381,7,6,"PSdeG-PSOE",277
32,"32033",676,480,468,4,12,"PSdeG-PSOE",127
32,"32015",830,543,541,4,2,"PSdeG-PSOE",158
15,"15065",7151,5281,5165,63,116,"PSdeG-PSOE",1541
32,"32010",360,276,273,3,3,"PSdeG-PSOE",82
15,"15039",1224,874,850,11,24,"PSdeG-PSOE",256
15,"15049",1091,805,796,8,9,"PSdeG-PSOE",141
32,"32025",1013,773,761,7,12,"PSdeG-PSOE",203
36,"36056",4961,3719,3635,30,84,"PSdeG-PSOE",923
36,"36004",10123,7396,7273,93,123,"PSdeG-PSOE",1989
32,"32047",1746,1272,1252,6,20,"PSdeG-PSOE",284
27,"27037",1017,759,748,10,11,"PSdeG-PSOE",244
15,"15036",56248,40194,39764,508,430,"PSdeG-PSOE",12857
32,"32022",1238,924,916,5,8,"PSdeG-PSOE",333
15,"15027",1555,1227,1204,18,23,"PSdeG-PSOE",368
27,"27041",2238,1640,1615,10,25,"PSdeG-PSOE",459
32,"32016",724,543,535,3,8,"PSdeG-PSOE",318
27,"27004",1149,741,722,2,19,"PSdeG-PSOE",223
32,"32058",5225,3915,3857,35,58,"PSdeG-PSOE",1174
15,"15087",5692,3883,3838,53,45,"PSdeG-PSOE",1280
32,"32080",286,223,220,1,3,"PSdeG-PSOE",47
15,"15037",4031,2700,2677,13,23,"PSdeG-PSOE",768
27,"27051",8012,5936,5832,70,104,"PSdeG-PSOE",1866
15,"15068",4849,3435,3392,55,43,"PSdeG-PSOE",1082
32,"32017",1202,821,815,6,6,"PSdeG-PSOE",225
27,"27054",1145,907,890,5,17,"PSdeG-PSOE",268
36,"36014",1872,1373,1345,14,28,"PSdeG-PSOE",357
32,"32027",1000,762,747,5,15,"PSdeG-PSOE",233
32,"32082",1178,880,872,12,8,"PSdeG-PSOE",268
36,"36901",4152,3400,3338,15,62,"PSdeG-PSOE",1395
32,"32043",2512,1805,1789,16,16,"PSdeG-PSOE",545
15,"15902",4522,3220,3159,47,61,"PSdeG-PSOE",955
15,"15013",6299,4549,4486,45,63,"PSdeG-PSOE",1260
27,"27038",923,688,677,12,11,"PSdeG-PSOE",306
32,"32071",1378,963,954,7,9,"PSdeG-PSOE",339
15,"15015",2883,2079,2049,21,30,"PSdeG-PSOE",626
15,"15001",4689,3422,3362,52,60,"PSdeG-PSOE",950
15,"15029",5403,3682,3622,62,60,"PSdeG-PSOE",1138
27,"27002",1546,1136,1103,9,33,"PSdeG-PSOE",476
27,"27022",4683,3131,3059,30,72,"PSdeG-PSOE",1054
36,"36059",4663,3196,3115,31,81,"PSdeG-PSOE",761
15,"15064",2127,1608,1577,29,31,"PSdeG-PSOE",582
36,"36015",4076,2903,2834,37,69,"PSdeG-PSOE",1074
27,"27065",12076,8393,8183,128,210,"PSdeG-PSOE",2525
27,"27043",1219,814,797,6,17,"PSdeG-PSOE",263
32,"32089",1220,872,857,15,15,"PSdeG-PSOE",233
27,"27039",4430,3437,3353,53,84,"PSdeG-PSOE",880
36,"36033",12244,9553,9358,80,195,"PSdeG-PSOE",3133
32,"32024",4835,3484,3439,23,45,"PSdeG-PSOE",1072
15,"15901",3359,2237,2205,35,32,"PSdeG-PSOE",779
36,"36046",4043,3157,3084,27,73,"PSdeG-PSOE",968
32,"32040",1418,1083,1075,3,8,"PSdeG-PSOE",287
32,"32021",874,616,615,4,1,"PSdeG-PSOE",273
32,"32059",1703,1248,1228,12,20,"PSdeG-PSOE",394
36,"36001",2401,1739,1715,19,24,"PSdeG-PSOE",524
36,"36057",238171,181891,180030,1636,1861,"PSdeG-PSOE",65551
27,"27056",1206,896,880,9,16,"PSdeG-PSOE",310
27,"27066",12633,9139,8911,84,228,"PSdeG-PSOE",3128
36,"36060",30432,22488,22196,199,292,"PSdeG-PSOE",7504
15,"15033",2422,1887,1866,13,21,"PSdeG-PSOE",536
32,"32002",2022,1510,1485,8,25,"PSdeG-PSOE",605
27,"27040",3035,2285,2234,19,51,"PSdeG-PSOE",653
27,"27057",11097,7917,7735,88,182,"PSdeG-PSOE",2511
27,"27901",2275,1542,1531,27,11,"PSdeG-PSOE",436
36,"36022",9061,6640,6482,47,158,"PSdeG-PSOE",2118
32,"32038",399,274,271,3,3,"PSdeG-PSOE",103
27,"27052",862,645,640,4,5,"PSdeG-PSOE",294
32,"32042",1505,1097,1091,12,6,"PSdeG-PSOE",324
15,"15059",10255,7423,7262,122,161,"PSdeG-PSOE",2013
15,"15088",3415,2349,2323,28,26,"PSdeG-PSOE",684
27,"27061",1016,784,763,9,21,"PSdeG-PSOE",305
36,"36020",2184,1621,1599,13,22,"PSdeG-PSOE",413
36,"36040",2517,1895,1853,18,42,"PSdeG-PSOE",612
15,"15072",9436,6962,6860,60,102,"PSdeG-PSOE",2020
27,"27060",2463,1695,1669,12,26,"PSdeG-PSOE",521
36,"36029",16086,12196,12005,126,191,"PSdeG-PSOE",3518
32,"32068",1419,998,987,4,11,"PSdeG-PSOE",325
32,"32050",2280,1788,1775,19,13,"PSdeG-PSOE",469
27,"27012",1276,776,768,9,8,"PSdeG-PSOE",347
15,"15077",8155,5554,5433,59,121,"PSdeG-PSOE",1456
32,"32036",1261,954,938,9,16,"PSdeG-PSOE",189
36,"36007",1618,1163,1133,7,30,"PSdeG-PSOE",391
36,"36008",21884,16428,16170,165,258,"PSdeG-PSOE",4406
32,"32051",1407,1158,1153,12,5,"PSdeG-PSOE",286
15,"15035",11208,8175,8068,105,107,"PSdeG-PSOE",2720
27,"27031",15212,10826,10649,125,177,"PSdeG-PSOE",3845
15,"15066",4008,2931,2886,30,45,"PSdeG-PSOE",706
15,"15057",12051,8814,8660,89,154,"PSdeG-PSOE",2491
27,"27003",1772,1271,1241,6,30,"PSdeG-PSOE",353
27,"27018",3232,2114,2089,24,25,"PSdeG-PSOE",926
36,"36039",15610,11844,11592,103,252,"PSdeG-PSOE",3502
36,"36032",3537,2676,2626,16,50,"PSdeG-PSOE",807
36,"36051",14315,10396,10223,70,173,"PSdeG-PSOE",2901
36,"36043",4682,3345,3303,17,42,"PSdeG-PSOE",1017
36,"36026",19924,14342,14132,171,210,"PSdeG-PSOE",3920
36,"36018",3073,2184,2144,9,40,"PSdeG-PSOE",643
27,"27015",4020,2809,2730,33,79,"PSdeG-PSOE",864
27,"27019",8189,6148,6039,94,109,"PSdeG-PSOE",2059
27,"27009",2022,1514,1488,17,26,"PSdeG-PSOE",404
32,"32030",944,690,685,7,5,"PSdeG-PSOE",393
32,"32091",1703,1312,1306,4,6,"PSdeG-PSOE",495
32,"32087",1675,1313,1288,18,25,"PSdeG-PSOE",357
36,"36045",24478,18627,18327,157,300,"PSdeG-PSOE",6558
15,"15060",5843,4360,4281,65,79,"PSdeG-PSOE",1340
32,"32005",827,628,622,4,6,"PSdeG-PSOE",145
32,"32083",821,592,587,7,5,"PSdeG-PSOE",161
15,"15048",5048,3791,3730,38,61,"PSdeG-PSOE",1158
15,"15052",4104,2928,2878,30,50,"PSdeG-PSOE",1100
36,"36042",18072,13314,13091,130,223,"PSdeG-PSOE",4001
36,"36047",2287,1601,1585,14,16,"PSdeG-PSOE",546
32,"32009",10590,7661,7574,68,87,"PSdeG-PSOE",2692
15,"15041",9581,7223,7082,96,141,"PSdeG-PSOE",2096
27,"27013",3684,2997,2935,26,62,"PSdeG-PSOE",955
15,"15019",26006,18323,18075,280,248,"PSdeG-PSOE",5756
32,"32029",436,340,337,1,3,"PSdeG-PSOE",76
15,"15009",10615,8066,7919,93,147,"PSdeG-PSOE",2602
15,"15006",5169,3527,3436,32,91,"PSdeG-PSOE",1007
15,"15071",7805,5476,5401,62,75,"PSdeG-PSOE",1638
32,"32020",2460,1899,1876,6,23,"PSdeG-PSOE",551
32,"32046",1098,793,782,5,11,"PSdeG-PSOE",235
15,"15011",15481,11249,11037,105,212,"PSdeG-PSOE",3046
32,"32079",1287,1016,1006,6,10,"PSdeG-PSOE",352
15,"15014",3836,2739,2698,38,41,"PSdeG-PSOE",762
15,"15080",1640,1177,1150,9,27,"PSdeG-PSOE",452
36,"36041",13621,10098,9939,97,159,"PSdeG-PSOE",2752
32,"32065",630,478,474,5,4,"PSdeG-PSOE",185
27,"27042",1648,1247,1233,21,14,"PSdeG-PSOE",356
27,"27011",2358,1582,1558,12,24,"PSdeG-PSOE",635
32,"32037",681,534,523,6,11,"PSdeG-PSOE",112
32,"32086",2563,1699,1686,19,13,"PSdeG-PSOE",539
32,"32053",1363,1114,1098,14,16,"PSdeG-PSOE",233
15,"15021",5244,3884,3806,70,78,"PSdeG-PSOE",1230
32,"32055",1230,908,889,5,19,"PSdeG-PSOE",240
36,"36021",12099,9105,8974,85,131,"PSdeG-PSOE",2937
32,"32044",809,625,617,2,8,"PSdeG-PSOE",203
32,"32063",1819,1313,1287,6,26,"PSdeG-PSOE",521
27,"27005",2551,1908,1868,26,40,"PSdeG-PSOE",530
15,"15050",1748,1038,1027,15,11,"PSdeG-PSOE",393
32,"32003",889,667,654,3,13,"PSdeG-PSOE",189
32,"32074",993,737,734,4,3,"PSdeG-PSOE",231
15,"15081",982,755,741,11,14,"PSdeG-PSOE",143
15,"15058",28606,22203,22022,261,181,"PSdeG-PSOE",6813
32,"32035",1370,881,872,5,9,"PSdeG-PSOE",201
36,"36024",16395,12372,12165,102,207,"PSdeG-PSOE",2972
27,"27021",1649,1080,1048,14,32,"PSdeG-PSOE",361
32,"32066",551,399,396,1,3,"PSdeG-PSOE",69
15,"15032",3413,2487,2414,28,73,"PSdeG-PSOE",602
27,"27047",1525,1026,1008,5,18,"PSdeG-PSOE",338
32,"32092",482,337,334,2,3,"PSdeG-PSOE",98
32,"32031",1014,764,756,5,8,"PSdeG-PSOE",176
32,"32049",689,468,462,3,6,"PSdeG-PSOE",177
32,"32085",10634,7655,7551,66,104,"PSdeG-PSOE",2424
15,"15074",3919,2865,2808,33,57,"PSdeG-PSOE",683
15,"15070",8797,6312,6173,108,139,"PSdeG-PSOE",2536
36,"36002",3076,2225,2185,19,40,"PSdeG-PSOE",558
32,"32045",2360,1712,1689,18,23,"PSdeG-PSOE",578
27,"27063",1715,1236,1198,10,38,"PSdeG-PSOE",482
15,"15069",6588,4914,4830,58,84,"PSdeG-PSOE",1642
15,"15038",2123,1441,1413,25,28,"PSdeG-PSOE",437
15,"15018",1087,771,761,8,10,"PSdeG-PSOE",351
32,"32039",1142,895,890,7,5,"PSdeG-PSOE",228
36,"36003",10038,7747,7632,79,115,"PSdeG-PSOE",2092
27,"27046",1448,1074,1063,7,11,"PSdeG-PSOE",460
36,"36010",2828,2217,2184,15,33,"PSdeG-PSOE",809
32,"32067",1193,827,818,10,9,"PSdeG-PSOE",221
36,"36023",8279,6187,6085,46,102,"PSdeG-PSOE",1574
20,"20011",1633,1297,1287,2,10,"PSE-EE (PSO",131
48,"48067",1134,877,872,5,5,"PSE-EE (PSO",30
48,"48094",3125,2407,2388,12,19,"PSE-EE (PSO",161
48,"48037",684,537,531,4,6,"PSE-EE (PSO",56
48,"48064",613,494,492,1,2,"PSE-EE (PSO",16
48,"48097",1316,979,976,4,3,"PSE-EE (PSO",151
48,"48003",14444,11233,11162,43,71,"PSE-EE (PSO",1635
1,"1017",816,579,574,2,5,"PSE-EE (PSO",77
48,"48013",79423,59100,58630,458,470,"PSE-EE (PSO",17324
48,"48053",904,738,728,5,10,"PSE-EE (PSO",49
20,"20023",446,299,299,1,0,"PSE-EE (PSO",16
1,"1032",500,372,362,1,10,"PSE-EE (PSO",80
20,"20907",117,88,87,0,1,"PSE-EE (PSO",1
1,"1042",907,723,721,4,2,"PSE-EE (PSO",52
1,"1053",592,376,373,2,3,"PSE-EE (PSO",46
48,"48090",6016,4700,4639,24,61,"PSE-EE (PSO",1027
48,"48087",432,357,356,0,1,"PSE-EE (PSO",27
20,"20022",854,621,621,7,0,"PSE-EE (PSO",33
48,"48057",5745,4391,4376,13,15,"PSE-EE (PSO",162
20,"20038",380,296,295,0,1,"PSE-EE (PSO",8
1,"1002",8035,6227,6159,17,68,"PSE-EE (PSO",1036
48,"48024",999,813,811,2,2,"PSE-EE (PSO",19
48,"48063",356,277,274,2,3,"PSE-EE (PSO",8
48,"48023",580,493,489,0,4,"PSE-EE (PSO",22
20,"20015",1237,975,967,8,8,"PSE-EE (PSO",33
1,"1047",967,686,673,8,13,"PSE-EE (PSO",150
48,"48033",204,160,159,1,1,"PSE-EE (PSO",3
20,"20068",188,142,142,1,0,"PSE-EE (PSO",4
48,"48091",1090,862,857,9,5,"PSE-EE (PSO",72
48,"48028",691,576,573,1,3,"PSE-EE (PSO",11
20,"20075",4346,3158,3134,19,24,"PSE-EE (PSO",432
1,"1049",132,100,100,1,0,"PSE-EE (PSO",9
48,"48043",4539,3566,3556,22,10,"PSE-EE (PSO",356
20,"20070",1083,831,823,2,8,"PSE-EE (PSO",36
1,"1057",243,202,199,0,3,"PSE-EE (PSO",12
1,"1011",215,179,175,3,4,"PSE-EE (PSO",29
20,"20058",739,555,551,4,4,"PSE-EE (PSO",113
48,"48026",1139,920,913,4,7,"PSE-EE (PSO",22
20,"20073",4698,3530,3515,29,15,"PSE-EE (PSO",411
48,"48088",133,99,98,2,1,"PSE-EE (PSO",4
48,"48055",2596,2023,2005,12,18,"PSE-EE (PSO",218
48,"48061",799,636,636,2,0,"PSE-EE (PSO",34
20,"20021",186,112,112,0,0,"PSE-EE (PSO",6
48,"48906",753,611,608,1,3,"PSE-EE (PSO",32
20,"20076",7025,5263,5237,31,26,"PSE-EE (PSO",833
20,"20078",1145,882,879,4,3,"PSE-EE (PSO",43
48,"48913",1224,977,967,6,10,"PSE-EE (PSO",104
20,"20044",364,263,262,0,1,"PSE-EE (PSO",23
48,"48084",21858,15943,15796,116,147,"PSE-EE (PSO",4734
48,"48903",1807,1471,1462,6,9,"PSE-EE (PSO",101
20,"20061",4392,3278,3264,11,14,"PSE-EE (PSO",347
20,"20014",1156,772,765,4,7,"PSE-EE (PSO",45
20,"20001",257,174,172,1,2,"PSE-EE (PSO",8
20,"20041",234,156,151,2,5,"PSE-EE (PSO",6
1,"1006",176,127,127,2,0,"PSE-EE (PSO",21
1,"1022",761,577,569,5,8,"PSE-EE (PSO",154
20,"20045",46866,33932,33700,191,232,"PSE-EE (PSO",9805
48,"48911",388,323,322,3,1,"PSE-EE (PSO",5
48,"48086",2015,1504,1486,6,18,"PSE-EE (PSO",190
48,"48010",474,368,368,0,0,"PSE-EE (PSO",11
48,"48038",1158,891,891,2,0,"PSE-EE (PSO",46
20,"20009",11343,8168,8106,46,62,"PSE-EE (PSO",1995
20,"20003",551,401,399,2,2,"PSE-EE (PSO",28
48,"48070",528,392,390,2,2,"PSE-EE (PSO",5
20,"20062",945,727,726,3,1,"PSE-EE (PSO",42
20,"20032",8681,6491,6429,22,62,"PSE-EE (PSO",1104
1,"1058",1403,958,951,4,7,"PSE-EE (PSO",127
1,"1039",195,157,153,0,4,"PSE-EE (PSO",40
48,"48005",113,80,80,0,0,"PSE-EE (PSO",6
20,"20026",204,182,159,3,23,"PSE-EE (PSO",6
48,"48907",340,283,281,1,2,"PSE-EE (PSO",3
48,"48017",13150,9546,9504,38,42,"PSE-EE (PSO",690
48,"48078",37991,28582,28382,202,200,"PSE-EE (PSO",8610
1,"1902",730,551,545,6,6,"PSE-EE (PSO",101
1,"1063",1830,1363,1353,4,10,"PSE-EE (PSO",181
20,"20007",327,235,230,2,5,"PSE-EE (PSO",5
1,"1036",14772,10850,10746,69,104,"PSE-EE (PSO",2223
20,"20074",11503,8767,8720,26,47,"PSE-EE (PSO",1040
48,"48019",3461,2647,2633,12,14,"PSE-EE (PSO",430
20,"20031",183,125,125,2,0,"PSE-EE (PSO",2
48,"48016",5437,4282,4248,21,34,"PSE-EE (PSO",662
48,"48905",2490,1911,1891,16,20,"PSE-EE (PSO",231
20,"20052",1070,833,827,2,6,"PSE-EE (PSO",79
48,"48072",970,735,730,1,5,"PSE-EE (PSO",35
20,"20901",1412,1034,1030,2,4,"PSE-EE (PSO",149
48,"48032",5773,4504,4476,5,28,"PSE-EE (PSO",607
48,"48002",7777,6034,5981,48,53,"PSE-EE (PSO",1375
20,"20065",2943,2145,2124,11,21,"PSE-EE (PSO",396
20,"20042",3172,2247,2231,9,16,"PSE-EE (PSO",319
48,"48014",1242,915,910,4,5,"PSE-EE (PSO",109
48,"48914",325,286,285,0,1,"PSE-EE (PSO",2
1,"1037",585,426,425,1,1,"PSE-EE (PSO",40
1,"1043",2337,1669,1656,18,13,"PSE-EE (PSO",430
20,"20005",1267,884,882,2,2,"PSE-EE (PSO",70
48,"48046",12644,9809,9744,46,65,"PSE-EE (PSO",946
20,"20072",4752,3445,3412,24,33,"PSE-EE (PSO",670
20,"20046",1248,918,909,11,9,"PSE-EE (PSO",86
20,"20902",14229,10567,10495,53,72,"PSE-EE (PSO",3215
1,"1021",469,333,330,1,3,"PSE-EE (PSO",51
1,"1013",703,491,487,2,4,"PSE-EE (PSO",52
1,"1003",1179,908,903,6,5,"PSE-EE (PSO",37
48,"48048",543,421,419,1,2,"PSE-EE (PSO",19
48,"48004",326,261,260,3,1,"PSE-EE (PSO",1
1,"1055",840,608,602,10,6,"PSE-EE (PSO",100
20,"20034",3154,2336,2315,20,21,"PSE-EE (PSO",379
1,"1052",268,188,187,1,1,"PSE-EE (PSO",42
20,"20081",7655,5629,5601,22,28,"PSE-EE (PSO",840
20,"20049",4159,3024,3004,11,20,"PSE-EE (PSO",422
20,"20905",153,124,124,1,0,"PSE-EE (PSO",0
48,"48912",2331,1843,1833,7,10,"PSE-EE (PSO",285
48,"48049",545,448,448,0,0,"PSE-EE (PSO",10
48,"48904",3542,2832,2811,27,21,"PSE-EE (PSO",367
48,"48093",888,720,715,2,5,"PSE-EE (PSO",53
1,"1027",430,295,293,2,2,"PSE-EE (PSO",29
1,"1001",2005,1438,1419,4,19,"PSE-EE (PSO",304
20,"20067",30618,21972,21854,138,118,"PSE-EE (PSO",5801
48,"48052",1567,1309,1300,4,9,"PSE-EE (PSO",54
1,"1056",205,134,134,0,0,"PSE-EE (PSO",9
48,"48006",309,265,265,0,0,"PSE-EE (PSO",15
48,"48009",772,628,622,2,6,"PSE-EE (PSO",33
48,"48060",3620,2615,2606,13,9,"PSE-EE (PSO",127
20,"20020",113,67,67,0,0,"PSE-EE (PSO",1
48,"48022",2316,1645,1631,11,14,"PSE-EE (PSO",202
20,"20018",11218,8145,8109,41,36,"PSE-EE (PSO",509
1,"1060",201,174,166,1,8,"PSE-EE (PSO",19
20,"20035",484,384,384,2,0,"PSE-EE (PSO",15
48,"48015",33109,24697,24475,161,222,"PSE-EE (PSO",6529
48,"48041",686,581,579,2,2,"PSE-EE (PSO",27
20,"20904",89,50,49,0,1,"PSE-EE (PSO",1
48,"48007",385,281,279,1,2,"PSE-EE (PSO",4
48,"48069",13094,10021,9954,49,67,"PSE-EE (PSO",981
48,"48040",1309,979,973,5,6,"PSE-EE (PSO",58
20,"20080",7709,5629,5588,28,41,"PSE-EE (PSO",1665
48,"48039",256,218,217,1,1,"PSE-EE (PSO",10
20,"20071",15036,11090,11025,59,65,"PSE-EE (PSO",1350
48,"48071",6038,4711,4674,27,37,"PSE-EE (PSO",1134
20,"20024",391,274,274,1,0,"PSE-EE (PSO",10
48,"48030",601,490,489,0,1,"PSE-EE (PSO",19
48,"48089",3463,2746,2732,10,14,"PSE-EE (PSO",309
48,"48073",6837,4950,4921,33,29,"PSE-EE (PSO",253
20,"20017",8484,6294,6263,25,31,"PSE-EE (PSO",766
48,"48018",867,605,603,3,2,"PSE-EE (PSO",21
48,"48068",1528,1218,1211,5,7,"PSE-EE (PSO",47
20,"20029",4272,3257,3239,18,18,"PSE-EE (PSO",312
1,"1010",2315,1789,1770,14,19,"PSE-EE (PSO",196
1,"1046",631,464,461,0,3,"PSE-EE (PSO",73
48,"48021",1336,990,983,4,7,"PSE-EE (PSO",78
20,"20028",2258,1579,1574,9,5,"PSE-EE (PSO",281
48,"48075",2067,1591,1565,11,26,"PSE-EE (PSO",98
20,"20906",130,99,98,1,1,"PSE-EE (PSO",3
1,"1023",262,210,206,3,4,"PSE-EE (PSO",21
48,"48054",24938,19329,19197,124,132,"PSE-EE (PSO",3809
1,"1041",152,107,103,2,4,"PSE-EE (PSO",4
20,"20048",184,120,120,2,0,"PSE-EE (PSO",7
48,"48079",395,313,312,2,1,"PSE-EE (PSO",11
20,"20013",5430,4144,4119,19,25,"PSE-EE (PSO",526
20,"20057",194,143,143,0,0,"PSE-EE (PSO",6
48,"48011",9652,7293,7251,37,42,"PSE-EE (PSO",1422
48,"48025",860,694,694,3,0,"PSE-EE (PSO",24
1,"1051",3558,2448,2433,14,15,"PSE-EE (PSO",359
48,"48058",946,724,715,3,9,"PSE-EE (PSO",77
1,"1014",366,283,277,7,6,"PSE-EE (PSO",48
48,"48074",3273,2480,2460,14,20,"PSE-EE (PSO",326
1,"1061",152,129,129,2,0,"PSE-EE (PSO",10
48,"48909",202,172,172,2,0,"PSE-EE (PSO",4
48,"48095",2326,1691,1680,11,11,"PSE-EE (PSO",344
20,"20050",270,186,183,3,3,"PSE-EE (PSO",0
1,"1004",1356,1007,998,3,9,"PSE-EE (PSO",134
1,"1028",1068,774,772,7,2,"PSE-EE (PSO",143
1,"1901",2474,1655,1631,13,24,"PSE-EE (PSO",368
20,"20060",88,75,75,0,0,"PSE-EE (PSO",0
48,"48062",293,247,245,0,2,"PSE-EE (PSO",2
20,"20027",2758,1980,1958,19,22,"PSE-EE (PSO",136
1,"1031",1163,948,928,6,20,"PSE-EE (PSO",146
1,"1033",656,533,525,1,8,"PSE-EE (PSO",99
20,"20030",21198,15734,15654,100,80,"PSE-EE (PSO",4306
20,"20064",12436,8730,8652,59,78,"PSE-EE (PSO",1897
20,"20066",439,327,326,0,1,"PSE-EE (PSO",1
20,"20903",4803,3514,3481,24,33,"PSE-EE (PSO",471
48,"48076",284,226,224,1,2,"PSE-EE (PSO",10
1,"1020",320,239,238,1,1,"PSE-EE (PSO",24
48,"48042",1365,1136,1130,7,6,"PSE-EE (PSO",121
48,"48031",308,236,236,0,0,"PSE-EE (PSO",6
20,"20002",355,258,257,8,1,"PSE-EE (PSO",5
20,"20051",6775,5124,5091,24,33,"PSE-EE (PSO",896
48,"48056",989,791,785,4,6,"PSE-EE (PSO",25
1,"1034",150,111,111,2,0,"PSE-EE (PSO",20
48,"48066",347,291,291,0,0,"PSE-EE (PSO",7
1,"1016",421,236,229,3,7,"PSE-EE (PSO",29
48,"48092",869,676,674,9,2,"PSE-EE (PSO",59
48,"48035",404,334,331,2,3,"PSE-EE (PSO",8
20,"20019",9912,7226,7195,51,31,"PSE-EE (PSO",1318
20,"20053",4848,3479,3451,27,28,"PSE-EE (PSO",472
48,"48059",400,329,325,0,4,"PSE-EE (PSO",21
20,"20077",5254,4083,4059,22,24,"PSE-EE (PSO",795
20,"20040",15753,11440,11364,69,76,"PSE-EE (PSO",1796
1,"1030",143,118,117,1,1,"PSE-EE (PSO",22
1,"1044",231,171,166,0,5,"PSE-EE (PSO",37
20,"20016",1524,997,997,1,0,"PSE-EE (PSO",44
48,"48008",615,454,448,4,6,"PSE-EE (PSO",32
20,"20079",18142,14055,13971,75,84,"PSE-EE (PSO",1871
20,"20036",13192,9864,9806,67,58,"PSE-EE (PSO",1381
48,"48082",37396,27913,27694,172,219,"PSE-EE (PSO",7343
48,"48085",10637,8270,8223,54,47,"PSE-EE (PSO",1030
48,"48065",3303,2541,2524,15,17,"PSE-EE (PSO",374
48,"48081",1883,1532,1518,3,14,"PSE-EE (PSO",136
48,"48029",8613,6697,6642,52,55,"PSE-EE (PSO",1671
20,"20054",459,313,312,1,1,"PSE-EE (PSO",8
48,"48096",6510,5247,5185,36,62,"PSE-EE (PSO",895
20,"20004",227,156,154,4,2,"PSE-EE (PSO",10
20,"20059",8867,6792,6759,21,33,"PSE-EE (PSO",576
1,"1019",148,121,121,0,0,"PSE-EE (PSO",7
48,"48908",249,214,213,0,1,"PSE-EE (PSO",11
1,"1054",1013,729,726,2,3,"PSE-EE (PSO",79
48,"48915",347,259,259,4,0,"PSE-EE (PSO",7
1,"1008",802,576,570,3,6,"PSE-EE (PSO",89
1,"1018",1408,998,993,6,5,"PSE-EE (PSO",141
48,"48051",216,157,157,0,0,"PSE-EE (PSO",19
20,"20055",17378,12565,12482,55,83,"PSE-EE (PSO",2353
48,"48045",5194,4138,4098,25,40,"PSE-EE (PSO",622
20,"20037",103,77,77,0,0,"PSE-EE (PSO",1
48,"48036",24038,18180,18050,94,130,"PSE-EE (PSO",3366
20,"20043",1734,1254,1248,5,6,"PSE-EE (PSO",62
48,"48034",12639,9519,9443,77,76,"PSE-EE (PSO",2846
48,"48901",5151,4042,4012,22,30,"PSE-EE (PSO",818
48,"48902",18971,14015,13895,101,120,"PSE-EE (PSO",3289
48,"48044",62054,49055,48840,373,215,"PSE-EE (PSO",6886
20,"20039",2144,1704,1692,11,12,"PSE-EE (PSO",76
48,"48027",22668,17326,17224,95,102,"PSE-EE (PSO",2632
20,"20012",148,113,112,0,1,"PSE-EE (PSO",5
20,"20008",704,455,449,6,6,"PSE-EE (PSO",18
1,"1059",189037,133121,131768,792,1353,"PSE-EE (PSO",31954
20,"20025",1116,835,830,2,5,"PSE-EE (PSO",51
20,"20063",8061,6042,5999,36,43,"PSE-EE (PSO",431
48,"48910",2802,2082,2073,3,9,"PSE-EE (PSO",441
48,"48020",272959,203643,202331,1472,1312,"PSE-EE (PSO",41685
48,"48050",187,153,149,0,4,"PSE-EE (PSO",7
48,"48001",5885,4359,4334,35,25,"PSE-EE (PSO",801
48,"48077",3376,2656,2647,11,9,"PSE-EE (PSO",257
20,"20006",254,169,169,0,0,"PSE-EE (PSO",6
20,"20069",147441,111102,110598,762,504,"PSE-EE (PSO",23324
20,"20056",4075,2983,2942,12,41,"PSE-EE (PSO",200
20,"20010",1528,1156,1151,5,5,"PSE-EE (PSO",125
1,"1009",1265,920,914,6,6,"PSE-EE (PSO",113
48,"48083",6946,5238,5201,35,37,"PSE-EE (PSO",1338
20,"20047",462,337,335,2,2,"PSE-EE (PSO",17
48,"48080",9946,7574,7499,46,75,"PSE-EE (PSO",2095
48,"48047",149,115,115,1,0,"PSE-EE (PSO",1
48,"48012",2071,1685,1674,7,11,"PSE-EE (PSO",88
20,"20033",854,675,671,5,4,"PSE-EE (PSO",39
1,"1062",315,236,229,2,7,"PSE-EE (PSO",32
31,"31062",1075,870,861,10,9,"PSOE",356
6,"6126",2142,1619,1594,9,25,"PSOE",742
22,"22151",88,66,65,0,1,"PSOE",12
45,"45099",3635,2741,2684,23,57,"PSOE",791
50,"50181",1000,770,754,7,16,"PSOE",223
10,"10020",1576,1259,1225,9,34,"PSOE",632
50,"50295",49,46,46,0,0,"PSOE",20
3,"3083",5487,3993,3934,28,59,"PSOE",1412
37,"37269",430,331,325,2,6,"PSOE",125
26,"26113",31,30,30,0,0,"PSOE",3
9,"9332",140,103,102,0,1,"PSOE",20
4,"4008",464,386,383,4,3,"PSOE",105
18,"18093",2756,1902,1885,8,17,"PSOE",746
28,"28113",36716,29939,29607,224,332,"PSOE",8762
47,"47007",4036,3261,3217,25,44,"PSOE",848
31,"31090",141,86,86,0,0,"PSOE",11
28,"28086",5390,3992,3936,26,56,"PSOE",1026
29,"29904",417,337,335,2,2,"PSOE",257
40,"40148",228,185,180,0,5,"PSOE",53
47,"47124",388,322,319,2,3,"PSOE",98
49,"49083",50,41,41,1,0,"PSOE",5
9,"9058",395,325,317,1,8,"PSOE",69
50,"50267",573,440,434,7,6,"PSOE",199
21,"21040",3181,2303,2227,21,76,"PSOE",886
39,"39080",3505,2735,2701,8,34,"PSOE",726
31,"31186",288,220,216,1,4,"PSOE",28
31,"31051",234,183,182,2,1,"PSOE",46
2,"2007",1013,820,813,6,7,"PSOE",442
46,"46001",783,612,607,4,5,"PSOE",193
37,"37018",110,86,85,1,1,"PSOE",21
9,"9303",75,67,67,0,0,"PSOE",11
28,"28119",2245,1839,1821,10,18,"PSOE",365
4,"4087",156,117,116,1,1,"PSOE",37
40,"40076",6537,5130,5012,22,118,"PSOE",1313
39,"39064",1341,1103,1094,5,9,"PSOE",173
42,"42085",178,133,133,3,0,"PSOE",19
44,"44158",1166,921,904,7,17,"PSOE",302
41,"41096",6134,4926,4845,44,81,"PSOE",1510
9,"9482",35,28,28,0,0,"PSOE",3
49,"49030",80,66,62,0,4,"PSOE",4
40,"40053",83,62,62,1,0,"PSOE",24
45,"45188",2762,2144,2098,14,46,"PSOE",737
46,"46101",816,696,687,3,9,"PSOE",233
12,"12055",106,85,83,2,2,"PSOE",24
4,"4075",5427,3989,3961,15,28,"PSOE",1438
50,"50002",125,96,91,1,5,"PSOE",17
9,"9307",112,87,86,0,1,"PSOE",47
31,"31225",35,29,29,1,0,"PSOE",13
23,"23033",1319,1076,1057,8,19,"PSOE",420
9,"9334",48,37,35,0,2,"PSOE",10
26,"26063",118,96,95,2,1,"PSOE",29
19,"19124",380,271,268,0,3,"PSOE",107
39,"39049",306,209,208,4,1,"PSOE",56
42,"42034",44,36,36,1,0,"PSOE",13
6,"6084",1065,904,890,8,14,"PSOE",338
31,"31197",65,56,56,0,0,"PSOE",29
9,"9384",295,222,216,1,6,"PSOE",38
45,"45128",2552,1874,1839,9,35,"PSOE",632
42,"42208",20,16,16,0,0,"PSOE",3
44,"44135",102,85,85,0,0,"PSOE",26
39,"39002",3414,2630,2578,23,52,"PSOE",738
50,"50101",832,625,614,1,11,"PSOE",248
47,"47046",125,107,104,1,3,"PSOE",33
11,"11029",5423,3161,3105,55,56,"PSOE",1160
18,"18102",8227,6100,5969,32,131,"PSOE",2932
9,"9120",38,32,31,2,1,"PSOE",11
14,"14031",566,453,446,2,7,"PSOE",194
3,"3118",2426,1741,1718,8,23,"PSOE",383
16,"16202",741,573,568,4,5,"PSOE",227
47,"47087",368,292,288,3,4,"PSOE",92
4,"4082",277,198,196,1,2,"PSOE",64
34,"34099",52,45,41,0,4,"PSOE",9
45,"45017",260,218,213,1,5,"PSOE",108
21,"21005",15697,9910,9778,72,132,"PSOE",3714
31,"31163",2002,1507,1475,14,32,"PSOE",580
19,"19107",315,273,270,2,3,"PSOE",83
26,"26164",51,37,37,1,0,"PSOE",15
50,"50221",32,22,22,0,0,"PSOE",11
6,"6069",3005,2172,2133,24,39,"PSOE",1117
24,"24050",105,88,87,3,1,"PSOE",25
46,"46055",1284,1031,1021,2,10,"PSOE",263
45,"45135",4173,3402,3349,18,53,"PSOE",1154
16,"16170",653,514,500,3,14,"PSOE",214
34,"34061",96,77,77,2,0,"PSOE",9
19,"19228",29,22,22,0,0,"PSOE",15
19,"19263",22,13,12,0,1,"PSOE",4
31,"31216",3871,2861,2832,32,29,"PSOE",774
37,"37274",118473,91137,90221,811,916,"PSOE",26018
47,"47067",153,119,119,3,0,"PSOE",13
4,"4044",1533,1190,1176,8,14,"PSOE",374
14,"14023",2007,1734,1711,9,23,"PSOE",622
3,"3086",166,143,143,1,0,"PSOE",40
19,"19096",101,81,79,1,2,"PSOE",20
14,"14009",2669,1863,1844,19,19,"PSOE",785
44,"44247",287,216,215,6,1,"PSOE",92
18,"18916",1778,1249,1236,9,13,"PSOE",507
38,"38005",5666,3795,3761,24,34,"PSOE",1278
31,"31041",1659,1245,1228,23,17,"PSOE",313
37,"37291",269,212,209,2,3,"PSOE",66
9,"9273",51,46,46,3,0,"PSOE",6
9,"9119",45,26,26,0,0,"PSOE",9
49,"49247",417,301,294,0,7,"PSOE",78
47,"47016",70,62,61,0,1,"PSOE",18
31,"31033",46,29,28,0,1,"PSOE",2
42,"42070",32,24,24,0,0,"PSOE",13
45,"45114",560,441,436,0,5,"PSOE",184
50,"50008",5185,3753,3711,35,42,"PSOE",1246
30,"30018",8326,6544,6438,25,106,"PSOE",1986
26,"26111",250,209,205,2,4,"PSOE",87
19,"19075",61,44,43,0,1,"PSOE",7
46,"46013",17712,14181,14075,88,106,"PSOE",3473
31,"31114",374,291,286,4,5,"PSOE",68
18,"18010",532,420,416,2,4,"PSOE",205
19,"19244",74,54,54,0,0,"PSOE",16
33,"33019",2882,1981,1939,8,42,"PSOE",648
19,"19269",94,75,75,0,0,"PSOE",24
14,"14038",32692,24015,23679,213,336,"PSOE",6733
10,"10057",126,97,96,2,1,"PSOE",54
28,"28106",78429,59182,58471,417,711,"PSOE",18771
5,"5018",24,18,17,0,1,"PSOE",4
39,"39016",23868,19029,18839,108,190,"PSOE",4963
46,"46079",313,252,248,1,4,"PSOE",59
16,"16045",185,142,141,0,1,"PSOE",67
19,"19090",90,73,72,1,1,"PSOE",33
18,"18105",3822,2688,2650,12,38,"PSOE",1384
3,"3113",4342,3194,3154,23,40,"PSOE",1039
19,"19070",67,53,51,0,2,"PSOE",19
2,"2047",107,89,88,1,1,"PSOE",20
16,"16029",102,81,81,1,0,"PSOE",28
37,"37020",425,341,339,4,2,"PSOE",91
34,"34139",160,119,118,0,1,"PSOE",35
47,"47114",3911,2864,2807,28,57,"PSOE",791
3,"3133",41499,26593,26308,151,285,"PSOE",7269
6,"6068",431,324,317,4,7,"PSOE",186
9,"9017",90,72,70,2,2,"PSOE",27
49,"49028",105,94,93,1,1,"PSOE",14
19,"19109",33,30,30,1,0,"PSOE",1
49,"49050",504,351,351,3,0,"PSOE",72
30,"30005",30193,22648,22419,136,229,"PSOE",4958
45,"45027",327,276,273,0,3,"PSOE",113
4,"4056",164,135,133,1,2,"PSOE",30
46,"46217",893,733,723,6,10,"PSOE",220
39,"39072",324,206,204,4,2,"PSOE",17
14,"14053",5925,4442,4348,75,94,"PSOE",1891
37,"37296",298,241,239,2,2,"PSOE",108
5,"5234",46,43,43,0,0,"PSOE",6
11,"11012",97629,73036,72347,715,689,"PSOE",20927
46,"46213",15504,11420,11232,124,188,"PSOE",3197
23,"23087",11185,8500,8363,65,137,"PSOE",2611
9,"9463",250,203,201,6,2,"PSOE",63
19,"19218",45,34,34,1,0,"PSOE",12
50,"50184",90,79,79,0,0,"PSOE",25
37,"37310",172,125,124,3,1,"PSOE",63
31,"31232",25574,19124,18913,236,211,"PSOE",5483
9,"9196",135,108,107,0,1,"PSOE",48
45,"45077",562,442,437,0,5,"PSOE",137
50,"50131",210,157,156,0,1,"PSOE",42
47,"47101",1644,1354,1337,9,17,"PSOE",539
22,"22051",91,78,78,1,0,"PSOE",25
13,"13004",996,769,763,3,6,"PSOE",366
50,"50006",908,705,689,3,16,"PSOE",315
28,"28101",229,183,182,2,1,"PSOE",36
37,"37322",2466,1764,1723,17,41,"PSOE",519
40,"40170",1307,1066,1054,7,12,"PSOE",259
12,"12064",80,75,73,1,2,"PSOE",24
26,"26056",403,334,328,2,6,"PSOE",120
50,"50085",183,136,136,1,0,"PSOE",38
31,"31021",60,47,47,3,0,"PSOE",8
12,"12089",4546,3353,3304,12,49,"PSOE",711
42,"42052",17,15,15,0,0,"PSOE",0
24,"24022",306,227,224,1,3,"PSOE",60
18,"18017",18148,12712,12523,96,189,"PSOE",3654
19,"19267",21,17,17,1,0,"PSOE",4
42,"42092",62,42,41,1,1,"PSOE",7
49,"49084",268,226,223,9,3,"PSOE",57
24,"24179",299,239,238,3,1,"PSOE",66
44,"44245",245,176,171,1,5,"PSOE",43
37,"37016",574,464,455,3,9,"PSOE",118
11,"11902",3656,2427,2383,29,44,"PSOE",1016
47,"47066",1407,1131,1122,11,9,"PSOE",297
50,"50240",965,720,702,9,18,"PSOE",276
26,"26162",112,95,94,0,1,"PSOE",31
5,"5179",199,181,175,0,6,"PSOE",18
37,"37314",82,72,68,0,4,"PSOE",12
31,"31074",390,310,307,5,3,"PSOE",54
31,"31195",171,125,125,2,0,"PSOE",9
40,"40176",375,325,322,6,3,"PSOE",132
4,"4096",281,239,237,1,2,"PSOE",95
26,"26064",2337,1764,1724,14,40,"PSOE",565
42,"42121",55,42,42,0,0,"PSOE",15
40,"40026",113,106,105,2,1,"PSOE",28
28,"28038",5155,4142,4090,20,52,"PSOE",1104
46,"46019",8948,7150,7067,40,83,"PSOE",2766
2,"2016",538,405,401,4,4,"PSOE",142
6,"6161",288,226,222,1,4,"PSOE",104
45,"45202",3982,3094,3055,8,39,"PSOE",929
37,"37377",218,181,176,2,5,"PSOE",44
23,"23041",491,383,382,0,1,"PSOE",140
26,"26100",56,46,46,0,0,"PSOE",22
40,"40168",28,22,22,0,0,"PSOE",4
19,"19135",93,76,72,0,4,"PSOE",22
4,"4097",242,184,184,0,0,"PSOE",89
29,"29026",1010,747,736,3,11,"PSOE",309
49,"49080",630,499,493,4,6,"PSOE",201
31,"31054",454,322,318,4,4,"PSOE",59
50,"50032",242,179,176,1,3,"PSOE",71
24,"24063",355,261,261,2,0,"PSOE",59
4,"4052",12767,9352,9269,90,83,"PSOE",2590
49,"49099",98,75,74,0,1,"PSOE",31
34,"34046",44,31,31,0,0,"PSOE",11
31,"31094",105,78,76,0,2,"PSOE",28
3,"3120",2421,1823,1786,9,37,"PSOE",530
24,"24081",122,91,88,0,3,"PSOE",9
13,"13021",417,343,343,0,0,"PSOE",135
24,"24016",507,314,311,2,3,"PSOE",143
9,"9311",59,47,46,0,1,"PSOE",24
47,"47035",902,715,707,5,8,"PSOE",229
50,"50284",132,105,104,1,1,"PSOE",39
37,"37218",48,29,29,0,0,"PSOE",2
4,"4099",4931,3781,3719,24,62,"PSOE",1132
37,"37281",39,34,33,0,1,"PSOE",11
40,"40171",39,29,29,1,0,"PSOE",4
5,"5222",152,111,109,0,2,"PSOE",23
44,"44263",377,296,285,3,11,"PSOE",103
38,"38009",4299,3105,3069,16,36,"PSOE",791
12,"12095",950,763,756,9,7,"PSOE",261
9,"9454",42,37,36,0,1,"PSOE",10
31,"31173",846,686,674,5,12,"PSOE",267
50,"50009",97,72,71,1,1,"PSOE",17
29,"29003",922,740,727,3,13,"PSOE",344
31,"31038",1336,992,981,8,11,"PSOE",312
22,"22067",71,52,52,0,0,"PSOE",24
6,"6041",457,381,374,5,7,"PSOE",159
50,"50028",77,59,58,1,1,"PSOE",23
40,"40129",164,129,128,2,1,"PSOE",26
22,"22082",285,230,226,2,4,"PSOE",55
34,"34003",150,122,120,2,2,"PSOE",15
46,"46082",4958,3801,3759,21,42,"PSOE",939
3,"3903",2577,1996,1973,11,23,"PSOE",593
44,"44168",184,137,136,4,1,"PSOE",28
45,"45177",2023,1693,1651,11,42,"PSOE",561
40,"40206",162,132,128,2,4,"PSOE",24
16,"16908",163,135,133,0,2,"PSOE",65
50,"50279",73,61,60,2,1,"PSOE",41
37,"37279",726,570,562,6,8,"PSOE",163
28,"28131",13432,10500,10387,81,113,"PSOE",2482
38,"38011",21563,15380,15214,69,166,"PSOE",4195
6,"6061",1084,915,905,8,10,"PSOE",536
41,"41066",1310,1027,1010,1,17,"PSOE",643
5,"5110",706,550,546,4,4,"PSOE",134
37,"37113",409,330,329,3,1,"PSOE",139
6,"6024",1133,963,941,5,22,"PSOE",420
3,"3020",95,84,84,2,0,"PSOE",22
5,"5012",121,100,97,0,3,"PSOE",22
30,"30025",5001,3951,3898,27,53,"PSOE",1278
12,"12040",118683,91285,90499,666,786,"PSOE",26295
22,"22102",181,153,151,1,2,"PSOE",44
18,"18098",5994,4293,4247,29,46,"PSOE",1721
34,"34053",200,176,171,5,5,"PSOE",46
50,"50014",119,85,85,0,0,"PSOE",32
10,"10214",217,175,175,1,0,"PSOE",57
26,"26131",34,34,34,1,0,"PSOE",7
33,"33001",1504,875,864,15,11,"PSOE",350
19,"19114",33,25,25,1,0,"PSOE",12
44,"44221",384,320,315,2,5,"PSOE",101
2,"2064",374,318,315,3,3,"PSOE",139
28,"28034",370,284,280,0,4,"PSOE",68
46,"46258",2636,2100,2079,9,21,"PSOE",609
19,"19092",395,317,309,1,8,"PSOE",92
42,"42105",46,37,37,1,0,"PSOE",2
19,"19222",96,73,72,2,1,"PSOE",25
6,"6056",454,378,376,1,2,"PSOE",194
49,"49273",166,111,110,0,1,"PSOE",27
21,"21059",220,184,180,0,4,"PSOE",136
6,"6052",3969,3043,2970,21,73,"PSOE",1043
24,"24034",3457,2627,2588,31,39,"PSOE",1118
10,"10148",32986,23987,23589,201,398,"PSOE",7806
31,"31043",32,24,24,0,0,"PSOE",6
40,"40034",75,63,62,1,1,"PSOE",11
37,"37014",1153,414,411,4,3,"PSOE",130
6,"6016",2943,2283,2247,24,36,"PSOE",1106
47,"47034",72,57,57,1,0,"PSOE",15
19,"19193",23,20,20,0,0,"PSOE",12
4,"4065",368,287,284,2,3,"PSOE",138
47,"47083",83,66,65,1,1,"PSOE",9
14,"14060",3694,2878,2798,26,80,"PSOE",1158
21,"21032",1801,1401,1378,8,23,"PSOE",736
22,"22060",1172,906,901,13,5,"PSOE",334
46,"46097",958,764,756,6,8,"PSOE",186
50,"50038",1405,1112,1099,13,13,"PSOE",473
11,"11035",13715,9510,9385,128,125,"PSOE",3091
16,"16049",144,111,108,1,3,"PSOE",48
41,"41097",3135,2355,2308,11,47,"PSOE",1243
49,"49174",130,93,91,0,2,"PSOE",24
34,"34205",55,44,44,0,0,"PSOE",12
23,"23060",19153,14444,14281,87,163,"PSOE",5779
31,"31086",13640,11040,10966,116,74,"PSOE",2246
33,"33031",33854,23523,23143,307,380,"PSOE",8781
26,"26071",8662,6409,6288,52,121,"PSOE",2183
37,"37288",276,225,224,5,1,"PSOE",58
31,"31194",326,251,250,1,1,"PSOE",27
33,"33055",1492,1156,1121,6,35,"PSOE",422
40,"40036",502,413,406,11,7,"PSOE",75
18,"18192",1466,1171,1156,1,15,"PSOE",561
18,"18018",554,457,451,0,6,"PSOE",211
42,"42016",20,13,13,0,0,"PSOE",3
50,"50165",1783,1359,1330,20,29,"PSOE",440
31,"31020",433,273,272,1,1,"PSOE",16
23,"23006",4582,3607,3543,32,64,"PSOE",2050
19,"19333",105,74,73,1,1,"PSOE",35
10,"10205",1965,1344,1300,8,44,"PSOE",595
11,"11020",166423,117732,116448,1427,1284,"PSOE",35305
39,"39034",257,167,162,2,5,"PSOE",24
19,"19241",35,24,23,2,1,"PSOE",3
37,"37294",11787,9201,9083,76,118,"PSOE",2502
47,"47122",2016,1655,1617,15,38,"PSOE",512
41,"41099",3968,2666,2642,23,24,"PSOE",1315
35,"35029",4357,2869,2832,32,37,"PSOE",712
39,"39031",1245,990,983,5,7,"PSOE",147
31,"31142",1390,994,982,8,12,"PSOE",283
47,"47099",155,135,133,0,2,"PSOE",27
49,"49042",230,179,174,1,5,"PSOE",35
41,"41007",12438,9009,8775,135,234,"PSOE",3899
10,"10004",690,529,517,8,12,"PSOE",258
37,"37354",5467,3960,3910,31,50,"PSOE",1050
41,"41076",2143,1419,1403,14,16,"PSOE",730
50,"50004",478,380,376,2,4,"PSOE",167
34,"34076",545,475,473,2,2,"PSOE",119
4,"4001",1014,768,763,9,5,"PSOE",326
10,"10213",534,447,441,5,6,"PSOE",166
26,"26092",109,84,82,1,2,"PSOE",21
9,"9441",92,81,81,1,0,"PSOE",3
26,"26153",10,9,9,0,0,"PSOE",7
38,"38028",22035,15684,15522,86,162,"PSOE",5295
49,"49263",45,37,37,0,0,"PSOE",4
10,"10005",530,407,384,3,23,"PSOE",163
19,"19243",36,32,31,0,1,"PSOE",7
31,"31167",831,651,636,3,15,"PSOE",164
9,"9316",108,89,89,0,0,"PSOE",21
38,"38029",1493,839,823,5,16,"PSOE",276
47,"47113",142,117,117,1,0,"PSOE",39
49,"49059",88,72,71,0,1,"PSOE",12
31,"31105",1478,1203,1189,21,14,"PSOE",412
19,"19230",548,437,430,1,7,"PSOE",107
50,"50186",37,28,28,0,0,"PSOE",8
28,"28108",3642,2878,2841,16,37,"PSOE",654
16,"16070",28,26,26,1,0,"PSOE",13
6,"6076",824,631,620,0,11,"PSOE",268
4,"4010",580,445,434,2,11,"PSOE",238
42,"42008",56,41,41,0,0,"PSOE",8
21,"21041",112810,77371,76488,900,883,"PSOE",24784
41,"41102",14750,10972,10677,110,295,"PSOE",4092
33,"33015",1428,1003,993,7,10,"PSOE",339
5,"5198",71,51,51,0,0,"PSOE",8
50,"50266",121,85,80,0,5,"PSOE",32
47,"47031",196,155,155,3,0,"PSOE",38
30,"30023",3875,3107,3068,20,39,"PSOE",851
22,"22022",543,441,433,4,8,"PSOE",147
5,"5008",208,168,163,1,5,"PSOE",40
31,"31065",1859,1383,1366,16,17,"PSOE",500
49,"49168",93,74,74,0,0,"PSOE",16
24,"24139",2087,1558,1540,20,18,"PSOE",462
37,"37035",165,134,134,0,0,"PSOE",48
46,"46184",26453,21076,20810,172,266,"PSOE",5608
23,"23101",352,273,271,0,2,"PSOE",151
5,"5242",686,588,585,11,3,"PSOE",71
47,"47185",87,77,77,0,0,"PSOE",21
47,"47032",153,121,121,1,0,"PSOE",14
13,"13061",5639,4119,4071,56,48,"PSOE",1390
22,"22042",117,96,95,1,1,"PSOE",30
37,"37313",534,413,411,1,2,"PSOE",121
19,"19097",14,13,13,0,0,"PSOE",2
19,"19262",123,98,97,0,1,"PSOE",30
46,"46023",328,277,269,1,8,"PSOE",58
50,"50274",66,48,47,0,1,"PSOE",10
10,"10010",2213,1499,1470,6,29,"PSOE",692
38,"38022",18629,12903,12759,84,144,"PSOE",3021
6,"6058",1980,1519,1493,13,26,"PSOE",632
49,"49241",240,199,199,1,0,"PSOE",27
37,"37208",69,52,51,0,1,"PSOE",7
9,"9416",60,44,44,0,0,"PSOE",14
11,"11003",1240,898,876,7,22,"PSOE",318
29,"29020",3280,2531,2485,23,46,"PSOE",759
42,"42050",27,21,21,1,0,"PSOE",0
9,"9467",60,46,46,0,0,"PSOE",9
21,"21033",561,428,427,4,1,"PSOE",199
50,"50161",103,80,80,0,0,"PSOE",10
49,"49268",368,282,279,2,3,"PSOE",50
33,"33072",1455,973,963,14,10,"PSOE",367
5,"5251",56,39,39,0,0,"PSOE",7
10,"10161",82,50,50,1,0,"PSOE",26
26,"26107",91,78,77,0,1,"PSOE",21
47,"47081",41,36,36,0,0,"PSOE",18
11,"11009",580,429,420,2,9,"PSOE",149
9,"9480",109,87,85,1,2,"PSOE",20
34,"34056",1949,1537,1511,7,26,"PSOE",445
12,"12049",421,339,329,2,10,"PSOE",115
37,"37361",81,63,61,0,2,"PSOE",10
37,"37286",203,147,142,2,5,"PSOE",56
21,"21046",1714,1097,1071,13,26,"PSOE",324
6,"6026",815,661,653,5,8,"PSOE",268
40,"40119",166,133,132,1,1,"PSOE",18
3,"3094",9626,7206,7138,42,68,"PSOE",1586
45,"45183",2337,1743,1704,7,39,"PSOE",414
28,"28133",6116,4581,4486,22,95,"PSOE",1298
31,"31080",490,393,390,2,3,"PSOE",101
28,"28087",3259,2643,2623,16,20,"PSOE",615
10,"10032",1596,1263,1243,5,20,"PSOE",465
40,"40110",316,254,253,2,1,"PSOE",89
5,"5062",166,136,133,0,3,"PSOE",11
40,"40005",25,21,21,0,0,"PSOE",3
34,"34233",128,118,117,2,1,"PSOE",21
40,"40002",34,30,30,0,0,"PSOE",8
46,"46250",581614,454786,451184,2675,3602,"PSOE",113237
49,"49148",264,146,136,1,10,"PSOE",39
22,"22052",885,708,702,6,6,"PSOE",279
31,"31180",197,155,154,2,1,"PSOE",34
31,"31222",58,38,38,3,0,"PSOE",11
46,"46107",1849,1501,1480,5,21,"PSOE",500
28,"28091",5474,4027,3977,26,50,"PSOE",1173
21,"21012",286,238,233,4,5,"PSOE",93
31,"31045",509,395,390,5,5,"PSOE",101
29,"29902",2592,1841,1817,18,24,"PSOE",979
46,"46209",1901,1517,1500,5,17,"PSOE",509
34,"34134",40,31,31,1,0,"PSOE",10
10,"10055",696,527,512,1,15,"PSOE",155
31,"31113",127,84,83,1,1,"PSOE",21
50,"50277",49,37,37,3,0,"PSOE",10
49,"49260",700,558,548,8,10,"PSOE",173
37,"37189",114,88,88,2,0,"PSOE",35
49,"49017",259,196,195,0,1,"PSOE",34
12,"12082",9573,7672,7570,55,102,"PSOE",2024
37,"37041",73,55,55,0,0,"PSOE",8
47,"47010",14572,12316,12186,102,130,"PSOE",2749
49,"49269",220,163,162,1,1,"PSOE",47
23,"23030",1208,1022,1011,6,11,"PSOE",639
2,"2033",1870,1503,1463,11,40,"PSOE",499
4,"4085",371,305,303,2,2,"PSOE",114
4,"4072",314,245,240,0,5,"PSOE",80
3,"3130",43,23,23,0,0,"PSOE",3
47,"47078",159,135,131,0,4,"PSOE",27
19,"19257",3283,2448,2424,21,24,"PSOE",690
10,"10018",1630,1149,1112,12,37,"PSOE",533
14,"14050",2352,1840,1801,11,39,"PSOE",623
23,"23042",317,234,232,1,2,"PSOE",87
39,"39069",1928,1650,1627,9,23,"PSOE",307
2,"2002",435,358,352,2,6,"PSOE",131
19,"19233",82,72,72,1,0,"PSOE",15
47,"47001",52,47,46,0,1,"PSOE",2
47,"47220",154,119,119,1,0,"PSOE",17
42,"42119",145,90,89,6,1,"PSOE",9
18,"18088",1530,1152,1142,0,10,"PSOE",589
24,"24055",676,513,508,6,5,"PSOE",167
16,"16198",1299,1044,1027,11,17,"PSOE",434
19,"19901",36,32,32,0,0,"PSOE",9
29,"29027",2309,1716,1692,18,24,"PSOE",573
19,"19073",16,13,13,0,0,"PSOE",4
31,"31036",895,665,659,8,6,"PSOE",220
4,"4062",4460,3466,3425,12,41,"PSOE",1355
37,"37318",199,152,152,1,0,"PSOE",29
19,"19122",81,64,64,1,0,"PSOE",23
18,"18124",359,269,267,0,2,"PSOE",61
24,"24175",1831,1433,1412,17,21,"PSOE",346
16,"16155",488,411,408,3,3,"PSOE",140
34,"34062",150,108,107,1,1,"PSOE",23
50,"50020",802,606,600,7,6,"PSOE",214
37,"37381",139,97,95,1,2,"PSOE",16
31,"31064",1387,1174,1163,9,11,"PSOE",475
21,"21054",8157,6002,5869,60,133,"PSOE",1563
24,"24137",1052,815,803,14,12,"PSOE",375
19,"19074",65,60,60,0,0,"PSOE",28
26,"26169",68,61,61,2,0,"PSOE",26
37,"37316",716,576,565,4,11,"PSOE",100
42,"42084",20,16,16,0,0,"PSOE",2
35,"35032",3348,2585,2542,20,43,"PSOE",655
19,"19188",43,34,33,0,1,"PSOE",11
22,"22072",194,141,140,0,1,"PSOE",44
21,"21042",15579,8742,8579,138,163,"PSOE",2320
23,"23055",46343,33603,33225,243,378,"PSOE",11493
37,"37194",237,182,181,0,1,"PSOE",67
37,"37120",97,83,81,1,2,"PSOE",16
28,"28097",125,100,100,0,0,"PSOE",42
46,"46133",472,374,374,2,0,"PSOE",202
49,"49022",280,243,241,1,2,"PSOE",104
35,"35014",11908,7101,6947,63,154,"PSOE",1668
37,"37317",288,240,238,2,2,"PSOE",72
3,"3109",2976,2375,2345,11,30,"PSOE",904
23,"23082",1875,1402,1389,7,13,"PSOE",611
24,"24023",262,208,206,3,2,"PSOE",48
41,"41086",16209,11006,10881,116,125,"PSOE",4477
47,"47103",255,215,214,3,1,"PSOE",69
22,"22229",108,80,80,2,0,"PSOE",28
46,"46002",1215,963,959,5,4,"PSOE",263
41,"41077",8631,6441,6289,46,152,"PSOE",2807
31,"31040",173,139,139,1,0,"PSOE",22
40,"40174",324,254,250,2,4,"PSOE",49
45,"45103",362,306,299,0,7,"PSOE",126
31,"31028",220,147,147,0,0,"PSOE",22
37,"37184",290,199,195,0,4,"PSOE",58
49,"49255",396,324,323,3,1,"PSOE",75
37,"37372",134,104,104,0,0,"PSOE",36
19,"19079",8,7,7,1,0,"PSOE",0
46,"46094",20691,15841,15672,88,169,"PSOE",3974
24,"24210",527,387,386,0,1,"PSOE",156
28,"28144",6423,5274,5222,35,52,"PSOE",1273
21,"21057",995,631,629,3,2,"PSOE",371
37,"37012",145,116,114,0,2,"PSOE",27
10,"10024",675,518,505,4,13,"PSOE",134
12,"12099",586,449,434,3,15,"PSOE",119
49,"49081",1322,1051,1030,11,21,"PSOE",397
9,"9139",98,82,82,2,0,"PSOE",26
22,"22908",188,133,131,0,2,"PSOE",51
16,"16087",226,191,184,3,7,"PSOE",60
23,"23027",716,524,518,2,6,"PSOE",289
47,"47117",286,240,235,0,5,"PSOE",43
3,"3104",27091,21366,21119,250,247,"PSOE",6436
44,"44150",26,21,21,0,0,"PSOE",8
49,"49052",179,125,123,1,2,"PSOE",33
31,"31083",50,41,41,1,0,"PSOE",3
18,"18096",344,265,265,2,0,"PSOE",161
40,"40163",41,38,38,0,0,"PSOE",1
28,"28903",35344,30490,30287,201,203,"PSOE",7661
23,"23048",820,644,636,1,8,"PSOE",181
9,"9164",150,116,114,0,2,"PSOE",25
21,"21035",9726,6628,6520,78,108,"PSOE",2995
5,"5053",80,57,57,2,0,"PSOE",7
5,"5194",132,111,111,0,0,"PSOE",39
39,"39041",1767,1437,1417,18,20,"PSOE",365
30,"30021",9441,6664,6591,32,73,"PSOE",1570
5,"5058",72,52,52,0,0,"PSOE",11
42,"42053",21,15,15,0,0,"PSOE",0
40,"40013",56,47,47,0,0,"PSOE",4
21,"21023",2051,1356,1332,5,24,"PSOE",664
44,"44051",2588,2034,1997,26,37,"PSOE",650
24,"24171",349,201,198,4,3,"PSOE",79
46,"46026",1202,1012,997,1,15,"PSOE",231
23,"23049",1747,1321,1305,11,16,"PSOE",662
23,"23059",5728,4259,4187,18,72,"PSOE",2132
44,"44234",70,57,57,1,0,"PSOE",14
24,"24024",638,463,452,8,11,"PSOE",111
29,"29013",1602,1262,1238,12,24,"PSOE",552
4,"4058",342,256,256,0,0,"PSOE",116
18,"18063",1217,712,702,6,10,"PSOE",306
2,"2055",1057,770,755,6,15,"PSOE",379
28,"28125",3216,2459,2444,11,15,"PSOE",534
4,"4095",690,508,502,2,6,"PSOE",173
37,"37200",196,145,145,0,0,"PSOE",42
21,"21074",2698,1979,1945,15,34,"PSOE",937
47,"47131",165,127,127,3,0,"PSOE",45
19,"19002",57,45,45,0,0,"PSOE",22
4,"4083",1740,1342,1326,4,16,"PSOE",609
28,"28030",1815,1438,1395,10,43,"PSOE",338
35,"35019",32841,21136,20850,125,286,"PSOE",6011
13,"13008",427,304,302,0,2,"PSOE",109
29,"29014",222,151,150,6,1,"PSOE",60
19,"19183",71,61,59,0,2,"PSOE",32
23,"23096",2571,2099,2063,9,36,"PSOE",1239
28,"28137",1744,1385,1366,8,19,"PSOE",348
5,"5019",44838,36021,35637,287,384,"PSOE",8756
46,"46262",213,170,165,1,5,"PSOE",34
31,"31169",2205,1597,1568,17,29,"PSOE",721
9,"9149",34,27,27,0,0,"PSOE",7
24,"24026",1099,812,799,5,13,"PSOE",142
37,"37042",41,32,31,1,1,"PSOE",2
6,"6064",850,658,647,2,11,"PSOE",363
46,"46211",1837,1490,1462,11,28,"PSOE",441
9,"9483",189,153,150,1,3,"PSOE",43
42,"42090",88,69,68,2,1,"PSOE",12
26,"26158",246,207,206,2,1,"PSOE",56
24,"24041",527,371,364,4,7,"PSOE",126
19,"19053",1929,1472,1458,9,14,"PSOE",476
28,"28052",3949,2890,2818,8,72,"PSOE",614
26,"26074",107,97,96,2,1,"PSOE",34
46,"46029",20423,15450,15274,100,176,"PSOE",3704
26,"26087",170,136,135,3,1,"PSOE",33
16,"16186",412,358,354,1,4,"PSOE",145
42,"42071",163,111,108,2,3,"PSOE",30
24,"24134",3294,2540,2479,25,61,"PSOE",1042
50,"50086",178,121,119,2,2,"PSOE",63
33,"33027",769,505,497,14,8,"PSOE",225
4,"4074",2887,2062,2038,16,24,"PSOE",734
9,"9032",103,72,72,0,0,"PSOE",34
49,"49008",431,293,289,2,4,"PSOE",102
13,"13042",888,699,686,2,13,"PSOE",248
31,"31172",365,287,275,4,12,"PSOE",48
39,"39071",422,318,316,0,2,"PSOE",18
47,"47029",50,43,43,1,0,"PSOE",9
50,"50177",276,226,223,0,3,"PSOE",63
47,"47186",244448,197042,195276,1561,1766,"PSOE",58118
21,"21029",1509,1183,1160,14,23,"PSOE",527
34,"34034",115,96,95,3,1,"PSOE",33
50,"50030",201,138,136,1,2,"PSOE",43
37,"37306",242,184,181,2,3,"PSOE",47
9,"9318",58,37,37,0,0,"PSOE",16
40,"40063",6944,5479,5352,39,127,"PSOE",1602
46,"46041",327,251,250,2,1,"PSOE",71
50,"50012",96,79,79,1,0,"PSOE",38
40,"40055",32,26,25,0,1,"PSOE",11
5,"5207",645,543,540,3,3,"PSOE",219
16,"16057",64,53,53,0,0,"PSOE",17
47,"47219",40,38,34,0,4,"PSOE",13
44,"44264",248,175,171,0,4,"PSOE",64
9,"9103",200,179,179,1,0,"PSOE",73
24,"24019",341,279,272,0,7,"PSOE",133
3,"3112",637,526,520,0,6,"PSOE",146
50,"50254",174,123,122,0,1,"PSOE",38
31,"31120",383,264,260,3,4,"PSOE",40
41,"41100",967,765,727,8,38,"PSOE",410
11,"11006",24522,16656,16392,220,264,"PSOE",6398
37,"37034",75,66,66,0,0,"PSOE",25
2,"2001",695,567,559,3,8,"PSOE",201
22,"22215",128,91,91,1,0,"PSOE",37
9,"9445",43,36,34,1,2,"PSOE",10
37,"37283",119,96,96,0,0,"PSOE",0
3,"3051",344,312,307,2,5,"PSOE",107
39,"39045",351,280,277,1,3,"PSOE",67
24,"24112",299,226,223,1,3,"PSOE",130
37,"37092",1889,1459,1447,16,12,"PSOE",329
47,"47127",138,92,89,1,3,"PSOE",14
42,"42079",21,18,18,1,0,"PSOE",1
5,"5132",881,634,626,2,8,"PSOE",176
6,"6036",4958,3785,3728,22,57,"PSOE",1618
44,"44138",118,90,89,2,1,"PSOE",23
11,"11015",64073,43152,42713,710,439,"PSOE",11776
19,"19126",1687,1306,1285,9,21,"PSOE",295
44,"44252",75,56,56,1,0,"PSOE",16
37,"37248",152,125,121,1,4,"PSOE",19
41,"41022",4269,3158,3110,16,48,"PSOE",1607
22,"22061",6583,5027,4973,51,54,"PSOE",1521
40,"40128",122,95,93,2,2,"PSOE",29
11,"11004",89545,60056,59323,741,733,"PSOE",17049
11,"11016",15051,10188,10042,131,146,"PSOE",2954
40,"40021",19,18,18,0,0,"PSOE",5
46,"46259",462,395,394,2,1,"PSOE",113
18,"18905",15550,11394,11230,132,164,"PSOE",3462
22,"22086",209,157,155,1,2,"PSOE",44
14,"14036",3676,2850,2766,40,84,"PSOE",1351
39,"39065",232,190,189,5,1,"PSOE",36
42,"42202",20,12,11,0,1,"PSOE",2
31,"31056",185,141,134,3,7,"PSOE",22
31,"31057",1741,1365,1344,12,21,"PSOE",487
37,"37362",4729,3769,3720,36,49,"PSOE",810
9,"9057",148,120,116,0,4,"PSOE",37
50,"50238",86,66,66,2,0,"PSOE",12
24,"24129",111,91,91,1,0,"PSOE",23
29,"29011",2871,1955,1926,11,29,"PSOE",1011
42,"42128",46,41,41,0,0,"PSOE",12
50,"50298",5427,4373,4323,30,50,"PSOE",1366
14,"14040",3755,3047,3006,21,41,"PSOE",788
26,"26082",100,85,85,0,0,"PSOE",36
19,"19210",18,18,17,0,1,"PSOE",1
44,"44129",36,29,29,0,0,"PSOE",15
37,"37039",282,222,222,1,0,"PSOE",68
5,"5016",6354,5090,5005,40,85,"PSOE",1215
9,"9141",602,501,493,4,8,"PSOE",164
11,"11042",1155,870,852,7,18,"PSOE",405
50,"50114",132,111,111,1,0,"PSOE",44
4,"4070",1545,1192,1182,7,10,"PSOE",431
50,"50007",49,34,34,0,0,"PSOE",6
5,"5084",69,46,46,0,0,"PSOE",13
9,"9329",117,90,89,8,1,"PSOE",34
9,"9026",371,305,303,2,2,"PSOE",82
40,"40059",108,90,89,0,1,"PSOE",23
24,"24037",337,234,234,1,0,"PSOE",66
9,"9438",561,485,473,6,12,"PSOE",122
31,"31140",115,83,83,2,0,"PSOE",16
18,"18040",226,146,145,0,1,"PSOE",76
40,"40003",121,91,89,1,2,"PSOE",10
6,"6062",576,435,430,0,5,"PSOE",193
31,"31154",211,125,124,2,1,"PSOE",12
16,"16213",34,29,28,0,1,"PSOE",8
28,"28115",62352,53136,52912,268,224,"PSOE",8910
21,"21050",12522,8425,8312,84,113,"PSOE",3054
22,"22222",517,407,398,5,9,"PSOE",108
19,"19105",2540,2013,1988,13,25,"PSOE",490
10,"10030",472,323,318,1,5,"PSOE",122
4,"4048",1496,1109,1102,4,7,"PSOE",340
28,"28169",1553,1280,1273,15,7,"PSOE",227
33,"33005",1376,929,916,14,13,"PSOE",353
2,"2057",1960,1522,1489,15,33,"PSOE",663
37,"37017",222,177,177,1,0,"PSOE",23
14,"14039",2575,2037,1990,14,47,"PSOE",920
40,"40074",245,219,214,5,5,"PSOE",42
46,"46049",268,231,228,1,3,"PSOE",64
5,"5257",135,104,104,0,0,"PSOE",30
16,"16251",1809,1469,1443,11,26,"PSOE",370
19,"19089",25,19,19,1,0,"PSOE",11
50,"50270",38,32,30,1,2,"PSOE",11
4,"4101",4375,3161,3112,34,49,"PSOE",1180
22,"22225",2610,1867,1843,15,24,"PSOE",568
21,"21064",6641,4689,4597,66,92,"PSOE",1965
13,"13010",881,680,666,4,14,"PSOE",287
5,"5102",1681,1358,1329,4,29,"PSOE",404
47,"47112",2570,2098,2075,13,23,"PSOE",521
37,"37203",146,113,112,0,1,"PSOE",30
5,"5140",106,91,89,0,2,"PSOE",17
49,"49043",265,210,208,1,2,"PSOE",83
13,"13071",38130,27060,26802,237,258,"PSOE",10482
9,"9458",484,408,401,5,7,"PSOE",112
23,"23097",6356,4509,4462,17,47,"PSOE",1645
40,"40029",24,21,21,0,0,"PSOE",7
2,"2035",1946,1592,1576,15,16,"PSOE",553
46,"46212",1590,1209,1192,4,17,"PSOE",316
31,"31132",148,121,121,2,0,"PSOE",13
46,"46111",11326,8603,8492,55,111,"PSOE",2203
9,"9064",305,251,249,3,2,"PSOE",51
21,"21077",1725,1307,1286,10,21,"PSOE",605
40,"40182",173,126,124,1,2,"PSOE",34
12,"12105",816,639,625,5,14,"PSOE",146
22,"22201",266,192,192,2,0,"PSOE",95
47,"47009",99,84,84,0,0,"PSOE",26
49,"49046",242,178,175,0,3,"PSOE",53
24,"24029",695,521,520,4,1,"PSOE",248
40,"40043",1791,1472,1447,9,25,"PSOE",398
19,"19110",56,47,47,0,0,"PSOE",9
14,"14042",18727,15069,14837,201,232,"PSOE",5630
6,"6077",321,260,256,4,4,"PSOE",151
38,"38041",6970,5288,5258,38,30,"PSOE",1033
30,"30003",25046,17860,17668,99,192,"PSOE",5753
14,"14073",2772,2124,2069,18,55,"PSOE",1017
4,"4011",2757,2171,2136,11,35,"PSOE",980
24,"24084",152,113,113,0,0,"PSOE",45
49,"49062",105,69,69,1,0,"PSOE",24
4,"4024",3225,2558,2534,23,24,"PSOE",798
41,"41029",13483,10357,10199,120,158,"PSOE",3814
37,"37282",194,148,146,1,2,"PSOE",40
12,"12001",1033,834,825,8,9,"PSOE",284
28,"28110",2003,1596,1571,7,25,"PSOE",527
42,"42213",25,16,16,0,0,"PSOE",5
16,"16204",241,198,196,1,2,"PSOE",58
9,"9904",468,371,369,3,2,"PSOE",103
26,"26171",156,131,127,0,4,"PSOE",27
40,"40044",139,105,103,2,2,"PSOE",26
19,"19160",905,618,613,3,5,"PSOE",129
26,"26042",799,605,596,5,9,"PSOE",232
6,"6157",397,296,292,1,4,"PSOE",126
18,"18083",228,189,188,1,1,"PSOE",77
24,"24047",720,531,523,2,8,"PSOE",136
44,"44148",76,64,63,0,1,"PSOE",31
31,"31109",1664,1290,1283,10,7,"PSOE",236
16,"16910",78,54,54,1,0,"PSOE",23
22,"22075",119,87,87,1,0,"PSOE",45
9,"9398",74,59,58,1,1,"PSOE",19
4,"4090",312,253,249,0,4,"PSOE",112
16,"16205",107,80,79,0,1,"PSOE",16
16,"16074",28,23,23,0,0,"PSOE",10
47,"47199",71,59,59,3,0,"PSOE",15
45,"45012",631,516,509,2,7,"PSOE",149
50,"50005",239,204,201,2,3,"PSOE",37
42,"42127",38,27,27,1,0,"PSOE",8
4,"4014",149,109,108,0,1,"PSOE",73
47,"47128",56,49,46,0,3,"PSOE",2
44,"44257",154,110,109,1,1,"PSOE",38
49,"49066",449,319,314,4,5,"PSOE",87
47,"47003",204,171,168,4,3,"PSOE",39
34,"34070",135,101,101,1,0,"PSOE",34
37,"37249",38,28,28,0,0,"PSOE",10
50,"50091",40,35,35,0,0,"PSOE",8
14,"14901",915,795,782,8,13,"PSOE",488
6,"6093",4345,3356,3281,18,75,"PSOE",1388
9,"9024",150,116,114,0,2,"PSOE",30
10,"10012",564,469,464,1,5,"PSOE",239
30,"30006",829,731,727,4,4,"PSOE",204
33,"33012",5105,3601,3566,46,35,"PSOE",1088
41,"41904",1792,1171,1162,16,9,"PSOE",799
50,"50016",44,31,31,0,0,"PSOE",7
10,"10036",306,240,237,2,3,"PSOE",128
9,"9292",75,62,62,2,0,"PSOE",22
19,"19332",85,70,70,1,0,"PSOE",17
50,"50083",84,70,68,0,2,"PSOE",30
42,"42129",678,540,539,1,1,"PSOE",186
37,"37250",332,232,231,1,1,"PSOE",104
11,"11030",22973,16087,15853,165,234,"PSOE",4119
2,"2017",777,588,584,0,4,"PSOE",248
6,"6094",1459,1017,1008,8,9,"PSOE",584
34,"34042",292,244,243,3,1,"PSOE",67
50,"50035",75,63,62,0,1,"PSOE",9
50,"50102",820,653,642,9,11,"PSOE",235
13,"13066",2604,2182,2146,6,36,"PSOE",830
22,"22089",276,216,216,2,0,"PSOE",80
4,"4904",1879,1328,1322,4,6,"PSOE",250
47,"47097",307,258,256,4,2,"PSOE",102
31,"31072",5320,4046,3958,40,88,"PSOE",1406
39,"39030",1895,1374,1358,6,16,"PSOE",359
19,"19066",50,43,43,0,0,"PSOE",8
16,"16163",60,50,50,0,0,"PSOE",23
19,"19167",129,104,102,0,2,"PSOE",20
50,"50134",118,91,89,0,2,"PSOE",19
19,"19240",51,42,41,1,1,"PSOE",13
49,"49004",111,77,77,4,0,"PSOE",18
33,"33075",253,139,135,1,4,"PSOE",68
37,"37328",164,127,127,4,0,"PSOE",46
45,"45002",2608,1840,1821,7,19,"PSOE",616
28,"28116",759,621,618,7,3,"PSOE",148
40,"40179",626,540,529,2,11,"PSOE",164
11,"11008",17840,12434,12236,181,198,"PSOE",3999
16,"16181",57,46,46,1,0,"PSOE",19
26,"26072",285,252,247,1,5,"PSOE",97
29,"29036",611,448,444,3,4,"PSOE",211
3,"3129",1218,994,982,5,12,"PSOE",239
19,"19169",33,26,25,0,1,"PSOE",9
26,"26125",2663,2042,2011,32,31,"PSOE",722
22,"22007",756,576,571,5,5,"PSOE",175
16,"16216",278,243,240,0,3,"PSOE",111
34,"34060",135,111,110,0,1,"PSOE",26
12,"12074",761,659,645,7,14,"PSOE",232
3,"3036",86,77,75,2,2,"PSOE",21
37,"37072",145,136,134,3,2,"PSOE",28
23,"23031",765,659,647,4,12,"PSOE",407
31,"31063",83,63,60,2,3,"PSOE",11
45,"45097",1044,901,890,4,11,"PSOE",323
31,"31089",228,187,184,0,3,"PSOE",35
46,"46009",3140,2582,2536,14,46,"PSOE",742
19,"19004",59,52,52,0,0,"PSOE",3
47,"47144",75,63,63,1,0,"PSOE",12
50,"50136",534,416,405,2,11,"PSOE",85
34,"34106",113,101,101,0,0,"PSOE",12
21,"21052",4429,2951,2891,19,60,"PSOE",1408
47,"47008",22,15,15,0,0,"PSOE",1
4,"4086",1643,1226,1209,6,17,"PSOE",399
37,"37032",549,431,430,3,1,"PSOE",108
40,"40228",494,397,391,5,6,"PSOE",105
42,"42088",60,53,53,0,0,"PSOE",11
5,"5219",37,30,30,0,0,"PSOE",7
29,"29061",1033,840,821,5,19,"PSOE",227
28,"28118",61,52,51,0,1,"PSOE",14
44,"44155",1056,830,813,9,17,"PSOE",366
49,"49020",261,215,210,2,5,"PSOE",74
33,"33028",1158,635,630,6,5,"PSOE",306
9,"9302",98,75,73,0,2,"PSOE",10
5,"5232",106,87,84,1,3,"PSOE",11
12,"12085",5079,3504,3459,13,45,"PSOE",916
40,"40159",132,101,101,0,0,"PSOE",22
5,"5193",180,156,156,2,0,"PSOE",51
3,"3069",3311,2356,2327,12,29,"PSOE",557
23,"23054",376,296,289,1,7,"PSOE",173
46,"46255",3209,2415,2381,18,34,"PSOE",638
50,"50272",13174,10143,10042,103,101,"PSOE",2986
50,"50282",57,47,45,0,2,"PSOE",12
37,"37307",148,110,107,2,3,"PSOE",26
22,"22083",445,379,372,5,7,"PSOE",140
33,"33029",323,172,170,2,2,"PSOE",84
41,"41020",12992,8679,8524,117,155,"PSOE",4264
21,"21055",7218,5328,5215,41,113,"PSOE",1368
4,"4037",1221,975,960,8,15,"PSOE",450
24,"24165",327,236,233,1,3,"PSOE",82
9,"9246",609,449,441,2,8,"PSOE",102
34,"34196",88,74,74,4,0,"PSOE",14
50,"50169",336,261,259,2,2,"PSOE",84
30,"30004",1126,884,876,5,8,"PSOE",347
42,"42107",67,48,48,0,0,"PSOE",13
24,"24071",967,755,741,7,14,"PSOE",293
6,"6079",644,492,487,3,5,"PSOE",242
45,"45117",715,571,556,1,15,"PSOE",261
21,"21056",2922,2307,2228,27,79,"PSOE",1097
37,"37195",37,29,29,1,0,"PSOE",16
16,"16089",377,308,308,1,0,"PSOE",120
11,"11002",4200,3287,3257,5,30,"PSOE",1565
31,"31027",814,623,610,8,13,"PSOE",45
22,"22085",96,82,81,0,1,"PSOE",38
42,"42108",10,7,7,0,0,"PSOE",0
2,"2015",1433,1234,1214,7,20,"PSOE",483
2,"2027",283,239,238,3,1,"PSOE",81
30,"30015",19372,14430,14283,91,147,"PSOE",3915
16,"16007",1159,975,968,10,7,"PSOE",344
45,"45026",218,177,172,0,5,"PSOE",72
18,"18025",279,214,212,0,2,"PSOE",107
23,"23091",679,575,571,3,4,"PSOE",278
37,"37122",203,174,174,1,0,"PSOE",57
22,"22901",714,521,508,3,13,"PSOE",212
22,"22115",347,262,261,1,1,"PSOE",66
42,"42063",47,31,28,0,3,"PSOE",11
23,"23057",732,613,611,4,2,"PSOE",275
37,"37097",44,29,29,0,0,"PSOE",5
13,"13064",1836,1455,1446,18,9,"PSOE",478
24,"24181",1414,1067,1055,14,12,"PSOE",399
29,"29010",1632,1372,1319,4,53,"PSOE",696
24,"24127",268,204,201,3,3,"PSOE",53
31,"31029",916,661,647,7,14,"PSOE",172
44,"44159",37,32,32,1,0,"PSOE",4
9,"9250",259,215,214,1,1,"PSOE",71
37,"37237",304,238,234,0,4,"PSOE",83
50,"50229",65,57,56,0,1,"PSOE",18
30,"30016",152709,110165,109114,717,1051,"PSOE",25316
44,"44243",27,24,23,0,1,"PSOE",6
19,"19250",15,13,13,0,0,"PSOE",5
5,"5134",49,41,40,0,1,"PSOE",7
31,"31221",1235,944,938,11,6,"PSOE",160
50,"50210",36,29,29,0,0,"PSOE",10
24,"24036",272,181,179,4,2,"PSOE",92
40,"40107",92,76,74,0,2,"PSOE",11
47,"47076",17721,14605,14438,134,167,"PSOE",4216
40,"40154",23,20,20,0,0,"PSOE",5
9,"9043",186,128,128,1,0,"PSOE",29
19,"19266",229,194,192,1,2,"PSOE",33
50,"50025",4516,3417,3364,35,53,"PSOE",1049
46,"46056",175,156,156,3,0,"PSOE",49
13,"13036",766,626,617,0,9,"PSOE",253
16,"16234",23,16,16,0,0,"PSOE",12
44,"44173",102,85,80,0,5,"PSOE",22
2,"2043",1173,975,962,1,13,"PSOE",392
14,"14048",1189,948,933,5,15,"PSOE",502
47,"47182",1335,1034,1022,6,12,"PSOE",302
31,"31207",285,209,206,1,3,"PSOE",29
31,"31046",53,39,39,0,0,"PSOE",5
41,"41081",29840,22819,22465,228,354,"PSOE",10318
50,"50026",421,340,328,4,12,"PSOE",145
3,"3139",23061,16378,16178,128,200,"PSOE",4564
49,"49221",234,138,130,1,8,"PSOE",34
19,"19213",70,53,52,0,1,"PSOE",22
4,"4059",1025,742,731,3,11,"PSOE",431
37,"37029",193,139,133,1,6,"PSOE",42
47,"47056",83,71,71,0,0,"PSOE",13
49,"49069",327,211,207,0,4,"PSOE",52
31,"31060",14185,10582,10485,103,97,"PSOE",2909
9,"9014",192,143,142,0,1,"PSOE",41
9,"9045",274,199,196,1,3,"PSOE",38
26,"26152",27,23,23,1,0,"PSOE",4
46,"46008",2624,2036,1996,9,40,"PSOE",574
9,"9202",22,22,22,2,0,"PSOE",2
9,"9046",24,19,19,0,0,"PSOE",3
6,"6074",4755,3719,3638,27,81,"PSOE",1311
11,"11903",1791,1234,1211,16,23,"PSOE",535
28,"28127",66441,56199,55932,327,267,"PSOE",10178
50,"50194",81,59,59,1,0,"PSOE",15
10,"10031",164,136,135,0,1,"PSOE",45
9,"9372",204,176,175,1,1,"PSOE",47
41,"41083",1128,865,859,6,6,"PSOE",459
46,"46100",281,210,205,0,5,"PSOE",62
10,"10113",2258,1695,1657,6,38,"PSOE",765
26,"26001",198,171,165,1,6,"PSOE",64
31,"31184",65,48,46,0,2,"PSOE",2
9,"9241",247,192,188,2,4,"PSOE",53
5,"5127",608,499,496,0,3,"PSOE",135
23,"23063",3764,2812,2781,22,31,"PSOE",1316
9,"9048",1380,1070,1039,8,31,"PSOE",287
12,"12094",875,694,682,2,12,"PSOE",228
42,"42057",147,95,93,3,2,"PSOE",9
9,"9411",154,118,118,0,0,"PSOE",29
26,"26141",100,73,73,0,0,"PSOE",12
46,"46040",995,807,794,7,13,"PSOE",264
9,"9078",37,31,31,0,0,"PSOE",11
19,"19171",5302,4297,4238,24,59,"PSOE",1525
42,"42073",73,58,57,0,1,"PSOE",11
19,"19186",78,67,67,0,0,"PSOE",30
37,"37045",28,19,18,0,1,"PSOE",0
28,"28095",1677,1310,1293,4,17,"PSOE",311
37,"37089",62,51,50,0,1,"PSOE",13
18,"18911",7869,5871,5765,49,106,"PSOE",1649
40,"40136",106,82,81,0,1,"PSOE",12
29,"29006",665,491,483,5,8,"PSOE",204
50,"50262",1163,930,912,15,18,"PSOE",389
47,"47030",941,759,740,3,19,"PSOE",194
38,"38040",5446,3513,3462,13,51,"PSOE",732
31,"31255",103,87,84,0,3,"PSOE",17
31,"31092",685,514,511,6,3,"PSOE",75
50,"50253",382,318,315,2,3,"PSOE",94
41,"41085",4170,3337,3270,27,67,"PSOE",1182
50,"50060",170,137,135,2,2,"PSOE",42
14,"14063",1000,767,757,4,10,"PSOE",343
37,"37010",923,739,735,2,4,"PSOE",202
31,"31133",35,28,28,0,0,"PSOE",6
11,"11013",2332,1747,1713,16,34,"PSOE",767
44,"44157",64,38,38,1,0,"PSOE",12
9,"9136",173,130,128,0,2,"PSOE",29
6,"6034",167,115,115,1,0,"PSOE",40
26,"26144",188,161,160,1,1,"PSOE",30
39,"39007",393,300,298,1,2,"PSOE",74
10,"10077",637,501,499,3,2,"PSOE",213
40,"40032",378,287,278,1,9,"PSOE",60
29,"29019",864,687,679,7,8,"PSOE",196
42,"42078",1005,769,756,6,13,"PSOE",210
9,"9054",89,69,68,1,1,"PSOE",11
47,"47093",797,628,615,6,13,"PSOE",184
44,"44169",310,250,245,4,5,"PSOE",109
16,"16060",722,571,560,3,11,"PSOE",198
49,"49035",222,195,195,2,0,"PSOE",51
50,"50292",129,113,113,1,0,"PSOE",32
50,"50120",55,43,43,2,0,"PSOE",18
41,"41059",35105,27781,27472,261,309,"PSOE",8804
10,"10159",317,241,240,0,1,"PSOE",103
46,"46014",3130,2488,2462,7,26,"PSOE",659
47,"47094",123,110,109,1,1,"PSOE",37
19,"19235",98,82,81,0,1,"PSOE",41
9,"9326",154,129,127,4,2,"PSOE",32
41,"41087",10496,7661,7477,57,184,"PSOE",2475
44,"44231",36,33,32,0,1,"PSOE",9
46,"46074",2678,2158,2135,13,23,"PSOE",559
19,"19309",21,18,17,0,1,"PSOE",6
14,"14035",5817,4373,4314,44,59,"PSOE",1673
5,"5014",5291,4096,4044,29,52,"PSOE",1299
46,"46034",1811,1407,1389,13,18,"PSOE",338
44,"44061",75,66,65,2,1,"PSOE",25
10,"10025",379,328,317,3,11,"PSOE",117
19,"19209",41,35,34,0,1,"PSOE",8
19,"19129",27,25,25,0,0,"PSOE",7
16,"16048",409,331,330,1,1,"PSOE",106
12,"12006",174,149,149,2,0,"PSOE",54
24,"24114",2893,2017,1989,17,28,"PSOE",873
26,"26032",45,37,37,1,0,"PSOE",14
3,"3115",255,222,221,2,1,"PSOE",62
18,"18038",1047,810,787,4,23,"PSOE",363
38,"38044",2199,1443,1429,10,14,"PSOE",384
24,"24076",1286,998,981,8,17,"PSOE",329
14,"14016",1283,1005,994,4,11,"PSOE",522
9,"9010",32,27,27,1,0,"PSOE",3
38,"38014",1341,991,981,6,10,"PSOE",218
22,"22077",362,301,293,3,8,"PSOE",125
16,"16247",63,53,53,1,0,"PSOE",26
47,"47086",3823,3090,3046,24,44,"PSOE",1095
28,"28124",59,52,52,0,0,"PSOE",11
6,"6083",46489,34360,33989,270,371,"PSOE",11597
10,"10082",1810,1495,1476,9,19,"PSOE",701
49,"49122",778,586,573,6,13,"PSOE",151
9,"9419",67,53,52,0,1,"PSOE",3
10,"10068",711,576,556,2,20,"PSOE",208
9,"9110",77,57,57,0,0,"PSOE",22
49,"49040",112,97,97,0,0,"PSOE",47
22,"22088",143,111,111,1,0,"PSOE",47
9,"9144",44,37,37,2,0,"PSOE",3
22,"22053",786,573,567,3,6,"PSOE",223
24,"24078",336,259,255,0,4,"PSOE",94
37,"37099",61,46,46,1,0,"PSOE",22
44,"44142",28,21,21,0,0,"PSOE",10
50,"50183",319,242,241,4,1,"PSOE",63
3,"3085",269,243,237,0,6,"PSOE",50
47,"47005",502,420,414,2,6,"PSOE",125
5,"5124",92,71,70,1,1,"PSOE",9
46,"46078",28394,20928,20748,156,180,"PSOE",6558
6,"6018",740,543,536,5,7,"PSOE",291
19,"19088",95,82,82,2,0,"PSOE",21
45,"45186",2945,2319,2280,11,39,"PSOE",619
46,"46169",32294,24909,24676,157,233,"PSOE",7867
44,"44034",126,97,97,2,0,"PSOE",25
40,"40060",68,46,46,0,0,"PSOE",6
3,"3025",1292,1009,991,7,18,"PSOE",271
40,"40097",125,96,95,1,1,"PSOE",41
26,"26151",411,353,351,3,2,"PSOE",123
31,"31183",713,569,555,6,14,"PSOE",86
18,"18111",2849,2193,2160,24,33,"PSOE",741
49,"49005",128,87,85,1,2,"PSOE",27
42,"42042",49,42,42,1,0,"PSOE",6
42,"42043",3838,2897,2855,18,42,"PSOE",657
12,"12042",574,486,479,8,7,"PSOE",97
5,"5061",261,214,208,0,6,"PSOE",79
22,"22199",6926,5113,5051,44,62,"PSOE",1933
40,"40039",180,147,144,1,3,"PSOE",30
24,"24162",1772,1382,1369,22,13,"PSOE",445
34,"34186",47,41,41,0,0,"PSOE",10
50,"50203",1057,849,837,9,12,"PSOE",225
14,"14030",7797,6116,6036,54,80,"PSOE",2699
46,"46039",2121,1730,1698,19,32,"PSOE",505
33,"33077",1118,772,761,4,11,"PSOE",255
3,"3088",5810,4380,4313,31,67,"PSOE",1128
26,"26037",131,99,98,1,1,"PSOE",30
42,"42044",53,41,39,0,2,"PSOE",3
37,"37367",185,150,148,4,2,"PSOE",30
37,"37331",188,130,130,1,0,"PSOE",30
2,"2011",578,461,459,2,2,"PSOE",187
37,"37008",4222,3431,3393,19,38,"PSOE",828
33,"33037",33247,23529,23210,297,319,"PSOE",8807
31,"31145",161,131,129,1,2,"PSOE",28
44,"44177",101,75,75,1,0,"PSOE",43
37,"37368",17,15,11,0,4,"PSOE",0
9,"9117",71,55,53,0,2,"PSOE",16
46,"46172",5412,3878,3832,18,46,"PSOE",956
3,"3089",9497,6952,6794,55,158,"PSOE",2270
24,"24121",616,491,484,4,7,"PSOE",172
37,"37104",25,18,18,0,0,"PSOE",0
38,"38050",2436,1564,1529,12,35,"PSOE",486
50,"50096",36,22,22,0,0,"PSOE",5
4,"4051",406,343,339,1,4,"PSOE",121
46,"46022",15325,11197,11072,70,125,"PSOE",3408
37,"37357",258,0,0,0,0,"PSOE",0
37,"37106",249,173,173,1,0,"PSOE",38
50,"50129",213,151,149,5,2,"PSOE",44
19,"19201",60,45,45,0,0,"PSOE",6
24,"24122",1319,983,969,3,14,"PSOE",330
5,"5064",102,83,81,2,2,"PSOE",12
14,"14012",6076,4579,4489,38,90,"PSOE",2110
3,"3050",19334,14377,14253,71,124,"PSOE",3625
31,"31093",275,212,206,0,6,"PSOE",48
19,"19247",142,118,117,2,1,"PSOE",57
9,"9102",33,26,25,0,1,"PSOE",2
50,"50188",27,24,24,0,0,"PSOE",8
23,"23045",2057,1519,1507,7,12,"PSOE",609
18,"18082",827,587,577,5,10,"PSOE",222
14,"14033",1265,994,985,9,9,"PSOE",484
28,"28173",519,417,412,4,5,"PSOE",140
42,"42010",21,18,16,0,2,"PSOE",1
41,"41067",7227,5367,5271,56,96,"PSOE",2229
44,"44019",68,42,42,0,0,"PSOE",7
14,"14044",1620,1279,1264,12,15,"PSOE",687
26,"26079",620,526,521,0,5,"PSOE",115
23,"23046",2331,1953,1926,3,27,"PSOE",998
21,"21044",17955,11674,11479,136,195,"PSOE",2807
24,"24167",716,516,505,4,11,"PSOE",178
47,"47138",219,182,177,1,5,"PSOE",54
37,"37336",52,46,45,3,1,"PSOE",11
40,"40010",111,95,94,0,1,"PSOE",21
35,"35025",1773,1247,1235,9,12,"PSOE",293
28,"28174",1840,1363,1349,10,14,"PSOE",319
9,"9070",33,28,25,0,3,"PSOE",9
42,"42142",45,35,35,0,0,"PSOE",10
34,"34005",792,659,645,5,14,"PSOE",178
26,"26146",86,69,69,1,0,"PSOE",16
12,"12136",2606,2262,2223,17,39,"PSOE",602
19,"19208",41,34,34,0,0,"PSOE",13
9,"9056",4812,3585,3533,36,52,"PSOE",873
29,"29043",2474,1764,1720,25,44,"PSOE",704
21,"21070",6222,4413,4322,47,91,"PSOE",1762
44,"44222",122,102,102,1,0,"PSOE",35
39,"39046",1343,1002,988,8,14,"PSOE",265
16,"16193",58,51,51,2,0,"PSOE",28
18,"18084",4458,3467,3417,17,50,"PSOE",997
34,"34147",160,125,124,1,1,"PSOE",19
42,"42189",53,44,42,0,2,"PSOE",9
31,"31151",57,42,42,1,0,"PSOE",10
50,"50162",137,112,110,2,2,"PSOE",57
45,"45151",546,434,431,0,3,"PSOE",158
29,"29055",1880,1493,1470,15,23,"PSOE",607
37,"37013",107,73,72,0,1,"PSOE",15
50,"50276",119,91,91,1,0,"PSOE",42
40,"40177",140,114,113,1,1,"PSOE",29
40,"40071",43,37,31,0,6,"PSOE",2
19,"19150",126,102,100,0,2,"PSOE",33
31,"31098",1962,1562,1544,14,18,"PSOE",279
50,"50064",438,368,362,1,6,"PSOE",163
47,"47141",118,103,102,0,1,"PSOE",16
37,"37149",61,56,54,1,2,"PSOE",4
29,"29056",1061,783,772,4,11,"PSOE",325
23,"23015",1332,1066,1048,4,18,"PSOE",531
42,"42082",7,7,7,0,0,"PSOE",1
22,"22004",124,90,88,1,2,"PSOE",29
12,"12017",148,120,116,0,4,"PSOE",35
22,"22028",362,284,282,5,2,"PSOE",96
19,"19194",94,76,76,0,0,"PSOE",30
47,"47130",99,76,76,2,0,"PSOE",14
29,"29057",341,236,233,0,3,"PSOE",136
49,"49259",79,62,61,0,1,"PSOE",10
26,"26083",354,295,291,1,4,"PSOE",59
50,"50104",326,264,259,4,5,"PSOE",93
50,"50017",1779,1386,1373,14,13,"PSOE",349
33,"33024",225188,169937,168490,1483,1447,"PSOE",55594
14,"14018",3611,2802,2741,25,61,"PSOE",946
24,"24131",677,468,463,1,5,"PSOE",99
19,"19212",674,528,519,2,9,"PSOE",136
33,"33076",12147,8532,8452,104,80,"PSOE",2461
50,"50105",279,216,213,4,3,"PSOE",75
24,"24012",285,204,202,2,2,"PSOE",45
50,"50065",55,43,43,1,0,"PSOE",21
19,"19051",61,54,54,0,0,"PSOE",24
46,"46028",388,324,319,1,5,"PSOE",84
9,"9061",148,129,129,0,0,"PSOE",9
4,"4019",232,181,179,0,2,"PSOE",91
40,"40191",204,166,165,1,1,"PSOE",25
37,"37265",208,184,181,1,3,"PSOE",86
50,"50251",8207,6352,6242,46,110,"PSOE",2063
40,"40224",19,16,16,0,0,"PSOE",2
18,"18020",501,365,358,2,7,"PSOE",138
16,"16001",64,51,51,0,0,"PSOE",15
19,"19120",108,90,90,1,0,"PSOE",24
40,"40051",34,33,31,0,2,"PSOE",9
2,"2021",1014,836,827,5,9,"PSOE",299
24,"24187",845,641,630,6,11,"PSOE",177
31,"31211",17,13,13,1,0,"PSOE",1
50,"50213",93,76,75,0,1,"PSOE",11
9,"9016",84,55,54,0,1,"PSOE",23
9,"9390",569,464,459,5,5,"PSOE",126
42,"42194",146,111,111,0,0,"PSOE",31
31,"31157",3470,2507,2473,32,34,"PSOE",813
41,"41074",2998,2364,2322,17,42,"PSOE",985
26,"26050",130,97,97,0,0,"PSOE",17
19,"19215",144,121,119,0,2,"PSOE",23
37,"37031",336,261,258,3,3,"PSOE",55
16,"16042",1108,948,938,3,10,"PSOE",446
21,"21053",3287,2375,2322,17,53,"PSOE",910
5,"5231",151,126,126,0,0,"PSOE",36
42,"42058",102,84,84,0,0,"PSOE",14
45,"45901",780,593,587,3,6,"PSOE",190
45,"45205",7342,5347,5275,30,72,"PSOE",1499
31,"31240",513,385,385,6,0,"PSOE",30
50,"50195",53,42,41,0,1,"PSOE",10
6,"6132",829,598,593,0,5,"PSOE",307
4,"4100",9266,6046,5988,49,58,"PSOE",1624
3,"3008",159,127,126,0,1,"PSOE",40
10,"10183",958,748,735,3,13,"PSOE",324
9,"9079",48,42,42,1,0,"PSOE",2
24,"24176",299,243,238,3,5,"PSOE",58
37,"37033",92,69,69,2,0,"PSOE",20
16,"16169",51,36,32,0,4,"PSOE",11
18,"18162",929,730,719,4,11,"PSOE",303
9,"9135",40,34,34,0,0,"PSOE",6
26,"26052",148,113,113,1,0,"PSOE",27
9,"9035",284,213,210,1,3,"PSOE",71
30,"30014",1585,1226,1202,3,24,"PSOE",496
13,"13090",1023,814,796,5,18,"PSOE",335
19,"19306",22,19,19,0,0,"PSOE",2
19,"19260",38,33,31,1,2,"PSOE",18
12,"12087",25,19,18,2,1,"PSOE",1
40,"40161",35,28,26,0,2,"PSOE",2
46,"46256",7211,5263,5209,27,54,"PSOE",1320
44,"44251",242,197,187,0,10,"PSOE",40
29,"29030",774,660,657,3,3,"PSOE",394
26,"26053",195,161,160,3,1,"PSOE",53
9,"9464",33,27,27,0,0,"PSOE",2
37,"37158",233,168,166,0,2,"PSOE",48
4,"4102",14110,9871,9765,90,106,"PSOE",2759
49,"49267",97,73,68,1,5,"PSOE",12
35,"35033",6403,4565,4502,34,63,"PSOE",1209
38,"38001",20907,12323,12197,70,126,"PSOE",3948
44,"44220",113,92,89,0,3,"PSOE",14
10,"10145",125,106,104,1,2,"PSOE",47
40,"40020",155,125,119,4,6,"PSOE",32
29,"29031",1559,1139,1113,13,26,"PSOE",567
49,"49064",483,319,317,1,2,"PSOE",78
38,"38032",13536,9924,9867,63,57,"PSOE",2421
49,"49183",93,73,71,2,2,"PSOE",8
37,"37235",219,170,166,4,4,"PSOE",34
19,"19221",35,26,26,0,0,"PSOE",8
14,"14024",1859,1461,1418,10,43,"PSOE",645
26,"26055",39,35,35,1,0,"PSOE",10
46,"46003",953,828,811,5,17,"PSOE",241
5,"5196",57,45,42,0,3,"PSOE",24
28,"28088",286,193,193,2,0,"PSOE",67
28,"28902",523,418,415,2,3,"PSOE",64
39,"39036",971,794,787,5,7,"PSOE",216
44,"44128",59,46,45,0,1,"PSOE",19
9,"9471",142,113,112,3,1,"PSOE",23
50,"50015",81,61,59,1,2,"PSOE",39
19,"19147",45,36,36,0,0,"PSOE",14
47,"47200",71,62,62,0,0,"PSOE",8
47,"47013",90,80,78,4,2,"PSOE",34
12,"12090",104,85,83,1,2,"PSOE",16
19,"19081",27,19,19,0,0,"PSOE",4
37,"37273",88,67,67,0,0,"PSOE",17
34,"34025",53,37,37,2,0,"PSOE",7
13,"13003",449,346,343,0,3,"PSOE",139
24,"24143",495,388,380,2,8,"PSOE",174
18,"18061",1000,827,822,1,5,"PSOE",296
23,"23014",2552,2056,2020,11,36,"PSOE",845
14,"14005",6318,4464,4380,59,84,"PSOE",1700
3,"3033",102,87,85,0,2,"PSOE",17
21,"21060",12235,8053,7929,93,124,"PSOE",2416
40,"40047",32,25,25,0,0,"PSOE",7
46,"46260",2647,2136,2113,8,23,"PSOE",639
4,"4093",1919,1346,1326,10,20,"PSOE",456
33,"33003",612,373,369,6,4,"PSOE",136
16,"16176",31,22,22,0,0,"PSOE",14
4,"4030",1066,783,776,5,7,"PSOE",333
37,"37351",269,234,233,6,1,"PSOE",70
19,"19065",114,92,91,0,1,"PSOE",30
10,"10109",1730,1208,1181,12,27,"PSOE",481
23,"23028",6131,4696,4635,24,61,"PSOE",1948
9,"9476",60,50,50,0,0,"PSOE",18
5,"5200",40,27,26,0,1,"PSOE",4
3,"3004",599,465,458,4,7,"PSOE",160
2,"2031",541,432,425,0,7,"PSOE",173
44,"44258",53,44,44,0,0,"PSOE",9
9,"9478",45,40,40,0,0,"PSOE",15
16,"16177",82,64,63,0,1,"PSOE",14
33,"33034",10043,6765,6671,69,94,"PSOE",2369
46,"46067",1744,1451,1432,4,19,"PSOE",444
37,"37276",126,101,101,0,0,"PSOE",15
13,"13053",14075,10930,10798,98,132,"PSOE",3782
47,"47026",49,40,39,0,1,"PSOE",7
31,"31168",241,203,199,2,4,"PSOE",27
40,"40156",281,223,222,1,1,"PSOE",63
47,"47088",105,90,90,0,0,"PSOE",25
10,"10111",1306,1006,994,12,12,"PSOE",348
13,"13007",1233,1005,967,11,38,"PSOE",413
19,"19134",30,24,24,0,0,"PSOE",10
49,"49150",123,90,90,3,0,"PSOE",33
47,"47057",273,204,200,0,4,"PSOE",22
45,"45079",349,272,272,1,0,"PSOE",92
33,"33066",42882,30942,30529,401,413,"PSOE",9783
10,"10193",1412,1158,1145,4,13,"PSOE",308
12,"12031",3942,2976,2931,24,45,"PSOE",698
19,"19227",73,55,53,0,2,"PSOE",30
14,"14029",4029,3089,3039,15,50,"PSOE",1420
37,"37165",31,22,21,0,1,"PSOE",2
21,"21063",2620,2037,1992,11,45,"PSOE",1228
46,"46099",772,620,614,1,6,"PSOE",248
31,"31129",384,260,259,0,1,"PSOE",39
50,"50288",3444,2689,2668,24,21,"PSOE",651
38,"38018",4455,3242,3198,24,44,"PSOE",819
16,"16098",520,441,439,6,2,"PSOE",172
31,"31170",45,37,36,2,1,"PSOE",8
47,"47018",36,31,29,0,2,"PSOE",1
40,"40028",105,96,96,1,0,"PSOE",15
31,"31048",160,133,132,2,1,"PSOE",24
45,"45082",1143,976,967,7,9,"PSOE",381
50,"50261",205,171,167,1,4,"PSOE",87
47,"47090",2435,1956,1921,12,35,"PSOE",603
47,"47028",30,17,17,0,0,"PSOE",2
41,"41084",2815,2177,2111,3,66,"PSOE",1072
50,"50001",88,71,70,0,1,"PSOE",11
37,"37243",90,71,70,0,1,"PSOE",8
26,"26088",41,38,38,0,0,"PSOE",12
31,"31171",669,516,502,3,14,"PSOE",211
40,"40100",263,219,215,1,4,"PSOE",51
44,"44227",72,61,61,0,0,"PSOE",14
37,"37356",87,66,66,0,0,"PSOE",19
14,"14062",963,753,745,4,8,"PSOE",365
12,"12065",171,150,147,0,3,"PSOE",52
19,"19091",23,19,19,0,0,"PSOE",5
37,"37204",255,197,195,0,2,"PSOE",49
13,"13058",4050,3188,3128,24,60,"PSOE",1186
16,"16056",453,323,321,1,2,"PSOE",133
9,"9901",340,256,255,1,1,"PSOE",64
44,"44007",152,120,117,0,3,"PSOE",25
22,"22058",191,157,157,3,0,"PSOE",52
5,"5169",219,176,173,1,3,"PSOE",34
49,"49033",666,515,508,1,7,"PSOE",150
40,"40101",923,737,728,8,9,"PSOE",180
28,"28096",19809,15584,15392,118,192,"PSOE",3882
28,"28162",2771,2264,2243,6,21,"PSOE",421
12,"12067",523,423,416,1,7,"PSOE",155
3,"3019",15465,12156,11988,80,168,"PSOE",3455
31,"31214",87,66,64,0,2,"PSOE",11
31,"31053",503,375,370,4,5,"PSOE",99
26,"26028",139,120,117,1,3,"PSOE",30
21,"21031",1172,807,764,5,43,"PSOE",352
12,"12068",41,26,25,1,1,"PSOE",7
37,"37170",1370,1009,990,10,19,"PSOE",276
31,"31012",771,571,564,5,7,"PSOE",223
49,"49034",417,320,317,0,3,"PSOE",87
9,"9323",59,41,41,2,0,"PSOE",6
19,"19278",24,24,24,0,0,"PSOE",4
47,"47126",44,42,42,1,0,"PSOE",4
29,"29097",4168,3086,3009,37,77,"PSOE",1424
14,"14064",300,231,227,6,4,"PSOE",104
11,"11014",17141,11836,11705,214,131,"PSOE",3347
38,"38042",3781,2799,2774,11,25,"PSOE",1104
40,"40068",22,21,21,0,0,"PSOE",2
16,"16244",708,627,617,1,10,"PSOE",274
26,"26066",259,216,212,3,4,"PSOE",50
10,"10118",281,242,242,2,0,"PSOE",117
5,"5171",67,57,51,1,6,"PSOE",5
42,"42036",40,34,33,2,1,"PSOE",8
31,"31136",452,337,333,5,4,"PSOE",60
4,"4079",54086,38415,38134,239,281,"PSOE",9101
14,"14004",1981,1522,1509,8,13,"PSOE",622
50,"50293",392,295,293,6,2,"PSOE",127
23,"23002",17399,13575,13341,97,234,"PSOE",5357
41,"41003",2371,1801,1760,8,41,"PSOE",772
3,"3021",5578,4720,4626,35,94,"PSOE",1124
44,"44201",478,417,412,3,5,"PSOE",169
37,"37135",1163,934,924,8,10,"PSOE",281
41,"41088",512,383,377,1,6,"PSOE",209
46,"46004",1919,1641,1616,14,25,"PSOE",357
37,"37312",244,198,197,1,1,"PSOE",55
37,"37081",871,725,717,4,8,"PSOE",268
9,"9039",56,44,44,0,0,"PSOE",2
46,"46227",888,708,693,6,15,"PSOE",258
28,"28165",1910,1443,1430,11,13,"PSOE",329
12,"12070",499,434,430,3,4,"PSOE",148
9,"9009",158,139,137,4,2,"PSOE",26
33,"33073",8186,5090,5023,65,67,"PSOE",1689
40,"40106",183,153,151,2,2,"PSOE",58
31,"31138",954,699,698,8,1,"PSOE",112
44,"44203",9,9,9,0,0,"PSOE",2
16,"16161",52,47,47,0,0,"PSOE",11
42,"42081",136,95,93,0,2,"PSOE",23
4,"4081",346,272,271,2,1,"PSOE",159
47,"47191",115,85,84,0,1,"PSOE",12
23,"23904",2604,1727,1701,7,26,"PSOE",786
33,"33033",9439,6565,6468,78,97,"PSOE",2643
37,"37015",205,131,130,2,1,"PSOE",41
3,"3084",497,429,429,4,0,"PSOE",155
22,"22106",20,15,15,0,0,"PSOE",6
23,"23903",3499,2738,2714,7,24,"PSOE",1115
29,"29090",1653,1215,1200,8,15,"PSOE",333
37,"37327",179,154,150,0,4,"PSOE",50
3,"3024",3948,3210,3164,14,46,"PSOE",1067
19,"19239",91,64,63,1,1,"PSOE",17
38,"38015",4067,2951,2926,22,25,"PSOE",623
42,"42115",95,77,77,1,0,"PSOE",8
22,"22195",234,193,192,0,1,"PSOE",34
40,"40143",83,73,73,2,0,"PSOE",17
28,"28104",15318,12897,12797,87,100,"PSOE",2625
19,"19195",37,29,28,2,1,"PSOE",14
28,"28167",8608,7086,7015,48,71,"PSOE",2017
19,"19104",18,16,16,0,0,"PSOE",6
19,"19050",15,13,13,0,0,"PSOE",8
24,"24199",405,302,297,3,5,"PSOE",97
10,"10002",359,284,279,2,5,"PSOE",119
37,"37365",166,132,131,1,1,"PSOE",24
21,"21037",459,363,357,4,6,"PSOE",195
24,"24038",3048,2360,2315,23,45,"PSOE",921
31,"31182",30,28,28,1,0,"PSOE",7
46,"46017",32990,23940,23694,155,246,"PSOE",5486
5,"5100",267,217,212,1,5,"PSOE",60
44,"44043",88,67,65,1,2,"PSOE",18
37,"37177",265,209,208,0,1,"PSOE",40
9,"9013",44,37,37,0,0,"PSOE",5
24,"24039",1954,1563,1552,28,11,"PSOE",386
14,"14070",1284,988,969,5,19,"PSOE",377
24,"24001",168,105,104,0,1,"PSOE",32
46,"46109",6174,4763,4639,30,124,"PSOE",1392
40,"40145",1105,906,899,2,7,"PSOE",283
49,"49164",139,103,102,2,1,"PSOE",38
11,"11021",4926,3592,3486,50,106,"PSOE",1458
34,"34185",68,53,51,1,2,"PSOE",13
21,"21003",677,505,489,3,16,"PSOE",321
16,"16153",936,786,768,7,18,"PSOE",309
16,"16238",464,387,383,2,4,"PSOE",151
50,"50126",2262,1736,1708,20,28,"PSOE",482
22,"22200",239,181,178,0,3,"PSOE",55
47,"47123",461,391,390,3,1,"PSOE",94
30,"30001",4539,3615,3567,16,48,"PSOE",974
37,"37178",99,82,82,0,0,"PSOE",17
29,"29015",32064,23769,23461,213,308,"PSOE",8241
46,"46110",21317,15839,15699,89,140,"PSOE",4767
10,"10127",4706,3508,3423,23,85,"PSOE",1164
5,"5217",54,44,43,0,1,"PSOE",10
33,"33017",2997,2096,2058,29,38,"PSOE",821
18,"18182",1917,1391,1381,7,10,"PSOE",676
11,"11022",48682,28113,27794,294,319,"PSOE",8898
37,"37280",71,41,40,0,1,"PSOE",7
18,"18078",710,561,554,4,7,"PSOE",250
34,"34048",63,54,53,2,1,"PSOE",16
49,"49127",2430,1835,1799,30,36,"PSOE",537
44,"44238",2294,1763,1743,10,20,"PSOE",755
5,"5103",66,48,48,0,0,"PSOE",5
44,"44046",43,32,32,0,0,"PSOE",13
34,"34092",260,210,206,0,4,"PSOE",54
9,"9018",24647,18982,18715,184,267,"PSOE",5754
3,"3121",21787,15670,15453,81,217,"PSOE",3802
6,"6055",1998,1552,1523,9,29,"PSOE",631
3,"3028",964,804,795,6,9,"PSOE",230
35,"35022",51302,33009,32566,198,443,"PSOE",9170
24,"24004",494,408,403,7,5,"PSOE",111
29,"29018",1996,1523,1481,11,42,"PSOE",625
37,"37061",207,160,160,0,0,"PSOE",40
42,"42089",57,48,48,1,0,"PSOE",18
46,"46021",23977,18032,17879,125,153,"PSOE",5736
6,"6155",1825,1316,1292,21,24,"PSOE",554
18,"18079",3469,2667,2623,16,44,"PSOE",1511
24,"24164",362,221,220,1,1,"PSOE",49
3,"3122",43704,31952,31681,218,271,"PSOE",9364
28,"28172",9751,7994,7928,38,66,"PSOE",1489
22,"22074",275,223,221,10,2,"PSOE",76
40,"40149",486,383,376,3,7,"PSOE",79
40,"40150",61,53,53,1,0,"PSOE",10
38,"38021",1599,1079,1057,8,22,"PSOE",363
12,"12077",4790,3594,3565,39,29,"PSOE",1045
10,"10131",12808,9377,9254,67,123,"PSOE",2656
10,"10008",1291,1015,997,16,18,"PSOE",365
5,"5065",459,393,382,1,11,"PSOE",70
3,"3123",7576,5900,5814,36,86,"PSOE",1751
40,"40115",156,131,130,4,1,"PSOE",53
44,"44240",149,121,121,0,0,"PSOE",43
10,"10009",263,196,193,2,3,"PSOE",62
50,"50070",49,28,28,0,0,"PSOE",14
31,"31067",1896,1418,1397,17,21,"PSOE",544
47,"47073",116,91,89,0,2,"PSOE",18
49,"49170",98,75,75,1,0,"PSOE",29
9,"9021",51,36,35,1,1,"PSOE",4
37,"37259",36,29,29,0,0,"PSOE",3
46,"46205",14233,11274,11145,55,129,"PSOE",3269
28,"28036",2675,2135,2093,17,42,"PSOE",461
5,"5107",55,43,43,2,0,"PSOE",6
23,"23012",4018,2835,2804,15,31,"PSOE",1288
34,"34006",79,73,70,3,3,"PSOE",7
40,"40045",120,92,92,1,0,"PSOE",30
44,"44180",72,61,61,0,0,"PSOE",20
47,"47012",101,80,80,0,0,"PSOE",20
19,"19249",28,28,28,0,0,"PSOE",7
23,"23047",1579,1260,1247,13,13,"PSOE",608
40,"40070",148,110,107,1,3,"PSOE",34
41,"41032",3843,3018,2944,17,74,"PSOE",1392
18,"18914",1657,1315,1278,5,37,"PSOE",650
30,"30026",16252,11142,10977,65,165,"PSOE",2949
40,"40118",47,38,37,2,1,"PSOE",9
10,"10052",166,124,123,0,1,"PSOE",18
13,"13033",1560,1278,1262,9,16,"PSOE",682
45,"45105",380,284,275,2,9,"PSOE",84
40,"40152",748,637,620,6,17,"PSOE",186
42,"42094",603,484,475,10,9,"PSOE",139
50,"50072",195,164,161,3,3,"PSOE",40
49,"49013",229,176,175,4,1,"PSOE",65
47,"47096",126,106,105,0,1,"PSOE",26
37,"37299",229,175,168,0,7,"PSOE",42
39,"39028",3870,3131,3094,19,37,"PSOE",530
37,"37300",547,392,391,5,1,"PSOE",128
31,"31112",93,71,70,0,1,"PSOE",8
26,"26069",230,187,186,0,1,"PSOE",54
19,"19252",60,49,47,0,2,"PSOE",12
50,"50073",2117,1735,1706,13,29,"PSOE",538
49,"49054",849,641,629,5,12,"PSOE",208
24,"24010",8268,5968,5847,66,121,"PSOE",1508
10,"10136",285,223,223,1,0,"PSOE",98
9,"9348",133,105,104,0,1,"PSOE",30
16,"16211",322,233,229,0,4,"PSOE",94
9,"9025",108,73,72,0,1,"PSOE",13
12,"12081",602,488,481,0,7,"PSOE",145
31,"31058",202,163,160,2,3,"PSOE",19
22,"22043",93,68,67,1,1,"PSOE",21
50,"50249",284,229,227,1,2,"PSOE",48
9,"9181",277,220,219,2,1,"PSOE",31
12,"12138",19179,14217,14006,124,211,"PSOE",4317
26,"26046",1571,1185,1157,18,28,"PSOE",372
13,"13083",2392,1772,1714,13,58,"PSOE",496
9,"9074",834,697,694,8,3,"PSOE",184
50,"50192",233,189,183,0,6,"PSOE",68
46,"46118",3670,2930,2894,25,36,"PSOE",992
37,"37070",528,422,417,2,5,"PSOE",112
50,"50250",56,45,45,0,0,"PSOE",12
29,"29081",261,212,210,2,2,"PSOE",85
50,"50075",72,59,59,1,0,"PSOE",10
18,"18086",339,291,289,0,2,"PSOE",207
5,"5228",167,124,124,0,0,"PSOE",7
39,"39059",7577,5978,5916,47,62,"PSOE",1450
19,"19256",44,32,32,0,0,"PSOE",8
9,"9352",107,86,86,2,0,"PSOE",20
46,"46252",128,106,106,2,0,"PSOE",32
12,"12140",1140,936,922,7,14,"PSOE",310
24,"24172",415,240,237,1,3,"PSOE",62
46,"46119",752,627,614,8,13,"PSOE",203
11,"11033",21702,14645,14436,190,209,"PSOE",4778
28,"28011",420,315,311,1,4,"PSOE",78
22,"22045",73,57,56,0,1,"PSOE",21
45,"45019",7545,5831,5740,52,91,"PSOE",1972
16,"16215",237,157,153,1,4,"PSOE",89
11,"11034",2331,1708,1670,17,38,"PSOE",822
26,"26073",94,72,68,0,4,"PSOE",24
41,"41091",539730,412509,408312,3804,4197,"PSOE",133592
50,"50106",127,97,96,0,1,"PSOE",39
34,"34091",122,103,102,4,1,"PSOE",24
23,"23052",1108,949,931,8,18,"PSOE",513
16,"16085",135,109,109,1,0,"PSOE",36
5,"5115",516,397,395,3,2,"PSOE",93
45,"45112",1841,1250,1220,7,30,"PSOE",446
42,"42100",31,27,27,0,0,"PSOE",7
24,"24174",469,360,354,5,6,"PSOE",104
40,"40158",15,13,13,1,0,"PSOE",1
31,"31076",2520,2110,2094,21,16,"PSOE",284
39,"39032",1426,1156,1141,8,15,"PSOE",215
5,"5076",473,417,413,7,4,"PSOE",95
3,"3099",42876,32576,32172,192,404,"PSOE",7854
44,"44249",46,37,37,1,0,"PSOE",12
10,"10019",1416,1120,1094,3,26,"PSOE",307
16,"16086",881,751,747,3,4,"PSOE",265
9,"9190",86,68,67,0,1,"PSOE",9
2,"2023",515,442,435,1,7,"PSOE",171
6,"6065",298,258,255,1,3,"PSOE",113
28,"28181",20669,17314,17205,101,109,"PSOE",3117
31,"31078",2419,1924,1899,18,25,"PSOE",692
44,"44026",95,76,75,2,1,"PSOE",16
4,"4063",1063,847,835,5,12,"PSOE",286
10,"10102",503,407,403,3,4,"PSOE",224
18,"18089",14540,10725,10583,65,142,"PSOE",3768
30,"30012",9069,7397,7266,53,131,"PSOE",2913
45,"45069",1817,1460,1438,4,22,"PSOE",474
49,"49021",14258,10333,10206,102,127,"PSOE",3382
10,"10905",632,491,485,4,6,"PSOE",178
47,"47082",810,679,668,8,11,"PSOE",145
40,"40230",95,70,67,0,3,"PSOE",27
49,"49265",120,93,92,1,1,"PSOE",35
49,"49180",138,95,95,0,0,"PSOE",23
12,"12115",208,170,167,1,3,"PSOE",37
29,"29029",380,294,287,2,7,"PSOE",102
46,"46214",16415,12723,12610,74,113,"PSOE",3479
9,"9194",1969,1526,1511,14,15,"PSOE",416
35,"35005",1017,751,743,1,8,"PSOE",222
5,"5039",48,47,47,0,0,"PSOE",3
13,"13044",2569,1984,1951,12,33,"PSOE",704
46,"46032",5692,4518,4476,22,42,"PSOE",1293
47,"47115",276,231,223,1,8,"PSOE",45
6,"6035",865,678,670,4,8,"PSOE",237
50,"50022",504,396,386,11,10,"PSOE",122
11,"11038",13613,10879,10676,101,203,"PSOE",3399
19,"19125",40,28,28,0,0,"PSOE",4
31,"31202",4345,3132,3085,36,47,"PSOE",882
3,"3102",7226,5600,5516,28,84,"PSOE",1492
28,"28015",20440,17084,16953,103,131,"PSOE",3615
19,"19220",2536,1833,1813,9,20,"PSOE",411
49,"49023",909,682,674,5,8,"PSOE",178
47,"47116",403,321,320,3,1,"PSOE",83
24,"24141",101,78,78,0,0,"PSOE",31
4,"4066",13488,9324,9255,73,69,"PSOE",2578
40,"40056",32,21,21,0,0,"PSOE",4
18,"18095",2002,1566,1537,11,29,"PSOE",614
22,"22217",372,296,290,5,6,"PSOE",100
13,"13047",5780,4553,4461,32,92,"PSOE",1673
22,"22218",40,32,31,1,1,"PSOE",15
42,"42110",55,43,43,0,0,"PSOE",7
50,"50199",325,238,232,3,6,"PSOE",93
24,"24060",574,371,369,1,2,"PSOE",115
50,"50256",74,46,45,0,1,"PSOE",6
9,"9362",205,177,177,3,0,"PSOE",53
31,"31110",84,72,72,3,0,"PSOE",31
41,"41078",2459,1910,1895,24,15,"PSOE",955
22,"22205",459,347,345,1,2,"PSOE",160
21,"21022",186,132,129,0,3,"PSOE",59
42,"42111",279,209,208,3,1,"PSOE",60
50,"50285",650,466,462,7,4,"PSOE",135
37,"37311",207,164,162,4,2,"PSOE",45
19,"19265",135,107,107,1,0,"PSOE",21
28,"28048",504,399,392,6,7,"PSOE",125
50,"50200",475,416,407,4,9,"PSOE",206
40,"40022",193,162,159,2,3,"PSOE",67
46,"46207",6686,5220,5137,36,83,"PSOE",1355
37,"37082",745,546,536,2,10,"PSOE",197
14,"14057",6139,5054,4964,51,90,"PSOE",1885
4,"4902",45395,31127,30881,251,246,"PSOE",6529
50,"50113",584,505,495,3,10,"PSOE",237
31,"31166",250,184,184,2,0,"PSOE",34
49,"49027",126,88,88,0,0,"PSOE",14
13,"13050",479,399,394,2,5,"PSOE",136
2,"2029",3327,2586,2556,15,30,"PSOE",814
26,"26058",143,116,115,2,1,"PSOE",27
9,"9310",15,14,13,1,1,"PSOE",5
10,"10027",76,66,66,0,0,"PSOE",43
41,"41024",22737,15687,15398,167,289,"PSOE",6382
47,"47025",114,98,98,0,0,"PSOE",40
4,"4903",4308,3102,3075,17,27,"PSOE",683
37,"37083",176,160,156,1,4,"PSOE",57
40,"40131",50,47,47,0,0,"PSOE",10
46,"46006",4468,3731,3683,22,48,"PSOE",919
37,"37163",32,27,27,0,0,"PSOE",1
47,"47214",1364,1112,1074,7,38,"PSOE",297
24,"24183",752,549,543,8,6,"PSOE",176
12,"12120",161,138,138,0,0,"PSOE",45
22,"22178",103,84,84,2,0,"PSOE",14
49,"49188",110,87,86,0,1,"PSOE",18
34,"34222",109,81,79,1,2,"PSOE",9
31,"31208",2562,2067,2036,16,31,"PSOE",915
16,"16096",280,239,234,3,5,"PSOE",112
41,"41082",3359,2760,2718,11,42,"PSOE",1357
9,"9368",28,21,21,1,0,"PSOE",1
31,"31087",181,136,135,6,1,"PSOE",16
50,"50027",224,170,165,1,5,"PSOE",75
37,"37277",77,56,56,0,0,"PSOE",8
22,"22223",74,63,63,1,0,"PSOE",27
3,"3107",2769,2011,1986,10,25,"PSOE",524
16,"16237",98,83,83,0,0,"PSOE",18
19,"19226",41,32,32,0,0,"PSOE",11
28,"28093",2142,1751,1728,9,23,"PSOE",384
47,"47089",132,116,115,1,1,"PSOE",16
47,"47216",114,102,98,0,4,"PSOE",1
14,"14059",687,571,563,7,8,"PSOE",229
49,"49071",715,500,499,3,1,"PSOE",124
5,"5087",149,112,111,1,1,"PSOE",13
44,"44164",20,18,18,0,0,"PSOE",2
49,"49275",51218,38135,37628,388,507,"PSOE",11754
47,"47058",202,154,153,3,1,"PSOE",47
44,"44065",57,37,36,0,1,"PSOE",2
22,"22057",364,286,284,3,2,"PSOE",154
50,"50289",51,40,38,1,2,"PSOE",13
33,"33006",1480,1001,992,9,9,"PSOE",445
22,"22094",98,72,71,2,1,"PSOE",23
9,"9047",54,46,45,0,1,"PSOE",5
47,"47217",1973,1569,1541,19,28,"PSOE",389
34,"34224",42,30,29,0,1,"PSOE",6
41,"41027",3966,2830,2784,32,46,"PSOE",1096
5,"5205",79,66,66,0,0,"PSOE",22
9,"9373",406,284,268,3,16,"PSOE",27
44,"44262",143,115,112,0,3,"PSOE",23
19,"19271",41,26,26,0,0,"PSOE",5
38,"38039",11112,8233,8161,54,72,"PSOE",1582
44,"44165",173,136,135,2,1,"PSOE",47
23,"23032",523,443,439,1,4,"PSOE",292
26,"26102",6057,4672,4579,37,93,"PSOE",1392
49,"49032",287,224,222,0,2,"PSOE",57
40,"40135",269,224,221,1,3,"PSOE",72
10,"10033",403,306,302,6,4,"PSOE",85
22,"22226",771,598,591,6,7,"PSOE",244
29,"29095",3304,2536,2470,22,66,"PSOE",1229
44,"44133",15,12,12,0,0,"PSOE",0
40,"40906",2131,1830,1814,10,16,"PSOE",517
28,"28129",8578,6925,6853,45,72,"PSOE",1553
39,"39043",1523,1246,1220,10,26,"PSOE",138
16,"16240",100,77,76,0,1,"PSOE",32
47,"47125",51,46,45,0,1,"PSOE",9
49,"49077",159,104,103,0,1,"PSOE",23
3,"3049",12143,9418,9302,47,116,"PSOE",2345
29,"29040",1936,1419,1395,7,24,"PSOE",546
47,"47092",102,86,85,0,1,"PSOE",13
49,"49078",142,113,113,1,0,"PSOE",46
50,"50291",93,78,77,1,1,"PSOE",17
22,"22228",529,421,417,3,4,"PSOE",100
28,"28024",168,146,145,1,1,"PSOE",21
31,"31052",103,79,78,0,1,"PSOE",13
28,"28130",28508,23566,23305,179,261,"PSOE",7480
10,"10157",245,185,185,1,0,"PSOE",62
46,"46042",3348,2825,2774,11,51,"PSOE",858
26,"26104",11,9,9,0,0,"PSOE",2
5,"5010",145,119,118,1,1,"PSOE",28
19,"19232",58,49,49,0,0,"PSOE",11
9,"9003",184,143,142,2,1,"PSOE",50
33,"33010",1724,1211,1202,15,9,"PSOE",516
49,"49197",162,129,123,2,6,"PSOE",42
24,"24154",955,702,691,3,11,"PSOE",231
42,"42124",58,41,41,0,0,"PSOE",13
44,"44137",188,148,146,0,2,"PSOE",25
45,"45179",495,383,382,3,1,"PSOE",149
42,"42215",735,540,529,5,11,"PSOE",164
46,"46134",2380,1836,1825,5,11,"PSOE",534
50,"50207",93,68,67,2,1,"PSOE",18
46,"46225",348,279,273,2,6,"PSOE",57
50,"50150",621,451,450,2,1,"PSOE",162
12,"12126",24347,19023,18749,152,274,"PSOE",5585
13,"13017",247,189,188,2,1,"PSOE",80
9,"9162",132,102,102,1,0,"PSOE",24
28,"28164",3202,2553,2530,19,23,"PSOE",581
9,"9905",389,308,303,2,5,"PSOE",75
46,"46044",4198,3399,3337,13,62,"PSOE",1109
31,"31096",101,85,84,3,1,"PSOE",22
19,"19234",45,32,32,0,0,"PSOE",10
19,"19098",18,18,17,0,1,"PSOE",11
50,"50121",277,220,218,2,2,"PSOE",94
34,"34163",46,40,40,1,0,"PSOE",10
24,"24074",96,73,73,0,0,"PSOE",21
9,"9472",52,45,44,0,1,"PSOE",17
44,"44232",368,284,273,2,11,"PSOE",101
22,"22062",154,115,115,1,0,"PSOE",32
42,"42217",34,26,26,0,0,"PSOE",11
39,"39074",7041,5612,5551,31,61,"PSOE",961
47,"47033",204,167,167,2,0,"PSOE",39
47,"47095",41,36,34,2,2,"PSOE",4
2,"2004",606,504,499,5,5,"PSOE",204
5,"5212",197,138,136,0,2,"PSOE",36
49,"49159",269,214,213,1,1,"PSOE",70
9,"9217",349,268,266,5,2,"PSOE",68
29,"29044",757,540,533,7,7,"PSOE",233
37,"37324",335,276,274,1,2,"PSOE",71
28,"28058",141251,112674,111423,778,1251,"PSOE",37597
19,"19102",92,80,80,0,0,"PSOE",28
12,"12100",1281,1118,1102,5,16,"PSOE",408
47,"47129",855,715,696,3,19,"PSOE",225
46,"46228",2417,1953,1913,13,40,"PSOE",460
37,"37251",107,79,79,1,0,"PSOE",12
46,"46137",242,200,200,3,0,"PSOE",59
34,"34133",105,88,86,1,2,"PSOE",13
22,"22149",308,247,246,3,1,"PSOE",91
10,"10040",434,321,314,1,7,"PSOE",164
5,"5253",78,62,60,0,2,"PSOE",10
42,"42001",251,186,186,2,0,"PSOE",75
40,"40178",90,63,63,1,0,"PSOE",6
47,"47224",97,74,74,0,0,"PSOE",23
45,"45138",1055,889,874,5,15,"PSOE",302
39,"39076",3483,2770,2734,21,36,"PSOE",677
26,"26070",155,133,132,0,1,"PSOE",37
12,"12072",1082,901,889,15,12,"PSOE",309
9,"9112",104,76,76,1,0,"PSOE",21
5,"5099",457,392,389,2,3,"PSOE",142
21,"21001",610,480,461,3,19,"PSOE",220
19,"19196",90,77,70,1,7,"PSOE",20
38,"38016",1178,654,648,6,6,"PSOE",215
13,"13068",1037,802,783,2,19,"PSOE",308
34,"34236",147,111,111,0,0,"PSOE",17
49,"49085",918,673,660,5,13,"PSOE",209
10,"10165",253,212,210,1,2,"PSOE",78
22,"22107",100,68,67,0,1,"PSOE",23
16,"16109",41,33,33,3,0,"PSOE",7
19,"19285",20,18,18,0,0,"PSOE",7
47,"47132",39,33,33,0,0,"PSOE",8
12,"12073",132,110,107,1,3,"PSOE",23
50,"50241",595,434,423,3,11,"PSOE",124
10,"10003",540,388,386,4,2,"PSOE",131
47,"47226",149,124,123,0,1,"PSOE",52
40,"40180",277,231,224,3,7,"PSOE",33
47,"47037",163,134,128,2,6,"PSOE",33
19,"19286",742,610,603,4,7,"PSOE",142
49,"49086",111,94,93,1,1,"PSOE",28
44,"44236",59,44,44,0,0,"PSOE",7
3,"3119",17223,13244,13116,75,128,"PSOE",3521
49,"49006",142,111,111,1,0,"PSOE",33
49,"49248",174,142,139,2,3,"PSOE",38
9,"9063",214,185,184,0,1,"PSOE",19
28,"28107",442,336,325,3,11,"PSOE",116
45,"45142",7800,6245,6143,67,102,"PSOE",1966
2,"2046",1132,975,953,10,22,"PSOE",290
34,"34238",305,261,260,2,1,"PSOE",106
47,"47227",55,46,46,0,0,"PSOE",19
37,"37216",294,248,247,2,1,"PSOE",66
5,"5021",1871,1469,1440,15,29,"PSOE",392
45,"45005",227,180,174,5,6,"PSOE",59
19,"19155",66,56,56,0,0,"PSOE",17
18,"18112",110,80,76,0,4,"PSOE",23
24,"24042",61,47,47,1,0,"PSOE",18
49,"49166",1192,916,899,10,17,"PSOE",317
19,"19156",933,756,745,1,11,"PSOE",222
46,"46202",17660,13782,13645,93,137,"PSOE",2909
47,"47134",148,127,126,6,1,"PSOE",40
4,"4009",151,126,124,3,2,"PSOE",24
31,"31227",8111,6198,6129,69,69,"PSOE",1731
45,"45190",458,378,365,2,13,"PSOE",146
41,"41037",3192,2505,2479,15,26,"PSOE",1229
6,"6088",12505,9311,9140,93,171,"PSOE",3356
9,"9226",56,47,47,0,0,"PSOE",10
22,"22242",63,47,45,1,2,"PSOE",10
19,"19055",44,34,34,1,0,"PSOE",9
37,"37293",106,75,74,0,1,"PSOE",22
9,"9279",167,131,128,2,3,"PSOE",23
49,"49047",100,72,72,0,0,"PSOE",17
6,"6089",608,524,519,3,5,"PSOE",243
2,"2049",796,582,574,1,8,"PSOE",299
2,"2048",1178,989,967,7,22,"PSOE",360
31,"31228",494,383,382,0,1,"PSOE",102
19,"19159",87,77,76,0,1,"PSOE",17
5,"5024",198,142,139,2,3,"PSOE",36
16,"16203",10167,7720,7591,49,129,"PSOE",2872
44,"44147",398,293,286,3,7,"PSOE",111
28,"28141",6246,4943,4890,44,53,"PSOE",1002
19,"19111",162,142,142,0,0,"PSOE",51
31,"31188",296,200,197,0,3,"PSOE",46
45,"45101",3709,3052,3002,14,50,"PSOE",755
12,"12106",1163,980,951,7,29,"PSOE",453
42,"42140",14,13,12,0,1,"PSOE",0
24,"24166",1359,1038,1011,11,27,"PSOE",301
40,"40078",151,123,122,2,1,"PSOE",44
49,"49048",114,85,85,0,0,"PSOE",16
31,"31229",38,36,36,2,0,"PSOE",2
5,"5025",82,70,70,0,0,"PSOE",11
50,"50099",3042,2299,2265,20,34,"PSOE",884
9,"9176",59,50,47,2,3,"PSOE",6
37,"37062",77,65,63,0,2,"PSOE",8
28,"28111",622,492,487,1,5,"PSOE",129
14,"14013",16604,12618,12388,155,230,"PSOE",4243
29,"29053",1694,1263,1245,18,18,"PSOE",337
18,"18185",542,454,453,2,1,"PSOE",173
42,"42141",114,89,89,0,0,"PSOE",19
50,"50042",16,16,16,0,0,"PSOE",3
16,"16259",27,22,21,0,1,"PSOE",10
34,"34052",167,144,143,2,1,"PSOE",31
21,"21045",227,181,178,1,3,"PSOE",96
34,"34246",69,53,53,0,0,"PSOE",13
10,"10173",558,445,439,0,6,"PSOE",107
19,"19162",67,50,48,0,2,"PSOE",17
13,"13078",8936,6820,6733,46,87,"PSOE",2533
28,"28067",4361,3548,3509,14,39,"PSOE",1060
37,"37209",410,288,283,3,5,"PSOE",120
3,"3125",336,259,257,1,2,"PSOE",55
38,"38013",3019,2023,1991,12,32,"PSOE",582
26,"26121",30,21,21,1,0,"PSOE",9
31,"31069",830,639,638,3,1,"PSOE",178
37,"37147",172,130,127,3,3,"PSOE",42
5,"5029",99,69,69,0,0,"PSOE",15
45,"45013",1671,1320,1298,4,22,"PSOE",426
33,"33052",704,520,513,5,7,"PSOE",245
24,"24089",101353,78253,77375,776,878,"PSOE",23307
37,"37185",537,416,405,1,11,"PSOE",80
16,"16209",111,97,97,0,0,"PSOE",40
5,"5148",23,17,17,0,0,"PSOE",4
50,"50132",771,589,576,2,13,"PSOE",140
30,"30007",6484,4774,4727,25,47,"PSOE",1167
19,"19251",39,31,31,0,0,"PSOE",10
10,"10013",266,203,202,2,1,"PSOE",65
47,"47014",47,43,43,1,0,"PSOE",13
47,"47044",323,282,279,1,3,"PSOE",86
31,"31193",1438,1129,1123,13,6,"PSOE",192
14,"14902",1121,928,900,7,28,"PSOE",549
14,"14047",1629,1300,1285,18,15,"PSOE",489
22,"22117",2414,1798,1784,18,14,"PSOE",484
13,"13081",590,449,440,0,9,"PSOE",201
45,"45153",1560,1243,1230,4,13,"PSOE",382
33,"33054",1611,1145,1124,8,21,"PSOE",438
37,"37187",555,437,433,0,4,"PSOE",147
18,"18049",596,485,481,0,4,"PSOE",183
30,"30008",14450,10832,10675,60,157,"PSOE",2674
28,"28114",143,104,104,0,0,"PSOE",16
39,"39001",2065,1669,1643,16,26,"PSOE",389
38,"38026",33514,26298,26076,191,222,"PSOE",5744
18,"18050",1670,1231,1213,9,18,"PSOE",428
40,"40121",249,196,193,4,3,"PSOE",31
39,"39086",362,273,268,1,5,"PSOE",73
22,"22248",104,83,82,0,1,"PSOE",31
5,"5267",107,71,70,3,1,"PSOE",26
34,"34103",97,84,81,0,3,"PSOE",18
23,"23050",90596,69591,68903,460,688,"PSOE",20743
30,"30009",12689,10036,9909,50,127,"PSOE",2739
22,"22044",234,184,183,3,1,"PSOE",80
24,"24053",406,279,276,6,3,"PSOE",53
37,"37152",402,308,302,1,6,"PSOE",63
34,"34059",402,326,320,3,6,"PSOE",105
23,"23051",2727,2060,2023,5,37,"PSOE",953
44,"44246",1590,1173,1150,11,23,"PSOE",397
13,"13038",1604,1251,1216,14,35,"PSOE",646
13,"13084",841,683,673,6,10,"PSOE",267
10,"10179",277,220,219,0,1,"PSOE",98
5,"5153",87,65,65,1,0,"PSOE",14
50,"50135",88,74,74,3,0,"PSOE",23
24,"24093",338,239,232,3,7,"PSOE",70
50,"50222",1570,1126,1105,17,21,"PSOE",446
37,"37229",139,110,106,2,4,"PSOE",17
44,"44154",248,200,195,2,5,"PSOE",39
47,"47207",260,213,211,2,2,"PSOE",47
37,"37304",159,105,105,0,0,"PSOE",21
47,"47111",998,806,795,6,11,"PSOE",286
49,"49058",298,244,242,1,2,"PSOE",90
28,"28012",918,727,711,6,16,"PSOE",178
35,"35030",9949,6611,6462,65,149,"PSOE",1597
47,"47048",175,148,148,0,0,"PSOE",29
10,"10181",680,548,542,2,6,"PSOE",253
26,"26126",29,29,29,1,0,"PSOE",6
39,"39004",1483,1181,1163,4,18,"PSOE",326
9,"9077",30,22,22,0,0,"PSOE",3
46,"46060",9287,7184,7110,40,74,"PSOE",1959
46,"46242",330,279,279,0,0,"PSOE",68
37,"37305",218,180,178,3,2,"PSOE",46
12,"12084",17723,13501,13281,118,220,"PSOE",4012
37,"37344",235,171,168,1,3,"PSOE",52
3,"3068",42,40,40,3,0,"PSOE",4
24,"24095",307,237,235,0,2,"PSOE",48
10,"10060",935,670,658,4,12,"PSOE",284
40,"40087",87,70,70,0,0,"PSOE",7
26,"26168",5515,4130,4077,36,53,"PSOE",1133
42,"42059",20,13,13,0,0,"PSOE",0
37,"37156",4276,2621,2572,27,49,"PSOE",622
47,"47019",91,74,73,0,1,"PSOE",18
16,"16218",187,149,148,2,1,"PSOE",57
49,"49061",145,111,108,0,3,"PSOE",34
19,"19172",50,35,35,1,0,"PSOE",10
42,"42021",68,44,44,2,0,"PSOE",7
37,"37074",140,107,106,1,1,"PSOE",42
12,"12022",328,273,269,1,4,"PSOE",82
40,"40229",28,24,24,0,0,"PSOE",11
24,"24018",174,141,139,0,2,"PSOE",23
12,"12024",133,117,117,0,0,"PSOE",41
9,"9413",408,313,310,2,3,"PSOE",77
19,"19305",135,104,103,3,1,"PSOE",35
11,"11037",5644,4567,4433,34,134,"PSOE",1284
3,"3039",89,70,70,0,0,"PSOE",17
34,"34214",178,141,141,1,0,"PSOE",48
42,"42060",29,20,19,0,1,"PSOE",3
37,"37270",183,143,140,1,3,"PSOE",27
40,"40019",29,26,26,0,0,"PSOE",9
41,"41048",2198,1561,1512,22,49,"PSOE",783
19,"19023",127,98,96,0,2,"PSOE",28
3,"3070",2106,1554,1528,9,26,"PSOE",405
18,"18024",831,682,667,6,15,"PSOE",289
21,"21019",584,441,425,10,16,"PSOE",239
19,"19307",26,23,23,0,0,"PSOE",3
5,"5040",64,51,51,1,0,"PSOE",10
37,"37121",556,448,444,3,4,"PSOE",150
10,"10022",412,319,316,1,3,"PSOE",132
29,"29087",371,266,263,2,3,"PSOE",86
9,"9306",98,82,81,1,1,"PSOE",21
41,"41094",6447,4998,4912,43,86,"PSOE",1870
44,"44060",37,28,28,0,0,"PSOE",4
31,"31081",334,259,256,7,3,"PSOE",26
9,"9361",112,94,94,1,0,"PSOE",17
47,"47148",423,342,339,2,3,"PSOE",90
35,"35006",31309,23434,23019,221,415,"PSOE",7332
28,"28154",5525,4283,4222,24,61,"PSOE",1275
46,"46155",993,785,772,2,13,"PSOE",275
44,"44191",722,567,561,7,6,"PSOE",211
16,"16277",109,82,82,0,0,"PSOE",16
19,"19031",10,8,8,0,0,"PSOE",3
49,"49229",113,88,87,0,1,"PSOE",36
31,"31204",36,27,27,1,0,"PSOE",3
24,"24223",2540,1971,1929,37,42,"PSOE",638
38,"38033",3594,2512,2467,11,45,"PSOE",964
47,"47023",3057,2577,2557,21,20,"PSOE",594
50,"50024",556,427,426,6,1,"PSOE",199
33,"33032",11086,8028,7849,129,179,"PSOE",3308
24,"24061",1736,1350,1328,10,22,"PSOE",381
47,"47212",358,312,311,3,1,"PSOE",73
38,"38003",1510,1058,1047,4,11,"PSOE",459
18,"18027",2604,1902,1887,6,15,"PSOE",924
44,"44192",349,288,284,1,4,"PSOE",98
18,"18132",3124,2575,2548,17,27,"PSOE",1398
5,"5237",155,131,129,1,2,"PSOE",6
34,"34165",59,51,50,1,1,"PSOE",5
6,"6038",790,583,574,4,9,"PSOE",260
9,"9041",26,26,26,1,0,"PSOE",9
47,"47118",149,111,108,1,3,"PSOE",38
19,"19130",61365,49363,48747,383,616,"PSOE",14494
40,"40058",309,277,271,0,6,"PSOE",54
26,"26096",260,221,212,2,9,"PSOE",72
40,"40024",827,657,645,4,12,"PSOE",184
24,"24102",608,457,448,3,9,"PSOE",190
31,"31085",502,401,399,5,2,"PSOE",54
40,"40165",74,56,54,1,2,"PSOE",21
26,"26136",92,80,80,3,0,"PSOE",28
37,"37003",107,82,82,1,0,"PSOE",21
33,"33064",250,175,174,0,1,"PSOE",79
46,"46157",2960,2329,2296,12,33,"PSOE",533
2,"2067",1129,866,852,4,14,"PSOE",349
44,"44063",65,55,55,1,0,"PSOE",15
18,"18907",1774,1426,1415,10,11,"PSOE",634
28,"28049",57902,47976,47561,329,415,"PSOE",15381
23,"23029",806,651,637,0,14,"PSOE",313
31,"31127",135,96,96,0,0,"PSOE",9
37,"37040",382,319,316,1,3,"PSOE",118
30,"30019",25846,18755,18517,172,238,"PSOE",4539
18,"18134",6069,4431,4345,30,86,"PSOE",1167
42,"42162",2325,1721,1699,16,22,"PSOE",358
5,"5240",3323,2389,2346,16,43,"PSOE",602
21,"21062",1386,893,885,15,8,"PSOE",318
37,"37315",86,68,67,0,1,"PSOE",11
4,"4071",363,303,301,2,2,"PSOE",166
46,"46068",345,308,307,4,1,"PSOE",85
33,"33065",1084,761,746,18,15,"PSOE",195
3,"3045",213,178,173,4,5,"PSOE",54
12,"12121",1044,941,915,4,26,"PSOE",404
10,"10029",380,320,315,1,5,"PSOE",177
49,"49234",399,339,333,2,6,"PSOE",125
4,"4032",5698,4168,4138,20,30,"PSOE",1501
42,"42163",46,37,37,0,0,"PSOE",10
5,"5001",179,153,152,2,1,"PSOE",43
37,"37241",164,129,127,0,2,"PSOE",26
42,"42029",131,98,97,2,1,"PSOE",21
6,"6008",613,540,532,0,8,"PSOE",329
24,"24066",449,329,324,3,5,"PSOE",70
26,"26139",55,43,43,0,0,"PSOE",8
37,"37202",989,838,828,7,10,"PSOE",222
38,"38037",12803,8628,8517,48,111,"PSOE",2721
5,"5204",583,486,482,4,4,"PSOE",139
40,"40061",65,50,48,2,2,"PSOE",8
33,"33067",747,608,596,9,12,"PSOE",284
19,"19270",25,21,21,0,0,"PSOE",4
18,"18065",591,482,468,4,14,"PSOE",171
45,"45081",19138,15010,14829,110,181,"PSOE",3656
26,"26061",1552,1228,1194,14,34,"PSOE",409
31,"31049",679,512,505,2,7,"PSOE",49
22,"22137",1015,741,733,9,8,"PSOE",299
45,"45127",764,582,577,3,5,"PSOE",114
9,"9425",476,366,362,1,4,"PSOE",133
42,"42031",26,19,19,1,0,"PSOE",1
37,"37355",162,137,135,0,2,"PSOE",36
10,"10073",721,553,546,4,7,"PSOE",224
26,"26026",1265,1061,1049,2,12,"PSOE",348
24,"24068",443,343,336,1,7,"PSOE",174
45,"45174",296,253,250,3,3,"PSOE",80
34,"34124",63,58,58,0,0,"PSOE",17
31,"31131",907,719,712,8,7,"PSOE",101
31,"31010",5728,4211,4153,30,58,"PSOE",906
50,"50058",63,54,53,2,1,"PSOE",15
37,"37319",93,67,65,1,2,"PSOE",23
28,"28128",445,352,352,2,0,"PSOE",116
31,"31213",100,69,68,0,1,"PSOE",11
16,"16142",120,95,95,0,0,"PSOE",33
18,"18001",230,173,170,1,3,"PSOE",99
33,"33069",3419,2557,2533,32,24,"PSOE",1000
16,"16906",71,52,52,1,0,"PSOE",22
34,"34125",79,59,58,0,1,"PSOE",9
14,"14001",3443,2724,2675,24,49,"PSOE",1145
50,"50235",2412,1826,1807,22,19,"PSOE",525
26,"26143",242,190,189,0,1,"PSOE",56
18,"18034",486,376,374,4,2,"PSOE",165
16,"16143",15,10,10,1,0,"PSOE",2
37,"37009",196,142,141,1,1,"PSOE",38
5,"5130",94,86,86,0,0,"PSOE",38
18,"18002",526,400,400,0,0,"PSOE",266
37,"37358",164,142,135,2,7,"PSOE",24
19,"19325",144,87,87,1,0,"PSOE",22
3,"3080",1328,1077,1064,4,13,"PSOE",246
5,"5170",50,38,38,0,0,"PSOE",12
2,"2073",4844,3828,3772,28,56,"PSOE",1277
44,"44199",39,39,38,5,1,"PSOE",12
37,"37321",149,121,121,0,0,"PSOE",41
12,"12004",4177,3225,3187,13,38,"PSOE",885
16,"16190",4957,4006,3945,36,61,"PSOE",1281
24,"24191",108,89,89,0,0,"PSOE",27
40,"40139",258,207,202,0,5,"PSOE",64
21,"21068",962,562,550,14,12,"PSOE",274
46,"46012",929,727,707,3,20,"PSOE",194
9,"9380",73,53,53,0,0,"PSOE",12
37,"37133",101,84,80,0,4,"PSOE",22
10,"10199",159,123,123,1,0,"PSOE",33
37,"37359",163,122,117,0,5,"PSOE",24
46,"46043",135,119,116,1,3,"PSOE",20
29,"29042",14447,10383,10199,98,184,"PSOE",2697
47,"47158",858,672,663,8,9,"PSOE",302
31,"31055",263,199,197,3,2,"PSOE",18
46,"46104",1891,1515,1481,17,34,"PSOE",396
19,"19146",46,41,41,1,0,"PSOE",20
45,"45042",183,141,137,0,4,"PSOE",46
9,"9267",113,102,101,2,1,"PSOE",17
22,"22143",197,134,132,1,2,"PSOE",31
37,"37096",203,162,160,1,2,"PSOE",38
39,"39018",4272,3533,3476,17,57,"PSOE",1100
6,"6014",6535,4757,4679,36,78,"PSOE",1438
47,"47063",89,71,71,0,0,"PSOE",7
38,"38043",19265,14000,13856,115,144,"PSOE",3486
49,"49199",241,174,171,4,3,"PSOE",65
6,"6048",824,714,702,2,12,"PSOE",340
3,"3052",967,805,790,4,15,"PSOE",182
44,"44109",102,71,70,1,1,"PSOE",26
16,"16148",546,481,479,1,2,"PSOE",121
35,"35016",300503,203470,201240,1598,2230,"PSOE",59001
9,"9108",432,332,326,1,6,"PSOE",94
21,"21071",211,155,152,3,3,"PSOE",68
44,"44074",444,353,346,3,7,"PSOE",108
22,"22025",1035,764,755,24,9,"PSOE",243
31,"31260",1249,904,901,15,3,"PSOE",194
44,"44110",37,33,33,0,0,"PSOE",8
49,"49002",58,49,43,0,6,"PSOE",12
34,"34084",155,127,126,1,1,"PSOE",26
12,"12039",792,688,680,3,8,"PSOE",226
50,"50034",787,568,556,3,12,"PSOE",214
47,"47065",817,658,653,2,5,"PSOE",226
9,"9218",347,277,271,0,6,"PSOE",90
22,"22027",306,230,225,3,5,"PSOE",65
45,"45046",2369,1860,1832,5,28,"PSOE",772
19,"19283",32,26,26,0,0,"PSOE",14
37,"37137",99,65,65,0,0,"PSOE",5
16,"16023",507,401,398,2,3,"PSOE",140
24,"24116",390,283,279,1,4,"PSOE",85
40,"40108",110,91,90,0,1,"PSOE",22
31,"31018",422,317,312,4,5,"PSOE",85
9,"9437",270,227,224,2,3,"PSOE",66
4,"4046",848,653,649,5,4,"PSOE",265
19,"19151",1083,785,770,5,15,"PSOE",262
44,"44204",27,22,22,0,0,"PSOE",11
37,"37176",130,103,103,1,0,"PSOE",34
6,"6017",257,211,210,1,1,"PSOE",68
49,"49162",175,134,131,1,3,"PSOE",47
31,"31059",183,145,143,0,2,"PSOE",33
23,"23905",1840,1358,1341,9,17,"PSOE",545
42,"42041",31,23,23,1,0,"PSOE",4
31,"31141",107,76,74,0,2,"PSOE",5
31,"31019",1808,1392,1378,18,14,"PSOE",261
45,"45048",355,277,271,1,6,"PSOE",100
2,"2080",499,409,400,0,9,"PSOE",164
40,"40213",95,83,80,1,3,"PSOE",20
4,"4047",2230,1806,1785,8,21,"PSOE",682
42,"42131",52,37,37,0,0,"PSOE",12
5,"5216",213,166,165,0,1,"PSOE",29
45,"45003",550,435,431,4,4,"PSOE",138
45,"45187",3976,3365,3308,24,57,"PSOE",1343
44,"44206",103,83,82,0,1,"PSOE",17
9,"9274",1045,875,867,8,8,"PSOE",293
22,"22029",119,103,103,0,0,"PSOE",27
35,"35020",5933,4140,4088,14,52,"PSOE",1599
49,"49125",1401,1031,1010,7,21,"PSOE",337
31,"31061",48,46,46,0,0,"PSOE",12
21,"21039",299,226,223,7,3,"PSOE",123
42,"42132",135,114,113,1,1,"PSOE",23
30,"30031",500,435,433,3,2,"PSOE",88
24,"24002",233,183,183,1,0,"PSOE",65
19,"19198",17,17,17,0,0,"PSOE",7
6,"6020",1739,1420,1387,5,33,"PSOE",605
50,"50067",13788,10562,10413,107,149,"PSOE",3088
47,"47164",350,290,286,2,4,"PSOE",97
46,"46171",16429,12527,12373,61,154,"PSOE",3575
29,"29071",979,718,712,14,6,"PSOE",289
14,"14010",4001,3106,3068,15,38,"PSOE",1528
9,"9442",370,305,301,5,4,"PSOE",99
49,"49044",78,64,64,1,0,"PSOE",26
34,"34049",329,251,247,5,4,"PSOE",72
19,"19054",167,144,141,2,3,"PSOE",47
42,"42007",109,89,89,1,0,"PSOE",19
44,"44115",102,96,95,0,1,"PSOE",40
2,"2084",305,221,215,1,6,"PSOE",83
18,"18044",164,113,112,0,1,"PSOE",42
3,"3027",172,156,153,0,3,"PSOE",48
37,"37256",195,152,150,0,2,"PSOE",49
49,"49250",1194,954,939,8,15,"PSOE",264
6,"6022",2634,2156,2112,7,44,"PSOE",1000
37,"37369",125,95,93,0,2,"PSOE",33
37,"37180",68,39,39,1,0,"PSOE",16
14,"14011",572,498,495,5,3,"PSOE",236
41,"41010",4573,3407,3345,27,62,"PSOE",1178
2,"2012",1825,1541,1509,8,32,"PSOE",676
16,"16031",36,25,25,0,0,"PSOE",12
49,"49009",389,305,304,2,1,"PSOE",70
47,"47071",398,345,341,2,4,"PSOE",60
49,"49251",161,125,124,0,1,"PSOE",47
21,"21006",3329,2307,2262,20,45,"PSOE",1271
22,"22036",88,76,75,0,1,"PSOE",12
42,"42184",56,42,41,1,1,"PSOE",10
47,"47167",242,212,210,0,2,"PSOE",67
31,"31025",763,562,557,6,5,"PSOE",78
26,"26077",17,17,17,0,0,"PSOE",4
3,"3060",106,84,84,0,0,"PSOE",25
26,"26157",282,233,232,1,1,"PSOE",49
16,"16157",190,163,161,1,2,"PSOE",62
37,"37370",308,256,254,2,2,"PSOE",50
50,"50013",200,166,166,3,0,"PSOE",66
26,"26041",114,84,84,0,0,"PSOE",17
29,"29052",222,156,153,2,3,"PSOE",55
31,"31905",2968,2253,2236,21,17,"PSOE",733
46,"46083",15374,11259,11096,56,163,"PSOE",2516
10,"10091",350,293,291,1,2,"PSOE",92
46,"46144",628,511,505,1,6,"PSOE",124
19,"19293",1905,1513,1499,10,14,"PSOE",433
3,"3092",6688,5444,5370,36,74,"PSOE",1346
22,"22204",1119,836,832,9,4,"PSOE",196
5,"5221",323,249,244,1,5,"PSOE",85
12,"12014",167,131,127,1,4,"PSOE",53
34,"34143",157,125,120,1,5,"PSOE",33
47,"47074",141,122,122,2,0,"PSOE",55
19,"19204",149,112,112,1,0,"PSOE",54
9,"9283",44,33,33,0,0,"PSOE",7
22,"22245",306,266,263,0,3,"PSOE",66
9,"9447",43,40,40,0,0,"PSOE",12
46,"46084",1503,1225,1195,1,30,"PSOE",351
39,"39027",3066,2511,2467,15,44,"PSOE",534
40,"40220",62,48,48,0,0,"PSOE",10
34,"34146",53,47,46,0,1,"PSOE",16
49,"49172",481,316,310,2,6,"PSOE",63
12,"12048",249,181,175,2,6,"PSOE",66
4,"4092",2789,2207,2173,6,34,"PSOE",738
37,"37337",139,114,114,0,0,"PSOE",7
47,"47139",1004,790,776,2,14,"PSOE",276
31,"31191",3018,2365,2337,22,28,"PSOE",723
37,"37261",217,166,163,0,3,"PSOE",46
45,"45197",1894,1525,1499,6,26,"PSOE",621
14,"14015",2067,1575,1551,16,24,"PSOE",556
37,"37148",404,321,315,2,6,"PSOE",81
34,"34009",30,26,26,0,0,"PSOE",4
34,"34100",131,100,97,1,3,"PSOE",31
49,"49133",291,213,211,0,2,"PSOE",71
16,"16035",238,190,188,0,2,"PSOE",86
5,"5070",30,28,28,0,0,"PSOE",11
47,"47106",44,35,35,0,0,"PSOE",7
29,"29022",171,144,143,0,1,"PSOE",75
3,"3127",351,290,277,2,13,"PSOE",98
19,"19116",12,9,9,1,0,"PSOE",1
37,"37112",152,104,103,0,1,"PSOE",31
45,"45199",3107,2221,2184,8,37,"PSOE",567
21,"21011",3473,2543,2513,14,30,"PSOE",1290
35,"35027",10499,7651,7530,57,121,"PSOE",2134
49,"49014",116,89,88,2,1,"PSOE",30
49,"49258",110,93,92,0,1,"PSOE",30
10,"10217",521,436,432,0,4,"PSOE",163
22,"22207",121,78,78,1,0,"PSOE",28
23,"23016",384,316,311,0,5,"PSOE",175
37,"37114",78,64,59,0,5,"PSOE",9
3,"3096",5779,4433,4352,30,81,"PSOE",1315
6,"6128",4415,3345,3288,34,57,"PSOE",1405
41,"41071",5598,3993,3915,34,78,"PSOE",1776
16,"16212",230,198,196,2,2,"PSOE",81
40,"40155",3835,3165,3121,43,44,"PSOE",855
5,"5188",41,36,34,0,2,"PSOE",4
37,"37028",137,111,107,1,4,"PSOE",25
35,"35028",10044,6188,6105,52,83,"PSOE",1721
16,"16039",367,263,262,2,1,"PSOE",98
28,"28178",1134,949,935,1,14,"PSOE",229
9,"9294",102,86,85,0,1,"PSOE",38
41,"41016",7767,5937,5829,56,108,"PSOE",1854
49,"49136",312,227,220,3,7,"PSOE",33
34,"34206",814,668,660,13,8,"PSOE",270
19,"19118",10,10,10,1,0,"PSOE",7
26,"26165",337,289,284,0,5,"PSOE",98
9,"9455",43,37,36,0,1,"PSOE",8
31,"31237",186,151,149,1,2,"PSOE",39
9,"9297",313,268,267,6,1,"PSOE",31
5,"5189",396,325,321,1,4,"PSOE",110
31,"31155",241,181,180,3,1,"PSOE",85
44,"44122",1284,995,984,15,11,"PSOE",347
40,"40015",24,24,24,1,0,"PSOE",3
26,"26048",22,22,22,0,0,"PSOE",2
47,"47079",54,48,48,0,0,"PSOE",2
12,"12083",89,73,71,1,2,"PSOE",25
18,"18194",2045,1394,1370,11,24,"PSOE",661
9,"9353",76,64,63,2,1,"PSOE",13
9,"9189",126,102,96,0,6,"PSOE",30
22,"22170",668,529,520,4,9,"PSOE",143
6,"6902",1663,1273,1252,4,21,"PSOE",505
22,"22212",70,56,56,0,0,"PSOE",32
26,"26049",153,115,115,1,0,"PSOE",26
3,"3006",494,413,409,1,4,"PSOE",79
46,"46181",16908,12749,12597,82,152,"PSOE",3296
45,"45066",7770,6064,5962,21,102,"PSOE",1574
10,"10903",796,623,614,4,9,"PSOE",281
28,"28084",16103,12519,12378,82,141,"PSOE",3626
50,"50076",75,64,63,0,1,"PSOE",27
44,"44123",99,69,69,1,0,"PSOE",22
10,"10100",783,584,566,7,18,"PSOE",279
49,"49138",208,159,154,2,5,"PSOE",50
12,"12053",2030,1656,1636,10,20,"PSOE",524
49,"49019",228,170,164,0,6,"PSOE",59
18,"18054",838,649,648,8,1,"PSOE",205
37,"37380",56,46,45,1,1,"PSOE",13
31,"31198",37,32,32,0,0,"PSOE",3
31,"31077",5407,4148,4081,39,67,"PSOE",1365
11,"11036",687,457,447,7,10,"PSOE",223
22,"22047",241,213,212,2,1,"PSOE",45
42,"42020",4186,3027,2988,28,39,"PSOE",933
26,"26015",180,145,142,1,3,"PSOE",24
49,"49264",540,372,369,1,3,"PSOE",96
31,"31159",1105,880,871,3,9,"PSOE",123
34,"34019",110,92,91,2,1,"PSOE",19
19,"19217",42,38,38,0,0,"PSOE",12
50,"50168",27,20,20,0,0,"PSOE",9
31,"31119",36,26,25,0,1,"PSOE",3
28,"28044",6193,5040,4991,31,49,"PSOE",1205
40,"40018",75,60,60,0,0,"PSOE",7
34,"34020",51,38,38,0,0,"PSOE",15
46,"46153",435,364,356,1,8,"PSOE",107
37,"37233",56,46,46,2,0,"PSOE",18
47,"47209",34,25,25,0,0,"PSOE",4
9,"9358",248,186,179,1,7,"PSOE",34
50,"50197",96,78,78,1,0,"PSOE",19
44,"44056",457,352,341,4,11,"PSOE",93
31,"31161",345,286,279,4,7,"PSOE",59
39,"39035",9169,7135,7045,40,90,"PSOE",1784
45,"45070",1406,1201,1188,4,13,"PSOE",415
31,"31039",92,72,70,1,2,"PSOE",17
5,"5195",206,157,157,0,0,"PSOE",43
11,"11001",4342,2928,2870,32,58,"PSOE",1439
28,"28183",1124,857,842,4,15,"PSOE",209
37,"37159",79,68,68,0,0,"PSOE",19
46,"46093",2134,1700,1687,8,13,"PSOE",466
46,"46215",1397,1104,1093,12,11,"PSOE",337
11,"11039",9945,6824,6726,111,98,"PSOE",2442
26,"26054",292,235,231,2,4,"PSOE",87
44,"44127",57,45,45,0,0,"PSOE",16
34,"34023",5098,4016,3973,48,43,"PSOE",1445
19,"19219",9,7,7,0,0,"PSOE",5
21,"21020",353,242,236,3,6,"PSOE",118
18,"18059",4253,3166,3123,22,43,"PSOE",1375
50,"50255",197,162,160,2,2,"PSOE",107
37,"37271",351,286,280,0,6,"PSOE",87
16,"16046",223,162,161,1,1,"PSOE",55
13,"13001",1195,947,943,5,4,"PSOE",475
12,"12058",64,56,56,0,0,"PSOE",4
21,"21021",12469,8238,8097,76,141,"PSOE",2356
19,"19080",65,51,51,0,0,"PSOE",12
47,"47084",1101,880,871,7,9,"PSOE",315
35,"35034",8396,4599,4546,55,53,"PSOE",1156
50,"50081",491,390,384,5,6,"PSOE",141
40,"40233",396,323,320,2,3,"PSOE",86
49,"49146",274,213,209,1,4,"PSOE",83
6,"6037",1668,1137,1125,6,12,"PSOE",467
46,"46095",578,467,458,1,9,"PSOE",109
49,"49185",156,126,120,1,6,"PSOE",25
34,"34024",25,17,16,1,1,"PSOE",2
40,"40234",376,307,299,2,8,"PSOE",90
16,"16174",168,143,141,1,2,"PSOE",62
33,"33002",9474,6779,6662,74,117,"PSOE",2641
18,"18165",4251,3113,3073,20,40,"PSOE",1162
34,"34069",2184,1737,1701,16,36,"PSOE",685
29,"29034",467,374,373,1,1,"PSOE",90
12,"12059",228,191,188,0,3,"PSOE",70
11,"11005",4520,3212,3128,23,84,"PSOE",1491
12,"12091",176,131,130,0,1,"PSOE",35
22,"22131",83,65,65,0,0,"PSOE",28
5,"5238",739,589,586,1,3,"PSOE",180
41,"41080",1240,940,913,11,27,"PSOE",419
18,"18062",11041,8531,8355,71,176,"PSOE",2484
13,"13096",7533,5766,5696,43,70,"PSOE",2018
5,"5199",37,31,31,0,0,"PSOE",1
12,"12060",430,368,365,1,3,"PSOE",108
5,"5083",141,104,103,2,1,"PSOE",23
34,"34167",110,88,88,0,0,"PSOE",20
50,"50258",53,33,33,3,0,"PSOE",5
19,"19224",102,91,90,1,1,"PSOE",9
21,"21024",466,355,341,4,14,"PSOE",172
42,"42205",85,64,62,0,2,"PSOE",18
24,"24064",1515,1159,1141,11,18,"PSOE",479
39,"39039",546,431,428,0,3,"PSOE",99
3,"3138",3183,2390,2359,16,31,"PSOE",616
41,"41052",3027,2357,2288,14,69,"PSOE",1127
26,"26098",99,77,77,1,0,"PSOE",15
46,"46261",1709,1367,1340,14,27,"PSOE",421
50,"50259",84,58,58,0,0,"PSOE",13
41,"41098",5152,4046,3986,24,60,"PSOE",1436
50,"50287",252,200,196,7,4,"PSOE",68
18,"18908",784,599,581,0,18,"PSOE",235
42,"42069",1491,1073,1048,20,25,"PSOE",375
26,"26177",301,250,246,2,4,"PSOE",82
28,"28092",153428,121511,120211,807,1300,"PSOE",37345
16,"16051",126,102,100,0,2,"PSOE",42
44,"44131",27,22,22,0,0,"PSOE",10
9,"9148",79,63,63,5,0,"PSOE",23
26,"26060",75,60,60,1,0,"PSOE",12
9,"9314",92,75,74,1,1,"PSOE",31
9,"9423",28,26,26,0,0,"PSOE",3
31,"31047",236,181,179,5,2,"PSOE",52
21,"21026",253,189,183,1,6,"PSOE",78
26,"26178",71,57,56,1,1,"PSOE",26
12,"12063",44,37,37,1,0,"PSOE",11
16,"16052",537,429,429,2,0,"PSOE",164
29,"29093",2164,1704,1678,4,26,"PSOE",834
19,"19038",22,19,19,0,0,"PSOE",2
6,"6075",475,379,369,2,10,"PSOE",240
4,"4073",336,243,243,0,0,"PSOE",85
44,"44226",124,87,83,2,4,"PSOE",31
9,"9315",393,291,286,4,5,"PSOE",67
46,"46221",345,294,294,0,0,"PSOE",78
13,"13055",615,475,465,5,10,"PSOE",225
9,"9208",179,130,127,1,3,"PSOE",24
5,"5167",225,181,175,1,6,"PSOE",88
3,"3110",312,271,269,1,2,"PSOE",52
24,"24150",224,176,174,2,2,"PSOE",37
19,"19229",57,52,52,0,0,"PSOE",17
29,"29005",4499,3202,3171,37,31,"PSOE",998
46,"46191",1949,1541,1505,7,36,"PSOE",451
46,"46902",356,300,296,8,4,"PSOE",132
38,"38008",5658,4126,4056,19,70,"PSOE",1165
5,"5206",29,21,20,1,1,"PSOE",10
6,"6043",686,553,544,6,9,"PSOE",216
11,"11011",1736,1285,1249,7,36,"PSOE",427
24,"24028",365,297,290,2,7,"PSOE",112
37,"37168",407,305,300,0,5,"PSOE",106
9,"9152",248,197,195,0,2,"PSOE",57
18,"18174",434,362,357,0,5,"PSOE",180
47,"47060",231,198,195,4,3,"PSOE",59
42,"42211",81,74,73,2,1,"PSOE",12
50,"50087",29,18,18,0,0,"PSOE",3
9,"9211",1362,1065,1050,16,15,"PSOE",284
46,"46223",7781,6057,5995,42,62,"PSOE",1637
9,"9317",19,19,19,1,0,"PSOE",4
44,"44037",449,334,331,1,3,"PSOE",88
19,"19231",10,7,7,0,0,"PSOE",1
42,"42076",201,157,151,0,6,"PSOE",40
24,"24030",4201,3080,3024,25,56,"PSOE",1110
14,"14032",393,328,321,2,7,"PSOE",141
5,"5208",38,31,31,0,0,"PSOE",8
50,"50263",176,119,116,0,3,"PSOE",65
50,"50178",276,193,193,4,0,"PSOE",96
33,"33070",3293,2499,2473,32,26,"PSOE",911
37,"37047",228,93,92,1,1,"PSOE",29
40,"40031",540,429,424,6,5,"PSOE",114
4,"4077",302,275,275,1,0,"PSOE",69
44,"44136",51,43,43,1,0,"PSOE",13
5,"5092",146,118,116,0,2,"PSOE",22
31,"31174",107,70,70,0,0,"PSOE",13
46,"46103",1338,1056,1042,5,14,"PSOE",271
18,"18175",11786,8883,8730,58,153,"PSOE",3283
37,"37207",325,260,258,1,2,"PSOE",32
34,"34036",238,199,198,1,1,"PSOE",79
9,"9052",29,17,17,1,0,"PSOE",0
45,"45087",8198,6375,6281,36,94,"PSOE",1736
3,"3904",1420,1112,1095,5,17,"PSOE",412
19,"19190",2302,1788,1767,13,21,"PSOE",682
28,"28025",404,314,305,3,9,"PSOE",65
29,"29008",15183,10716,10555,93,161,"PSOE",2977
44,"44230",152,112,111,1,1,"PSOE",50
31,"31135",112,76,75,2,1,"PSOE",17
10,"10200",341,262,261,0,1,"PSOE",116
24,"24073",442,328,324,2,4,"PSOE",104
50,"50062",1863,1441,1416,9,25,"PSOE",455
18,"18036",3970,3197,3149,26,48,"PSOE",791
19,"19045",127,107,107,1,0,"PSOE",17
10,"10119",574,458,455,0,3,"PSOE",206
5,"5094",132,109,108,1,1,"PSOE",5
49,"49157",192,153,149,0,4,"PSOE",48
50,"50151",603,490,489,3,1,"PSOE",222
26,"26067",20,19,19,0,0,"PSOE",4
16,"16191",858,707,701,8,6,"PSOE",258
5,"5211",430,364,357,6,7,"PSOE",74
31,"31177",251,172,168,1,4,"PSOE",38
33,"33011",10659,6448,6332,119,116,"PSOE",1901
16,"16245",400,329,318,0,11,"PSOE",87
41,"41004",57465,41004,40321,571,683,"PSOE",14127
50,"50090",134,108,108,0,0,"PSOE",17
28,"28100",4409,3425,3382,20,43,"PSOE",732
37,"37285",366,273,272,1,1,"PSOE",82
10,"10121",7914,5924,5809,36,115,"PSOE",2209
37,"37136",633,448,434,8,14,"PSOE",162
19,"19330",67,60,60,0,0,"PSOE",29
46,"46197",1926,1473,1455,9,18,"PSOE",376
39,"39047",1976,1564,1538,8,26,"PSOE",263
13,"13019",5095,3758,3717,25,41,"PSOE",1179
45,"45090",368,287,286,1,1,"PSOE",115
41,"41089",6629,4904,4814,48,90,"PSOE",2002
12,"12071",1267,1021,1006,11,15,"PSOE",324
46,"46106",1466,1156,1142,3,14,"PSOE",361
18,"18071",5612,4271,4184,29,87,"PSOE",1498
46,"46076",591,497,487,0,10,"PSOE",175
28,"28059",4515,3573,3542,12,31,"PSOE",897
45,"45137",1567,1155,1139,11,16,"PSOE",476
31,"31017",370,288,286,3,2,"PSOE",35
34,"34041",84,73,72,3,1,"PSOE",14
23,"23039",2154,1644,1605,6,39,"PSOE",764
10,"10123",575,470,465,2,5,"PSOE",256
6,"6050",4042,3246,3163,27,83,"PSOE",1142
37,"37055",118,96,95,0,1,"PSOE",20
18,"18072",664,481,473,0,8,"PSOE",218
41,"41090",3507,2766,2694,15,72,"PSOE",1196
47,"47192",94,82,81,2,1,"PSOE",23
44,"44042",114,84,84,0,0,"PSOE",29
37,"37364",757,549,536,7,13,"PSOE",171
39,"39048",1765,1429,1420,4,9,"PSOE",266
45,"45047",2668,1922,1882,11,40,"PSOE",367
46,"46047",532,447,441,4,6,"PSOE",155
9,"9012",92,76,75,0,1,"PSOE",22
34,"34045",73,67,65,0,2,"PSOE",15
22,"22066",748,576,567,6,9,"PSOE",174
40,"40037",34,19,19,0,0,"PSOE",6
37,"37056",40,33,33,0,0,"PSOE",1
18,"18074",264,207,205,0,2,"PSOE",96
49,"49163",215,151,148,1,3,"PSOE",34
22,"22197",439,356,353,10,3,"PSOE",135
37,"37289",218,159,158,0,1,"PSOE",35
47,"47193",1609,1347,1332,9,15,"PSOE",377
24,"24160",645,481,475,1,6,"PSOE",125
24,"24118",104,66,66,0,0,"PSOE",36
47,"47098",556,480,475,4,5,"PSOE",116
47,"47006",186,153,149,1,4,"PSOE",41
39,"39050",255,188,184,2,4,"PSOE",36
19,"19106",76,57,57,0,0,"PSOE",22
16,"16067",119,96,93,2,3,"PSOE",23
46,"46018",567,483,479,3,4,"PSOE",167
18,"18181",202,150,148,0,2,"PSOE",31
47,"47068",30,23,23,0,0,"PSOE",5
45,"45004",552,434,434,4,0,"PSOE",156
37,"37254",175,141,140,1,1,"PSOE",42
4,"4049",5603,4104,4054,27,50,"PSOE",1461
46,"46201",62,47,47,0,0,"PSOE",32
50,"50185",136,103,102,0,1,"PSOE",21
44,"44237",368,299,293,2,6,"PSOE",111
47,"47195",430,335,320,2,15,"PSOE",100
49,"49165",55,53,50,0,3,"PSOE",11
22,"22068",65,46,44,1,2,"PSOE",16
47,"47100",119,104,102,2,2,"PSOE",39
50,"50010",66,56,55,2,1,"PSOE",5
9,"9335",87,71,71,0,0,"PSOE",24
39,"39051",73,65,64,0,1,"PSOE",6
12,"12075",107,89,87,0,2,"PSOE",33
6,"6054",5454,4329,4190,46,139,"PSOE",1543
33,"33078",126,87,85,0,2,"PSOE",40
45,"45098",2110,1675,1652,6,23,"PSOE",293
23,"23043",518,398,397,0,1,"PSOE",169
9,"9337",114,93,93,0,0,"PSOE",30
19,"19288",22,21,21,1,0,"PSOE",6
50,"50128",27,24,24,0,0,"PSOE",8
33,"33018",2819,2072,2044,28,28,"PSOE",665
22,"22069",418,337,334,5,3,"PSOE",95
6,"6154",2799,2075,2022,15,53,"PSOE",908
37,"37292",94,76,73,1,3,"PSOE",11
38,"38019",13758,8870,8776,46,94,"PSOE",3390
45,"45054",3831,2980,2944,11,36,"PSOE",933
4,"4088",2435,1708,1693,6,15,"PSOE",706
29,"29017",6428,4943,4871,32,72,"PSOE",2276
46,"46203",3544,2851,2810,21,41,"PSOE",860
46,"46112",542,460,454,0,6,"PSOE",140
40,"40041",967,773,764,9,9,"PSOE",212
22,"22202",145,127,126,0,1,"PSOE",47
40,"40077",932,747,730,9,17,"PSOE",175
9,"9174",781,625,608,3,17,"PSOE",186
28,"28109",1622,1205,1192,3,13,"PSOE",219
5,"5220",363,312,308,5,4,"PSOE",61
4,"4089",694,516,510,1,6,"PSOE",175
2,"2013",135,113,110,0,3,"PSOE",35
41,"41011",15454,11892,11591,160,301,"PSOE",5956
31,"31066",812,636,628,10,8,"PSOE",220
21,"21043",1857,1465,1424,7,41,"PSOE",819
46,"46204",6657,5262,5204,27,58,"PSOE",1713
50,"50098",162,121,120,3,1,"PSOE",49
45,"45056",2300,1526,1501,8,25,"PSOE",450
47,"47198",66,47,47,0,0,"PSOE",10
11,"11026",4695,3656,3564,18,92,"PSOE",1211
9,"9340",76,56,56,1,0,"PSOE",10
19,"19058",7375,6122,6061,34,61,"PSOE",1724
39,"39054",4528,3614,3575,23,39,"PSOE",958
9,"9281",135,104,102,1,2,"PSOE",28
19,"19203",29,25,25,0,0,"PSOE",11
19,"19248",76,56,56,0,0,"PSOE",18
12,"12078",333,238,235,1,3,"PSOE",61
24,"24046",899,678,663,7,15,"PSOE",267
9,"9022",61,54,54,0,0,"PSOE",8
2,"2051",1665,1253,1222,6,31,"PSOE",306
24,"24007",753,569,563,4,6,"PSOE",243
10,"10132",365,276,271,2,5,"PSOE",153
9,"9177",1127,883,877,6,6,"PSOE",184
37,"37297",401,319,315,2,4,"PSOE",95
31,"31068",2816,2194,2136,17,58,"PSOE",875
39,"39055",1075,836,829,8,7,"PSOE",155
44,"44149",100,74,73,0,1,"PSOE",32
42,"42144",423,338,336,4,2,"PSOE",112
4,"4055",366,315,314,3,1,"PSOE",158
26,"26080",453,385,383,2,2,"PSOE",90
46,"46085",11075,8106,8011,54,95,"PSOE",2246
40,"40046",82,69,69,1,0,"PSOE",28
9,"9346",89,69,68,1,1,"PSOE",14
3,"3032",99,87,87,0,0,"PSOE",17
28,"28112",154,137,137,1,0,"PSOE",46
37,"37298",172,126,125,0,1,"PSOE",33
31,"31030",135,105,105,3,0,"PSOE",19
46,"46116",13608,10792,10731,76,61,"PSOE",2661
31,"31070",2628,1930,1881,16,49,"PSOE",633
37,"37067",3254,2742,2714,29,28,"PSOE",798
45,"45198",1790,1488,1464,5,24,"PSOE",520
37,"37026",175,148,148,2,0,"PSOE",48
24,"24090",326,213,213,2,0,"PSOE",57
13,"13080",321,246,246,1,0,"PSOE",105
4,"4057",1260,970,953,10,17,"PSOE",348
21,"21047",1869,1242,1206,8,36,"PSOE",546
47,"47203",58,48,48,0,0,"PSOE",6
6,"6060",5723,4401,4323,31,78,"PSOE",1877
5,"5226",65,52,52,0,0,"PSOE",4
22,"22206",182,145,145,0,0,"PSOE",63
44,"44151",182,139,138,1,1,"PSOE",61
34,"34057",462,345,330,3,15,"PSOE",94
40,"40048",35,29,29,0,0,"PSOE",13
47,"47015",176,136,135,0,1,"PSOE",48
49,"49015",201,157,155,0,2,"PSOE",56
4,"4094",209,156,154,0,2,"PSOE",25
3,"3128",4295,3007,2982,24,25,"PSOE",636
49,"49055",95,83,83,1,0,"PSOE",22
9,"9129",89,75,75,0,0,"PSOE",39
46,"46057",474,319,313,1,6,"PSOE",65
39,"39058",800,574,573,1,1,"PSOE",203
45,"45154",1479,1163,1149,5,14,"PSOE",325
16,"16082",271,207,206,3,1,"PSOE",93
44,"44152",67,48,48,2,0,"PSOE",3
11,"11032",54469,33144,32810,461,334,"PSOE",10741
9,"9183",47,41,41,0,0,"PSOE",10
5,"5073",289,239,238,0,1,"PSOE",47
45,"45109",2786,2273,2206,9,67,"PSOE",676
44,"44023",18,14,14,0,0,"PSOE",2
46,"46088",150,129,127,0,2,"PSOE",39
28,"28040",16648,11709,11551,66,158,"PSOE",3321
38,"38027",5545,3937,3896,22,41,"PSOE",931
47,"47173",885,708,704,7,4,"PSOE",282
5,"5229",82,67,67,1,0,"PSOE",9
40,"40049",40,30,29,0,1,"PSOE",7
50,"50278",177,137,137,2,0,"PSOE",37
46,"46210",344,265,258,2,7,"PSOE",79
24,"24054",417,318,311,0,7,"PSOE",62
37,"37190",193,144,144,1,0,"PSOE",31
31,"31075",118,96,95,2,1,"PSOE",8
49,"49176",610,426,426,4,0,"PSOE",73
40,"40157",43,33,33,2,0,"PSOE",9
9,"9184",7,5,5,0,0,"PSOE",0
28,"28041",4788,4012,3973,23,39,"PSOE",846
50,"50019",64,48,47,0,1,"PSOE",14
5,"5114",1264,1061,1030,3,31,"PSOE",429
19,"19303",40,35,35,0,0,"PSOE",7
10,"10140",1082,868,855,8,13,"PSOE",310
40,"40192",133,104,102,2,2,"PSOE",29
28,"28117",98,89,87,2,2,"PSOE",18
5,"5230",65,58,58,4,0,"PSOE",4
22,"22081",243,187,186,0,1,"PSOE",38
37,"37073",620,481,471,6,10,"PSOE",119
19,"19121",264,219,217,0,2,"PSOE",90
50,"50280",301,246,240,1,6,"PSOE",97
4,"4098",1455,1097,1087,9,10,"PSOE",442
19,"19258",84,69,66,1,3,"PSOE",14
37,"37192",355,234,227,5,7,"PSOE",59
5,"5116",96,77,75,0,2,"PSOE",9
29,"29028",1224,875,858,4,17,"PSOE",390
22,"22213",2923,2261,2221,24,40,"PSOE",800
41,"41075",10279,7543,7370,96,173,"PSOE",2610
9,"9460",167,149,149,5,0,"PSOE",32
28,"28043",6166,4404,4320,30,84,"PSOE",1198
46,"46091",115,99,99,0,0,"PSOE",11
49,"49141",296,220,218,0,2,"PSOE",81
50,"50048",33,25,25,0,0,"PSOE",17
9,"9191",33,24,24,0,0,"PSOE",6
37,"37193",365,277,276,3,1,"PSOE",109
34,"34213",52,42,42,0,0,"PSOE",10
5,"5117",193,169,167,0,2,"PSOE",32
9,"9192",55,48,47,2,1,"PSOE",12
16,"16274",103,86,85,0,1,"PSOE",45
31,"31200",748,555,546,5,9,"PSOE",182
50,"50021",25,23,23,1,0,"PSOE",1
41,"41093",19012,15637,15525,97,112,"PSOE",3921
31,"31201",151084,115375,114510,1072,865,"PSOE",27079
31,"31242",264,194,194,2,0,"PSOE",24
47,"47051",321,274,272,1,2,"PSOE",65
5,"5158",345,279,274,2,5,"PSOE",65
23,"23088",6020,4779,4703,56,76,"PSOE",2048
24,"24221",750,563,553,6,10,"PSOE",145
30,"30013",7467,5621,5553,26,68,"PSOE",2387
50,"50109",98,69,67,3,2,"PSOE",13
37,"37078",788,670,658,6,12,"PSOE",201
38,"38031",29154,22871,22598,143,273,"PSOE",6748
28,"28120",1209,991,974,3,17,"PSOE",297
9,"9360",25,22,22,0,0,"PSOE",6
18,"18094",2304,1845,1798,16,47,"PSOE",648
3,"3040",258,223,217,1,6,"PSOE",35
18,"18057",5540,4306,4246,30,60,"PSOE",1226
40,"40127",35,28,28,0,0,"PSOE",6
28,"28121",205,166,165,1,1,"PSOE",59
31,"31203",30,22,22,1,0,"PSOE",8
5,"5235",139,106,101,0,5,"PSOE",32
9,"9037",106,97,97,0,0,"PSOE",46
37,"37079",80,69,68,2,1,"PSOE",11
16,"16091",64,46,46,1,0,"PSOE",28
16,"16225",59,40,40,0,0,"PSOE",15
18,"18904",743,555,545,1,10,"PSOE",231
3,"3135",192,157,155,0,2,"PSOE",68
45,"45118",2088,1562,1540,11,22,"PSOE",454
31,"31245",77,60,59,4,1,"PSOE",4
50,"50110",336,268,266,1,2,"PSOE",109
31,"31082",623,433,433,3,0,"PSOE",60
47,"47022",59,56,54,1,2,"PSOE",6
44,"44256",34,32,32,1,0,"PSOE",6
28,"28047",42847,33561,33215,216,346,"PSOE",8969
14,"14055",18446,13919,13711,148,208,"PSOE",4504
28,"28122",570,457,448,3,9,"PSOE",110
13,"13048",506,388,384,3,4,"PSOE",155
24,"24180",1101,844,833,8,11,"PSOE",189
19,"19178",30,15,15,0,0,"PSOE",5
50,"50111",183,144,142,2,2,"PSOE",39
45,"45028",3628,2916,2863,16,53,"PSOE",1207
21,"21058",2556,1732,1709,21,23,"PSOE",1081
6,"6070",7686,6083,5948,44,135,"PSOE",2649
2,"2028",118,99,98,4,1,"PSOE",55
31,"31003",117,97,97,1,0,"PSOE",22
46,"46096",257,220,217,0,3,"PSOE",75
46,"46187",1304,991,982,8,9,"PSOE",280
24,"24182",411,302,295,4,7,"PSOE",79
24,"24062",130,90,90,2,0,"PSOE",32
37,"37199",129,97,97,0,0,"PSOE",36
37,"37125",227,171,169,0,2,"PSOE",48
42,"42113",521,382,380,3,2,"PSOE",84
50,"50903",2238,1750,1732,11,18,"PSOE",494
44,"44223",73,58,58,0,0,"PSOE",15
44,"44160",440,311,306,2,5,"PSOE",74
16,"16231",50,40,40,0,0,"PSOE",8
19,"19132",93,72,72,0,0,"PSOE",18
47,"47024",232,189,188,0,1,"PSOE",70
44,"44161",430,320,316,1,4,"PSOE",113
46,"46036",558,391,379,2,12,"PSOE",77
9,"9199",94,72,70,0,2,"PSOE",14
5,"5239",231,177,174,1,3,"PSOE",36
6,"6039",1807,1506,1474,13,32,"PSOE",950
10,"10028",82,60,59,0,1,"PSOE",37
31,"31005",281,202,201,5,1,"PSOE",59
42,"42068",78,62,61,2,1,"PSOE",10
44,"44194",104,80,80,1,0,"PSOE",21
9,"9366",75,60,60,2,0,"PSOE",12
14,"14058",7859,5854,5745,51,109,"PSOE",2167
47,"47215",48,44,44,0,0,"PSOE",8
19,"19268",43,42,42,0,0,"PSOE",15
42,"42206",8,4,4,0,0,"PSOE",0
37,"37201",237,188,187,1,1,"PSOE",53
29,"29035",1505,1151,1133,6,18,"PSOE",593
47,"47121",521,429,422,5,7,"PSOE",191
5,"5125",56,47,43,0,4,"PSOE",10
28,"28050",4367,3411,3384,14,27,"PSOE",718
10,"10152",446,354,350,2,4,"PSOE",165
42,"42117",133,109,106,0,3,"PSOE",18
46,"46129",512,408,400,4,8,"PSOE",135
44,"44225",103,82,81,0,1,"PSOE",33
13,"13054",4914,3946,3890,31,56,"PSOE",1171
18,"18099",1581,1279,1245,5,34,"PSOE",440
12,"12093",165,128,126,0,2,"PSOE",35
31,"31088",5675,4331,4285,59,46,"PSOE",1157
47,"47027",2775,2246,2222,14,24,"PSOE",696
23,"23062",1418,1206,1190,5,16,"PSOE",592
21,"21027",50,40,39,0,1,"PSOE",14
19,"19184",62,45,45,0,0,"PSOE",8
42,"42118",21,13,13,1,0,"PSOE",1
18,"18100",7981,5900,5769,44,131,"PSOE",2531
10,"10153",283,204,199,0,5,"PSOE",58
34,"34032",37,34,34,1,0,"PSOE",5
9,"9151",445,358,354,3,4,"PSOE",138
44,"44132",58,47,47,0,0,"PSOE",17
13,"13009",1397,1145,1123,4,22,"PSOE",315
40,"40099",52,46,44,0,2,"PSOE",10
50,"50204",2394,1876,1855,21,21,"PSOE",909
40,"40062",57,49,49,0,0,"PSOE",9
2,"2034",1324,1088,1083,10,5,"PSOE",436
34,"34225",5001,4070,4021,48,49,"PSOE",1419
14,"14061",688,567,556,2,11,"PSOE",296
5,"5005",171,142,142,2,0,"PSOE",27
22,"22095",65,57,56,1,1,"PSOE",23
21,"21065",255,178,173,2,5,"PSOE",52
46,"46131",49504,37495,37064,259,431,"PSOE",9962
50,"50117",125,100,100,3,0,"PSOE",37
9,"9374",90,79,78,1,1,"PSOE",13
31,"31091",327,224,224,1,0,"PSOE",30
19,"19139",26,20,20,1,0,"PSOE",8
3,"3111",5565,4183,4149,29,34,"PSOE",1145
47,"47218",979,757,745,5,12,"PSOE",236
35,"35013",6584,5067,4974,49,93,"PSOE",1272
22,"22139",78,60,60,0,0,"PSOE",6
24,"24189",5816,4434,4382,49,52,"PSOE",1073
50,"50290",358,272,266,6,6,"PSOE",102
34,"34079",1715,1421,1402,10,19,"PSOE",380
2,"2036",95,75,75,0,0,"PSOE",26
26,"26103",827,655,645,3,10,"PSOE",197
37,"37320",88,67,67,1,0,"PSOE",15
13,"13059",196,169,168,0,1,"PSOE",64
34,"34080",5291,3802,3728,35,74,"PSOE",1189
33,"33039",1641,1251,1243,6,8,"PSOE",504
39,"39044",3868,3019,2985,8,34,"PSOE",713
19,"19277",16,13,13,0,0,"PSOE",5
50,"50119",872,684,680,4,4,"PSOE",229
40,"40065",469,376,373,1,3,"PSOE",84
9,"9051",163,134,133,1,1,"PSOE",24
22,"22099",465,365,362,3,3,"PSOE",151
13,"13060",272,219,214,4,5,"PSOE",81
23,"23066",4299,3603,3545,13,58,"PSOE",1430
30,"30024",60183,45738,45317,290,421,"PSOE",12645
50,"50003",119,95,95,1,0,"PSOE",37
5,"5246",52,39,39,0,0,"PSOE",14
49,"49156",230,189,182,0,7,"PSOE",61
16,"16102",1163,951,943,16,8,"PSOE",263
13,"13015",5226,4010,3959,20,51,"PSOE",1547
44,"44039",202,166,165,3,1,"PSOE",35
26,"26105",2211,1744,1723,19,21,"PSOE",575
34,"34230",17,13,13,0,0,"PSOE",1
33,"33040",4566,3205,3150,50,55,"PSOE",1144
26,"26145",237,207,204,0,3,"PSOE",45
44,"44265",181,153,148,1,5,"PSOE",31
35,"35015",10728,6233,6108,54,125,"PSOE",1829
44,"44108",300,228,224,5,4,"PSOE",70
9,"9007",55,37,37,0,0,"PSOE",6
45,"45088",2332,1724,1695,16,29,"PSOE",498
31,"31217",334,233,225,3,8,"PSOE",54
37,"37323",476,380,377,7,3,"PSOE",88
41,"41902",4600,3141,3092,48,49,"PSOE",1586
22,"22189",178,143,143,0,0,"PSOE",67
40,"40069",74,65,65,0,0,"PSOE",15
42,"42125",75,62,62,2,0,"PSOE",23
10,"10038",83,70,69,0,1,"PSOE",24
28,"28132",12068,9067,8954,63,113,"PSOE",2808
13,"13063",3652,2692,2649,32,43,"PSOE",907
5,"5095",236,193,191,0,2,"PSOE",58
47,"47222",86,71,71,0,0,"PSOE",20
50,"50294",64,49,47,0,2,"PSOE",15
41,"41903",6769,5018,4919,73,99,"PSOE",2059
34,"34083",1664,1244,1229,10,15,"PSOE",329
23,"23069",5262,4395,4329,15,66,"PSOE",1779
44,"44041",58,48,44,1,4,"PSOE",15
16,"16192",43,30,29,0,1,"PSOE",19
19,"19148",42,35,33,0,2,"PSOE",8
31,"31220",742,620,615,2,5,"PSOE",213
31,"31097",10521,7602,7550,76,52,"PSOE",1771
2,"2041",321,253,251,3,2,"PSOE",76
18,"18107",924,694,680,3,14,"PSOE",372
6,"6082",393,314,305,5,9,"PSOE",131
34,"34232",735,595,584,8,11,"PSOE",199
19,"19282",143,114,114,1,0,"PSOE",16
33,"33043",658,462,455,4,7,"PSOE",217
18,"18039",3382,2517,2490,20,27,"PSOE",1056
45,"45184",201,133,132,0,1,"PSOE",74
11,"11018",1446,1126,1100,6,26,"PSOE",471
10,"10041",1025,840,825,6,15,"PSOE",335
49,"49202",172,125,124,2,1,"PSOE",48
44,"44075",326,275,263,0,12,"PSOE",71
33,"33044",177352,134444,133352,1391,1092,"PSOE",36448
44,"44268",32,30,30,0,0,"PSOE",12
34,"34086",99,92,90,2,2,"PSOE",22
10,"10163",339,275,269,0,6,"PSOE",114
9,"9059",136704,109424,108039,1134,1385,"PSOE",31469
38,"38045",3549,2149,2109,6,40,"PSOE",714
16,"16064",651,575,569,4,6,"PSOE",198
50,"50124",399,316,316,3,0,"PSOE",68
16,"16195",458,368,364,3,4,"PSOE",171
6,"6117",1401,1089,1067,6,22,"PSOE",432
47,"47225",74,61,60,0,1,"PSOE",9
49,"49203",287,229,223,2,6,"PSOE",57
47,"47036",205,162,157,1,5,"PSOE",40
14,"14068",516,405,400,1,5,"PSOE",207
41,"41034",23480,16510,16250,230,260,"PSOE",6868
50,"50296",382,288,272,1,16,"PSOE",128
37,"37214",116,87,87,4,0,"PSOE",21
31,"31101",1412,1097,1087,11,10,"PSOE",163
34,"34237",573,479,472,4,7,"PSOE",121
44,"44076",2110,1725,1691,22,34,"PSOE",682
39,"39077",236,175,173,0,2,"PSOE",42
49,"49041",414,309,307,4,2,"PSOE",133
24,"24201",1039,775,765,5,10,"PSOE",264
23,"23072",1885,1485,1468,5,17,"PSOE",648
14,"14069",7376,5511,5398,47,113,"PSOE",2702
30,"30030",320172,249965,247884,1497,2081,"PSOE",55821
10,"10166",313,211,202,0,9,"PSOE",57
37,"37101",142,119,117,0,2,"PSOE",23
28,"28031",2140,1642,1614,11,28,"PSOE",553
5,"5178",345,287,283,1,4,"PSOE",60
2,"2009",19456,15229,15007,152,222,"PSOE",5370
33,"33016",18904,14376,14235,168,141,"PSOE",4230
46,"46140",377,312,312,2,0,"PSOE",67
37,"37330",318,255,248,2,7,"PSOE",76
39,"39079",8861,6827,6745,47,82,"PSOE",1806
23,"23073",4389,3400,3363,13,37,"PSOE",1539
28,"28138",63,49,49,0,0,"PSOE",7
41,"41036",3917,2944,2885,27,59,"PSOE",1121
28,"28063",254,203,202,2,1,"PSOE",51
29,"29049",2926,2197,2165,9,32,"PSOE",1077
16,"16253",308,250,249,2,1,"PSOE",60
31,"31104",1751,1306,1280,1,26,"PSOE",487
9,"9173",129,102,102,0,0,"PSOE",21
2,"2010",1798,1494,1469,6,25,"PSOE",558
47,"47039",166,134,134,0,0,"PSOE",55
16,"16112",1468,1108,1096,6,12,"PSOE",438
24,"24082",860,690,678,12,12,"PSOE",243
34,"34137",24,23,22,2,1,"PSOE",11
42,"42182",51,42,42,1,0,"PSOE",5
26,"26114",74,62,60,0,2,"PSOE",26
26,"26115",23,21,19,0,2,"PSOE",2
37,"37332",70,53,53,0,0,"PSOE",13
34,"34241",18,17,14,4,3,"PSOE",0
21,"21078",2646,1926,1895,14,31,"PSOE",904
47,"47196",28,24,24,0,0,"PSOE",0
26,"26155",149,119,119,0,0,"PSOE",51
47,"47135",82,69,67,1,2,"PSOE",20
9,"9066",54,41,40,1,1,"PSOE",21
45,"45145",2613,1950,1921,13,29,"PSOE",486
34,"34093",81,70,70,0,0,"PSOE",5
23,"23075",3220,2559,2524,18,35,"PSOE",1212
37,"37021",69,52,51,1,1,"PSOE",12
16,"16255",136,108,108,0,0,"PSOE",48
19,"19290",851,581,577,5,4,"PSOE",166
31,"31106",718,585,581,3,4,"PSOE",203
10,"10048",204,156,154,0,2,"PSOE",42
50,"50040",86,71,71,0,0,"PSOE",21
21,"21902",1144,829,824,9,5,"PSOE",536
49,"49092",116,87,86,0,1,"PSOE",36
22,"22113",470,369,369,2,0,"PSOE",133
37,"37107",10483,7732,7633,78,99,"PSOE",2043
46,"46113",2527,1906,1892,12,14,"PSOE",416
37,"37183",386,296,294,4,2,"PSOE",100
23,"23076",768,653,646,3,7,"PSOE",299
37,"37221",394,299,299,2,0,"PSOE",130
50,"50041",17,14,14,0,0,"PSOE",9
33,"33020",13000,9476,9338,108,138,"PSOE",3607
46,"46053",537,459,457,2,2,"PSOE",167
10,"10172",696,517,513,0,4,"PSOE",207
34,"34199",1159,910,880,7,30,"PSOE",296
9,"9343",93,73,72,1,1,"PSOE",17
5,"5026",187,163,159,1,4,"PSOE",48
38,"38052",1280,893,887,4,6,"PSOE",197
5,"5262",323,254,254,0,0,"PSOE",107
10,"10050",1015,831,823,2,8,"PSOE",326
4,"4054",352,280,278,2,2,"PSOE",104
18,"18187",512,388,387,0,1,"PSOE",244
5,"5263",163,121,120,0,1,"PSOE",26
23,"23079",3639,2859,2818,20,41,"PSOE",1323
14,"14075",557,429,411,5,18,"PSOE",230
6,"6091",3668,2839,2776,26,63,"PSOE",1213
26,"26120",1460,1130,1109,3,21,"PSOE",371
42,"42012",29,23,23,0,0,"PSOE",7
46,"46115",352,261,260,0,1,"PSOE",60
46,"46024",444,339,335,1,4,"PSOE",112
16,"16118",1350,1126,1093,6,33,"PSOE",313
14,"14045",3013,2508,2468,13,40,"PSOE",1353
40,"40188",83,71,71,0,0,"PSOE",20
9,"9403",103,90,89,0,1,"PSOE",18
49,"49095",279,221,217,0,4,"PSOE",60
2,"2053",2885,2313,2282,13,31,"PSOE",911
19,"19115",32,23,23,0,0,"PSOE",3
46,"46238",13105,9717,9610,57,107,"PSOE",2234
19,"19163",60,46,44,0,2,"PSOE",11
5,"5265",79,59,59,0,0,"PSOE",10
5,"5225",353,300,297,2,3,"PSOE",65
13,"13034",58768,46017,45585,385,432,"PSOE",12838
16,"16079",26,17,17,0,0,"PSOE",10
19,"19064",64,56,56,0,0,"PSOE",11
31,"31192",157,133,130,1,3,"PSOE",17
42,"42014",60,44,44,1,0,"PSOE",10
37,"37225",99,90,86,1,4,"PSOE",19
9,"9073",963,799,787,7,12,"PSOE",203
42,"42148",9,9,9,0,0,"PSOE",0
19,"19166",152,125,122,0,3,"PSOE",32
50,"50219",4283,3274,3213,53,61,"PSOE",840
50,"50044",222,161,161,3,0,"PSOE",80
5,"5266",102,79,78,0,1,"PSOE",13
16,"16266",358,281,279,3,2,"PSOE",73
37,"37069",971,721,704,2,17,"PSOE",183
28,"28147",990,779,769,2,10,"PSOE",238
40,"40082",106,83,81,0,2,"PSOE",11
45,"45016",4442,3621,3583,21,38,"PSOE",1050
37,"37301",79,69,67,0,2,"PSOE",16
28,"28080",49801,41938,41705,248,233,"PSOE",7609
28,"28070",113,94,94,2,0,"PSOE",14
42,"42054",19,15,15,0,0,"PSOE",8
46,"46148",1509,1208,1195,7,13,"PSOE",310
9,"9236",35,29,29,1,0,"PSOE",1
22,"22006",272,206,201,2,5,"PSOE",74
37,"37340",142,101,101,0,0,"PSOE",17
46,"46027",932,769,755,1,14,"PSOE",213
18,"18157",1148,914,898,8,16,"PSOE",287
19,"19255",72,51,51,0,0,"PSOE",22
24,"24052",139,99,99,0,0,"PSOE",50
12,"12051",448,324,319,2,5,"PSOE",38
18,"18158",8010,5524,5449,23,75,"PSOE",2702
44,"44153",1749,1264,1243,11,21,"PSOE",418
39,"39003",258,205,202,3,3,"PSOE",45
45,"45156",3338,2805,2750,9,55,"PSOE",989
42,"42017",131,104,104,2,0,"PSOE",41
49,"49223",716,552,548,0,4,"PSOE",146
18,"18122",16001,11761,11556,110,205,"PSOE",4448
37,"37341",48,36,36,0,0,"PSOE",8
9,"9409",110,87,87,0,0,"PSOE",32
16,"16084",50,36,32,0,4,"PSOE",15
49,"49057",105,85,81,2,4,"PSOE",24
47,"47206",78,64,64,0,0,"PSOE",25
39,"39060",6693,5459,5394,29,65,"PSOE",1394
16,"16166",239,176,174,3,2,"PSOE",72
44,"44185",93,73,72,1,1,"PSOE",22
18,"18021",17869,13238,13004,110,234,"PSOE",3882
19,"19214",72,56,55,0,1,"PSOE",19
3,"3098",518,412,400,1,12,"PSOE",151
28,"28072",6088,5001,4961,23,40,"PSOE",1086
45,"45020",1239,987,973,4,14,"PSOE",307
2,"2058",313,218,214,1,4,"PSOE",113
10,"10059",325,234,232,1,2,"PSOE",119
19,"19170",189,116,116,0,0,"PSOE",41
23,"23086",11442,8618,8431,80,187,"PSOE",3703
4,"4021",180,146,143,0,3,"PSOE",48
4,"4022",357,261,261,0,0,"PSOE",124
18,"18022",13804,9877,9714,92,163,"PSOE",3403
5,"5903",138,94,92,0,2,"PSOE",35
6,"6098",534,421,411,8,10,"PSOE",210
30,"30042",2180,1727,1703,6,24,"PSOE",519
6,"6903",2027,1607,1594,16,13,"PSOE",663
39,"39061",3488,2833,2798,18,35,"PSOE",462
9,"9243",73,57,55,0,2,"PSOE",15
19,"19259",28,24,24,0,0,"PSOE",14
3,"3132",515,417,414,4,3,"PSOE",141
45,"45068",171,142,142,0,0,"PSOE",72
50,"50297",502835,394653,391387,3269,3266,"PSOE",119436
12,"12114",194,161,160,2,1,"PSOE",54
28,"28152",16839,14205,14151,87,54,"PSOE",2523
50,"50050",86,65,65,1,0,"PSOE",36
14,"14052",9080,5999,5909,63,90,"PSOE",2296
41,"41092",7679,5668,5568,61,100,"PSOE",2941
16,"16004",227,193,191,0,2,"PSOE",68
19,"19173",51,47,47,0,0,"PSOE",10
41,"41047",10411,8348,8242,84,106,"PSOE",2501
13,"13089",1609,1336,1299,10,37,"PSOE",547
5,"5233",226,198,197,0,1,"PSOE",49
24,"24058",195,127,125,1,2,"PSOE",41
9,"9304",192,164,161,2,3,"PSOE",17
34,"34022",1019,856,849,8,7,"PSOE",352
5,"5078",100,87,86,0,1,"PSOE",10
46,"46062",4572,3571,3510,20,61,"PSOE",883
44,"44190",65,45,43,0,2,"PSOE",12
9,"9414",181,148,146,0,2,"PSOE",38
10,"10185",573,463,460,3,3,"PSOE",181
19,"19174",91,69,69,0,0,"PSOE",17
23,"23090",1219,1014,1004,5,10,"PSOE",450
42,"42022",206,161,161,1,0,"PSOE",25
28,"28153",795,566,564,5,2,"PSOE",143
49,"49181",335,227,224,2,3,"PSOE",67
22,"22084",555,438,433,5,5,"PSOE",128
31,"31162",48,34,33,1,1,"PSOE",15
12,"12902",2248,1678,1653,7,25,"PSOE",432
12,"12025",121,102,99,0,3,"PSOE",25
50,"50901",140,108,108,0,0,"PSOE",40
37,"37347",464,368,359,2,9,"PSOE",99
13,"13092",1715,1434,1425,1,9,"PSOE",544
26,"26018",10441,8400,8311,64,89,"PSOE",3120
42,"42158",94,78,78,0,0,"PSOE",35
49,"49107",116,82,81,1,1,"PSOE",33
5,"5041",995,776,767,3,9,"PSOE",146
45,"45072",661,525,517,3,8,"PSOE",167
13,"13093",3930,2960,2906,34,54,"PSOE",934
19,"19176",230,184,183,0,1,"PSOE",37
26,"26132",106,87,87,0,0,"PSOE",30
10,"10065",200,149,149,0,0,"PSOE",68
50,"50228",250,217,214,3,3,"PSOE",38
19,"19177",61,49,48,0,1,"PSOE",25
33,"33062",388,250,245,9,5,"PSOE",130
47,"47053",126,100,97,0,3,"PSOE",31
22,"22014",233,185,182,3,3,"PSOE",75
4,"4901",494,381,378,0,3,"PSOE",175
42,"42025",1134,824,813,6,11,"PSOE",300
44,"44031",82,52,52,1,0,"PSOE",19
12,"12118",76,64,63,0,1,"PSOE",10
19,"19310",7,6,6,0,0,"PSOE",4
22,"22220",150,120,117,0,3,"PSOE",33
3,"3012",1133,910,897,7,13,"PSOE",295
38,"38034",3998,3033,2993,19,40,"PSOE",818
44,"44032",17,13,13,0,0,"PSOE",8
46,"46005",23013,17487,17286,112,201,"PSOE",5560
9,"9309",292,224,223,3,1,"PSOE",50
14,"14026",2014,1502,1474,10,28,"PSOE",684
33,"33063",374,284,283,3,1,"PSOE",111
40,"40130",128,102,96,0,6,"PSOE",26
44,"44062",31,24,23,1,1,"PSOE",5
51,"51001",59934,38342,37884,322,458,"PSOE",13766
44,"44100",175,142,141,2,1,"PSOE",66
31,"31125",274,211,207,7,4,"PSOE",41
16,"16010",137,104,101,0,3,"PSOE",13
35,"35008",6207,4733,4654,42,79,"PSOE",1387
9,"9253",106,88,85,2,3,"PSOE",21
19,"19314",45,38,38,1,0,"PSOE",6
47,"47151",28,22,22,0,0,"PSOE",1
47,"47119",87,66,65,1,1,"PSOE",21
34,"34168",45,39,39,0,0,"PSOE",10
19,"19225",851,664,650,3,14,"PSOE",184
9,"9200",58,40,40,0,0,"PSOE",15
10,"10110",2224,1618,1559,5,59,"PSOE",514
26,"26138",4545,3433,3374,27,59,"PSOE",1031
22,"22017",822,664,660,5,4,"PSOE",300
12,"12092",126,108,106,1,2,"PSOE",21
42,"42116",42,30,30,1,0,"PSOE",11
40,"40166",253,214,213,1,1,"PSOE",56
37,"37353",122,95,95,1,0,"PSOE",32
45,"45032",444,319,313,2,6,"PSOE",133
46,"46159",23051,17496,17359,104,137,"PSOE",4893
16,"16012",77,65,65,0,0,"PSOE",37
45,"45033",298,224,221,1,3,"PSOE",84
10,"10070",669,516,513,1,3,"PSOE",165
23,"23095",8591,6634,6571,27,63,"PSOE",2544
41,"41053",21618,16549,16150,194,399,"PSOE",6434
18,"18030",567,448,442,4,6,"PSOE",171
37,"37127",200,145,145,1,0,"PSOE",52
22,"22018",308,234,232,2,2,"PSOE",92
26,"26024",210,171,169,1,2,"PSOE",62
9,"9094",51,46,45,0,1,"PSOE",10
50,"50232",160,116,114,2,2,"PSOE",35
3,"3076",8736,6571,6467,40,104,"PSOE",1973
5,"5241",3041,2242,2204,24,38,"PSOE",570
45,"45126",239,173,168,0,5,"PSOE",69
26,"26140",239,199,194,1,5,"PSOE",50
22,"22019",175,151,151,0,0,"PSOE",54
37,"37129",252,206,202,2,4,"PSOE",69
41,"41026",4300,3561,3521,18,40,"PSOE",1517
31,"31210",186,156,156,1,0,"PSOE",32
49,"49075",134,118,114,1,4,"PSOE",46
26,"26101",34,27,27,0,0,"PSOE",10
3,"3016",91,77,77,1,0,"PSOE",22
40,"40204",151,109,104,1,5,"PSOE",25
44,"44006",223,171,169,2,2,"PSOE",66
49,"49114",40,33,32,1,1,"PSOE",13
4,"4034",165,107,106,1,1,"PSOE",22
10,"10195",7557,5790,5691,38,99,"PSOE",1896
24,"24230",410,312,309,5,3,"PSOE",89
44,"44197",50,35,35,0,0,"PSOE",17
4,"4035",8433,6246,6196,33,50,"PSOE",2474
28,"28160",8629,6922,6856,34,66,"PSOE",1463
6,"6109",3843,3228,3106,26,122,"PSOE",1664
19,"19322",26,21,21,1,0,"PSOE",8
12,"12033",1951,1528,1506,10,22,"PSOE",454
10,"10196",294,231,231,2,0,"PSOE",110
13,"13057",1105,934,919,3,15,"PSOE",352
47,"47155",3410,2694,2660,21,34,"PSOE",698
46,"46010",950,727,718,6,9,"PSOE",174
10,"10115",3488,2878,2816,15,62,"PSOE",1069
9,"9050",52,36,36,0,0,"PSOE",10
6,"6011",24665,18486,18253,178,233,"PSOE",5293
9,"9101",74,57,57,0,0,"PSOE",5
2,"2072",1525,1146,1112,4,34,"PSOE",428
9,"9428",103,86,86,0,0,"PSOE",25
42,"42033",50,45,44,1,1,"PSOE",11
12,"12034",1400,1108,1080,7,28,"PSOE",381
49,"49116",360,255,248,5,7,"PSOE",80
44,"44198",181,151,145,1,6,"PSOE",39
24,"24109",876,635,619,3,16,"PSOE",267
21,"21067",402,300,299,2,1,"PSOE",172
12,"12125",222,189,187,0,2,"PSOE",69
6,"6111",493,374,370,2,4,"PSOE",182
44,"44008",1565,1158,1138,8,20,"PSOE",514
9,"9429",55,41,41,0,0,"PSOE",5
22,"22909",301,233,231,4,2,"PSOE",81
24,"24110",1154,895,880,5,15,"PSOE",435
31,"31256",96,64,64,0,0,"PSOE",5
40,"40173",142,122,117,1,5,"PSOE",30
31,"31175",64,50,50,0,0,"PSOE",13
42,"42123",158,118,118,2,0,"PSOE",30
16,"16145",425,362,357,8,5,"PSOE",165
5,"5131",95,72,71,0,1,"PSOE",5
44,"44070",55,45,45,0,0,"PSOE",10
31,"31257",903,690,679,6,11,"PSOE",197
16,"16146",87,68,68,0,0,"PSOE",22
46,"46164",12073,8987,8836,63,151,"PSOE",2620
5,"5247",227,182,177,1,5,"PSOE",55
19,"19326",2343,1789,1768,9,21,"PSOE",425
16,"16103",239,203,203,0,0,"PSOE",54
39,"39073",10200,8230,8150,65,80,"PSOE",1906
19,"19145",41,38,38,0,0,"PSOE",1
12,"12005",8052,6056,5935,50,121,"PSOE",1942
9,"9431",120,98,98,3,0,"PSOE",20
44,"44009",799,621,611,7,10,"PSOE",262
22,"22024",222,179,177,1,2,"PSOE",67
16,"16147",56,32,32,0,0,"PSOE",7
9,"9104",47,39,39,0,0,"PSOE",3
49,"49119",222,181,180,0,1,"PSOE",80
9,"9432",174,145,137,0,8,"PSOE",42
19,"19191",13,12,12,0,0,"PSOE",6
34,"34231",217,184,178,0,6,"PSOE",35
41,"41060",15100,11304,11105,113,199,"PSOE",4388
5,"5173",59,52,52,0,0,"PSOE",8
23,"23902",2229,1843,1820,7,23,"PSOE",1221
12,"12038",156,110,109,1,1,"PSOE",33
9,"9433",58,51,50,1,1,"PSOE",17
42,"42037",29,19,18,0,1,"PSOE",5
44,"44267",71,53,52,0,1,"PSOE",8
34,"34131",58,51,51,0,0,"PSOE",4
6,"6115",1243,898,876,3,22,"PSOE",327
23,"23003",8644,6604,6523,36,81,"PSOE",3043
31,"31016",7752,6114,6064,47,50,"PSOE",1893
26,"26148",150,128,124,1,4,"PSOE",43
12,"12128",1362,1099,1076,9,23,"PSOE",350
9,"9434",1280,1089,1077,12,12,"PSOE",286
50,"50239",63,47,47,0,0,"PSOE",11
21,"21072",10227,7947,7739,98,208,"PSOE",3372
16,"16107",98,76,75,1,1,"PSOE",33
18,"18006",4087,3109,3042,28,67,"PSOE",1122
9,"9109",1066,686,650,11,36,"PSOE",161
23,"23004",421,356,355,2,1,"PSOE",115
50,"50153",922,705,704,6,1,"PSOE",319
41,"41062",2175,1763,1746,8,17,"PSOE",820
37,"37363",107,81,80,0,1,"PSOE",32
49,"49245",253,183,182,2,1,"PSOE",50
45,"45185",7600,6094,5999,19,95,"PSOE",2275
10,"10204",419,342,339,4,3,"PSOE",114
19,"19049",9,8,8,0,0,"PSOE",5
2,"2079",2823,2303,2253,22,50,"PSOE",753
44,"44012",310,240,238,5,2,"PSOE",74
11,"11019",1753,1353,1295,7,58,"PSOE",487
5,"5176",223,173,166,2,7,"PSOE",54
14,"14007",15042,10970,10758,86,212,"PSOE",4228
37,"37252",101,80,79,1,1,"PSOE",14
44,"44205",634,444,426,9,18,"PSOE",146
12,"12130",420,345,341,0,4,"PSOE",38
49,"49123",532,406,402,2,4,"PSOE",149
24,"24117",412,336,335,0,1,"PSOE",57
40,"40212",27,22,20,0,2,"PSOE",9
31,"31263",231,154,154,0,0,"PSOE",9
37,"37139",187,162,157,2,5,"PSOE",33
28,"28168",1329,976,969,3,7,"PSOE",245
22,"22109",266,207,205,3,2,"PSOE",60
37,"37253",133,107,103,0,4,"PSOE",35
6,"6019",2012,1539,1495,14,44,"PSOE",774
37,"37140",642,422,418,2,4,"PSOE",86
47,"47163",280,238,232,2,6,"PSOE",88
42,"42178",101,75,75,0,0,"PSOE",15
10,"10207",464,349,340,3,9,"PSOE",148
19,"19334",44,37,37,0,0,"PSOE",23
16,"16026",93,70,68,1,2,"PSOE",20
29,"29070",43090,30294,29928,243,366,"PSOE",8062
9,"9062",40,39,39,0,0,"PSOE",11
40,"40075",153,128,127,0,1,"PSOE",38
31,"31143",93,58,52,0,6,"PSOE",10
6,"6119",681,551,547,1,4,"PSOE",229
44,"44114",238,188,184,1,4,"PSOE",54
28,"28170",2487,1840,1810,10,30,"PSOE",511
50,"50156",209,174,171,1,3,"PSOE",70
45,"45189",616,506,498,2,8,"PSOE",148
9,"9115",91,71,66,2,5,"PSOE",13
47,"47165",6822,5456,5296,62,160,"PSOE",1201
44,"44207",130,101,101,1,0,"PSOE",43
24,"24003",608,430,418,0,12,"PSOE",125
19,"19108",102,92,89,0,3,"PSOE",25
19,"19200",64,56,56,0,0,"PSOE",21
44,"44208",26,22,22,0,0,"PSOE",4
28,"28171",4382,3202,3134,11,68,"PSOE",819
18,"18077",471,372,366,5,6,"PSOE",196
5,"5141",95,82,82,0,0,"PSOE",23
44,"44017",272,221,219,0,2,"PSOE",81
37,"37142",566,446,444,6,2,"PSOE",113
5,"5063",31,27,27,0,0,"PSOE",2
50,"50243",311,252,247,1,5,"PSOE",88
31,"31024",99,54,54,1,0,"PSOE",3
12,"12044",452,403,400,4,3,"PSOE",178
23,"23044",4719,3817,3749,18,68,"PSOE",1417
40,"40112",2772,2255,2223,21,32,"PSOE",602
40,"40216",774,670,665,11,5,"PSOE",161
26,"26040",63,51,50,0,1,"PSOE",13
47,"47070",30,26,25,0,1,"PSOE",2
31,"31146",29,25,25,1,0,"PSOE",4
49,"49090",193,153,151,0,2,"PSOE",47
31,"31904",1561,1139,1130,7,9,"PSOE",237
18,"18045",1060,748,737,10,11,"PSOE",371
10,"10211",447,345,343,2,2,"PSOE",173
50,"50245",76,58,58,0,0,"PSOE",17
3,"3091",241,201,196,0,5,"PSOE",53
31,"31147",106,88,86,3,2,"PSOE",11
9,"9122",88,64,64,0,0,"PSOE",16
37,"37022",245,200,196,2,4,"PSOE",38
31,"31026",132,116,112,0,4,"PSOE",45
38,"38051",7326,5418,5352,27,66,"PSOE",1318
18,"18116",2853,2265,2233,15,32,"PSOE",735
49,"49010",348,301,295,6,6,"PSOE",108
49,"49252",304,244,241,6,3,"PSOE",75
49,"49130",158,131,131,5,0,"PSOE",40
29,"29074",781,606,597,2,9,"PSOE",260
22,"22160",212,171,170,3,1,"PSOE",49
23,"23011",2134,1649,1614,11,35,"PSOE",811
42,"42185",25,20,20,0,0,"PSOE",5
45,"45194",65,49,48,0,1,"PSOE",17
45,"45195",2072,1615,1583,4,32,"PSOE",714
50,"50246",38,28,28,0,0,"PSOE",7
6,"6124",1656,1323,1296,5,27,"PSOE",683
2,"2014",350,285,280,1,5,"PSOE",113
18,"18047",6074,4437,4353,33,84,"PSOE",1342
37,"37024",88,69,69,0,0,"PSOE",16
2,"2901",2185,1633,1613,9,20,"PSOE",563
31,"31907",11205,9216,9140,121,76,"PSOE",2147
49,"49131",238,182,178,0,4,"PSOE",55
49,"49256",242,204,202,4,2,"PSOE",54
19,"19060",157,128,125,0,3,"PSOE",34
3,"3093",19713,15195,14988,108,207,"PSOE",4524
37,"37260",139,109,109,0,0,"PSOE",41
50,"50218",110,92,92,0,0,"PSOE",24
22,"22041",152,121,119,2,2,"PSOE",29
9,"9448",201,161,161,1,0,"PSOE",24
9,"9125",552,424,421,3,3,"PSOE",108
6,"6125",1679,1348,1324,5,24,"PSOE",571
21,"21010",14976,9475,9352,145,123,"PSOE",3271
5,"5069",74,63,62,0,1,"PSOE",6
44,"44212",41,32,32,0,0,"PSOE",8
35,"35026",82764,55647,54846,499,801,"PSOE",15074
41,"41069",29569,21075,20657,361,418,"PSOE",6226
37,"37262",69,60,60,0,0,"PSOE",4
45,"45060",158,118,118,0,0,"PSOE",69
13,"13035",955,739,720,6,19,"PSOE",372
31,"31071",15,13,13,0,0,"PSOE",5
9,"9405",129,99,97,1,2,"PSOE",27
28,"28079",2374366,1872679,1859094,11998,13585,"PSOE",502909
9,"9450",25,17,17,0,0,"PSOE",9
31,"31152",1270,937,929,19,8,"PSOE",289
26,"26163",124,106,104,1,2,"PSOE",29
6,"6127",2809,2285,2258,13,27,"PSOE",908
31,"31031",220,158,157,1,1,"PSOE",21
26,"26045",11,11,11,0,0,"PSOE",7
10,"10096",3326,2553,2501,14,52,"PSOE",1110
19,"19211",356,301,300,0,1,"PSOE",89
31,"31153",2173,1591,1580,10,11,"PSOE",262
39,"39029",636,512,512,5,0,"PSOE",78
9,"9451",238,211,207,2,4,"PSOE",86
14,"14017",10945,8514,8386,90,128,"PSOE",3953
34,"34151",147,99,97,1,2,"PSOE",23
19,"19254",43,36,36,0,0,"PSOE",9
45,"45062",1074,888,867,4,21,"PSOE",248
2,"2018",796,693,682,5,11,"PSOE",244
10,"10218",1083,810,796,3,14,"PSOE",422
49,"49135",588,409,405,0,4,"PSOE",117
37,"37264",55,42,42,0,0,"PSOE",9
40,"40223",228,181,181,0,0,"PSOE",47
6,"6029",1183,946,935,12,11,"PSOE",586
42,"42097",14,7,7,0,0,"PSOE",3
47,"47142",124,94,92,0,2,"PSOE",17
5,"5113",62,49,49,0,0,"PSOE",9
10,"10016",327,260,259,1,1,"PSOE",118
9,"9351",62,51,50,1,1,"PSOE",2
12,"12139",302,219,217,3,2,"PSOE",38
44,"44216",26922,20603,20279,204,324,"PSOE",5665
31,"31034",31,27,26,0,1,"PSOE",1
34,"34015",39,32,31,0,1,"PSOE",5
46,"46180",651,525,519,0,6,"PSOE",171
37,"37378",99,69,67,2,2,"PSOE",20
45,"45065",261,207,205,2,2,"PSOE",91
31,"31156",239,191,191,1,0,"PSOE",33
49,"49018",288,225,222,1,3,"PSOE",84
14,"14049",16282,12515,12301,121,214,"PSOE",5036
34,"34017",889,743,738,6,5,"PSOE",238
6,"6031",461,316,301,1,15,"PSOE",123
34,"34208",47,38,38,0,0,"PSOE",1
33,"33026",8270,5540,5474,69,66,"PSOE",1914
26,"26167",50,38,38,1,0,"PSOE",5
46,"46253",114,85,85,2,0,"PSOE",28
16,"16271",595,513,511,2,2,"PSOE",175
33,"33057",1538,1129,1097,14,32,"PSOE",456
49,"49262",370,287,286,1,1,"PSOE",89
40,"40016",54,43,43,1,0,"PSOE",5
50,"50166",236,200,198,1,2,"PSOE",55
44,"44025",5825,4337,4197,50,140,"PSOE",1530
47,"47175",6704,5296,5222,52,74,"PSOE",1667
18,"18053",1561,1102,1099,3,3,"PSOE",492
9,"9354",33,29,29,2,0,"PSOE",5
14,"14020",338,240,233,2,7,"PSOE",129
29,"29083",2062,1607,1574,9,33,"PSOE",755
18,"18161",251,222,220,1,2,"PSOE",88
10,"10904",722,549,543,7,6,"PSOE",193
9,"9301",648,545,536,7,9,"PSOE",123
6,"6032",78,65,64,0,1,"PSOE",11
19,"19216",130,100,99,1,1,"PSOE",35
26,"26051",210,178,176,1,2,"PSOE",43
23,"23020",1524,1363,1348,12,15,"PSOE",483
46,"46243",124,105,104,0,1,"PSOE",34
49,"49179",346,233,232,0,1,"PSOE",67
42,"42196",8,6,6,0,0,"PSOE",0
14,"14021",260397,195951,193914,2025,2037,"PSOE",50643
50,"50077",206,158,157,1,1,"PSOE",69
50,"50078",231,173,171,0,2,"PSOE",86
31,"31241",125,100,100,2,0,"PSOE",7
5,"5905",222,165,164,1,1,"PSOE",20
37,"37077",252,216,213,2,3,"PSOE",93
6,"6033",1269,1026,1010,4,16,"PSOE",488
6,"6133",1799,1476,1453,12,23,"PSOE",685
26,"26170",427,343,338,2,5,"PSOE",89
42,"42155",142,92,92,0,0,"PSOE",16
16,"16088",101,85,85,1,0,"PSOE",39
45,"45116",680,547,537,4,10,"PSOE",171
45,"45115",2586,2158,2114,8,44,"PSOE",692
34,"34063",87,77,77,1,0,"PSOE",21
12,"12901",3357,2693,2675,19,18,"PSOE",823
12,"12056",257,218,216,1,2,"PSOE",66
44,"44028",171,140,138,1,2,"PSOE",41
19,"19076",19,18,18,0,0,"PSOE",4
49,"49266",70,51,49,2,2,"PSOE",11
42,"42061",272,207,204,2,3,"PSOE",55
10,"10104",5151,3862,3782,22,80,"PSOE",1239
12,"12057",578,485,473,3,12,"PSOE",147
22,"22049",74,63,63,0,0,"PSOE",10
18,"18163",315,246,241,1,5,"PSOE",81
9,"9195",55,45,45,1,0,"PSOE",14
16,"16224",77,61,60,1,1,"PSOE",19
23,"23024",12224,9586,9329,46,257,"PSOE",3704
10,"10105",2476,1798,1760,21,38,"PSOE",608
9,"9137",180,149,147,1,2,"PSOE",35
50,"50170",364,286,279,1,7,"PSOE",120
3,"3103",245,212,211,4,1,"PSOE",78
38,"38002",972,678,640,3,38,"PSOE",284
37,"37036",57,42,41,0,1,"PSOE",7
24,"24020",434,302,299,1,3,"PSOE",87
46,"46033",196,169,168,3,1,"PSOE",27
9,"9138",87,74,72,2,2,"PSOE",19
26,"26172",25,23,23,0,0,"PSOE",9
50,"50171",96,78,78,1,0,"PSOE",16
37,"37272",133,106,106,1,0,"PSOE",23
22,"22050",93,79,79,2,0,"PSOE",21
16,"16047",214,175,174,4,1,"PSOE",43
16,"16173",190,141,141,0,0,"PSOE",50
22,"22175",184,139,137,1,2,"PSOE",45
4,"4067",520,387,379,1,8,"PSOE",214
24,"24021",1602,1211,1194,7,17,"PSOE",456
26,"26173",6,6,6,0,0,"PSOE",2
50,"50902",79,69,69,0,0,"PSOE",18
14,"14025",2857,2482,2436,14,46,"PSOE",1058
9,"9140",115,88,88,2,0,"PSOE",36
10,"10107",1030,840,828,5,12,"PSOE",403
44,"44099",649,457,450,2,7,"PSOE",227
24,"24101",384,285,283,4,2,"PSOE",145
49,"49025",159,126,124,0,2,"PSOE",57
31,"31206",2082,1610,1589,15,21,"PSOE",346
14,"14056",23513,17065,16684,147,381,"PSOE",6889
9,"9198",100,80,79,0,1,"PSOE",23
45,"45121",7273,5362,5291,27,71,"PSOE",1426
49,"49026",201,163,162,0,1,"PSOE",64
16,"16093",57,47,47,0,0,"PSOE",14
19,"19223",101,66,66,1,0,"PSOE",26
31,"31044",294,243,242,5,1,"PSOE",12
31,"31165",2763,2121,2091,21,30,"PSOE",788
18,"18097",995,708,702,4,6,"PSOE",245
34,"34220",149,133,132,0,1,"PSOE",37
24,"24145",618,443,435,3,8,"PSOE",174
6,"6138",1013,783,767,3,16,"PSOE",428
47,"47181",165,143,143,0,0,"PSOE",39
29,"29001",4199,3380,3341,20,39,"PSOE",1585
3,"3014",238879,176118,174768,1105,1350,"PSOE",49118
5,"5123",103,85,85,1,0,"PSOE",18
44,"44224",21,15,15,0,0,"PSOE",7
18,"18029",1813,1183,1169,9,14,"PSOE",548
16,"16011",23,18,18,0,0,"PSOE",6
45,"45123",3160,2434,2392,16,42,"PSOE",662
39,"39067",759,582,575,3,7,"PSOE",142
40,"40025",128,109,106,1,3,"PSOE",14
46,"46007",12284,9370,9265,65,105,"PSOE",2363
24,"24184",183,121,119,0,2,"PSOE",43
6,"6040",987,747,739,6,8,"PSOE",375
6,"6139",502,429,421,5,8,"PSOE",222
50,"50174",83,58,58,0,0,"PSOE",16
40,"40132",46,32,31,1,1,"PSOE",4
5,"5201",499,414,407,2,7,"PSOE",122
21,"21025",3898,2765,2705,39,60,"PSOE",1023
22,"22181",88,60,59,1,1,"PSOE",18
47,"47183",139,118,118,1,0,"PSOE",27
38,"38006",41302,23632,23415,133,217,"PSOE",7222
5,"5086",76,64,61,0,3,"PSOE",8
34,"34031",26,24,24,0,0,"PSOE",4
29,"29092",579,434,426,5,8,"PSOE",168
49,"49029",614,497,488,9,9,"PSOE",84
28,"28021",576,387,386,3,1,"PSOE",84
3,"3015",12807,9782,9634,63,148,"PSOE",2545
39,"39040",4267,3428,3385,24,43,"PSOE",870
46,"46069",157,130,129,0,1,"PSOE",52
28,"28094",959,736,729,6,7,"PSOE",160
49,"49151",593,453,444,5,9,"PSOE",151
50,"50260",32,28,28,0,0,"PSOE",9
49,"49031",145,107,103,0,4,"PSOE",24
6,"6141",1688,1308,1291,16,17,"PSOE",612
29,"29004",295,233,226,0,7,"PSOE",97
37,"37166",199,146,144,0,2,"PSOE",32
29,"29037",215,179,179,0,0,"PSOE",67
34,"34123",1637,1376,1354,8,22,"PSOE",433
46,"46263",239,204,200,3,4,"PSOE",112
28,"28022",36550,31559,31436,207,123,"PSOE",5033
33,"33007",1398,960,951,9,9,"PSOE",422
37,"37167",177,159,158,3,1,"PSOE",74
21,"21028",370,300,293,1,7,"PSOE",131
11,"11010",6351,4472,4385,140,87,"PSOE",1756
9,"9485",56,50,50,2,0,"PSOE",5
34,"34033",17,15,15,0,0,"PSOE",1
16,"16055",679,478,477,4,1,"PSOE",155
26,"26180",223,182,177,3,5,"PSOE",39
34,"34174",178,150,149,2,1,"PSOE",27
44,"44036",23,20,20,0,0,"PSOE",5
31,"31050",6002,4111,4061,58,50,"PSOE",585
45,"45083",551,470,465,5,5,"PSOE",103
46,"46162",1177,954,938,4,16,"PSOE",351
9,"9427",1364,1002,972,13,30,"PSOE",200
9,"9261",449,343,342,5,1,"PSOE",106
5,"5007",110,81,80,2,1,"PSOE",8
28,"28023",5090,4252,4212,31,40,"PSOE",892
46,"46132",2196,1877,1853,10,24,"PSOE",505
34,"34035",100,84,82,1,2,"PSOE",31
18,"18067",681,511,507,3,4,"PSOE",251
40,"40138",2127,1729,1696,18,33,"PSOE",546
46,"46102",19635,15330,15207,95,123,"PSOE",5518
6,"6144",512,422,416,1,6,"PSOE",226
33,"33008",1705,1285,1273,9,12,"PSOE",479
9,"9155",25,20,20,0,0,"PSOE",7
19,"19095",11,10,10,1,0,"PSOE",2
41,"41001",1565,1224,1213,8,11,"PSOE",549
46,"46011",7523,5320,5235,28,85,"PSOE",1215
22,"22059",1139,867,855,10,12,"PSOE",277
38,"38010",3974,2814,2777,20,37,"PSOE",1065
26,"26183",66,50,50,0,0,"PSOE",10
45,"45086",493,373,368,0,5,"PSOE",111
45,"45085",1511,1141,1128,9,13,"PSOE",218
9,"9321",1597,1293,1280,4,13,"PSOE",435
16,"16243",379,323,318,5,5,"PSOE",115
5,"5209",75,58,57,0,1,"PSOE",13
23,"23034",2490,2033,1999,15,34,"PSOE",995
6,"6046",1250,1010,995,7,15,"PSOE",459
24,"24031",210,180,176,0,4,"PSOE",52
9,"9903",3139,2379,2352,27,27,"PSOE",662
41,"41002",1427,1057,1024,5,33,"PSOE",457
22,"22188",76,60,59,1,1,"PSOE",23
45,"45040",1276,842,828,4,14,"PSOE",272
34,"34129",170,134,132,2,2,"PSOE",23
6,"6013",265,227,221,0,6,"PSOE",157
44,"44200",39,25,25,0,0,"PSOE",2
4,"4041",330,248,247,1,1,"PSOE",65
3,"3081",1494,1163,1141,5,22,"PSOE",285
5,"5210",79,57,57,0,0,"PSOE",3
3,"3114",1581,1263,1237,9,26,"PSOE",368
31,"31176",2930,2204,2134,33,70,"PSOE",831
22,"22103",676,520,517,6,3,"PSOE",201
50,"50033",65,50,50,1,0,"PSOE",21
29,"29009",1441,1097,1073,8,24,"PSOE",546
44,"44040",191,164,158,2,6,"PSOE",58
47,"47002",18,18,18,0,0,"PSOE",5
40,"40141",833,644,627,5,17,"PSOE",165
49,"49037",177,146,143,1,3,"PSOE",35
46,"46105",16132,11703,11582,64,121,"PSOE",3776
46,"46196",140,115,114,0,1,"PSOE",37
13,"13018",766,644,634,0,10,"PSOE",315
34,"34039",62,49,49,0,0,"PSOE",4
9,"9906",1200,975,958,8,17,"PSOE",208
44,"44141",127,100,100,0,0,"PSOE",29
50,"50063",61,54,54,0,0,"PSOE",27
6,"6148",957,762,746,12,16,"PSOE",363
29,"29100",2378,1711,1686,22,25,"PSOE",903
28,"28027",1200,920,906,4,14,"PSOE",277
4,"4080",199,158,157,0,1,"PSOE",55
49,"49038",94,68,68,1,0,"PSOE",16
37,"37052",278,201,199,2,2,"PSOE",71
9,"9327",29,22,22,0,0,"PSOE",4
18,"18178",671,535,532,0,3,"PSOE",269
34,"34180",64,55,55,2,0,"PSOE",10
29,"29067",430670,312817,309994,2768,2823,"PSOE",92989
31,"31261",237,174,173,3,1,"PSOE",44
10,"10203",4428,3212,3152,25,60,"PSOE",1125
19,"19238",44,30,30,1,0,"PSOE",7
40,"40035",135,111,110,0,1,"PSOE",24
14,"14037",3182,2388,2319,22,69,"PSOE",1101
19,"19103",251,218,216,1,2,"PSOE",90
28,"28029",562,459,456,2,3,"PSOE",94
46,"46198",871,707,693,4,14,"PSOE",200
5,"5213",95,77,75,0,2,"PSOE",11
42,"42219",40,33,32,1,1,"PSOE",8
21,"21036",203,147,143,0,4,"PSOE",76
26,"26150",100,83,83,0,0,"PSOE",34
45,"45001",1837,1371,1340,12,31,"PSOE",506
40,"40072",224,198,194,3,4,"PSOE",50
18,"18145",10869,8532,8405,69,127,"PSOE",2223
37,"37175",404,321,319,8,2,"PSOE",68
23,"23040",1443,1164,1149,3,15,"PSOE",492
34,"34182",753,609,604,6,5,"PSOE",192
50,"50268",42,33,32,1,1,"PSOE",4
5,"5214",27,22,22,0,0,"PSOE",2
16,"16065",372,306,305,2,1,"PSOE",100
6,"6151",1054,791,778,2,13,"PSOE",390
16,"16196",602,522,510,3,12,"PSOE",255
37,"37100",77,60,59,1,1,"PSOE",2
16,"16066",2298,1932,1885,17,47,"PSOE",504
5,"5215",159,126,124,0,2,"PSOE",34
45,"45094",367,290,288,4,2,"PSOE",101
34,"34184",49,39,38,0,1,"PSOE",7
37,"37057",209,165,162,2,3,"PSOE",40
9,"9169",97,86,85,0,1,"PSOE",23
37,"37290",134,113,112,0,1,"PSOE",32
18,"18076",790,607,604,1,3,"PSOE",396
44,"44144",325,249,247,1,2,"PSOE",128
44,"44044",83,65,64,2,1,"PSOE",9
16,"16197",66,45,45,0,0,"PSOE",20
16,"16152",32,28,28,1,0,"PSOE",3
19,"19197",27,22,22,0,0,"PSOE",13
37,"37366",41,30,30,0,0,"PSOE",7
24,"24161",295,223,219,0,4,"PSOE",33
38,"38017",30646,18576,18373,100,203,"PSOE",5060
24,"24040",412,322,320,2,2,"PSOE",111
44,"44045",368,302,298,8,4,"PSOE",110
45,"45096",987,829,813,3,16,"PSOE",224
44,"44145",972,741,732,11,9,"PSOE",248
42,"42086",33,21,19,0,2,"PSOE",4
41,"41008",1040,840,822,4,18,"PSOE",527
50,"50095",12136,9020,8928,99,92,"PSOE",3722
40,"40040",2495,1913,1895,20,18,"PSOE",456
9,"9172",168,132,132,1,0,"PSOE",36
37,"37179",196,172,169,0,3,"PSOE",51
41,"41065",22550,16215,16010,189,205,"PSOE",7587
10,"10006",1230,1006,995,8,11,"PSOE",492
11,"11023",9372,7032,6950,94,82,"PSOE",3139
40,"40146",238,205,202,0,3,"PSOE",54
47,"47228",439,353,352,1,1,"PSOE",93
47,"47069",118,96,92,1,4,"PSOE",28
12,"12011",4582,3511,3431,27,80,"PSOE",1272
42,"42135",70,46,45,0,1,"PSOE",13
50,"50011",116,100,99,0,1,"PSOE",50
14,"14041",3115,2449,2376,45,73,"PSOE",762
9,"9338",231,193,189,2,4,"PSOE",49
5,"5104",33,24,23,0,1,"PSOE",2
16,"16156",82,65,65,0,0,"PSOE",27
37,"37181",264,185,184,1,1,"PSOE",54
44,"44146",170,148,146,3,2,"PSOE",59
26,"26076",116,93,91,0,2,"PSOE",28
11,"11024",6583,4774,4682,40,92,"PSOE",1993
18,"18183",624,442,441,1,1,"PSOE",179
31,"31903",6862,4962,4915,31,47,"PSOE",1463
34,"34094",61,44,44,0,0,"PSOE",7
49,"49091",248,185,183,4,2,"PSOE",66
9,"9339",126,105,105,1,0,"PSOE",28
9,"9019",144,113,109,1,4,"PSOE",22
5,"5105",336,272,266,2,6,"PSOE",74
11,"11025",4388,3092,3045,30,47,"PSOE",1617
31,"31187",101,68,68,1,0,"PSOE",8
34,"34051",91,81,79,0,2,"PSOE",11
9,"9020",237,184,180,5,4,"PSOE",48
45,"45100",179,150,148,1,2,"PSOE",62
13,"13030",120,97,96,0,1,"PSOE",38
50,"50273",32,24,24,0,0,"PSOE",10
2,"2050",90,75,75,0,0,"PSOE",23
5,"5261",33,26,26,0,0,"PSOE",2
24,"24207",278,242,235,0,7,"PSOE",93
14,"14043",7408,5721,5619,76,102,"PSOE",2777
9,"9067",407,285,278,2,7,"PSOE",60
44,"44048",53,47,47,0,0,"PSOE",14
47,"47011",557,478,476,5,2,"PSOE",124
41,"41012",3368,2416,2361,23,55,"PSOE",1074
5,"5106",28,22,22,0,0,"PSOE",0
3,"3030",563,474,466,2,8,"PSOE",148
6,"6057",537,442,433,1,9,"PSOE",189
33,"33051",6811,4879,4809,63,70,"PSOE",1681
41,"41040",11111,8768,8679,76,89,"PSOE",2099
45,"45011",275,241,238,2,3,"PSOE",82
11,"11027",68637,48919,48441,519,478,"PSOE",12584
44,"44086",421,332,327,3,5,"PSOE",102
19,"19294",25,19,18,0,1,"PSOE",7
10,"10011",532,439,435,3,4,"PSOE",239
4,"4091",326,267,266,3,1,"PSOE",170
50,"50189",678,544,534,5,10,"PSOE",175
44,"44241",506,416,407,1,9,"PSOE",148
5,"5224",100,91,90,1,1,"PSOE",13
9,"9023",1178,982,966,14,16,"PSOE",246
42,"42093",35,29,29,2,0,"PSOE",4
50,"50190",675,565,553,5,12,"PSOE",251
50,"50100",306,238,235,3,3,"PSOE",95
47,"47105",175,152,149,1,3,"PSOE",51
24,"24049",1415,1146,1134,8,12,"PSOE",456
5,"5108",40,28,28,0,0,"PSOE",13
10,"10134",553,396,392,2,4,"PSOE",126
22,"22076",288,228,226,1,2,"PSOE",83
5,"5109",441,363,356,5,7,"PSOE",105
34,"34202",28,20,20,1,0,"PSOE",3
44,"44050",3115,2333,2299,27,34,"PSOE",725
44,"44181",66,58,57,0,1,"PSOE",12
44,"44021",104,86,85,2,1,"PSOE",31
41,"41070",6397,4987,4921,55,66,"PSOE",1391
37,"37375",673,583,573,4,10,"PSOE",259
45,"45106",7395,5971,5861,40,110,"PSOE",2047
9,"9347",135,108,108,0,0,"PSOE",24
14,"14046",4443,3550,3486,38,64,"PSOE",1352
41,"41014",2486,1939,1878,6,61,"PSOE",765
37,"37068",340,256,256,3,0,"PSOE",68
50,"50133",100,82,82,2,0,"PSOE",40
9,"9072",320,259,258,1,1,"PSOE",84
46,"46208",1070,875,866,2,9,"PSOE",270
46,"46117",500,407,399,1,8,"PSOE",112
34,"34204",52,41,41,1,0,"PSOE",6
33,"33023",3271,2448,2397,35,51,"PSOE",963
10,"10137",404,346,344,3,2,"PSOE",155
22,"22078",438,326,323,3,3,"PSOE",122
11,"11031",76294,54123,53583,589,540,"PSOE",15823
34,"34011",386,326,321,2,5,"PSOE",95
5,"5227",340,237,234,0,3,"PSOE",64
31,"31236",1318,958,950,8,8,"PSOE",116
26,"26010",85,68,68,1,0,"PSOE",19
21,"21049",3282,2294,2214,21,80,"PSOE",1052
9,"9027",48,41,39,0,2,"PSOE",11
47,"47110",438,352,347,4,5,"PSOE",125
37,"37302",262,182,181,2,1,"PSOE",44
41,"41072",4037,3256,3221,19,35,"PSOE",1391
10,"10219",1212,814,806,8,8,"PSOE",365
24,"24092",745,606,601,6,5,"PSOE",192
9,"9130",66,55,52,0,3,"PSOE",8
42,"42192",38,26,26,1,0,"PSOE",11
26,"26084",7187,5620,5558,36,62,"PSOE",1382
44,"44053",105,81,81,0,0,"PSOE",26
49,"49056",288,232,230,2,2,"PSOE",98
22,"22079",114,89,88,1,1,"PSOE",40
10,"10138",540,422,415,3,7,"PSOE",236
3,"3035",632,529,525,2,4,"PSOE",192
47,"47017",198,162,160,1,2,"PSOE",13
19,"19119",75,68,66,2,2,"PSOE",21
18,"18193",14802,11165,10973,110,192,"PSOE",3177
50,"50018",893,705,696,3,9,"PSOE",327
37,"37071",76,67,67,0,0,"PSOE",33
9,"9030",119,90,89,1,1,"PSOE",23
45,"45111",53,43,41,0,2,"PSOE",24
50,"50047",43,32,31,1,1,"PSOE",13
42,"42018",131,102,102,1,0,"PSOE",17
4,"4020",286,218,217,1,1,"PSOE",74
23,"23018",2268,1738,1722,8,16,"PSOE",996
24,"24133",356,267,267,4,0,"PSOE",72
31,"31239",281,215,212,7,3,"PSOE",32
44,"44054",94,79,79,0,0,"PSOE",20
37,"37191",104,65,65,1,0,"PSOE",13
49,"49177",260,165,162,2,3,"PSOE",70
28,"28042",1266,1020,1010,2,10,"PSOE",204
2,"2022",344,252,252,1,0,"PSOE",77
42,"42019",511,384,378,7,6,"PSOE",88
16,"16217",94,77,77,0,0,"PSOE",26
13,"13041",249,179,171,2,8,"PSOE",63
50,"50107",988,837,828,11,9,"PSOE",261
3,"3037",341,289,284,1,5,"PSOE",80
18,"18901",488,335,329,2,6,"PSOE",116
46,"46030",796,653,633,7,20,"PSOE",227
14,"14051",1348,1064,1048,7,16,"PSOE",545
42,"42103",554,448,442,2,6,"PSOE",105
10,"10142",840,641,639,5,2,"PSOE",316
22,"22172",520,412,407,3,5,"PSOE",113
49,"49102",183,136,135,2,1,"PSOE",51
46,"46152",87,69,69,0,0,"PSOE",24
45,"45022",393,290,288,3,2,"PSOE",84
28,"28074",140580,113723,112489,776,1234,"PSOE",39043
22,"22214",118,98,97,1,1,"PSOE",13
44,"44055",77,58,56,0,2,"PSOE",15
47,"47208",56,37,37,0,0,"PSOE",8
2,"2061",618,504,500,7,4,"PSOE",167
26,"26091",147,132,131,1,1,"PSOE",22
5,"5118",68,44,43,0,1,"PSOE",11
9,"9356",43,36,36,0,0,"PSOE",4
24,"24177",472,330,326,3,4,"PSOE",88
47,"47050",3898,3084,3047,36,37,"PSOE",863
18,"18023",15645,11708,11561,91,147,"PSOE",3802
16,"16275",12,12,12,0,0,"PSOE",3
37,"37345",150,134,133,0,1,"PSOE",40
33,"33060",14132,9960,9794,135,166,"PSOE",4263
45,"45024",1043,832,821,5,11,"PSOE",250
6,"6001",659,539,534,7,5,"PSOE",219
39,"39063",954,726,722,4,4,"PSOE",180
46,"46123",1948,1469,1446,5,23,"PSOE",363
2,"2026",832,682,673,6,9,"PSOE",333
9,"9036",37,33,32,3,1,"PSOE",0
18,"18903",851,644,636,1,8,"PSOE",266
19,"19261",32,24,24,0,0,"PSOE",5
12,"12088",57,54,54,0,0,"PSOE",14
42,"42198",19,15,15,0,0,"PSOE",6
4,"4026",55,46,45,1,1,"PSOE",7
10,"10023",791,619,614,1,5,"PSOE",345
10,"10146",1513,1128,1104,6,24,"PSOE",490
46,"46124",785,680,675,5,5,"PSOE",152
13,"13046",693,558,547,0,11,"PSOE",229
33,"33030",873,678,671,1,7,"PSOE",159
41,"41021",21397,15585,15334,201,251,"PSOE",6255
50,"50023",208,165,164,2,1,"PSOE",43
47,"47211",48,43,43,1,0,"PSOE",3
4,"4027",226,147,147,1,0,"PSOE",34
33,"33061",350,201,200,2,1,"PSOE",87
3,"3041",6093,4444,4398,13,46,"PSOE",1109
40,"40162",387,286,278,3,8,"PSOE",50
4,"4103",1439,1120,1108,16,12,"PSOE",406
11,"11040",398,348,342,4,6,"PSOE",209
46,"46125",846,681,675,1,6,"PSOE",235
45,"45119",3485,2478,2430,21,48,"PSOE",665
19,"19264",34,28,28,0,0,"PSOE",15
37,"37080",212,173,169,0,4,"PSOE",42
34,"34217",1251,1053,1042,7,11,"PSOE",264
29,"29032",6657,5314,5190,30,124,"PSOE",2204
31,"31164",545,438,433,6,5,"PSOE",181
46,"46247",961,695,687,3,8,"PSOE",141
6,"6004",1549,1276,1257,6,19,"PSOE",640
13,"13049",747,566,553,4,13,"PSOE",194
5,"5197",100,84,83,0,1,"PSOE",12
19,"19032",146,102,101,2,1,"PSOE",47
10,"10026",656,515,507,8,8,"PSOE",170
26,"26174",132,116,116,5,0,"PSOE",27
50,"50082",84,63,63,0,0,"PSOE",17
19,"19179",76,66,64,1,2,"PSOE",30
10,"10108",203,131,130,1,1,"PSOE",38
30,"30017",11477,8952,8844,62,108,"PSOE",2498
49,"49109",562,445,444,5,1,"PSOE",124
45,"45029",188,160,159,0,1,"PSOE",70
24,"24226",193,136,134,2,2,"PSOE",23
18,"18906",911,722,716,4,6,"PSOE",242
18,"18028",907,766,756,0,10,"PSOE",281
16,"16134",4383,3544,3491,34,53,"PSOE",1025
40,"40164",185,136,134,3,2,"PSOE",18
6,"6072",2225,1777,1752,20,25,"PSOE",743
38,"38035",10384,6657,6596,50,61,"PSOE",1508
50,"50286",75,58,55,0,3,"PSOE",22
10,"10150",331,277,272,6,5,"PSOE",152
14,"14027",7876,6227,6103,81,124,"PSOE",2410
11,"11901",5698,4167,4080,81,87,"PSOE",1974
18,"18168",781,613,604,6,9,"PSOE",168
50,"50173",149,107,105,0,2,"PSOE",39
10,"10069",785,609,596,2,13,"PSOE",264
22,"22133",108,85,83,1,2,"PSOE",37
3,"3044",4557,3650,3600,17,50,"PSOE",1018
34,"34221",170,138,136,2,2,"PSOE",56
19,"19133",81,70,70,0,0,"PSOE",27
46,"46128",1581,1324,1287,2,37,"PSOE",364
50,"50115",3275,2399,2355,32,44,"PSOE",812
9,"9201",28,20,19,0,1,"PSOE",4
45,"45124",2069,1757,1718,14,39,"PSOE",633
34,"34073",180,149,145,2,4,"PSOE",37
38,"38036",6831,4947,4829,58,118,"PSOE",1847
9,"9044",53,49,47,1,2,"PSOE",16
9,"9369",422,328,325,8,3,"PSOE",111
44,"44163",114,92,92,0,0,"PSOE",35
24,"24185",452,339,332,3,7,"PSOE",92
31,"31209",147,116,116,0,0,"PSOE",21
30,"30020",6431,4991,4940,19,51,"PSOE",1211
28,"28051",1640,1301,1292,9,9,"PSOE",303
22,"22090",85,66,66,1,0,"PSOE",24
46,"46038",307,243,241,0,2,"PSOE",82
33,"33036",11335,8356,8243,92,113,"PSOE",3003
34,"34170",51,35,35,0,0,"PSOE",5
16,"16097",139,121,120,1,1,"PSOE",60
18,"18909",539,432,426,1,6,"PSOE",210
5,"5126",62,53,52,0,1,"PSOE",11
34,"34074",683,545,540,4,5,"PSOE",209
9,"9206",55,47,47,1,0,"PSOE",7
5,"5002",1890,1497,1468,8,29,"PSOE",453
50,"50116",170,132,131,0,1,"PSOE",53
47,"47184",541,447,441,0,6,"PSOE",94
19,"19185",27,19,19,0,0,"PSOE",6
49,"49190",50,45,45,1,0,"PSOE",18
10,"10072",835,632,625,3,7,"PSOE",346
5,"5243",81,63,62,1,1,"PSOE",12
38,"38038",164468,112475,111577,728,898,"PSOE",29208
16,"16099",184,126,121,0,5,"PSOE",35
19,"19138",223,176,172,4,4,"PSOE",79
24,"24067",606,375,371,2,4,"PSOE",67
34,"34077",381,301,293,2,8,"PSOE",96
41,"41028",2071,1741,1713,18,28,"PSOE",521
49,"49076",328,260,258,6,2,"PSOE",65
31,"31212",129,102,102,6,0,"PSOE",30
19,"19272",65,58,56,1,2,"PSOE",21
30,"30022",17056,12158,11954,126,204,"PSOE",3503
46,"46192",790,599,586,8,13,"PSOE",174
6,"6142",259,214,208,1,6,"PSOE",125
3,"3018",12439,9387,9283,50,104,"PSOE",2461
3,"3902",10578,7654,7530,56,124,"PSOE",1601
42,"42032",142,120,120,0,0,"PSOE",29
34,"34227",72,63,61,4,2,"PSOE",6
37,"37205",217,177,174,0,3,"PSOE",66
50,"50118",2110,1622,1605,19,17,"PSOE",689
12,"12096",744,588,580,7,8,"PSOE",237
40,"40172",45,37,37,0,0,"PSOE",10
45,"45130",302,241,235,2,6,"PSOE",74
44,"44067",108,82,78,0,4,"PSOE",27
22,"22096",320,274,272,2,2,"PSOE",67
2,"2037",22952,16040,15815,101,225,"PSOE",5071
12,"12003",943,745,731,6,14,"PSOE",154
16,"16242",308,266,263,2,3,"PSOE",68
45,"45131",264,226,225,0,1,"PSOE",80
16,"16101",139,123,122,0,1,"PSOE",56
23,"23065",1550,1199,1186,4,13,"PSOE",568
6,"6078",506,415,410,1,5,"PSOE",126
34,"34081",60,48,48,0,0,"PSOE",10
37,"37049",127,89,89,0,0,"PSOE",26
37,"37091",164,108,108,3,0,"PSOE",22
24,"24070",3941,3007,2947,27,60,"PSOE",1384
31,"31215",4669,3580,3508,35,72,"PSOE",1395
18,"18103",722,556,555,3,1,"PSOE",250
2,"2075",1718,1470,1448,4,22,"PSOE",518
14,"14003",1258,989,968,12,21,"PSOE",431
41,"41901",2703,2242,2201,29,41,"PSOE",1544
40,"40207",800,662,652,6,10,"PSOE",169
2,"2038",266,217,216,1,1,"PSOE",65
41,"41030",500,419,410,6,9,"PSOE",182
26,"26106",76,66,65,0,1,"PSOE",25
38,"38012",2310,1705,1687,6,18,"PSOE",544
12,"12069",53,45,44,1,1,"PSOE",7
50,"50208",1748,1360,1344,11,16,"PSOE",550
23,"23067",2421,1909,1873,13,36,"PSOE",765
18,"18004",687,521,515,4,6,"PSOE",202
9,"9160",80,64,64,1,0,"PSOE",13
45,"45180",2834,2269,2239,11,30,"PSOE",560
10,"10037",76855,60447,59702,451,745,"PSOE",17689
6,"6080",1890,1482,1467,18,15,"PSOE",659
28,"28057",1549,1246,1239,5,7,"PSOE",259
18,"18106",415,300,295,0,5,"PSOE",135
4,"4002",1039,798,792,7,6,"PSOE",380
40,"40210",98,70,70,0,0,"PSOE",14
24,"24194",266,199,199,1,0,"PSOE",120
50,"50209",2747,1993,1975,29,18,"PSOE",549
16,"16104",55,46,46,0,0,"PSOE",19
44,"44172",295,220,218,4,2,"PSOE",73
19,"19099",289,217,214,0,3,"PSOE",84
49,"49200",936,744,726,10,18,"PSOE",238
50,"50122",67,55,54,0,1,"PSOE",14
45,"45136",5825,4314,4260,22,54,"PSOE",1358
5,"5015",68,48,48,1,0,"PSOE",19
39,"39075",136968,104358,103487,690,871,"PSOE",25466
49,"49201",285,243,243,7,0,"PSOE",120
37,"37211",212,164,163,1,1,"PSOE",34
37,"37325",90,70,70,0,0,"PSOE",23
37,"37212",101,85,83,0,2,"PSOE",24
37,"37098",304,214,210,0,4,"PSOE",105
3,"3053",7469,5950,5865,26,85,"PSOE",1236
50,"50123",436,344,338,1,6,"PSOE",153
29,"29045",1681,1263,1242,9,21,"PSOE",381
18,"18108",826,677,669,3,8,"PSOE",305
2,"2042",818,631,620,1,11,"PSOE",289
30,"30028",6400,4364,4289,30,75,"PSOE",1698
14,"14067",3870,3057,2998,24,59,"PSOE",1063
24,"24198",547,402,399,4,3,"PSOE",238
9,"9219",27153,20116,19831,215,285,"PSOE",7375
34,"34234",68,59,57,0,2,"PSOE",12
45,"45092",223,204,204,1,0,"PSOE",67
49,"49003",869,627,624,3,3,"PSOE",174
10,"10124",858,710,701,3,9,"PSOE",342
19,"19001",41,33,33,0,0,"PSOE",4
18,"18109",599,452,448,3,4,"PSOE",176
31,"31100",256,181,178,1,3,"PSOE",32
23,"23071",1720,1348,1330,6,18,"PSOE",553
31,"31223",959,718,711,8,7,"PSOE",228
10,"10042",88,59,59,0,0,"PSOE",30
9,"9060",128,111,111,1,0,"PSOE",28
29,"29046",2540,1896,1855,13,41,"PSOE",788
44,"44112",408,303,293,2,10,"PSOE",110
9,"9388",33,28,28,0,0,"PSOE",11
42,"42004",2294,1807,1767,22,40,"PSOE",545
28,"28136",680,569,563,0,6,"PSOE",162
2,"2044",1049,746,737,5,9,"PSOE",327
4,"4007",731,570,569,0,1,"PSOE",227
38,"38047",1756,1276,1259,6,17,"PSOE",328
24,"24080",207,162,161,0,1,"PSOE",45
34,"34089",140,119,114,2,5,"PSOE",19
19,"19153",22,22,22,0,0,"PSOE",10
45,"45141",849,677,665,4,12,"PSOE",257
16,"16250",65,41,41,0,0,"PSOE",10
6,"6152",1285,952,935,4,17,"PSOE",397
28,"28001",80,64,64,0,0,"PSOE",11
19,"19154",59,48,47,0,1,"PSOE",4
19,"19287",136,107,105,3,2,"PSOE",22
38,"38048",3957,2889,2842,12,47,"PSOE",754
37,"37102",379,297,291,3,6,"PSOE",85
49,"49205",367,286,282,5,4,"PSOE",61
2,"2045",3617,3020,2969,38,51,"PSOE",982
9,"9224",159,135,132,0,3,"PSOE",22
44,"44176",153,124,124,0,0,"PSOE",45
42,"42006",152,115,112,2,3,"PSOE",25
42,"42134",2652,2028,1989,17,39,"PSOE",618
31,"31226",574,380,377,3,3,"PSOE",68
46,"46232",872,714,706,3,8,"PSOE",279
31,"31023",7609,6371,6319,70,52,"PSOE",1408
50,"50271",248,197,189,2,8,"PSOE",41
5,"5258",107,96,96,2,0,"PSOE",21
30,"30032",2851,2256,2218,14,38,"PSOE",701
18,"18011",4376,3286,3248,18,38,"PSOE",1207
37,"37255",42,31,31,2,0,"PSOE",5
37,"37059",117,106,100,0,6,"PSOE",35
24,"24120",311,209,209,0,0,"PSOE",39
40,"40215",83,69,69,0,0,"PSOE",8
45,"45144",740,605,598,7,7,"PSOE",252
10,"10169",494,405,395,1,10,"PSOE",151
50,"50039",467,366,364,3,2,"PSOE",140
29,"29050",398,274,269,2,5,"PSOE",125
34,"34189",53,39,39,1,0,"PSOE",6
29,"29072",3277,2628,2592,16,36,"PSOE",1206
19,"19007",435,328,319,1,9,"PSOE",99
34,"34242",93,66,64,1,2,"PSOE",16
45,"45007",665,549,533,0,16,"PSOE",292
28,"28064",135,110,104,1,6,"PSOE",31
10,"10007",630,513,507,4,6,"PSOE",164
18,"18150",6903,5149,5063,42,86,"PSOE",1782
3,"3090",17881,13593,13437,108,156,"PSOE",3653
33,"33049",6044,4152,4079,56,73,"PSOE",1671
16,"16115",47,35,35,0,0,"PSOE",17
4,"4012",187,163,162,1,1,"PSOE",73
46,"46234",327,264,263,5,1,"PSOE",85
10,"10171",355,261,255,0,6,"PSOE",136
40,"40184",248,205,203,0,2,"PSOE",39
18,"18013",4152,3168,3103,16,65,"PSOE",1144
50,"50130",362,252,249,1,3,"PSOE",86
19,"19291",1131,875,864,1,11,"PSOE",267
4,"4053",12500,9437,9298,56,139,"PSOE",2767
31,"31148",92,67,65,4,2,"PSOE",23
6,"6123",4512,3358,3266,28,92,"PSOE",1479
37,"37108",99,80,78,2,2,"PSOE",16
2,"2086",2426,1738,1728,8,10,"PSOE",847
34,"34096",50,44,44,0,0,"PSOE",16
40,"40185",815,624,618,4,6,"PSOE",171
9,"9068",24,18,18,0,0,"PSOE",6
42,"42011",17,11,11,0,0,"PSOE",2
14,"14074",2237,1859,1839,8,20,"PSOE",922
47,"47231",4458,3677,3651,47,26,"PSOE",943
42,"42187",59,51,49,1,2,"PSOE",4
22,"22162",129,99,99,0,0,"PSOE",27
9,"9446",12,8,8,0,0,"PSOE",2
13,"13077",3399,2447,2380,30,67,"PSOE",870
49,"49011",212,166,165,7,1,"PSOE",24
22,"22039",805,667,662,5,5,"PSOE",250
38,"38053",3763,2628,2588,21,40,"PSOE",708
18,"18015",425,333,333,0,0,"PSOE",158
49,"49214",664,519,510,2,9,"PSOE",156
50,"50217",431,346,344,0,2,"PSOE",164
46,"46145",22099,16685,16499,128,186,"PSOE",4726
23,"23080",1721,1370,1355,8,15,"PSOE",724
12,"12015",114,99,98,0,1,"PSOE",15
28,"28145",2640,2014,1987,11,27,"PSOE",595
49,"49094",213,138,138,0,0,"PSOE",51
31,"31233",93,72,70,1,2,"PSOE",17
46,"46146",1641,1314,1281,11,33,"PSOE",254
19,"19011",236,181,181,0,0,"PSOE",75
37,"37224",189,168,165,0,3,"PSOE",29
9,"9071",40,32,32,0,0,"PSOE",6
31,"31111",91,69,69,1,0,"PSOE",9
44,"44087",68,56,54,0,2,"PSOE",15
38,"38901",1456,1024,1010,9,14,"PSOE",340
5,"5186",1558,1255,1247,9,8,"PSOE",287
49,"49053",915,726,715,5,11,"PSOE",258
44,"44244",68,48,48,4,0,"PSOE",9
38,"38024",15310,10234,10088,82,146,"PSOE",2471
19,"19297",32,27,27,0,0,"PSOE",5
5,"5030",43,36,36,0,0,"PSOE",11
37,"37338",78,66,64,0,2,"PSOE",11
12,"12110",219,168,166,1,2,"PSOE",76
45,"45152",547,448,442,1,6,"PSOE",199
3,"3095",4740,3702,3657,23,45,"PSOE",976
45,"45014",4020,2910,2854,22,56,"PSOE",1179
28,"28069",56,47,45,2,2,"PSOE",6
9,"9235",140,105,102,0,3,"PSOE",37
44,"44088",23,21,21,0,0,"PSOE",6
50,"50045",1198,957,951,3,6,"PSOE",296
4,"4017",1276,907,900,4,7,"PSOE",307
19,"19299",102,78,78,1,0,"PSOE",24
26,"26123",124,112,110,0,2,"PSOE",32
42,"42096",251,164,160,3,4,"PSOE",34
4,"4018",252,215,213,1,2,"PSOE",101
28,"28009",14500,11656,11564,62,92,"PSOE",2751
37,"37027",235,188,184,2,4,"PSOE",50
34,"34904",300,220,220,0,0,"PSOE",89
40,"40190",48,40,39,0,1,"PSOE",4
9,"9407",27,23,23,0,0,"PSOE",5
44,"44183",63,43,43,0,0,"PSOE",17
34,"34058",185,161,161,1,0,"PSOE",61
16,"16083",45,29,28,0,1,"PSOE",4
33,"33025",8996,6369,6309,81,60,"PSOE",2160
47,"47205",355,263,258,3,5,"PSOE",50
22,"22208",194,159,156,1,3,"PSOE",55
22,"22122",65,58,58,3,0,"PSOE",17
41,"41044",7698,5967,5898,59,69,"PSOE",1939
19,"19301",37,31,31,0,0,"PSOE",5
2,"2056",1643,1330,1308,4,22,"PSOE",552
16,"16270",156,124,124,1,0,"PSOE",24
37,"37116",69,51,51,0,0,"PSOE",12
46,"46058",1734,1349,1325,9,24,"PSOE",494
37,"37115",110,81,81,2,0,"PSOE",19
10,"10098",381,310,309,1,1,"PSOE",122
30,"30040",705,600,596,1,4,"PSOE",182
5,"5035",96,78,78,0,0,"PSOE",32
47,"47047",202,164,161,3,3,"PSOE",15
10,"10017",772,595,591,3,4,"PSOE",227
26,"26166",147,136,136,2,0,"PSOE",11
37,"37154",129,106,102,3,4,"PSOE",11
9,"9298",75,62,62,1,0,"PSOE",5
49,"49100",286,210,208,2,2,"PSOE",82
24,"24094",1326,982,966,4,16,"PSOE",264
6,"6131",1063,880,874,5,6,"PSOE",514
6,"6097",2283,1803,1762,10,41,"PSOE",813
5,"5154",34,25,25,1,0,"PSOE",7
45,"45158",2546,2026,2001,9,25,"PSOE",606
41,"41046",3006,2464,2427,13,37,"PSOE",1158
29,"29060",671,511,506,1,5,"PSOE",156
37,"37155",68,52,52,0,0,"PSOE",23
47,"47145",586,446,440,2,6,"PSOE",94
37,"37118",120,93,90,2,3,"PSOE",27
2,"2059",313,252,250,3,2,"PSOE",127
42,"42154",99,81,81,1,0,"PSOE",34
22,"22125",39429,29988,29612,337,376,"PSOE",9852
50,"50137",964,790,781,9,9,"PSOE",312
31,"31118",158,120,116,2,4,"PSOE",25
47,"47049",91,66,64,0,2,"PSOE",17
49,"49225",127,81,81,0,0,"PSOE",17
9,"9355",87,69,67,1,2,"PSOE",5
12,"12142",145,123,121,1,2,"PSOE",26
31,"31037",90,72,72,0,0,"PSOE",3
10,"10101",179,140,138,2,2,"PSOE",57
3,"3100",496,402,395,2,7,"PSOE",109
37,"37232",378,322,321,1,1,"PSOE",68
40,"40194",39191,31175,30785,250,390,"PSOE",9286
9,"9244",45,35,35,0,0,"PSOE",15
26,"26089",111800,87863,86778,700,1085,"PSOE",27228
30,"30043",25401,20378,19992,131,386,"PSOE",4940
18,"18126",1450,1115,1087,11,28,"PSOE",457
40,"40088",268,200,200,0,0,"PSOE",51
46,"46244",59626,44018,43679,342,339,"PSOE",12466
34,"34066",57,52,48,1,4,"PSOE",6
44,"44250",19,15,15,0,0,"PSOE",2
42,"42197",68,56,56,0,0,"PSOE",11
23,"23021",517,446,440,0,6,"PSOE",263
44,"44125",65,50,50,0,0,"PSOE",18
28,"28182",198,169,169,1,0,"PSOE",42
34,"34159",370,247,244,5,3,"PSOE",98
6,"6101",442,359,354,2,5,"PSOE",138
22,"22012",102,81,80,1,1,"PSOE",20
31,"31121",65,51,51,0,0,"PSOE",7
45,"45025",1219,926,913,5,13,"PSOE",329
50,"50225",1532,1072,1064,10,8,"PSOE",333
46,"46154",797,645,630,1,15,"PSOE",106
31,"31243",302,241,237,5,4,"PSOE",45
5,"5119",24,16,16,1,0,"PSOE",2
19,"19078",50,38,37,0,1,"PSOE",31
50,"50140",157,108,108,0,0,"PSOE",25
29,"29064",437,319,315,2,4,"PSOE",123
31,"31122",4946,3915,3882,59,33,"PSOE",861
2,"2062",386,287,285,4,2,"PSOE",125
16,"16276",21,18,18,1,0,"PSOE",8
42,"42023",60,49,48,0,1,"PSOE",10
24,"24222",14431,11296,11135,117,161,"PSOE",3393
5,"5159",228,160,159,2,1,"PSOE",7
44,"44029",579,466,457,3,9,"PSOE",204
49,"49145",210,133,131,1,2,"PSOE",28
46,"46185",364,315,310,1,5,"PSOE",95
39,"39092",871,635,629,2,6,"PSOE",186
12,"12117",3545,2770,2698,11,72,"PSOE",743
24,"24224",574,435,427,3,8,"PSOE",125
37,"37123",162,122,117,3,5,"PSOE",16
34,"34114",198,152,152,0,0,"PSOE",20
16,"16008",83,65,65,0,0,"PSOE",31
49,"49108",454,325,322,2,3,"PSOE",93
44,"44001",65,51,50,0,1,"PSOE",13
9,"9086",661,521,518,5,3,"PSOE",111
5,"5121",262,201,199,0,2,"PSOE",59
9,"9308",62,48,48,0,0,"PSOE",12
41,"41079",9293,7137,6979,80,158,"PSOE",3232
22,"22015",300,232,226,5,6,"PSOE",59
28,"28155",485,414,409,0,5,"PSOE",178
45,"45074",401,335,326,3,9,"PSOE",112
41,"41051",2311,1770,1734,5,36,"PSOE",771
3,"3137",657,484,480,5,4,"PSOE",128
31,"31084",1948,1483,1472,9,11,"PSOE",125
22,"22177",97,81,81,1,0,"PSOE",19
26,"26095",95,78,78,1,0,"PSOE",46
26,"26135",153,123,123,1,0,"PSOE",33
37,"37162",209,156,153,1,3,"PSOE",43
28,"28018",4068,3367,3344,15,23,"PSOE",760
49,"49270",137,111,111,0,0,"PSOE",47
3,"3013",1070,882,869,3,13,"PSOE",292
39,"39066",877,711,705,5,6,"PSOE",202
3,"3074",1750,1433,1427,3,6,"PSOE",328
2,"2066",223,172,169,1,3,"PSOE",72
39,"39010",610,518,512,1,6,"PSOE",147
49,"49110",345,222,220,2,2,"PSOE",67
46,"46158",1040,805,796,4,9,"PSOE",247
44,"44130",27,24,24,0,0,"PSOE",2
40,"40902",117,96,96,1,0,"PSOE",14
52,"52001",54124,34068,33749,237,319,"PSOE",6986
19,"19317",127,98,97,0,1,"PSOE",32
34,"34028",134,110,107,3,3,"PSOE",25
45,"45169",186,135,134,0,1,"PSOE",47
31,"31249",1823,1381,1373,21,8,"PSOE",664
28,"28157",682,530,516,1,14,"PSOE",139
37,"37240",939,694,686,3,8,"PSOE",154
42,"42028",76,65,65,1,0,"PSOE",21
40,"40095",464,379,369,2,10,"PSOE",58
19,"19182",39,32,32,0,0,"PSOE",9
31,"31006",1877,1453,1436,16,17,"PSOE",550
44,"44195",84,66,65,1,1,"PSOE",25
37,"37004",24,19,19,0,0,"PSOE",3
24,"24104",245,173,172,1,1,"PSOE",55
47,"47153",104,76,75,0,1,"PSOE",18
31,"31128",341,255,250,3,5,"PSOE",42
49,"49112",118,78,78,2,0,"PSOE",26
50,"50056",405,332,330,4,2,"PSOE",100
24,"24228",626,432,426,3,6,"PSOE",91
49,"49235",422,312,301,0,11,"PSOE",98
5,"5047",4118,3334,3248,25,86,"PSOE",1180
5,"5165",370,293,285,4,8,"PSOE",83
10,"10112",1518,1168,1151,4,17,"PSOE",439
2,"2069",11414,9019,8883,54,136,"PSOE",2372
6,"6108",2249,1726,1684,22,42,"PSOE",714
10,"10071",124,85,84,0,1,"PSOE",41
4,"4033",125,98,95,0,3,"PSOE",53
42,"42030",89,72,72,0,0,"PSOE",4
31,"31008",63,51,49,1,2,"PSOE",9
49,"49152",483,327,322,2,5,"PSOE",73
24,"24149",146,123,123,0,0,"PSOE",32
46,"46130",857,680,669,6,11,"PSOE",205
22,"22906",174,137,134,5,3,"PSOE",55
26,"26062",86,74,72,1,2,"PSOE",14
50,"50147",751,564,559,3,5,"PSOE",261
37,"37007",399,311,306,3,5,"PSOE",94
12,"12032",23649,17680,17505,118,175,"PSOE",4779
13,"13904",504,394,376,6,18,"PSOE",137
49,"49237",143,95,93,0,2,"PSOE",33
12,"12123",43,35,34,1,1,"PSOE",8
33,"33068",1047,624,620,8,4,"PSOE",280
39,"39014",901,709,704,5,5,"PSOE",162
22,"22020",119,91,87,1,4,"PSOE",25
18,"18033",279,221,220,1,1,"PSOE",93
12,"12002",115,99,97,0,2,"PSOE",34
50,"50234",242,194,187,3,7,"PSOE",49
9,"9100",58,46,46,0,0,"PSOE",4
49,"49192",124,102,102,2,0,"PSOE",43
19,"19323",34,29,29,0,0,"PSOE",9
42,"42120",132,89,87,0,2,"PSOE",25
31,"31011",709,515,511,4,4,"PSOE",96
37,"37131",171,138,137,0,1,"PSOE",27
16,"16016",216,175,174,3,1,"PSOE",67
47,"47156",150,128,128,2,0,"PSOE",24
24,"24902",335,266,263,1,3,"PSOE",96
49,"49239",617,437,420,7,17,"PSOE",194
45,"45176",3841,2992,2952,16,40,"PSOE",747
46,"46072",3542,3008,2961,33,47,"PSOE",818
47,"47061",243,203,197,3,6,"PSOE",66
10,"10197",108,84,84,0,0,"PSOE",32
46,"46163",1856,1522,1501,4,21,"PSOE",324
14,"14002",10859,8215,8078,93,137,"PSOE",3827
16,"16017",340,281,271,2,10,"PSOE",119
44,"44229",143,110,108,4,2,"PSOE",35
41,"41057",253,189,188,0,1,"PSOE",101
12,"12036",546,428,420,9,8,"PSOE",142
9,"9214",641,454,445,5,9,"PSOE",156
16,"16909",661,540,535,1,5,"PSOE",288
31,"31013",626,427,422,5,5,"PSOE",76
42,"42035",741,537,523,7,14,"PSOE",184
33,"33071",563,413,407,2,6,"PSOE",228
9,"9159",61,52,51,0,1,"PSOE",5
16,"16058",97,73,73,0,0,"PSOE",39
37,"37011",99,75,73,0,2,"PSOE",24
26,"26029",36,29,28,0,1,"PSOE",11
22,"22023",389,313,305,6,8,"PSOE",129
19,"19327",397,333,332,0,1,"PSOE",59
9,"9215",365,267,264,1,3,"PSOE",74
41,"41031",1215,866,848,3,18,"PSOE",531
45,"45041",3897,2959,2904,28,55,"PSOE",798
23,"23901",1139,946,934,3,12,"PSOE",471
9,"9055",48,34,34,1,0,"PSOE",7
18,"18003",14413,11095,10883,92,212,"PSOE",3322
4,"4043",511,423,421,3,2,"PSOE",164
37,"37134",212,156,148,0,8,"PSOE",57
5,"5172",116,95,93,0,2,"PSOE",29
31,"31259",476,347,346,0,1,"PSOE",57
24,"24113",351,277,272,2,5,"PSOE",70
18,"18177",373,253,252,1,1,"PSOE",95
2,"2003",133957,105024,104115,786,909,"PSOE",28729
19,"19046",22148,17383,17137,125,246,"PSOE",5488
9,"9105",97,81,76,1,5,"PSOE",24
42,"42173",29702,22141,21776,301,365,"PSOE",8043
46,"46166",8202,6482,6399,39,83,"PSOE",1606
2,"2077",54,45,44,0,1,"PSOE",17
50,"50152",1368,1061,1043,6,18,"PSOE",393
10,"10202",588,469,459,0,10,"PSOE",181
16,"16022",78,70,70,0,0,"PSOE",29
9,"9269",29,25,23,1,2,"PSOE",2
10,"10039",402,302,301,0,1,"PSOE",107
49,"49243",109,86,83,0,3,"PSOE",14
24,"24115",53267,39733,39172,433,561,"PSOE",14584
37,"37173",1420,1077,1058,13,19,"PSOE",348
14,"14006",1321,1155,1127,4,28,"PSOE",381
28,"28166",347,287,286,1,1,"PSOE",85
42,"42175",21,15,15,0,0,"PSOE",0
35,"35017",27216,17531,17102,133,429,"PSOE",4225
42,"42038",34,27,27,1,0,"PSOE",2
5,"5174",65,53,52,1,1,"PSOE",9
22,"22063",159,133,132,2,1,"PSOE",41
47,"47161",3945,3370,3344,20,26,"PSOE",608
40,"40211",69,58,58,1,0,"PSOE",13
35,"35018",13056,8699,8618,73,81,"PSOE",2524
19,"19048",19,13,13,0,0,"PSOE",5
42,"42039",210,147,141,2,6,"PSOE",50
33,"33074",3376,2345,2311,41,34,"PSOE",938
5,"5097",476,332,327,0,5,"PSOE",72
6,"6116",1512,1158,1144,3,14,"PSOE",571
34,"34087",122,105,105,0,0,"PSOE",19
5,"5175",149,122,119,1,3,"PSOE",21
31,"31262",234,201,199,2,2,"PSOE",28
23,"23005",29940,19587,19330,191,257,"PSOE",6883
26,"26034",612,509,497,5,12,"PSOE",210
44,"44013",11250,8525,8420,95,105,"PSOE",2674
14,"14008",2785,1942,1910,15,32,"PSOE",869
16,"16151",64,52,52,0,0,"PSOE",10
6,"6051",1543,1206,1188,3,18,"PSOE",541
29,"29068",7716,5347,5230,58,117,"PSOE",1393
50,"50093",83,66,66,1,0,"PSOE",18
5,"5059",92,63,63,0,0,"PSOE",21
18,"18146",937,690,682,6,8,"PSOE",284
45,"45049",423,340,335,1,5,"PSOE",85
39,"39021",467,392,385,2,7,"PSOE",107
40,"40109",72,59,54,1,5,"PSOE",5
9,"9113",460,369,364,3,5,"PSOE",100
5,"5177",139,117,117,0,0,"PSOE",58
23,"23007",3026,2317,2301,13,16,"PSOE",1068
18,"18042",418,344,340,7,4,"PSOE",118
21,"21002",15922,11918,11773,119,145,"PSOE",3074
29,"29048",1370,1149,1135,10,14,"PSOE",526
6,"6086",1174,869,862,4,7,"PSOE",391
2,"2081",18331,14219,13987,108,232,"PSOE",4393
9,"9440",80,66,66,0,0,"PSOE",25
19,"19052",21,16,16,0,0,"PSOE",11
24,"24119",695,515,501,8,14,"PSOE",193
2,"2082",95,83,83,0,0,"PSOE",33
40,"40214",196,167,163,1,4,"PSOE",40
9,"9275",166,130,130,2,0,"PSOE",32
19,"19335",56,45,43,0,2,"PSOE",25
19,"19003",29,28,28,2,0,"PSOE",15
37,"37058",56,41,41,0,0,"PSOE",7
16,"16027",701,540,531,2,9,"PSOE",192
22,"22156",296,246,242,3,4,"PSOE",78
47,"47038",101,79,79,0,0,"PSOE",24
49,"49249",63,52,52,1,0,"PSOE",7
31,"31144",763,504,503,1,1,"PSOE",52
10,"10209",265,184,184,2,0,"PSOE",88
35,"35021",15014,10909,10792,71,117,"PSOE",2795
28,"28032",5042,4039,3992,23,47,"PSOE",1047
10,"10046",187,154,152,0,2,"PSOE",68
14,"14071",884,641,634,2,7,"PSOE",302
46,"46141",437,367,360,5,7,"PSOE",92
9,"9277",107,92,89,0,3,"PSOE",38
45,"45191",521,449,446,0,3,"PSOE",202
46,"46081",9993,7972,7882,51,90,"PSOE",1969
9,"9443",152,115,112,0,3,"PSOE",26
42,"42045",276,212,209,2,3,"PSOE",58
34,"34190",49,36,36,3,0,"PSOE",5
10,"10210",492,362,358,3,4,"PSOE",206
26,"26039",38,34,34,0,0,"PSOE",10
42,"42046",46,35,33,2,2,"PSOE",7
49,"49128",533,428,424,7,4,"PSOE",156
42,"42009",77,69,69,2,0,"PSOE",13
46,"46142",761,580,565,4,15,"PSOE",169
9,"9227",113,93,91,0,2,"PSOE",33
46,"46173",1319,1084,1062,6,22,"PSOE",270
10,"10089",1328,1014,982,20,32,"PSOE",485
28,"28004",6564,4798,4767,26,31,"PSOE",1230
35,"35023",11694,8785,8607,67,178,"PSOE",2003
40,"40113",408,339,335,6,4,"PSOE",127
50,"50069",67,44,44,0,0,"PSOE",22
45,"45055",998,844,828,4,16,"PSOE",327
24,"24006",487,393,387,3,6,"PSOE",117
6,"6023",4170,3088,3045,18,43,"PSOE",1604
19,"19202",17,13,13,0,0,"PSOE",3
24,"24044",152,116,114,0,2,"PSOE",30
16,"16116",77,59,59,0,0,"PSOE",26
31,"31107",1680,1330,1312,16,18,"PSOE",291
37,"37145",244,187,185,3,2,"PSOE",68
39,"39082",1622,1261,1252,16,9,"PSOE",204
10,"10212",1645,1283,1238,7,45,"PSOE",518
19,"19059",74,53,46,0,7,"PSOE",6
5,"5183",123,104,96,0,8,"PSOE",16
18,"18046",1753,1206,1185,1,21,"PSOE",465
21,"21008",2613,1803,1777,6,26,"PSOE",1022
42,"42049",109,73,72,1,1,"PSOE",12
45,"45010",389,280,280,3,0,"PSOE",132
37,"37063",60,45,45,1,0,"PSOE",15
18,"18151",259,194,193,3,1,"PSOE",90
46,"46175",428,367,354,3,13,"PSOE",82
46,"46114",574,457,452,1,5,"PSOE",114
18,"18117",507,402,396,5,6,"PSOE",186
44,"44211",35,24,24,0,0,"PSOE",12
29,"29076",2335,1661,1614,11,47,"PSOE",642
9,"9124",1432,1078,1054,7,24,"PSOE",417
49,"49012",73,45,45,0,0,"PSOE",15
31,"31150",199,140,139,2,1,"PSOE",20
50,"50071",127,89,88,0,1,"PSOE",8
22,"22040",144,124,120,1,4,"PSOE",36
18,"18048",2462,1873,1832,16,41,"PSOE",743
50,"50247",842,621,616,7,5,"PSOE",179
18,"18153",8796,6686,6594,59,92,"PSOE",1917
10,"10215",413,305,301,2,4,"PSOE",153
40,"40186",34,29,29,0,0,"PSOE",6
45,"45059",1696,1442,1415,4,27,"PSOE",357
19,"19061",53,45,45,0,0,"PSOE",10
49,"49132",313,252,249,0,3,"PSOE",68
24,"24009",278,154,151,2,3,"PSOE",47
26,"26044",51,44,42,0,2,"PSOE",15
22,"22246",71,50,50,0,0,"PSOE",15
44,"44119",119,83,82,0,1,"PSOE",37
9,"9288",88,73,71,1,2,"PSOE",11
19,"19298",55,47,47,0,0,"PSOE",16
46,"46177",4778,3767,3711,17,56,"PSOE",1143
50,"50163",3787,3041,3022,31,19,"PSOE",629
3,"3003",455,395,388,0,7,"PSOE",82
9,"9289",1379,1002,994,9,8,"PSOE",303
34,"34149",21,18,18,0,0,"PSOE",3
47,"47204",235,182,178,0,4,"PSOE",49
6,"6160",3019,2252,2209,10,43,"PSOE",957
44,"44022",463,342,326,6,16,"PSOE",120
22,"22164",43,33,31,0,2,"PSOE",7
24,"24130",418,331,326,0,5,"PSOE",96
9,"9128",78,63,61,1,2,"PSOE",24
40,"40120",196,176,169,0,7,"PSOE",48
47,"47077",237,187,183,2,4,"PSOE",22
37,"37263",338,251,246,0,5,"PSOE",89
40,"40014",56,44,43,2,1,"PSOE",16
29,"29080",6895,5005,4934,59,71,"PSOE",1751
10,"10014",1829,1448,1419,12,29,"PSOE",614
50,"50220",43,37,37,0,0,"PSOE",20
24,"24011",189,122,121,1,1,"PSOE",92
46,"46251",2442,2017,1976,9,41,"PSOE",691
47,"47172",135,119,119,0,0,"PSOE",31
45,"45201",3620,2465,2419,10,46,"PSOE",721
23,"23017",1480,1227,1202,6,25,"PSOE",675
29,"29058",1538,1079,1062,5,17,"PSOE",432
44,"44089",52,44,44,0,0,"PSOE",5
49,"49175",205,150,149,2,1,"PSOE",44
37,"37151",143,112,111,1,1,"PSOE",20
34,"34152",125,104,101,0,3,"PSOE",37
3,"3005",7903,6247,6195,37,52,"PSOE",1441
44,"44024",28,25,24,0,1,"PSOE",4
45,"45064",3998,3166,3117,17,49,"PSOE",848
9,"9131",480,412,402,2,10,"PSOE",148
16,"16165",55,49,48,1,1,"PSOE",21
16,"16040",85,72,72,1,0,"PSOE",7
42,"42055",165,124,122,2,2,"PSOE",39
22,"22080",264,208,202,2,6,"PSOE",50
4,"4060",407,308,304,1,4,"PSOE",80
4,"4061",622,501,494,4,7,"PSOE",240
37,"37030",81,68,65,0,3,"PSOE",16
6,"6030",169,147,146,1,1,"PSOE",65
12,"12052",539,453,439,5,14,"PSOE",125
46,"46089",2170,1692,1672,6,20,"PSOE",430
19,"19302",52,43,41,1,2,"PSOE",11
47,"47174",270,215,208,2,7,"PSOE",60
31,"31035",50,34,32,0,2,"PSOE",16
41,"41045",5854,4287,4200,58,87,"PSOE",1655
9,"9456",137,104,104,0,0,"PSOE",35
16,"16041",339,271,267,2,4,"PSOE",92
40,"40123",141,108,104,1,4,"PSOE",20
46,"46090",1633,1413,1392,5,21,"PSOE",446
9,"9133",38,33,33,0,0,"PSOE",14
13,"13040",841,690,666,2,24,"PSOE",251
40,"40052",72,56,56,0,0,"PSOE",17
34,"34156",50,43,43,0,0,"PSOE",4
21,"21016",993,770,744,6,26,"PSOE",423
37,"37267",182,153,150,1,3,"PSOE",32
50,"50252",5057,3661,3613,36,48,"PSOE",1145
24,"24136",496,375,371,2,4,"PSOE",80
22,"22046",714,592,587,13,5,"PSOE",252
37,"37268",108,72,70,0,2,"PSOE",13
44,"44218",31,25,25,2,0,"PSOE",5
24,"24017",538,427,424,2,3,"PSOE",127
5,"5156",234,153,151,0,2,"PSOE",19
41,"41019",4895,3518,3462,36,56,"PSOE",1321
5,"5904",112,81,81,3,0,"PSOE",16
35,"35003",5582,3441,3391,26,50,"PSOE",780
44,"44124",73,58,57,0,1,"PSOE",27
46,"46254",943,751,734,4,17,"PSOE",260
45,"45160",1095,913,905,2,8,"PSOE",245
22,"22252",118,100,99,0,1,"PSOE",36
13,"13043",209,167,167,1,0,"PSOE",50
10,"10143",141,118,113,1,5,"PSOE",57
50,"50108",52,43,42,0,1,"PSOE",14
40,"40125",75,61,61,2,0,"PSOE",16
5,"5157",235,175,174,2,1,"PSOE",76
42,"42156",29,23,23,0,0,"PSOE",4
10,"10144",920,731,723,4,8,"PSOE",299
42,"42106",14,12,12,0,0,"PSOE",2
37,"37346",252,214,213,3,1,"PSOE",49
49,"49104",335,245,240,1,5,"PSOE",73
44,"44096",153,120,112,1,8,"PSOE",41
50,"50079",227,182,178,1,4,"PSOE",72
22,"22173",218,162,160,1,2,"PSOE",56
24,"24178",72,65,65,1,0,"PSOE",23
29,"29086",774,537,532,1,5,"PSOE",241
16,"16171",1749,1449,1422,6,27,"PSOE",561
47,"47021",72,63,63,0,0,"PSOE",14
6,"6134",530,337,331,3,6,"PSOE",157
5,"5079",68,56,56,0,0,"PSOE",6
3,"3010",336,295,280,0,15,"PSOE",69
34,"34160",134,114,112,0,2,"PSOE",53
6,"6135",1096,915,902,3,13,"PSOE",289
22,"22174",462,381,377,0,4,"PSOE",130
28,"28046",4776,3944,3912,22,32,"PSOE",860
24,"24059",821,575,572,3,3,"PSOE",300
42,"42062",20,14,13,0,1,"PSOE",6
42,"42200",76,54,53,0,1,"PSOE",8
5,"5080",44,31,29,0,2,"PSOE",7
23,"23056",3062,2332,2281,13,51,"PSOE",930
37,"37196",72,56,53,0,3,"PSOE",17
26,"26093",48,38,38,0,0,"PSOE",18
24,"24142",24730,18823,18504,201,319,"PSOE",6164
47,"47179",373,275,273,1,2,"PSOE",74
42,"42201",23,20,20,0,0,"PSOE",7
3,"3011",8014,5870,5810,38,60,"PSOE",1728
31,"31042",2695,2071,2043,21,28,"PSOE",910
6,"6136",1510,1189,1160,7,29,"PSOE",583
37,"37160",606,431,418,6,13,"PSOE",147
28,"28016",78,62,61,1,1,"PSOE",14
22,"22176",170,136,135,0,1,"PSOE",29
40,"40092",113,86,84,2,2,"PSOE",24
5,"5042",141,117,116,0,1,"PSOE",23
13,"13094",290,227,227,1,0,"PSOE",75
28,"28089",3842,3087,3048,12,39,"PSOE",706
47,"47180",57,46,46,1,0,"PSOE",7
9,"9249",50,39,39,0,0,"PSOE",12
16,"16278",63,51,51,0,0,"PSOE",25
28,"28123",61103,52177,51832,338,345,"PSOE",14718
42,"42064",85,71,71,0,0,"PSOE",31
22,"22087",58,47,47,0,0,"PSOE",9
4,"4029",8819,6149,6073,45,76,"PSOE",2328
16,"16175",5079,4279,4207,40,72,"PSOE",1748
6,"6071",238,197,193,0,4,"PSOE",104
3,"3043",2899,2466,2434,21,32,"PSOE",794
49,"49232",84,71,70,0,1,"PSOE",25
38,"38004",4490,3242,3202,18,40,"PSOE",974
37,"37198",203,163,162,3,1,"PSOE",50
47,"47055",192,157,154,1,3,"PSOE",56
10,"10149",434,308,304,2,4,"PSOE",150
18,"18167",1850,1330,1317,17,13,"PSOE",598
46,"46218",1031,907,885,6,22,"PSOE",165
22,"22221",90,58,56,0,2,"PSOE",5
26,"26175",47,40,40,2,0,"PSOE",14
13,"13051",336,272,271,1,1,"PSOE",111
40,"40200",38,32,31,0,1,"PSOE",12
9,"9143",27,18,18,0,0,"PSOE",3
19,"19086",1392,1095,1083,7,12,"PSOE",426
22,"22904",761,581,566,2,15,"PSOE",179
49,"49149",365,285,282,2,3,"PSOE",61
21,"21061",5089,3358,3290,42,68,"PSOE",1377
13,"13052",6313,4844,4762,38,82,"PSOE",1581
3,"3106",564,485,479,4,6,"PSOE",156
19,"19087",17,14,14,0,0,"PSOE",6
5,"5085",30,27,27,0,0,"PSOE",2
22,"22054",1617,1196,1183,15,13,"PSOE",295
34,"34029",659,557,551,5,6,"PSOE",107
50,"50084",66,47,47,0,0,"PSOE",15
29,"29002",1150,851,842,4,9,"PSOE",377
37,"37085",5002,3994,3951,40,43,"PSOE",910
33,"33004",65515,48686,48245,511,441,"PSOE",15870
28,"28020",169,110,109,0,1,"PSOE",22
18,"18170",324,225,224,1,1,"PSOE",113
46,"46220",48968,35430,34964,306,466,"PSOE",9865
44,"44064",63,49,48,0,1,"PSOE",11
34,"34169",381,314,309,6,5,"PSOE",52
42,"42207",47,41,41,0,0,"PSOE",8
18,"18064",366,307,306,0,1,"PSOE",144
6,"6140",611,515,506,1,9,"PSOE",146
28,"28159",594,493,491,5,2,"PSOE",125
45,"45080",3,3,3,0,0,"PSOE",0
37,"37278",789,618,613,8,5,"PSOE",142
16,"16185",35,29,29,0,0,"PSOE",12
40,"40134",697,560,548,7,12,"PSOE",185
24,"24027",1219,913,886,8,27,"PSOE",344
38,"38007",1625,1124,1104,2,20,"PSOE",366
5,"5048",106,98,94,1,4,"PSOE",26
37,"37087",910,755,747,3,8,"PSOE",138
40,"40203",958,801,788,6,13,"PSOE",229
44,"44261",722,584,578,8,6,"PSOE",249
5,"5166",160,128,123,1,5,"PSOE",20
47,"47154",146,122,118,2,4,"PSOE",19
26,"26179",41,33,32,0,1,"PSOE",14
22,"22907",1444,1149,1137,12,12,"PSOE",367
18,"18066",2108,1537,1525,9,12,"PSOE",803
3,"3017",379,321,311,1,10,"PSOE",112
24,"24151",445,334,328,3,6,"PSOE",105
10,"10114",962,754,737,2,17,"PSOE",366
16,"16239",118,89,88,0,1,"PSOE",47
42,"42209",135,107,100,5,7,"PSOE",30
22,"22184",168,142,139,2,3,"PSOE",41
13,"13011",4506,3111,3044,29,67,"PSOE",1355
22,"22186",191,165,164,2,1,"PSOE",73
9,"9259",227,198,197,2,1,"PSOE",51
49,"49153",151,110,108,0,2,"PSOE",38
42,"42166",57,49,49,0,0,"PSOE",8
47,"47059",97,75,75,0,0,"PSOE",18
3,"3048",4971,3808,3739,19,69,"PSOE",834
19,"19187",42,36,36,0,0,"PSOE",13
44,"44167",39,30,30,0,0,"PSOE",7
9,"9375",42,38,38,0,0,"PSOE",6
47,"47091",74,64,63,1,1,"PSOE",26
40,"40030",428,357,350,3,7,"PSOE",138
21,"21030",1879,1523,1504,14,19,"PSOE",750
16,"16188",77,56,56,0,0,"PSOE",24
22,"22187",294,244,243,2,1,"PSOE",59
13,"13013",7050,5475,5371,39,104,"PSOE",1679
5,"5090",77,70,69,0,1,"PSOE",18
33,"33009",869,595,591,5,4,"PSOE",180
4,"4076",1221,951,933,8,18,"PSOE",454
26,"26065",58,49,47,0,2,"PSOE",8
9,"9001",30,27,27,0,0,"PSOE",11
44,"44068",643,518,511,9,7,"PSOE",168
18,"18068",1606,1293,1277,11,16,"PSOE",385
24,"24153",233,187,183,1,4,"PSOE",65
6,"6045",476,368,362,3,6,"PSOE",180
6,"6145",899,744,723,1,21,"PSOE",348
50,"50264",147,122,120,0,2,"PSOE",52
46,"46194",15813,11654,11511,83,143,"PSOE",3385
34,"34177",176,154,152,2,2,"PSOE",43
19,"19189",115,93,92,0,1,"PSOE",35
4,"4038",3110,2235,2203,23,32,"PSOE",804
47,"47062",157,134,134,0,0,"PSOE",13
46,"46073",1077,867,862,10,5,"PSOE",322
40,"40103",146,125,123,0,2,"PSOE",33
39,"39101",236,173,171,1,2,"PSOE",39
37,"37171",397,297,292,1,5,"PSOE",50
39,"39017",553,416,409,0,7,"PSOE",35
26,"26030",17,17,17,0,0,"PSOE",2
50,"50265",74,56,56,0,0,"PSOE",14
34,"34037",276,224,223,2,1,"PSOE",37
47,"47189",151,126,123,0,3,"PSOE",34
40,"40208",720,592,585,4,7,"PSOE",143
9,"9381",33,25,25,0,0,"PSOE",2
19,"19280",3611,2805,2767,25,38,"PSOE",693
28,"28026",6703,5422,5367,21,55,"PSOE",1035
44,"44071",585,449,447,6,2,"PSOE",145
49,"49036",508,361,355,6,6,"PSOE",127
24,"24156",220,146,144,2,2,"PSOE",45
46,"46135",9827,7928,7883,44,45,"PSOE",1833
18,"18037",528,435,426,2,9,"PSOE",142
40,"40033",67,57,57,1,0,"PSOE",9
21,"21034",1159,863,845,4,18,"PSOE",373
47,"47190",95,81,81,1,0,"PSOE",15
9,"9163",578,490,481,5,9,"PSOE",136
31,"31178",472,354,348,3,6,"PSOE",144
18,"18070",289,224,222,3,2,"PSOE",77
22,"22190",122,89,89,0,0,"PSOE",40
30,"30027",49767,39111,38724,245,387,"PSOE",9262
26,"26108",290,241,237,0,4,"PSOE",53
45,"45043",783,670,664,6,6,"PSOE",228
24,"24157",2545,2028,1972,25,56,"PSOE",500
2,"2005",545,443,436,5,7,"PSOE",147
22,"22105",101,82,82,4,0,"PSOE",33
11,"11017",3194,2265,2221,38,44,"PSOE",1015
23,"23038",3785,3182,3162,16,20,"PSOE",982
46,"46015",7477,5857,5808,33,49,"PSOE",1556
3,"3116",1159,901,884,3,17,"PSOE",213
42,"42218",75,52,51,0,1,"PSOE",11
28,"28102",891,681,666,4,15,"PSOE",260
5,"5135",398,324,320,2,4,"PSOE",75
31,"31179",483,348,344,2,4,"PSOE",134
2,"2006",561,482,480,2,2,"PSOE",180
50,"50092",300,234,230,1,4,"PSOE",99
37,"37287",309,215,214,3,1,"PSOE",50
22,"22064",162,121,121,0,0,"PSOE",50
49,"49039",327,255,246,6,9,"PSOE",67
44,"44111",78,64,64,1,0,"PSOE",27
3,"3117",377,320,313,1,7,"PSOE",75
42,"42176",27,22,22,2,0,"PSOE",3
12,"12101",356,297,289,2,8,"PSOE",91
41,"41006",2738,1971,1945,16,26,"PSOE",1112
18,"18180",627,442,435,4,7,"PSOE",228
45,"45093",154,124,123,0,1,"PSOE",31
44,"44143",394,327,327,2,0,"PSOE",131
10,"10001",283,233,232,3,1,"PSOE",128
46,"46108",426,346,342,1,4,"PSOE",146
37,"37213",83,65,64,0,1,"PSOE",9
46,"46199",5842,4451,4414,23,37,"PSOE",1190
47,"47162",68,55,55,0,0,"PSOE",7
30,"30029",12055,9003,8882,58,121,"PSOE",2955
47,"47143",110,78,78,1,0,"PSOE",16
12,"12102",521,442,434,2,8,"PSOE",196
40,"40144",18,16,16,0,0,"PSOE",0
4,"4084",341,258,255,0,3,"PSOE",95
29,"29903",493,358,354,6,4,"PSOE",159
10,"10125",862,655,639,4,16,"PSOE",276
2,"2008",1123,857,842,9,15,"PSOE",347
13,"13023",8950,6359,6271,76,88,"PSOE",1252
50,"50269",279,189,186,1,3,"PSOE",62
13,"13024",891,636,628,2,8,"PSOE",237
31,"31264",177,107,105,2,2,"PSOE",9
26,"26036",17013,12543,12354,95,189,"PSOE",3663
46,"46170",3408,2769,2720,16,49,"PSOE",947
49,"49087",483,322,320,2,2,"PSOE",66
47,"47133",2776,2317,2292,28,25,"PSOE",622
5,"5101",277,224,222,0,2,"PSOE",33
13,"13025",296,260,256,1,4,"PSOE",105
19,"19242",77,67,67,0,0,"PSOE",3
50,"50094",1518,1172,1155,20,17,"PSOE",433
6,"6053",590,461,444,7,17,"PSOE",257
39,"39022",969,740,732,2,8,"PSOE",133
33,"33047",1074,841,835,12,6,"PSOE",277
24,"24202",7559,5449,5363,63,86,"PSOE",2228
3,"3057",177,148,147,0,1,"PSOE",41
37,"37141",152,120,119,2,1,"PSOE",50
37,"37019",140,118,117,1,1,"PSOE",18
31,"31185",470,335,332,6,3,"PSOE",51
28,"28033",4082,3172,3140,13,32,"PSOE",691
42,"42087",51,45,44,1,1,"PSOE",8
5,"5022",1571,1295,1282,5,13,"PSOE",209
22,"22035",226,174,174,0,0,"PSOE",86
31,"31901",15510,12225,12133,114,92,"PSOE",3383
18,"18043",130,93,93,0,0,"PSOE",14
49,"49007",365,271,265,7,6,"PSOE",114
37,"37060",280,224,224,0,0,"PSOE",60
13,"13027",3223,2343,2309,22,34,"PSOE",964
30,"30002",9735,7319,7227,33,92,"PSOE",1818
46,"46020",3792,3028,2973,11,55,"PSOE",879
34,"34001",39,32,32,3,0,"PSOE",8
41,"41009",1167,820,805,4,15,"PSOE",367
34,"34050",185,156,156,2,0,"PSOE",50
13,"13028",10273,8434,8273,42,161,"PSOE",2728
10,"10129",348,263,250,0,13,"PSOE",126
44,"44209",815,606,592,2,14,"PSOE",188
37,"37257",49,40,40,1,0,"PSOE",7
50,"50244",191,153,150,1,3,"PSOE",43
41,"41038",102179,76348,75425,819,923,"PSOE",26918
49,"49208",364,260,255,5,5,"PSOE",34
37,"37333",202,138,137,4,1,"PSOE",33
45,"45008",142,121,121,0,0,"PSOE",58
19,"19246",42,30,30,0,0,"PSOE",14
50,"50187",56,43,43,0,0,"PSOE",18
18,"18184",2170,1688,1656,3,32,"PSOE",739
28,"28035",1394,1057,1043,3,14,"PSOE",308
3,"3029",244,174,167,1,7,"PSOE",53
44,"44047",229,125,124,2,1,"PSOE",47
46,"46052",508,436,426,3,10,"PSOE",153
40,"40008",45,37,37,0,0,"PSOE",11
46,"46174",949,789,770,4,19,"PSOE",288
5,"5144",66,51,51,0,0,"PSOE",17
50,"50160",2150,1652,1619,14,33,"PSOE",731
9,"9229",183,136,136,2,0,"PSOE",46
49,"49169",34,28,26,0,2,"PSOE",8
26,"26078",86,71,70,1,1,"PSOE",29
45,"45148",275,209,209,1,0,"PSOE",69
19,"19112",53,41,40,1,1,"PSOE",10
16,"16073",188,159,155,0,4,"PSOE",65
31,"31906",2683,2040,2023,28,17,"PSOE",487
24,"24087",586,469,460,4,9,"PSOE",79
23,"23077",611,483,479,0,4,"PSOE",251
28,"28005",136050,108267,107316,772,951,"PSOE",32505
31,"31231",108,73,70,1,3,"PSOE",30
18,"18152",906,692,686,1,6,"PSOE",500
37,"37222",86,64,62,0,2,"PSOE",15
45,"45149",539,448,440,0,8,"PSOE",150
45,"45104",421,340,335,1,5,"PSOE",165
33,"33021",4361,3098,3043,31,55,"PSOE",1139
34,"34201",171,139,139,0,0,"PSOE",36
24,"24168",439,365,360,3,5,"PSOE",118
16,"16206",196,146,144,3,2,"PSOE",55
33,"33022",813,555,543,6,12,"PSOE",235
18,"18188",1648,1295,1276,4,19,"PSOE",667
9,"9179",38,32,32,0,0,"PSOE",5
16,"16078",41517,31810,31486,340,324,"PSOE",10838
24,"24008",9025,6803,6702,79,101,"PSOE",1603
34,"34055",263,214,213,3,1,"PSOE",58
24,"24088",995,813,802,12,11,"PSOE",211
24,"24169",2809,2165,2146,18,19,"PSOE",991
28,"28068",11554,9122,9022,44,100,"PSOE",2095
16,"16264",390,338,328,2,10,"PSOE",124
46,"46237",7148,5537,5472,36,65,"PSOE",1630
10,"10053",279,226,224,5,2,"PSOE",86
50,"50191",445,341,337,2,4,"PSOE",128
10,"10216",1522,1195,1167,9,28,"PSOE",424
39,"39056",2268,1847,1830,7,17,"PSOE",372
21,"21048",313,243,237,4,6,"PSOE",119
9,"9180",133,104,99,1,5,"PSOE",30
26,"26081",15,14,14,1,0,"PSOE",1
46,"46025",2455,2002,1981,6,21,"PSOE",559
31,"31234",149,115,114,0,1,"PSOE",31
16,"16121",233,183,179,0,4,"PSOE",76
5,"5149",100,82,79,0,3,"PSOE",17
37,"37339",308,227,226,0,1,"PSOE",62
24,"24170",1839,1417,1391,7,26,"PSOE",559
47,"47109",171,130,130,1,0,"PSOE",50
42,"42095",1857,1498,1473,21,25,"PSOE",442
41,"41015",5401,3984,3889,50,95,"PSOE",1603
45,"45107",3423,2806,2770,18,36,"PSOE",805
24,"24051",394,290,283,3,7,"PSOE",84
3,"3034",1391,1107,1090,7,17,"PSOE",312
34,"34903",183,128,128,1,0,"PSOE",28
46,"46087",109,98,98,1,0,"PSOE",44
47,"47045",734,601,590,5,11,"PSOE",217
9,"9182",76,65,64,0,1,"PSOE",12
37,"37188",160,115,112,3,3,"PSOE",30
45,"45108",482,385,382,0,3,"PSOE",153
2,"2019",2368,2009,1975,5,34,"PSOE",866
34,"34012",340,271,265,2,6,"PSOE",74
9,"9350",430,340,339,9,1,"PSOE",50
30,"30039",20191,14552,14380,96,172,"PSOE",3275
22,"22119",1256,963,954,5,9,"PSOE",343
5,"5046",39,37,37,0,0,"PSOE",14
29,"29024",372,265,250,3,15,"PSOE",118
46,"46149",344,260,256,2,4,"PSOE",56
6,"6162",2895,2289,2254,11,35,"PSOE",989
50,"50046",167,134,130,3,4,"PSOE",29
22,"22249",118,93,93,2,0,"PSOE",25
9,"9239",47,39,39,0,0,"PSOE",8
6,"6063",2938,2299,2264,11,35,"PSOE",1257
34,"34154",76,59,58,0,1,"PSOE",11
37,"37303",181,137,137,1,0,"PSOE",46
13,"13039",14212,10929,10761,107,168,"PSOE",3568
21,"21051",221,180,177,1,3,"PSOE",83
31,"31196",31,28,28,0,0,"PSOE",5
6,"6901",2117,1686,1655,17,31,"PSOE",690
42,"42098",9,8,8,0,0,"PSOE",3
28,"28083",9665,7794,7737,56,57,"PSOE",1906
9,"9076",24,17,17,1,0,"PSOE",3
46,"46150",1797,1275,1257,9,18,"PSOE",360
5,"5190",53,47,47,1,0,"PSOE",1
22,"22008",155,127,125,0,2,"PSOE",36
34,"34210",103,90,90,1,0,"PSOE",27
3,"3067",93,87,87,0,0,"PSOE",30
13,"13086",162,139,136,1,3,"PSOE",59
46,"46120",1183,958,936,3,22,"PSOE",286
50,"50223",916,751,745,13,6,"PSOE",378
9,"9410",2999,2175,2135,27,40,"PSOE",987
28,"28150",3187,2640,2604,20,36,"PSOE",512
3,"3131",179,147,139,0,8,"PSOE",33
41,"41018",9410,6987,6882,52,105,"PSOE",3503
22,"22251",334,269,263,4,6,"PSOE",66
45,"45113",1797,1300,1281,6,19,"PSOE",414
3,"3038",335,275,267,1,8,"PSOE",95
24,"24056",2762,2062,2013,24,49,"PSOE",755
9,"9033",81,69,68,1,1,"PSOE",18
46,"46121",111,96,94,2,2,"PSOE",25
47,"47080",35,23,21,0,2,"PSOE",2
13,"13088",589,439,429,1,10,"PSOE",188
5,"5077",158,133,131,1,2,"PSOE",35
49,"49139",153,111,110,1,1,"PSOE",30
28,"28151",3251,2483,2450,11,33,"PSOE",718
2,"2060",1280,1039,1020,5,19,"PSOE",296
26,"26128",96,74,74,1,0,"PSOE",38
49,"49226",239,207,200,3,7,"PSOE",66
39,"39090",772,619,609,1,10,"PSOE",103
33,"33059",4403,3007,2942,42,65,"PSOE",985
24,"24096",108,69,69,0,0,"PSOE",26
38,"38030",1945,1430,1420,6,10,"PSOE",508
40,"40160",93,72,72,0,0,"PSOE",10
6,"6067",1915,1393,1370,7,23,"PSOE",550
24,"24097",204,155,155,7,0,"PSOE",38
45,"45023",2248,1799,1784,16,15,"PSOE",512
37,"37382",164,135,134,0,1,"PSOE",57
4,"4064",2879,2196,2179,12,17,"PSOE",619
49,"49142",249,175,173,0,2,"PSOE",82
22,"22127",529,434,432,4,2,"PSOE",121
35,"35004",41728,23957,23683,219,274,"PSOE",7551
26,"26017",354,293,290,4,3,"PSOE",120
44,"44059",550,446,437,7,9,"PSOE",138
2,"2025",7355,5864,5693,30,171,"PSOE",1467
26,"26130",201,164,163,0,1,"PSOE",36
50,"50283",69,53,52,3,1,"PSOE",17
3,"3134",141,119,117,0,2,"PSOE",37
49,"49105",136,105,103,1,2,"PSOE",24
40,"40091",108,93,93,1,0,"PSOE",23
28,"28045",35264,27864,27597,180,267,"PSOE",6921
14,"14054",13796,11042,10799,102,243,"PSOE",3849
34,"34110",82,66,65,0,1,"PSOE",31
22,"22254",1094,857,850,11,7,"PSOE",333
50,"50198",49,43,43,1,0,"PSOE",18
10,"10064",1409,1103,1072,6,31,"PSOE",464
22,"22128",192,155,154,2,1,"PSOE",40
19,"19308",60,57,57,1,0,"PSOE",28
24,"24099",155,121,121,1,0,"PSOE",39
6,"6102",1019,852,842,2,10,"PSOE",431
12,"12037",17,17,17,1,0,"PSOE",6
45,"45164",172,143,143,1,0,"PSOE",45
46,"46216",5252,4291,4263,23,28,"PSOE",870
34,"34068",29,24,23,0,1,"PSOE",4
5,"5236",106,77,77,0,0,"PSOE",26
3,"3042",1462,1025,1008,3,17,"PSOE",248
16,"16227",108,85,85,1,0,"PSOE",29
16,"16092",154,113,112,0,1,"PSOE",25
49,"49065",1073,789,777,3,12,"PSOE",199
24,"24100",754,602,598,7,4,"PSOE",158
37,"37037",107,86,86,0,0,"PSOE",13
39,"39037",2019,1572,1560,2,12,"PSOE",324
10,"10066",161,141,137,0,4,"PSOE",53
2,"2065",443,373,370,0,3,"PSOE",146
37,"37236",127,90,86,0,4,"PSOE",25
37,"37349",103,69,68,0,1,"PSOE",12
40,"40093",76,68,67,0,1,"PSOE",11
11,"11041",9858,6916,6763,70,153,"PSOE",2436
47,"47085",16381,12697,12540,129,157,"PSOE",3723
9,"9473",87,76,73,0,3,"PSOE",16
16,"16228",176,150,150,1,0,"PSOE",27
50,"50054",56,48,47,0,1,"PSOE",13
9,"9251",365,278,277,0,1,"PSOE",55
49,"49147",249,197,196,1,1,"PSOE",60
34,"34116",55,45,45,0,0,"PSOE",10
10,"10190",521,372,361,2,11,"PSOE",135
4,"4069",4757,3633,3588,25,45,"PSOE",1311
12,"12028",12955,10391,10301,68,90,"PSOE",2355
45,"45122",5516,4611,4561,28,50,"PSOE",1267
26,"26021",2752,2132,2105,10,27,"PSOE",617
9,"9090",50,45,45,2,0,"PSOE",2
49,"49067",336,236,232,0,4,"PSOE",71
31,"31004",32,26,26,0,0,"PSOE",4
28,"28019",1269,990,981,4,9,"PSOE",355
34,"34071",161,138,138,0,0,"PSOE",25
4,"4031",2249,1778,1773,2,5,"PSOE",916
16,"16050",220,182,179,1,3,"PSOE",64
42,"42027",73,63,63,0,0,"PSOE",18
19,"19181",55,47,46,1,1,"PSOE",13
10,"10191",523,406,398,3,8,"PSOE",144
41,"41025",2019,1492,1439,7,53,"PSOE",537
49,"49068",435,287,286,1,1,"PSOE",69
10,"10151",198,161,157,2,4,"PSOE",75
16,"16095",81,69,68,1,1,"PSOE",18
16,"16236",865,669,665,2,4,"PSOE",172
33,"33035",11226,8326,8252,112,74,"PSOE",2618
12,"12029",673,566,556,3,10,"PSOE",198
6,"6095",9511,7338,7152,116,186,"PSOE",3299
34,"34121",183,155,151,1,4,"PSOE",11
37,"37086",104,88,88,0,0,"PSOE",20
24,"24065",2175,1695,1660,18,35,"PSOE",506
31,"31007",126,101,95,3,6,"PSOE",19
37,"37005",67,48,48,2,0,"PSOE",10
28,"28126",47,35,35,0,0,"PSOE",12
3,"3140",26027,19805,19438,230,367,"PSOE",5744
23,"23061",7691,5636,5531,51,105,"PSOE",2537
46,"46190",50023,37273,36976,250,297,"PSOE",10192
41,"41063",2713,1988,1944,17,44,"PSOE",843
9,"9257",86,74,71,0,3,"PSOE",6
13,"13902",449,362,360,2,2,"PSOE",143
45,"45171",1326,1032,1013,6,19,"PSOE",349
3,"3046",1619,1213,1190,17,23,"PSOE",337
12,"12122",767,655,646,3,9,"PSOE",161
18,"18032",242,180,178,2,2,"PSOE",57
40,"40904",341,302,300,4,2,"PSOE",49
16,"16140",19,16,16,0,0,"PSOE",13
22,"22055",310,258,255,2,3,"PSOE",93
37,"37006",117,81,81,2,0,"PSOE",17
31,"31130",322,237,235,7,2,"PSOE",29
50,"50057",1332,1001,986,10,15,"PSOE",274
37,"37242",80,65,64,1,1,"PSOE",13
39,"39013",535,434,431,1,3,"PSOE",77
13,"13056",11657,9236,9142,85,94,"PSOE",3123
19,"19136",12,12,12,0,0,"PSOE",6
3,"3901",1109,827,820,5,7,"PSOE",191
18,"18910",730,491,487,0,4,"PSOE",179
44,"44105",69,54,54,1,0,"PSOE",22
29,"29038",18683,12820,12666,168,154,"PSOE",4219
44,"44066",87,66,65,0,1,"PSOE",36
24,"24188",3820,3107,3056,33,51,"PSOE",989
39,"39070",123,101,99,0,2,"PSOE",24
50,"50176",222,161,156,3,5,"PSOE",61
39,"39042",5930,4722,4676,26,46,"PSOE",994
40,"40905",128,101,100,4,1,"PSOE",10
16,"16187",55,43,43,0,0,"PSOE",13
24,"24108",348,268,265,2,3,"PSOE",59
41,"41101",6016,4524,4480,42,44,"PSOE",1939
42,"42167",236,183,182,3,1,"PSOE",46
31,"31254",1920,1457,1435,8,22,"PSOE",545
3,"3079",18403,14632,14382,114,250,"PSOE",3845
10,"10156",100,78,78,0,0,"PSOE",41
50,"50205",74,58,57,0,1,"PSOE",28
5,"5245",348,295,290,3,5,"PSOE",58
19,"19142",249,178,177,1,1,"PSOE",61
10,"10034",336,269,267,0,2,"PSOE",121
18,"18912",1367,990,984,5,6,"PSOE",536
23,"23064",1678,1413,1404,10,9,"PSOE",657
18,"18140",42374,29390,29025,221,365,"PSOE",9724
9,"9902",446,345,341,0,4,"PSOE",81
42,"42168",108,85,85,1,0,"PSOE",27
39,"39100",849,650,644,9,6,"PSOE",113
46,"46224",154,124,124,2,0,"PSOE",30
34,"34229",58,42,40,1,2,"PSOE",9
50,"50206",453,371,370,5,1,"PSOE",105
19,"19143",1754,1422,1402,11,20,"PSOE",409
28,"28055",907,671,666,5,5,"PSOE",242
29,"29041",3599,2570,2532,22,38,"PSOE",756
49,"49240",185,141,136,0,5,"PSOE",38
46,"46904",805,643,628,13,15,"PSOE",173
47,"47188",99,77,77,0,0,"PSOE",21
50,"50061",193,173,169,1,4,"PSOE",74
31,"31134",175,130,128,1,2,"PSOE",28
6,"6112",383,334,334,1,0,"PSOE",155
49,"49117",437,340,335,1,5,"PSOE",112
37,"37247",173,144,143,1,1,"PSOE",26
18,"18913",781,590,577,5,13,"PSOE",159
4,"4078",1110,819,814,2,5,"PSOE",322
31,"31095",72,61,60,0,1,"PSOE",14
16,"16019",185,147,147,0,0,"PSOE",42
5,"5013",847,708,701,0,7,"PSOE",255
14,"14034",304,246,239,1,7,"PSOE",79
19,"19009",247,190,187,0,3,"PSOE",62
5,"5133",67,48,48,0,0,"PSOE",17
44,"44171",182,130,128,0,2,"PSOE",30
34,"34082",80,68,68,0,0,"PSOE",23
22,"22230",288,229,228,3,1,"PSOE",73
26,"26031",98,89,87,0,2,"PSOE",30
24,"24033",205,146,146,3,0,"PSOE",28
3,"3082",12936,9025,8931,57,94,"PSOE",2507
19,"19192",1759,1367,1360,3,7,"PSOE",423
49,"49242",444,364,359,3,5,"PSOE",91
18,"18143",949,757,740,5,17,"PSOE",292
19,"19281",18,17,17,3,0,"PSOE",5
18,"18005",362,268,265,0,3,"PSOE",145
10,"10162",528,430,424,2,6,"PSOE",249
26,"26147",34,30,29,0,1,"PSOE",18
46,"46075",147,136,134,2,2,"PSOE",33
49,"49082",343,288,286,8,2,"PSOE",115
46,"46136",2619,2030,2003,24,27,"PSOE",581
12,"12007",731,649,642,8,7,"PSOE",127
39,"39019",2229,1785,1751,15,34,"PSOE",374
49,"49121",368,269,266,1,3,"PSOE",72
5,"5056",94,83,83,0,0,"PSOE",13
26,"26109",73,66,66,0,0,"PSOE",25
18,"18915",731,539,532,1,7,"PSOE",311
22,"22233",80,50,50,0,0,"PSOE",25
47,"47223",152,123,120,2,3,"PSOE",38
29,"29012",9718,7243,7123,47,120,"PSOE",3126
41,"41033",4965,3634,3580,27,54,"PSOE",1680
46,"46046",884,654,643,3,11,"PSOE",116
9,"9386",55,49,49,0,0,"PSOE",2
26,"26149",45,36,36,0,0,"PSOE",18
41,"41005",9250,6925,6809,69,116,"PSOE",2699
31,"31139",155,105,105,0,0,"PSOE",18
24,"24158",296,226,220,2,6,"PSOE",59
6,"6149",10203,8194,8051,72,143,"PSOE",3027
9,"9272",259,197,195,2,2,"PSOE",59
46,"46077",7344,5873,5761,49,112,"PSOE",2002
38,"38046",9271,7297,7212,53,85,"PSOE",1660
46,"46138",360,305,303,2,2,"PSOE",92
45,"45139",145,118,117,1,1,"PSOE",63
10,"10164",720,474,461,3,13,"PSOE",218
13,"13067",342,298,295,0,3,"PSOE",154
4,"4006",7218,5002,4940,33,62,"PSOE",1462
16,"16025",25,21,21,0,0,"PSOE",5
22,"22234",745,587,578,11,9,"PSOE",170
9,"9168",272,222,216,3,6,"PSOE",101
24,"24025",289,234,226,4,8,"PSOE",40
10,"10178",729,567,559,4,8,"PSOE",224
42,"42151",38,31,30,0,1,"PSOE",13
9,"9221",492,413,409,0,4,"PSOE",116
46,"46230",14084,10694,10599,67,95,"PSOE",3445
50,"50125",345,264,261,3,3,"PSOE",99
44,"44077",74,55,54,0,1,"PSOE",31
5,"5256",112,94,92,1,2,"PSOE",31
46,"46048",3509,2758,2720,11,38,"PSOE",781
26,"26112",223,177,174,0,3,"PSOE",55
41,"41073",1685,1172,1157,13,15,"PSOE",549
31,"31115",160,116,116,3,0,"PSOE",11
19,"19018",141,112,110,0,2,"PSOE",25
21,"21075",335,256,249,0,7,"PSOE",136
50,"50066",2835,2199,2177,19,22,"PSOE",470
12,"12131",59,50,50,0,0,"PSOE",9
12,"12010",237,203,198,1,5,"PSOE",69
10,"10167",307,238,237,1,1,"PSOE",114
31,"31102",136,75,75,2,0,"PSOE",11
22,"22236",236,207,203,2,4,"PSOE",78
44,"44175",113,84,82,1,2,"PSOE",33
47,"47194",292,245,243,1,2,"PSOE",60
50,"50155",90,70,69,0,1,"PSOE",25
40,"40225",1098,902,882,4,20,"PSOE",207
34,"34136",149,105,102,0,3,"PSOE",23
10,"10045",970,739,735,6,4,"PSOE",379
37,"37103",414,309,309,4,0,"PSOE",84
31,"31103",39,27,27,0,0,"PSOE",3
38,"38049",2683,1781,1743,18,38,"PSOE",526
46,"46050",186,157,154,1,3,"PSOE",74
50,"50068",1947,1402,1389,11,13,"PSOE",545
6,"6153",20240,15464,15210,134,254,"PSOE",5814
10,"10128",5628,4238,4126,43,112,"PSOE",1740
49,"49088",82,59,59,0,0,"PSOE",13
49,"49206",794,584,570,7,14,"PSOE",177
3,"3058",4967,4031,3967,24,64,"PSOE",849
37,"37217",59,48,46,1,2,"PSOE",16
50,"50214",18,10,10,0,0,"PSOE",3
44,"44082",89,72,69,0,3,"PSOE",22
39,"39024",1815,1436,1420,14,16,"PSOE",358
3,"3059",20590,15909,15766,96,143,"PSOE",3643
24,"24205",981,744,732,8,12,"PSOE",180
19,"19289",23,19,19,0,0,"PSOE",5
28,"28140",3139,2547,2523,12,24,"PSOE",522
44,"44239",22,19,19,0,0,"PSOE",0
12,"12076",76,64,64,1,0,"PSOE",21
12,"12012",2613,2217,2180,6,37,"PSOE",803
45,"45192",2412,2103,2068,7,35,"PSOE",800
5,"5181",46,39,39,0,0,"PSOE",12
44,"44084",55,45,45,0,0,"PSOE",14
47,"47166",251,196,189,3,7,"PSOE",46
40,"40183",116,103,103,0,0,"PSOE",3
26,"26117",2097,1680,1647,17,33,"PSOE",601
44,"44178",53,39,39,0,0,"PSOE",13
13,"13075",199,157,157,0,0,"PSOE",47
10,"10049",3758,3167,3086,19,81,"PSOE",1316
26,"26118",72,63,60,1,3,"PSOE",12
16,"16032",277,224,223,1,1,"PSOE",102
37,"37182",78,57,57,0,0,"PSOE",4
37,"37334",73,49,49,0,0,"PSOE",12
42,"42048",60,50,50,0,0,"PSOE",8
16,"16258",172,128,128,2,0,"PSOE",52
10,"10090",494,364,357,6,7,"PSOE",162
46,"46235",21270,15754,15592,101,162,"PSOE",3991
26,"26005",2480,1687,1661,5,26,"PSOE",495
6,"6156",1171,919,901,10,18,"PSOE",390
12,"12107",351,312,306,1,6,"PSOE",101
34,"34098",783,614,605,3,9,"PSOE",171
28,"28143",77,62,62,0,0,"PSOE",16
12,"12135",36194,27266,26961,192,305,"PSOE",7952
47,"47168",30,29,29,0,0,"PSOE",0
29,"29075",12890,9033,8949,73,84,"PSOE",2507
31,"31149",2271,1645,1628,9,17,"PSOE",202
3,"3031",41857,28648,28362,163,286,"PSOE",8592
24,"24032",102,84,83,0,1,"PSOE",30
46,"46236",937,764,755,5,9,"PSOE",237
19,"19010",9,10,10,0,0,"PSOE",2
46,"46054",11390,8717,8604,52,113,"PSOE",2601
22,"22002",106,95,94,0,1,"PSOE",35
30,"30036",15256,10884,10703,56,181,"PSOE",2182
26,"26007",481,391,383,0,8,"PSOE",139
45,"45150",414,326,320,2,6,"PSOE",177
29,"29054",42393,30327,30108,218,219,"PSOE",7745
41,"41041",9760,7835,7646,44,189,"PSOE",3024
2,"2052",466,394,394,3,0,"PSOE",147
41,"41013",4807,3480,3425,30,55,"PSOE",1990
10,"10174",171,129,127,0,2,"PSOE",46
46,"46176",2045,1450,1434,12,16,"PSOE",330
24,"24211",263,219,214,3,5,"PSOE",47
5,"5185",90,71,70,0,1,"PSOE",10
49,"49257",310,205,202,2,3,"PSOE",70
9,"9231",59,43,43,1,0,"PSOE",12
40,"40221",48,42,42,0,0,"PSOE",6
16,"16119",179,128,128,0,0,"PSOE",50
6,"6159",2339,1577,1507,25,70,"PSOE",636
22,"22116",1369,1025,1003,8,22,"PSOE",356
34,"34902",123,98,98,4,0,"PSOE",17
28,"28146",1792,1308,1293,8,15,"PSOE",419
18,"18120",257,219,217,1,2,"PSOE",145
44,"44182",198,172,171,2,1,"PSOE",54
44,"44213",65,46,46,0,0,"PSOE",10
6,"6027",645,572,568,0,4,"PSOE",208
3,"3063",27121,19869,19713,131,156,"PSOE",6236
10,"10176",347,266,261,2,5,"PSOE",117
46,"46147",17133,12260,12120,59,140,"PSOE",3094
26,"26122",116,98,97,0,1,"PSOE",23
22,"22247",30,21,21,0,0,"PSOE",12
37,"37226",150,119,119,2,0,"PSOE",14
30,"30038",15674,11755,11675,59,80,"PSOE",2898
49,"49097",74,43,43,0,0,"PSOE",15
31,"31235",157,121,118,0,3,"PSOE",29
5,"5187",1728,1394,1364,7,30,"PSOE",431
19,"19117",1611,1279,1257,7,22,"PSOE",447
37,"37150",36,31,31,0,0,"PSOE",0
5,"5033",170,146,145,0,1,"PSOE",33
24,"24214",634,473,471,3,2,"PSOE",198
46,"46239",453,372,366,2,6,"PSOE",122
26,"26124",776,635,624,5,11,"PSOE",218
13,"13037",790,633,620,3,13,"PSOE",255
10,"10097",106,88,85,3,3,"PSOE",28
5,"5112",95,66,64,2,2,"PSOE",8
19,"19284",10,9,9,1,0,"PSOE",6
46,"46098",2403,1807,1772,8,35,"PSOE",390
9,"9255",84,70,70,1,0,"PSOE",13
46,"46179",2116,1723,1678,18,45,"PSOE",513
28,"28071",64,56,54,0,2,"PSOE",10
9,"9408",42,33,33,0,0,"PSOE",6
19,"19067",69,53,50,1,3,"PSOE",30
10,"10901",1177,818,805,1,13,"PSOE",301
19,"19168",266,211,206,4,5,"PSOE",85
45,"45110",1697,1339,1326,11,13,"PSOE",576
39,"39068",649,515,509,7,6,"PSOE",98
10,"10085",319,240,236,1,4,"PSOE",93
40,"40202",55,38,38,0,0,"PSOE",4
46,"46241",389,318,313,4,5,"PSOE",87
9,"9132",171,136,130,1,6,"PSOE",20
28,"28149",6172,5089,5038,31,51,"PSOE",1183
49,"49137",170,138,134,0,4,"PSOE",41
37,"37266",70,58,56,0,2,"PSOE",10
12,"12112",110,97,96,1,1,"PSOE",34
45,"45204",634,500,497,1,3,"PSOE",155
35,"35002",24129,16979,16736,116,243,"PSOE",4228
28,"28180",5317,4266,4222,26,44,"PSOE",1494
16,"16002",195,166,164,1,2,"PSOE",44
24,"24015",2209,1714,1672,19,42,"PSOE",428
44,"44217",31,25,25,0,0,"PSOE",8
23,"23053",9449,6379,6325,25,54,"PSOE",2943
26,"26127",186,162,159,1,3,"PSOE",64
5,"5155",46,36,36,0,0,"PSOE",8
5,"5191",124,105,105,0,0,"PSOE",42
19,"19021",976,744,724,5,20,"PSOE",230
12,"12113",87,65,64,0,1,"PSOE",18
28,"28073",12751,9940,9838,63,102,"PSOE",2797
16,"16273",303,236,231,2,5,"PSOE",28
16,"16126",729,622,616,5,6,"PSOE",216
44,"44093",79,73,73,4,0,"PSOE",26
40,"40124",234,175,168,3,7,"PSOE",55
22,"22009",585,439,435,4,4,"PSOE",194
19,"19304",220,177,175,1,2,"PSOE",58
34,"34157",2364,1881,1846,13,35,"PSOE",537
50,"50167",215,181,179,1,2,"PSOE",47
16,"16003",133,111,110,1,1,"PSOE",40
39,"39005",1406,1127,1110,12,17,"PSOE",205
6,"6099",1162,833,813,6,20,"PSOE",415
44,"44156",46,36,33,1,3,"PSOE",6
24,"24057",1306,1018,997,7,21,"PSOE",386
16,"16129",90,78,77,0,1,"PSOE",23
34,"34109",63,42,41,0,1,"PSOE",6
10,"10061",1598,1126,1114,5,12,"PSOE",546
16,"16219",81,64,63,0,1,"PSOE",43
14,"14022",3886,3080,3043,18,37,"PSOE",1360
26,"26129",936,770,759,1,11,"PSOE",258
50,"50138",47,42,42,1,0,"PSOE",7
45,"45162",632,481,471,2,10,"PSOE",181
40,"40195",813,630,623,5,7,"PSOE",172
44,"44094",123,112,112,0,0,"PSOE",20
28,"28014",34047,26858,26575,178,283,"PSOE",7289
16,"16130",536,445,444,0,1,"PSOE",219
46,"46245",528,430,426,2,4,"PSOE",114
37,"37309",37,27,27,0,0,"PSOE",6
19,"19024",8525,6587,6485,33,102,"PSOE",1728
6,"6002",4314,3181,3086,44,95,"PSOE",1002
40,"40231",98,80,80,2,0,"PSOE",14
47,"47052",6752,5665,5589,57,76,"PSOE",1499
31,"31244",156,95,94,5,1,"PSOE",18
28,"28076",425,354,349,3,5,"PSOE",90
34,"34067",129,87,87,0,0,"PSOE",38
45,"45163",8340,6486,6363,38,123,"PSOE",1966
16,"16172",349,278,275,3,3,"PSOE",99
23,"23025",2727,2125,2090,8,35,"PSOE",910
46,"46257",5428,4237,4190,23,47,"PSOE",1187
34,"34216",60,46,46,0,0,"PSOE",3
37,"37023",1586,1316,1298,12,18,"PSOE",351
37,"37050",67,54,54,0,0,"PSOE",15
18,"18164",1794,1225,1205,9,20,"PSOE",384
44,"44097",126,91,90,2,1,"PSOE",21
46,"46064",525,427,424,4,3,"PSOE",117
45,"45165",62598,47784,47120,345,664,"PSOE",14264
31,"31001",80,63,63,0,0,"PSOE",10
3,"3072",348,297,295,2,2,"PSOE",88
31,"31123",617,392,388,3,4,"PSOE",62
41,"41050",5180,4217,4149,34,68,"PSOE",1605
9,"9038",111,95,95,0,0,"PSOE",30
39,"39009",3307,2545,2526,11,19,"PSOE",566
34,"34113",40,37,37,0,0,"PSOE",8
46,"46186",19529,15294,15125,69,169,"PSOE",4179
5,"5082",495,399,394,1,5,"PSOE",116
6,"6103",4753,3656,3598,35,58,"PSOE",1507
31,"31002",433,324,324,4,0,"PSOE",44
22,"22902",208,160,156,0,4,"PSOE",35
49,"49231",293,212,209,0,3,"PSOE",57
29,"29033",1089,776,761,2,15,"PSOE",355
23,"23058",8817,6964,6873,48,91,"PSOE",2870
47,"47054",613,501,498,0,3,"PSOE",125
29,"29089",3161,2477,2426,19,51,"PSOE",921
50,"50257",163,136,134,1,2,"PSOE",64
47,"47213",108,84,84,0,0,"PSOE",27
26,"26057",51,47,47,1,0,"PSOE",18
19,"19082",99,76,75,0,1,"PSOE",33
44,"44193",69,57,56,1,1,"PSOE",17
49,"49186",235,181,178,4,3,"PSOE",35
40,"40094",364,284,279,1,5,"PSOE",67
9,"9365",27,19,19,1,0,"PSOE",3
45,"45030",478,368,364,3,4,"PSOE",149
5,"5163",1705,1360,1345,4,15,"PSOE",387
49,"49271",181,147,144,1,3,"PSOE",67
46,"46127",2740,2174,2147,11,27,"PSOE",652
37,"37275",101,69,67,0,2,"PSOE",28
46,"46188",693,591,585,3,6,"PSOE",125
50,"50055",3627,2627,2571,41,56,"PSOE",792
13,"13005",23187,18379,18119,174,260,"PSOE",6487
9,"9421",242,197,196,2,1,"PSOE",51
50,"50201",444,357,354,1,3,"PSOE",109
45,"45031",2824,2104,2068,20,36,"PSOE",614
24,"24103",264,162,161,1,1,"PSOE",46
26,"26023",435,351,347,5,4,"PSOE",128
13,"13098",1983,1537,1485,22,52,"PSOE",479
16,"16901",630,498,492,4,6,"PSOE",150
9,"9422",32,27,26,2,1,"PSOE",5
12,"12018",283,242,235,0,7,"PSOE",86
42,"42149",387,311,308,3,3,"PSOE",102
37,"37228",325,278,273,0,5,"PSOE",106
16,"16902",127,101,101,0,0,"PSOE",42
22,"22135",174,132,132,5,0,"PSOE",31
6,"6073",700,506,492,11,14,"PSOE",188
45,"45125",2263,1871,1842,10,29,"PSOE",677
35,"35010",3797,2601,2572,9,29,"PSOE",717
45,"45170",199,154,150,1,4,"PSOE",43
39,"39096",670,523,518,2,5,"PSOE",104
6,"6118",157,125,125,1,0,"PSOE",79
18,"18087",182514,141305,139588,865,1717,"PSOE",37181
10,"10139",95,78,77,1,1,"PSOE",37
16,"16013",26,21,20,0,1,"PSOE",10
24,"24105",1498,1188,1177,18,11,"PSOE",326
16,"16903",996,816,806,9,10,"PSOE",169
16,"16053",391,334,327,4,7,"PSOE",136
44,"44035",105,86,84,1,2,"PSOE",22
37,"37128",242,187,184,1,3,"PSOE",77
6,"6042",981,714,705,4,9,"PSOE",344
45,"45034",1291,1066,1039,7,27,"PSOE",352
18,"18171",2111,1679,1638,8,41,"PSOE",684
45,"45172",641,504,496,4,8,"PSOE",184
18,"18147",3644,2492,2441,18,51,"PSOE",985
37,"37044",450,342,335,6,7,"PSOE",85
22,"22136",749,579,576,5,3,"PSOE",194
46,"46161",1472,1200,1172,7,28,"PSOE",354
3,"3077",1374,1131,1114,9,17,"PSOE",279
31,"31253",119,106,105,0,1,"PSOE",13
16,"16904",451,386,383,3,3,"PSOE",135
18,"18173",8972,6594,6459,58,135,"PSOE",2575
5,"5049",410,310,305,3,5,"PSOE",109
18,"18137",1002,776,773,0,3,"PSOE",290
49,"49115",169,137,136,0,1,"PSOE",48
24,"24901",860,642,630,7,12,"PSOE",243
33,"33038",2234,1669,1644,16,25,"PSOE",654
19,"19040",57,40,40,0,0,"PSOE",16
16,"16015",351,251,250,4,1,"PSOE",60
6,"6010",1075,859,846,8,13,"PSOE",413
26,"26142",784,651,641,5,10,"PSOE",204
39,"39099",3149,2562,2540,22,22,"PSOE",616
9,"9209",4419,3407,3338,37,69,"PSOE",840
5,"5244",41,32,32,0,0,"PSOE",2
29,"29039",2728,2084,2050,14,34,"PSOE",646
50,"50059",754,599,589,6,10,"PSOE",228
45,"45175",614,512,504,3,8,"PSOE",190
4,"4036",223,188,186,1,2,"PSOE",72
39,"39015",824,646,644,2,2,"PSOE",109
34,"34126",254,220,219,3,1,"PSOE",39
10,"10076",793,597,585,4,12,"PSOE",266
37,"37245",335,240,240,5,0,"PSOE",86
37,"37169",176,138,137,1,1,"PSOE",48
9,"9262",158,137,136,1,1,"PSOE",34
50,"50149",33,25,25,1,0,"PSOE",5
5,"5052",87,77,77,0,0,"PSOE",7
37,"37132",325,232,231,0,1,"PSOE",92
44,"44038",98,83,80,0,3,"PSOE",34
10,"10198",1071,945,924,3,21,"PSOE",356
18,"18035",1190,965,952,4,13,"PSOE",392
2,"2074",5891,4435,4375,41,60,"PSOE",1647
37,"37246",5155,4153,4107,33,46,"PSOE",1302
10,"10158",337,269,267,0,2,"PSOE",155
34,"34127",80,64,64,1,0,"PSOE",11
49,"49209",474,338,334,4,4,"PSOE",86
9,"9430",22,20,20,0,0,"PSOE",7
41,"41058",17860,12850,12598,152,252,"PSOE",4402
22,"22001",214,162,162,0,0,"PSOE",31
28,"28163",429,361,345,4,16,"PSOE",111
49,"49118",194,151,151,1,0,"PSOE",38
50,"50236",101,82,80,1,2,"PSOE",27
33,"33041",7112,5251,5194,63,57,"PSOE",1906
10,"10078",370,289,278,4,11,"PSOE",119
40,"40140",79,58,58,0,0,"PSOE",15
37,"37360",215,158,153,3,5,"PSOE",46
50,"50080",34,29,29,0,0,"PSOE",8
26,"26160",732,578,574,4,4,"PSOE",178
14,"14065",1813,1439,1421,11,18,"PSOE",565
5,"5055",540,448,445,1,3,"PSOE",131
2,"2039",952,798,789,9,9,"PSOE",349
6,"6113",2677,2117,2076,13,41,"PSOE",828
39,"39102",2255,1711,1698,11,13,"PSOE",389
23,"23037",520,431,425,6,6,"PSOE",238
9,"9216",374,283,281,2,2,"PSOE",90
42,"42080",150,116,116,1,0,"PSOE",31
29,"29099",969,757,735,5,22,"PSOE",348
49,"49158",203,163,155,0,8,"PSOE",73
16,"16062",25,21,21,0,0,"PSOE",13
19,"19329",59,49,49,0,0,"PSOE",18
16,"16020",9,5,5,0,0,"PSOE",1
31,"31137",198,106,103,3,3,"PSOE",13
33,"33042",4243,3137,3103,36,34,"PSOE",948
46,"46045",1243,1033,1018,3,15,"PSOE",186
31,"31219",81,60,59,1,1,"PSOE",20
9,"9382",30,24,23,0,1,"PSOE",3
45,"45182",987,815,800,7,15,"PSOE",312
5,"5096",79,62,62,1,0,"PSOE",24
24,"24196",1918,1446,1422,9,24,"PSOE",608
22,"22144",257,207,204,1,3,"PSOE",68
41,"41061",2144,1763,1712,7,51,"PSOE",374
40,"40001",706,597,590,7,7,"PSOE",139
4,"4045",1704,1355,1326,12,29,"PSOE",704
2,"2078",899,705,691,3,14,"PSOE",259
26,"26033",163,143,142,3,1,"PSOE",60
9,"9908",427,294,290,6,4,"PSOE",67
10,"10122",220,171,164,0,7,"PSOE",66
9,"9270",159,119,117,4,2,"PSOE",25
49,"49160",43,29,26,0,3,"PSOE",15
16,"16149",154,130,130,2,0,"PSOE",51
46,"46016",1075,887,880,8,7,"PSOE",344
3,"3023",1379,1216,1199,6,17,"PSOE",368
37,"37376",2164,1606,1581,15,25,"PSOE",381
50,"50182",3675,2846,2810,36,36,"PSOE",546
12,"12129",1801,1382,1356,17,26,"PSOE",594
37,"37138",219,180,176,1,4,"PSOE",49
21,"21073",1891,1191,1156,17,35,"PSOE",458
16,"16024",123,96,95,0,1,"PSOE",39
33,"33014",8771,6425,6368,51,57,"PSOE",2207
16,"16150",94,75,75,1,0,"PSOE",23
26,"26035",16,14,13,0,1,"PSOE",6
44,"44235",89,67,66,2,1,"PSOE",16
13,"13022",332,264,256,1,8,"PSOE",131
24,"24148",1616,1252,1237,11,15,"PSOE",265
46,"46037",1109,927,918,4,9,"PSOE",308
6,"6106",413,267,263,3,4,"PSOE",118
23,"23084",907,685,670,0,15,"PSOE",349
10,"10084",1294,899,869,5,30,"PSOE",389
49,"49246",217,180,177,2,3,"PSOE",34
34,"34135",399,320,315,4,5,"PSOE",73
40,"40004",445,348,341,0,7,"PSOE",106
49,"49124",237,169,166,1,3,"PSOE",55
9,"9439",1054,867,851,8,16,"PSOE",195
39,"39087",41381,32335,31995,194,340,"PSOE",9898
21,"21038",1076,786,771,8,15,"PSOE",279
46,"46200",1848,1560,1539,6,21,"PSOE",494
24,"24014",7180,5189,5097,46,92,"PSOE",1949
14,"14019",6408,5163,5086,58,77,"PSOE",2190
3,"3056",8629,6838,6737,38,101,"PSOE",2175
50,"50212",32,29,29,1,0,"PSOE",10
44,"44113",72,51,50,0,1,"PSOE",18
40,"40181",4166,3405,3337,21,68,"PSOE",1121
42,"42181",391,319,317,0,2,"PSOE",158
9,"9114",76,63,63,0,0,"PSOE",16
10,"10086",303,249,244,3,5,"PSOE",83
23,"23085",2182,1733,1717,7,16,"PSOE",998
18,"18123",288,219,219,2,0,"PSOE",103
22,"22110",707,531,528,2,3,"PSOE",182
39,"39088",59,51,51,0,0,"PSOE",26
39,"39023",6523,5205,5144,22,61,"PSOE",1566
40,"40111",52,44,44,0,0,"PSOE",10
10,"10208",121,94,94,2,0,"PSOE",58
9,"9276",389,283,268,5,15,"PSOE",88
13,"13026",415,342,340,1,2,"PSOE",142
10,"10168",320,209,202,1,7,"PSOE",84
6,"6087",2030,1592,1571,16,21,"PSOE",693
16,"16068",127,104,104,4,0,"PSOE",39
26,"26154",10,10,10,1,0,"PSOE",1
5,"5180",82,61,60,0,1,"PSOE",3
31,"31902",4649,3620,3598,34,22,"PSOE",803
28,"28003",170,148,148,1,0,"PSOE",45
12,"12133",60,53,52,1,1,"PSOE",8
24,"24163",4073,3269,3231,36,38,"PSOE",815
42,"42183",106,83,83,1,0,"PSOE",8
6,"6121",3268,2558,2531,26,27,"PSOE",983
16,"16071",20,18,18,0,0,"PSOE",4
29,"29073",1645,1200,1185,13,15,"PSOE",490
18,"18114",591,443,437,2,6,"PSOE",195
24,"24083",1005,800,791,7,9,"PSOE",371
37,"37143",375,308,306,2,2,"PSOE",98
34,"34140",96,69,69,1,0,"PSOE",16
16,"16030",22,19,19,1,0,"PSOE",10
2,"2085",309,264,263,4,1,"PSOE",117
50,"50215",20,18,18,0,0,"PSOE",3
9,"9444",63,43,43,2,0,"PSOE",6
37,"37258",137,99,98,1,1,"PSOE",31
40,"40218",84,62,62,0,0,"PSOE",5
5,"5182",731,494,490,6,4,"PSOE",119
23,"23010",14241,10186,10015,68,171,"PSOE",3653
44,"44018",16,16,16,0,0,"PSOE",2
29,"29051",41793,29275,28764,249,511,"PSOE",7536
12,"12013",137,113,113,0,0,"PSOE",32
37,"37371",258,176,175,0,1,"PSOE",62
47,"47230",288,236,233,1,3,"PSOE",73
12,"12045",328,275,271,2,4,"PSOE",120
34,"34215",162,143,142,3,1,"PSOE",53
6,"6090",824,602,578,4,24,"PSOE",276
40,"40009",40,34,34,0,0,"PSOE",8
9,"9466",112,87,85,2,2,"PSOE",14
24,"24124",346,231,226,2,5,"PSOE",61
5,"5066",439,373,367,2,6,"PSOE",148
16,"16158",511,428,417,4,11,"PSOE",123
28,"28066",7515,6105,6039,40,66,"PSOE",1048
44,"44179",325,233,231,7,2,"PSOE",88
31,"31108",1829,1460,1437,16,23,"PSOE",513
12,"12046",182,161,161,1,0,"PSOE",57
28,"28099",1923,1490,1475,7,15,"PSOE",320
5,"5093",353,275,269,0,6,"PSOE",44
50,"50179",264,231,228,0,3,"PSOE",87
37,"37146",102,86,86,1,0,"PSOE",12
16,"16033",1644,1345,1320,11,25,"PSOE",510
42,"42188",43,35,34,1,1,"PSOE",11
47,"47169",61,53,53,0,0,"PSOE",4
26,"26043",349,272,268,2,4,"PSOE",106
44,"44118",158,126,122,1,4,"PSOE",41
42,"42051",15,10,10,0,0,"PSOE",0
37,"37373",700,522,514,0,8,"PSOE",235
16,"16160",60,44,43,1,1,"PSOE",7
37,"37110",103,84,82,0,2,"PSOE",25
28,"28006",80622,64905,64483,400,422,"PSOE",17223
5,"5027",260,217,211,3,6,"PSOE",39
28,"28175",935,775,767,3,8,"PSOE",156
50,"50043",246,172,170,2,2,"PSOE",49
4,"4015",118,97,97,2,0,"PSOE",46
6,"6015",117934,87081,86114,785,967,"PSOE",23860
33,"33053",1079,738,729,6,9,"PSOE",326
9,"9127",52,45,45,1,0,"PSOE",6
28,"28007",126831,103108,102202,710,906,"PSOE",31209
10,"10094",228,180,180,0,0,"PSOE",102
37,"37374",1147,946,923,4,23,"PSOE",315
47,"47075",4775,3849,3784,38,65,"PSOE",861
34,"34010",553,454,449,3,5,"PSOE",105
46,"46086",80,69,69,0,0,"PSOE",21
47,"47140",110,91,90,0,1,"PSOE",17
40,"40081",119,96,95,2,1,"PSOE",22
42,"42145",134,108,108,0,0,"PSOE",39
24,"24212",1002,772,764,7,8,"PSOE",273
44,"44120",219,158,152,1,6,"PSOE",42
16,"16036",122,98,97,1,1,"PSOE",39
16,"16162",39,31,30,0,1,"PSOE",9
18,"18154",975,701,699,3,2,"PSOE",244
12,"12050",1230,987,972,10,15,"PSOE",364
19,"19034",23,23,22,0,1,"PSOE",10
50,"50074",6166,4547,4444,33,103,"PSOE",1541
29,"29023",2290,1569,1550,3,19,"PSOE",273
16,"16122",249,197,196,3,1,"PSOE",76
9,"9406",246,203,200,4,3,"PSOE",49
5,"5151",80,64,64,1,0,"PSOE",18
21,"21013",10570,7195,7089,73,106,"PSOE",2654
31,"31032",1678,1285,1269,25,16,"PSOE",531
49,"49016",229,189,187,2,2,"PSOE",55
44,"44215",168,121,120,1,1,"PSOE",43
44,"44052",74,50,49,0,1,"PSOE",10
50,"50036",100,80,80,0,0,"PSOE",25
6,"6150",780,637,635,2,2,"PSOE",267
44,"44004",379,312,310,5,2,"PSOE",87
26,"26176",53,48,48,0,0,"PSOE",3
28,"28148",88647,70218,69546,570,672,"PSOE",20068
3,"3097",996,833,816,4,17,"PSOE",175
6,"6096",207,168,167,1,1,"PSOE",54
45,"45018",551,399,397,3,2,"PSOE",110
33,"33056",4877,3469,3420,30,49,"PSOE",1026
9,"9295",54,38,38,0,0,"PSOE",4
26,"26099",1216,993,973,14,20,"PSOE",338
24,"24132",615,405,404,5,1,"PSOE",112
28,"28082",6063,4939,4889,46,50,"PSOE",1140
22,"22167",473,392,384,4,8,"PSOE",125
12,"12020",120,107,107,0,0,"PSOE",11
28,"28179",1450,1115,1100,3,15,"PSOE",245
49,"49261",1505,1168,1149,8,19,"PSOE",392
37,"37342",255,200,199,1,1,"PSOE",47
46,"46059",1240,1038,1030,3,8,"PSOE",288
19,"19071",8155,6327,6242,35,85,"PSOE",1448
10,"10058",993,739,723,4,16,"PSOE",310
18,"18159",999,828,824,1,4,"PSOE",342
9,"9170",209,164,159,0,5,"PSOE",32
24,"24229",388,312,307,2,5,"PSOE",77
12,"12141",92,81,81,0,0,"PSOE",15
9,"9258",171,142,141,2,1,"PSOE",36
16,"16272",199,162,161,1,1,"PSOE",36
9,"9242",66,53,53,1,0,"PSOE",19
49,"49101",147,99,96,0,3,"PSOE",19
42,"42153",12,10,10,1,0,"PSOE",2
5,"5037",219,143,142,2,1,"PSOE",32
23,"23019",1479,1209,1183,3,26,"PSOE",538
40,"40017",84,74,71,2,3,"PSOE",17
39,"39033",540,430,423,1,7,"PSOE",122
31,"31158",248,182,177,2,5,"PSOE",18
16,"16043",88,71,71,1,0,"PSOE",15
21,"21017",2325,1450,1419,22,31,"PSOE",671
24,"24218",444,343,341,6,2,"PSOE",102
9,"9134",220,155,151,1,4,"PSOE",57
47,"47176",202,138,138,1,0,"PSOE",37
33,"33058",1664,1205,1176,5,29,"PSOE",522
34,"34108",502,424,415,6,9,"PSOE",166
10,"10182",124,91,90,0,1,"PSOE",37
45,"45037",1535,1121,1105,7,16,"PSOE",423
6,"6044",29204,21778,21492,203,286,"PSOE",7761
46,"46061",343,285,280,4,5,"PSOE",69
49,"49103",394,343,339,3,4,"PSOE",64
46,"46031",10521,7735,7607,62,128,"PSOE",2158
50,"50196",102,83,81,2,2,"PSOE",45
22,"22048",12593,9614,9528,82,86,"PSOE",2896
49,"49227",313,255,254,1,1,"PSOE",74
39,"39006",1721,1332,1315,3,17,"PSOE",241
44,"44126",317,226,222,1,4,"PSOE",91
37,"37157",78,64,64,0,0,"PSOE",33
44,"44027",149,120,119,0,1,"PSOE",44
47,"47177",100,80,79,0,1,"PSOE",23
22,"22253",57,48,47,0,1,"PSOE",15
26,"26016",28,24,23,0,1,"PSOE",8
22,"22011",97,78,75,2,3,"PSOE",15
9,"9083",27,24,23,0,1,"PSOE",3
10,"10062",393,339,334,0,5,"PSOE",194
49,"49063",310,246,240,2,6,"PSOE",89
9,"9378",29,21,20,0,1,"PSOE",4
44,"44107",205,159,158,0,1,"PSOE",65
24,"24098",1149,882,863,7,19,"PSOE",356
47,"47137",31,23,23,0,0,"PSOE",5
49,"49143",194,141,135,2,6,"PSOE",27
41,"41049",9493,7463,7312,78,151,"PSOE",3125
19,"19027",131,98,96,0,2,"PSOE",40
18,"18127",16822,12735,12537,106,198,"PSOE",4556
22,"22013",275,218,217,6,1,"PSOE",75
10,"10186",944,781,758,1,23,"PSOE",349
2,"2063",1375,1067,1047,1,20,"PSOE",451
45,"45057",224,188,184,0,4,"PSOE",63
39,"39026",1720,1322,1312,5,10,"PSOE",263
10,"10092",266,216,211,18,5,"PSOE",90
12,"12098",533,446,440,4,6,"PSOE",135
45,"45073",287,226,225,1,1,"PSOE",81
10,"10106",127,108,106,0,2,"PSOE",46
23,"23026",3450,2625,2573,17,52,"PSOE",1192
29,"29088",2694,2019,1951,31,68,"PSOE",869
49,"49024",637,465,461,2,4,"PSOE",136
13,"13002",1419,1021,995,5,26,"PSOE",354
40,"40057",1405,1176,1163,10,13,"PSOE",565
26,"26019",350,270,256,3,14,"PSOE",73
39,"39093",302,256,256,2,0,"PSOE",60
50,"50053",650,505,497,4,8,"PSOE",206
26,"26134",83,70,67,0,3,"PSOE",22
10,"10188",478,387,379,0,8,"PSOE",179
3,"3022",137,122,119,0,3,"PSOE",28
49,"49230",82,67,66,0,1,"PSOE",33
18,"18119",1712,1352,1317,11,35,"PSOE",483
31,"31246",128,105,101,3,4,"PSOE",27
37,"37161",121,88,88,0,0,"PSOE",15
50,"50172",178,134,131,3,3,"PSOE",33
46,"46126",5574,4565,4528,25,37,"PSOE",1251
31,"31205",420,312,310,7,2,"PSOE",125
13,"13095",72,60,60,1,0,"PSOE",18
9,"9418",73,58,55,2,3,"PSOE",7
44,"44002",46,42,42,0,0,"PSOE",18
6,"6005",1691,1246,1225,15,21,"PSOE",682
34,"34027",1046,791,783,13,8,"PSOE",285
12,"12119",137,107,104,1,3,"PSOE",16
23,"23093",3131,2428,2380,22,48,"PSOE",1440
46,"46248",4886,3672,3613,25,59,"PSOE",1042
16,"16094",120,89,88,0,1,"PSOE",17
2,"2030",2978,2357,2315,13,42,"PSOE",1104
16,"16194",220,181,173,1,8,"PSOE",102
6,"6105",604,406,400,2,6,"PSOE",155
39,"39085",6964,5489,5445,28,44,"PSOE",1329
44,"44003",17,14,14,0,0,"PSOE",2
44,"44033",244,174,172,0,2,"PSOE",63
46,"46249",9159,7113,7012,73,101,"PSOE",2364
5,"5045",80,65,65,0,0,"PSOE",11
49,"49111",121,100,100,3,0,"PSOE",18
37,"37352",201,159,158,0,1,"PSOE",47
26,"26059",1122,861,841,7,20,"PSOE",248
9,"9312",89,75,74,2,1,"PSOE",18
11,"11007",18020,11346,11152,176,194,"PSOE",3456
12,"12061",380,277,274,2,3,"PSOE",123
22,"22165",452,360,356,1,4,"PSOE",118
10,"10015",627,488,475,0,13,"PSOE",185
9,"9220",70,59,58,0,1,"PSOE",21
40,"40903",77,63,62,0,1,"PSOE",6
18,"18135",4434,3169,3105,23,64,"PSOE",1519
39,"39012",6737,5391,5314,52,77,"PSOE",1424
19,"19037",132,114,112,0,2,"PSOE",24
9,"9256",333,260,256,2,4,"PSOE",73
49,"49189",192,132,128,1,4,"PSOE",21
2,"2032",265,208,203,3,5,"PSOE",79
45,"45095",660,528,519,3,9,"PSOE",183
34,"34223",205,160,157,1,3,"PSOE",24
31,"31224",875,684,677,10,7,"PSOE",246
37,"37329",39,36,36,0,0,"PSOE",0
50,"50193",663,536,516,1,20,"PSOE",170
41,"41017",15712,12048,11896,118,152,"PSOE",3486
19,"19319",4583,3640,3585,24,55,"PSOE",901
9,"9424",34,24,24,0,0,"PSOE",2
42,"42164",1589,1201,1172,10,29,"PSOE",335
22,"22182",233,178,174,1,4,"PSOE",79
18,"18136",1782,1382,1359,12,23,"PSOE",765
50,"50175",924,713,710,9,3,"PSOE",257
10,"10194",524,440,435,4,5,"PSOE",160
5,"5036",116,100,100,0,0,"PSOE",9
6,"6130",186,159,154,0,5,"PSOE",89
44,"44196",125,96,95,2,1,"PSOE",49
29,"29059",2643,2086,2042,8,44,"PSOE",795
44,"44005",46,31,31,1,0,"PSOE",8
5,"5088",29,23,23,0,0,"PSOE",3
29,"29094",59350,42199,41749,419,450,"PSOE",12633
45,"45173",9729,7664,7558,46,106,"PSOE",2127
50,"50029",604,475,467,7,8,"PSOE",242
5,"5128",342,274,267,1,7,"PSOE",109
34,"34171",941,702,688,9,14,"PSOE",178
10,"10155",1082,825,819,4,6,"PSOE",383
18,"18101",9410,7280,7181,72,99,"PSOE",2080
16,"16905",1278,1028,1012,11,16,"PSOE",354
45,"45052",3134,2670,2652,23,18,"PSOE",750
18,"18149",5401,4290,4212,28,78,"PSOE",1147
5,"5168",3500,2774,2730,25,44,"PSOE",596
37,"37244",128,99,97,1,2,"PSOE",14
37,"37130",178,150,150,2,0,"PSOE",15
19,"19041",167,133,129,1,4,"PSOE",59
46,"46071",470,382,366,0,16,"PSOE",133
46,"46051",8384,6550,6452,24,98,"PSOE",1542
19,"19245",1145,904,880,8,24,"PSOE",290
26,"26181",14,14,14,0,0,"PSOE",4
29,"29007",28584,21525,21318,202,207,"PSOE",5436
42,"42075",78,60,60,1,0,"PSOE",12
34,"34175",87,67,66,0,1,"PSOE",11
46,"46903",6285,5035,4996,27,39,"PSOE",962
37,"37046",10749,8133,7989,84,144,"PSOE",2256
19,"19042",21,19,18,1,1,"PSOE",11
45,"45038",3505,2749,2705,16,44,"PSOE",562
46,"46193",8964,7206,7156,27,50,"PSOE",2178
44,"44106",153,115,111,2,4,"PSOE",47
50,"50148",290,229,227,2,2,"PSOE",98
45,"45039",208,176,176,0,0,"PSOE",35
46,"46143",4230,3255,3200,20,55,"PSOE",826
10,"10117",243,156,154,1,2,"PSOE",97
16,"16189",262,220,220,1,0,"PSOE",45
13,"13014",481,400,395,1,5,"PSOE",172
19,"19043",99,87,84,2,3,"PSOE",34
28,"28065",130679,106997,105975,762,1022,"PSOE",34404
40,"40104",284,229,224,2,5,"PSOE",63
29,"29063",303,243,239,1,4,"PSOE",75
44,"44117",319,263,256,5,7,"PSOE",112
9,"9265",47,38,36,2,2,"PSOE",6
22,"22141",114,86,85,0,1,"PSOE",12
18,"18141",384,269,264,0,5,"PSOE",49
31,"31014",266,195,195,4,0,"PSOE",25
6,"6047",837,677,669,6,8,"PSOE",336
45,"45133",2808,2233,2187,14,46,"PSOE",763
28,"28901",868,653,639,6,14,"PSOE",167
13,"13016",661,508,495,2,13,"PSOE",148
6,"6146",1048,837,819,4,18,"PSOE",457
29,"29098",1235,953,935,12,18,"PSOE",481
5,"5249",96,69,69,0,0,"PSOE",16
45,"45134",1609,1305,1291,6,14,"PSOE",389
10,"10160",237,189,183,3,6,"PSOE",101
34,"34178",119,105,104,0,1,"PSOE",14
46,"46226",31,27,27,0,0,"PSOE",19
6,"6114",127,109,108,0,1,"PSOE",73
10,"10079",858,694,684,1,10,"PSOE",219
12,"12127",67,50,50,1,0,"PSOE",24
47,"47064",37,32,29,0,3,"PSOE",2
26,"26068",79,62,62,1,0,"PSOE",25
34,"34179",26,20,19,0,1,"PSOE",0
37,"37109",177,149,149,3,0,"PSOE",29
47,"47159",831,703,693,0,10,"PSOE",250
45,"45181",2337,1846,1818,7,28,"PSOE",645
2,"2040",563,516,513,3,3,"PSOE",218
14,"14066",5756,4396,4310,36,86,"PSOE",1505
19,"19237",40,33,33,0,0,"PSOE",12
22,"22232",87,66,65,2,1,"PSOE",20
23,"23081",1483,1137,1109,7,28,"PSOE",583
12,"12080",1900,1604,1575,10,29,"PSOE",752
10,"10135",1241,995,981,5,14,"PSOE",395
9,"9907",1507,1198,1174,16,24,"PSOE",298
47,"47004",1136,950,939,5,11,"PSOE",400
33,"33013",429,320,316,1,4,"PSOE",94
40,"40142",52,42,40,0,2,"PSOE",12
5,"5252",58,38,38,0,0,"PSOE",3
23,"23070",3808,2598,2565,34,33,"PSOE",938
29,"29901",44578,31840,31537,286,303,"PSOE",8145
24,"24077",215,178,178,0,0,"PSOE",62
49,"49173",344,220,216,1,4,"PSOE",56
9,"9166",98,77,77,1,0,"PSOE",10
34,"34132",107,84,83,0,1,"PSOE",23
28,"28039",125,103,103,2,0,"PSOE",37
39,"39057",2367,1831,1796,14,35,"PSOE",505
41,"41043",667,475,453,3,22,"PSOE",257
31,"31099",49,43,43,0,0,"PSOE",13
39,"39020",23931,17782,17566,126,216,"PSOE",5931
46,"46229",911,755,752,5,3,"PSOE",233
28,"28135",985,762,756,1,6,"PSOE",169
31,"31181",134,94,93,1,1,"PSOE",14
42,"42083",26,22,22,0,0,"PSOE",8
5,"5017",86,74,73,0,1,"PSOE",10
37,"37126",30,26,26,0,0,"PSOE",2
34,"34072",143,130,128,1,2,"PSOE",23
28,"28158",678,547,540,1,7,"PSOE",83
45,"45078",1328,1152,1133,6,19,"PSOE",427
49,"49098",204,157,153,2,4,"PSOE",38
3,"3055",5247,4042,3991,24,51,"PSOE",853
40,"40073",385,339,335,6,4,"PSOE",80
12,"12009",17859,13054,12911,98,143,"PSOE",3800
22,"22235",88,72,72,1,0,"PSOE",24
18,"18007",741,533,527,6,6,"PSOE",279
40,"40084",53,40,39,0,1,"PSOE",9
28,"28061",22564,18245,18064,117,181,"PSOE",4324
44,"44090",66,49,49,0,0,"PSOE",9
22,"22209",159,139,136,5,3,"PSOE",61
29,"29047",1103,909,898,2,11,"PSOE",470
6,"6129",573,455,451,2,4,"PSOE",245
42,"42056",28,25,24,0,1,"PSOE",1
31,"31265",78,52,47,1,5,"PSOE",6
33,"33046",483,370,367,6,3,"PSOE",100
22,"22032",107,74,74,2,0,"PSOE",24
21,"21076",2142,1573,1551,24,22,"PSOE",821
3,"3026",1316,1040,1024,5,16,"PSOE",324
10,"10126",1470,1114,1104,7,10,"PSOE",429
50,"50037",127,93,93,0,0,"PSOE",19
37,"37379",173,152,152,0,0,"PSOE",48
34,"34155",120,104,103,0,1,"PSOE",47
31,"31252",83,57,57,0,0,"PSOE",2
22,"22250",344,271,264,6,7,"PSOE",78
44,"44080",284,214,212,1,2,"PSOE",91
46,"46080",985,799,788,5,11,"PSOE",276
19,"19005",91,63,63,0,0,"PSOE",19
26,"26075",321,266,265,0,1,"PSOE",94
23,"23074",2971,2410,2378,8,32,"PSOE",1079
50,"50157",286,226,220,0,6,"PSOE",105
18,"18148",803,652,648,0,4,"PSOE",260
24,"24203",95,72,72,0,0,"PSOE",18
26,"26002",827,643,639,5,4,"PSOE",205
45,"45159",85,75,74,0,1,"PSOE",24
22,"22111",146,115,115,1,0,"PSOE",33
26,"26038",81,61,61,0,0,"PSOE",29
9,"9225",81,62,62,0,0,"PSOE",22
13,"13072",729,542,531,3,11,"PSOE",160
5,"5259",106,87,87,0,0,"PSOE",25
9,"9392",49,41,41,0,0,"PSOE",17
18,"18138",2482,1698,1668,20,30,"PSOE",726
45,"45053",7834,6440,6333,46,107,"PSOE",2342
49,"49167",179,140,136,2,4,"PSOE",46
23,"23009",12808,10348,10233,66,115,"PSOE",3504
47,"47040",61,45,44,0,1,"PSOE",6
9,"9065",138,118,117,1,1,"PSOE",29
40,"40007",68,58,58,0,0,"PSOE",14
40,"40054",107,91,88,0,3,"PSOE",22
50,"50281",68,55,52,0,3,"PSOE",9
24,"24206",1611,1286,1268,7,18,"PSOE",604
38,"38020",15899,11057,10924,90,133,"PSOE",2940
47,"47102",264,217,211,1,6,"PSOE",68
24,"24043",122,71,69,0,2,"PSOE",32
16,"16072",133,96,95,1,1,"PSOE",37
10,"10103",426,330,327,0,3,"PSOE",164
19,"19008",37,32,32,1,0,"PSOE",7
34,"34004",5533,4345,4286,41,59,"PSOE",1313
22,"22203",76,61,61,0,0,"PSOE",19
22,"22037",112,96,96,0,0,"PSOE",12
47,"47147",102,85,85,0,0,"PSOE",16
50,"50051",800,615,608,3,7,"PSOE",283
21,"21007",6318,4614,4524,50,90,"PSOE",1716
44,"44210",743,600,594,8,6,"PSOE",219
50,"50139",322,257,256,0,1,"PSOE",92
19,"19161",211,165,163,2,2,"PSOE",62
31,"31189",1127,781,775,10,6,"PSOE",184
13,"13031",2471,2044,2020,15,24,"PSOE",763
40,"40219",565,451,432,2,19,"PSOE",43
9,"9123",43,39,38,0,1,"PSOE",10
24,"24086",266,211,210,0,1,"PSOE",50
9,"9266",103,85,85,0,0,"PSOE",27
22,"22114",124,86,82,1,4,"PSOE",31
22,"22244",46,37,37,2,0,"PSOE",11
4,"4013",143321,101501,100814,750,687,"PSOE",29499
10,"10051",433,338,332,0,6,"PSOE",91
19,"19113",446,352,342,3,10,"PSOE",140
40,"40151",43,32,32,0,0,"PSOE",3
3,"3124",460,401,390,2,11,"PSOE",112
31,"31190",45,41,41,4,0,"PSOE",11
11,"11028",32791,24276,24028,279,248,"PSOE",9200
37,"37065",271,187,184,0,3,"PSOE",44
49,"49171",610,477,473,8,4,"PSOE",155
50,"50275",110,55,55,0,0,"PSOE",16
37,"37025",244,209,206,0,3,"PSOE",56
16,"16263",966,763,755,2,8,"PSOE",345
6,"6092",555,428,419,3,9,"PSOE",204
42,"42159",40,36,35,0,1,"PSOE",6
4,"4003",17540,12174,12051,75,123,"PSOE",3343
6,"6147",338,262,258,2,4,"PSOE",143
40,"40105",44,39,38,0,1,"PSOE",7
42,"42013",37,29,29,0,0,"PSOE",13
37,"37223",112,78,76,0,2,"PSOE",31
26,"26008",1822,1436,1420,14,16,"PSOE",530
42,"42026",22,20,20,0,0,"PSOE",7
16,"16279",174,125,125,0,0,"PSOE",32
24,"24144",639,469,462,2,7,"PSOE",115
18,"18189",772,619,611,4,8,"PSOE",183
2,"2054",383,314,309,1,5,"PSOE",94
42,"42190",92,74,73,1,1,"PSOE",31
40,"40199",101,79,78,0,1,"PSOE",14
45,"45076",564,389,388,2,1,"PSOE",124
19,"19311",87,71,71,2,0,"PSOE",20
41,"41042",5849,4730,4692,20,38,"PSOE",2419
49,"49219",7221,5301,5186,62,115,"PSOE",1758
5,"5057",2401,1949,1917,19,32,"PSOE",651
16,"16038",28,21,21,0,0,"PSOE",6
9,"9232",140,110,107,0,3,"PSOE",45
18,"18133",2109,1632,1618,12,14,"PSOE",592
45,"45168",62790,50868,50335,359,533,"PSOE",14303
42,"42161",135,104,104,0,0,"PSOE",23
28,"28177",10722,9093,9029,64,64,"PSOE",1815
5,"5072",94,86,85,1,1,"PSOE",11
19,"19016",57,40,40,0,0,"PSOE",22
13,"13082",25882,17928,17721,101,207,"PSOE",4657
10,"10177",1695,1358,1323,9,35,"PSOE",509
45,"45063",380,294,289,0,5,"PSOE",122
31,"31073",296,218,217,3,1,"PSOE",23
10,"10083",96,74,73,0,1,"PSOE",23
9,"9167",53,39,36,0,3,"PSOE",4
19,"19152",550,413,405,3,8,"PSOE",146
16,"16248",862,730,720,10,10,"PSOE",254
44,"44102",27,22,22,0,0,"PSOE",1
45,"45155",319,261,253,1,8,"PSOE",115
9,"9238",941,573,567,8,6,"PSOE",199
3,"3065",169399,128218,127256,967,962,"PSOE",36918
9,"9075",103,87,87,1,0,"PSOE",18
44,"44184",38,28,26,0,2,"PSOE",2
13,"13901",864,687,673,1,14,"PSOE",263
28,"28010",10538,8708,8635,54,73,"PSOE",1816
50,"50154",116,98,98,0,0,"PSOE",17
5,"5060",109,88,88,0,0,"PSOE",16
35,"35001",4571,3523,3463,8,60,"PSOE",1181
5,"5074",665,571,565,2,6,"PSOE",143
24,"24215",152,125,124,1,1,"PSOE",22
16,"16124",1826,1482,1455,6,27,"PSOE",528
2,"2020",431,359,356,3,3,"PSOE",148
5,"5075",99,79,79,1,0,"PSOE",16
21,"21015",654,363,359,8,4,"PSOE",182
31,"31116",58,45,43,2,2,"PSOE",5
10,"10099",559,412,401,3,11,"PSOE",177
10,"10180",4168,2735,2680,18,55,"PSOE",895
22,"22155",65,54,54,0,0,"PSOE",10
49,"49224",169,117,115,0,2,"PSOE",31
22,"22124",182,148,148,1,0,"PSOE",46
30,"30041",13970,9796,9682,80,114,"PSOE",2684
19,"19039",59,56,55,1,1,"PSOE",18
45,"45067",2289,1860,1820,17,40,"PSOE",542
31,"31117",589,420,419,5,1,"PSOE",21
37,"37230",214,176,176,0,0,"PSOE",71
37,"37343",66,50,48,1,2,"PSOE",9
37,"37117",1553,1245,1230,14,15,"PSOE",300
34,"34211",175,160,160,0,0,"PSOE",28
31,"31199",141,96,94,0,2,"PSOE",13
49,"49178",747,574,564,4,10,"PSOE",128
28,"28053",6840,5797,5739,32,58,"PSOE",1372
35,"35031",7412,5593,5519,41,74,"PSOE",1107
46,"46182",1310,988,977,5,11,"PSOE",262
39,"39089",134,99,98,0,1,"PSOE",11
5,"5038",113,89,88,0,1,"PSOE",16
28,"28013",41563,32024,31693,194,331,"PSOE",9116
26,"26014",447,313,309,2,4,"PSOE",133
22,"22157",183,136,134,1,2,"PSOE",63
5,"5023",175,158,155,2,3,"PSOE",42
40,"40205",229,185,180,1,5,"PSOE",48
50,"50224",65,54,54,1,0,"PSOE",15
2,"2024",3374,2657,2613,23,44,"PSOE",936
16,"16128",51,44,44,0,0,"PSOE",10
22,"22126",87,66,66,0,0,"PSOE",12
24,"24190",146,109,109,1,0,"PSOE",29
9,"9377",629,494,488,4,6,"PSOE",84
31,"31160",105,87,86,1,1,"PSOE",11
19,"19022",571,443,434,7,9,"PSOE",96
6,"6100",852,681,677,3,4,"PSOE",294
29,"29062",651,576,567,4,9,"PSOE",285
40,"40089",214,176,170,1,6,"PSOE",24
21,"21079",687,503,500,5,3,"PSOE",261
44,"44189",48,36,36,0,0,"PSOE",11
46,"46183",6028,4620,4534,29,86,"PSOE",937
45,"45132",2376,1915,1908,13,7,"PSOE",319
10,"10035",1806,1320,1282,12,38,"PSOE",580
49,"49194",340,236,233,3,3,"PSOE",77
24,"24005",345,255,250,2,5,"PSOE",64
37,"37206",91,66,63,1,3,"PSOE",17
49,"49129",821,628,616,5,12,"PSOE",267
30,"30034",1075,852,831,4,21,"PSOE",249
40,"40196",32,28,28,1,0,"PSOE",2
12,"12116",67,57,57,0,0,"PSOE",18
9,"9084",167,132,127,4,5,"PSOE",34
10,"10063",161,141,141,1,0,"PSOE",52
30,"30902",8225,5797,5715,22,82,"PSOE",1570
39,"39091",1885,1512,1503,6,9,"PSOE",317
37,"37335",389,308,301,3,7,"PSOE",64
50,"50227",110,74,73,2,1,"PSOE",24
19,"19044",284,226,223,1,3,"PSOE",60
18,"18014",6898,5262,5162,43,100,"PSOE",1407
9,"9325",177,117,117,2,0,"PSOE",24
47,"47178",166,144,143,4,1,"PSOE",31
41,"41095",39970,27911,27583,389,328,"PSOE",10663
3,"3136",410,329,323,3,6,"PSOE",78
5,"5120",32,25,25,1,0,"PSOE",6
19,"19127",90,63,63,0,0,"PSOE",12
9,"9197",137,108,107,0,1,"PSOE",20
50,"50141",109,90,90,1,0,"PSOE",15
26,"26094",69,56,56,0,0,"PSOE",16
49,"49184",170,122,121,0,1,"PSOE",12
37,"37348",100,79,79,0,0,"PSOE",7
28,"28017",1280,1017,1012,9,5,"PSOE",225
49,"49120",53,39,39,0,0,"PSOE",18
3,"3001",345,285,282,1,3,"PSOE",42
50,"50180",106,84,84,1,0,"PSOE",30
50,"50237",102,81,81,3,0,"PSOE",28
21,"21014",4065,3192,3148,22,44,"PSOE",1442
41,"41023",7975,5918,5812,51,106,"PSOE",2631
46,"46035",6855,5500,5422,34,78,"PSOE",1857
9,"9268",88,71,71,0,0,"PSOE",33
50,"50248",502,390,377,6,13,"PSOE",157
19,"19165",41,36,36,0,0,"PSOE",13
45,"45075",124,93,90,0,3,"PSOE",24
28,"28090",9128,7590,7516,54,74,"PSOE",1750
42,"42065",23,18,18,2,0,"PSOE",2
46,"46167",345,255,255,0,0,"PSOE",106
49,"49244",49,32,32,1,0,"PSOE",5
18,"18179",503,346,343,3,3,"PSOE",159
10,"10067",10245,7850,7701,80,149,"PSOE",2779
37,"37350",404,310,307,0,3,"PSOE",51
10,"10095",314,260,255,2,5,"PSOE",113
18,"18144",803,650,640,2,10,"PSOE",158
34,"34181",422,324,321,3,3,"PSOE",165
49,"49134",166,111,111,2,0,"PSOE",33
19,"19015",84,74,73,0,1,"PSOE",24
34,"34102",202,173,171,2,2,"PSOE",40
39,"39011",1575,1249,1242,3,7,"PSOE",187
23,"23094",3729,3111,3077,16,34,"PSOE",1616
9,"9091",701,545,533,5,12,"PSOE",127
16,"16135",118,86,85,0,1,"PSOE",30
49,"49187",1202,930,921,8,9,"PSOE",294
44,"44260",138,91,90,1,1,"PSOE",23
44,"44121",53,38,38,2,0,"PSOE",6
49,"49272",77,55,51,0,4,"PSOE",6
13,"13006",572,437,430,5,7,"PSOE",183
24,"24146",251,206,204,1,2,"PSOE",54
50,"50231",257,210,207,3,3,"PSOE",74
31,"31250",2748,1995,1982,21,13,"PSOE",355
50,"50202",131,90,88,1,2,"PSOE",38
19,"19318",23,18,18,0,0,"PSOE",11
12,"12041",100,76,75,0,1,"PSOE",17
16,"16137",37,27,25,0,2,"PSOE",4
12,"12111",334,283,279,4,4,"PSOE",115
47,"47187",75,54,53,0,1,"PSOE",13
13,"13069",618,488,469,3,19,"PSOE",216
45,"45140",1089,887,870,5,17,"PSOE",391
30,"30010",6857,5533,5457,38,76,"PSOE",1470
34,"34122",86,68,66,0,2,"PSOE",22
16,"16139",324,249,249,2,0,"PSOE",68
31,"31251",3152,2437,2402,12,35,"PSOE",823
46,"46160",1907,1508,1485,5,23,"PSOE",489
2,"2070",384,318,318,2,0,"PSOE",231
9,"9095",112,70,68,1,2,"PSOE",14
46,"46231",2401,1780,1770,8,10,"PSOE",541
29,"29082",34113,26248,26002,304,246,"PSOE",6636
45,"45157",2261,1627,1603,8,24,"PSOE",386
10,"10902",735,537,521,2,16,"PSOE",246
41,"41054",713,596,588,4,8,"PSOE",264
16,"16125",1599,1314,1295,9,19,"PSOE",395
46,"46070",17700,13558,13437,115,121,"PSOE",2736
10,"10154",177,134,133,1,1,"PSOE",59
13,"13903",493,412,406,1,6,"PSOE",109
35,"35012",10765,6327,6270,32,57,"PSOE",1563
9,"9098",477,372,360,4,12,"PSOE",106
37,"37088",199,151,149,1,2,"PSOE",50
45,"45036",634,490,482,0,8,"PSOE",153
2,"2071",1058,912,906,2,6,"PSOE",400
12,"12043",560,460,450,2,10,"PSOE",122
40,"40006",22,18,18,0,0,"PSOE",6
34,"34240",87,65,63,3,2,"PSOE",11
44,"44187",193,155,151,1,4,"PSOE",40
3,"3078",474,372,371,2,1,"PSOE",75
45,"45129",109,84,83,0,1,"PSOE",31
24,"24107",214,170,170,2,0,"PSOE",63
41,"41056",3694,3044,3009,36,35,"PSOE",1602
26,"26003",389,329,328,1,1,"PSOE",98
34,"34228",76,62,62,0,0,"PSOE",22
37,"37090",66,51,51,1,0,"PSOE",13
22,"22227",199,155,154,1,1,"PSOE",67
19,"19274",950,753,741,7,12,"PSOE",229
16,"16113",3067,2416,2383,15,33,"PSOE",817
9,"9412",765,564,558,7,6,"PSOE",153
29,"29069",86694,58863,58127,561,736,"PSOE",17285
49,"49155",80,66,65,1,1,"PSOE",10
5,"5260",97,81,80,1,1,"PSOE",13
10,"10116",3728,2849,2776,27,73,"PSOE",1156
9,"9395",122,95,94,0,1,"PSOE",21
21,"21018",1719,1167,1139,9,28,"PSOE",651
50,"50159",641,527,526,8,1,"PSOE",205
50,"50031",139,97,90,0,7,"PSOE",35
24,"24123",716,514,507,2,7,"PSOE",197
18,"18115",2650,1988,1975,20,13,"PSOE",903
45,"45147",590,506,496,2,10,"PSOE",175
13,"13045",616,482,479,4,3,"PSOE",168
45,"45193",589,512,507,6,5,"PSOE",159
28,"28075",5952,4797,4758,25,39,"PSOE",1139
37,"37174",983,788,768,0,20,"PSOE",265
9,"9228",157,136,136,0,0,"PSOE",31
45,"45102",3585,2724,2676,20,48,"PSOE",728
47,"47157",495,428,426,3,2,"PSOE",148
16,"16018",381,313,312,2,1,"PSOE",88
42,"42172",28,25,25,1,0,"PSOE",0
22,"22142",94,80,80,2,0,"PSOE",18
3,"3071",3988,3125,3088,28,37,"PSOE",768
46,"46195",1982,1562,1554,2,8,"PSOE",460
50,"50216",240,189,181,3,8,"PSOE",51
18,"18069",497,374,366,4,8,"PSOE",135
9,"9396",153,125,124,0,1,"PSOE",12
19,"19279",51,44,44,0,0,"PSOE",8
18,"18176",241,182,180,0,2,"PSOE",125
13,"13062",559,478,471,1,7,"PSOE",171
46,"46165",7298,5744,5697,38,47,"PSOE",1428
34,"34130",198,165,161,2,4,"PSOE",58
31,"31258",7879,6189,6140,57,49,"PSOE",1441
24,"24155",442,374,371,6,3,"PSOE",112
16,"16061",941,790,763,8,27,"PSOE",307
34,"34038",268,198,197,0,1,"PSOE",28
10,"10120",156,110,108,0,2,"PSOE",40
37,"37172",853,601,590,4,11,"PSOE",112
45,"45196",1387,1099,1084,6,15,"PSOE",362
45,"45089",1432,1159,1134,5,25,"PSOE",468
21,"21009",835,575,557,0,18,"PSOE",256
46,"46139",4512,3612,3567,25,45,"PSOE",897
16,"16106",2708,2200,2163,17,37,"PSOE",939
16,"16246",452,348,340,1,8,"PSOE",116
49,"49216",147,122,114,0,8,"PSOE",50
45,"45120",121,96,96,0,0,"PSOE",42
5,"5122",119,90,88,1,2,"PSOE",25
18,"18016",308,232,231,5,1,"PSOE",117
24,"24197",736,556,552,7,4,"PSOE",159
4,"4004",400,320,315,2,5,"PSOE",118
22,"22003",132,114,114,0,0,"PSOE",29
47,"47150",259,206,202,0,4,"PSOE",55
42,"42160",247,195,194,4,1,"PSOE",72
22,"22193",269,220,217,2,3,"PSOE",59
34,"34104",233,190,189,1,1,"PSOE",47
28,"28134",63352,51185,50776,336,409,"PSOE",13704
10,"10054",524,435,422,1,13,"PSOE",198
26,"26009",391,317,314,2,3,"PSOE",103
9,"9011",73,50,49,0,1,"PSOE",7
40,"40222",163,143,142,1,1,"PSOE",46
29,"29079",2335,1796,1765,7,31,"PSOE",840
42,"42191",180,129,129,1,0,"PSOE",45
22,"22150",461,368,362,1,6,"PSOE",118
38,"38025",7088,5166,5089,39,77,"PSOE",1561
46,"46168",1982,1543,1522,5,21,"PSOE",461
4,"4005",533,448,442,0,6,"PSOE",171
5,"5254",181,155,153,0,2,"PSOE",36
16,"16249",1938,1544,1529,13,15,"PSOE",639
26,"26022",187,153,148,0,5,"PSOE",22
24,"24159",1746,1393,1368,6,25,"PSOE",285
5,"5136",84,64,64,2,0,"PSOE",22
3,"3054",336,277,272,2,5,"PSOE",86
9,"9093",162,138,137,1,1,"PSOE",42
29,"29091",9407,6859,6719,63,140,"PSOE",1951
26,"26011",7229,5355,5277,64,78,"PSOE",1806
33,"33045",4382,3214,3156,23,58,"PSOE",1291
10,"10043",754,578,572,3,6,"PSOE",290
10,"10206",201,146,144,1,2,"PSOE",51
49,"49222",370,284,282,2,2,"PSOE",162
6,"6085",3410,2719,2663,28,56,"PSOE",1220
44,"44020",22,18,18,0,0,"PSOE",1
45,"45161",15266,11185,11023,69,162,"PSOE",2688
42,"42177",64,55,54,6,1,"PSOE",13
34,"34088",264,211,207,1,4,"PSOE",63
5,"5901",253,173,171,1,2,"PSOE",42
26,"26086",15,15,15,0,0,"PSOE",1
42,"42193",16,7,7,0,0,"PSOE",0
9,"9389",64,50,50,0,0,"PSOE",12
12,"12103",90,75,70,1,5,"PSOE",9
13,"13070",766,620,604,6,16,"PSOE",213
16,"16111",163,125,122,1,3,"PSOE",51
3,"3066",41802,31046,30696,285,350,"PSOE",9511
10,"10044",1404,1092,1077,7,15,"PSOE",563
34,"34047",1738,1439,1420,8,19,"PSOE",278
9,"9213",270,196,196,1,0,"PSOE",33
45,"45203",2713,2092,2053,16,39,"PSOE",674
22,"22168",23,21,20,0,1,"PSOE",10
6,"6009",228,190,187,2,3,"PSOE",68
19,"19020",46,35,34,1,1,"PSOE",7
49,"49126",273,161,160,1,1,"PSOE",56
9,"9391",361,286,283,3,3,"PSOE",88
6,"6021",908,708,698,9,10,"PSOE",252
16,"16199",28,23,23,1,0,"PSOE",4
4,"4050",751,522,519,1,3,"PSOE",240
16,"16154",4752,3798,3732,37,66,"PSOE",1269
45,"45021",2605,1987,1950,23,37,"PSOE",656
30,"30011",4695,3665,3610,16,55,"PSOE",961
2,"2083",209,183,183,0,0,"PSOE",99
44,"44016",436,334,331,1,3,"PSOE",113
5,"5192",93,81,78,0,3,"PSOE",24
28,"28085",4141,3337,3296,13,41,"PSOE",970
29,"29084",27218,19648,19352,173,296,"PSOE",6188
13,"13087",23207,17321,17032,202,289,"PSOE",5515
12,"12108",438,382,379,4,3,"PSOE",108
5,"5142",90,83,81,0,2,"PSOE",19
18,"18012",2143,1651,1634,8,17,"PSOE",697
39,"39052",18957,15123,14985,106,138,"PSOE",3221
10,"10047",937,772,760,3,12,"PSOE",358
13,"13073",497,394,390,1,4,"PSOE",175
9,"9034",292,239,238,2,1,"PSOE",52
18,"18121",130,104,103,3,1,"PSOE",47
16,"16254",203,168,166,1,2,"PSOE",56
10,"10021",5045,3932,3840,32,92,"PSOE",1888
44,"44219",173,142,136,1,6,"PSOE",31
47,"47229",231,174,168,0,6,"PSOE",60
3,"3101",4911,3827,3772,20,55,"PSOE",976
9,"9280",27,22,22,0,0,"PSOE",8
4,"4023",120,95,95,2,0,"PSOE",32
45,"45146",101,86,85,0,1,"PSOE",19
16,"16044",43,31,30,0,1,"PSOE",10
12,"12097",65,54,54,1,0,"PSOE",15
6,"6012",3233,2515,2492,15,23,"PSOE",1278
23,"23099",4822,3687,3633,28,54,"PSOE",1415
47,"47210",402,300,289,2,11,"PSOE",83
22,"22903",622,538,533,3,5,"PSOE",187
3,"3073",222,200,196,3,4,"PSOE",70
19,"19175",30,19,19,1,0,"PSOE",1
45,"45071",1802,1488,1465,0,23,"PSOE",633
30,"30035",19268,14248,14103,92,145,"PSOE",2779
49,"49093",280,239,238,2,1,"PSOE",96
31,"31230",95,79,79,0,0,"PSOE",21
24,"24209",2609,1880,1857,13,23,"PSOE",713
9,"9006",59,37,36,1,1,"PSOE",8
34,"34112",39,30,30,0,0,"PSOE",7
37,"37234",317,224,222,1,2,"PSOE",83
34,"34245",310,244,240,3,4,"PSOE",74
47,"47041",153,119,116,2,3,"PSOE",32
5,"5145",47,27,27,1,0,"PSOE",8
3,"3061",1054,830,816,3,14,"PSOE",177
47,"47042",50,41,39,0,2,"PSOE",11
5,"5147",147,119,117,0,2,"PSOE",14
40,"40079",226,179,175,1,4,"PSOE",50
39,"39083",1074,786,777,4,9,"PSOE",146
19,"19036",248,213,210,1,3,"PSOE",68
3,"3062",221,182,180,1,2,"PSOE",33
9,"9400",310,250,247,4,3,"PSOE",99
28,"28037",1578,1196,1180,5,16,"PSOE",498
10,"10093",393,313,303,4,10,"PSOE",186
16,"16132",34,26,26,0,0,"PSOE",12
29,"29021",159,121,120,0,1,"PSOE",47
22,"22021",1884,1465,1450,13,15,"PSOE",585
5,"5138",289,224,223,2,1,"PSOE",37
46,"46240",206,175,169,2,6,"PSOE",30
47,"47043",309,276,273,1,3,"PSOE",111
5,"5264",57,40,38,1,2,"PSOE",5
5,"5162",75,58,58,0,0,"PSOE",27
9,"9363",922,733,725,3,8,"PSOE",101
34,"34901",1071,854,847,4,7,"PSOE",188
37,"37124",196,153,153,2,0,"PSOE",49
34,"34101",45,39,38,0,1,"PSOE",7
47,"47171",384,315,311,5,4,"PSOE",73
24,"24225",992,762,751,5,11,"PSOE",220
9,"9328",74,51,50,0,1,"PSOE",15
42,"42174",179,132,128,1,4,"PSOE",57
31,"31238",115,101,100,2,1,"PSOE",28
9,"9223",43,39,39,1,0,"PSOE",5
6,"6104",656,530,524,6,6,"PSOE",301
6,"6049",974,732,712,7,20,"PSOE",286
45,"45091",374,275,274,1,1,"PSOE",116
26,"26025",89,77,77,0,0,"PSOE",32
40,"40086",660,570,548,3,22,"PSOE",140
24,"24106",218,164,162,0,2,"PSOE",44
42,"42204",54,45,43,2,2,"PSOE",10
24,"24091",585,433,423,1,10,"PSOE",117
50,"50164",388,279,272,2,7,"PSOE",92
16,"16081",49,42,42,0,0,"PSOE",12
3,"3064",5004,3782,3736,20,46,"PSOE",1070
34,"34120",63965,50687,50117,471,570,"PSOE",16613
5,"5164",17,12,12,0,0,"PSOE",2
9,"9330",1480,1180,1161,8,19,"PSOE",330
26,"26047",1879,1569,1549,10,20,"PSOE",600
46,"46219",122,105,104,0,1,"PSOE",27
12,"12008",224,197,194,1,3,"PSOE",61
4,"4028",202,183,181,0,2,"PSOE",108
3,"3075",149,125,125,0,0,"PSOE",19
46,"46189",473,412,408,2,4,"PSOE",108
5,"5034",14,12,12,0,0,"PSOE",3
10,"10056",532,434,428,3,6,"PSOE",200
16,"16269",393,322,317,3,5,"PSOE",111
50,"50144",31,26,25,0,1,"PSOE",9
47,"47149",45,39,39,1,0,"PSOE",6
49,"49207",217,151,148,4,3,"PSOE",41
49,"49238",268,222,216,2,6,"PSOE",69
5,"5152",655,537,534,3,3,"PSOE",104
9,"9082",36,34,34,0,0,"PSOE",1
49,"49204",57,42,42,0,0,"PSOE",9
18,"18051",1090,800,795,13,5,"PSOE",411
24,"24173",908,679,667,3,12,"PSOE",190
5,"5902",293,246,242,1,4,"PSOE",51
26,"26012",33,28,26,0,2,"PSOE",9
13,"13085",2287,1911,1885,13,26,"PSOE",767
19,"19019",14,10,10,0,0,"PSOE",2
16,"16110",91,80,80,0,0,"PSOE",5
30,"30901",10529,8488,8375,37,113,"PSOE",2155
42,"42152",67,47,46,0,1,"PSOE",7
24,"24216",671,504,502,3,2,"PSOE",113
26,"26013",323,258,256,1,2,"PSOE",81
34,"34243",320,260,258,1,2,"PSOE",65
42,"42157",10,10,10,0,0,"PSOE",0
49,"49228",55,47,47,0,0,"PSOE",3
37,"37231",239,204,203,6,1,"PSOE",64
40,"40193",221,163,161,5,2,"PSOE",59
16,"16167",292,235,229,1,6,"PSOE",103
49,"49191",266,216,214,1,2,"PSOE",129
10,"10087",1606,1239,1223,5,16,"PSOE",529
21,"21004",1593,1114,1085,16,29,"PSOE",561
41,"41064",5611,3763,3667,47,96,"PSOE",1998
34,"34018",205,181,177,2,4,"PSOE",39
3,"3007",169,145,141,0,4,"PSOE",33
42,"42195",92,53,53,1,0,"PSOE",19
22,"22016",566,423,420,4,3,"PSOE",199
12,"12026",835,656,639,4,17,"PSOE",206
10,"10147",1283,1038,1007,4,31,"PSOE",527
14,"14072",999,763,754,4,9,"PSOE",387
5,"5051",162,135,131,0,4,"PSOE",35
47,"47146",278,232,230,3,2,"PSOE",94
24,"24219",492,374,371,5,3,"PSOE",92
24,"24079",872,671,665,4,6,"PSOE",163
37,"37051",80,59,58,0,1,"PSOE",23
9,"9154",124,101,101,3,0,"PSOE",20
28,"28054",11891,9476,9395,64,81,"PSOE",2304
42,"42003",66,55,55,0,0,"PSOE",13
40,"40126",67,53,51,0,2,"PSOE",5
19,"19057",72,59,58,0,1,"PSOE",22
37,"37119",95,78,77,0,1,"PSOE",36
34,"34141",176,154,152,0,2,"PSOE",41
16,"16005",232,175,172,0,3,"PSOE",63
45,"45009",464,303,301,2,2,"PSOE",80
39,"39081",437,356,347,2,9,"PSOE",52
22,"22158",11951,8877,8801,69,76,"PSOE",2891
9,"9449",92,75,74,1,1,"PSOE",5
50,"50142",24,18,18,0,0,"PSOE",11
34,"34176",127,106,104,2,2,"PSOE",11
37,"37054",238,200,196,3,4,"PSOE",78
12,"12134",135,102,100,0,2,"PSOE",40
44,"44085",49,31,31,0,0,"PSOE",1
28,"28028",1820,1493,1483,8,10,"PSOE",351
49,"49113",166,139,139,1,0,"PSOE",21
39,"39098",1379,1154,1144,7,10,"PSOE",129
16,"16131",127,90,90,1,0,"PSOE",26
26,"26119",177,150,147,2,3,"PSOE",74
49,"49220",139,110,104,2,6,"PSOE",43
23,"23001",920,769,766,3,3,"PSOE",356
13,"13091",544,485,476,4,9,"PSOE",182
42,"42171",114,80,79,0,1,"PSOE",15
23,"23035",1103,903,882,6,21,"PSOE",394
47,"47221",100,84,83,1,1,"PSOE",18
28,"28078",40,37,37,0,0,"PSOE",5
50,"50052",85,64,64,0,0,"PSOE",14
39,"39008",13900,10895,10767,81,128,"PSOE",2955
44,"44266",102,89,86,1,3,"PSOE",19
26,"26110",150,128,124,1,4,"PSOE",38
37,"37164",238,194,193,4,1,"PSOE",55
6,"6003",766,625,610,3,15,"PSOE",307
42,"42024",86,66,66,3,0,"PSOE",19
22,"22129",163,117,116,0,1,"PSOE",30
10,"10080",360,256,246,0,10,"PSOE",112
12,"12124",1840,1477,1460,8,17,"PSOE",351
19,"19017",57,50,49,0,1,"PSOE",12
16,"16123",66,43,43,0,0,"PSOE",17
41,"41035",1060,803,788,8,15,"PSOE",375
34,"34158",286,194,194,0,0,"PSOE",85
35,"35007",518,405,401,0,4,"PSOE",59
6,"6081",1042,825,811,4,14,"PSOE",445
30,"30037",19254,14416,14217,67,199,"PSOE",2835
5,"5043",75,62,62,0,0,"PSOE",25
40,"40012",238,178,175,4,3,"PSOE",47
28,"28156",1084,885,880,6,5,"PSOE",233
9,"9088",64,42,42,4,0,"PSOE",11
19,"19331",2643,2043,2009,11,34,"PSOE",690
47,"47197",867,721,717,2,4,"PSOE",231
50,"50088",282,233,227,2,6,"PSOE",94
13,"13065",2813,1993,1971,13,22,"PSOE",709
39,"39038",1506,1093,1076,2,17,"PSOE",271
10,"10081",184,142,140,4,2,"PSOE",48
40,"40189",479,392,380,2,12,"PSOE",161
16,"16063",113,86,83,0,3,"PSOE",29
46,"46063",1783,1368,1345,9,23,"PSOE",395
35,"35024",14243,9496,9394,65,102,"PSOE",2334
45,"45051",1634,1336,1290,9,46,"PSOE",471
45,"45200",4478,3666,3565,35,101,"PSOE",1391
3,"3047",9711,6910,6791,36,119,"PSOE",2074
6,"6028",4109,3613,3538,17,75,"PSOE",1637
35,"35009",20109,15017,14803,78,214,"PSOE",4031
39,"39095",2240,1809,1778,12,31,"PSOE",645
42,"42015",32,23,23,1,0,"PSOE",4
42,"42130",51,46,45,0,1,"PSOE",5
6,"6006",4494,3395,3325,24,70,"PSOE",1552
14,"14028",307,258,257,0,1,"PSOE",147
16,"16108",43,40,39,1,1,"PSOE",17
13,"13097",2205,1764,1742,6,22,"PSOE",690
5,"5054",1203,946,927,5,19,"PSOE",320
6,"6025",5096,3981,3904,28,77,"PSOE",1664
44,"44101",51,43,42,1,1,"PSOE",11
22,"22905",287,226,224,2,2,"PSOE",62
10,"10192",767,625,614,1,11,"PSOE",261
40,"40201",43,39,37,0,2,"PSOE",3
9,"9178",40,27,27,0,0,"PSOE",7
46,"46233",3781,2901,2847,22,54,"PSOE",730
24,"24152",447,301,296,1,5,"PSOE",61
6,"6066",1725,1297,1286,9,11,"PSOE",737
21,"21066",495,401,396,4,5,"PSOE",249
42,"42212",62,48,47,1,1,"PSOE",8
44,"44174",409,306,300,3,6,"PSOE",82
10,"10184",740,607,597,5,10,"PSOE",223
29,"29025",41515,29572,29311,221,261,"PSOE",7767
9,"9029",144,120,118,3,2,"PSOE",31
6,"6107",1570,1117,1106,9,11,"PSOE",565
37,"37215",134,97,96,3,1,"PSOE",37
39,"39078",1406,1101,1090,7,11,"PSOE",230
12,"12016",1550,1281,1260,11,21,"PSOE",408
40,"40901",414,331,328,8,3,"PSOE",73
30,"30033",10363,8115,7979,54,136,"PSOE",2064
37,"37144",338,275,273,1,2,"PSOE",82
28,"28062",288,243,236,0,7,"PSOE",40
5,"5139",66,59,59,0,0,"PSOE",3
47,"47160",392,317,314,2,3,"PSOE",96
22,"22130",10128,7355,7294,61,61,"PSOE",2408
46,"46065",1576,1246,1228,6,18,"PSOE",283
33,"33050",558,381,375,2,6,"PSOE",145
28,"28002",3281,2481,2455,24,26,"PSOE",572
28,"28008",1961,1477,1456,6,21,"PSOE",367
16,"16141",130,105,105,0,0,"PSOE",43
46,"46222",394,325,324,1,1,"PSOE",108
6,"6120",3373,2757,2719,10,38,"PSOE",1286
46,"46151",757,586,579,0,7,"PSOE",147
34,"34107",73,54,54,2,0,"PSOE",13
50,"50230",1134,853,846,6,7,"PSOE",333
16,"16117",1022,822,809,6,13,"PSOE",331
21,"21069",1667,1214,1198,13,16,"PSOE",602
37,"37239",206,184,181,3,3,"PSOE",55
16,"16159",209,147,144,0,3,"PSOE",60
9,"9387",111,91,89,0,2,"PSOE",37
44,"44010",184,137,137,1,0,"PSOE",44
10,"10201",179,157,156,1,1,"PSOE",72
19,"19006",757,556,548,7,8,"PSOE",191
23,"23098",838,721,715,2,6,"PSOE",363
24,"24227",1548,1148,1128,5,20,"PSOE",293
42,"42216",26,20,20,1,0,"PSOE",10
47,"47232",100,76,76,1,0,"PSOE",16
5,"5129",116,82,76,1,6,"PSOE",7
41,"41068",13936,10692,10530,73,162,"PSOE",5420
49,"49154",109,64,63,0,1,"PSOE",38
9,"9394",662,495,490,10,5,"PSOE",196
13,"13079",12265,9441,9218,123,223,"PSOE",3528
9,"9175",119,93,93,0,0,"PSOE",20
3,"3009",46121,36093,35720,235,373,"PSOE",12261
10,"10130",1747,1352,1321,12,31,"PSOE",628
46,"46092",263,182,179,1,3,"PSOE",39
45,"45050",489,381,363,3,18,"PSOE",127
34,"34192",82,68,68,0,0,"PSOE",6
44,"44011",48,32,32,1,0,"PSOE",10
39,"39084",874,718,712,4,6,"PSOE",104
3,"3105",5471,4099,4003,14,96,"PSOE",1013
31,"31247",147,117,115,0,2,"PSOE",11
37,"37238",106,88,87,1,1,"PSOE",28
46,"46066",1285,1058,1043,6,15,"PSOE",304
39,"39094",841,676,670,3,6,"PSOE",110
19,"19321",34,29,29,0,0,"PSOE",15
13,"13076",461,377,369,0,8,"PSOE",156
16,"16014",563,444,443,4,1,"PSOE",189
50,"50143",546,409,401,5,8,"PSOE",137
45,"45006",1326,983,972,6,11,"PSOE",405
45,"45015",662,506,500,2,6,"PSOE",174
24,"24213",170,140,139,0,1,"PSOE",38
31,"31126",351,255,254,2,1,"PSOE",28
12,"12132",484,415,412,4,3,"PSOE",118
50,"50211",237,177,173,0,4,"PSOE",61
28,"28060",1565,1262,1247,5,15,"PSOE",565
45,"45035",293,228,223,1,5,"PSOE",80
5,"5044",250,189,189,1,0,"PSOE",36
5,"5184",240,207,204,1,3,"PSOE",64
5,"5160",296,236,232,1,4,"PSOE",53
16,"16034",155,124,122,1,2,"PSOE",43
31,"31015",1990,1533,1508,17,25,"PSOE",494
19,"19157",56,40,37,0,3,"PSOE",11
19,"19300",788,664,652,2,12,"PSOE",123
2,"2068",324,274,273,0,1,"PSOE",101
47,"47152",68,59,59,0,0,"PSOE",29
26,"26027",143,101,98,1,3,"PSOE",37
29,"29096",2756,2061,2018,21,43,"PSOE",1028
19,"19123",36,33,32,2,1,"PSOE",11
47,"47020",272,228,225,5,3,"PSOE",68
46,"46122",2730,2103,2071,19,32,"PSOE",702
12,"12027",17473,12829,12683,90,146,"PSOE",3697
10,"10189",2527,1958,1907,12,51,"PSOE",863
12,"12137",37,27,27,0,0,"PSOE",13
45,"45045",1331,1001,990,2,11,"PSOE",341
44,"44116",76,62,62,0,0,"PSOE",6
6,"6137",933,730,723,5,7,"PSOE",369
19,"19013",114,99,99,0,0,"PSOE",53
13,"13074",944,826,813,1,13,"PSOE",329
26,"26020",454,347,337,4,10,"PSOE",94
13,"13020",4729,3461,3416,34,45,"PSOE",1365
47,"47170",43,34,32,0,2,"PSOE",12
19,"19033",48,42,41,0,1,"PSOE",17
16,"16009",54,49,49,0,0,"PSOE",9
41,"41039",31500,23692,23345,234,347,"PSOE",7904
50,"50233",104,82,82,0,0,"PSOE",13
9,"9415",275,206,204,0,2,"PSOE",36
5,"5218",105,82,81,0,1,"PSOE",17
49,"49236",70,55,55,0,0,"PSOE",11
29,"29016",263,217,217,0,0,"PSOE",80
10,"10141",289,224,223,0,1,"PSOE",91
50,"50242",93,72,70,0,2,"PSOE",25
46,"46178",4943,3684,3641,21,43,"PSOE",666
18,"18085",701,465,460,1,5,"PSOE",215
50,"50089",8584,6951,6912,34,39,"PSOE",1468
39,"39062",1841,1511,1500,9,11,"PSOE",224
24,"24069",39,27,27,0,0,"PSOE",1
46,"46246",1042,860,838,2,22,"PSOE",225
34,"34161",22,17,16,0,1,"PSOE",3
24,"24193",365,286,285,0,1,"PSOE",97
6,"6007",1433,1078,1071,5,7,"PSOE",636
40,"40083",72,53,51,3,2,"PSOE",3
19,"19296",27,24,24,0,0,"PSOE",4
5,"5089",455,354,340,1,14,"PSOE",91
45,"45084",2121,1708,1676,16,32,"PSOE",718
33,"33048",136,87,87,1,0,"PSOE",42
6,"6158",13362,10282,10112,73,170,"PSOE",3652
9,"9345",117,96,95,1,1,"PSOE",34
5,"5143",62,51,51,0,0,"PSOE",13
12,"12109",653,544,533,3,11,"PSOE",199
9,"9417",42,32,32,0,0,"PSOE",3
29,"29085",138,100,98,0,2,"PSOE",51
13,"13029",90,77,77,0,0,"PSOE",27
44,"44014",2499,2015,1963,25,52,"PSOE",684
26,"26004",66,54,54,0,0,"PSOE",6
29,"29077",214,158,156,1,2,"PSOE",82
22,"22243",39,28,28,0,0,"PSOE",6
37,"37186",96,79,79,0,0,"PSOE",21
28,"28176",13836,11415,11326,64,89,"PSOE",1820
49,"49079",103,91,79,1,12,"PSOE",22
19,"19047",55,47,47,0,0,"PSOE",18
16,"16280",165,130,128,3,2,"PSOE",41
6,"6110",137,106,105,0,1,"PSOE",51
37,"37002",126,81,81,0,0,"PSOE",31
18,"18902",755,611,595,1,16,"PSOE",270
9,"9247",22,18,18,0,0,"PSOE",3
50,"50146",190,152,149,0,3,"PSOE",68
44,"44103",123,101,100,1,1,"PSOE",25
10,"10088",196,139,138,0,1,"PSOE",51
24,"24217",133,106,105,1,1,"PSOE",25
45,"45061",2485,1850,1822,7,28,"PSOE",770
31,"31248",270,158,154,6,4,"PSOE",35
12,"12021",4377,3528,3473,23,55,"PSOE",942
42,"42165",419,288,285,8,3,"PSOE",91
6,"6122",6562,4837,4723,43,114,"PSOE",1885
23,"23092",27662,21206,20981,170,225,"PSOE",7361
19,"19324",160,128,123,1,5,"PSOE",49
10,"10175",1361,1031,997,8,34,"PSOE",433
28,"28056",914,715,703,4,12,"PSOE",179
13,"13032",1084,842,831,9,11,"PSOE",338
14,"14014",2509,2071,2030,7,41,"PSOE",969
34,"34218",445,352,345,2,7,"PSOE",61
40,"40198",24,20,20,0,0,"PSOE",2
31,"31908",1064,810,803,2,7,"PSOE",122
38,"38023",125528,88323,87456,598,867,"PSOE",22972
9,"9287",199,169,168,1,1,"PSOE",51
39,"39097",679,437,435,2,2,"PSOE",80
22,"22239",88,71,71,0,0,"PSOE",16
37,"37038",751,607,592,4,15,"PSOE",178
46,"46156",2024,1642,1628,7,14,"PSOE",492
49,"49193",435,303,287,1,16,"PSOE",76
13,"13012",382,279,277,2,2,"PSOE",150
18,"18056",3418,2523,2478,22,45,"PSOE",1048
5,"5081",37,29,29,0,0,"PSOE",8
39,"39025",8703,6954,6854,39,100,"PSOE",2079
4,"4068",174,134,134,0,0,"PSOE",54
37,"37001",172,133,133,0,0,"PSOE",41
16,"16133",4387,3607,3544,38,63,"PSOE",1229
45,"45167",1385,1143,1130,2,13,"PSOE",387
5,"5067",74,61,60,0,1,"PSOE",13
16,"16265",20,20,19,0,1,"PSOE",9
10,"10133",1154,971,955,3,16,"PSOE",668
10,"10187",430,316,311,0,5,"PSOE",136
6,"6143",3370,2635,2589,23,46,"PSOE",1490
16,"16006",110,99,98,1,1,"PSOE",32
49,"49210",448,372,370,3,2,"PSOE",153
37,"37197",87,63,63,0,0,"PSOE",9
26,"26161",8,7,7,0,0,"PSOE",1
23,"23008",1434,1155,1133,6,22,"PSOE",639
44,"44092",70,56,55,1,1,"PSOE",11
45,"45143",1190,940,925,3,15,"PSOE",254
19,"19199",19,17,16,0,1,"PSOE",8
29,"29066",346,266,266,2,0,"PSOE",96
49,"49096",157,129,123,2,6,"PSOE",43
5,"5161",550,444,434,2,10,"PSOE",113
2,"2076",318,256,250,1,6,"PSOE",114
16,"16100",640,570,565,1,5,"PSOE",234
31,"31079",67,60,60,0,0,"PSOE",19
31,"31022",483,349,345,3,4,"PSOE",36
40,"40122",525,442,434,2,8,"PSOE",119
47,"47104",2836,2339,2267,23,72,"PSOE",542
18,"18128",342,274,272,1,2,"PSOE",88
44,"44228",99,83,83,0,0,"PSOE",24
49,"49233",85,58,58,0,0,"PSOE",8
22,"22112",9516,7043,6956,84,87,"PSOE",1890
40,"40080",48,39,39,0,0,"PSOE",5
45,"45166",1564,1298,1279,6,19,"PSOE",561
41,"41055",14804,10863,10720,79,143,"PSOE",4526
44,"44049",796,592,578,9,14,"PSOE",209
10,"10075",236,186,182,1,4,"PSOE",68
29,"29065",194,150,150,0,0,"PSOE",46
3,"3002",3631,2841,2801,16,40,"PSOE",796
31,"31124",207,151,150,2,1,"PSOE",21
4,"4016",2128,1643,1621,4,22,"PSOE",457
9,"9230",33,28,28,0,0,"PSOE",0
6,"6059",1759,1300,1285,12,15,"PSOE",529
9,"9085",472,371,365,3,6,"PSOE",114
12,"12104",6814,5486,5406,35,80,"PSOE",1594
24,"24125",421,298,289,2,9,"PSOE",87
39,"39053",213,146,145,2,1,"PSOE",25
22,"22163",419,363,361,1,2,"PSOE",96
42,"42139",21,15,15,1,0,"PSOE",2
45,"45058",352,270,269,5,1,"PSOE",96
35,"35011",24705,17099,16823,129,276,"PSOE",4924
37,"37219",165,101,97,2,4,"PSOE",18
31,"31009",672,510,503,4,7,"PSOE",152
9,"9248",78,64,64,0,0,"PSOE",10
37,"37284",314,241,237,2,4,"PSOE",66
10,"10170",239,180,179,1,1,"PSOE",66
26,"26006",1825,1496,1470,8,26,"PSOE",501
12,"12079",419,346,336,2,10,"PSOE",113
46,"46206",557,461,455,6,6,"PSOE",169
28,"28161",51559,41390,40922,255,468,"PSOE",9694
7,"7023",3757,2777,2735,43,42,"PSOE",683
7,"7047",2371,1775,1747,13,28,"PSOE",363
7,"7036",27950,20870,20707,154,163,"PSOE",4923
7,"7034",1064,906,900,6,6,"PSOE",201
7,"7012",1909,1358,1343,15,15,"PSOE",383
7,"7063",1420,1139,1129,10,10,"PSOE",256
7,"7901",594,454,446,6,8,"PSOE",72
7,"7037",3357,2142,2120,16,22,"PSOE",604
7,"7011",28642,19567,19396,147,171,"PSOE",5777
7,"7020",3692,2833,2808,42,25,"PSOE",640
7,"7061",9564,6678,6583,67,95,"PSOE",1595
7,"7035",1596,1242,1234,13,8,"PSOE",312
7,"7018",379,287,286,1,1,"PSOE",80
7,"7007",414,326,324,2,2,"PSOE",83
7,"7001",3628,2792,2753,18,39,"PSOE",831
7,"7902",1091,776,743,10,33,"PSOE",197
7,"7055",7897,5264,5176,47,88,"PSOE",1251
7,"7053",1164,956,948,4,8,"PSOE",248
7,"7003",12374,7550,7442,51,108,"PSOE",1888
7,"7006",5332,3769,3722,25,47,"PSOE",1023
7,"7039",4970,3557,3489,36,68,"PSOE",703
7,"7041",2097,1662,1634,20,28,"PSOE",267
7,"7027",22047,14986,14853,139,133,"PSOE",4002
7,"7046",16718,10573,10469,94,104,"PSOE",3179
7,"7045",1300,1038,1030,6,8,"PSOE",301
7,"7054",22958,14097,13908,123,189,"PSOE",3525
7,"7016",2931,2201,2178,31,23,"PSOE",632
7,"7044",8791,6335,6196,66,139,"PSOE",1231
7,"7049",1480,1092,1075,10,17,"PSOE",188
7,"7031",24784,16683,16527,160,156,"PSOE",4248
7,"7050",3442,2303,2275,28,28,"PSOE",397
7,"7024",7294,4213,4160,44,53,"PSOE",1181
7,"7058",2857,2258,2233,18,25,"PSOE",505
7,"7038",2025,1581,1556,14,25,"PSOE",354
7,"7008",6047,4570,4513,31,57,"PSOE",1169
7,"7009",741,554,544,4,10,"PSOE",115
7,"7017",882,652,646,6,6,"PSOE",88
7,"7021",230,183,178,3,5,"PSOE",37
7,"7056",5245,3883,3841,32,42,"PSOE",878
7,"7029",4366,3270,3229,25,41,"PSOE",1042
7,"7040",288348,192799,191053,1586,1746,"PSOE",51305
7,"7052",4816,3276,3258,39,18,"PSOE",902
7,"7014",7778,4724,4669,50,55,"PSOE",1578
7,"7028",920,686,676,8,10,"PSOE",153
7,"7002",6612,4721,4672,43,49,"PSOE",1268
7,"7057",7404,5117,5028,50,89,"PSOE",1231
7,"7005",6975,4824,4775,43,49,"PSOE",1389
7,"7015",21976,14458,14297,205,161,"PSOE",3328
7,"7033",28373,17884,17684,201,200,"PSOE",4195
7,"7019",164,124,124,0,0,"PSOE",12
7,"7032",20888,14257,14096,108,161,"PSOE",4167
7,"7022",11615,8055,7934,91,121,"PSOE",1899
7,"7065",2302,1633,1603,10,30,"PSOE",282
7,"7064",5528,3793,3765,23,28,"PSOE",1084
7,"7048",18412,11528,11412,112,116,"PSOE",3246
7,"7059",3035,2257,2226,13,31,"PSOE",537
7,"7062",7902,4889,4828,58,61,"PSOE",1444
7,"7043",3430,2465,2438,24,27,"PSOE",442
7,"7013",7231,5372,5253,43,119,"PSOE",954
7,"7030",1590,1234,1202,8,32,"PSOE",198
7,"7004",4033,2898,2860,28,38,"PSOE",796
7,"7025",446,363,362,4,1,"PSOE",73
7,"7010",5070,3815,3777,47,38,"PSOE",898
7,"7060",2665,1976,1964,14,12,"PSOE",442
7,"7042",10785,7256,7191,60,65,"PSOE",2079
7,"7026",30991,19827,19602,161,225,"PSOE",6168
7,"7051",5414,3610,3575,37,35,"PSOE",877
25,"25901",287,209,207,1,2,"PUM+J",0
25,"25239",595,367,366,3,1,"PUM+J",0
25,"25076",134,94,93,0,1,"PUM+J",0
43,"43168",84,65,65,1,0,"PUM+J",0
25,"25152",144,106,106,1,0,"PUM+J",0
25,"25017",232,184,181,0,3,"PUM+J",0
25,"25024",352,273,272,0,1,"PUM+J",0
43,"43053",188,153,149,0,4,"PUM+J",0
25,"25166",172,137,136,1,1,"PUM+J",0
43,"43174",144,128,127,0,1,"PUM+J",0
43,"43003",350,266,264,3,2,"PUM+J",0
25,"25039",261,216,216,1,0,"PUM+J",0
43,"43019",1336,1020,1008,4,12,"PUM+J",1
25,"25006",317,246,245,3,1,"PUM+J",0
25,"25008",1088,867,857,7,10,"PUM+J",0
43,"43088",2026,1565,1562,9,3,"PUM+J",0
43,"43172",337,261,257,2,4,"PUM+J",0
25,"25164",357,264,261,4,3,"PUM+J",0
25,"25118",327,241,239,2,2,"PUM+J",0
25,"25179",171,134,134,1,0,"PUM+J",1
43,"43146",41,35,35,0,0,"PUM+J",0
43,"43124",472,379,373,1,6,"PUM+J",0
43,"43072",93,74,74,0,0,"PUM+J",0
25,"25176",307,262,259,1,3,"PUM+J",0
25,"25131",402,321,320,1,1,"PUM+J",1
25,"25226",242,184,183,4,1,"PUM+J",0
25,"25209",1550,1192,1172,4,20,"PUM+J",3
25,"25221",117,92,92,0,0,"PUM+J",0
43,"43086",5263,4046,4021,17,25,"PUM+J",2
43,"43010",337,286,284,2,2,"PUM+J",0
43,"43101",145,122,122,1,0,"PUM+J",0
43,"43906",2103,1595,1587,14,8,"PUM+J",0
43,"43128",905,751,747,4,4,"PUM+J",1
43,"43129",4611,3528,3495,21,33,"PUM+J",1
43,"43075",86,71,69,0,2,"PUM+J",0
43,"43094",2120,1659,1646,9,13,"PUM+J",0
43,"43015",119,101,101,0,0,"PUM+J",0
25,"25055",163,130,129,0,1,"PUM+J",0
25,"25062",695,578,573,3,5,"PUM+J",0
25,"25253",145,122,121,0,1,"PUM+J",0
25,"25170",261,230,228,4,2,"PUM+J",1
25,"25145",76,66,66,1,0,"PUM+J",0
25,"25059",813,621,612,3,9,"PUM+J",0
43,"43144",1236,1025,1021,8,4,"PUM+J",1
43,"43118",425,357,356,0,1,"PUM+J",0
43,"43042",2198,1820,1816,8,4,"PUM+J",0
25,"25196",112,94,93,0,1,"PUM+J",0
43,"43122",111,98,97,0,1,"PUM+J",0
25,"25100",184,145,144,1,1,"PUM+J",0
25,"25206",250,189,188,2,1,"PUM+J",0
43,"43121",591,463,462,0,1,"PUM+J",0
25,"25137",8686,6327,6296,46,31,"PUM+J",3
25,"25216",241,199,199,2,0,"PUM+J",0
25,"25096",888,663,661,2,2,"PUM+J",0
43,"43136",10463,7789,7749,36,40,"PUM+J",4
25,"25104",122,91,91,0,0,"PUM+J",0
43,"43126",1211,1005,999,4,6,"PUM+J",0
43,"43024",1556,1154,1137,3,17,"PUM+J",0
43,"43166",1628,1292,1285,3,7,"PUM+J",0
43,"43078",843,653,644,4,9,"PUM+J",0
25,"25183",535,419,416,4,3,"PUM+J",1
25,"25244",362,296,294,2,2,"PUM+J",0
43,"43048",763,614,609,7,5,"PUM+J",1
25,"25172",1779,1407,1405,3,2,"PUM+J",1
43,"43090",1169,749,742,2,7,"PUM+J",0
43,"43120",421,302,297,2,5,"PUM+J",1
43,"43051",9092,6577,6502,26,75,"PUM+J",4
43,"43145",4209,3409,3391,9,18,"PUM+J",1
25,"25149",1378,1108,1102,3,6,"PUM+J",0
43,"43160",1322,1051,1045,0,6,"PUM+J",0
43,"43038",21861,16504,16406,112,98,"PUM+J",9
43,"43131",4772,3432,3401,18,31,"PUM+J",1
25,"25081",287,221,220,2,1,"PUM+J",0
43,"43164",306,228,228,0,0,"PUM+J",0
43,"43134",273,224,223,5,1,"PUM+J",0
43,"43017",116,98,98,1,0,"PUM+J",0
25,"25224",126,98,98,0,0,"PUM+J",0
25,"25061",80,59,58,0,1,"PUM+J",0
25,"25133",686,528,527,2,1,"PUM+J",0
25,"25073",546,420,418,2,2,"PUM+J",0
25,"25219",149,118,118,1,0,"PUM+J",0
43,"43108",1778,1374,1365,6,9,"PUM+J",1
43,"43161",17113,12944,12881,64,63,"PUM+J",9
25,"25004",575,470,467,2,3,"PUM+J",0
25,"25148",219,168,168,1,0,"PUM+J",0
25,"25103",136,103,102,2,1,"PUM+J",0
25,"25913",86,77,77,0,0,"PUM+J",0
43,"43018",385,335,334,3,1,"PUM+J",0
43,"43021",345,270,269,3,1,"PUM+J",0
25,"25020",274,221,221,2,0,"PUM+J",0
25,"25099",1291,981,978,2,3,"PUM+J",0
25,"25044",178,145,144,6,1,"PUM+J",0
25,"25088",95,85,83,0,2,"PUM+J",0
25,"25014",249,203,200,2,3,"PUM+J",0
25,"25231",494,410,408,2,2,"PUM+J",0
43,"43103",905,746,740,8,6,"PUM+J",1
25,"25177",358,270,268,1,2,"PUM+J",0
43,"43082",351,303,297,1,6,"PUM+J",1
25,"25121",635,436,429,1,7,"PUM+J",0
25,"25085",141,118,117,2,1,"PUM+J",0
25,"25134",603,492,490,1,2,"PUM+J",0
43,"43152",434,357,356,0,1,"PUM+J",0
43,"43142",1083,850,842,8,8,"PUM+J",1
43,"43154",126,111,111,0,0,"PUM+J",0
25,"25111",113,90,89,0,1,"PUM+J",0
25,"25247",147,100,100,2,0,"PUM+J",0
25,"25124",157,114,114,0,0,"PUM+J",0
25,"25211",672,513,512,6,1,"PUM+J",1
43,"43046",90,73,73,1,0,"PUM+J",0
25,"25157",162,137,137,4,0,"PUM+J",0
25,"25079",285,228,227,0,1,"PUM+J",0
25,"25240",1385,1116,1110,10,6,"PUM+J",1
43,"43169",450,396,396,3,0,"PUM+J",0
25,"25119",2245,1798,1792,10,6,"PUM+J",0
25,"25194",415,325,325,3,0,"PUM+J",0
43,"43044",3949,3060,3032,31,28,"PUM+J",2
25,"25040",10614,7791,7734,58,57,"PUM+J",3
25,"25068",531,402,399,6,3,"PUM+J",0
25,"25033",1121,899,890,5,9,"PUM+J",0
43,"43096",98,82,82,0,0,"PUM+J",0
43,"43137",1905,1515,1499,15,16,"PUM+J",2
25,"25122",1925,1505,1497,23,8,"PUM+J",0
25,"25158",1606,1291,1277,5,14,"PUM+J",0
25,"25030",123,90,90,1,0,"PUM+J",0
43,"43173",99,80,78,0,2,"PUM+J",0
25,"25057",214,162,161,0,1,"PUM+J",0
43,"43149",684,533,533,4,0,"PUM+J",0
43,"43069",178,146,146,0,0,"PUM+J",0
43,"43170",878,706,704,7,2,"PUM+J",0
43,"43002",1875,1367,1348,11,19,"PUM+J",0
25,"25069",425,329,327,1,2,"PUM+J",1
43,"43111",2098,1496,1483,8,13,"PUM+J",4
43,"43903",2333,1717,1700,11,17,"PUM+J",1
25,"25175",176,135,135,1,0,"PUM+J",0
25,"25905",369,308,307,1,1,"PUM+J",2
43,"43099",286,234,234,0,0,"PUM+J",1
43,"43127",759,630,626,3,4,"PUM+J",1
43,"43062",259,223,220,2,3,"PUM+J",0
25,"25058",4358,3269,3254,7,15,"PUM+J",3
25,"25189",2164,1591,1583,11,8,"PUM+J",1
25,"25051",1510,1176,1172,6,4,"PUM+J",0
43,"43056",806,616,613,5,3,"PUM+J",0
25,"25140",773,573,571,5,2,"PUM+J",0
25,"25233",285,231,229,2,2,"PUM+J",0
25,"25074",180,157,155,2,2,"PUM+J",0
25,"25041",528,399,396,4,3,"PUM+J",0
25,"25086",521,414,411,2,3,"PUM+J",0
43,"43067",528,450,445,1,5,"PUM+J",0
25,"25154",118,94,94,0,0,"PUM+J",0
43,"43081",633,532,531,7,1,"PUM+J",0
43,"43153",11092,8327,8291,34,36,"PUM+J",6
43,"43049",727,589,584,2,5,"PUM+J",0
25,"25212",224,195,195,2,0,"PUM+J",0
43,"43902",2743,1996,1980,16,16,"PUM+J",0
43,"43904",2861,2083,2058,27,25,"PUM+J",0
43,"43063",536,401,397,1,4,"PUM+J",0
25,"25003",3721,2828,2815,19,13,"PUM+J",2
43,"43159",81,63,62,0,1,"PUM+J",0
25,"25220",994,822,816,3,6,"PUM+J",0
25,"25078",1001,807,805,5,2,"PUM+J",0
25,"25132",143,118,118,0,0,"PUM+J",1
43,"43071",891,713,706,6,7,"PUM+J",1
25,"25060",69,49,49,1,0,"PUM+J",0
25,"25093",629,489,487,4,2,"PUM+J",0
25,"25204",1191,936,930,5,6,"PUM+J",0
25,"25192",724,564,558,4,6,"PUM+J",0
43,"43020",2276,1831,1819,12,12,"PUM+J",3
25,"25064",98,88,88,0,0,"PUM+J",0
25,"25136",96,79,79,2,0,"PUM+J",0
25,"25201",110,89,89,0,0,"PUM+J",0
25,"25097",84,72,72,1,0,"PUM+J",0
25,"25143",84,72,71,0,1,"PUM+J",0
43,"43901",8750,6057,6004,43,53,"PUM+J",3
25,"25001",139,104,103,1,1,"PUM+J",0
25,"25215",505,299,299,4,0,"PUM+J",0
25,"25110",2731,2121,2106,14,15,"PUM+J",1
43,"43032",466,379,379,1,0,"PUM+J",0
43,"43059",250,214,214,1,0,"PUM+J",0
25,"25907",497,389,386,2,3,"PUM+J",0
25,"25072",5874,4468,4450,24,18,"PUM+J",5
43,"43029",314,253,252,0,1,"PUM+J",0
25,"25046",407,349,347,1,2,"PUM+J",0
43,"43040",326,278,276,0,2,"PUM+J",1
43,"43030",482,373,372,2,1,"PUM+J",0
25,"25089",97,72,71,1,1,"PUM+J",0
43,"43014",14357,10596,10542,60,54,"PUM+J",5
43,"43041",228,179,177,3,2,"PUM+J",0
43,"43162",4418,3467,3453,20,14,"PUM+J",3
43,"43107",383,308,308,1,0,"PUM+J",0
43,"43150",1238,1034,1026,6,8,"PUM+J",1
43,"43057",38,31,31,1,0,"PUM+J",0
25,"25193",767,614,606,6,8,"PUM+J",0
25,"25049",155,113,111,0,2,"PUM+J",0
43,"43907",4359,3370,3346,22,24,"PUM+J",5
43,"43083",144,116,113,1,3,"PUM+J",0
25,"25037",366,286,284,3,2,"PUM+J",0
43,"43050",2634,1881,1868,13,13,"PUM+J",0
43,"43148",90763,69756,69423,299,333,"PUM+J",45
43,"43074",1812,1419,1412,4,7,"PUM+J",0
25,"25191",321,248,244,3,4,"PUM+J",0
25,"25197",141,109,108,0,1,"PUM+J",0
25,"25071",42,32,31,0,1,"PUM+J",0
25,"25249",176,139,138,1,1,"PUM+J",0
25,"25139",491,390,388,3,2,"PUM+J",0
43,"43023",214,186,186,1,0,"PUM+J",0
43,"43151",109,98,98,0,0,"PUM+J",0
25,"25909",140,108,107,2,1,"PUM+J",0
25,"25047",972,784,781,8,3,"PUM+J",1
43,"43077",455,342,339,2,3,"PUM+J",0
25,"25150",165,136,133,0,3,"PUM+J",0
43,"43066",155,121,121,1,0,"PUM+J",0
43,"43176",746,588,586,7,2,"PUM+J",0
25,"25250",330,261,258,1,3,"PUM+J",0
25,"25075",131,102,102,0,0,"PUM+J",0
25,"25169",167,118,117,0,1,"PUM+J",0
43,"43105",156,132,132,3,0,"PUM+J",0
43,"43117",143,114,113,0,1,"PUM+J",0
25,"25130",183,142,140,0,2,"PUM+J",0
25,"25173",1649,1278,1262,5,16,"PUM+J",0
43,"43070",238,194,193,1,1,"PUM+J",0
43,"43084",521,424,423,2,1,"PUM+J",0
25,"25242",689,539,531,0,8,"PUM+J",0
43,"43004",6274,4744,4691,39,53,"PUM+J",3
43,"43130",177,145,145,0,0,"PUM+J",0
25,"25043",801,613,606,1,7,"PUM+J",0
25,"25208",333,252,249,0,3,"PUM+J",0
25,"25098",232,172,170,2,2,"PUM+J",0
25,"25002",467,357,356,2,1,"PUM+J",0
25,"25908",221,159,158,1,1,"PUM+J",0
25,"25202",108,75,75,0,0,"PUM+J",0
25,"25094",139,116,116,0,0,"PUM+J",0
25,"25230",1555,1221,1208,8,13,"PUM+J",0
43,"43033",768,609,607,3,2,"PUM+J",0
43,"43116",463,381,379,2,2,"PUM+J",0
25,"25248",880,714,713,4,1,"PUM+J",0
25,"25016",2083,1590,1587,8,3,"PUM+J",0
25,"25129",159,115,115,2,0,"PUM+J",0
43,"43110",251,184,184,1,0,"PUM+J",0
25,"25114",95,79,79,0,0,"PUM+J",0
25,"25019",4646,3224,3199,22,25,"PUM+J",3
43,"43034",468,393,393,0,0,"PUM+J",0
25,"25168",488,408,407,6,1,"PUM+J",0
25,"25227",664,517,517,1,0,"PUM+J",0
25,"25077",440,331,330,1,1,"PUM+J",1
25,"25029",1607,1270,1265,6,5,"PUM+J",1
25,"25210",1079,867,853,4,14,"PUM+J",0
43,"43100",3489,2820,2816,15,4,"PUM+J",2
25,"25109",214,179,176,3,3,"PUM+J",0
25,"25910",91,70,67,2,3,"PUM+J",0
25,"25050",3269,2457,2446,23,11,"PUM+J",0
43,"43143",51,45,44,0,1,"PUM+J",0
25,"25035",366,306,302,2,4,"PUM+J",2
43,"43037",17902,12787,12695,63,92,"PUM+J",11
25,"25182",1043,842,839,9,3,"PUM+J",0
43,"43005",3643,2765,2749,22,16,"PUM+J",2
25,"25127",214,172,172,0,0,"PUM+J",0
25,"25163",236,181,179,3,2,"PUM+J",0
43,"43043",3289,2624,2613,14,11,"PUM+J",1
25,"25904",162,147,147,3,0,"PUM+J",0
25,"25022",107,88,88,0,0,"PUM+J",0
25,"25048",1632,1274,1264,7,10,"PUM+J",0
43,"43109",2704,1937,1922,16,15,"PUM+J",0
25,"25120",92704,68713,68361,445,352,"PUM+J",53
25,"25174",390,324,324,0,0,"PUM+J",0
25,"25185",679,493,491,6,2,"PUM+J",0
43,"43171",14705,11002,10956,62,46,"PUM+J",10
25,"25101",543,454,449,1,5,"PUM+J",0
25,"25005",274,202,202,2,0,"PUM+J",0
43,"43155",22619,16724,16624,101,100,"PUM+J",9
25,"25138",547,440,436,1,4,"PUM+J",0
25,"25113",1116,912,908,8,4,"PUM+J",3
25,"25902",542,449,439,3,10,"PUM+J",0
43,"43140",2438,1847,1837,16,10,"PUM+J",2
43,"43093",3884,2956,2933,14,23,"PUM+J",2
25,"25232",1356,1066,1061,2,5,"PUM+J",0
43,"43092",7235,5200,5174,21,26,"PUM+J",8
25,"25903",229,189,188,0,1,"PUM+J",0
43,"43055",1988,1631,1622,7,9,"PUM+J",0
43,"43102",463,384,379,2,5,"PUM+J",0
43,"43047",4209,2878,2856,23,22,"PUM+J",4
25,"25135",1000,773,769,2,4,"PUM+J",0
43,"43167",384,334,333,2,1,"PUM+J",0
43,"43006",676,531,525,4,6,"PUM+J",0
43,"43028",2766,2007,1988,7,19,"PUM+J",1
25,"25027",977,765,763,4,2,"PUM+J",0
43,"43119",838,630,628,4,2,"PUM+J",0
25,"25034",2288,1733,1719,9,14,"PUM+J",3
43,"43035",235,205,203,7,2,"PUM+J",0
43,"43158",77,61,61,1,0,"PUM+J",0
43,"43001",694,543,543,5,0,"PUM+J",0
43,"43098",354,291,291,1,0,"PUM+J",0
25,"25082",295,229,229,2,0,"PUM+J",0
25,"25222",66,57,57,0,0,"PUM+J",0
43,"43089",281,209,208,0,1,"PUM+J",0
25,"25142",365,300,299,2,1,"PUM+J",0
43,"43080",227,195,195,0,0,"PUM+J",0
25,"25038",1482,1111,1094,11,17,"PUM+J",0
25,"25032",67,53,53,0,0,"PUM+J",0
25,"25070",811,677,675,4,2,"PUM+J",2
43,"43141",105,86,86,0,0,"PUM+J",0
25,"25126",284,233,232,1,1,"PUM+J",0
25,"25115",801,638,637,4,1,"PUM+J",0
25,"25031",57,39,39,0,0,"PUM+J",0
43,"43068",483,367,365,5,2,"PUM+J",0
25,"25045",54,31,31,5,0,"PUM+J",0
43,"43079",356,306,305,1,1,"PUM+J",0
43,"43112",250,204,204,1,0,"PUM+J",0
25,"25011",5260,3908,3871,30,37,"PUM+J",4
25,"25254",711,576,571,5,5,"PUM+J",0
25,"25036",184,144,143,0,1,"PUM+J",0
25,"25128",127,87,87,0,0,"PUM+J",0
43,"43012",3647,3028,3019,15,9,"PUM+J",2
43,"43076",460,378,377,2,1,"PUM+J",1
25,"25217",10819,8163,8120,64,43,"PUM+J",3
25,"25190",257,215,215,0,0,"PUM+J",0
25,"25167",226,185,185,2,0,"PUM+J",0
25,"25228",3115,2468,2459,19,9,"PUM+J",1
25,"25912",843,685,684,4,1,"PUM+J",1
25,"25015",335,262,260,8,2,"PUM+J",1
43,"43091",123,93,93,1,0,"PUM+J",0
25,"25203",8798,6279,6231,26,48,"PUM+J",6
25,"25161",343,243,243,0,0,"PUM+J",0
25,"25207",6430,4899,4867,41,32,"PUM+J",6
43,"43135",341,283,280,4,3,"PUM+J",0
25,"25007",1392,1089,1083,4,6,"PUM+J",0
43,"43058",96,77,77,0,0,"PUM+J",0
43,"43061",38,28,28,0,0,"PUM+J",0
43,"43036",865,605,602,1,3,"PUM+J",1
25,"25186",207,174,173,7,1,"PUM+J",0
43,"43045",146,128,127,0,1,"PUM+J",0
43,"43905",14941,10510,10446,40,64,"PUM+J",9
25,"25063",95,61,61,0,0,"PUM+J",0
25,"25218",86,79,79,0,0,"PUM+J",0
43,"43133",5605,4202,4168,21,34,"PUM+J",0
43,"43125",890,700,698,12,2,"PUM+J",1
25,"25205",562,451,447,7,4,"PUM+J",1
43,"43095",2564,1995,1984,14,11,"PUM+J",1
43,"43008",307,202,200,1,2,"PUM+J",0
43,"43013",4392,3341,3321,14,20,"PUM+J",1
43,"43157",345,303,303,0,0,"PUM+J",0
43,"43106",793,656,651,2,5,"PUM+J",1
25,"25010",196,156,155,2,1,"PUM+J",0
25,"25123",189,151,151,0,0,"PUM+J",0
25,"25092",127,101,99,1,2,"PUM+J",0
25,"25105",103,89,88,1,1,"PUM+J",0
25,"25042",208,160,160,1,0,"PUM+J",0
43,"43016",3445,2628,2608,11,20,"PUM+J",2
25,"25056",213,163,163,3,0,"PUM+J",0
43,"43147",521,446,442,4,4,"PUM+J",0
43,"43060",2684,2158,2152,8,6,"PUM+J",0
43,"43031",1446,1180,1178,7,2,"PUM+J",0
43,"43027",164,137,137,0,0,"PUM+J",0
25,"25181",175,136,135,0,1,"PUM+J",0
43,"43175",537,426,419,5,7,"PUM+J",0
43,"43073",84,68,67,0,1,"PUM+J",0
25,"25146",221,172,170,3,2,"PUM+J",0
25,"25053",1092,879,873,8,6,"PUM+J",0
43,"43026",765,614,613,3,1,"PUM+J",0
25,"25171",2127,1639,1630,8,9,"PUM+J",1
43,"43039",105,85,85,0,0,"PUM+J",0
25,"25009",605,505,491,5,14,"PUM+J",0
25,"25012",2342,1748,1739,10,9,"PUM+J",3
25,"25087",56,49,49,0,0,"PUM+J",0
25,"25238",205,163,163,2,0,"PUM+J",0
43,"43085",235,198,194,0,4,"PUM+J",0
25,"25052",1562,1273,1264,3,9,"PUM+J",0
43,"43065",382,308,304,1,4,"PUM+J",0
43,"43163",26013,18942,18796,89,146,"PUM+J",11
25,"25245",430,346,342,1,4,"PUM+J",0
43,"43165",572,492,492,1,0,"PUM+J",2
43,"43113",397,325,323,2,2,"PUM+J",0
25,"25156",784,608,605,4,3,"PUM+J",1
43,"43097",399,341,341,1,0,"PUM+J",0
25,"25252",557,424,422,4,2,"PUM+J",0
43,"43114",375,306,305,0,1,"PUM+J",0
43,"43064",2017,1569,1558,9,11,"PUM+J",1
25,"25911",424,332,331,1,1,"PUM+J",0
43,"43138",2648,1926,1896,8,30,"PUM+J",1
25,"25180",228,176,174,1,2,"PUM+J",0
43,"43022",1435,1130,1123,8,7,"PUM+J",1
43,"43177",284,243,242,0,1,"PUM+J",0
25,"25155",618,493,489,2,4,"PUM+J",0
25,"25023",4527,3621,3601,23,20,"PUM+J",1
43,"43009",1391,1086,1078,3,8,"PUM+J",0
25,"25243",3730,2637,2606,20,31,"PUM+J",2
43,"43025",590,476,472,0,4,"PUM+J",0
43,"43104",1762,1410,1401,5,9,"PUM+J",0
43,"43054",2792,2145,2134,21,11,"PUM+J",0
25,"25151",736,592,584,1,8,"PUM+J",0
25,"25255",395,321,318,2,3,"PUM+J",1
43,"43139",1999,1552,1539,10,13,"PUM+J",0
25,"25025",1378,996,983,8,13,"PUM+J",1
25,"25165",276,221,219,1,2,"PUM+J",1
25,"25906",210,157,155,0,2,"PUM+J",1
43,"43011",1079,912,909,1,3,"PUM+J",0
25,"25234",4201,3087,3072,13,15,"PUM+J",0
25,"25200",323,253,252,0,1,"PUM+J",0
25,"25102",661,517,511,8,6,"PUM+J",0
25,"25225",541,427,420,4,7,"PUM+J",0
43,"43132",363,292,291,2,1,"PUM+J",0
25,"25067",706,537,532,4,5,"PUM+J",0
25,"25112",268,214,212,2,2,"PUM+J",0
25,"25153",192,152,150,1,2,"PUM+J",0
43,"43123",71092,53689,53369,241,320,"PUM+J",57
43,"43007",640,510,509,0,1,"PUM+J",0
43,"43052",934,765,756,2,9,"PUM+J",0
43,"43178",1421,1118,1113,7,5,"PUM+J",1
25,"25223",911,732,723,6,9,"PUM+J",0
25,"25251",713,562,558,4,4,"PUM+J",0
43,"43115",128,112,111,1,1,"PUM+J",0
25,"25125",389,303,300,1,3,"PUM+J",0
25,"25141",152,118,118,1,0,"PUM+J",0
25,"25021",2541,1891,1882,14,9,"PUM+J",0
43,"43156",3956,2993,2965,23,28,"PUM+J",5
25,"25013",2108,1570,1557,12,13,"PUM+J",0
42,"42075",78,60,60,1,0,"PUM+J",0
16,"16063",113,86,83,0,3,"PUM+J",0
45,"45040",1276,842,828,4,14,"PUM+J",2
18,"18061",1000,827,822,1,5,"PUM+J",0
22,"22115",347,262,261,1,1,"PUM+J",0
37,"37332",70,53,53,0,0,"PUM+J",0
19,"19282",143,114,114,1,0,"PUM+J",0
16,"16175",5079,4279,4207,40,72,"PUM+J",1
31,"31070",2628,1930,1881,16,49,"PUM+J",6
26,"26051",210,178,176,1,2,"PUM+J",0
14,"14053",5925,4442,4348,75,94,"PUM+J",6
42,"42064",85,71,71,0,0,"PUM+J",0
9,"9334",48,37,35,0,2,"PUM+J",1
31,"31151",57,42,42,1,0,"PUM+J",0
16,"16053",391,334,327,4,7,"PUM+J",0
16,"16197",66,45,45,0,0,"PUM+J",0
2,"2009",19456,15229,15007,152,222,"PUM+J",12
34,"34027",1046,791,783,13,8,"PUM+J",0
24,"24026",1099,812,799,5,13,"PUM+J",1
47,"47110",438,352,347,4,5,"PUM+J",1
37,"37315",86,68,67,0,1,"PUM+J",0
47,"47105",175,152,149,1,3,"PUM+J",0
24,"24001",168,105,104,0,1,"PUM+J",0
50,"50240",965,720,702,9,18,"PUM+J",0
29,"29084",27218,19648,19352,173,296,"PUM+J",35
28,"28147",990,779,769,2,10,"PUM+J",2
47,"47215",48,44,44,0,0,"PUM+J",0
37,"37034",75,66,66,0,0,"PUM+J",0
19,"19242",77,67,67,0,0,"PUM+J",0
19,"19217",42,38,38,0,0,"PUM+J",0
2,"2023",515,442,435,1,7,"PUM+J",0
47,"47113",142,117,117,1,0,"PUM+J",0
40,"40001",706,597,590,7,7,"PUM+J",0
28,"28113",36716,29939,29607,224,332,"PUM+J",30
22,"22013",275,218,217,6,1,"PUM+J",0
50,"50077",206,158,157,1,1,"PUM+J",0
5,"5212",197,138,136,0,2,"PUM+J",0
33,"33062",388,250,245,9,5,"PUM+J",1
24,"24149",146,123,123,0,0,"PUM+J",2
4,"4093",1919,1346,1326,10,20,"PUM+J",1
50,"50242",93,72,70,0,2,"PUM+J",0
45,"45084",2121,1708,1676,16,32,"PUM+J",0
19,"19188",43,34,33,0,1,"PUM+J",0
9,"9372",204,176,175,1,1,"PUM+J",1
28,"28107",442,336,325,3,11,"PUM+J",0
29,"29086",774,537,532,1,5,"PUM+J",0
31,"31179",483,348,344,2,4,"PUM+J",0
50,"50256",74,46,45,0,1,"PUM+J",0
50,"50270",38,32,30,1,2,"PUM+J",0
18,"18040",226,146,145,0,1,"PUM+J",0
34,"34056",1949,1537,1511,7,26,"PUM+J",3
47,"47046",125,107,104,1,3,"PUM+J",0
50,"50023",208,165,164,2,1,"PUM+J",0
37,"37160",606,431,418,6,13,"PUM+J",0
9,"9213",270,196,196,1,0,"PUM+J",0
35,"35015",10728,6233,6108,54,125,"PUM+J",6
42,"42201",23,20,20,0,0,"PUM+J",0
34,"34230",17,13,13,0,0,"PUM+J",0
29,"29038",18683,12820,12666,168,154,"PUM+J",11
31,"31204",36,27,27,1,0,"PUM+J",0
4,"4065",368,287,284,2,3,"PUM+J",0
19,"19221",35,26,26,0,0,"PUM+J",0
41,"41088",512,383,377,1,6,"PUM+J",0
4,"4027",226,147,147,1,0,"PUM+J",0
28,"28127",66441,56199,55932,327,267,"PUM+J",60
16,"16148",546,481,479,1,2,"PUM+J",0
40,"40152",748,637,620,6,17,"PUM+J",1
24,"24021",1602,1211,1194,7,17,"PUM+J",0
50,"50245",76,58,58,0,0,"PUM+J",0
4,"4004",400,320,315,2,5,"PUM+J",0
42,"42060",29,20,19,0,1,"PUM+J",0
34,"34084",155,127,126,1,1,"PUM+J",0
48,"48048",543,421,419,1,2,"PUM+J",1
16,"16187",55,43,43,0,0,"PUM+J",0
29,"29005",4499,3202,3171,37,31,"PUM+J",6
34,"34068",29,24,23,0,1,"PUM+J",0
19,"19227",73,55,53,0,2,"PUM+J",0
28,"28901",868,653,639,6,14,"PUM+J",1
28,"28013",41563,32024,31693,194,331,"PUM+J",34
39,"39011",1575,1249,1242,3,7,"PUM+J",1
37,"37374",1147,946,923,4,23,"PUM+J",1
23,"23043",518,398,397,0,1,"PUM+J",0
37,"37045",28,19,18,0,1,"PUM+J",0
33,"33021",4361,3098,3043,31,55,"PUM+J",5
9,"9476",60,50,50,0,0,"PUM+J",0
6,"6057",537,442,433,1,9,"PUM+J",0
47,"47004",1136,950,939,5,11,"PUM+J",2
33,"33009",869,595,591,5,4,"PUM+J",1
12,"12036",546,428,420,9,8,"PUM+J",0
39,"39008",13900,10895,10767,81,128,"PUM+J",9
33,"33012",5105,3601,3566,46,35,"PUM+J",4
4,"4036",223,188,186,1,2,"PUM+J",0
18,"18030",567,448,442,4,6,"PUM+J",1
45,"45032",444,319,313,2,6,"PUM+J",1
5,"5122",119,90,88,1,2,"PUM+J",0
42,"42034",44,36,36,1,0,"PUM+J",0
49,"49147",249,197,196,1,1,"PUM+J",0
28,"28031",2140,1642,1614,11,28,"PUM+J",0
24,"24161",295,223,219,0,4,"PUM+J",0
24,"24134",3294,2540,2479,25,61,"PUM+J",6
39,"39073",10200,8230,8150,65,80,"PUM+J",7
37,"37372",134,104,104,0,0,"PUM+J",0
24,"24027",1219,913,886,8,27,"PUM+J",2
18,"18063",1217,712,702,6,10,"PUM+J",0
2,"2068",324,274,273,0,1,"PUM+J",0
6,"6058",1980,1519,1493,13,26,"PUM+J",0
9,"9480",109,87,85,1,2,"PUM+J",0
44,"44183",63,43,43,0,0,"PUM+J",0
49,"49053",915,726,715,5,11,"PUM+J",0
16,"16019",185,147,147,0,0,"PUM+J",0
44,"44265",181,153,148,1,5,"PUM+J",0
16,"16272",199,162,161,1,1,"PUM+J",0
47,"47060",231,198,195,4,3,"PUM+J",1
23,"23101",352,273,271,0,2,"PUM+J",0
12,"12100",1281,1118,1102,5,16,"PUM+J",0
28,"28095",1677,1310,1293,4,17,"PUM+J",0
31,"31132",148,121,121,2,0,"PUM+J",0
7,"7053",1164,956,948,4,8,"PUM+J",0
47,"47099",155,135,133,0,2,"PUM+J",0
16,"16003",133,111,110,1,1,"PUM+J",0
9,"9314",92,75,74,1,1,"PUM+J",1
31,"31154",211,125,124,2,1,"PUM+J",0
4,"4010",580,445,434,2,11,"PUM+J",0
19,"19118",10,10,10,1,0,"PUM+J",0
24,"24058",195,127,125,1,2,"PUM+J",0
32,"32017",1202,821,815,6,6,"PUM+J",0
6,"6080",1890,1482,1467,18,15,"PUM+J",0
19,"19121",264,219,217,0,2,"PUM+J",0
22,"22048",12593,9614,9528,82,86,"PUM+J",11
49,"49119",222,181,180,0,1,"PUM+J",0
16,"16146",87,68,68,0,0,"PUM+J",0
50,"50189",678,544,534,5,10,"PUM+J",0
44,"44125",65,50,50,0,0,"PUM+J",0
31,"31199",141,96,94,0,2,"PUM+J",0
12,"12063",44,37,37,1,0,"PUM+J",0
14,"14009",2669,1863,1844,19,19,"PUM+J",0
19,"19110",56,47,47,0,0,"PUM+J",0
41,"41094",6447,4998,4912,43,86,"PUM+J",3
19,"19279",51,44,44,0,0,"PUM+J",0
28,"28086",5390,3992,3936,26,56,"PUM+J",8
23,"23021",517,446,440,0,6,"PUM+J",0
49,"49076",328,260,258,6,2,"PUM+J",0
26,"26056",403,334,328,2,6,"PUM+J",0
24,"24079",872,671,665,4,6,"PUM+J",0
26,"26169",68,61,61,2,0,"PUM+J",0
19,"19133",81,70,70,0,0,"PUM+J",0
19,"19057",72,59,58,0,1,"PUM+J",1
40,"40159",132,101,101,0,0,"PUM+J",0
9,"9018",24647,18982,18715,184,267,"PUM+J",59
31,"31067",1896,1418,1397,17,21,"PUM+J",3
34,"34019",110,92,91,2,1,"PUM+J",0
5,"5077",158,133,131,1,2,"PUM+J",0
4,"4044",1533,1190,1176,8,14,"PUM+J",0
5,"5213",95,77,75,0,2,"PUM+J",0
5,"5234",46,43,43,0,0,"PUM+J",0
19,"19237",40,33,33,0,0,"PUM+J",0
42,"42198",19,15,15,0,0,"PUM+J",0
12,"12057",578,485,473,3,12,"PUM+J",0
37,"37033",92,69,69,2,0,"PUM+J",0
18,"18059",4253,3166,3123,22,43,"PUM+J",1
47,"47040",61,45,44,0,1,"PUM+J",0
40,"40218",84,62,62,0,0,"PUM+J",0
22,"22204",1119,836,832,9,4,"PUM+J",0
37,"37286",203,147,142,2,5,"PUM+J",0
40,"40129",164,129,128,2,1,"PUM+J",0
31,"31085",502,401,399,5,2,"PUM+J",0
40,"40901",414,331,328,8,3,"PUM+J",1
6,"6024",1133,963,941,5,22,"PUM+J",1
9,"9281",135,104,102,1,2,"PUM+J",0
6,"6040",987,747,739,6,8,"PUM+J",0
28,"28091",5474,4027,3977,26,50,"PUM+J",4
42,"42083",26,22,22,0,0,"PUM+J",0
37,"37299",229,175,168,0,7,"PUM+J",0
40,"40128",122,95,93,2,2,"PUM+J",1
19,"19126",1687,1306,1285,9,21,"PUM+J",1
42,"42202",20,12,11,0,1,"PUM+J",0
48,"48039",256,218,217,1,1,"PUM+J",0
19,"19138",223,176,172,4,4,"PUM+J",0
29,"29024",372,265,250,3,15,"PUM+J",0
45,"45049",423,340,335,1,5,"PUM+J",0
26,"26072",285,252,247,1,5,"PUM+J",0
37,"37357",258,0,0,0,0,"PUM+J",0
16,"16170",653,514,500,3,14,"PUM+J",1
49,"49116",360,255,248,5,7,"PUM+J",0
9,"9061",148,129,129,0,0,"PUM+J",0
18,"18025",279,214,212,0,2,"PUM+J",0
50,"50072",195,164,161,3,3,"PUM+J",0
31,"31205",420,312,310,7,2,"PUM+J",4
7,"7051",5414,3610,3575,37,35,"PUM+J",2
16,"16234",23,16,16,0,0,"PUM+J",0
34,"34102",202,173,171,2,2,"PUM+J",0
5,"5002",1890,1497,1468,8,29,"PUM+J",0
9,"9482",35,28,28,0,0,"PUM+J",0
23,"23007",3026,2317,2301,13,16,"PUM+J",2
37,"37014",1153,414,411,4,3,"PUM+J",0
37,"37290",134,113,112,0,1,"PUM+J",1
26,"26069",230,187,186,0,1,"PUM+J",0
50,"50185",136,103,102,0,1,"PUM+J",0
47,"47075",4775,3849,3784,38,65,"PUM+J",5
37,"37364",757,549,536,7,13,"PUM+J",1
41,"41090",3507,2766,2694,15,72,"PUM+J",1
44,"44236",59,44,44,0,0,"PUM+J",0
5,"5126",62,53,52,0,1,"PUM+J",0
50,"50116",170,132,131,0,1,"PUM+J",0
50,"50032",242,179,176,1,3,"PUM+J",0
40,"40124",234,175,168,3,7,"PUM+J",0
50,"50058",63,54,53,2,1,"PUM+J",0
22,"22212",70,56,56,0,0,"PUM+J",0
14,"14028",307,258,257,0,1,"PUM+J",0
29,"29016",263,217,217,0,0,"PUM+J",0
47,"47101",1644,1354,1337,9,17,"PUM+J",2
22,"22057",364,286,284,3,2,"PUM+J",0
23,"23030",1208,1022,1011,6,11,"PUM+J",0
34,"34046",44,31,31,0,0,"PUM+J",0
39,"39063",954,726,722,4,4,"PUM+J",1
48,"48049",545,448,448,0,0,"PUM+J",0
37,"37191",104,65,65,1,0,"PUM+J",0
34,"34062",150,108,107,1,1,"PUM+J",0
14,"14031",566,453,446,2,7,"PUM+J",0
9,"9154",124,101,101,3,0,"PUM+J",0
29,"29095",3304,2536,2470,22,66,"PUM+J",5
9,"9388",33,28,28,0,0,"PUM+J",0
31,"31038",1336,992,981,8,11,"PUM+J",0
42,"42193",16,7,7,0,0,"PUM+J",0
40,"40041",967,773,764,9,9,"PUM+J",0
19,"19195",37,29,28,2,1,"PUM+J",0
31,"31159",1105,880,871,3,9,"PUM+J",2
49,"49031",145,107,103,0,4,"PUM+J",0
37,"37008",4222,3431,3393,19,38,"PUM+J",7
9,"9119",45,26,26,0,0,"PUM+J",0
22,"22099",465,365,362,3,3,"PUM+J",0
44,"44251",242,197,187,0,10,"PUM+J",0
49,"49193",435,303,287,1,16,"PUM+J",1
38,"38021",1599,1079,1057,8,22,"PUM+J",1
28,"28004",6564,4798,4767,26,31,"PUM+J",7
47,"47157",495,428,426,3,2,"PUM+J",0
29,"29040",1936,1419,1395,7,24,"PUM+J",0
16,"16243",379,323,318,5,5,"PUM+J",0
16,"16181",57,46,46,1,0,"PUM+J",0
6,"6044",29204,21778,21492,203,286,"PUM+J",24
31,"31133",35,28,28,0,0,"PUM+J",0
7,"7056",5245,3883,3841,32,42,"PUM+J",5
5,"5220",363,312,308,5,4,"PUM+J",0
19,"19247",142,118,117,2,1,"PUM+J",0
44,"44247",287,216,215,6,1,"PUM+J",0
19,"19078",50,38,37,0,1,"PUM+J",0
38,"38022",18629,12903,12759,84,144,"PUM+J",11
19,"19271",41,26,26,0,0,"PUM+J",0
50,"50099",3042,2299,2265,20,34,"PUM+J",2
4,"4090",312,253,249,0,4,"PUM+J",0
19,"19248",76,56,56,0,0,"PUM+J",0
32,"32083",821,592,587,7,5,"PUM+J",0
41,"41077",8631,6441,6289,46,152,"PUM+J",6
37,"37208",69,52,51,0,1,"PUM+J",0
42,"42103",554,448,442,2,6,"PUM+J",0
9,"9178",40,27,27,0,0,"PUM+J",0
28,"28046",4776,3944,3912,22,32,"PUM+J",7
9,"9037",106,97,97,0,0,"PUM+J",0
49,"49033",666,515,508,1,7,"PUM+J",2
22,"22197",439,356,353,10,3,"PUM+J",0
47,"47134",148,127,126,6,1,"PUM+J",0
45,"45003",550,435,431,4,4,"PUM+J",0
9,"9262",158,137,136,1,1,"PUM+J",1
2,"2017",777,588,584,0,4,"PUM+J",0
50,"50030",201,138,136,1,2,"PUM+J",0
40,"40115",156,131,130,4,1,"PUM+J",0
19,"19191",13,12,12,0,0,"PUM+J",0
34,"34006",79,73,70,3,3,"PUM+J",0
14,"14005",6318,4464,4380,59,84,"PUM+J",3
31,"31097",10521,7602,7550,76,52,"PUM+J",20
31,"31191",3018,2365,2337,22,28,"PUM+J",3
19,"19115",32,23,23,0,0,"PUM+J",0
28,"28176",13836,11415,11326,64,89,"PUM+J",10
37,"37186",96,79,79,0,0,"PUM+J",0
44,"44150",26,21,21,0,0,"PUM+J",0
24,"24129",111,91,91,1,0,"PUM+J",1
24,"24076",1286,998,981,8,17,"PUM+J",0
38,"38031",29154,22871,22598,143,273,"PUM+J",22
5,"5224",100,91,90,1,1,"PUM+J",1
9,"9327",29,22,22,0,0,"PUM+J",0
14,"14026",2014,1502,1474,10,28,"PUM+J",0
48,"48060",3620,2615,2606,13,9,"PUM+J",1
29,"29067",430670,312817,309994,2768,2823,"PUM+J",400
23,"23056",3062,2332,2281,13,51,"PUM+J",2
38,"38045",3549,2149,2109,6,40,"PUM+J",1
23,"23082",1875,1402,1389,7,13,"PUM+J",0
50,"50191",445,341,337,2,4,"PUM+J",0
40,"40150",61,53,53,1,0,"PUM+J",0
9,"9330",1480,1180,1161,8,19,"PUM+J",1
4,"4082",277,198,196,1,2,"PUM+J",0
37,"37288",276,225,224,5,1,"PUM+J",0
42,"42115",95,77,77,1,0,"PUM+J",0
49,"49267",97,73,68,1,5,"PUM+J",1
47,"47112",2570,2098,2075,13,23,"PUM+J",2
28,"28080",49801,41938,41705,248,233,"PUM+J",50
28,"28177",10722,9093,9029,64,64,"PUM+J",10
31,"31141",107,76,74,0,2,"PUM+J",2
49,"49260",700,558,548,8,10,"PUM+J",0
6,"6029",1183,946,935,12,11,"PUM+J",1
24,"24082",860,690,678,12,12,"PUM+J",0
50,"50104",326,264,259,4,5,"PUM+J",0
26,"26036",17013,12543,12354,95,189,"PUM+J",10
49,"49056",288,232,230,2,2,"PUM+J",2
37,"37056",40,33,33,0,0,"PUM+J",0
5,"5059",92,63,63,0,0,"PUM+J",0
28,"28092",153428,121511,120211,807,1300,"PUM+J",162
9,"9311",59,47,46,0,1,"PUM+J",0
4,"4084",341,258,255,0,3,"PUM+J",0
49,"49273",166,111,110,0,1,"PUM+J",1
40,"40180",277,231,224,3,7,"PUM+J",0
4,"4048",1496,1109,1102,4,7,"PUM+J",3
45,"45096",987,829,813,3,16,"PUM+J",1
2,"2008",1123,857,842,9,15,"PUM+J",4
5,"5242",686,588,585,11,3,"PUM+J",0
19,"19198",17,17,17,0,0,"PUM+J",0
16,"16067",119,96,93,2,3,"PUM+J",0
26,"26001",198,171,165,1,6,"PUM+J",0
16,"16153",936,786,768,7,18,"PUM+J",1
33,"33015",1428,1003,993,7,10,"PUM+J",1
16,"16196",602,522,510,3,12,"PUM+J",0
5,"5247",227,182,177,1,5,"PUM+J",0
39,"39020",23931,17782,17566,126,216,"PUM+J",22
23,"23042",317,234,232,1,2,"PUM+J",0
19,"19065",114,92,91,0,1,"PUM+J",0
44,"44114",238,188,184,1,4,"PUM+J",0
9,"9032",103,72,72,0,0,"PUM+J",1
45,"45112",1841,1250,1220,7,30,"PUM+J",1
37,"37279",726,570,562,6,8,"PUM+J",2
31,"31104",1751,1306,1280,1,26,"PUM+J",7
12,"12021",4377,3528,3473,23,55,"PUM+J",4
37,"37380",56,46,45,1,1,"PUM+J",0
49,"49192",124,102,102,2,0,"PUM+J",0
50,"50067",13788,10562,10413,107,149,"PUM+J",11
14,"14051",1348,1064,1048,7,16,"PUM+J",1
49,"49127",2430,1835,1799,30,36,"PUM+J",3
19,"19258",84,69,66,1,3,"PUM+J",0
14,"14021",260397,195951,193914,2025,2037,"PUM+J",218
19,"19109",33,30,30,1,0,"PUM+J",0
34,"34001",39,32,32,3,0,"PUM+J",0
19,"19255",72,51,51,0,0,"PUM+J",0
4,"4099",4931,3781,3719,24,62,"PUM+J",5
44,"44053",105,81,81,0,0,"PUM+J",0
37,"37156",4276,2621,2572,27,49,"PUM+J",1
47,"47061",243,203,197,3,6,"PUM+J",0
24,"24018",174,141,139,0,2,"PUM+J",0
4,"4087",156,117,116,1,1,"PUM+J",0
37,"37269",430,331,325,2,6,"PUM+J",0
40,"40229",28,24,24,0,0,"PUM+J",0
50,"50119",872,684,680,4,4,"PUM+J",0
49,"49078",142,113,113,1,0,"PUM+J",0
37,"37144",338,275,273,1,2,"PUM+J",0
20,"20023",446,299,299,1,0,"PUM+J",0
47,"47135",82,69,67,1,2,"PUM+J",0
9,"9192",55,48,47,2,1,"PUM+J",0
37,"37307",148,110,107,2,3,"PUM+J",0
12,"12077",4790,3594,3565,39,29,"PUM+J",4
26,"26091",147,132,131,1,1,"PUM+J",0
48,"48902",18971,14015,13895,101,120,"PUM+J",16
50,"50253",382,318,315,2,3,"PUM+J",0
7,"7010",5070,3815,3777,47,38,"PUM+J",4
20,"20020",113,67,67,0,0,"PUM+J",0
34,"34224",42,30,29,0,1,"PUM+J",0
37,"37322",2466,1764,1723,17,41,"PUM+J",4
45,"45020",1239,987,973,4,14,"PUM+J",1
2,"2001",695,567,559,3,8,"PUM+J",0
19,"19145",41,38,38,0,0,"PUM+J",0
19,"19262",123,98,97,0,1,"PUM+J",0
18,"18057",5540,4306,4246,30,60,"PUM+J",8
5,"5195",206,157,157,0,0,"PUM+J",0
50,"50255",197,162,160,2,2,"PUM+J",0
12,"12126",24347,19023,18749,152,274,"PUM+J",14
49,"49080",630,499,493,4,6,"PUM+J",0
9,"9266",103,85,85,0,0,"PUM+J",1
28,"28111",622,492,487,1,5,"PUM+J",1
12,"12078",333,238,235,1,3,"PUM+J",0
31,"31245",77,60,59,4,1,"PUM+J",1
47,"47022",59,56,54,1,2,"PUM+J",0
49,"49012",73,45,45,0,0,"PUM+J",0
24,"24087",586,469,460,4,9,"PUM+J",1
28,"28140",3139,2547,2523,12,24,"PUM+J",1
18,"18095",2002,1566,1537,11,29,"PUM+J",2
9,"9034",292,239,238,2,1,"PUM+J",1
12,"12099",586,449,434,3,15,"PUM+J",0
47,"47033",204,167,167,2,0,"PUM+J",0
5,"5133",67,48,48,0,0,"PUM+J",0
31,"31071",15,13,13,0,0,"PUM+J",0
50,"50200",475,416,407,4,9,"PUM+J",0
16,"16209",111,97,97,0,0,"PUM+J",0
23,"23047",1579,1260,1247,13,13,"PUM+J",2
5,"5029",99,69,69,0,0,"PUM+J",0
40,"40186",34,29,29,0,0,"PUM+J",0
16,"16093",57,47,47,0,0,"PUM+J",0
9,"9308",62,48,48,0,0,"PUM+J",0
37,"37312",244,198,197,1,1,"PUM+J",0
24,"24061",1736,1350,1328,10,22,"PUM+J",2
37,"37161",121,88,88,0,0,"PUM+J",0
44,"44172",295,220,218,4,2,"PUM+J",0
6,"6060",5723,4401,4323,31,78,"PUM+J",2
4,"4077",302,275,275,1,0,"PUM+J",0
9,"9380",73,53,53,0,0,"PUM+J",0
34,"34082",80,68,68,0,0,"PUM+J",0
50,"50004",478,380,376,2,4,"PUM+J",0
28,"28038",5155,4142,4090,20,52,"PUM+J",4
31,"31189",1127,781,775,10,6,"PUM+J",2
29,"29001",4199,3380,3341,20,39,"PUM+J",3
50,"50258",53,33,33,3,0,"PUM+J",0
44,"44151",182,139,138,1,1,"PUM+J",0
33,"33034",10043,6765,6671,69,94,"PUM+J",14
9,"9366",75,60,60,2,0,"PUM+J",0
31,"31167",831,651,636,3,15,"PUM+J",2
38,"38005",5666,3795,3761,24,34,"PUM+J",1
24,"24145",618,443,435,3,8,"PUM+J",0
18,"18108",826,677,669,3,8,"PUM+J",1
50,"50008",5185,3753,3711,35,42,"PUM+J",3
40,"40036",502,413,406,11,7,"PUM+J",1
31,"31086",13640,11040,10966,116,74,"PUM+J",59
29,"29091",9407,6859,6719,63,140,"PUM+J",7
37,"37276",126,101,101,0,0,"PUM+J",0
22,"22133",108,85,83,1,2,"PUM+J",0
9,"9368",28,21,21,1,0,"PUM+J",0
49,"49016",229,189,187,2,2,"PUM+J",0
31,"31060",14185,10582,10485,103,97,"PUM+J",40
44,"44152",67,48,48,2,0,"PUM+J",0
23,"23051",2727,2060,2023,5,37,"PUM+J",0
47,"47016",70,62,61,0,1,"PUM+J",0
23,"23041",491,383,382,0,1,"PUM+J",0
9,"9423",28,26,26,0,0,"PUM+J",0
38,"38007",1625,1124,1104,2,20,"PUM+J",0
45,"45140",1089,887,870,5,17,"PUM+J",1
31,"31169",2205,1597,1568,17,29,"PUM+J",0
31,"31007",126,101,95,3,6,"PUM+J",0
14,"14059",687,571,563,7,8,"PUM+J",0
47,"47184",541,447,441,0,6,"PUM+J",0
31,"31102",136,75,75,2,0,"PUM+J",0
9,"9114",76,63,63,0,0,"PUM+J",0
40,"40904",341,302,300,4,2,"PUM+J",0
26,"26073",94,72,68,0,4,"PUM+J",0
6,"6064",850,658,647,2,11,"PUM+J",0
20,"20030",21198,15734,15654,100,80,"PUM+J",18
19,"19287",136,107,105,3,2,"PUM+J",0
32,"32051",1407,1158,1153,12,5,"PUM+J",0
29,"29015",32064,23769,23461,213,308,"PUM+J",26
18,"18062",11041,8531,8355,71,176,"PUM+J",11
44,"44262",143,115,112,0,3,"PUM+J",1
5,"5191",124,105,105,0,0,"PUM+J",0
42,"42086",33,21,19,0,2,"PUM+J",0
37,"37356",87,66,66,0,0,"PUM+J",0
12,"12113",87,65,64,0,1,"PUM+J",0
40,"40087",87,70,70,0,0,"PUM+J",0
12,"12122",767,655,646,3,9,"PUM+J",1
26,"26141",100,73,73,0,0,"PUM+J",0
9,"9048",1380,1070,1039,8,31,"PUM+J",2
5,"5243",81,63,62,1,1,"PUM+J",0
49,"49167",179,140,136,2,4,"PUM+J",0
42,"42105",46,37,37,1,0,"PUM+J",0
45,"45128",2552,1874,1839,9,35,"PUM+J",0
31,"31131",907,719,712,8,7,"PUM+J",5
45,"45021",2605,1987,1950,23,37,"PUM+J",3
22,"22009",585,439,435,4,4,"PUM+J",0
41,"41092",7679,5668,5568,61,100,"PUM+J",8
9,"9901",340,256,255,1,1,"PUM+J",3
47,"47124",388,322,319,2,3,"PUM+J",0
4,"4075",5427,3989,3961,15,28,"PUM+J",5
18,"18001",230,173,170,1,3,"PUM+J",0
44,"44167",39,30,30,0,0,"PUM+J",0
24,"24069",39,27,27,0,0,"PUM+J",0
49,"49238",268,222,216,2,6,"PUM+J",0
44,"44263",377,296,285,3,11,"PUM+J",0
28,"28182",198,169,169,1,0,"PUM+J",0
47,"47167",242,212,210,0,2,"PUM+J",0
42,"42046",46,35,33,2,2,"PUM+J",0
50,"50187",56,43,43,0,0,"PUM+J",0
31,"31080",490,393,390,2,3,"PUM+J",2
37,"37358",164,142,135,2,7,"PUM+J",0
48,"48078",37991,28582,28382,202,200,"PUM+J",40
45,"45039",208,176,176,0,0,"PUM+J",0
18,"18002",526,400,400,0,0,"PUM+J",0
6,"6111",493,374,370,2,4,"PUM+J",0
20,"20043",1734,1254,1248,5,6,"PUM+J",0
39,"39035",9169,7135,7045,40,90,"PUM+J",5
47,"47221",100,84,83,1,1,"PUM+J",0
34,"34210",103,90,90,1,0,"PUM+J",0
14,"14060",3694,2878,2798,26,80,"PUM+J",6
31,"31215",4669,3580,3508,35,72,"PUM+J",14
37,"37371",258,176,175,0,1,"PUM+J",0
19,"19058",7375,6122,6061,34,61,"PUM+J",11
41,"41086",16209,11006,10881,116,125,"PUM+J",13
42,"42078",1005,769,756,6,13,"PUM+J",0
9,"9215",365,267,264,1,3,"PUM+J",0
6,"6079",644,492,487,3,5,"PUM+J",0
37,"37296",298,241,239,2,2,"PUM+J",0
50,"50070",49,28,28,0,0,"PUM+J",0
19,"19059",74,53,46,0,7,"PUM+J",0
29,"29065",194,150,150,0,0,"PUM+J",0
50,"50901",140,108,108,0,0,"PUM+J",0
4,"4041",330,248,247,1,1,"PUM+J",0
9,"9905",389,308,303,2,5,"PUM+J",2
9,"9085",472,371,365,3,6,"PUM+J",1
50,"50227",110,74,73,2,1,"PUM+J",0
6,"6102",1019,852,842,2,10,"PUM+J",0
6,"6047",837,677,669,6,8,"PUM+J",0
19,"19147",45,36,36,0,0,"PUM+J",0
31,"31219",81,60,59,1,1,"PUM+J",0
47,"47095",41,36,34,2,2,"PUM+J",0
14,"14065",1813,1439,1421,11,18,"PUM+J",0
16,"16035",238,190,188,0,2,"PUM+J",2
45,"45182",987,815,800,7,15,"PUM+J",0
31,"31150",199,140,139,2,1,"PUM+J",0
37,"37198",203,163,162,3,1,"PUM+J",0
28,"28123",61103,52177,51832,338,345,"PUM+J",60
5,"5198",71,51,51,0,0,"PUM+J",0
33,"33073",8186,5090,5023,65,67,"PUM+J",6
16,"16022",78,70,70,0,0,"PUM+J",0
34,"34039",62,49,49,0,0,"PUM+J",0
47,"47003",204,171,168,4,3,"PUM+J",0
34,"34041",84,73,72,3,1,"PUM+J",0
19,"19148",42,35,33,0,2,"PUM+J",0
41,"41089",6629,4904,4814,48,90,"PUM+J",8
5,"5015",68,48,48,1,0,"PUM+J",0
40,"40002",34,30,30,0,0,"PUM+J",0
40,"40107",92,76,74,0,2,"PUM+J",0
23,"23066",4299,3603,3545,13,58,"PUM+J",2
19,"19096",101,81,79,1,2,"PUM+J",0
24,"24197",736,556,552,7,4,"PUM+J",1
45,"45137",1567,1155,1139,11,16,"PUM+J",1
37,"37015",205,131,130,2,1,"PUM+J",0
45,"45047",2668,1922,1882,11,40,"PUM+J",4
34,"34086",99,92,90,2,2,"PUM+J",1
37,"37083",176,160,156,1,4,"PUM+J",0
24,"24226",193,136,134,2,2,"PUM+J",0
47,"47119",87,66,65,1,1,"PUM+J",0
47,"47097",307,258,256,4,2,"PUM+J",0
50,"50083",84,70,68,0,2,"PUM+J",0
42,"42068",78,62,61,2,1,"PUM+J",1
4,"4070",1545,1192,1182,7,10,"PUM+J",0
9,"9012",92,76,75,0,1,"PUM+J",0
31,"31140",115,83,83,2,0,"PUM+J",0
5,"5099",457,392,389,2,3,"PUM+J",0
39,"39048",1765,1429,1420,4,9,"PUM+J",0
9,"9272",259,197,195,2,2,"PUM+J",0
40,"40190",48,40,39,0,1,"PUM+J",0
14,"14018",3611,2802,2741,25,61,"PUM+J",4
49,"49004",111,77,77,4,0,"PUM+J",0
37,"37071",76,67,67,0,0,"PUM+J",0
24,"24039",1954,1563,1552,28,11,"PUM+J",2
2,"2044",1049,746,737,5,9,"PUM+J",1
37,"37151",143,112,111,1,1,"PUM+J",0
47,"47132",39,33,33,0,0,"PUM+J",1
34,"34237",573,479,472,4,7,"PUM+J",0
47,"47057",273,204,200,0,4,"PUM+J",0
39,"39021",467,392,385,2,7,"PUM+J",0
47,"47067",153,119,119,3,0,"PUM+J",0
45,"45171",1326,1032,1013,6,19,"PUM+J",1
6,"6052",3969,3043,2970,21,73,"PUM+J",3
12,"12093",165,128,126,0,2,"PUM+J",0
49,"49164",139,103,102,2,1,"PUM+J",0
31,"31143",93,58,52,0,6,"PUM+J",0
33,"33077",1118,772,761,4,11,"PUM+J",0
37,"37278",789,618,613,8,5,"PUM+J",1
9,"9170",209,164,159,0,5,"PUM+J",0
12,"12042",574,486,479,8,7,"PUM+J",0
6,"6152",1285,952,935,4,17,"PUM+J",1
42,"42208",20,16,16,0,0,"PUM+J",0
7,"7021",230,183,178,3,5,"PUM+J",0
42,"42134",2652,2028,1989,17,39,"PUM+J",3
37,"37216",294,248,247,2,1,"PUM+J",0
31,"31076",2520,2110,2094,21,16,"PUM+J",8
23,"23008",1434,1155,1133,6,22,"PUM+J",0
31,"31211",17,13,13,1,0,"PUM+J",0
12,"12094",875,694,682,2,12,"PUM+J",1
23,"23074",2971,2410,2378,8,32,"PUM+J",1
40,"40182",173,126,124,1,2,"PUM+J",0
34,"34091",122,103,102,4,1,"PUM+J",0
14,"14061",688,567,556,2,11,"PUM+J",2
31,"31023",7609,6371,6319,70,52,"PUM+J",31
19,"19229",57,52,52,0,0,"PUM+J",0
38,"38019",13758,8870,8776,46,94,"PUM+J",2
31,"31227",8111,6198,6129,69,69,"PUM+J",18
47,"47039",166,134,134,0,0,"PUM+J",0
2,"2084",305,221,215,1,6,"PUM+J",0
37,"37281",39,34,33,0,1,"PUM+J",0
16,"16030",22,19,19,1,0,"PUM+J",0
49,"49008",431,293,289,2,4,"PUM+J",0
37,"37020",425,341,339,4,2,"PUM+J",0
9,"9174",781,625,608,3,17,"PUM+J",1
4,"4051",406,343,339,1,4,"PUM+J",0
50,"50244",191,153,150,1,3,"PUM+J",0
26,"26155",149,119,119,0,0,"PUM+J",0
44,"44198",181,151,145,1,6,"PUM+J",0
24,"24109",876,635,619,3,16,"PUM+J",0
50,"50060",170,137,135,2,2,"PUM+J",0
23,"23099",4822,3687,3633,28,54,"PUM+J",1
5,"5181",46,39,39,0,0,"PUM+J",0
34,"34140",96,69,69,1,0,"PUM+J",0
6,"6023",4170,3088,3045,18,43,"PUM+J",0
14,"14012",6076,4579,4489,38,90,"PUM+J",2
7,"7057",7404,5117,5028,50,89,"PUM+J",5
22,"22022",543,441,433,4,8,"PUM+J",1
31,"31120",383,264,260,3,4,"PUM+J",3
28,"28131",13432,10500,10387,81,113,"PUM+J",10
9,"9904",468,371,369,3,2,"PUM+J",1
49,"49035",222,195,195,2,0,"PUM+J",0
50,"50273",32,24,24,0,0,"PUM+J",0
4,"4078",1110,819,814,2,5,"PUM+J",0
19,"19125",40,28,28,0,0,"PUM+J",0
23,"23046",2331,1953,1926,3,27,"PUM+J",1
47,"47012",101,80,80,0,0,"PUM+J",0
48,"48029",8613,6697,6642,52,55,"PUM+J",6
16,"16158",511,428,417,4,11,"PUM+J",1
35,"35024",14243,9496,9394,65,102,"PUM+J",8
2,"2038",266,217,216,1,1,"PUM+J",0
4,"4038",3110,2235,2203,23,32,"PUM+J",1
47,"47127",138,92,89,1,3,"PUM+J",0
40,"40104",284,229,224,2,5,"PUM+J",0
48,"48090",6016,4700,4639,24,61,"PUM+J",3
18,"18187",512,388,387,0,1,"PUM+J",0
9,"9447",43,40,40,0,0,"PUM+J",0
24,"24033",205,146,146,3,0,"PUM+J",0
40,"40118",47,38,37,2,1,"PUM+J",0
37,"37109",177,149,149,3,0,"PUM+J",0
2,"2040",563,516,513,3,3,"PUM+J",0
9,"9432",174,145,137,0,8,"PUM+J",0
44,"44171",182,130,128,0,2,"PUM+J",0
5,"5014",5291,4096,4044,29,52,"PUM+J",1
6,"6071",238,197,193,0,4,"PUM+J",0
22,"22086",209,157,155,1,2,"PUM+J",0
22,"22087",58,47,47,0,0,"PUM+J",0
39,"39019",2229,1785,1751,15,34,"PUM+J",1
40,"40106",183,153,151,2,2,"PUM+J",0
26,"26032",45,37,37,1,0,"PUM+J",1
42,"42189",53,44,42,0,2,"PUM+J",0
50,"50162",137,112,110,2,2,"PUM+J",0
50,"50101",832,625,614,1,11,"PUM+J",0
18,"18084",4458,3467,3417,17,50,"PUM+J",6
19,"19297",32,27,27,0,0,"PUM+J",0
37,"37067",3254,2742,2714,29,28,"PUM+J",6
6,"6159",2339,1577,1507,25,70,"PUM+J",0
26,"26033",163,143,142,3,1,"PUM+J",2
9,"9437",270,227,224,2,3,"PUM+J",1
9,"9058",395,325,317,1,8,"PUM+J",1
16,"16149",154,130,130,2,0,"PUM+J",1
5,"5016",6354,5090,5005,40,85,"PUM+J",10
22,"22077",362,301,293,3,8,"PUM+J",0
5,"5266",102,79,78,0,1,"PUM+J",0
26,"26082",100,85,85,0,0,"PUM+J",0
31,"31153",2173,1591,1580,10,11,"PUM+J",2
31,"31235",157,121,118,0,3,"PUM+J",1
19,"19015",84,74,73,0,1,"PUM+J",0
31,"31112",93,71,70,0,1,"PUM+J",0
14,"14902",1121,928,900,7,28,"PUM+J",0
31,"31207",285,209,206,1,3,"PUM+J",0
14,"14007",15042,10970,10758,86,212,"PUM+J",5
37,"37055",118,96,95,0,1,"PUM+J",0
31,"31222",58,38,38,3,0,"PUM+J",0
16,"16039",367,263,262,2,1,"PUM+J",1
24,"24131",677,468,463,1,5,"PUM+J",0
19,"19117",1611,1279,1257,7,22,"PUM+J",0
37,"37114",78,64,59,0,5,"PUM+J",0
19,"19254",43,36,36,0,0,"PUM+J",0
40,"40156",281,223,222,1,1,"PUM+J",0
31,"31073",296,218,217,3,1,"PUM+J",0
50,"50017",1779,1386,1373,14,13,"PUM+J",1
47,"47006",186,153,149,1,4,"PUM+J",0
28,"28178",1134,949,935,1,14,"PUM+J",1
50,"50075",72,59,59,1,0,"PUM+J",0
12,"12041",100,76,75,0,1,"PUM+J",0
47,"47078",159,135,131,0,4,"PUM+J",0
41,"41082",3359,2760,2718,11,42,"PUM+J",2
49,"49246",217,180,177,2,3,"PUM+J",0
28,"28116",759,621,618,7,3,"PUM+J",0
34,"34060",135,111,110,0,1,"PUM+J",1
42,"42085",178,133,133,3,0,"PUM+J",0
19,"19038",22,19,19,0,0,"PUM+J",0
19,"19153",22,22,22,0,0,"PUM+J",0
37,"37165",31,22,21,0,1,"PUM+J",0
33,"33026",8270,5540,5474,69,66,"PUM+J",10
31,"31142",1390,994,982,8,12,"PUM+J",1
4,"4085",371,305,303,2,2,"PUM+J",0
40,"40158",15,13,13,1,0,"PUM+J",0
16,"16085",135,109,109,1,0,"PUM+J",0
19,"19120",108,90,90,1,0,"PUM+J",0
12,"12001",1033,834,825,8,9,"PUM+J",0
31,"31170",45,37,36,2,1,"PUM+J",0
40,"40028",105,96,96,1,0,"PUM+J",0
50,"50260",32,28,28,0,0,"PUM+J",0
49,"49075",134,118,114,1,4,"PUM+J",1
44,"44185",93,73,72,1,1,"PUM+J",0
9,"9016",84,55,54,0,1,"PUM+J",0
31,"31035",50,34,32,0,2,"PUM+J",0
37,"37267",182,153,150,1,3,"PUM+J",3
31,"31036",895,665,659,8,6,"PUM+J",3
32,"32089",1220,872,857,15,15,"PUM+J",0
34,"34049",329,251,247,5,4,"PUM+J",0
50,"50261",205,171,167,1,4,"PUM+J",0
47,"47196",28,24,24,0,0,"PUM+J",0
44,"44249",46,37,37,1,0,"PUM+J",0
19,"19304",220,177,175,1,2,"PUM+J",0
50,"50020",802,606,600,7,6,"PUM+J",0
4,"4062",4460,3466,3425,12,41,"PUM+J",2
40,"40040",2495,1913,1895,20,18,"PUM+J",7
24,"24017",538,427,424,2,3,"PUM+J",1
49,"49139",153,111,110,1,1,"PUM+J",0
44,"44026",95,76,75,2,1,"PUM+J",0
34,"34063",87,77,77,1,0,"PUM+J",0
31,"31160",105,87,86,1,1,"PUM+J",0
24,"24057",1306,1018,997,7,21,"PUM+J",0
32,"32034",1074,855,846,1,9,"PUM+J",1
44,"44056",457,352,341,4,11,"PUM+J",0
7,"7902",1091,776,743,10,33,"PUM+J",2
26,"26129",936,770,759,1,11,"PUM+J",0
4,"4088",2435,1708,1693,6,15,"PUM+J",2
42,"42089",57,48,48,1,0,"PUM+J",0
42,"42184",56,42,41,1,1,"PUM+J",0
33,"33029",323,172,170,2,2,"PUM+J",0
19,"19124",380,271,268,0,3,"PUM+J",1
45,"45116",680,547,537,4,10,"PUM+J",0
19,"19261",32,24,24,0,0,"PUM+J",0
18,"18093",2756,1902,1885,8,17,"PUM+J",1
12,"12902",2248,1678,1653,7,25,"PUM+J",1
44,"44008",1565,1158,1138,8,20,"PUM+J",2
28,"28152",16839,14205,14151,87,54,"PUM+J",14
14,"14023",2007,1734,1711,9,23,"PUM+J",2
50,"50264",147,122,120,0,2,"PUM+J",0
23,"23035",1103,903,882,6,21,"PUM+J",0
14,"14043",7408,5721,5619,76,102,"PUM+J",6
28,"28097",125,100,100,0,0,"PUM+J",1
16,"16224",77,61,60,1,1,"PUM+J",0
28,"28088",286,193,193,2,0,"PUM+J",0
49,"49063",310,246,240,2,6,"PUM+J",0
34,"34023",5098,4016,3973,48,43,"PUM+J",6
35,"35033",6403,4565,4502,34,63,"PUM+J",1
40,"40009",40,34,34,0,0,"PUM+J",0
40,"40045",120,92,92,1,0,"PUM+J",1
24,"24167",716,516,505,4,11,"PUM+J",0
35,"35025",1773,1247,1235,9,12,"PUM+J",3
47,"47084",1101,880,871,7,9,"PUM+J",0
16,"16173",190,141,141,0,0,"PUM+J",0
45,"45026",218,177,172,0,5,"PUM+J",0
5,"5107",55,43,43,2,0,"PUM+J",0
35,"35034",8396,4599,4546,55,53,"PUM+J",3
5,"5081",37,29,29,0,0,"PUM+J",0
12,"12058",64,56,56,0,0,"PUM+J",0
22,"22076",288,228,226,1,2,"PUM+J",0
31,"31042",2695,2071,2043,21,28,"PUM+J",6
37,"37037",107,86,86,0,0,"PUM+J",0
22,"22103",676,520,517,6,3,"PUM+J",2
37,"37209",410,288,283,3,5,"PUM+J",0
49,"49200",936,744,726,10,18,"PUM+J",1
22,"22218",40,32,31,1,1,"PUM+J",0
19,"19209",41,35,34,0,1,"PUM+J",0
19,"19208",41,34,34,0,0,"PUM+J",0
6,"6070",7686,6083,5948,44,135,"PUM+J",2
12,"12059",228,191,188,0,3,"PUM+J",0
24,"24181",1414,1067,1055,14,12,"PUM+J",0
26,"26020",454,347,337,4,10,"PUM+J",0
49,"49146",274,213,209,1,4,"PUM+J",0
22,"22051",91,78,78,1,0,"PUM+J",0
28,"28903",35344,30490,30287,201,203,"PUM+J",38
44,"44021",104,86,85,2,1,"PUM+J",0
6,"6049",974,732,712,7,20,"PUM+J",0
19,"19283",32,26,26,0,0,"PUM+J",0
2,"2042",818,631,620,1,11,"PUM+J",0
18,"18085",701,465,460,1,5,"PUM+J",0
41,"41080",1240,940,913,11,27,"PUM+J",2
49,"49067",336,236,232,0,4,"PUM+J",0
33,"33003",612,373,369,6,4,"PUM+J",1
9,"9310",15,14,13,1,1,"PUM+J",0
24,"24144",639,469,462,2,7,"PUM+J",1
18,"18167",1850,1330,1317,17,13,"PUM+J",1
44,"44032",17,13,13,0,0,"PUM+J",0
29,"29090",1653,1215,1200,8,15,"PUM+J",2
44,"44052",74,50,49,0,1,"PUM+J",0
9,"9348",133,105,104,0,1,"PUM+J",0
19,"19225",851,664,650,3,14,"PUM+J",1
26,"26164",51,37,37,1,0,"PUM+J",0
47,"47214",1364,1112,1074,7,38,"PUM+J",1
49,"49028",105,94,93,1,1,"PUM+J",0
37,"37200",196,145,145,0,0,"PUM+J",0
14,"14058",7859,5854,5745,51,109,"PUM+J",4
34,"34028",134,110,107,3,3,"PUM+J",0
31,"31046",53,39,39,0,0,"PUM+J",0
45,"45201",3620,2465,2419,10,46,"PUM+J",4
40,"40014",56,44,43,2,1,"PUM+J",0
20,"20069",147441,111102,110598,762,504,"PUM+J",137
9,"9169",97,86,85,0,1,"PUM+J",0
47,"47131",165,127,127,3,0,"PUM+J",0
22,"22208",194,159,156,1,3,"PUM+J",0
16,"16151",64,52,52,0,0,"PUM+J",1
42,"42177",64,55,54,6,1,"PUM+J",0
9,"9131",480,412,402,2,10,"PUM+J",3
5,"5204",583,486,482,4,4,"PUM+J",1
48,"48044",62054,49055,48840,373,215,"PUM+J",82
28,"28093",2142,1751,1728,9,23,"PUM+J",6
29,"29014",222,151,150,6,1,"PUM+J",0
50,"50084",66,47,47,0,0,"PUM+J",0
19,"19052",21,16,16,0,0,"PUM+J",0
40,"40061",65,50,48,2,2,"PUM+J",0
26,"26100",56,46,46,0,0,"PUM+J",0
4,"4073",336,243,243,0,0,"PUM+J",0
19,"19089",25,19,19,1,0,"PUM+J",0
47,"47217",1973,1569,1541,19,28,"PUM+J",3
40,"40062",57,49,49,0,0,"PUM+J",0
18,"18010",532,420,416,2,4,"PUM+J",0
24,"24202",7559,5449,5363,63,86,"PUM+J",8
44,"44080",284,214,212,1,2,"PUM+J",1
6,"6020",1739,1420,1387,5,33,"PUM+J",0
42,"42044",53,41,39,0,2,"PUM+J",0
37,"37367",185,150,148,4,2,"PUM+J",0
19,"19215",144,121,119,0,2,"PUM+J",0
18,"18910",730,491,487,0,4,"PUM+J",0
19,"19321",34,29,29,0,0,"PUM+J",0
12,"12064",80,75,73,1,2,"PUM+J",1
14,"14030",7797,6116,6036,54,80,"PUM+J",0
42,"42119",145,90,89,6,1,"PUM+J",0
4,"4086",1643,1226,1209,6,17,"PUM+J",1
29,"29083",2062,1607,1574,9,33,"PUM+J",1
44,"44066",87,66,65,0,1,"PUM+J",0
6,"6142",259,214,208,1,6,"PUM+J",0
37,"37167",177,159,158,3,1,"PUM+J",0
18,"18033",279,221,220,1,1,"PUM+J",0
44,"44124",73,58,57,0,1,"PUM+J",0
45,"45037",1535,1121,1105,7,16,"PUM+J",0
41,"41084",2815,2177,2111,3,66,"PUM+J",1
6,"6143",3370,2635,2589,23,46,"PUM+J",2
5,"5244",41,32,32,0,0,"PUM+J",0
34,"34034",115,96,95,3,1,"PUM+J",1
34,"34035",100,84,82,1,2,"PUM+J",0
16,"16016",216,175,174,3,1,"PUM+J",0
47,"47091",74,64,63,1,1,"PUM+J",0
19,"19187",42,36,36,0,0,"PUM+J",0
50,"50087",29,18,18,0,0,"PUM+J",0
19,"19231",10,7,7,0,0,"PUM+J",0
14,"14032",393,328,321,2,7,"PUM+J",0
33,"33008",1705,1285,1273,9,12,"PUM+J",0
44,"44038",98,83,80,0,3,"PUM+J",0
6,"6144",512,422,416,1,6,"PUM+J",0
18,"18140",42374,29390,29025,221,365,"PUM+J",29
4,"4037",1221,975,960,8,15,"PUM+J",1
31,"31053",503,375,370,4,5,"PUM+J",0
39,"39091",1885,1512,1503,6,9,"PUM+J",0
40,"40206",162,132,128,2,4,"PUM+J",3
24,"24032",102,84,83,0,1,"PUM+J",0
47,"47093",797,628,615,6,13,"PUM+J",0
50,"50254",174,123,122,0,1,"PUM+J",0
40,"40231",98,80,80,2,0,"PUM+J",0
44,"44240",149,121,121,0,0,"PUM+J",0
29,"29041",3599,2570,2532,22,38,"PUM+J",1
37,"37092",1889,1459,1447,16,12,"PUM+J",1
40,"40173",142,122,117,1,5,"PUM+J",0
22,"22060",1172,906,901,13,5,"PUM+J",1
24,"24071",967,755,741,7,14,"PUM+J",1
18,"18913",781,590,577,5,13,"PUM+J",0
42,"42215",735,540,529,5,11,"PUM+J",0
31,"31054",454,322,318,4,4,"PUM+J",2
50,"50141",109,90,90,1,0,"PUM+J",0
6,"6013",265,227,221,0,6,"PUM+J",0
31,"31216",3871,2861,2832,32,29,"PUM+J",6
37,"37248",152,125,121,1,4,"PUM+J",0
5,"5196",57,45,42,0,3,"PUM+J",0
38,"38013",3019,2023,1991,12,32,"PUM+J",3
31,"31055",263,199,197,3,2,"PUM+J",1
37,"37050",67,54,54,0,0,"PUM+J",0
41,"41078",2459,1910,1895,24,15,"PUM+J",2
47,"47002",18,18,18,0,0,"PUM+J",0
40,"40033",67,57,57,1,0,"PUM+J",0
4,"4002",1039,798,792,7,6,"PUM+J",1
47,"47023",3057,2577,2557,21,20,"PUM+J",4
40,"40163",41,38,38,0,0,"PUM+J",0
31,"31178",472,354,348,3,6,"PUM+J",0
48,"48071",6038,4711,4674,27,37,"PUM+J",4
5,"5121",262,201,199,0,2,"PUM+J",0
22,"22230",288,229,228,3,1,"PUM+J",0
9,"9009",158,139,137,4,2,"PUM+J",2
49,"49037",177,146,143,1,3,"PUM+J",1
37,"37013",107,73,72,0,1,"PUM+J",0
22,"22025",1035,764,755,24,9,"PUM+J",1
37,"37362",4729,3769,3720,36,49,"PUM+J",6
31,"31138",954,699,698,8,1,"PUM+J",0
18,"18005",362,268,265,0,3,"PUM+J",0
20,"20906",130,99,98,1,1,"PUM+J",0
9,"9384",295,222,216,1,6,"PUM+J",2
22,"22027",306,230,225,3,5,"PUM+J",0
47,"47129",855,715,696,3,19,"PUM+J",1
31,"31057",1741,1365,1344,12,21,"PUM+J",4
50,"50064",438,368,362,1,6,"PUM+J",0
37,"37098",304,214,210,0,4,"PUM+J",1
37,"37099",61,46,46,1,0,"PUM+J",0
47,"47161",3945,3370,3344,20,26,"PUM+J",5
40,"40178",90,63,63,1,0,"PUM+J",0
49,"49084",268,226,223,9,3,"PUM+J",0
47,"47086",3823,3090,3046,24,44,"PUM+J",5
48,"48042",1365,1136,1130,7,6,"PUM+J",0
49,"49040",112,97,97,0,0,"PUM+J",0
24,"24183",752,549,543,8,6,"PUM+J",2
44,"44042",114,84,84,0,0,"PUM+J",0
50,"50092",300,234,230,1,4,"PUM+J",1
38,"38015",4067,2951,2926,22,25,"PUM+J",1
6,"6018",740,543,536,5,7,"PUM+J",0
35,"35019",32841,21136,20850,125,286,"PUM+J",19
19,"19050",15,13,13,0,0,"PUM+J",0
28,"28050",4367,3411,3384,14,27,"PUM+J",0
37,"37201",237,188,187,1,1,"PUM+J",1
50,"50036",100,80,80,0,0,"PUM+J",0
34,"34012",340,271,265,2,6,"PUM+J",0
2,"2080",499,409,400,0,9,"PUM+J",1
44,"44246",1590,1173,1150,11,23,"PUM+J",3
5,"5074",665,571,565,2,6,"PUM+J",0
31,"31087",181,136,135,6,1,"PUM+J",1
5,"5215",159,126,124,0,2,"PUM+J",0
28,"28106",78429,59182,58471,417,711,"PUM+J",101
19,"19241",35,24,23,2,1,"PUM+J",0
50,"50175",924,713,710,9,3,"PUM+J",1
37,"37365",166,132,131,1,1,"PUM+J",0
4,"4072",314,245,240,0,5,"PUM+J",0
37,"37057",209,165,162,2,3,"PUM+J",0
20,"20029",4272,3257,3239,18,18,"PUM+J",3
40,"40039",180,147,144,1,3,"PUM+J",0
31,"31021",60,47,47,3,0,"PUM+J",0
37,"37366",41,30,30,0,0,"PUM+J",0
49,"49042",230,179,174,1,5,"PUM+J",0
26,"26152",27,23,23,1,0,"PUM+J",0
44,"44207",130,101,101,1,0,"PUM+J",0
47,"47090",2435,1956,1921,12,35,"PUM+J",1
19,"19136",12,12,12,0,0,"PUM+J",0
44,"44261",722,584,578,8,6,"PUM+J",0
23,"23086",11442,8618,8431,80,187,"PUM+J",10
2,"2034",1324,1088,1083,10,5,"PUM+J",0
26,"26153",10,9,9,0,0,"PUM+J",0
24,"24002",233,183,183,1,0,"PUM+J",0
45,"45051",1634,1336,1290,9,46,"PUM+J",1
22,"22068",65,46,44,1,2,"PUM+J",0
35,"35012",10765,6327,6270,32,57,"PUM+J",5
19,"19272",65,58,56,1,2,"PUM+J",0
20,"20031",183,125,125,2,0,"PUM+J",0
31,"31185",470,335,332,6,3,"PUM+J",0
39,"39052",18957,15123,14985,106,138,"PUM+J",13
50,"50243",311,252,247,1,5,"PUM+J",0
40,"40148",228,185,180,0,5,"PUM+J",0
45,"45006",1326,983,972,6,11,"PUM+J",3
49,"49166",1192,916,899,10,17,"PUM+J",0
48,"48057",5745,4391,4376,13,15,"PUM+J",1
28,"28109",1622,1205,1192,3,13,"PUM+J",3
50,"50039",467,366,364,3,2,"PUM+J",1
5,"5219",37,30,30,0,0,"PUM+J",0
34,"34190",49,36,36,3,0,"PUM+J",0
31,"31146",29,25,25,1,0,"PUM+J",0
9,"9279",167,131,128,2,3,"PUM+J",0
47,"47102",264,217,211,1,6,"PUM+J",0
31,"31147",106,88,86,3,2,"PUM+J",0
18,"18045",1060,748,737,10,11,"PUM+J",0
5,"5024",198,142,139,2,3,"PUM+J",0
31,"31065",1859,1383,1366,16,17,"PUM+J",1
45,"45100",179,150,148,1,2,"PUM+J",0
31,"31106",718,585,581,3,4,"PUM+J",0
33,"33019",2882,1981,1939,8,42,"PUM+J",0
44,"44239",22,19,19,0,0,"PUM+J",0
19,"19111",162,142,142,0,0,"PUM+J",0
37,"37282",194,148,146,1,2,"PUM+J",0
50,"50169",336,261,259,2,2,"PUM+J",0
34,"34159",370,247,244,5,3,"PUM+J",1
31,"31039",92,72,70,1,2,"PUM+J",0
47,"47126",44,42,42,1,0,"PUM+J",0
5,"5012",121,100,97,0,3,"PUM+J",0
34,"34081",60,48,48,0,0,"PUM+J",0
19,"19160",905,618,613,3,5,"PUM+J",2
23,"23011",2134,1649,1614,11,35,"PUM+J",1
23,"23045",2057,1519,1507,7,12,"PUM+J",1
2,"2014",350,285,280,1,5,"PUM+J",0
9,"9343",93,73,72,1,1,"PUM+J",0
28,"28036",2675,2135,2093,17,42,"PUM+J",7
45,"45102",3585,2724,2676,20,48,"PUM+J",6
12,"12046",182,161,161,1,0,"PUM+J",0
26,"26145",237,207,204,0,3,"PUM+J",1
47,"47104",2836,2339,2267,23,72,"PUM+J",2
16,"16159",209,147,144,0,3,"PUM+J",0
7,"7058",2857,2258,2233,18,25,"PUM+J",1
5,"5184",240,207,204,1,3,"PUM+J",0
18,"18047",6074,4437,4353,33,84,"PUM+J",3
14,"14044",1620,1279,1264,12,15,"PUM+J",2
37,"37297",401,319,315,2,4,"PUM+J",0
19,"19113",446,352,342,3,10,"PUM+J",1
16,"16074",28,23,23,0,0,"PUM+J",0
41,"41013",4807,3480,3425,30,55,"PUM+J",1
47,"47159",831,703,693,0,10,"PUM+J",1
31,"31177",251,172,168,1,4,"PUM+J",0
9,"9382",30,24,23,0,1,"PUM+J",1
9,"9039",56,44,44,0,0,"PUM+J",0
39,"39074",7041,5612,5551,31,61,"PUM+J",3
37,"37052",278,201,199,2,2,"PUM+J",0
50,"50015",81,61,59,1,2,"PUM+J",0
24,"24049",1415,1146,1134,8,12,"PUM+J",0
16,"16078",41517,31810,31486,340,324,"PUM+J",42
6,"6125",1679,1348,1324,5,24,"PUM+J",0
26,"26162",112,95,94,0,1,"PUM+J",0
19,"19064",64,56,56,0,0,"PUM+J",0
23,"23014",2552,2056,2020,11,36,"PUM+J",1
16,"16265",20,20,19,0,1,"PUM+J",0
40,"40142",52,42,40,0,2,"PUM+J",0
40,"40013",56,47,47,0,0,"PUM+J",0
47,"47096",126,106,105,0,1,"PUM+J",0
9,"9218",347,277,271,0,6,"PUM+J",1
42,"42095",1857,1498,1473,21,25,"PUM+J",1
40,"40082",106,83,81,0,2,"PUM+J",0
9,"9128",78,63,61,1,2,"PUM+J",0
37,"37375",673,583,573,4,10,"PUM+J",0
26,"26163",124,106,104,1,2,"PUM+J",0
26,"26046",1571,1185,1157,18,28,"PUM+J",1
37,"37300",547,392,391,5,1,"PUM+J",0
2,"2054",383,314,309,1,5,"PUM+J",0
50,"50192",233,189,183,0,6,"PUM+J",0
47,"47005",502,420,414,2,6,"PUM+J",0
22,"22078",438,326,323,3,3,"PUM+J",2
28,"28167",8608,7086,7015,48,71,"PUM+J",5
22,"22043",93,68,67,1,1,"PUM+J",0
47,"47077",237,187,183,2,4,"PUM+J",0
48,"48063",356,277,274,2,3,"PUM+J",2
32,"32086",2563,1699,1686,19,13,"PUM+J",0
42,"42054",19,15,15,0,0,"PUM+J",0
5,"5267",107,71,70,3,1,"PUM+J",0
5,"5033",170,146,145,0,1,"PUM+J",0
28,"28115",62352,53136,52912,268,224,"PUM+J",50
5,"5073",289,239,238,0,1,"PUM+J",0
9,"9439",1054,867,851,8,16,"PUM+J",4
19,"19105",2540,2013,1988,13,25,"PUM+J",6
9,"9027",48,41,39,0,2,"PUM+J",0
50,"50268",42,33,32,1,1,"PUM+J",0
4,"4032",5698,4168,4138,20,30,"PUM+J",0
9,"9332",140,103,102,0,1,"PUM+J",0
20,"20008",704,455,449,6,6,"PUM+J",0
26,"26048",22,22,22,0,0,"PUM+J",0
9,"9029",144,120,118,3,2,"PUM+J",0
40,"40037",34,19,19,0,0,"PUM+J",0
19,"19119",75,68,66,2,2,"PUM+J",0
18,"18042",418,344,340,7,4,"PUM+J",0
37,"37341",48,36,36,0,0,"PUM+J",0
42,"42017",131,104,104,2,0,"PUM+J",0
16,"16216",278,243,240,0,3,"PUM+J",0
31,"31197",65,56,56,0,0,"PUM+J",0
50,"50106",127,97,96,0,1,"PUM+J",0
4,"4097",242,184,184,0,0,"PUM+J",0
38,"38028",22035,15684,15522,86,162,"PUM+J",11
23,"23052",1108,949,931,8,18,"PUM+J",0
38,"38048",3957,2889,2842,12,47,"PUM+J",2
19,"19107",315,273,270,2,3,"PUM+J",0
32,"32023",1132,867,862,7,5,"PUM+J",0
29,"29093",2164,1704,1678,4,26,"PUM+J",1
33,"33017",2997,2096,2058,29,38,"PUM+J",0
26,"26087",170,136,135,3,1,"PUM+J",0
33,"33027",769,505,497,14,8,"PUM+J",2
48,"48066",347,291,291,0,0,"PUM+J",0
42,"42100",31,27,27,0,0,"PUM+J",1
6,"6902",1663,1273,1252,4,21,"PUM+J",0
47,"47008",22,15,15,0,0,"PUM+J",0
18,"18078",710,561,554,4,7,"PUM+J",0
48,"48067",1134,877,872,5,5,"PUM+J",1
49,"49020",261,215,210,2,5,"PUM+J",0
16,"16169",51,36,32,0,4,"PUM+J",0
22,"22125",39429,29988,29612,337,376,"PUM+J",52
32,"32033",676,480,468,4,12,"PUM+J",0
37,"37305",218,180,178,3,2,"PUM+J",0
49,"49059",88,72,71,0,1,"PUM+J",0
29,"29028",1224,875,858,4,17,"PUM+J",3
28,"28181",20669,17314,17205,101,109,"PUM+J",15
19,"19074",65,60,60,0,0,"PUM+J",0
4,"4100",9266,6046,5988,49,58,"PUM+J",5
12,"12085",5079,3504,3459,13,45,"PUM+J",0
37,"37074",140,107,106,1,1,"PUM+J",0
9,"9244",45,35,35,0,0,"PUM+J",0
45,"45114",560,441,436,0,5,"PUM+J",0
4,"4063",1063,847,835,5,12,"PUM+J",0
9,"9463",250,203,201,6,2,"PUM+J",0
2,"2061",618,504,500,7,4,"PUM+J",0
9,"9358",248,186,179,1,7,"PUM+J",0
39,"39006",1721,1332,1315,3,17,"PUM+J",1
9,"9082",36,34,34,0,0,"PUM+J",0
14,"14052",9080,5999,5909,63,90,"PUM+J",1
49,"49062",105,69,69,1,0,"PUM+J",0
31,"31201",151084,115375,114510,1072,865,"PUM+J",386
34,"34066",57,52,48,1,4,"PUM+J",0
6,"6045",476,368,362,3,6,"PUM+J",0
19,"19325",144,87,87,1,0,"PUM+J",0
26,"26029",36,29,28,0,1,"PUM+J",0
50,"50197",96,78,78,1,0,"PUM+J",1
47,"47011",557,478,476,5,2,"PUM+J",0
9,"9176",59,50,47,2,3,"PUM+J",1
49,"49266",70,51,49,2,2,"PUM+J",0
42,"42157",10,10,10,0,0,"PUM+J",0
50,"50022",504,396,386,11,10,"PUM+J",1
31,"31040",173,139,139,1,0,"PUM+J",0
47,"47021",72,63,63,0,0,"PUM+J",0
40,"40020",155,125,119,4,6,"PUM+J",0
22,"22049",74,63,63,0,0,"PUM+J",0
49,"49064",483,319,317,1,2,"PUM+J",0
9,"9446",12,8,8,0,0,"PUM+J",0
50,"50110",336,268,266,1,2,"PUM+J",0
42,"42158",94,78,78,0,0,"PUM+J",0
26,"26132",106,87,87,0,0,"PUM+J",0
37,"37272",133,106,106,1,0,"PUM+J",0
37,"37196",72,56,53,0,3,"PUM+J",0
18,"18904",743,555,545,1,10,"PUM+J",0
16,"16225",59,40,40,0,0,"PUM+J",1
41,"41022",4269,3158,3110,16,48,"PUM+J",0
40,"40162",387,286,278,3,8,"PUM+J",0
4,"4103",1439,1120,1108,16,12,"PUM+J",3
38,"38003",1510,1058,1047,4,11,"PUM+J",0
16,"16192",43,30,29,0,1,"PUM+J",0
18,"18905",15550,11394,11230,132,164,"PUM+J",11
5,"5251",56,39,39,0,0,"PUM+J",0
26,"26080",453,385,383,2,2,"PUM+J",0
24,"24169",2809,2165,2146,18,19,"PUM+J",3
44,"44159",37,32,32,1,0,"PUM+J",0
31,"31083",50,41,41,1,0,"PUM+J",1
49,"49185",156,126,120,1,6,"PUM+J",0
6,"6004",1549,1276,1257,6,19,"PUM+J",0
9,"9472",52,45,44,0,1,"PUM+J",0
34,"34218",445,352,345,2,7,"PUM+J",0
37,"37197",87,63,63,0,0,"PUM+J",0
40,"40234",376,307,299,2,8,"PUM+J",0
9,"9347",135,108,108,0,0,"PUM+J",0
49,"49159",269,214,213,1,1,"PUM+J",0
9,"9010",32,27,27,1,0,"PUM+J",0
5,"5252",58,38,38,0,0,"PUM+J",0
18,"18906",911,722,716,4,6,"PUM+J",0
37,"37313",534,413,411,1,2,"PUM+J",0
48,"48072",970,735,730,1,5,"PUM+J",1
49,"49271",181,147,144,1,3,"PUM+J",0
23,"23094",3729,3111,3077,16,34,"PUM+J",1
37,"37162",209,156,153,1,3,"PUM+J",0
24,"24023",262,208,206,3,2,"PUM+J",0
34,"34071",161,138,138,0,0,"PUM+J",0
50,"50201",444,357,354,1,3,"PUM+J",0
16,"16081",49,42,42,0,0,"PUM+J",1
19,"19267",21,17,17,1,0,"PUM+J",0
28,"28124",59,52,52,0,0,"PUM+J",0
32,"32011",918,526,521,6,5,"PUM+J",0
28,"28019",1269,990,981,4,9,"PUM+J",0
41,"41098",5152,4046,3986,24,60,"PUM+J",4
49,"49027",126,88,88,0,0,"PUM+J",0
49,"49111",121,100,100,3,0,"PUM+J",0
50,"50286",75,58,55,0,3,"PUM+J",0
40,"40166",253,214,213,1,1,"PUM+J",0
47,"47121",521,429,422,5,7,"PUM+J",0
40,"40049",40,30,29,0,1,"PUM+J",0
4,"4095",690,508,502,2,6,"PUM+J",1
2,"2019",2368,2009,1975,5,34,"PUM+J",7
50,"50287",252,200,196,7,4,"PUM+J",1
45,"45064",3998,3166,3117,17,49,"PUM+J",5
32,"32022",1238,924,916,5,8,"PUM+J",1
29,"29025",41515,29572,29311,221,261,"PUM+J",36
22,"22135",174,132,132,5,0,"PUM+J",0
42,"42117",133,109,106,0,3,"PUM+J",0
31,"31209",147,116,116,0,0,"PUM+J",0
22,"22090",85,66,66,1,0,"PUM+J",0
49,"49071",715,500,499,3,1,"PUM+J",0
22,"22223",74,63,63,1,0,"PUM+J",0
5,"5001",179,153,152,2,1,"PUM+J",0
26,"26178",71,57,56,1,1,"PUM+J",0
34,"34170",51,35,35,0,0,"PUM+J",0
26,"26060",75,60,60,1,0,"PUM+J",0
48,"48075",2067,1591,1565,11,26,"PUM+J",1
34,"34032",37,34,34,1,0,"PUM+J",0
50,"50288",3444,2689,2668,24,21,"PUM+J",2
9,"9206",55,47,47,1,0,"PUM+J",0
31,"31049",679,512,505,2,7,"PUM+J",1
31,"31089",228,187,184,0,3,"PUM+J",0
5,"5088",29,23,23,0,0,"PUM+J",0
28,"28032",5042,4039,3992,23,47,"PUM+J",2
23,"23019",1479,1209,1183,3,26,"PUM+J",1
37,"37203",146,113,112,0,1,"PUM+J",0
44,"44226",124,87,83,2,4,"PUM+J",0
37,"37044",450,342,335,6,7,"PUM+J",0
5,"5127",608,499,496,0,3,"PUM+J",0
47,"47028",30,17,17,0,0,"PUM+J",0
5,"5005",171,142,142,2,0,"PUM+J",0
41,"41083",1128,865,859,6,6,"PUM+J",2
34,"34076",545,475,473,2,2,"PUM+J",0
38,"38009",4299,3105,3069,16,36,"PUM+J",2
37,"37318",199,152,152,1,0,"PUM+J",0
28,"28128",445,352,352,2,0,"PUM+J",0
19,"19091",23,19,19,0,0,"PUM+J",0
31,"31051",234,183,182,2,1,"PUM+J",2
12,"12065",171,150,147,0,3,"PUM+J",1
40,"40030",428,357,350,3,7,"PUM+J",0
28,"28129",8578,6925,6853,45,72,"PUM+J",11
9,"9317",19,19,19,1,0,"PUM+J",0
40,"40906",2131,1830,1814,10,16,"PUM+J",1
37,"37319",93,67,65,1,2,"PUM+J",0
19,"19092",395,317,309,1,8,"PUM+J",0
29,"29039",2728,2084,2050,14,34,"PUM+J",5
50,"50002",125,96,91,1,5,"PUM+J",0
31,"31173",846,686,674,5,12,"PUM+J",0
23,"23064",1678,1413,1404,10,9,"PUM+J",0
39,"39071",422,318,316,0,2,"PUM+J",0
31,"31092",685,514,511,6,3,"PUM+J",1
22,"22096",320,274,272,2,2,"PUM+J",0
39,"39072",324,206,204,4,2,"PUM+J",0
19,"19277",16,13,13,0,0,"PUM+J",0
41,"41029",13483,10357,10199,120,158,"PUM+J",13
50,"50291",93,78,77,1,1,"PUM+J",1
34,"34080",5291,3802,3728,35,74,"PUM+J",0
34,"34022",1019,856,849,8,7,"PUM+J",0
39,"39062",1841,1511,1500,9,11,"PUM+J",1
5,"5118",68,44,43,0,1,"PUM+J",0
24,"24031",210,180,176,0,4,"PUM+J",0
40,"40230",95,70,67,0,3,"PUM+J",0
50,"50079",227,182,178,1,4,"PUM+J",0
19,"19233",82,72,72,1,0,"PUM+J",0
38,"38011",21563,15380,15214,69,166,"PUM+J",22
47,"47188",99,77,77,0,0,"PUM+J",0
28,"28099",1923,1490,1475,7,15,"PUM+J",0
48,"48080",9946,7574,7499,46,75,"PUM+J",12
50,"50179",264,231,228,0,3,"PUM+J",0
31,"31094",105,78,76,0,2,"PUM+J",1
34,"34229",58,42,40,1,2,"PUM+J",0
37,"37360",215,158,153,3,5,"PUM+J",0
38,"38042",3781,2799,2774,11,25,"PUM+J",3
16,"16103",239,203,203,0,0,"PUM+J",0
24,"24112",299,226,223,1,3,"PUM+J",0
19,"19045",127,107,107,1,0,"PUM+J",0
26,"26067",20,19,19,0,0,"PUM+J",0
33,"33072",1455,973,963,14,10,"PUM+J",3
50,"50005",239,204,201,2,3,"PUM+J",1
44,"44109",102,71,70,1,1,"PUM+J",0
47,"47094",123,110,109,1,1,"PUM+J",0
22,"22189",178,143,143,0,0,"PUM+J",0
50,"50062",1863,1441,1416,9,25,"PUM+J",0
49,"49036",508,361,355,6,6,"PUM+J",1
42,"42127",38,27,27,1,0,"PUM+J",0
9,"9417",42,32,32,0,0,"PUM+J",0
33,"33032",11086,8028,7849,129,179,"PUM+J",9
44,"44256",34,32,32,1,0,"PUM+J",0
41,"41032",3843,3018,2944,17,74,"PUM+J",4
44,"44011",48,32,32,1,0,"PUM+J",0
37,"37324",335,276,274,1,2,"PUM+J",0
18,"18004",687,521,515,4,6,"PUM+J",1
6,"6048",824,714,702,2,12,"PUM+J",0
50,"50266",121,85,80,0,5,"PUM+J",0
39,"39047",1976,1564,1538,8,26,"PUM+J",1
48,"48051",216,157,157,0,0,"PUM+J",0
48,"48915",347,259,259,4,0,"PUM+J",0
45,"45198",1790,1488,1464,5,24,"PUM+J",0
41,"41070",6397,4987,4921,55,66,"PUM+J",7
14,"14047",1629,1300,1285,18,15,"PUM+J",0
16,"16193",58,51,51,2,0,"PUM+J",0
44,"44141",127,100,100,0,0,"PUM+J",1
50,"50210",36,29,29,0,0,"PUM+J",0
16,"16247",63,53,53,1,0,"PUM+J",0
50,"50239",63,47,47,0,0,"PUM+J",0
6,"6116",1512,1158,1144,3,14,"PUM+J",0
9,"9219",27153,20116,19831,215,285,"PUM+J",48
26,"26149",45,36,36,0,0,"PUM+J",0
24,"24116",390,283,279,1,4,"PUM+J",0
9,"9043",186,128,128,1,0,"PUM+J",1
6,"6149",10203,8194,8051,72,143,"PUM+J",15
33,"33044",177352,134444,133352,1391,1092,"PUM+J",223
12,"12072",1082,901,889,15,12,"PUM+J",0
2,"2043",1173,975,962,1,13,"PUM+J",0
37,"37213",83,65,64,0,1,"PUM+J",0
19,"19104",18,16,16,0,0,"PUM+J",0
28,"28029",562,459,456,2,3,"PUM+J",1
24,"24037",337,234,234,1,0,"PUM+J",0
18,"18180",627,442,435,4,7,"PUM+J",0
44,"44205",634,444,426,9,18,"PUM+J",1
37,"37085",5002,3994,3951,40,43,"PUM+J",4
49,"49069",327,211,207,0,4,"PUM+J",0
22,"22222",517,407,398,5,9,"PUM+J",0
22,"22028",362,284,282,5,2,"PUM+J",0
9,"9168",272,222,216,3,6,"PUM+J",1
19,"19212",674,528,519,2,9,"PUM+J",1
47,"47026",49,40,39,0,1,"PUM+J",0
22,"22109",266,207,205,3,2,"PUM+J",1
18,"18111",2849,2193,2160,24,33,"PUM+J",4
28,"28136",680,569,563,0,6,"PUM+J",0
29,"29047",1103,909,898,2,11,"PUM+J",1
41,"41035",1060,803,788,8,15,"PUM+J",0
40,"40145",1105,906,899,2,7,"PUM+J",0
44,"44144",325,249,247,1,2,"PUM+J",0
49,"49086",111,94,93,1,1,"PUM+J",1
31,"31224",875,684,677,10,7,"PUM+J",0
16,"16250",65,41,41,0,0,"PUM+J",0
41,"41007",12438,9009,8775,135,234,"PUM+J",9
50,"50184",90,79,79,0,0,"PUM+J",0
50,"50037",127,93,93,0,0,"PUM+J",0
50,"50269",279,189,186,1,3,"PUM+J",0
5,"5216",213,166,165,0,1,"PUM+J",1
49,"49087",483,322,320,2,2,"PUM+J",0
40,"40181",4166,3405,3337,21,68,"PUM+J",4
18,"18065",591,482,468,4,14,"PUM+J",0
23,"23062",1418,1206,1190,5,16,"PUM+J",0
5,"5140",106,91,89,0,2,"PUM+J",0
5,"5217",54,44,43,0,1,"PUM+J",0
37,"37179",196,172,169,0,3,"PUM+J",0
19,"19155",66,56,56,0,0,"PUM+J",0
6,"6087",2030,1592,1571,16,21,"PUM+J",1
50,"50038",1405,1112,1099,13,13,"PUM+J",1
50,"50010",66,56,55,2,1,"PUM+J",0
42,"42087",51,45,44,1,1,"PUM+J",0
47,"47069",118,96,92,1,4,"PUM+J",0
37,"37368",17,15,11,0,4,"PUM+J",0
9,"9277",107,92,89,0,3,"PUM+J",0
16,"16199",28,23,23,1,0,"PUM+J",0
42,"42135",70,46,45,0,1,"PUM+J",0
14,"14011",572,498,495,5,3,"PUM+J",0
34,"34092",260,210,206,0,4,"PUM+J",0
18,"18012",2143,1651,1634,8,17,"PUM+J",0
5,"5142",90,83,81,0,2,"PUM+J",1
20,"20062",945,727,726,3,1,"PUM+J",0
19,"19055",44,34,34,1,0,"PUM+J",0
34,"34093",81,70,70,0,0,"PUM+J",0
6,"6154",2799,2075,2022,15,53,"PUM+J",1
37,"37293",106,75,74,0,1,"PUM+J",0
37,"37294",11787,9201,9083,76,118,"PUM+J",17
48,"48058",946,724,715,3,9,"PUM+J",0
14,"14042",18727,15069,14837,201,232,"PUM+J",20
26,"26076",116,93,91,0,2,"PUM+J",0
37,"37106",249,173,173,1,0,"PUM+J",0
23,"23076",768,653,646,3,7,"PUM+J",0
34,"34003",150,122,120,2,2,"PUM+J",0
18,"18013",4152,3168,3103,16,65,"PUM+J",3
44,"44178",53,39,39,0,0,"PUM+J",0
4,"4011",2757,2171,2136,11,35,"PUM+J",3
19,"19142",249,178,177,1,1,"PUM+J",0
5,"5130",94,86,86,0,0,"PUM+J",0
5,"5092",146,118,116,0,2,"PUM+J",0
31,"31188",296,200,197,0,3,"PUM+J",1
42,"42168",108,85,85,1,0,"PUM+J",1
31,"31175",64,50,50,0,0,"PUM+J",0
9,"9067",407,285,278,2,7,"PUM+J",0
33,"33020",13000,9476,9338,108,138,"PUM+J",10
18,"18185",542,454,453,2,1,"PUM+J",1
9,"9445",43,36,34,1,2,"PUM+J",0
22,"22114",124,86,82,1,4,"PUM+J",0
19,"19009",247,190,187,0,3,"PUM+J",0
6,"6090",824,602,578,4,24,"PUM+J",0
42,"42141",114,89,89,0,0,"PUM+J",0
24,"24046",899,678,663,7,15,"PUM+J",1
42,"42092",62,42,41,1,1,"PUM+J",0
41,"41068",13936,10692,10530,73,162,"PUM+J",9
49,"49050",504,351,351,3,0,"PUM+J",1
37,"37063",60,45,45,1,0,"PUM+J",0
5,"5263",163,121,120,0,1,"PUM+J",0
5,"5222",152,111,109,0,2,"PUM+J",0
6,"6091",3668,2839,2776,26,63,"PUM+J",0
42,"42142",45,35,35,0,0,"PUM+J",0
41,"41040",11111,8768,8679,76,89,"PUM+J",15
18,"18117",507,402,396,5,6,"PUM+J",0
18,"18015",425,333,333,0,0,"PUM+J",0
34,"34053",200,176,171,5,5,"PUM+J",0
9,"9056",4812,3585,3533,36,52,"PUM+J",5
29,"29010",1632,1372,1319,4,53,"PUM+J",0
12,"12127",67,50,50,1,0,"PUM+J",0
42,"42080",150,116,116,1,0,"PUM+J",0
31,"31233",93,72,70,1,2,"PUM+J",1
47,"47139",1004,790,776,2,14,"PUM+J",2
31,"31110",84,72,72,3,0,"PUM+J",1
23,"23080",1721,1370,1355,8,15,"PUM+J",2
22,"22205",459,347,345,1,2,"PUM+J",0
34,"34055",263,214,213,3,1,"PUM+J",2
9,"9024",150,116,114,0,2,"PUM+J",0
50,"50276",119,91,91,1,0,"PUM+J",0
44,"44050",3115,2333,2299,27,34,"PUM+J",3
2,"2041",321,253,251,3,2,"PUM+J",0
44,"44074",444,353,346,3,7,"PUM+J",0
49,"49083",50,41,41,1,0,"PUM+J",0
19,"19210",18,18,17,0,1,"PUM+J",0
49,"49258",110,93,92,0,1,"PUM+J",0
48,"48032",5773,4504,4476,5,28,"PUM+J",1
47,"47106",44,35,35,0,0,"PUM+J",0
19,"19252",60,49,47,0,2,"PUM+J",0
49,"49054",849,641,629,5,12,"PUM+J",1
42,"42148",9,9,9,0,0,"PUM+J",0
9,"9073",963,799,787,7,12,"PUM+J",4
23,"23049",1747,1321,1305,11,16,"PUM+J",1
50,"50044",222,161,161,3,0,"PUM+J",0
34,"34205",55,44,44,0,0,"PUM+J",0
42,"42015",32,23,23,1,0,"PUM+J",0
47,"47014",47,43,43,1,0,"PUM+J",0
38,"38025",7088,5166,5089,39,77,"PUM+J",5
31,"31032",1678,1285,1269,25,16,"PUM+J",7
9,"9026",371,305,303,2,2,"PUM+J",0
44,"44245",245,176,171,1,5,"PUM+J",1
49,"49135",588,409,405,0,4,"PUM+J",0
22,"22165",452,360,356,1,4,"PUM+J",0
40,"40121",249,196,193,4,3,"PUM+J",1
49,"49221",234,138,130,1,8,"PUM+J",0
16,"16123",66,43,43,0,0,"PUM+J",0
49,"49041",414,309,307,4,2,"PUM+J",0
34,"34103",97,84,81,0,3,"PUM+J",0
26,"26124",776,635,624,5,11,"PUM+J",0
49,"49085",918,673,660,5,13,"PUM+J",0
28,"28061",22564,18245,18064,117,181,"PUM+J",22
18,"18050",1670,1231,1213,9,18,"PUM+J",1
39,"39059",7577,5978,5916,47,62,"PUM+J",7
22,"22167",473,392,384,4,8,"PUM+J",0
37,"37377",218,181,176,2,5,"PUM+J",0
14,"14049",16282,12515,12301,121,214,"PUM+J",14
37,"37378",99,69,67,2,2,"PUM+J",0
40,"40191",204,166,165,1,1,"PUM+J",0
18,"18020",501,365,358,2,7,"PUM+J",0
5,"5190",53,47,47,1,0,"PUM+J",0
37,"37116",69,51,51,0,0,"PUM+J",0
2,"2057",1960,1522,1489,15,33,"PUM+J",0
9,"9353",76,64,63,2,1,"PUM+J",0
20,"20040",15753,11440,11364,69,76,"PUM+J",14
47,"47111",998,806,795,6,11,"PUM+J",0
5,"5115",516,397,395,3,2,"PUM+J",0
18,"18088",1530,1152,1142,0,10,"PUM+J",0
14,"14050",2352,1840,1801,11,39,"PUM+J",0
29,"29048",1370,1149,1135,10,14,"PUM+J",1
39,"39079",8861,6827,6745,47,82,"PUM+J",4
50,"50019",64,48,47,0,1,"PUM+J",0
16,"16002",195,166,164,1,2,"PUM+J",0
34,"34106",113,101,101,0,0,"PUM+J",0
42,"42153",12,10,10,1,0,"PUM+J",0
49,"49101",147,99,96,0,3,"PUM+J",0
5,"5036",116,100,100,0,0,"PUM+J",0
26,"26167",50,38,38,1,0,"PUM+J",0
28,"28085",4141,3337,3296,13,41,"PUM+J",3
23,"23053",9449,6379,6325,25,54,"PUM+J",1
37,"37268",108,72,70,0,2,"PUM+J",0
18,"18901",488,335,329,2,6,"PUM+J",1
9,"9190",86,68,67,0,1,"PUM+J",0
37,"37231",239,204,203,6,1,"PUM+J",0
28,"28073",12751,9940,9838,63,102,"PUM+J",15
37,"37344",235,171,168,1,3,"PUM+J",0
28,"28151",3251,2483,2450,11,33,"PUM+J",3
40,"40053",83,62,62,1,0,"PUM+J",0
31,"31078",2419,1924,1899,18,25,"PUM+J",3
45,"45068",171,142,142,0,0,"PUM+J",0
38,"38029",1493,839,823,5,16,"PUM+J",0
47,"47146",278,232,230,3,2,"PUM+J",0
40,"40125",75,61,61,2,0,"PUM+J",0
5,"5905",222,165,164,1,1,"PUM+J",0
29,"29029",380,294,287,2,7,"PUM+J",0
47,"47176",202,138,138,1,0,"PUM+J",0
47,"47177",100,80,79,0,1,"PUM+J",1
50,"50050",86,65,65,1,0,"PUM+J",0
9,"9035",284,213,210,1,3,"PUM+J",0
24,"24177",472,330,326,3,4,"PUM+J",0
44,"44250",19,15,15,0,0,"PUM+J",0
31,"31079",67,60,60,0,0,"PUM+J",0
31,"31242",264,194,194,2,0,"PUM+J",0
22,"22084",555,438,433,5,5,"PUM+J",0
16,"16219",81,64,63,0,1,"PUM+J",0
47,"47051",321,274,272,1,2,"PUM+J",0
45,"45162",632,481,471,2,10,"PUM+J",0
16,"16130",536,445,444,0,1,"PUM+J",0
23,"23077",611,483,479,0,4,"PUM+J",0
44,"44157",64,38,38,1,0,"PUM+J",0
28,"28120",1209,991,974,3,17,"PUM+J",2
28,"28121",205,166,165,1,1,"PUM+J",1
2,"2062",386,287,285,4,2,"PUM+J",0
33,"33030",873,678,671,1,7,"PUM+J",0
50,"50170",364,286,279,1,7,"PUM+J",0
6,"6068",431,324,317,4,7,"PUM+J",0
19,"19220",2536,1833,1813,9,20,"PUM+J",0
2,"2027",283,239,238,3,1,"PUM+J",1
31,"31203",30,22,22,1,0,"PUM+J",0
19,"19263",22,13,12,0,1,"PUM+J",0
22,"22085",96,82,81,0,1,"PUM+J",0
19,"19079",8,7,7,1,0,"PUM+J",0
44,"44252",75,56,56,1,0,"PUM+J",0
41,"41049",9493,7463,7312,78,151,"PUM+J",10
45,"45164",172,143,143,1,0,"PUM+J",0
16,"16277",109,82,82,0,0,"PUM+J",0
31,"31001",80,63,63,0,0,"PUM+J",1
12,"12117",3545,2770,2698,11,72,"PUM+J",3
16,"16132",34,26,26,0,0,"PUM+J",0
28,"28089",3842,3087,3048,12,39,"PUM+J",3
47,"47053",126,100,97,0,3,"PUM+J",0
45,"45120",121,96,96,0,0,"PUM+J",0
19,"19080",65,51,51,0,0,"PUM+J",0
50,"50132",771,589,576,2,13,"PUM+J",1
22,"22014",233,185,182,3,3,"PUM+J",0
37,"37081",871,725,717,4,8,"PUM+J",0
49,"49065",1073,789,777,3,12,"PUM+J",1
37,"37273",88,67,67,0,0,"PUM+J",0
49,"49269",220,163,162,1,1,"PUM+J",1
26,"26094",69,56,56,0,0,"PUM+J",0
5,"5043",75,62,62,0,0,"PUM+J",0
22,"22902",208,160,156,0,4,"PUM+J",1
31,"31084",1948,1483,1472,9,11,"PUM+J",0
20,"20066",439,327,326,0,1,"PUM+J",0
23,"23048",820,644,636,1,8,"PUM+J",0
29,"29022",171,144,143,0,1,"PUM+J",0
50,"50025",4516,3417,3364,35,53,"PUM+J",2
50,"50113",584,505,495,3,10,"PUM+J",0
26,"26096",260,221,212,2,9,"PUM+J",1
40,"40200",38,32,31,0,1,"PUM+J",0
2,"2030",2978,2357,2315,13,42,"PUM+J",1
31,"31045",509,395,390,5,5,"PUM+J",4
31,"31125",274,211,207,7,4,"PUM+J",0
51,"51001",59934,38342,37884,322,458,"PUM+J",87
16,"16280",165,130,128,3,2,"PUM+J",2
12,"12028",12955,10391,10301,68,90,"PUM+J",11
22,"22903",622,538,533,3,5,"PUM+J",0
49,"49232",84,71,70,0,1,"PUM+J",0
24,"24064",1515,1159,1141,11,18,"PUM+J",0
6,"6072",2225,1777,1752,20,25,"PUM+J",0
45,"45077",562,442,437,0,5,"PUM+J",0
34,"34072",143,130,128,1,2,"PUM+J",0
19,"19086",1392,1095,1083,7,12,"PUM+J",0
37,"37239",206,184,181,3,3,"PUM+J",0
9,"9255",84,70,70,1,0,"PUM+J",0
41,"41025",2019,1492,1439,7,53,"PUM+J",2
48,"48074",3273,2480,2460,14,20,"PUM+J",6
50,"50045",1198,957,951,3,6,"PUM+J",1
4,"4071",363,303,301,2,2,"PUM+J",0
26,"26099",1216,993,973,14,20,"PUM+J",2
50,"50105",279,216,213,4,3,"PUM+J",0
18,"18086",339,291,289,0,2,"PUM+J",0
9,"9201",28,20,19,0,1,"PUM+J",1
40,"40026",113,106,105,2,1,"PUM+J",0
42,"42163",46,37,37,0,0,"PUM+J",0
19,"19318",23,18,18,0,0,"PUM+J",0
48,"48908",249,214,213,0,1,"PUM+J",1
26,"26139",55,43,43,0,0,"PUM+J",0
33,"33066",42882,30942,30529,401,413,"PUM+J",30
50,"50232",160,116,114,2,2,"PUM+J",0
50,"50028",77,59,58,1,1,"PUM+J",0
37,"37316",716,576,565,4,11,"PUM+J",0
38,"38037",12803,8628,8517,48,111,"PUM+J",9
16,"16903",996,816,806,9,10,"PUM+J",0
33,"33036",11335,8356,8243,92,113,"PUM+J",12
31,"31129",384,260,259,0,1,"PUM+J",0
38,"38038",164468,112475,111577,728,898,"PUM+J",133
37,"37166",199,146,144,0,2,"PUM+J",0
18,"18032",242,180,178,2,2,"PUM+J",0
9,"9373",406,284,268,3,16,"PUM+J",0
40,"40192",133,104,102,2,2,"PUM+J",0
49,"49152",483,327,322,2,5,"PUM+J",1
50,"50085",183,136,136,1,0,"PUM+J",0
40,"40170",1307,1066,1054,7,12,"PUM+J",1
41,"41027",3966,2830,2784,32,46,"PUM+J",3
12,"12032",23649,17680,17505,118,175,"PUM+J",22
18,"18137",1002,776,773,0,3,"PUM+J",0
50,"50117",125,100,100,3,0,"PUM+J",0
22,"22020",119,91,87,1,4,"PUM+J",1
31,"31090",141,86,86,0,0,"PUM+J",0
28,"28160",8629,6922,6856,34,66,"PUM+J",5
39,"39014",901,709,704,5,5,"PUM+J",2
42,"42166",57,49,49,0,0,"PUM+J",0
31,"31172",365,287,275,4,12,"PUM+J",0
19,"19186",78,67,67,0,0,"PUM+J",0
5,"5168",3500,2774,2730,25,44,"PUM+J",2
19,"19041",167,133,129,1,4,"PUM+J",1
5,"5007",110,81,80,2,1,"PUM+J",1
38,"38039",11112,8233,8161,54,72,"PUM+J",5
37,"37168",407,305,300,0,5,"PUM+J",0
9,"9051",163,134,133,1,1,"PUM+J",0
22,"22908",188,133,131,0,2,"PUM+J",0
34,"34079",1715,1421,1402,10,19,"PUM+J",1
12,"12003",943,745,731,6,14,"PUM+J",0
12,"12034",1400,1108,1080,7,28,"PUM+J",1
6,"6011",24665,18486,18253,178,233,"PUM+J",21
26,"26143",242,190,189,0,1,"PUM+J",0
39,"39100",849,650,644,9,6,"PUM+J",1
16,"16143",15,10,10,1,0,"PUM+J",0
22,"22139",78,60,60,0,0,"PUM+J",0
28,"28162",2771,2264,2243,6,21,"PUM+J",0
19,"19143",1754,1422,1402,11,20,"PUM+J",3
5,"5053",80,57,57,2,0,"PUM+J",0
37,"37010",923,739,735,2,4,"PUM+J",0
37,"37132",325,232,231,0,1,"PUM+J",0
5,"5170",50,38,38,0,0,"PUM+J",0
39,"39016",23868,19029,18839,108,190,"PUM+J",16
9,"9414",181,148,146,0,2,"PUM+J",0
19,"19043",99,87,84,2,3,"PUM+J",0
50,"50031",139,97,90,0,7,"PUM+J",0
49,"49079",103,91,79,1,12,"PUM+J",0
6,"6046",1250,1010,995,7,15,"PUM+J",0
24,"24193",365,286,285,0,1,"PUM+J",0
14,"14033",1265,994,985,9,9,"PUM+J",1
24,"24191",108,89,89,0,0,"PUM+J",0
24,"24154",955,702,691,3,11,"PUM+J",1
28,"28163",429,361,345,4,16,"PUM+J",1
28,"28025",404,314,305,3,9,"PUM+J",0
47,"47062",157,134,134,0,0,"PUM+J",0
47,"47158",858,672,663,8,9,"PUM+J",2
5,"5132",881,634,626,2,8,"PUM+J",0
40,"40207",800,662,652,6,10,"PUM+J",3
20,"20904",89,50,49,0,1,"PUM+J",0
19,"19235",98,82,81,0,1,"PUM+J",0
32,"32074",993,737,734,4,3,"PUM+J",1
2,"2003",133957,105024,104115,786,909,"PUM+J",186
16,"16910",78,54,54,1,0,"PUM+J",0
16,"16147",56,32,32,0,0,"PUM+J",0
37,"37285",366,273,272,1,1,"PUM+J",0
38,"38043",19265,14000,13856,115,144,"PUM+J",12
22,"22143",197,134,132,1,2,"PUM+J",1
37,"37323",476,380,377,7,3,"PUM+J",0
9,"9197",137,108,107,0,1,"PUM+J",1
26,"26107",91,78,77,0,1,"PUM+J",0
6,"6147",338,262,258,2,4,"PUM+J",0
12,"12070",499,434,430,3,4,"PUM+J",0
20,"20905",153,124,124,1,0,"PUM+J",0
37,"37136",633,448,434,8,14,"PUM+J",0
23,"23003",8644,6604,6523,36,81,"PUM+J",1
41,"41060",15100,11304,11105,113,199,"PUM+J",9
6,"6115",1243,898,876,3,22,"PUM+J",1
41,"41904",1792,1171,1162,16,9,"PUM+J",0
50,"50209",2747,1993,1975,29,18,"PUM+J",3
49,"49121",368,269,266,1,3,"PUM+J",0
9,"9365",27,19,19,1,0,"PUM+J",0
9,"9108",432,332,326,1,6,"PUM+J",1
18,"18107",924,694,680,3,14,"PUM+J",1
29,"29044",757,540,533,7,7,"PUM+J",0
42,"42039",210,147,141,2,6,"PUM+J",0
19,"19194",94,76,76,0,0,"PUM+J",0
26,"26109",73,66,66,0,0,"PUM+J",0
7,"7017",882,652,646,6,6,"PUM+J",1
31,"31261",237,174,173,3,1,"PUM+J",1
50,"50035",75,63,62,0,1,"PUM+J",0
34,"34234",68,59,57,0,2,"PUM+J",0
19,"19239",91,64,63,1,1,"PUM+J",0
26,"26110",150,128,124,1,4,"PUM+J",0
44,"44111",78,64,64,1,0,"PUM+J",0
49,"49003",869,627,624,3,3,"PUM+J",0
44,"44204",27,22,22,0,0,"PUM+J",0
45,"45185",7600,6094,5999,19,95,"PUM+J",6
12,"12101",356,297,289,2,8,"PUM+J",1
5,"5176",223,173,166,2,7,"PUM+J",0
9,"9438",561,485,473,6,12,"PUM+J",2
37,"37016",574,464,455,3,9,"PUM+J",1
6,"6117",1401,1089,1067,6,22,"PUM+J",2
26,"26071",8662,6409,6288,52,121,"PUM+J",8
39,"39067",759,582,575,3,7,"PUM+J",0
18,"18007",741,533,527,6,6,"PUM+J",0
39,"39077",236,175,173,0,2,"PUM+J",0
5,"5138",289,224,223,2,1,"PUM+J",0
41,"41062",2175,1763,1746,8,17,"PUM+J",0
6,"6118",157,125,125,1,0,"PUM+J",1
31,"31263",231,154,154,0,0,"PUM+J",0
45,"45186",2945,2319,2280,11,39,"PUM+J",0
24,"24118",104,66,66,0,0,"PUM+J",0
48,"48024",999,813,811,2,2,"PUM+J",0
19,"19051",61,54,54,0,0,"PUM+J",0
22,"22067",71,52,52,0,0,"PUM+J",0
26,"26151",411,353,351,3,2,"PUM+J",1
41,"41063",2713,1988,1944,17,44,"PUM+J",0
42,"42042",49,42,42,1,0,"PUM+J",0
37,"37254",175,141,140,1,1,"PUM+J",0
37,"37253",133,107,103,0,4,"PUM+J",0
37,"37018",110,86,85,1,1,"PUM+J",0
22,"22155",65,54,54,0,0,"PUM+J",0
40,"40213",95,83,80,1,3,"PUM+J",0
44,"44113",72,51,50,0,1,"PUM+J",0
49,"49125",1401,1031,1010,7,21,"PUM+J",1
6,"6075",475,379,369,2,10,"PUM+J",0
40,"40110",316,254,253,2,1,"PUM+J",0
41,"41064",5611,3763,3667,47,96,"PUM+J",5
9,"9276",389,283,268,5,15,"PUM+J",0
32,"32079",1287,1016,1006,6,10,"PUM+J",0
5,"5061",261,214,208,0,6,"PUM+J",0
16,"16154",4752,3798,3732,37,66,"PUM+J",2
14,"14071",884,641,634,2,7,"PUM+J",0
37,"37059",117,106,100,0,6,"PUM+J",0
31,"31063",83,63,60,2,3,"PUM+J",0
9,"9017",90,72,70,2,2,"PUM+J",0
24,"24163",4073,3269,3231,36,38,"PUM+J",5
31,"31145",161,131,129,1,2,"PUM+J",0
2,"2083",209,183,183,0,0,"PUM+J",0
45,"45098",2110,1675,1652,6,23,"PUM+J",1
47,"47165",6822,5456,5296,62,160,"PUM+J",4
26,"26038",81,61,61,0,0,"PUM+J",0
5,"5063",31,27,27,0,0,"PUM+J",0
5,"5180",82,61,60,0,1,"PUM+J",0
39,"39080",3505,2735,2701,8,34,"PUM+J",4
26,"26039",38,34,34,0,0,"PUM+J",0
45,"45191",521,449,446,0,3,"PUM+J",0
49,"49009",389,305,304,2,1,"PUM+J",0
40,"40007",68,58,58,0,0,"PUM+J",0
23,"23044",4719,3817,3749,18,68,"PUM+J",7
34,"34050",185,156,156,2,0,"PUM+J",0
18,"18115",2650,1988,1975,20,13,"PUM+J",3
44,"44209",815,606,592,2,14,"PUM+J",0
48,"48028",691,576,573,1,3,"PUM+J",0
37,"37060",280,224,224,0,0,"PUM+J",0
48,"48027",22668,17326,17224,95,102,"PUM+J",17
5,"5064",102,83,81,2,2,"PUM+J",0
9,"9444",63,43,43,2,0,"PUM+J",0
2,"2086",2426,1738,1728,8,10,"PUM+J",3
24,"24165",327,236,233,1,3,"PUM+J",0
4,"4089",694,516,510,1,6,"PUM+J",0
49,"49047",100,72,72,0,0,"PUM+J",0
18,"18035",1190,965,952,4,13,"PUM+J",0
44,"44048",53,47,47,0,0,"PUM+J",1
16,"16204",241,198,196,1,2,"PUM+J",1
18,"18014",6898,5262,5162,43,100,"PUM+J",8
12,"12014",167,131,127,1,4,"PUM+J",0
37,"37062",77,65,63,0,2,"PUM+J",0
18,"18046",1753,1206,1185,1,21,"PUM+J",1
41,"41067",7227,5367,5271,56,96,"PUM+J",0
45,"45195",2072,1615,1583,4,32,"PUM+J",0
37,"37259",36,29,29,0,0,"PUM+J",0
31,"31149",2271,1645,1628,9,17,"PUM+J",1
22,"22160",212,171,170,3,1,"PUM+J",0
47,"47103",255,215,214,3,1,"PUM+J",0
34,"34098",783,614,605,3,9,"PUM+J",1
14,"14075",557,429,411,5,18,"PUM+J",0
28,"28174",1840,1363,1349,10,14,"PUM+J",3
37,"37024",88,69,69,0,0,"PUM+J",0
42,"42187",59,51,49,1,2,"PUM+J",0
34,"34005",792,659,645,5,14,"PUM+J",0
6,"6025",5096,3981,3904,28,77,"PUM+J",1
4,"4055",366,315,314,3,1,"PUM+J",0
12,"12136",2606,2262,2223,17,39,"PUM+J",3
4,"4014",149,109,108,0,1,"PUM+J",0
37,"37223",112,78,76,0,2,"PUM+J",0
29,"29055",1880,1493,1470,15,23,"PUM+J",3
9,"9007",55,37,37,0,0,"PUM+J",0
33,"33052",704,520,513,5,7,"PUM+J",1
37,"37261",217,166,163,0,3,"PUM+J",0
35,"35026",82764,55647,54846,499,801,"PUM+J",67
47,"47170",43,34,32,0,2,"PUM+J",0
49,"49257",310,205,202,2,3,"PUM+J",0
31,"31029",916,661,647,7,14,"PUM+J",1
40,"40012",238,178,175,4,3,"PUM+J",0
40,"40119",166,133,132,1,1,"PUM+J",0
19,"19163",60,46,44,0,2,"PUM+J",0
5,"5069",74,63,62,0,1,"PUM+J",0
12,"12049",421,339,329,2,10,"PUM+J",0
50,"50238",86,66,66,2,0,"PUM+J",0
44,"44119",119,83,82,0,1,"PUM+J",0
42,"42190",92,74,73,1,1,"PUM+J",0
31,"31192",157,133,130,1,3,"PUM+J",2
31,"31193",1438,1129,1123,13,6,"PUM+J",8
47,"47045",734,601,590,5,11,"PUM+J",0
9,"9072",320,259,258,1,1,"PUM+J",2
6,"6127",2809,2285,2258,13,27,"PUM+J",1
40,"40222",163,143,142,1,1,"PUM+J",0
9,"9450",25,17,17,0,0,"PUM+J",0
33,"33054",1611,1145,1124,8,21,"PUM+J",0
44,"44022",463,342,326,6,16,"PUM+J",1
7,"7028",920,686,676,8,10,"PUM+J",1
37,"37376",2164,1606,1581,15,25,"PUM+J",3
12,"12017",148,120,116,0,4,"PUM+J",0
23,"23050",90596,69591,68903,460,688,"PUM+J",85
28,"28114",143,104,104,0,0,"PUM+J",0
37,"37028",137,111,107,1,4,"PUM+J",0
9,"9294",102,86,85,0,1,"PUM+J",0
31,"31194",326,251,250,1,1,"PUM+J",0
24,"24052",139,99,99,0,0,"PUM+J",0
37,"37301",79,69,67,0,2,"PUM+J",0
37,"37264",55,42,42,0,0,"PUM+J",0
50,"50164",388,279,272,2,7,"PUM+J",0
47,"47172",135,119,119,0,0,"PUM+J",0
22,"22044",234,184,183,3,1,"PUM+J",0
9,"9130",66,55,52,0,3,"PUM+J",0
4,"4059",1025,742,731,3,11,"PUM+J",0
7,"7063",1420,1139,1129,10,10,"PUM+J",3
5,"5113",62,49,49,0,0,"PUM+J",0
41,"41072",4037,3256,3221,19,35,"PUM+J",2
5,"5228",167,124,124,0,0,"PUM+J",0
31,"31196",31,28,28,0,0,"PUM+J",0
50,"50193",663,536,516,1,20,"PUM+J",0
2,"2020",431,359,356,3,3,"PUM+J",1
19,"19256",44,32,32,0,0,"PUM+J",0
34,"34154",76,59,58,0,1,"PUM+J",0
34,"34104",233,190,189,1,1,"PUM+J",0
45,"45018",551,399,397,3,2,"PUM+J",1
31,"31156",239,191,191,1,0,"PUM+J",0
26,"26012",33,28,26,0,2,"PUM+J",0
12,"12083",89,73,71,1,2,"PUM+J",0
2,"2021",1014,836,827,5,9,"PUM+J",0
28,"28042",1266,1020,1010,2,10,"PUM+J",2
47,"47017",198,162,160,1,2,"PUM+J",1
9,"9441",92,81,81,1,0,"PUM+J",0
44,"44025",5825,4337,4197,50,140,"PUM+J",6
24,"24094",1326,982,966,4,16,"PUM+J",3
32,"32004",1671,907,899,7,8,"PUM+J",2
47,"47175",6704,5296,5222,52,74,"PUM+J",6
37,"37031",336,261,258,3,3,"PUM+J",0
20,"20010",1528,1156,1151,5,5,"PUM+J",0
49,"49019",228,170,164,0,6,"PUM+J",0
12,"12053",2030,1656,1636,10,20,"PUM+J",0
16,"16217",94,77,77,0,0,"PUM+J",0
34,"34018",205,181,177,2,4,"PUM+J",0
19,"19122",81,64,64,1,0,"PUM+J",0
28,"28180",5317,4266,4222,26,44,"PUM+J",5
41,"41047",10411,8348,8242,84,106,"PUM+J",6
31,"31037",90,72,72,0,0,"PUM+J",0
35,"35031",7412,5593,5519,41,74,"PUM+J",9
6,"6032",78,65,64,0,1,"PUM+J",0
45,"45901",780,593,587,3,6,"PUM+J",0
49,"49264",540,372,369,1,3,"PUM+J",0
7,"7901",594,454,446,6,8,"PUM+J",1
47,"47019",91,74,73,0,1,"PUM+J",0
9,"9302",98,75,73,0,2,"PUM+J",0
47,"47081",41,36,36,0,0,"PUM+J",0
49,"49179",346,233,232,0,1,"PUM+J",0
12,"12055",106,85,83,2,2,"PUM+J",0
5,"5193",180,156,156,2,0,"PUM+J",0
18,"18126",1450,1115,1087,11,28,"PUM+J",1
22,"22047",241,213,212,2,1,"PUM+J",0
49,"49265",120,93,92,1,1,"PUM+J",0
5,"5039",48,47,47,0,0,"PUM+J",0
19,"19023",127,98,96,0,2,"PUM+J",0
9,"9413",408,313,310,2,3,"PUM+J",0
47,"47114",3911,2864,2807,28,57,"PUM+J",1
18,"18056",3418,2523,2478,22,45,"PUM+J",2
28,"28119",2245,1839,1821,10,18,"PUM+J",2
22,"22012",102,81,80,1,1,"PUM+J",0
49,"49022",280,243,241,1,2,"PUM+J",1
38,"38001",20907,12323,12197,70,126,"PUM+J",18
5,"5194",132,111,111,0,0,"PUM+J",0
9,"9464",33,27,27,0,0,"PUM+J",0
24,"24059",821,575,572,3,3,"PUM+J",0
32,"32091",1703,1312,1306,4,6,"PUM+J",0
2,"2026",832,682,673,6,9,"PUM+J",0
28,"28087",3259,2643,2623,16,20,"PUM+J",7
47,"47083",83,66,65,1,1,"PUM+J",0
47,"47210",402,300,289,2,11,"PUM+J",0
4,"4066",13488,9324,9255,73,69,"PUM+J",5
50,"50283",69,53,52,3,1,"PUM+J",0
9,"9306",98,82,81,1,1,"PUM+J",0
29,"29031",1559,1139,1113,13,26,"PUM+J",1
26,"26054",292,235,231,2,4,"PUM+J",1
7,"7003",12374,7550,7442,51,108,"PUM+J",12
5,"5120",32,25,25,1,0,"PUM+J",1
50,"50080",34,29,29,0,0,"PUM+J",0
38,"38002",972,678,640,3,38,"PUM+J",1
6,"6036",4958,3785,3728,22,57,"PUM+J",3
42,"42062",20,14,13,0,1,"PUM+J",0
40,"40127",35,28,28,0,0,"PUM+J",0
29,"29088",2694,2019,1951,31,68,"PUM+J",3
45,"45073",287,226,225,1,1,"PUM+J",0
6,"6135",1096,915,902,3,13,"PUM+J",0
20,"20015",1237,975,967,8,8,"PUM+J",0
19,"19177",61,49,48,0,1,"PUM+J",0
50,"50024",556,427,426,6,1,"PUM+J",0
42,"42025",1134,824,813,6,11,"PUM+J",1
26,"26173",6,6,6,0,0,"PUM+J",0
31,"31043",32,24,24,0,0,"PUM+J",0
37,"37274",118473,91137,90221,811,916,"PUM+J",149
28,"28047",42847,33561,33215,216,346,"PUM+J",55
9,"9363",922,733,725,3,8,"PUM+J",1
34,"34114",198,152,152,0,0,"PUM+J",0
5,"5197",100,84,83,0,1,"PUM+J",0
33,"33002",9474,6779,6662,74,117,"PUM+J",5
28,"28017",1280,1017,1012,9,5,"PUM+J",2
4,"4068",174,134,134,0,0,"PUM+J",0
9,"9289",1379,1002,994,9,8,"PUM+J",1
4,"4902",45395,31127,30881,251,246,"PUM+J",22
44,"44160",440,311,306,2,5,"PUM+J",0
40,"40164",185,136,134,3,2,"PUM+J",0
4,"4029",8819,6149,6073,45,76,"PUM+J",1
45,"45121",7273,5362,5291,27,71,"PUM+J",4
19,"19130",61365,49363,48747,383,616,"PUM+J",91
7,"7006",5332,3769,3722,25,47,"PUM+J",4
37,"37039",282,222,222,1,0,"PUM+J",0
49,"49026",201,163,162,0,1,"PUM+J",0
50,"50173",149,107,105,0,2,"PUM+J",0
47,"47181",165,143,143,0,0,"PUM+J",0
49,"49148",264,146,136,1,10,"PUM+J",0
20,"20017",8484,6294,6263,25,31,"PUM+J",4
22,"22053",786,573,567,3,6,"PUM+J",1
44,"44224",21,15,15,0,0,"PUM+J",0
40,"40131",50,47,47,0,0,"PUM+J",0
29,"29035",1505,1151,1133,6,18,"PUM+J",3
37,"37163",32,27,27,0,0,"PUM+J",0
40,"40059",108,90,89,0,1,"PUM+J",0
24,"24024",638,463,452,8,11,"PUM+J",0
6,"6138",1013,783,767,3,16,"PUM+J",1
50,"50026",421,340,328,4,12,"PUM+J",1
33,"33004",65515,48686,48245,511,441,"PUM+J",50
28,"28158",678,547,540,1,7,"PUM+J",0
24,"24184",183,121,119,0,2,"PUM+J",0
22,"22089",276,216,216,2,0,"PUM+J",0
44,"44163",114,92,92,0,0,"PUM+J",0
45,"45124",2069,1757,1718,14,39,"PUM+J",1
42,"42206",8,4,4,0,0,"PUM+J",0
24,"24065",2175,1695,1660,18,35,"PUM+J",3
18,"18064",366,307,306,0,1,"PUM+J",0
19,"19088",95,82,82,2,0,"PUM+J",0
20,"20018",11218,8145,8109,41,36,"PUM+J",8
42,"42069",1491,1073,1048,20,25,"PUM+J",1
5,"5201",499,414,407,2,7,"PUM+J",0
6,"6140",611,515,506,1,9,"PUM+J",0
5,"5086",76,64,61,0,3,"PUM+J",0
37,"37041",73,55,55,0,0,"PUM+J",0
39,"39040",4267,3428,3385,24,43,"PUM+J",0
16,"16052",537,429,429,2,0,"PUM+J",0
47,"47183",139,118,118,1,0,"PUM+J",0
31,"31088",5675,4331,4285,59,46,"PUM+J",22
18,"18136",1782,1382,1359,12,23,"PUM+J",0
16,"16238",464,387,383,2,4,"PUM+J",0
23,"23031",765,659,647,4,12,"PUM+J",0
34,"34171",941,702,688,9,14,"PUM+J",2
45,"45082",1143,976,967,7,9,"PUM+J",0
37,"37087",910,755,747,3,8,"PUM+J",2
24,"24187",845,641,630,6,11,"PUM+J",1
42,"42118",21,13,13,1,0,"PUM+J",0
6,"6009",228,190,187,2,3,"PUM+J",0
28,"28021",576,387,386,3,1,"PUM+J",0
42,"42071",163,111,108,2,3,"PUM+J",0
44,"44227",72,61,61,0,0,"PUM+J",0
19,"19090",90,73,72,1,1,"PUM+J",0
40,"40135",269,224,221,1,3,"PUM+J",0
5,"5167",225,181,175,1,6,"PUM+J",0
32,"32015",830,543,541,4,2,"PUM+J",0
44,"44133",15,12,12,0,0,"PUM+J",0
32,"32014",1045,775,769,5,6,"PUM+J",0
6,"6109",3843,3228,3106,26,122,"PUM+J",1
49,"49032",287,224,222,0,2,"PUM+J",0
24,"24151",445,334,328,3,6,"PUM+J",0
16,"16056",453,323,321,1,2,"PUM+J",1
37,"37280",71,41,40,0,1,"PUM+J",0
44,"44036",23,20,20,0,0,"PUM+J",1
47,"47030",941,759,740,3,19,"PUM+J",0
19,"19230",548,437,430,1,7,"PUM+J",1
26,"26181",14,14,14,0,0,"PUM+J",0
50,"50234",242,194,187,3,7,"PUM+J",0
9,"9101",74,57,57,0,0,"PUM+J",0
22,"22058",191,157,157,3,0,"PUM+J",0
40,"40138",2127,1729,1696,18,33,"PUM+J",1
50,"50263",176,119,116,0,3,"PUM+J",0
9,"9902",446,345,341,0,4,"PUM+J",1
19,"19095",11,10,10,1,0,"PUM+J",0
20,"20022",854,621,621,7,0,"PUM+J",0
37,"37169",176,138,137,1,1,"PUM+J",0
37,"37009",196,142,141,1,1,"PUM+J",0
42,"42076",201,157,151,0,6,"PUM+J",0
26,"26065",58,49,47,0,2,"PUM+J",0
31,"31052",103,79,78,0,1,"PUM+J",0
40,"40031",540,429,424,6,5,"PUM+J",0
5,"5208",38,31,31,0,0,"PUM+J",0
37,"37170",1370,1009,990,10,19,"PUM+J",1
29,"29008",15183,10716,10555,93,161,"PUM+J",9
37,"37049",127,89,89,0,0,"PUM+J",0
40,"40139",258,207,202,0,5,"PUM+J",0
9,"9214",641,454,445,5,9,"PUM+J",2
19,"19232",58,49,49,0,0,"PUM+J",0
37,"37207",325,260,258,1,2,"PUM+J",1
45,"45086",493,373,368,0,5,"PUM+J",0
40,"40068",22,21,21,0,0,"PUM+J",0
16,"16909",661,540,535,1,5,"PUM+J",2
45,"45041",3897,2959,2904,28,55,"PUM+J",2
34,"34129",170,134,132,2,2,"PUM+J",0
37,"37283",119,96,96,0,0,"PUM+J",0
39,"39017",553,416,409,0,7,"PUM+J",0
45,"45133",2808,2233,2187,14,46,"PUM+J",3
44,"44201",478,417,412,3,5,"PUM+J",0
37,"37012",145,116,114,0,2,"PUM+J",0
20,"20025",1116,835,830,2,5,"PUM+J",0
47,"47063",89,71,71,0,0,"PUM+J",0
9,"9326",154,129,127,4,2,"PUM+J",2
34,"34178",119,105,104,0,1,"PUM+J",0
4,"4043",511,423,421,3,2,"PUM+J",0
42,"42173",29702,22141,21776,301,365,"PUM+J",38
28,"28100",4409,3425,3382,20,43,"PUM+J",5
47,"47189",151,126,123,0,3,"PUM+J",0
50,"50293",392,295,293,6,2,"PUM+J",0
2,"2077",54,45,44,0,1,"PUM+J",0
32,"32047",1746,1272,1252,6,20,"PUM+J",1
31,"31096",101,85,84,3,1,"PUM+J",1
47,"47190",95,81,81,1,0,"PUM+J",1
45,"45089",1432,1159,1134,5,25,"PUM+J",2
44,"44041",58,48,44,1,4,"PUM+J",0
39,"39046",1343,1002,988,8,14,"PUM+J",2
28,"28027",1200,920,906,4,14,"PUM+J",2
19,"19047",55,47,47,0,0,"PUM+J",0
50,"50063",61,54,54,0,0,"PUM+J",0
23,"23038",3785,3182,3162,16,20,"PUM+J",2
20,"20026",204,182,159,3,23,"PUM+J",0
48,"48052",1567,1309,1300,4,9,"PUM+J",0
50,"50006",908,705,689,3,16,"PUM+J",0
9,"9109",1066,686,650,11,36,"PUM+J",6
38,"38014",1341,991,981,6,10,"PUM+J",2
18,"18071",5612,4271,4184,29,87,"PUM+J",3
19,"19048",19,13,13,0,0,"PUM+J",0
26,"26148",150,128,124,1,4,"PUM+J",0
6,"6083",46489,34360,33989,270,371,"PUM+J",73
45,"45183",2337,1743,1704,7,39,"PUM+J",2
45,"45046",2369,1860,1832,5,28,"PUM+J",1
19,"19151",1083,785,770,5,15,"PUM+J",3
47,"47192",94,82,81,2,1,"PUM+J",0
16,"16194",220,181,173,1,8,"PUM+J",0
22,"22064",162,121,121,0,0,"PUM+J",1
34,"34042",292,244,243,3,1,"PUM+J",1
44,"44142",28,21,21,0,0,"PUM+J",0
49,"49162",175,134,131,1,3,"PUM+J",0
9,"9167",53,39,36,0,3,"PUM+J",0
48,"48053",904,738,728,5,10,"PUM+J",2
41,"41006",2738,1971,1945,16,26,"PUM+J",2
37,"37252",101,80,79,1,1,"PUM+J",0
19,"19196",90,77,70,1,7,"PUM+J",0
33,"33075",253,139,135,1,4,"PUM+J",0
22,"22029",119,103,103,0,0,"PUM+J",0
37,"37017",222,177,177,1,0,"PUM+J",0
7,"7052",4816,3276,3258,39,18,"PUM+J",2
44,"44235",89,67,66,2,1,"PUM+J",0
6,"6150",780,637,635,2,2,"PUM+J",0
28,"28104",15318,12897,12797,87,100,"PUM+J",9
44,"44043",88,67,65,1,2,"PUM+J",0
22,"22066",748,576,567,6,9,"PUM+J",0
31,"31061",48,46,46,0,0,"PUM+J",0
18,"18181",202,150,148,0,2,"PUM+J",0
38,"38017",30646,18576,18373,100,203,"PUM+J",19
48,"48054",24938,19329,19197,124,132,"PUM+J",25
9,"9013",44,37,37,0,0,"PUM+J",0
47,"47007",4036,3261,3217,25,44,"PUM+J",6
29,"29904",417,337,335,2,2,"PUM+J",0
5,"5101",277,224,222,0,2,"PUM+J",0
33,"33016",18904,14376,14235,168,141,"PUM+J",6
50,"50009",97,72,71,1,1,"PUM+J",0
19,"19106",76,57,57,0,0,"PUM+J",0
9,"9275",166,130,130,2,0,"PUM+J",0
14,"14039",2575,2037,1990,14,47,"PUM+J",1
47,"47194",292,245,243,1,2,"PUM+J",0
24,"24040",412,322,320,2,2,"PUM+J",0
9,"9335",87,71,71,0,0,"PUM+J",0
48,"48055",2596,2023,2005,12,18,"PUM+J",3
6,"6053",590,461,444,7,17,"PUM+J",1
40,"40146",238,205,202,0,3,"PUM+J",0
24,"24041",527,371,364,4,7,"PUM+J",0
49,"49043",265,210,208,1,2,"PUM+J",0
19,"19108",102,92,89,0,3,"PUM+J",0
2,"2010",1798,1494,1469,6,25,"PUM+J",1
33,"33078",126,87,85,0,2,"PUM+J",0
9,"9337",114,93,93,0,0,"PUM+J",0
4,"4050",751,522,519,1,3,"PUM+J",1
12,"12075",107,89,87,0,2,"PUM+J",0
49,"49044",78,64,64,1,0,"PUM+J",0
6,"6054",5454,4329,4190,46,139,"PUM+J",2
40,"40076",6537,5130,5012,22,118,"PUM+J",4
5,"5218",105,82,81,0,1,"PUM+J",0
14,"14041",3115,2449,2376,45,73,"PUM+J",0
34,"34189",53,39,39,1,0,"PUM+J",0
19,"19244",74,54,54,0,0,"PUM+J",0
28,"28108",3642,2878,2841,16,37,"PUM+J",5
24,"24042",61,47,47,1,0,"PUM+J",0
44,"44146",170,148,146,3,2,"PUM+J",0
28,"28033",4082,3172,3140,13,32,"PUM+J",2
9,"9443",152,115,112,0,3,"PUM+J",0
24,"24043",122,71,69,0,2,"PUM+J",0
9,"9339",126,105,105,1,0,"PUM+J",1
6,"6055",1998,1552,1523,9,29,"PUM+J",0
49,"49046",242,178,175,0,3,"PUM+J",0
40,"40043",1791,1472,1447,9,25,"PUM+J",1
45,"45008",142,121,121,0,0,"PUM+J",0
9,"9394",662,495,490,10,5,"PUM+J",1
20,"20032",8681,6491,6429,22,62,"PUM+J",4
16,"16203",10167,7720,7591,49,129,"PUM+J",7
29,"29018",1996,1523,1481,11,42,"PUM+J",0
9,"9019",144,113,109,1,4,"PUM+J",0
19,"19246",42,30,30,0,0,"PUM+J",0
45,"45101",3709,3052,3002,14,50,"PUM+J",2
37,"37108",99,80,78,2,2,"PUM+J",0
31,"31107",1680,1330,1312,16,18,"PUM+J",6
50,"50130",362,252,249,1,3,"PUM+J",0
18,"18079",3469,2667,2623,16,44,"PUM+J",2
31,"31148",92,67,65,4,2,"PUM+J",0
49,"49010",348,301,295,6,6,"PUM+J",0
9,"9340",76,56,56,1,0,"PUM+J",0
2,"2013",135,113,110,0,3,"PUM+J",0
9,"9021",51,36,35,1,1,"PUM+J",0
28,"28110",2003,1596,1571,7,25,"PUM+J",0
19,"19112",53,41,40,1,1,"PUM+J",0
34,"34196",88,74,74,4,0,"PUM+J",0
28,"28005",136050,108267,107316,772,951,"PUM+J",143
19,"19204",149,112,112,1,0,"PUM+J",0
31,"31027",814,623,610,8,13,"PUM+J",1
9,"9177",1127,883,877,6,6,"PUM+J",1
9,"9068",24,18,18,0,0,"PUM+J",0
16,"16073",188,159,155,0,4,"PUM+J",0
49,"49170",98,75,75,1,0,"PUM+J",0
44,"44049",796,592,578,9,14,"PUM+J",0
31,"31069",830,639,638,3,1,"PUM+J",1
50,"50274",66,48,47,0,1,"PUM+J",0
22,"22075",119,87,87,1,0,"PUM+J",0
47,"47199",71,59,59,3,0,"PUM+J",0
24,"24008",9025,6803,6702,79,101,"PUM+J",14
42,"42144",423,338,336,4,2,"PUM+J",3
9,"9071",40,32,32,0,0,"PUM+J",0
19,"19114",33,25,25,1,0,"PUM+J",0
47,"47013",90,80,78,4,2,"PUM+J",0
19,"19250",15,13,13,0,0,"PUM+J",0
40,"40046",82,69,69,1,0,"PUM+J",0
19,"19296",27,24,24,0,0,"PUM+J",0
33,"33022",813,555,543,6,12,"PUM+J",0
37,"37262",69,60,60,0,0,"PUM+J",0
4,"4092",2789,2207,2173,6,34,"PUM+J",3
40,"40047",32,25,25,0,0,"PUM+J",0
33,"33053",1079,738,729,6,9,"PUM+J",2
49,"49172",481,316,310,2,6,"PUM+J",0
18,"18154",975,701,699,3,2,"PUM+J",0
39,"39028",3870,3131,3094,19,37,"PUM+J",2
5,"5070",30,28,28,0,0,"PUM+J",0
9,"9449",92,75,74,1,1,"PUM+J",0
24,"24010",8268,5968,5847,66,121,"PUM+J",9
22,"22206",182,145,145,0,0,"PUM+J",0
40,"40154",23,20,20,0,0,"PUM+J",0
39,"39057",2367,1831,1796,14,35,"PUM+J",0
24,"24170",1839,1417,1391,7,26,"PUM+J",2
29,"29023",2290,1569,1550,3,19,"PUM+J",6
44,"44244",68,48,48,4,0,"PUM+J",0
12,"12081",602,488,481,0,7,"PUM+J",0
9,"9181",277,220,219,2,1,"PUM+J",0
37,"37069",971,721,704,2,17,"PUM+J",0
47,"47141",118,103,102,0,1,"PUM+J",0
5,"5110",706,550,546,4,4,"PUM+J",0
19,"19211",356,301,300,0,1,"PUM+J",2
49,"49015",201,157,155,0,2,"PUM+J",0
29,"29057",341,236,233,0,3,"PUM+J",0
49,"49175",205,150,149,2,1,"PUM+J",1
18,"18192",1466,1171,1156,1,15,"PUM+J",0
6,"6062",576,435,430,0,5,"PUM+J",0
49,"49055",95,83,83,1,0,"PUM+J",0
14,"14048",1189,948,933,5,15,"PUM+J",0
16,"16213",34,29,28,0,1,"PUM+J",0
33,"33025",8996,6369,6309,81,60,"PUM+J",7
50,"50165",1783,1359,1330,20,29,"PUM+J",1
9,"9183",47,41,41,0,0,"PUM+J",0
50,"50250",56,45,45,0,0,"PUM+J",0
5,"5189",396,325,321,1,4,"PUM+J",0
39,"39031",1245,990,983,5,7,"PUM+J",0
35,"35001",4571,3523,3463,8,60,"PUM+J",1
48,"48034",12639,9519,9443,77,76,"PUM+J",19
31,"31074",390,310,307,5,3,"PUM+J",0
49,"49057",105,85,81,2,4,"PUM+J",0
45,"45065",261,207,205,2,2,"PUM+J",0
50,"50222",1570,1126,1105,17,21,"PUM+J",1
44,"44217",31,25,25,0,0,"PUM+J",0
50,"50279",73,61,60,2,1,"PUM+J",0
5,"5230",65,58,58,4,0,"PUM+J",0
24,"24173",908,679,667,3,12,"PUM+J",0
50,"50251",8207,6352,6242,46,110,"PUM+J",5
7,"7065",2302,1633,1603,10,30,"PUM+J",4
45,"45111",53,43,41,0,2,"PUM+J",0
41,"41091",539730,412509,408312,3804,4197,"PUM+J",755
41,"41074",2998,2364,2322,17,42,"PUM+J",0
28,"28117",98,89,87,2,2,"PUM+J",0
24,"24174",469,360,354,5,6,"PUM+J",1
49,"49058",298,244,242,1,2,"PUM+J",0
50,"50194",81,59,59,1,0,"PUM+J",0
18,"18194",2045,1394,1370,11,24,"PUM+J",3
45,"45067",2289,1860,1820,17,40,"PUM+J",2
9,"9354",33,29,29,2,0,"PUM+J",0
47,"47080",35,23,21,0,2,"PUM+J",0
31,"31198",37,32,32,0,0,"PUM+J",0
42,"42058",102,84,84,0,0,"PUM+J",0
22,"22081",243,187,186,0,1,"PUM+J",0
9,"9033",81,69,68,1,1,"PUM+J",0
31,"31077",5407,4148,4081,39,67,"PUM+J",7
44,"44155",1056,830,813,9,17,"PUM+J",2
22,"22082",285,230,226,2,4,"PUM+J",0
28,"28043",6166,4404,4320,30,84,"PUM+J",6
49,"49141",296,220,218,0,2,"PUM+J",0
9,"9355",87,69,67,1,2,"PUM+J",0
16,"16218",187,149,148,2,1,"PUM+J",0
37,"37193",365,277,276,3,1,"PUM+J",0
24,"24056",2762,2062,2013,24,49,"PUM+J",4
34,"34213",52,42,42,0,0,"PUM+J",0
24,"24137",1052,815,803,14,12,"PUM+J",2
47,"47209",34,25,25,0,0,"PUM+J",0
34,"34158",286,194,194,0,0,"PUM+J",0
40,"40018",75,60,60,0,0,"PUM+J",0
44,"44189",48,36,36,0,0,"PUM+J",0
40,"40160",93,72,72,0,0,"PUM+J",0
6,"6100",852,681,677,3,4,"PUM+J",0
31,"31200",748,555,546,5,9,"PUM+J",2
28,"28044",6193,5040,4991,31,49,"PUM+J",5
4,"4024",3225,2558,2534,23,24,"PUM+J",3
37,"37346",252,214,213,3,1,"PUM+J",0
5,"5158",345,279,274,2,5,"PUM+J",0
50,"50298",5427,4373,4323,30,50,"PUM+J",4
2,"2025",7355,5864,5693,30,171,"PUM+J",9
6,"6001",659,539,534,7,5,"PUM+J",0
37,"37078",788,670,658,6,12,"PUM+J",0
31,"31243",302,241,237,5,4,"PUM+J",2
9,"9360",25,22,22,0,0,"PUM+J",0
32,"32036",1261,954,938,9,16,"PUM+J",4
9,"9466",112,87,85,2,2,"PUM+J",0
45,"45117",715,571,556,1,15,"PUM+J",1
20,"20014",1156,772,765,4,7,"PUM+J",1
9,"9138",87,74,72,2,2,"PUM+J",0
16,"16091",64,46,46,1,0,"PUM+J",0
14,"14054",13796,11042,10799,102,243,"PUM+J",14
44,"44097",126,91,90,2,1,"PUM+J",0
49,"49229",113,88,87,0,1,"PUM+J",0
41,"41021",21397,15585,15334,201,251,"PUM+J",18
39,"39064",1341,1103,1094,5,9,"PUM+J",0
22,"22217",372,296,290,5,6,"PUM+J",0
40,"40056",32,21,21,0,0,"PUM+J",0
47,"47211",48,43,43,1,0,"PUM+J",0
37,"37310",172,125,124,3,1,"PUM+J",0
9,"9038",111,95,95,0,0,"PUM+J",1
50,"50284",132,105,104,1,1,"PUM+J",0
33,"33001",1504,875,864,15,11,"PUM+J",1
26,"26055",39,35,35,1,0,"PUM+J",0
5,"5042",141,117,116,0,1,"PUM+J",0
34,"34163",46,40,40,1,0,"PUM+J",0
28,"28122",570,457,448,3,9,"PUM+J",0
19,"19264",34,28,28,0,0,"PUM+J",0
16,"16092",154,113,112,0,1,"PUM+J",0
14,"14025",2857,2482,2436,14,46,"PUM+J",0
48,"48041",686,581,579,2,2,"PUM+J",0
49,"49025",159,126,124,0,2,"PUM+J",0
50,"50111",183,144,142,2,2,"PUM+J",0
28,"28048",504,399,392,6,7,"PUM+J",2
16,"16228",176,150,150,1,0,"PUM+J",0
50,"50285",650,466,462,7,4,"PUM+J",0
49,"49270",137,111,111,0,0,"PUM+J",1
38,"38004",4490,3242,3202,18,40,"PUM+J",5
42,"42113",521,382,380,3,2,"PUM+J",0
4,"4069",4757,3633,3588,25,45,"PUM+J",3
32,"32038",399,274,271,3,3,"PUM+J",0
12,"12119",137,107,104,1,3,"PUM+J",0
45,"45167",1385,1143,1130,2,13,"PUM+J",0
50,"50229",65,57,56,0,1,"PUM+J",0
26,"26095",95,78,78,1,0,"PUM+J",2
37,"37082",745,546,536,2,10,"PUM+J",0
19,"19132",93,72,72,0,0,"PUM+J",0
9,"9199",94,72,70,0,2,"PUM+J",0
41,"41024",22737,15687,15398,167,289,"PUM+J",12
5,"5238",739,589,586,1,3,"PUM+J",0
5,"5239",231,177,174,1,3,"PUM+J",0
18,"18097",995,708,702,4,6,"PUM+J",0
22,"22088",143,111,111,1,0,"PUM+J",0
40,"40902",117,96,96,1,0,"PUM+J",0
23,"23060",19153,14444,14281,87,163,"PUM+J",6
22,"22178",103,84,84,2,0,"PUM+J",0
44,"44258",53,44,44,0,0,"PUM+J",0
18,"18907",1774,1426,1415,10,11,"PUM+J",2
44,"44194",104,80,80,1,0,"PUM+J",0
45,"45123",3160,2434,2392,16,42,"PUM+J",5
4,"4904",1879,1328,1322,4,6,"PUM+J",0
9,"9044",53,49,47,1,2,"PUM+J",0
16,"16177",82,64,63,0,1,"PUM+J",0
28,"28125",3216,2459,2444,11,15,"PUM+J",2
9,"9148",79,63,63,5,0,"PUM+J",1
38,"38036",6831,4947,4829,58,118,"PUM+J",7
9,"9369",422,328,325,8,3,"PUM+J",0
34,"34073",180,149,145,2,4,"PUM+J",0
6,"6073",700,506,492,11,14,"PUM+J",0
18,"18099",1581,1279,1245,5,34,"PUM+J",2
19,"19269",94,75,75,0,0,"PUM+J",0
23,"23061",7691,5636,5531,51,105,"PUM+J",4
47,"47122",2016,1655,1617,15,38,"PUM+J",1
47,"47216",114,102,98,0,4,"PUM+J",0
2,"2032",265,208,203,3,5,"PUM+J",0
28,"28126",47,35,35,0,0,"PUM+J",0
5,"5241",3041,2242,2204,24,38,"PUM+J",1
2,"2033",1870,1503,1463,11,40,"PUM+J",1
26,"26061",1552,1228,1194,14,34,"PUM+J",1
49,"49275",51218,38135,37628,388,507,"PUM+J",63
37,"37129",252,206,202,2,4,"PUM+J",0
18,"18100",7981,5900,5769,44,131,"PUM+J",8
48,"48076",284,226,224,1,2,"PUM+J",0
47,"47123",461,391,390,3,1,"PUM+J",0
9,"9151",445,358,354,3,4,"PUM+J",0
44,"44035",105,86,84,1,2,"PUM+J",0
48,"48015",33109,24697,24475,161,222,"PUM+J",35
18,"18171",2111,1679,1638,8,41,"PUM+J",0
45,"45127",764,582,577,3,5,"PUM+J",1
26,"26101",34,27,27,0,0,"PUM+J",0
40,"40099",52,46,44,0,2,"PUM+J",0
50,"50289",51,40,38,1,2,"PUM+J",0
50,"50029",604,475,467,7,8,"PUM+J",0
9,"9374",90,79,78,1,1,"PUM+J",0
2,"2035",1946,1592,1576,15,16,"PUM+J",1
37,"37088",199,151,149,1,2,"PUM+J",1
34,"34077",381,301,293,2,8,"PUM+J",0
45,"45083",551,470,465,5,5,"PUM+J",0
42,"42120",132,89,87,0,2,"PUM+J",0
22,"22095",65,57,56,1,1,"PUM+J",0
37,"37089",62,51,50,0,1,"PUM+J",0
24,"24189",5816,4434,4382,49,52,"PUM+J",9
16,"16240",100,77,76,0,1,"PUM+J",0
23,"23032",523,443,439,1,4,"PUM+J",0
9,"9211",1362,1065,1050,16,15,"PUM+J",2
14,"14062",963,753,745,4,8,"PUM+J",1
50,"50262",1163,930,912,15,18,"PUM+J",1
26,"26103",827,655,645,3,10,"PUM+J",0
12,"12096",744,588,580,7,8,"PUM+J",0
50,"50118",2110,1622,1605,19,17,"PUM+J",0
5,"5245",348,295,290,3,5,"PUM+J",0
5,"5008",208,168,163,1,5,"PUM+J",0
47,"47125",51,46,45,0,1,"PUM+J",0
6,"6077",321,260,256,4,4,"PUM+J",0
20,"20053",4848,3479,3451,27,28,"PUM+J",3
49,"49077",159,104,103,0,1,"PUM+J",0
28,"28054",11891,9476,9395,64,81,"PUM+J",8
6,"6078",506,415,410,1,5,"PUM+J",0
24,"24070",3941,3007,2947,27,60,"PUM+J",1
38,"38041",6970,5288,5258,38,30,"PUM+J",4
18,"18912",1367,990,984,5,6,"PUM+J",1
22,"22228",529,421,417,3,4,"PUM+J",1
37,"37321",149,121,121,0,0,"PUM+J",0
47,"47220",154,119,119,1,0,"PUM+J",0
37,"37206",91,66,63,1,3,"PUM+J",0
5,"5209",75,58,57,0,1,"PUM+J",0
50,"50292",129,113,113,1,0,"PUM+J",0
18,"18175",11786,8883,8730,58,153,"PUM+J",15
4,"4001",1014,768,763,9,5,"PUM+J",0
44,"44070",55,45,45,0,0,"PUM+J",0
9,"9378",29,21,20,0,1,"PUM+J",0
19,"19326",2343,1789,1768,9,21,"PUM+J",4
20,"20903",4803,3514,3481,24,33,"PUM+J",4
44,"44200",39,25,25,0,0,"PUM+J",0
16,"16244",708,627,617,1,10,"PUM+J",0
31,"31135",112,76,75,2,1,"PUM+J",1
44,"44108",300,228,224,5,4,"PUM+J",0
41,"41059",35105,27781,27472,261,309,"PUM+J",45
22,"22061",6583,5027,4973,51,54,"PUM+J",1
42,"42036",40,34,33,2,1,"PUM+J",0
48,"48081",1883,1532,1518,3,14,"PUM+J",0
9,"9267",113,102,101,2,1,"PUM+J",0
40,"40140",79,58,58,0,0,"PUM+J",0
49,"49081",1322,1051,1030,11,21,"PUM+J",1
18,"18106",415,300,295,0,5,"PUM+J",3
24,"24034",3457,2627,2588,31,39,"PUM+J",1
16,"16062",25,21,21,0,0,"PUM+J",0
50,"50090",134,108,108,0,0,"PUM+J",0
40,"40141",833,644,627,5,17,"PUM+J",0
26,"26031",98,89,87,0,2,"PUM+J",0
9,"9216",374,283,281,2,2,"PUM+J",0
6,"6081",1042,825,811,4,14,"PUM+J",0
23,"23069",5262,4395,4329,15,66,"PUM+J",7
50,"50034",787,568,556,3,12,"PUM+J",1
42,"42217",34,26,26,0,0,"PUM+J",0
6,"6148",957,762,746,12,16,"PUM+J",0
19,"19281",18,17,17,3,0,"PUM+J",0
28,"28058",141251,112674,111423,778,1251,"PUM+J",185
40,"40071",43,37,31,0,6,"PUM+J",0
33,"33043",658,462,455,4,7,"PUM+J",1
28,"28101",229,183,182,2,1,"PUM+J",0
40,"40177",140,114,113,1,1,"PUM+J",0
23,"23903",3499,2738,2714,7,24,"PUM+J",1
42,"42128",46,41,41,0,0,"PUM+J",0
22,"22233",80,50,50,0,0,"PUM+J",0
23,"23004",421,356,355,2,1,"PUM+J",0
9,"9011",73,50,49,0,1,"PUM+J",0
2,"2006",561,482,480,2,2,"PUM+J",0
5,"5057",2401,1949,1917,19,32,"PUM+J",0
50,"50123",436,344,338,1,6,"PUM+J",0
9,"9059",136704,109424,108039,1134,1385,"PUM+J",312
48,"48083",6946,5238,5201,35,37,"PUM+J",3
31,"31221",1235,944,938,11,6,"PUM+J",3
24,"24198",547,402,399,4,3,"PUM+J",0
31,"31099",49,43,43,0,0,"PUM+J",0
19,"19240",51,42,41,1,1,"PUM+J",0
6,"6084",1065,904,890,8,14,"PUM+J",0
18,"18109",599,452,448,3,4,"PUM+J",0
49,"49123",532,406,402,2,4,"PUM+J",0
20,"20907",117,88,87,0,1,"PUM+J",0
4,"4083",1740,1342,1326,4,16,"PUM+J",3
31,"31059",183,145,143,0,2,"PUM+J",0
24,"24038",3048,2360,2315,23,45,"PUM+J",2
31,"31100",256,181,178,1,3,"PUM+J",0
48,"48084",21858,15943,15796,116,147,"PUM+J",21
41,"41034",23480,16510,16250,230,260,"PUM+J",19
40,"40073",385,339,335,6,4,"PUM+J",1
7,"7019",164,124,124,0,0,"PUM+J",0
42,"42003",66,55,55,0,0,"PUM+J",0
19,"19285",20,18,18,0,0,"PUM+J",0
37,"37214",116,87,87,4,0,"PUM+J",0
31,"31223",959,718,711,8,7,"PUM+J",0
37,"37101",142,119,117,0,2,"PUM+J",0
2,"2045",3617,3020,2969,38,51,"PUM+J",2
34,"34089",140,119,114,2,5,"PUM+J",0
40,"40074",245,219,214,5,5,"PUM+J",1
47,"47037",163,134,128,2,6,"PUM+J",1
19,"19003",29,28,28,2,0,"PUM+J",0
22,"22110",707,531,528,2,3,"PUM+J",1
37,"37178",99,82,82,0,0,"PUM+J",0
5,"5019",44838,36021,35637,287,384,"PUM+J",60
12,"12010",237,203,198,1,5,"PUM+J",0
31,"31225",35,29,29,1,0,"PUM+J",0
16,"16251",1809,1469,1443,11,26,"PUM+J",0
45,"45142",7800,6245,6143,67,102,"PUM+J",4
40,"40075",153,128,127,0,1,"PUM+J",0
44,"44176",153,124,124,0,0,"PUM+J",0
50,"50213",93,76,75,0,1,"PUM+J",0
31,"31103",39,27,27,0,0,"PUM+J",0
20,"20061",4392,3278,3264,11,14,"PUM+J",1
37,"37331",188,130,130,1,0,"PUM+J",0
38,"38018",4455,3242,3198,24,44,"PUM+J",3
26,"26114",74,62,60,0,2,"PUM+J",0
34,"34048",63,54,53,2,1,"PUM+J",0
24,"24003",608,430,418,0,12,"PUM+J",1
16,"16070",28,26,26,1,0,"PUM+J",0
5,"5062",166,136,133,0,3,"PUM+J",0
31,"31144",763,504,503,1,1,"PUM+J",0
29,"29050",398,274,269,2,5,"PUM+J",1
19,"19288",22,21,21,1,0,"PUM+J",0
2,"2047",107,89,88,1,1,"PUM+J",0
45,"45144",740,605,598,7,7,"PUM+J",0
14,"14072",999,763,754,4,9,"PUM+J",2
9,"9392",49,41,41,0,0,"PUM+J",0
26,"26115",23,21,19,0,2,"PUM+J",0
16,"16254",203,168,166,1,2,"PUM+J",0
12,"12076",76,64,64,1,0,"PUM+J",0
47,"47070",30,26,25,0,1,"PUM+J",0
42,"42139",21,15,15,1,0,"PUM+J",0
45,"45145",2613,1950,1921,13,29,"PUM+J",1
24,"24084",152,113,113,0,0,"PUM+J",2
5,"5143",62,51,51,0,0,"PUM+J",0
6,"6022",2634,2156,2112,7,44,"PUM+J",3
47,"47166",251,196,189,3,7,"PUM+J",2
6,"6089",608,524,519,3,5,"PUM+J",1
19,"19159",87,77,76,0,1,"PUM+J",0
26,"26117",2097,1680,1647,17,33,"PUM+J",0
16,"16255",136,108,108,0,0,"PUM+J",0
34,"34096",50,44,44,0,0,"PUM+J",0
9,"9066",54,41,40,1,1,"PUM+J",0
24,"24044",152,116,114,0,2,"PUM+J",0
38,"38051",7326,5418,5352,27,66,"PUM+J",1
42,"42090",88,69,68,2,1,"PUM+J",0
37,"37334",73,49,49,0,0,"PUM+J",0
50,"50188",27,24,24,0,0,"PUM+J",0
48,"48089",3463,2746,2732,10,14,"PUM+J",1
38,"38052",1280,893,887,4,6,"PUM+J",0
50,"50216",240,189,181,3,8,"PUM+J",0
5,"5261",33,26,26,0,0,"PUM+J",0
45,"45148",275,209,209,1,0,"PUM+J",0
14,"14074",2237,1859,1839,8,20,"PUM+J",2
24,"24209",2609,1880,1857,13,23,"PUM+J",1
39,"39054",4528,3614,3575,23,39,"PUM+J",3
32,"32027",1000,762,747,5,15,"PUM+J",1
18,"18082",827,587,577,5,10,"PUM+J",0
29,"29053",1694,1263,1245,18,18,"PUM+J",1
50,"50246",38,28,28,0,0,"PUM+J",0
40,"40079",226,179,175,1,4,"PUM+J",0
7,"7026",30991,19827,19602,161,225,"PUM+J",29
50,"50217",431,346,344,0,2,"PUM+J",0
22,"22001",214,162,162,0,0,"PUM+J",0
28,"28144",6423,5274,5222,35,52,"PUM+J",10
34,"34146",53,47,46,0,1,"PUM+J",0
34,"34099",52,45,41,0,4,"PUM+J",0
5,"5026",187,163,159,1,4,"PUM+J",0
12,"12015",114,99,98,0,1,"PUM+J",0
34,"34100",131,100,97,1,3,"PUM+J",0
45,"45012",631,516,509,2,7,"PUM+J",0
45,"45150",414,326,320,2,6,"PUM+J",0
40,"40188",83,71,71,0,0,"PUM+J",0
49,"49095",279,221,217,0,4,"PUM+J",0
49,"49132",313,252,249,0,3,"PUM+J",0
6,"6093",4345,3356,3281,18,75,"PUM+J",2
47,"47200",71,62,62,0,0,"PUM+J",1
4,"4015",118,97,97,2,0,"PUM+J",0
14,"14901",915,795,782,8,13,"PUM+J",1
32,"32084",902,636,631,2,5,"PUM+J",0
22,"22003",132,114,114,0,0,"PUM+J",0
39,"39056",2268,1847,1830,7,17,"PUM+J",2
12,"12080",1900,1604,1575,10,29,"PUM+J",1
44,"44051",2588,2034,1997,26,37,"PUM+J",2
24,"24050",105,88,87,3,1,"PUM+J",0
9,"9025",108,73,72,0,1,"PUM+J",0
31,"31111",91,69,69,1,0,"PUM+J",0
42,"42014",60,44,44,1,0,"PUM+J",0
19,"19166",152,125,122,0,3,"PUM+J",0
19,"19298",55,47,47,0,0,"PUM+J",0
5,"5151",80,64,64,1,0,"PUM+J",0
28,"28146",1792,1308,1293,8,15,"PUM+J",1
18,"18017",18148,12712,12523,96,189,"PUM+J",11
37,"37339",308,227,226,0,1,"PUM+J",0
32,"32030",944,690,685,7,5,"PUM+J",0
24,"24091",585,433,423,1,10,"PUM+J",2
47,"47142",124,94,92,0,2,"PUM+J",0
9,"9350",430,340,339,9,1,"PUM+J",0
16,"16212",230,198,196,2,2,"PUM+J",0
48,"48033",204,160,159,1,1,"PUM+J",0
16,"16122",249,197,196,3,1,"PUM+J",1
48,"48094",3125,2407,2388,12,19,"PUM+J",1
19,"19300",788,664,652,2,12,"PUM+J",4
48,"48003",14444,11233,11162,43,71,"PUM+J",17
40,"40223",228,181,181,0,0,"PUM+J",0
9,"9238",941,573,567,8,6,"PUM+J",0
42,"42151",38,31,30,0,1,"PUM+J",0
38,"38026",33514,26298,26076,191,222,"PUM+J",18
37,"37070",528,422,417,2,5,"PUM+J",0
34,"34059",402,326,320,3,6,"PUM+J",0
50,"50278",177,137,137,2,0,"PUM+J",0
49,"49261",1505,1168,1149,8,19,"PUM+J",2
9,"9352",107,86,86,2,0,"PUM+J",0
50,"50221",32,22,22,0,0,"PUM+J",0
24,"24215",152,125,124,1,1,"PUM+J",0
32,"32060",765,577,567,2,10,"PUM+J",0
50,"50046",167,134,130,3,4,"PUM+J",0
6,"6096",207,168,167,1,1,"PUM+J",0
16,"16084",50,36,32,0,4,"PUM+J",0
19,"19169",33,26,25,0,1,"PUM+J",0
37,"37190",193,144,144,1,0,"PUM+J",0
20,"20039",2144,1704,1692,11,12,"PUM+J",1
49,"49018",288,225,222,1,3,"PUM+J",0
16,"16166",239,176,174,3,2,"PUM+J",0
49,"49177",260,165,162,2,3,"PUM+J",0
50,"50047",43,32,31,1,1,"PUM+J",0
45,"45066",7770,6064,5962,21,102,"PUM+J",12
22,"22008",155,127,125,0,2,"PUM+J",1
48,"48005",113,80,80,0,0,"PUM+J",0
18,"18123",288,219,219,2,0,"PUM+J",0
49,"49224",169,117,115,0,2,"PUM+J",0
7,"7032",20888,14257,14096,108,161,"PUM+J",12
42,"42019",511,384,378,7,6,"PUM+J",0
18,"18021",17869,13238,13004,110,234,"PUM+J",21
41,"41018",9410,6987,6882,52,105,"PUM+J",6
29,"29061",1033,840,821,5,19,"PUM+J",1
6,"6065",298,258,255,1,3,"PUM+J",0
16,"16273",303,236,231,2,5,"PUM+J",0
2,"2059",313,252,250,3,2,"PUM+J",0
40,"40193",221,163,161,5,2,"PUM+J",0
9,"9243",73,57,55,0,2,"PUM+J",0
31,"31118",158,120,116,2,4,"PUM+J",0
47,"47145",586,446,440,2,6,"PUM+J",0
37,"37306",242,184,181,2,3,"PUM+J",0
42,"42020",4186,3027,2988,28,39,"PUM+J",3
7,"7033",28373,17884,17684,201,200,"PUM+J",28
22,"22252",118,100,99,0,1,"PUM+J",0
7,"7034",1064,906,900,6,6,"PUM+J",2
48,"48901",5151,4042,4012,22,30,"PUM+J",6
50,"50021",25,23,23,1,0,"PUM+J",0
37,"37232",378,322,321,1,1,"PUM+J",0
42,"42155",142,92,92,0,0,"PUM+J",0
42,"42021",68,44,44,2,0,"PUM+J",0
22,"22173",218,162,160,1,2,"PUM+J",0
31,"31119",36,26,25,0,1,"PUM+J",0
50,"50196",102,83,81,2,2,"PUM+J",0
40,"40195",813,630,623,5,7,"PUM+J",0
19,"19173",51,47,47,0,0,"PUM+J",1
6,"6067",1915,1393,1370,7,23,"PUM+J",1
16,"16171",1749,1449,1422,6,27,"PUM+J",1
48,"48038",1158,891,891,2,0,"PUM+J",1
37,"37270",183,143,140,1,3,"PUM+J",0
42,"42156",29,23,23,0,0,"PUM+J",0
44,"44028",171,140,138,1,2,"PUM+J",0
9,"9083",27,24,23,0,1,"PUM+J",0
12,"12088",57,54,54,0,0,"PUM+J",0
47,"47147",102,85,85,0,0,"PUM+J",0
37,"37121",556,448,444,3,4,"PUM+J",0
20,"20044",364,263,262,0,1,"PUM+J",2
50,"50139",322,257,256,0,1,"PUM+J",0
24,"24178",72,65,65,1,0,"PUM+J",0
31,"31081",334,259,256,7,3,"PUM+J",1
16,"16046",223,162,161,1,1,"PUM+J",0
37,"37271",351,286,280,0,6,"PUM+J",1
16,"16172",349,278,275,3,3,"PUM+J",0
33,"33031",33854,23523,23143,307,380,"PUM+J",15
19,"19027",131,98,96,0,2,"PUM+J",0
31,"31122",4946,3915,3882,59,33,"PUM+J",12
37,"37347",464,368,359,2,9,"PUM+J",0
26,"26131",34,34,34,1,0,"PUM+J",0
19,"19308",60,57,57,1,0,"PUM+J",0
7,"7037",3357,2142,2120,16,22,"PUM+J",0
33,"33061",350,201,200,2,1,"PUM+J",0
50,"50140",157,108,108,0,0,"PUM+J",0
49,"49268",368,282,279,2,3,"PUM+J",0
9,"9471",142,113,112,3,1,"PUM+J",0
34,"34161",22,17,16,0,1,"PUM+J",0
37,"37311",207,164,162,4,2,"PUM+J",0
6,"6003",766,625,610,3,15,"PUM+J",1
44,"44001",65,51,50,0,1,"PUM+J",0
7,"7005",6975,4824,4775,43,49,"PUM+J",0
34,"34069",2184,1737,1701,16,36,"PUM+J",1
34,"34217",1251,1053,1042,7,11,"PUM+J",0
35,"35007",518,405,401,0,4,"PUM+J",1
45,"45028",3628,2916,2863,16,53,"PUM+J",4
16,"16278",63,51,51,0,0,"PUM+J",0
19,"19310",7,6,6,0,0,"PUM+J",0
34,"34165",59,51,50,1,1,"PUM+J",0
26,"26174",132,116,116,5,0,"PUM+J",0
31,"31206",2082,1610,1589,15,21,"PUM+J",8
14,"14056",23513,17065,16684,147,381,"PUM+J",13
19,"19266",229,194,192,1,2,"PUM+J",0
5,"5123",103,85,85,1,0,"PUM+J",0
18,"18096",344,265,265,2,0,"PUM+J",1
20,"20047",462,337,335,2,2,"PUM+J",0
37,"37124",196,153,153,2,0,"PUM+J",0
31,"31004",32,26,26,0,0,"PUM+J",0
37,"37351",269,234,233,6,1,"PUM+J",0
26,"26136",92,80,80,3,0,"PUM+J",0
42,"42027",73,63,63,0,0,"PUM+J",0
9,"9419",67,53,52,0,1,"PUM+J",0
19,"19314",45,38,38,1,0,"PUM+J",0
7,"7039",4970,3557,3489,36,68,"PUM+J",6
50,"50055",3627,2627,2571,41,56,"PUM+J",4
38,"38035",10384,6657,6596,50,61,"PUM+J",10
4,"4031",2249,1778,1773,2,5,"PUM+J",1
32,"32039",1142,895,890,7,5,"PUM+J",0
6,"6006",4494,3395,3325,24,70,"PUM+J",2
28,"28157",682,530,516,1,14,"PUM+J",0
37,"37199",129,97,97,0,0,"PUM+J",0
5,"5045",80,65,65,0,0,"PUM+J",0
31,"31128",341,255,250,3,5,"PUM+J",0
19,"19182",39,32,32,0,0,"PUM+J",0
33,"33035",11226,8326,8252,112,74,"PUM+J",6
19,"19226",41,32,32,0,0,"PUM+J",1
49,"49188",110,87,86,0,1,"PUM+J",0
33,"33065",1084,761,746,18,15,"PUM+J",0
44,"44102",27,22,22,0,0,"PUM+J",0
18,"18135",4434,3169,3105,23,64,"PUM+J",1
50,"50144",31,26,25,0,1,"PUM+J",0
19,"19183",71,61,59,0,2,"PUM+J",0
2,"2069",11414,9019,8883,54,136,"PUM+J",4
37,"37127",200,145,145,1,0,"PUM+J",0
47,"47153",104,76,75,0,1,"PUM+J",0
34,"34122",86,68,66,0,2,"PUM+J",0
49,"49235",422,312,301,0,11,"PUM+J",0
20,"20080",7709,5629,5588,28,41,"PUM+J",4
12,"12031",3942,2976,2931,24,45,"PUM+J",0
16,"16139",324,249,249,2,0,"PUM+J",0
44,"44164",20,18,18,0,0,"PUM+J",0
39,"39069",1928,1650,1627,9,23,"PUM+J",2
22,"22225",2610,1867,1843,15,24,"PUM+J",2
2,"2070",384,318,318,2,0,"PUM+J",0
39,"39013",535,434,431,1,3,"PUM+J",1
37,"37006",117,81,81,2,0,"PUM+J",0
31,"31210",186,156,156,1,0,"PUM+J",0
24,"24066",449,329,324,3,5,"PUM+J",0
48,"48045",5194,4138,4098,25,40,"PUM+J",4
37,"37242",80,65,64,1,1,"PUM+J",0
47,"47058",202,154,153,3,1,"PUM+J",0
34,"34123",1637,1376,1354,8,22,"PUM+J",1
48,"48046",12644,9809,9744,46,65,"PUM+J",3
16,"16904",451,386,383,3,3,"PUM+J",0
23,"23097",6356,4509,4462,17,47,"PUM+J",9
22,"22907",1444,1149,1137,12,12,"PUM+J",2
40,"40100",263,219,215,1,4,"PUM+J",0
48,"48016",5437,4282,4248,21,34,"PUM+J",8
16,"16905",1278,1028,1012,11,16,"PUM+J",0
49,"49115",169,137,136,0,1,"PUM+J",0
4,"4035",8433,6246,6196,33,50,"PUM+J",1
31,"31010",5728,4211,4153,30,58,"PUM+J",9
9,"9427",1364,1002,972,13,30,"PUM+J",1
18,"18138",2482,1698,1668,20,30,"PUM+J",0
24,"24108",348,268,265,2,3,"PUM+J",0
41,"41101",6016,4524,4480,42,44,"PUM+J",4
44,"44135",102,85,85,0,0,"PUM+J",0
5,"5089",455,354,340,1,14,"PUM+J",0
34,"34227",72,63,61,4,2,"PUM+J",0
9,"9428",103,86,86,0,0,"PUM+J",0
24,"24902",335,266,263,1,3,"PUM+J",0
34,"34125",79,59,58,0,1,"PUM+J",0
37,"37244",128,99,97,1,2,"PUM+J",0
16,"16906",71,52,52,1,0,"PUM+J",0
42,"42033",50,45,44,1,1,"PUM+J",0
35,"35013",6584,5067,4974,49,93,"PUM+J",3
45,"45176",3841,2992,2952,16,40,"PUM+J",6
20,"20902",14229,10567,10495,53,72,"PUM+J",18
9,"9429",55,41,41,0,0,"PUM+J",0
16,"16908",163,135,133,0,2,"PUM+J",0
41,"41057",253,189,188,0,1,"PUM+J",0
16,"16017",340,281,271,2,10,"PUM+J",0
33,"33070",3293,2499,2473,32,26,"PUM+J",2
31,"31256",96,64,64,0,0,"PUM+J",0
22,"22141",114,86,85,0,1,"PUM+J",0
12,"12125",222,189,187,0,2,"PUM+J",0
37,"37133",101,84,80,0,4,"PUM+J",0
50,"50207",93,68,67,2,1,"PUM+J",0
37,"37171",397,297,292,1,5,"PUM+J",0
14,"14064",300,231,227,6,4,"PUM+J",0
9,"9159",61,52,51,0,1,"PUM+J",0
16,"16058",97,73,73,0,0,"PUM+J",0
19,"19190",2302,1788,1767,13,21,"PUM+J",1
6,"6112",383,334,334,1,0,"PUM+J",0
31,"31134",175,130,128,1,2,"PUM+J",1
22,"22023",389,313,305,6,8,"PUM+J",1
28,"28164",3202,2553,2530,19,23,"PUM+J",2
50,"50120",55,43,43,2,0,"PUM+J",0
12,"12005",8052,6056,5935,50,121,"PUM+J",8
50,"50265",74,56,56,0,0,"PUM+J",0
9,"9431",120,98,98,3,0,"PUM+J",0
48,"48914",325,286,285,0,1,"PUM+J",0
41,"41003",2371,1801,1760,8,41,"PUM+J",3
50,"50151",603,490,489,3,1,"PUM+J",0
31,"31217",334,233,225,3,8,"PUM+J",1
40,"40105",44,39,38,0,1,"PUM+J",0
14,"14004",1981,1522,1509,8,13,"PUM+J",0
5,"5172",116,95,93,0,2,"PUM+J",0
42,"42125",75,62,62,2,0,"PUM+J",0
47,"47222",86,71,71,0,0,"PUM+J",0
34,"34231",217,184,178,0,6,"PUM+J",0
28,"28057",1549,1246,1239,5,7,"PUM+J",1
29,"29099",969,757,735,5,22,"PUM+J",1
12,"12038",156,110,109,1,1,"PUM+J",0
18,"18037",528,435,426,2,9,"PUM+J",1
31,"31137",198,106,103,3,3,"PUM+J",1
9,"9433",58,51,50,1,1,"PUM+J",0
9,"9217",349,268,266,5,2,"PUM+J",0
19,"19193",23,20,20,0,0,"PUM+J",0
7,"7049",1480,1092,1075,10,17,"PUM+J",1
28,"28166",347,287,286,1,1,"PUM+J",0
44,"44110",37,33,33,0,0,"PUM+J",0
50,"50122",67,55,54,0,1,"PUM+J",0
49,"49243",109,86,83,0,3,"PUM+J",0
45,"45091",374,275,274,1,1,"PUM+J",0
14,"14006",1321,1155,1127,4,28,"PUM+J",0
42,"42038",34,27,27,1,0,"PUM+J",0
22,"22106",20,15,15,0,0,"PUM+J",0
23,"23070",3808,2598,2565,34,33,"PUM+J",1
29,"29045",1681,1263,1242,9,21,"PUM+J",2
28,"28134",63352,51185,50776,336,409,"PUM+J",82
48,"48022",2316,1645,1631,11,14,"PUM+J",1
14,"14037",3182,2388,2319,22,69,"PUM+J",3
22,"22149",308,247,246,3,1,"PUM+J",0
35,"35018",13056,8699,8618,73,81,"PUM+J",8
45,"45184",201,133,132,0,1,"PUM+J",1
18,"18039",3382,2517,2490,20,27,"PUM+J",1
34,"34087",122,105,105,0,0,"PUM+J",0
47,"47066",1407,1131,1122,11,9,"PUM+J",1
9,"9112",104,76,76,1,0,"PUM+J",0
9,"9387",111,91,89,0,2,"PUM+J",0
34,"34182",753,609,604,6,5,"PUM+J",0
40,"40003",121,91,89,1,2,"PUM+J",0
32,"32077",1104,820,815,10,5,"PUM+J",0
19,"19152",550,413,405,3,8,"PUM+J",0
42,"42041",31,23,23,1,0,"PUM+J",0
23,"23905",1840,1358,1341,9,17,"PUM+J",4
26,"26150",100,83,83,0,0,"PUM+J",0
34,"34134",40,31,31,1,0,"PUM+J",1
14,"14008",2785,1942,1910,15,32,"PUM+J",3
16,"16025",25,21,21,0,0,"PUM+J",0
49,"49124",237,169,166,1,3,"PUM+J",0
4,"4047",2230,1806,1785,8,21,"PUM+J",1
50,"50241",595,434,423,3,11,"PUM+J",3
19,"19197",27,22,22,0,0,"PUM+J",0
23,"23006",4582,3607,3543,32,64,"PUM+J",3
40,"40109",72,59,54,1,5,"PUM+J",0
50,"50065",55,43,43,1,0,"PUM+J",0
19,"19334",44,37,37,0,0,"PUM+J",0
49,"49247",417,301,294,0,7,"PUM+J",0
19,"19335",56,45,43,0,2,"PUM+J",0
31,"31265",78,52,47,1,5,"PUM+J",0
47,"47068",30,23,23,0,0,"PUM+J",0
50,"50066",2835,2199,2177,19,22,"PUM+J",1
49,"49248",174,142,139,2,3,"PUM+J",0
24,"24119",695,515,501,8,14,"PUM+J",1
28,"28169",1553,1280,1273,15,7,"PUM+J",1
31,"31901",15510,12225,12133,114,92,"PUM+J",47
4,"4049",5603,4104,4054,27,50,"PUM+J",3
37,"37141",152,120,119,2,1,"PUM+J",1
19,"19901",36,32,32,0,0,"PUM+J",0
26,"26037",131,99,98,1,1,"PUM+J",0
44,"44016",436,334,331,1,3,"PUM+J",0
33,"33047",1074,841,835,12,6,"PUM+J",0
48,"48026",1139,920,913,4,7,"PUM+J",0
47,"47038",101,79,79,0,0,"PUM+J",0
44,"44238",2294,1763,1743,10,20,"PUM+J",1
6,"6021",908,708,698,9,10,"PUM+J",0
41,"41009",1167,820,805,4,15,"PUM+J",1
22,"22200",239,181,178,0,3,"PUM+J",0
16,"16029",102,81,81,1,0,"PUM+J",0
50,"50157",286,226,220,0,6,"PUM+J",0
39,"39023",6523,5205,5144,22,61,"PUM+J",2
39,"39024",1815,1436,1420,14,16,"PUM+J",0
28,"28171",4382,3202,3134,11,68,"PUM+J",2
37,"37256",195,152,150,0,2,"PUM+J",0
50,"50068",1947,1402,1389,11,13,"PUM+J",2
22,"22036",88,76,75,0,1,"PUM+J",0
41,"41066",1310,1027,1010,1,17,"PUM+J",1
18,"18184",2170,1688,1656,3,32,"PUM+J",1
16,"16071",20,18,18,0,0,"PUM+J",0
49,"49250",1194,954,939,8,15,"PUM+J",1
37,"37370",308,256,254,2,2,"PUM+J",5
19,"19201",60,45,45,0,0,"PUM+J",1
38,"38020",15899,11057,10924,90,133,"PUM+J",10
5,"5260",97,81,80,1,1,"PUM+J",0
37,"37021",69,52,51,1,1,"PUM+J",0
31,"31024",99,54,54,1,0,"PUM+J",0
37,"37258",137,99,98,1,1,"PUM+J",0
9,"9280",27,22,22,0,0,"PUM+J",0
32,"32082",1178,880,872,12,8,"PUM+J",0
34,"34051",91,81,79,0,2,"PUM+J",0
50,"50013",200,166,166,3,0,"PUM+J",0
2,"2049",796,582,574,1,8,"PUM+J",0
49,"49092",116,87,86,0,1,"PUM+J",0
9,"9122",88,64,64,0,0,"PUM+J",0
20,"20003",551,401,399,2,2,"PUM+J",0
6,"6123",4512,3358,3266,28,92,"PUM+J",3
29,"29074",781,606,597,2,9,"PUM+J",0
45,"45056",2300,1526,1501,8,25,"PUM+J",1
31,"31026",132,116,112,0,4,"PUM+J",0
26,"26042",799,605,596,5,9,"PUM+J",0
19,"19203",29,25,25,0,0,"PUM+J",0
42,"42049",109,73,72,1,1,"PUM+J",0
45,"45011",275,241,238,2,3,"PUM+J",0
49,"49011",212,166,165,7,1,"PUM+J",0
34,"34052",167,144,143,2,1,"PUM+J",0
49,"49255",396,324,323,3,1,"PUM+J",0
47,"47073",116,91,89,0,2,"PUM+J",0
37,"37146",102,86,86,1,0,"PUM+J",0
48,"48030",601,490,489,0,1,"PUM+J",0
44,"44211",35,24,24,0,0,"PUM+J",0
44,"44241",506,416,407,1,9,"PUM+J",0
9,"9124",1432,1078,1054,7,24,"PUM+J",2
22,"22040",144,124,120,1,4,"PUM+J",1
31,"31028",220,147,147,0,0,"PUM+J",0
9,"9125",552,424,421,3,3,"PUM+J",1
37,"37373",700,522,514,0,8,"PUM+J",1
31,"31908",1064,810,803,2,7,"PUM+J",3
44,"44212",41,32,32,0,0,"PUM+J",0
26,"26044",51,44,42,0,2,"PUM+J",0
34,"34009",30,26,26,0,0,"PUM+J",0
49,"49052",179,125,123,1,2,"PUM+J",0
18,"18048",2462,1873,1832,16,41,"PUM+J",2
9,"9448",201,161,161,1,0,"PUM+J",0
45,"45059",1696,1442,1415,4,27,"PUM+J",0
7,"7060",2665,1976,1964,14,12,"PUM+J",3
44,"44243",27,24,23,0,1,"PUM+J",0
14,"14015",2067,1575,1551,16,24,"PUM+J",0
34,"34149",21,18,18,0,0,"PUM+J",0
24,"24212",1002,772,764,7,8,"PUM+J",4
31,"31030",135,105,105,3,0,"PUM+J",0
50,"50248",502,390,377,6,13,"PUM+J",1
18,"18120",257,219,217,1,2,"PUM+J",1
50,"50163",3787,3041,3022,31,19,"PUM+J",1
4,"4057",1260,970,953,10,17,"PUM+J",2
22,"22042",117,96,95,1,1,"PUM+J",1
9,"9127",52,45,45,1,0,"PUM+J",0
6,"6027",645,572,568,0,4,"PUM+J",2
7,"7061",9564,6678,6583,67,95,"PUM+J",6
29,"29079",2335,1796,1765,7,31,"PUM+J",1
5,"5072",94,86,85,1,1,"PUM+J",0
47,"47076",17721,14605,14438,134,167,"PUM+J",20
7,"7062",7902,4889,4828,58,61,"PUM+J",6
45,"45200",4478,3666,3565,35,101,"PUM+J",3
34,"34152",125,104,101,0,3,"PUM+J",0
49,"49259",79,62,61,0,1,"PUM+J",0
24,"24130",418,331,326,0,5,"PUM+J",0
4,"4094",209,156,154,0,2,"PUM+J",0
9,"9451",238,211,207,2,4,"PUM+J",0
50,"50074",6166,4547,4444,33,103,"PUM+J",2
16,"16163",60,50,50,0,0,"PUM+J",0
35,"35028",10044,6188,6105,52,83,"PUM+J",7
47,"47015",176,136,135,0,1,"PUM+J",0
9,"9454",42,37,36,0,1,"PUM+J",0
40,"40015",24,24,24,1,0,"PUM+J",0
6,"6128",4415,3345,3288,34,57,"PUM+J",1
26,"26047",1879,1569,1549,10,20,"PUM+J",2
47,"47173",885,708,704,7,4,"PUM+J",2
29,"29081",261,212,210,2,2,"PUM+J",0
28,"28010",10538,8708,8635,54,73,"PUM+J",21
26,"26084",7187,5620,5558,36,62,"PUM+J",8
5,"5034",14,12,12,0,0,"PUM+J",0
37,"37029",193,139,133,1,6,"PUM+J",0
23,"23017",1480,1227,1202,6,25,"PUM+J",0
6,"6030",169,147,146,1,1,"PUM+J",0
9,"9297",313,268,267,6,1,"PUM+J",1
31,"31155",241,181,180,3,1,"PUM+J",0
12,"12020",120,107,107,0,0,"PUM+J",0
19,"19214",72,56,55,0,1,"PUM+J",0
37,"37030",81,68,65,0,3,"PUM+J",0
32,"32032",7932,5956,5831,55,125,"PUM+J",1
5,"5114",1264,1061,1030,3,31,"PUM+J",0
50,"50076",75,64,63,0,1,"PUM+J",1
19,"19170",189,116,116,0,0,"PUM+J",0
35,"35030",9949,6611,6462,65,149,"PUM+J",9
33,"33057",1538,1129,1097,14,32,"PUM+J",4
49,"49262",370,287,286,1,1,"PUM+J",0
45,"45204",634,500,497,1,3,"PUM+J",0
31,"31157",3470,2507,2473,32,34,"PUM+J",8
16,"16167",292,235,229,1,6,"PUM+J",0
40,"40017",84,74,71,2,3,"PUM+J",0
9,"9298",75,62,62,1,0,"PUM+J",0
9,"9458",484,408,401,5,7,"PUM+J",2
22,"22046",714,592,587,13,5,"PUM+J",0
37,"37032",549,431,430,3,1,"PUM+J",0
14,"14020",338,240,233,2,7,"PUM+J",0
32,"32005",827,628,622,4,6,"PUM+J",1
45,"45205",7342,5347,5275,30,72,"PUM+J",7
20,"20011",1633,1297,1287,2,10,"PUM+J",0
37,"37381",139,97,95,1,2,"PUM+J",0
26,"26168",5515,4130,4077,36,53,"PUM+J",6
24,"24016",507,314,311,2,3,"PUM+J",0
18,"18054",838,649,648,8,1,"PUM+J",2
6,"6132",829,598,593,0,5,"PUM+J",0
9,"9134",220,155,151,1,4,"PUM+J",0
39,"39033",540,430,423,1,7,"PUM+J",0
35,"35032",3348,2585,2542,20,43,"PUM+J",3
48,"48037",684,537,531,4,6,"PUM+J",0
39,"39034",257,167,162,2,5,"PUM+J",0
12,"12142",145,123,121,1,2,"PUM+J",0
45,"45069",1817,1460,1438,4,22,"PUM+J",3
9,"9135",40,34,34,0,0,"PUM+J",0
18,"18902",755,611,595,1,16,"PUM+J",0
50,"50281",68,55,52,0,3,"PUM+J",0
19,"19306",22,19,19,0,0,"PUM+J",0
12,"12901",3357,2693,2675,19,18,"PUM+J",0
20,"20012",148,113,112,0,1,"PUM+J",0
45,"45023",2248,1799,1784,16,15,"PUM+J",1
41,"41048",2198,1561,1512,22,49,"PUM+J",1
12,"12024",133,117,117,0,0,"PUM+J",1
18,"18023",15645,11708,11561,91,147,"PUM+J",15
34,"34020",51,38,38,0,0,"PUM+J",0
22,"22215",128,91,91,1,0,"PUM+J",0
44,"44059",550,446,437,7,9,"PUM+J",0
24,"24097",204,155,155,7,0,"PUM+J",2
18,"18903",851,644,636,1,8,"PUM+J",1
24,"24139",2087,1558,1540,20,18,"PUM+J",1
26,"26053",195,161,160,3,1,"PUM+J",0
44,"44126",317,226,222,1,4,"PUM+J",0
32,"32092",482,337,334,2,3,"PUM+J",0
24,"24019",341,279,272,0,7,"PUM+J",0
26,"26093",48,38,38,0,0,"PUM+J",0
38,"38032",13536,9924,9867,63,57,"PUM+J",7
37,"37079",80,69,68,2,1,"PUM+J",0
4,"4026",55,46,45,1,1,"PUM+J",0
44,"44221",384,320,315,2,5,"PUM+J",0
24,"24020",434,302,299,1,3,"PUM+J",0
26,"26172",25,23,23,0,0,"PUM+J",0
49,"49145",210,133,131,1,2,"PUM+J",0
28,"28016",78,62,61,1,1,"PUM+J",0
37,"37159",79,68,68,0,0,"PUM+J",0
29,"29087",371,266,263,2,3,"PUM+J",0
39,"39036",971,794,787,5,7,"PUM+J",2
44,"44127",57,45,45,0,0,"PUM+J",0
49,"49024",637,465,461,2,4,"PUM+J",0
32,"32037",681,534,523,6,11,"PUM+J",1
26,"26019",350,270,256,3,14,"PUM+J",0
6,"6136",1510,1189,1160,7,29,"PUM+J",0
24,"24142",24730,18823,18504,201,319,"PUM+J",32
4,"4067",520,387,379,1,8,"PUM+J",1
50,"50081",491,390,384,5,6,"PUM+J",0
47,"47085",16381,12697,12540,129,157,"PUM+J",7
6,"6037",1668,1137,1125,6,12,"PUM+J",1
22,"22176",170,136,135,0,1,"PUM+J",0
16,"16048",409,331,330,1,1,"PUM+J",0
18,"18165",4251,3113,3073,20,40,"PUM+J",3
40,"40022",193,162,159,2,3,"PUM+J",0
7,"7038",2025,1581,1556,14,25,"PUM+J",2
31,"31247",147,117,115,0,2,"PUM+J",0
5,"5083",141,104,103,2,1,"PUM+J",0
19,"19178",30,15,15,0,0,"PUM+J",0
41,"41079",9293,7137,6979,80,158,"PUM+J",6
31,"31165",2763,2121,2091,21,30,"PUM+J",4
49,"49231",293,212,209,0,3,"PUM+J",0
24,"24102",608,457,448,3,9,"PUM+J",0
12,"12060",430,368,365,1,3,"PUM+J",0
37,"37275",101,69,67,0,2,"PUM+J",0
23,"23027",716,524,518,2,6,"PUM+J",0
28,"28090",9128,7590,7516,54,74,"PUM+J",8
14,"14057",6139,5054,4964,51,90,"PUM+J",2
45,"45076",564,389,388,2,1,"PUM+J",1
22,"22177",97,81,81,1,0,"PUM+J",0
16,"16050",220,182,179,1,3,"PUM+J",0
23,"23028",6131,4696,4635,24,61,"PUM+J",6
9,"9143",27,18,18,0,0,"PUM+J",0
5,"5199",37,31,31,0,0,"PUM+J",1
26,"26058",143,116,115,2,1,"PUM+J",1
5,"5084",69,46,46,0,0,"PUM+J",0
34,"34167",110,88,88,0,0,"PUM+J",0
34,"34120",63965,50687,50117,471,570,"PUM+J",85
16,"16095",81,69,68,1,1,"PUM+J",0
26,"26059",1122,861,841,7,20,"PUM+J",0
44,"44131",27,22,22,0,0,"PUM+J",0
26,"26177",301,250,246,2,4,"PUM+J",0
34,"34222",109,81,79,1,2,"PUM+J",0
44,"44034",126,97,97,2,0,"PUM+J",0
40,"40132",46,32,31,1,1,"PUM+J",0
47,"47087",368,292,288,3,4,"PUM+J",1
31,"31168",241,203,199,2,4,"PUM+J",0
31,"31047",236,181,179,5,2,"PUM+J",0
37,"37277",77,56,56,0,0,"PUM+J",0
19,"19087",17,14,14,0,0,"PUM+J",4
50,"50259",84,58,58,0,0,"PUM+J",0
34,"34031",26,24,24,0,0,"PUM+J",0
49,"49029",614,497,488,9,9,"PUM+J",4
40,"40168",28,22,22,0,0,"PUM+J",0
42,"42207",47,41,41,0,0,"PUM+J",0
29,"29092",579,434,426,5,8,"PUM+J",0
32,"32013",2017,1388,1380,5,8,"PUM+J",1
45,"45080",3,3,3,0,0,"PUM+J",0
9,"9149",34,27,27,0,0,"PUM+J",0
26,"26140",239,199,194,1,5,"PUM+J",0
9,"9315",393,291,286,4,5,"PUM+J",1
42,"42070",32,24,24,0,0,"PUM+J",0
19,"19228",29,22,22,0,0,"PUM+J",1
37,"37042",41,32,31,1,1,"PUM+J",0
26,"26062",86,74,72,1,2,"PUM+J",0
49,"49190",50,45,45,1,0,"PUM+J",0
45,"45081",19138,15010,14829,110,181,"PUM+J",37
31,"31008",63,51,49,1,2,"PUM+J",0
40,"40203",958,801,788,6,13,"PUM+J",0
16,"16141",130,105,105,0,0,"PUM+J",0
16,"16186",412,358,354,1,4,"PUM+J",0
24,"24028",365,297,290,2,7,"PUM+J",0
42,"42209",135,107,100,5,7,"PUM+J",1
4,"4074",2887,2062,2038,16,24,"PUM+J",1
9,"9316",108,89,89,0,0,"PUM+J",0
9,"9485",56,50,50,2,0,"PUM+J",0
20,"20021",186,112,112,0,0,"PUM+J",0
39,"39042",5930,4722,4676,26,46,"PUM+J",7
26,"26063",118,96,95,2,1,"PUM+J",1
34,"34174",178,150,149,2,1,"PUM+J",0
48,"48047",149,115,115,1,0,"PUM+J",0
31,"31050",6002,4111,4061,58,50,"PUM+J",11
33,"33007",1398,960,951,9,9,"PUM+J",2
50,"50290",358,272,266,6,6,"PUM+J",0
40,"40063",6944,5479,5352,39,127,"PUM+J",8
34,"34126",254,220,219,3,1,"PUM+J",0
40,"40136",106,82,81,0,1,"PUM+J",1
22,"22227",199,155,154,1,1,"PUM+J",0
31,"31213",100,69,68,0,1,"PUM+J",2
12,"12067",523,423,416,1,7,"PUM+J",0
24,"24030",4201,3080,3024,25,56,"PUM+J",3
5,"5207",645,543,540,3,3,"PUM+J",1
44,"44228",99,83,83,0,0,"PUM+J",0
26,"26064",2337,1764,1724,14,40,"PUM+J",4
29,"29096",2756,2061,2018,21,43,"PUM+J",0
39,"39044",3868,3019,2985,8,34,"PUM+J",2
45,"45085",1511,1141,1128,9,13,"PUM+J",3
28,"28096",19809,15584,15392,118,192,"PUM+J",17
41,"41085",4170,3337,3270,27,67,"PUM+J",7
9,"9001",30,27,27,0,0,"PUM+J",0
38,"38010",3974,2814,2777,20,37,"PUM+J",0
49,"49034",417,320,317,0,3,"PUM+J",0
31,"31174",107,70,70,0,0,"PUM+J",0
9,"9321",1597,1293,1280,4,13,"PUM+J",7
18,"18068",1606,1293,1277,11,16,"PUM+J",1
23,"23065",1550,1199,1186,4,13,"PUM+J",0
29,"29097",4168,3086,3009,37,77,"PUM+J",1
9,"9054",89,69,68,1,1,"PUM+J",0
20,"20054",459,313,312,1,1,"PUM+J",0
7,"7013",7231,5372,5253,43,119,"PUM+J",4
14,"14003",1258,989,968,12,21,"PUM+J",0
40,"40103",146,125,123,0,2,"PUM+J",1
22,"22142",94,80,80,2,0,"PUM+J",0
9,"9323",59,41,41,2,0,"PUM+J",0
37,"37011",99,75,73,0,2,"PUM+J",0
31,"31257",903,690,679,6,11,"PUM+J",1
18,"18036",3970,3197,3149,26,48,"PUM+J",5
44,"44231",36,33,32,0,1,"PUM+J",0
19,"19097",14,13,13,0,0,"PUM+J",0
49,"49241",240,199,199,1,0,"PUM+J",0
9,"9162",132,102,102,1,0,"PUM+J",1
26,"26030",17,17,17,0,0,"PUM+J",0
24,"24073",442,328,324,2,4,"PUM+J",2
37,"37096",203,162,160,1,2,"PUM+J",0
9,"9163",578,490,481,5,9,"PUM+J",0
19,"19098",18,18,17,0,1,"PUM+J",0
26,"26068",79,62,62,1,0,"PUM+J",0
23,"23902",2229,1843,1820,7,23,"PUM+J",0
40,"40210",98,70,70,0,0,"PUM+J",0
24,"24113",351,277,272,2,5,"PUM+J",1
5,"5095",236,193,191,0,2,"PUM+J",0
19,"19099",289,217,214,0,3,"PUM+J",1
2,"2004",606,504,499,5,5,"PUM+J",0
31,"31056",185,141,134,3,7,"PUM+J",2
40,"40034",75,63,62,1,1,"PUM+J",0
44,"44203",9,9,9,0,0,"PUM+J",0
29,"29100",2378,1711,1686,22,25,"PUM+J",2
49,"49038",94,68,68,1,0,"PUM+J",0
44,"44232",368,284,273,2,11,"PUM+J",0
42,"42081",136,95,93,0,2,"PUM+J",0
9,"9907",1507,1198,1174,16,24,"PUM+J",3
4,"4080",199,158,157,0,1,"PUM+J",0
47,"47223",152,123,120,2,3,"PUM+J",0
9,"9328",74,51,50,0,1,"PUM+J",1
2,"2005",545,443,436,5,7,"PUM+J",1
37,"37137",99,65,65,0,0,"PUM+J",1
18,"18038",1047,810,787,4,23,"PUM+J",1
49,"49002",58,49,43,0,6,"PUM+J",0
49,"49244",49,32,32,1,0,"PUM+J",0
37,"37325",90,70,70,0,0,"PUM+J",0
16,"16107",98,76,75,1,1,"PUM+J",0
40,"40143",83,73,73,2,0,"PUM+J",1
6,"6050",4042,3246,3163,27,83,"PUM+J",2
23,"23039",2154,1644,1605,6,39,"PUM+J",2
9,"9329",117,90,89,8,1,"PUM+J",0
47,"47130",99,76,76,2,0,"PUM+J",0
31,"31180",197,155,154,2,1,"PUM+J",1
18,"18072",664,481,473,0,8,"PUM+J",1
49,"49245",253,183,182,2,1,"PUM+J",1
12,"12040",118683,91285,90499,666,786,"PUM+J",82
23,"23040",1443,1164,1149,3,15,"PUM+J",0
38,"38016",1178,654,648,6,6,"PUM+J",0
31,"31019",1808,1392,1378,18,14,"PUM+J",2
37,"37176",130,103,103,1,0,"PUM+J",0
44,"44143",394,327,327,2,0,"PUM+J",0
50,"50183",319,242,241,4,1,"PUM+J",0
39,"39049",306,209,208,4,1,"PUM+J",0
29,"29903",493,358,354,6,4,"PUM+J",1
49,"49163",215,151,148,1,3,"PUM+J",0
34,"34236",147,111,111,0,0,"PUM+J",1
47,"47098",556,480,475,4,5,"PUM+J",1
14,"14069",7376,5511,5398,47,113,"PUM+J",7
18,"18076",790,607,604,1,3,"PUM+J",0
6,"6151",1054,791,778,2,13,"PUM+J",1
24,"24160",645,481,475,1,6,"PUM+J",2
16,"16066",2298,1932,1885,17,47,"PUM+J",2
5,"5100",267,217,212,1,5,"PUM+J",0
45,"45095",660,528,519,3,9,"PUM+J",0
23,"23072",1885,1485,1468,5,17,"PUM+J",1
47,"47226",149,124,123,0,1,"PUM+J",0
31,"31062",1075,870,861,10,9,"PUM+J",2
4,"4008",464,386,383,4,3,"PUM+J",0
19,"19286",742,610,603,4,7,"PUM+J",1
34,"34047",1738,1439,1420,8,19,"PUM+J",0
22,"22199",6926,5113,5051,44,62,"PUM+J",5
31,"31184",65,48,46,0,2,"PUM+J",0
49,"49165",55,53,50,0,3,"PUM+J",0
31,"31183",713,569,555,6,14,"PUM+J",2
48,"48056",989,791,785,4,6,"PUM+J",0
49,"49206",794,584,570,7,14,"PUM+J",1
18,"18077",471,372,366,5,6,"PUM+J",0
37,"37291",269,212,209,2,3,"PUM+J",0
32,"32024",4835,3484,3439,23,45,"PUM+J",3
47,"47195",430,335,320,2,15,"PUM+J",0
12,"12043",560,460,450,2,10,"PUM+J",2
37,"37292",94,76,73,1,3,"PUM+J",0
16,"16155",488,411,408,3,3,"PUM+J",0
18,"18043",130,93,93,0,0,"PUM+J",0
24,"24162",1772,1382,1369,22,13,"PUM+J",3
18,"18182",1917,1391,1381,7,10,"PUM+J",1
9,"9173",129,102,102,0,0,"PUM+J",1
18,"18114",591,443,437,2,6,"PUM+J",1
31,"31064",1387,1174,1163,9,11,"PUM+J",1
2,"2011",578,461,459,2,2,"PUM+J",0
22,"22201",266,192,192,2,0,"PUM+J",0
45,"45099",3635,2741,2684,23,57,"PUM+J",1
45,"45007",665,549,533,0,16,"PUM+J",2
37,"37369",125,95,93,0,2,"PUM+J",1
12,"12044",452,403,400,4,3,"PUM+J",0
16,"16202",741,573,568,4,5,"PUM+J",0
50,"50012",96,79,79,1,0,"PUM+J",0
47,"47010",14572,12316,12186,102,130,"PUM+J",13
40,"40077",932,747,730,9,17,"PUM+J",0
45,"45192",2412,2103,2068,7,35,"PUM+J",3
48,"48088",133,99,98,2,1,"PUM+J",0
5,"5104",33,24,23,0,1,"PUM+J",0
31,"31187",101,68,68,1,0,"PUM+J",0
44,"44047",229,125,124,2,1,"PUM+J",1
34,"34192",82,68,68,0,0,"PUM+J",1
40,"40149",486,383,376,3,7,"PUM+J",1
22,"22202",145,127,126,0,1,"PUM+J",0
20,"20033",854,675,671,5,4,"PUM+J",0
6,"6156",1171,919,901,10,18,"PUM+J",2
20,"20064",12436,8730,8652,59,78,"PUM+J",11
16,"16072",133,96,95,1,1,"PUM+J",0
40,"40044",139,105,103,2,2,"PUM+J",0
19,"19291",1131,875,864,1,11,"PUM+J",2
49,"49048",114,85,85,0,0,"PUM+J",0
49,"49169",34,28,26,0,2,"PUM+J",0
5,"5106",28,22,22,0,0,"PUM+J",0
32,"32026",2659,1988,1957,26,31,"PUM+J",1
24,"24166",1359,1038,1011,11,27,"PUM+J",3
26,"26078",86,71,70,1,1,"PUM+J",0
12,"12107",351,312,306,1,6,"PUM+J",1
37,"37023",1586,1316,1298,12,18,"PUM+J",1
22,"22074",275,223,221,10,2,"PUM+J",0
28,"28143",77,62,62,0,0,"PUM+J",0
16,"16117",1022,822,809,6,13,"PUM+J",1
20,"20034",3154,2336,2315,20,21,"PUM+J",2
16,"16205",107,80,79,0,1,"PUM+J",0
34,"34199",1159,910,880,7,30,"PUM+J",2
9,"9070",33,28,25,0,3,"PUM+J",0
41,"41012",3368,2416,2361,23,55,"PUM+J",3
4,"4091",326,267,266,3,1,"PUM+J",0
31,"31190",45,41,41,4,0,"PUM+J",0
37,"37298",172,126,125,0,1,"PUM+J",0
42,"42013",37,29,29,0,0,"PUM+J",0
9,"9346",89,69,68,1,1,"PUM+J",0
9,"9023",1178,982,966,14,16,"PUM+J",4
14,"14046",4443,3550,3486,38,64,"PUM+J",1
18,"18188",1648,1295,1276,4,19,"PUM+J",1
50,"50043",246,172,170,2,2,"PUM+J",0
45,"45013",1671,1320,1298,4,22,"PUM+J",1
42,"42094",603,484,475,10,9,"PUM+J",2
29,"29021",159,121,120,0,1,"PUM+J",0
2,"2016",538,405,401,4,4,"PUM+J",0
28,"28145",2640,2014,1987,11,27,"PUM+J",4
7,"7027",22047,14986,14853,139,133,"PUM+J",24
50,"50275",110,55,55,0,0,"PUM+J",0
48,"48031",308,236,236,0,0,"PUM+J",0
16,"16079",26,17,17,0,0,"PUM+J",0
19,"19251",39,31,31,0,0,"PUM+J",0
16,"16161",52,47,47,0,0,"PUM+J",1
19,"19116",12,9,9,1,0,"PUM+J",0
50,"50016",44,31,31,0,0,"PUM+J",0
41,"41014",2486,1939,1878,6,61,"PUM+J",0
47,"47203",58,48,48,0,0,"PUM+J",0
48,"48062",293,247,245,0,2,"PUM+J",0
9,"9180",133,104,99,1,5,"PUM+J",0
33,"33023",3271,2448,2397,35,51,"PUM+J",3
24,"24051",394,290,283,3,7,"PUM+J",0
34,"34057",462,345,330,3,15,"PUM+J",1
16,"16211",322,233,229,0,4,"PUM+J",0
5,"5227",340,237,234,0,3,"PUM+J",0
31,"31072",5320,4046,3958,40,88,"PUM+J",10
26,"26083",354,295,291,1,4,"PUM+J",0
47,"47109",171,130,130,1,0,"PUM+J",0
34,"34011",386,326,321,2,5,"PUM+J",0
49,"49174",130,93,91,0,2,"PUM+J",0
40,"40048",35,29,29,0,0,"PUM+J",0
9,"9182",76,65,64,0,1,"PUM+J",0
45,"45108",482,385,382,0,3,"PUM+J",0
2,"2055",1057,770,755,6,15,"PUM+J",2
32,"32031",1014,764,756,5,8,"PUM+J",0
41,"41016",7767,5937,5829,56,108,"PUM+J",4
22,"22079",114,89,88,1,1,"PUM+J",0
28,"28040",16648,11709,11551,66,158,"PUM+J",12
42,"42149",387,311,308,3,3,"PUM+J",2
44,"44184",38,28,26,0,2,"PUM+J",0
24,"24172",415,240,237,1,3,"PUM+J",0
19,"19213",70,53,52,0,1,"PUM+J",1
42,"42055",165,124,122,2,2,"PUM+J",1
31,"31195",171,125,125,2,0,"PUM+J",0
34,"34206",814,668,660,13,8,"PUM+J",0
42,"42098",9,8,8,0,0,"PUM+J",0
5,"5229",82,67,67,1,0,"PUM+J",0
38,"38027",5545,3937,3896,22,41,"PUM+J",1
40,"40123",141,108,104,1,4,"PUM+J",0
37,"37303",181,137,137,1,0,"PUM+J",0
29,"29026",1010,747,736,3,11,"PUM+J",0
40,"40157",43,33,33,2,0,"PUM+J",0
9,"9030",119,90,89,1,1,"PUM+J",0
22,"22080",264,208,202,2,6,"PUM+J",0
12,"12052",539,453,439,5,14,"PUM+J",0
9,"9410",2999,2175,2135,27,40,"PUM+J",8
48,"48035",404,334,331,2,3,"PUM+J",0
24,"24216",671,504,502,3,2,"PUM+J",1
6,"6901",2117,1686,1655,17,31,"PUM+J",0
28,"28149",6172,5089,5038,31,51,"PUM+J",5
40,"40052",72,56,56,0,0,"PUM+J",0
2,"2058",313,218,214,1,4,"PUM+J",0
37,"37072",145,136,134,3,2,"PUM+J",0
39,"39060",6693,5459,5394,29,65,"PUM+J",4
4,"4098",1455,1097,1087,9,10,"PUM+J",1
47,"47018",36,31,29,0,2,"PUM+J",1
24,"24175",1831,1433,1412,17,21,"PUM+J",3
22,"22213",2923,2261,2221,24,40,"PUM+J",7
9,"9189",126,102,96,0,6,"PUM+J",0
37,"37192",355,234,227,5,7,"PUM+J",0
29,"29027",2309,1716,1692,18,24,"PUM+J",0
18,"18089",14540,10725,10583,65,142,"PUM+J",12
35,"35003",5582,3441,3391,26,50,"PUM+J",2
24,"24055",676,513,508,6,5,"PUM+J",1
18,"18022",13804,9877,9714,92,163,"PUM+J",13
39,"39061",3488,2833,2798,18,35,"PUM+J",4
50,"50108",52,43,42,0,1,"PUM+J",0
19,"19259",28,24,24,0,0,"PUM+J",0
37,"37118",120,93,90,2,3,"PUM+J",0
31,"31241",125,100,100,2,0,"PUM+J",0
20,"20042",3172,2247,2231,9,16,"PUM+J",1
4,"4023",120,95,95,2,0,"PUM+J",0
42,"42106",14,12,12,0,0,"PUM+J",0
22,"22126",87,66,66,0,0,"PUM+J",0
50,"50297",502835,394653,391387,3269,3266,"PUM+J",586
5,"5117",193,169,167,0,2,"PUM+J",0
38,"38030",1945,1430,1420,6,10,"PUM+J",1
7,"7001",3628,2792,2753,18,39,"PUM+J",2
40,"40126",67,53,51,0,2,"PUM+J",0
41,"41076",2143,1419,1403,14,16,"PUM+J",0
19,"19076",19,18,18,0,0,"PUM+J",0
9,"9303",75,67,67,0,0,"PUM+J",0
16,"16005",232,175,172,0,3,"PUM+J",0
34,"34109",63,42,41,0,1,"PUM+J",0
45,"45024",1043,832,821,5,11,"PUM+J",0
6,"6034",167,115,115,1,0,"PUM+J",0
19,"19024",8525,6587,6485,33,102,"PUM+J",8
40,"40055",32,26,25,0,1,"PUM+J",0
48,"48069",13094,10021,9954,49,67,"PUM+J",12
4,"4101",4375,3161,3112,34,49,"PUM+J",3
28,"28045",35264,27864,27597,180,267,"PUM+J",47
40,"40161",35,28,26,0,2,"PUM+J",0
6,"6134",530,337,331,3,6,"PUM+J",1
34,"34160",134,114,112,0,2,"PUM+J",0
42,"42061",272,207,204,2,3,"PUM+J",0
31,"31162",48,34,33,1,1,"PUM+J",1
4,"4102",14110,9871,9765,90,106,"PUM+J",10
34,"34067",129,87,87,0,0,"PUM+J",0
5,"5119",24,16,16,1,0,"PUM+J",0
5,"5041",995,776,767,3,9,"PUM+J",0
24,"24179",299,239,238,3,1,"PUM+J",0
9,"9361",112,94,94,1,0,"PUM+J",1
9,"9196",135,108,107,0,1,"PUM+J",0
18,"18128",342,274,272,1,2,"PUM+J",0
47,"47116",403,321,320,3,1,"PUM+J",0
6,"6069",3005,2172,2133,24,39,"PUM+J",0
22,"22050",93,79,79,2,0,"PUM+J",0
23,"23026",3450,2625,2573,17,52,"PUM+J",3
49,"49184",170,122,121,0,1,"PUM+J",0
31,"31082",623,433,433,3,0,"PUM+J",1
7,"7004",4033,2898,2860,28,38,"PUM+J",1
37,"37080",212,173,169,0,4,"PUM+J",0
4,"4901",494,381,378,0,3,"PUM+J",0
44,"44061",75,66,65,2,1,"PUM+J",1
9,"9086",661,521,518,5,3,"PUM+J",0
18,"18027",2604,1902,1887,6,15,"PUM+J",0
47,"47117",286,240,235,0,5,"PUM+J",0
16,"16008",83,65,65,0,0,"PUM+J",0
24,"24224",574,435,427,3,8,"PUM+J",0
45,"45165",62598,47784,47120,345,664,"PUM+J",82
9,"9041",26,26,26,1,0,"PUM+J",0
50,"50082",84,63,63,0,0,"PUM+J",0
34,"34070",135,101,101,1,0,"PUM+J",0
40,"40058",309,277,271,0,6,"PUM+J",1
26,"26057",51,47,47,1,0,"PUM+J",0
42,"42065",23,18,18,2,0,"PUM+J",0
20,"20046",1248,918,909,11,9,"PUM+J",0
29,"29066",346,266,266,2,0,"PUM+J",1
47,"47118",149,111,108,1,3,"PUM+J",1
23,"23059",5728,4259,4187,18,72,"PUM+J",3
9,"9090",50,45,45,2,0,"PUM+J",0
33,"33033",9439,6565,6468,78,97,"PUM+J",9
12,"12091",176,131,130,0,1,"PUM+J",0
40,"40165",74,56,54,1,2,"PUM+J",1
34,"34220",149,133,132,0,1,"PUM+J",0
44,"44161",430,320,316,1,4,"PUM+J",0
29,"29034",467,374,373,1,1,"PUM+J",1
50,"50114",132,111,111,1,0,"PUM+J",0
4,"4903",4308,3102,3075,17,27,"PUM+J",0
34,"34221",170,138,136,2,2,"PUM+J",0
41,"41097",3135,2355,2308,11,47,"PUM+J",1
9,"9091",701,545,533,5,12,"PUM+J",0
37,"37314",82,72,68,0,4,"PUM+J",0
47,"47025",114,98,98,0,0,"PUM+J",0
9,"9200",58,40,40,0,0,"PUM+J",0
47,"47088",105,90,90,0,0,"PUM+J",0
31,"31208",2562,2067,2036,16,31,"PUM+J",4
50,"50027",224,170,165,1,5,"PUM+J",0
7,"7007",414,326,324,2,2,"PUM+J",0
39,"39068",649,515,509,7,6,"PUM+J",0
45,"45170",199,154,150,1,4,"PUM+J",0
32,"32040",1418,1083,1075,3,8,"PUM+J",1
16,"16236",865,669,665,2,4,"PUM+J",0
18,"18908",784,599,581,0,18,"PUM+J",0
5,"5125",56,47,43,0,4,"PUM+J",0
32,"32041",759,510,502,2,8,"PUM+J",0
49,"49112",118,78,78,2,0,"PUM+J",0
49,"49189",192,132,128,1,4,"PUM+J",1
41,"41099",3968,2666,2642,23,24,"PUM+J",4
19,"19135",93,76,72,0,4,"PUM+J",0
37,"37354",5467,3960,3910,31,50,"PUM+J",4
16,"16237",98,83,83,0,0,"PUM+J",0
14,"14029",4029,3089,3039,15,50,"PUM+J",4
20,"20050",270,186,183,3,3,"PUM+J",0
16,"16097",139,121,120,1,1,"PUM+J",0
28,"28052",3949,2890,2818,8,72,"PUM+J",2
9,"9047",54,46,45,0,1,"PUM+J",0
45,"45126",239,173,168,0,5,"PUM+J",0
23,"23096",2571,2099,2063,9,36,"PUM+J",2
42,"42165",419,288,285,8,3,"PUM+J",1
50,"50146",190,152,149,0,3,"PUM+J",0
49,"49236",70,55,55,0,0,"PUM+J",0
44,"44103",123,101,100,1,1,"PUM+J",0
50,"50147",751,564,559,3,5,"PUM+J",0
37,"37243",90,71,70,0,1,"PUM+J",0
50,"50204",2394,1876,1855,21,21,"PUM+J",1
22,"22094",98,72,71,2,1,"PUM+J",0
41,"41100",967,765,727,8,38,"PUM+J",0
26,"26102",6057,4672,4579,37,93,"PUM+J",3
28,"28053",6840,5797,5739,32,58,"PUM+J",8
16,"16099",184,126,121,0,5,"PUM+J",0
6,"6076",824,631,620,0,11,"PUM+J",1
9,"9209",4419,3407,3338,37,69,"PUM+J",11
45,"45129",109,84,83,0,1,"PUM+J",0
12,"12002",115,99,97,0,2,"PUM+J",0
7,"7011",28642,19567,19396,147,171,"PUM+J",27
50,"50205",74,58,57,0,1,"PUM+J",0
12,"12095",950,763,756,9,7,"PUM+J",0
37,"37046",10749,8133,7989,84,144,"PUM+J",14
9,"9375",42,38,38,0,0,"PUM+J",0
9,"9100",58,46,46,0,0,"PUM+J",0
40,"40101",923,737,728,8,9,"PUM+J",0
40,"40172",45,37,37,0,0,"PUM+J",0
5,"5129",116,82,76,1,6,"PUM+J",0
38,"38040",5446,3513,3462,13,51,"PUM+J",4
41,"41102",14750,10972,10677,110,295,"PUM+J",13
37,"37320",88,67,67,1,0,"PUM+J",0
26,"26104",11,9,9,0,0,"PUM+J",0
16,"16100",640,570,565,1,5,"PUM+J",2
47,"47219",40,38,34,0,4,"PUM+J",0
48,"48912",2331,1843,1833,7,10,"PUM+J",1
24,"24190",146,109,109,1,0,"PUM+J",0
49,"49194",340,236,233,3,3,"PUM+J",0
14,"14063",1000,767,757,4,10,"PUM+J",1
5,"5246",52,39,39,0,0,"PUM+J",0
44,"44264",248,175,171,0,4,"PUM+J",0
47,"47031",196,155,155,3,0,"PUM+J",0
41,"41901",2703,2242,2201,29,41,"PUM+J",0
9,"9003",184,143,142,2,1,"PUM+J",0
19,"19278",24,24,24,0,0,"PUM+J",0
9,"9430",22,20,20,0,0,"PUM+J",0
31,"31013",626,427,422,5,5,"PUM+J",1
42,"42035",741,537,523,7,14,"PUM+J",2
49,"49117",437,340,335,1,5,"PUM+J",0
9,"9265",47,38,36,2,2,"PUM+J",0
16,"16018",381,313,312,2,1,"PUM+J",0
32,"32045",2360,1712,1689,18,23,"PUM+J",0
22,"22229",108,80,80,2,0,"PUM+J",0
7,"7014",7778,4724,4669,50,55,"PUM+J",13
41,"41902",4600,3141,3092,48,49,"PUM+J",2
42,"42124",58,41,41,0,0,"PUM+J",0
37,"37284",314,241,237,2,4,"PUM+J",1
28,"28132",12068,9067,8954,63,113,"PUM+J",24
33,"33010",1724,1211,1202,15,9,"PUM+J",0
37,"37247",173,144,143,1,1,"PUM+J",0
31,"31136",452,337,333,5,4,"PUM+J",2
49,"49199",241,174,171,4,3,"PUM+J",0
34,"34083",1664,1244,1229,10,15,"PUM+J",1
20,"20055",17378,12565,12482,55,83,"PUM+J",7
34,"34179",26,20,19,0,1,"PUM+J",0
4,"4079",54086,38415,38134,239,281,"PUM+J",41
49,"49158",203,163,155,0,8,"PUM+J",0
49,"49242",444,364,359,3,5,"PUM+J",1
50,"50152",1368,1061,1043,6,18,"PUM+J",0
45,"45135",4173,3402,3349,18,53,"PUM+J",3
16,"16246",452,348,340,1,8,"PUM+J",0
28,"28133",6116,4581,4486,22,95,"PUM+J",7
6,"6015",117934,87081,86114,785,967,"PUM+J",114
47,"47034",72,57,57,1,0,"PUM+J",0
5,"5134",49,41,40,0,1,"PUM+J",0
4,"4003",17540,12174,12051,75,123,"PUM+J",5
20,"20057",194,143,143,0,0,"PUM+J",0
9,"9057",148,120,116,0,4,"PUM+J",0
37,"37211",212,164,163,1,1,"PUM+J",0
5,"5056",94,83,83,0,0,"PUM+J",0
2,"2078",899,705,691,3,14,"PUM+J",0
41,"41033",4965,3634,3580,27,54,"PUM+J",4
19,"19150",126,102,100,0,2,"PUM+J",0
49,"49201",285,243,243,7,0,"PUM+J",0
37,"37287",309,215,214,3,1,"PUM+J",0
19,"19103",251,218,216,1,2,"PUM+J",0
50,"50153",922,705,704,6,1,"PUM+J",0
42,"42175",21,15,15,0,0,"PUM+J",0
9,"9386",55,49,49,0,0,"PUM+J",1
44,"44268",32,30,30,0,0,"PUM+J",0
50,"50295",49,46,46,0,0,"PUM+J",0
24,"24077",215,178,178,0,0,"PUM+J",0
9,"9110",77,57,57,0,0,"PUM+J",0
24,"24078",336,259,255,0,4,"PUM+J",1
37,"37138",219,180,176,1,4,"PUM+J",0
42,"42219",40,33,32,1,1,"PUM+J",0
47,"47162",68,55,55,0,0,"PUM+J",0
24,"24199",405,302,297,3,5,"PUM+J",0
31,"31181",134,94,93,1,1,"PUM+J",0
9,"9060",128,111,111,1,0,"PUM+J",0
19,"19284",10,9,9,1,0,"PUM+J",0
32,"32049",689,468,462,3,6,"PUM+J",0
29,"29046",2540,1896,1855,13,41,"PUM+J",0
42,"42130",51,46,45,0,1,"PUM+J",0
45,"45048",355,277,271,1,6,"PUM+J",0
37,"37289",218,159,158,0,1,"PUM+J",0
42,"42131",52,37,37,0,0,"PUM+J",0
31,"31264",177,107,105,2,2,"PUM+J",0
44,"44174",409,306,300,3,6,"PUM+J",0
50,"50212",32,29,29,1,0,"PUM+J",0
19,"19002",57,45,45,0,0,"PUM+J",0
5,"5018",24,18,17,0,1,"PUM+J",0
16,"16110",91,80,80,0,0,"PUM+J",0
4,"4007",731,570,569,0,1,"PUM+J",0
26,"26112",223,177,174,0,3,"PUM+J",1
9,"9113",460,369,364,3,5,"PUM+J",0
45,"45187",3976,3365,3308,24,57,"PUM+J",4
42,"42006",152,115,112,2,3,"PUM+J",0
12,"12131",59,50,50,0,0,"PUM+J",0
42,"42178",101,75,75,0,0,"PUM+J",0
37,"37330",318,255,248,2,7,"PUM+J",1
42,"42132",135,114,113,1,1,"PUM+J",1
20,"20060",88,75,75,0,0,"PUM+J",0
28,"28062",288,243,236,0,7,"PUM+J",0
16,"16111",163,125,122,1,3,"PUM+J",0
47,"47133",2776,2317,2292,28,25,"PUM+J",4
37,"37255",42,31,31,2,0,"PUM+J",0
9,"9391",361,286,283,3,3,"PUM+J",0
5,"5021",1871,1469,1440,15,29,"PUM+J",1
29,"29049",2926,2197,2165,9,32,"PUM+J",0
24,"24081",122,91,88,0,3,"PUM+J",0
26,"26074",107,97,96,2,1,"PUM+J",0
5,"5141",95,82,82,0,0,"PUM+J",0
50,"50271",248,197,189,2,8,"PUM+J",0
50,"50011",116,100,99,0,1,"PUM+J",0
38,"38049",2683,1781,1743,18,38,"PUM+J",2
50,"50128",27,24,24,0,0,"PUM+J",0
18,"18112",110,80,76,0,4,"PUM+J",0
16,"16112",1468,1108,1096,6,12,"PUM+J",0
19,"19005",91,63,63,0,0,"PUM+J",0
7,"7022",11615,8055,7934,91,121,"PUM+J",11
9,"9226",56,47,47,0,0,"PUM+J",0
9,"9064",305,251,249,3,2,"PUM+J",1
29,"29072",3277,2628,2592,16,36,"PUM+J",0
19,"19200",64,56,56,0,0,"PUM+J",0
9,"9338",231,193,189,2,4,"PUM+J",0
34,"34242",93,66,64,1,2,"PUM+J",1
49,"49091",248,185,183,4,2,"PUM+J",0
42,"42009",77,69,69,2,0,"PUM+J",0
31,"31025",763,562,557,6,5,"PUM+J",2
5,"5023",175,158,155,2,3,"PUM+J",0
37,"37257",49,40,40,1,0,"PUM+J",0
19,"19157",56,40,37,0,3,"PUM+J",0
37,"37219",165,101,97,2,4,"PUM+J",0
7,"7023",3757,2777,2735,43,42,"PUM+J",7
33,"33049",6044,4152,4079,56,73,"PUM+J",6
50,"50040",86,71,71,0,0,"PUM+J",0
28,"28141",6246,4943,4890,44,53,"PUM+J",4
45,"45009",464,303,301,2,2,"PUM+J",0
5,"5025",82,70,70,0,0,"PUM+J",0
19,"19202",17,13,13,0,0,"PUM+J",0
47,"47137",31,23,23,0,0,"PUM+J",0
44,"44210",743,600,594,8,6,"PUM+J",2
5,"5262",323,254,254,0,0,"PUM+J",0
9,"9396",153,125,124,0,1,"PUM+J",0
31,"31230",95,79,79,0,0,"PUM+J",1
40,"40184",248,205,203,0,2,"PUM+J",0
45,"45010",389,280,280,3,0,"PUM+J",0
49,"49093",280,239,238,2,1,"PUM+J",0
5,"5183",123,104,96,0,8,"PUM+J",0
44,"44148",76,64,63,0,1,"PUM+J",0
33,"33051",6811,4879,4809,63,70,"PUM+J",5
45,"45057",224,188,184,0,4,"PUM+J",0
2,"2901",2185,1633,1613,9,20,"PUM+J",6
4,"4054",352,280,278,2,2,"PUM+J",0
37,"37222",86,64,62,0,2,"PUM+J",0
23,"23079",3639,2859,2818,20,41,"PUM+J",2
31,"31231",108,73,70,1,3,"PUM+J",0
24,"24007",753,569,563,4,6,"PUM+J",0
26,"26160",732,578,574,4,4,"PUM+J",0
45,"45149",539,448,440,0,8,"PUM+J",0
39,"39083",1074,786,777,4,9,"PUM+J",0
19,"19162",67,50,48,0,2,"PUM+J",0
45,"45196",1387,1099,1084,6,15,"PUM+J",2
5,"5027",260,217,211,3,6,"PUM+J",0
47,"47043",309,276,273,1,3,"PUM+J",0
2,"2052",466,394,394,3,0,"PUM+J",0
31,"31232",25574,19124,18913,236,211,"PUM+J",60
37,"37147",172,130,127,3,3,"PUM+J",0
19,"19061",53,45,45,0,0,"PUM+J",0
9,"9403",103,90,89,0,1,"PUM+J",1
38,"38901",1456,1024,1010,9,14,"PUM+J",1
26,"26121",30,21,21,1,0,"PUM+J",0
37,"37025",244,209,206,0,3,"PUM+J",0
45,"45197",1894,1525,1499,6,26,"PUM+J",0
47,"47140",110,91,90,0,1,"PUM+J",0
26,"26081",15,14,14,1,0,"PUM+J",0
47,"47044",323,282,279,1,3,"PUM+J",0
12,"12016",1550,1281,1260,11,21,"PUM+J",0
31,"31234",149,115,114,0,1,"PUM+J",0
26,"26008",1822,1436,1420,14,16,"PUM+J",3
22,"22004",124,90,88,1,2,"PUM+J",0
48,"48093",888,720,715,2,5,"PUM+J",0
5,"5030",43,36,36,0,0,"PUM+J",0
44,"44182",198,172,171,2,1,"PUM+J",0
28,"28069",56,47,45,2,2,"PUM+J",0
37,"37225",99,90,86,1,4,"PUM+J",0
23,"23081",1483,1137,1109,7,28,"PUM+J",1
39,"39001",2065,1669,1643,16,26,"PUM+J",0
9,"9406",246,203,200,4,3,"PUM+J",1
16,"16266",358,281,279,3,2,"PUM+J",1
49,"49097",74,43,43,0,0,"PUM+J",0
50,"50134",118,91,89,0,2,"PUM+J",0
2,"2018",796,693,682,5,11,"PUM+J",0
22,"22119",1256,963,954,5,9,"PUM+J",0
26,"26123",124,112,110,0,2,"PUM+J",0
49,"49098",204,157,153,2,4,"PUM+J",0
32,"32058",5225,3915,3857,35,58,"PUM+J",4
39,"39030",1895,1374,1358,6,16,"PUM+J",3
50,"50249",284,229,227,1,2,"PUM+J",0
18,"18121",130,104,103,3,1,"PUM+J",0
19,"19017",57,50,49,0,1,"PUM+J",0
9,"9075",103,87,87,1,0,"PUM+J",0
12,"12051",448,324,319,2,5,"PUM+J",0
49,"49136",312,227,220,3,7,"PUM+J",0
16,"16270",156,124,124,1,0,"PUM+J",0
16,"16083",45,29,28,0,1,"PUM+J",0
4,"4096",281,239,237,1,2,"PUM+J",0
5,"5901",253,173,171,1,2,"PUM+J",0
22,"22007",756,576,571,5,5,"PUM+J",1
39,"39003",258,205,202,3,3,"PUM+J",0
18,"18122",16001,11761,11556,110,205,"PUM+J",12
22,"22122",65,58,58,3,0,"PUM+J",0
6,"6129",573,455,451,2,4,"PUM+J",0
37,"37229",139,110,106,2,4,"PUM+J",0
19,"19301",37,31,31,0,0,"PUM+J",0
26,"26086",15,15,15,0,0,"PUM+J",0
4,"4061",622,501,494,4,7,"PUM+J",0
34,"34017",889,743,738,6,5,"PUM+J",1
42,"42056",28,25,24,0,1,"PUM+J",0
28,"28083",9665,7794,7737,56,57,"PUM+J",14
29,"29059",2643,2086,2042,8,44,"PUM+J",1
47,"47079",54,48,48,0,0,"PUM+J",0
47,"47144",75,63,63,1,0,"PUM+J",0
42,"42057",147,95,93,3,2,"PUM+J",0
26,"26013",323,258,256,1,2,"PUM+J",1
40,"40016",54,43,43,1,0,"PUM+J",0
24,"24217",133,106,105,1,1,"PUM+J",0
45,"45158",2546,2026,2001,9,25,"PUM+J",1
9,"9078",37,31,31,0,0,"PUM+J",0
19,"19171",5302,4297,4238,24,59,"PUM+J",4
29,"29060",671,511,506,1,5,"PUM+J",2
37,"37343",66,50,48,1,2,"PUM+J",2
9,"9242",66,53,53,1,0,"PUM+J",0
22,"22251",334,269,263,4,6,"PUM+J",0
48,"48097",1316,979,976,4,3,"PUM+J",0
19,"19216",130,100,99,1,1,"PUM+J",2
47,"47049",91,66,64,0,2,"PUM+J",0
50,"50167",215,181,179,1,2,"PUM+J",1
24,"24218",444,343,341,6,2,"PUM+J",1
23,"23087",11185,8500,8363,65,137,"PUM+J",8
16,"16004",227,193,191,0,2,"PUM+J",0
6,"6033",1269,1026,1010,4,16,"PUM+J",0
42,"42154",99,81,81,1,0,"PUM+J",0
32,"32062",766,582,579,1,3,"PUM+J",0
40,"40088",268,200,200,0,0,"PUM+J",1
48,"48007",385,281,279,1,2,"PUM+J",0
34,"34214",178,141,141,1,0,"PUM+J",0
49,"49180",138,95,95,0,0,"PUM+J",0
24,"24219",492,374,371,5,3,"PUM+J",1
12,"12115",208,170,167,1,3,"PUM+J",0
50,"50138",47,42,42,1,0,"PUM+J",0
47,"47020",272,228,225,5,3,"PUM+J",0
45,"45115",2586,2158,2114,8,44,"PUM+J",2
22,"22011",97,78,75,2,3,"PUM+J",0
23,"23088",6020,4779,4703,56,76,"PUM+J",1
37,"37382",164,135,134,0,1,"PUM+J",0
16,"16045",185,142,141,0,1,"PUM+J",0
5,"5079",68,56,56,0,0,"PUM+J",0
45,"45161",15266,11185,11023,69,162,"PUM+J",37
16,"16088",101,85,85,1,0,"PUM+J",0
42,"42022",206,161,161,1,0,"PUM+J",0
26,"26017",354,293,290,4,3,"PUM+J",2
12,"12116",67,57,57,0,0,"PUM+J",0
18,"18024",831,682,667,6,15,"PUM+J",0
40,"40196",32,28,28,1,0,"PUM+J",0
49,"49023",909,682,674,5,8,"PUM+J",3
50,"50109",98,69,67,3,2,"PUM+J",0
26,"26092",109,84,82,1,2,"PUM+J",0
49,"49183",93,73,71,2,2,"PUM+J",0
29,"29064",437,319,315,2,4,"PUM+J",0
28,"28154",5525,4283,4222,24,61,"PUM+J",3
37,"37235",219,170,166,4,4,"PUM+J",0
40,"40021",19,18,18,0,0,"PUM+J",0
31,"31244",156,95,94,5,1,"PUM+J",0
44,"44191",722,567,561,7,6,"PUM+J",1
22,"22128",192,155,154,2,1,"PUM+J",1
47,"47179",373,275,273,1,2,"PUM+J",0
20,"20075",4346,3158,3134,19,24,"PUM+J",5
32,"32065",630,478,474,5,4,"PUM+J",0
14,"14055",18446,13919,13711,148,208,"PUM+J",18
41,"41095",39970,27911,27583,389,328,"PUM+J",32
31,"31123",617,392,388,3,4,"PUM+J",0
24,"24100",754,602,598,7,4,"PUM+J",0
26,"26134",83,70,67,0,3,"PUM+J",0
37,"37236",127,90,86,0,4,"PUM+J",0
47,"47150",259,206,202,0,4,"PUM+J",0
2,"2065",443,373,370,0,3,"PUM+J",0
50,"50257",163,136,134,1,2,"PUM+J",0
19,"19081",27,19,19,0,0,"PUM+J",0
49,"49230",82,67,66,0,1,"PUM+J",1
24,"24143",495,388,380,2,8,"PUM+J",0
44,"44099",649,457,450,2,7,"PUM+J",0
2,"2064",374,318,315,3,3,"PUM+J",0
34,"34025",53,37,37,2,0,"PUM+J",0
47,"47024",232,189,188,0,1,"PUM+J",0
47,"47054",613,501,498,0,3,"PUM+J",0
44,"44193",69,57,56,1,1,"PUM+J",0
5,"5237",155,131,129,1,2,"PUM+J",1
29,"29033",1089,776,761,2,15,"PUM+J",1
37,"37238",106,88,87,1,1,"PUM+J",0
31,"31166",250,184,184,2,0,"PUM+J",0
18,"18028",907,766,756,0,10,"PUM+J",0
37,"37002",126,81,81,0,0,"PUM+J",0
44,"44223",73,58,58,0,0,"PUM+J",0
45,"45030",478,368,364,3,4,"PUM+J",1
16,"16010",137,104,101,0,3,"PUM+J",0
9,"9253",106,88,85,2,3,"PUM+J",0
19,"19034",23,23,22,0,1,"PUM+J",0
44,"44003",17,14,14,0,0,"PUM+J",0
45,"45168",62790,50868,50335,359,533,"PUM+J",93
49,"49110",345,222,220,2,2,"PUM+J",0
48,"48907",340,283,281,1,2,"PUM+J",0
45,"45031",2824,2104,2068,20,36,"PUM+J",1
22,"22904",761,581,566,2,15,"PUM+J",3
45,"45169",186,135,134,0,1,"PUM+J",0
24,"24103",264,162,161,1,1,"PUM+J",0
37,"37352",201,159,158,0,1,"PUM+J",0
16,"16011",23,18,18,0,0,"PUM+J",0
12,"12092",126,108,106,1,2,"PUM+J",0
23,"23095",8591,6634,6571,27,63,"PUM+J",2
47,"47056",83,71,71,0,0,"PUM+J",1
50,"50056",405,332,330,4,2,"PUM+J",1
12,"12029",673,566,556,3,10,"PUM+J",0
41,"41081",29840,22819,22465,228,354,"PUM+J",21
41,"41053",21618,16549,16150,194,399,"PUM+J",9
5,"5046",39,37,37,0,0,"PUM+J",0
16,"16902",127,101,101,0,0,"PUM+J",0
40,"40097",125,96,95,1,1,"PUM+J",0
9,"9094",51,46,45,0,1,"PUM+J",3
44,"44225",103,82,81,0,1,"PUM+J",0
39,"39096",670,523,518,2,5,"PUM+J",0
24,"24228",626,432,426,3,6,"PUM+J",0
49,"49151",593,453,444,5,9,"PUM+J",2
32,"32069",4256,3358,3309,39,49,"PUM+J",0
41,"41026",4300,3561,3521,18,40,"PUM+J",2
31,"31252",83,57,57,0,0,"PUM+J",0
19,"19184",62,45,45,0,0,"PUM+J",0
6,"6108",2249,1726,1684,22,42,"PUM+J",0
49,"49113",166,139,139,1,0,"PUM+J",0
42,"42030",89,72,72,0,0,"PUM+J",0
5,"5087",149,112,111,1,1,"PUM+J",0
22,"22055",310,258,255,2,3,"PUM+J",0
6,"6042",981,714,705,4,9,"PUM+J",0
16,"16014",563,444,443,4,1,"PUM+J",0
31,"31130",322,237,235,7,2,"PUM+J",1
40,"40905",128,101,100,4,1,"PUM+J",0
38,"38008",5658,4126,4056,19,70,"PUM+J",1
19,"19185",27,19,19,0,0,"PUM+J",0
4,"4034",165,107,106,1,1,"PUM+J",0
44,"44105",69,54,54,1,0,"PUM+J",0
9,"9259",227,198,197,2,1,"PUM+J",1
41,"41056",3694,3044,3009,36,35,"PUM+J",1
45,"45036",634,490,482,0,8,"PUM+J",0
47,"47059",97,75,75,0,0,"PUM+J",0
14,"14001",3443,2724,2675,24,49,"PUM+J",2
24,"24901",860,642,630,7,12,"PUM+J",0
33,"33068",1047,624,620,8,4,"PUM+J",0
18,"18173",8972,6594,6459,58,135,"PUM+J",5
47,"47155",3410,2694,2660,21,34,"PUM+J",5
20,"20052",1070,833,827,2,6,"PUM+J",0
28,"28161",51559,41390,40922,255,468,"PUM+J",43
47,"47029",50,43,43,1,0,"PUM+J",0
19,"19139",26,20,20,1,0,"PUM+J",0
45,"45175",614,512,504,3,8,"PUM+J",0
26,"26027",143,101,98,1,3,"PUM+J",0
40,"40205",229,185,180,1,5,"PUM+J",1
5,"5169",219,176,173,1,3,"PUM+J",0
18,"18034",486,376,374,4,2,"PUM+J",0
32,"32072",3687,2715,2682,22,33,"PUM+J",2
12,"12124",1840,1477,1460,8,17,"PUM+J",1
22,"22909",301,233,231,4,2,"PUM+J",1
44,"44229",143,110,108,4,2,"PUM+J",0
6,"6012",3233,2515,2492,15,23,"PUM+J",1
50,"50149",33,25,25,1,0,"PUM+J",0
5,"5052",87,77,77,0,0,"PUM+J",0
49,"49239",617,437,420,7,17,"PUM+J",0
34,"34176",127,106,104,2,2,"PUM+J",1
37,"37047",228,93,92,1,1,"PUM+J",0
12,"12068",41,26,25,1,1,"PUM+J",0
18,"18103",722,556,555,3,1,"PUM+J",0
9,"9903",3139,2379,2352,27,27,"PUM+J",4
44,"44230",152,112,111,1,1,"PUM+J",1
12,"12097",65,54,54,1,0,"PUM+J",0
26,"26105",2211,1744,1723,19,21,"PUM+J",0
31,"31012",771,571,564,5,7,"PUM+J",1
44,"44107",205,159,158,0,1,"PUM+J",1
32,"32073",1281,941,932,9,9,"PUM+J",0
5,"5171",67,57,51,1,6,"PUM+J",0
37,"37134",212,156,148,0,8,"PUM+J",0
31,"31258",7879,6189,6140,57,49,"PUM+J",29
48,"48019",3461,2647,2633,12,14,"PUM+J",1
6,"6113",2677,2117,2076,13,41,"PUM+J",3
9,"9104",47,39,39,0,0,"PUM+J",0
7,"7047",2371,1775,1747,13,28,"PUM+J",3
50,"50033",65,50,50,1,0,"PUM+J",1
31,"31095",72,61,60,0,1,"PUM+J",0
9,"9381",33,25,25,0,0,"PUM+J",0
12,"12037",17,17,17,1,0,"PUM+J",1
22,"22024",222,179,177,1,2,"PUM+J",0
37,"37135",1163,934,924,8,10,"PUM+J",0
5,"5249",96,69,69,0,0,"PUM+J",0
33,"33042",4243,3137,3103,36,34,"PUM+J",4
19,"19046",22148,17383,17137,125,246,"PUM+J",34
33,"33011",10659,6448,6332,119,116,"PUM+J",10
14,"14035",5817,4373,4314,44,59,"PUM+J",1
19,"19329",59,49,49,0,0,"PUM+J",0
34,"34131",58,51,51,0,0,"PUM+J",0
24,"24156",220,146,144,2,2,"PUM+J",0
49,"49120",53,39,39,0,0,"PUM+J",0
42,"42174",179,132,128,1,4,"PUM+J",0
9,"9268",88,71,71,0,0,"PUM+J",0
31,"31016",7752,6114,6064,47,50,"PUM+J",22
32,"32075",4382,3546,3489,35,57,"PUM+J",3
35,"35017",27216,17531,17102,133,429,"PUM+J",20
5,"5096",79,62,62,1,0,"PUM+J",0
31,"31220",742,620,615,2,5,"PUM+J",3
37,"37363",107,81,80,0,1,"PUM+J",0
18,"18145",10869,8532,8405,69,127,"PUM+J",4
32,"32076",1974,1492,1472,17,20,"PUM+J",1
47,"47160",392,317,314,2,3,"PUM+J",0
39,"39076",3483,2770,2734,21,36,"PUM+J",2
19,"19238",44,30,30,1,0,"PUM+J",0
24,"24158",296,226,220,2,6,"PUM+J",0
49,"49160",43,29,26,0,3,"PUM+J",0
23,"23005",29940,19587,19330,191,257,"PUM+J",20
16,"16150",94,75,75,1,0,"PUM+J",0
6,"6017",257,211,210,1,1,"PUM+J",0
26,"26070",155,133,132,0,1,"PUM+J",0
31,"31018",422,317,312,4,5,"PUM+J",0
28,"28102",891,681,666,4,15,"PUM+J",0
23,"23904",2604,1727,1701,7,26,"PUM+J",2
47,"47035",902,715,707,5,8,"PUM+J",2
22,"22195",234,193,192,0,1,"PUM+J",0
31,"31262",234,201,199,2,2,"PUM+J",1
16,"16195",458,368,364,3,4,"PUM+J",1
24,"24159",1746,1393,1368,6,25,"PUM+J",1
14,"14038",32692,24015,23679,213,336,"PUM+J",22
19,"19333",105,74,73,1,1,"PUM+J",0
40,"40212",27,22,20,0,2,"PUM+J",0
18,"18146",937,690,682,6,8,"PUM+J",0
2,"2007",1013,820,813,6,7,"PUM+J",0
16,"16065",372,306,305,2,1,"PUM+J",0
47,"47193",1609,1347,1332,9,15,"PUM+J",2
28,"28030",1815,1438,1395,10,43,"PUM+J",4
22,"22151",88,66,65,0,1,"PUM+J",0
2,"2081",18331,14219,13987,108,232,"PUM+J",6
33,"33076",12147,8532,8452,104,80,"PUM+J",6
37,"37140",642,422,418,2,4,"PUM+J",0
40,"40144",18,16,16,0,0,"PUM+J",0
50,"50155",90,70,69,0,1,"PUM+J",0
35,"35020",5933,4140,4088,14,52,"PUM+J",1
24,"24201",1039,775,765,5,10,"PUM+J",1
32,"32050",2280,1788,1775,19,13,"PUM+J",0
39,"39022",969,740,732,2,8,"PUM+J",0
24,"24080",207,162,161,0,1,"PUM+J",3
9,"9062",40,39,39,0,0,"PUM+J",0
42,"42043",3838,2897,2855,18,42,"PUM+J",5
45,"45188",2762,2144,2098,14,46,"PUM+J",0
34,"34136",149,105,102,0,3,"PUM+J",0
48,"48025",860,694,694,3,0,"PUM+J",0
45,"45189",616,506,498,2,8,"PUM+J",1
14,"14010",4001,3106,3068,15,38,"PUM+J",3
9,"9390",569,464,459,5,5,"PUM+J",2
37,"37103",414,309,309,4,0,"PUM+J",0
19,"19243",36,32,31,0,1,"PUM+J",0
6,"6120",3373,2757,2719,10,38,"PUM+J",4
40,"40111",52,44,44,0,0,"PUM+J",1
22,"22111",146,115,115,1,0,"PUM+J",0
50,"50156",209,174,171,1,3,"PUM+J",0
42,"42182",51,42,42,1,0,"PUM+J",0
19,"19199",19,17,16,0,1,"PUM+J",0
28,"28002",3281,2481,2455,24,26,"PUM+J",4
9,"9117",71,55,53,0,2,"PUM+J",0
7,"7055",7897,5264,5176,47,88,"PUM+J",3
22,"22156",296,246,242,3,4,"PUM+J",0
50,"50214",18,10,10,0,0,"PUM+J",0
49,"49249",63,52,52,1,0,"PUM+J",0
26,"26154",10,10,10,1,0,"PUM+J",0
20,"20001",257,174,172,1,2,"PUM+J",0
37,"37180",68,39,39,1,0,"PUM+J",0
35,"35022",51302,33009,32566,198,443,"PUM+J",28
37,"37218",48,29,29,0,0,"PUM+J",0
42,"42045",276,212,209,2,3,"PUM+J",0
24,"24004",494,408,403,7,5,"PUM+J",1
20,"20002",355,258,257,8,1,"PUM+J",0
28,"28034",370,284,280,0,4,"PUM+J",0
40,"40112",2772,2255,2223,21,32,"PUM+J",3
40,"40183",116,103,103,0,0,"PUM+J",0
16,"16031",36,25,25,0,0,"PUM+J",0
49,"49128",533,428,424,7,4,"PUM+J",1
42,"42048",60,50,50,0,0,"PUM+J",0
50,"50069",67,44,44,0,0,"PUM+J",0
28,"28172",9751,7994,7928,38,66,"PUM+J",10
4,"4052",12767,9352,9269,90,83,"PUM+J",11
22,"22037",112,96,96,0,0,"PUM+J",0
26,"26041",114,84,84,0,0,"PUM+J",0
44,"44147",398,293,286,3,7,"PUM+J",1
47,"47071",398,345,341,2,4,"PUM+J",0
31,"31066",812,636,628,10,8,"PUM+J",1
39,"39053",213,146,145,2,1,"PUM+J",0
37,"37022",245,200,196,2,4,"PUM+J",0
24,"24123",716,514,507,2,7,"PUM+J",0
40,"40008",45,37,37,0,0,"PUM+J",0
45,"45194",65,49,48,0,1,"PUM+J",0
44,"44117",319,263,256,5,7,"PUM+J",0
9,"9283",44,33,33,0,0,"PUM+J",0
47,"47198",66,47,47,0,0,"PUM+J",1
6,"6124",1656,1323,1296,5,27,"PUM+J",0
18,"18151",259,194,193,3,1,"PUM+J",0
18,"18116",2853,2265,2233,15,32,"PUM+J",2
39,"39082",1622,1261,1252,16,9,"PUM+J",0
5,"5145",47,27,27,1,0,"PUM+J",0
47,"47074",141,122,122,2,0,"PUM+J",0
29,"29075",12890,9033,8949,73,84,"PUM+J",7
20,"20004",227,156,154,4,2,"PUM+J",0
26,"26079",620,526,521,0,5,"PUM+J",1
45,"45103",362,306,299,0,7,"PUM+J",0
47,"47169",61,53,53,0,0,"PUM+J",0
31,"31907",11205,9216,9140,121,76,"PUM+J",38
12,"12048",249,181,175,2,6,"PUM+J",0
42,"42093",35,29,29,2,0,"PUM+J",0
26,"26161",8,7,7,0,0,"PUM+J",0
18,"18153",8796,6686,6594,59,92,"PUM+J",7
24,"24127",268,204,201,3,3,"PUM+J",0
20,"20005",1267,884,882,2,2,"PUM+J",0
16,"16206",196,146,144,3,2,"PUM+J",1
37,"37185",537,416,405,1,11,"PUM+J",1
22,"22163",419,363,361,1,2,"PUM+J",0
49,"49216",147,122,114,0,8,"PUM+J",0
24,"24009",278,154,151,2,3,"PUM+J",0
32,"32028",1550,1176,1171,10,5,"PUM+J",1
34,"34202",28,20,20,1,0,"PUM+J",0
40,"40221",48,42,42,0,0,"PUM+J",0
5,"5264",57,40,38,1,2,"PUM+J",0
22,"22041",152,121,119,2,2,"PUM+J",0
37,"37026",175,148,148,2,0,"PUM+J",0
31,"31152",1270,937,929,19,8,"PUM+J",2
45,"45060",158,118,118,0,0,"PUM+J",0
34,"34010",553,454,449,3,5,"PUM+J",0
28,"28008",1961,1477,1456,6,21,"PUM+J",0
20,"20006",254,169,169,0,0,"PUM+J",0
31,"31031",220,158,157,1,1,"PUM+J",0
16,"16162",39,31,30,0,1,"PUM+J",0
9,"9292",75,62,62,2,0,"PUM+J",0
5,"5265",79,59,59,0,0,"PUM+J",0
37,"37263",338,251,246,0,5,"PUM+J",0
12,"12050",1230,987,972,10,15,"PUM+J",0
42,"42053",21,15,15,0,0,"PUM+J",0
5,"5187",1728,1394,1364,7,30,"PUM+J",1
19,"19066",50,43,43,0,0,"PUM+J",0
6,"6028",4109,3613,3538,17,75,"PUM+J",3
34,"34151",147,99,97,1,2,"PUM+J",0
45,"45062",1074,888,867,4,21,"PUM+J",1
42,"42096",251,164,160,3,4,"PUM+J",0
18,"18157",1148,914,898,8,16,"PUM+J",1
44,"44215",168,121,120,1,1,"PUM+J",0
22,"22207",121,78,78,1,0,"PUM+J",1
42,"42097",14,7,7,0,0,"PUM+J",0
4,"4058",342,256,256,0,0,"PUM+J",0
24,"24012",285,204,202,2,2,"PUM+J",0
45,"45109",2786,2273,2206,9,67,"PUM+J",1
12,"12082",9573,7672,7570,55,102,"PUM+J",11
12,"12111",334,283,279,4,4,"PUM+J",0
37,"37115",110,81,81,2,0,"PUM+J",0
45,"45202",3982,3094,3055,8,39,"PUM+J",1
19,"19067",69,53,50,1,3,"PUM+J",0
40,"40224",19,16,16,0,0,"PUM+J",0
16,"16040",85,72,72,1,0,"PUM+J",0
24,"24014",7180,5189,5097,46,92,"PUM+J",4
32,"32003",889,667,654,3,13,"PUM+J",1
18,"18051",1090,800,795,13,5,"PUM+J",0
22,"22209",159,139,136,5,3,"PUM+J",0
34,"34015",39,32,31,0,1,"PUM+J",0
4,"4060",407,308,304,1,4,"PUM+J",1
28,"28179",1450,1115,1100,3,15,"PUM+J",2
19,"19257",3283,2448,2424,21,24,"PUM+J",4
23,"23018",2268,1738,1722,8,16,"PUM+J",1
24,"24054",417,318,311,0,7,"PUM+J",0
31,"31116",58,45,43,2,2,"PUM+J",2
24,"24133",356,267,267,4,0,"PUM+J",1
48,"48096",6510,5247,5185,36,62,"PUM+J",6
39,"39032",1426,1156,1141,8,15,"PUM+J",0
40,"40051",34,33,31,0,2,"PUM+J",0
34,"34155",120,104,103,0,1,"PUM+J",0
12,"12084",17723,13501,13281,118,220,"PUM+J",15
28,"28084",16103,12519,12378,82,141,"PUM+J",19
44,"44218",31,25,25,2,0,"PUM+J",0
42,"42194",146,111,111,0,0,"PUM+J",0
49,"49138",208,159,154,2,5,"PUM+J",0
40,"40228",494,397,391,5,6,"PUM+J",1
26,"26088",41,38,38,0,0,"PUM+J",0
9,"9301",648,545,536,7,9,"PUM+J",1
31,"31158",248,182,177,2,5,"PUM+J",0
48,"48036",24038,18180,18050,94,130,"PUM+J",30
26,"26050",130,97,97,0,0,"PUM+J",0
45,"45113",1797,1300,1281,6,19,"PUM+J",0
32,"32006",1434,1033,1019,8,14,"PUM+J",0
48,"48006",309,265,265,0,0,"PUM+J",0
6,"6131",1063,880,874,5,6,"PUM+J",1
28,"28012",918,727,711,6,16,"PUM+J",0
42,"42196",8,6,6,0,0,"PUM+J",0
47,"47208",56,37,37,0,0,"PUM+J",0
41,"41075",10279,7543,7370,96,173,"PUM+J",5
9,"9460",167,149,149,5,0,"PUM+J",0
23,"23020",1524,1363,1348,12,15,"PUM+J",2
24,"24096",108,69,69,0,0,"PUM+J",0
16,"16274",103,86,85,0,1,"PUM+J",0
19,"19022",571,443,434,7,9,"PUM+J",1
12,"12087",25,19,18,2,1,"PUM+J",0
6,"6133",1799,1476,1453,12,23,"PUM+J",1
32,"32007",1412,1011,1001,9,10,"PUM+J",1
49,"49103",394,343,339,3,4,"PUM+J",1
37,"37120",97,83,81,1,2,"PUM+J",0
49,"49021",14258,10333,10206,102,127,"PUM+J",11
29,"29085",138,100,98,0,2,"PUM+J",0
49,"49104",335,245,240,1,5,"PUM+J",0
20,"20073",4698,3530,3515,29,15,"PUM+J",0
9,"9246",609,449,441,2,8,"PUM+J",1
50,"50078",231,173,171,0,2,"PUM+J",0
28,"28075",5952,4797,4758,25,39,"PUM+J",7
9,"9036",37,33,32,3,1,"PUM+J",0
50,"50198",49,43,43,1,0,"PUM+J",0
19,"19219",9,7,7,0,0,"PUM+J",0
24,"24141",101,78,78,0,0,"PUM+J",0
31,"31161",345,286,279,4,7,"PUM+J",2
16,"16089",377,308,308,1,0,"PUM+J",0
37,"37035",165,134,134,0,0,"PUM+J",0
44,"44220",113,92,89,0,3,"PUM+J",0
19,"19175",30,19,19,1,0,"PUM+J",0
32,"32008",8572,6301,6216,65,85,"PUM+J",9
18,"18163",315,246,241,1,5,"PUM+J",0
5,"5080",44,31,29,0,2,"PUM+J",0
19,"19176",230,184,183,0,1,"PUM+J",0
9,"9307",112,87,86,0,1,"PUM+J",0
48,"48040",1309,979,973,5,6,"PUM+J",0
44,"44029",579,466,457,3,9,"PUM+J",0
5,"5235",139,106,101,0,5,"PUM+J",0
40,"40233",396,323,320,2,3,"PUM+J",0
42,"42200",76,54,53,0,1,"PUM+J",0
14,"14024",1859,1461,1418,10,43,"PUM+J",0
19,"19309",21,18,17,0,1,"PUM+J",0
31,"31163",2002,1507,1475,14,32,"PUM+J",5
44,"44222",122,102,102,1,0,"PUM+J",0
22,"22175",184,139,137,1,2,"PUM+J",0
45,"45074",401,335,326,3,9,"PUM+J",0
16,"16047",214,175,174,4,1,"PUM+J",0
34,"34024",25,17,16,1,1,"PUM+J",0
31,"31246",128,105,101,3,4,"PUM+J",0
37,"37349",103,69,68,0,1,"PUM+J",0
44,"44128",59,46,45,0,1,"PUM+J",0
20,"20076",7025,5263,5237,31,26,"PUM+J",1
16,"16174",168,143,141,1,2,"PUM+J",0
31,"31002",433,324,324,4,0,"PUM+J",0
48,"48905",2490,1911,1891,16,20,"PUM+J",2
19,"19032",146,102,101,2,1,"PUM+J",0
19,"19222",96,73,72,2,1,"PUM+J",0
37,"37038",751,607,592,4,15,"PUM+J",0
9,"9309",292,224,223,3,1,"PUM+J",0
42,"42161",135,104,104,0,0,"PUM+J",0
40,"40024",827,657,645,4,12,"PUM+J",0
40,"40199",101,79,78,0,1,"PUM+J",0
26,"26175",47,40,40,2,0,"PUM+J",0
19,"19223",101,66,66,1,0,"PUM+J",0
47,"47213",108,84,84,0,0,"PUM+J",1
22,"22221",90,58,56,0,2,"PUM+J",0
45,"45122",5516,4611,4561,28,50,"PUM+J",7
39,"39066",877,711,705,5,6,"PUM+J",0
24,"24063",355,261,261,2,0,"PUM+J",0
6,"6039",1807,1506,1474,13,32,"PUM+J",0
44,"44130",27,24,24,0,0,"PUM+J",1
18,"18168",781,613,604,6,9,"PUM+J",0
47,"47182",1335,1034,1022,6,12,"PUM+J",1
5,"5200",40,27,26,0,1,"PUM+J",0
49,"49068",435,287,286,1,1,"PUM+J",0
9,"9421",242,197,196,2,1,"PUM+J",1
39,"39095",2240,1809,1778,12,31,"PUM+J",0
49,"49149",365,285,282,2,3,"PUM+J",0
24,"24146",251,206,204,1,2,"PUM+J",0
23,"23029",806,651,637,0,14,"PUM+J",0
24,"24148",1616,1252,1237,11,15,"PUM+J",3
9,"9478",45,40,40,0,0,"PUM+J",0
12,"12061",380,277,274,2,3,"PUM+J",0
45,"45079",349,272,272,1,0,"PUM+J",0
40,"40060",68,46,46,0,0,"PUM+J",0
9,"9093",162,138,137,1,1,"PUM+J",1
9,"9312",89,75,74,2,1,"PUM+J",0
37,"37086",104,88,88,0,0,"PUM+J",0
38,"38006",41302,23632,23415,133,217,"PUM+J",67
22,"22054",1617,1196,1183,15,13,"PUM+J",6
7,"7008",6047,4570,4513,31,57,"PUM+J",5
37,"37202",989,838,828,7,10,"PUM+J",2
34,"34169",381,314,309,6,5,"PUM+J",0
49,"49150",123,90,90,3,0,"PUM+J",0
24,"24105",1498,1188,1177,18,11,"PUM+J",2
26,"26024",210,171,169,1,2,"PUM+J",0
33,"33005",1376,929,916,14,13,"PUM+J",0
16,"16185",35,29,29,0,0,"PUM+J",0
31,"31048",160,133,132,2,1,"PUM+J",0
47,"47089",132,116,115,1,1,"PUM+J",0
5,"5205",79,66,66,0,0,"PUM+J",0
50,"50203",1057,849,837,9,12,"PUM+J",2
44,"44005",46,31,31,1,0,"PUM+J",0
45,"45172",641,504,496,4,8,"PUM+J",0
24,"24229",388,312,307,2,5,"PUM+J",1
29,"29004",295,233,226,0,7,"PUM+J",0
19,"19039",59,56,55,1,1,"PUM+J",0
42,"42031",26,19,19,1,0,"PUM+J",1
24,"24230",410,312,309,5,3,"PUM+J",0
40,"40029",24,21,21,0,0,"PUM+J",0
9,"9483",189,153,150,1,3,"PUM+J",0
28,"28094",959,736,729,6,7,"PUM+J",0
42,"42073",73,58,57,0,1,"PUM+J",0
9,"9152",248,197,195,0,2,"PUM+J",0
33,"33037",33247,23529,23210,297,319,"PUM+J",21
22,"22184",168,142,139,2,3,"PUM+J",0
18,"18066",2108,1537,1525,9,12,"PUM+J",1
26,"26180",223,182,177,3,5,"PUM+J",0
28,"28023",5090,4252,4212,31,40,"PUM+J",2
22,"22186",191,165,164,2,1,"PUM+J",1
5,"5206",29,21,20,1,1,"PUM+J",0
26,"26142",784,651,641,5,10,"PUM+J",0
47,"47186",244448,197042,195276,1561,1766,"PUM+J",315
50,"50148",290,229,227,2,2,"PUM+J",0
12,"12033",1951,1528,1506,10,22,"PUM+J",2
9,"9050",52,36,36,0,0,"PUM+J",0
29,"29006",665,491,483,5,8,"PUM+J",0
16,"16188",77,56,56,0,0,"PUM+J",0
16,"16057",64,53,53,0,0,"PUM+J",0
9,"9318",58,37,37,0,0,"PUM+J",0
18,"18174",434,362,357,0,5,"PUM+J",0
50,"50178",276,193,193,4,0,"PUM+J",0
47,"47187",75,54,53,0,1,"PUM+J",0
18,"18102",8227,6100,5969,32,131,"PUM+J",4
4,"4076",1221,951,933,8,18,"PUM+J",0
26,"26183",66,50,50,0,0,"PUM+J",0
47,"47092",102,86,85,0,1,"PUM+J",0
22,"22059",1139,867,855,10,12,"PUM+J",3
44,"44068",643,518,511,9,7,"PUM+J",0
5,"5010",145,119,118,1,1,"PUM+J",0
40,"40065",469,376,373,1,3,"PUM+J",0
24,"24153",233,187,183,1,4,"PUM+J",0
37,"37091",164,108,108,3,0,"PUM+J",0
41,"41030",500,419,410,6,9,"PUM+J",0
39,"39101",236,173,171,1,2,"PUM+J",0
7,"7046",16718,10573,10469,94,104,"PUM+J",7
6,"6056",454,378,376,1,2,"PUM+J",0
41,"41011",15454,11892,11591,160,301,"PUM+J",6
19,"19189",115,93,92,0,1,"PUM+J",0
23,"23001",920,769,766,3,3,"PUM+J",0
2,"2002",435,358,352,2,6,"PUM+J",0
26,"26066",259,216,212,3,4,"PUM+J",0
44,"44137",188,148,146,0,2,"PUM+J",0
9,"9325",177,117,117,2,0,"PUM+J",0
9,"9160",80,64,64,1,0,"PUM+J",0
14,"14034",304,246,239,1,7,"PUM+J",0
40,"40032",378,287,278,1,9,"PUM+J",1
26,"26146",86,69,69,1,0,"PUM+J",0
34,"34130",198,165,161,2,4,"PUM+J",1
18,"18141",384,269,264,0,5,"PUM+J",2
18,"18914",1657,1315,1278,5,37,"PUM+J",0
12,"12069",53,45,44,1,1,"PUM+J",0
44,"44040",191,164,158,2,6,"PUM+J",0
28,"28026",6703,5422,5367,21,55,"PUM+J",7
2,"2076",318,256,250,1,6,"PUM+J",1
50,"50180",106,84,84,1,0,"PUM+J",0
7,"7048",18412,11528,11412,112,116,"PUM+J",14
47,"47064",37,32,29,0,3,"PUM+J",0
41,"41004",57465,41004,40321,571,683,"PUM+J",67
44,"44138",118,90,89,2,1,"PUM+J",0
50,"50181",1000,770,754,7,16,"PUM+J",1
22,"22105",101,82,82,4,0,"PUM+J",0
18,"18915",731,539,532,1,7,"PUM+J",1
38,"38044",2199,1443,1429,10,14,"PUM+J",0
9,"9164",150,116,114,0,2,"PUM+J",0
18,"18178",671,535,532,0,3,"PUM+J",0
50,"50091",40,35,35,0,0,"PUM+J",0
22,"22062",154,115,115,1,0,"PUM+J",0
26,"26108",290,241,237,0,4,"PUM+J",0
45,"45045",1331,1001,990,2,11,"PUM+J",0
4,"4081",346,272,271,2,1,"PUM+J",0
14,"14036",3676,2850,2766,40,84,"PUM+J",3
34,"34181",422,324,321,3,3,"PUM+J",0
45,"45136",5825,4314,4260,22,54,"PUM+J",8
9,"9270",159,119,117,4,2,"PUM+J",0
12,"12007",731,649,642,8,7,"PUM+J",0
49,"49039",327,255,246,6,9,"PUM+J",0
4,"4005",533,448,442,0,6,"PUM+J",0
37,"37175",404,321,319,8,2,"PUM+J",1
5,"5097",476,332,327,0,5,"PUM+J",0
16,"16064",651,575,569,4,6,"PUM+J",0
42,"42129",678,540,539,1,1,"PUM+J",3
28,"28059",4515,3573,3542,12,31,"PUM+J",6
12,"12129",1801,1382,1356,17,26,"PUM+J",0
29,"29901",44578,31840,31537,286,303,"PUM+J",40
19,"19049",9,8,8,0,0,"PUM+J",0
16,"16024",123,96,95,0,1,"PUM+J",0
40,"40179",626,540,529,2,11,"PUM+J",0
12,"12008",224,197,194,1,3,"PUM+J",0
45,"45139",145,118,117,1,1,"PUM+J",0
4,"4006",7218,5002,4940,33,62,"PUM+J",6
34,"34045",73,67,65,0,2,"PUM+J",0
33,"33014",8771,6425,6368,51,57,"PUM+J",5
29,"29902",2592,1841,1817,18,24,"PUM+J",2
20,"20058",739,555,551,4,4,"PUM+J",1
47,"47225",74,61,60,0,1,"PUM+J",0
45,"45093",154,124,123,0,1,"PUM+J",0
22,"22235",88,72,72,1,0,"PUM+J",0
45,"45002",2608,1840,1821,7,19,"PUM+J",0
42,"42084",20,16,16,0,0,"PUM+J",0
31,"31182",30,28,28,1,0,"PUM+J",0
18,"18074",264,207,205,0,2,"PUM+J",0
5,"5139",66,59,59,0,0,"PUM+J",0
37,"37177",265,209,208,0,1,"PUM+J",1
44,"44044",83,65,64,2,1,"PUM+J",1
9,"9389",64,50,50,0,0,"PUM+J",0
42,"42004",2294,1807,1767,22,40,"PUM+J",0
31,"31020",433,273,272,1,1,"PUM+J",0
32,"32078",1108,794,781,15,13,"PUM+J",2
34,"34135",399,320,315,4,5,"PUM+J",0
39,"39078",1406,1101,1090,7,11,"PUM+J",2
39,"39050",255,188,184,2,4,"PUM+J",0
44,"44237",368,299,293,2,6,"PUM+J",0
5,"5102",1681,1358,1329,4,29,"PUM+J",0
50,"50094",1518,1172,1155,20,17,"PUM+J",0
33,"33046",483,370,367,6,3,"PUM+J",0
49,"49006",142,111,111,1,0,"PUM+J",0
47,"47164",350,290,286,2,4,"PUM+J",1
9,"9063",214,185,184,0,1,"PUM+J",0
14,"14040",3755,3047,3006,21,41,"PUM+J",0
45,"45097",1044,901,890,4,11,"PUM+J",1
34,"34186",47,41,41,0,0,"PUM+J",0
44,"44145",972,741,732,11,9,"PUM+J",0
16,"16068",127,104,104,4,0,"PUM+J",0
50,"50095",12136,9020,8928,99,92,"PUM+J",11
19,"19156",933,756,745,1,11,"PUM+J",2
49,"49207",217,151,148,4,3,"PUM+J",0
12,"12104",6814,5486,5406,35,80,"PUM+J",2
22,"22239",88,71,71,0,0,"PUM+J",0
33,"33018",2819,2072,2044,28,28,"PUM+J",6
26,"26075",321,266,265,0,1,"PUM+J",0
47,"47009",99,84,84,0,0,"PUM+J",0
47,"47228",439,353,352,1,1,"PUM+J",0
33,"33048",136,87,87,1,0,"PUM+J",0
28,"28003",170,148,148,1,0,"PUM+J",0
19,"19245",1145,904,880,8,24,"PUM+J",4
31,"31186",288,220,216,1,4,"PUM+J",0
29,"29017",6428,4943,4871,32,72,"PUM+J",1
2,"2048",1178,989,967,7,22,"PUM+J",0
50,"50272",13174,10143,10042,103,101,"PUM+J",20
6,"6121",3268,2558,2531,26,27,"PUM+J",2
41,"41038",102179,76348,75425,819,923,"PUM+J",95
28,"28064",135,110,104,1,6,"PUM+J",0
47,"47197",867,721,717,2,4,"PUM+J",0
19,"19007",435,328,319,1,9,"PUM+J",1
9,"9175",119,93,93,0,0,"PUM+J",0
26,"26077",17,17,17,0,0,"PUM+J",0
50,"50098",162,121,120,3,1,"PUM+J",0
42,"42140",14,13,12,0,1,"PUM+J",0
47,"47041",153,119,116,2,3,"PUM+J",0
14,"14073",2772,2124,2069,18,55,"PUM+J",3
50,"50041",17,14,14,0,0,"PUM+J",0
45,"45147",590,506,496,2,10,"PUM+J",0
42,"42010",21,18,16,0,2,"PUM+J",0
48,"48059",400,329,325,0,4,"PUM+J",1
37,"37309",37,27,27,0,0,"PUM+J",0
33,"33060",14132,9960,9794,135,166,"PUM+J",5
5,"5221",323,249,244,1,5,"PUM+J",0
34,"34245",310,244,240,3,4,"PUM+J",1
26,"26005",2480,1687,1661,5,26,"PUM+J",1
29,"29019",864,687,679,7,8,"PUM+J",0
5,"5065",459,393,382,1,11,"PUM+J",0
34,"34143",157,125,120,1,5,"PUM+J",0
22,"22039",805,667,662,5,5,"PUM+J",1
32,"32055",1230,908,889,5,19,"PUM+J",0
19,"19294",25,19,18,0,1,"PUM+J",0
34,"34246",69,53,53,0,0,"PUM+J",1
47,"47231",4458,3677,3651,47,26,"PUM+J",8
49,"49214",664,519,510,2,9,"PUM+J",0
50,"50014",119,85,85,0,0,"PUM+J",0
20,"20035",484,384,384,2,0,"PUM+J",1
6,"6158",13362,10282,10112,73,170,"PUM+J",20
50,"50247",842,621,616,7,5,"PUM+J",2
40,"40151",43,32,32,0,0,"PUM+J",0
6,"6059",1759,1300,1285,12,15,"PUM+J",2
5,"5225",353,300,297,2,3,"PUM+J",1
45,"45104",421,340,335,1,5,"PUM+J",0
37,"37110",103,84,82,0,2,"PUM+J",0
18,"18119",1712,1352,1317,11,35,"PUM+J",0
37,"37337",139,114,114,0,0,"PUM+J",0
16,"16160",60,44,43,1,1,"PUM+J",0
9,"9179",38,32,32,0,0,"PUM+J",0
5,"5148",23,17,17,0,0,"PUM+J",0
44,"44181",66,58,57,0,1,"PUM+J",0
40,"40080",48,39,39,0,0,"PUM+J",0
9,"9288",88,73,71,1,2,"PUM+J",0
5,"5149",100,82,79,0,3,"PUM+J",0
32,"32029",436,340,337,1,3,"PUM+J",0
20,"20036",13192,9864,9806,67,58,"PUM+J",17
37,"37068",340,256,256,3,0,"PUM+J",0
5,"5226",65,52,52,0,0,"PUM+J",0
19,"19165",41,36,36,0,0,"PUM+J",0
34,"34204",52,41,41,1,0,"PUM+J",0
50,"50133",100,82,82,2,0,"PUM+J",0
28,"28039",125,103,103,2,0,"PUM+J",0
45,"45107",3423,2806,2770,18,36,"PUM+J",2
49,"49173",344,220,216,1,4,"PUM+J",2
37,"37187",555,437,433,0,4,"PUM+J",0
24,"24171",349,201,198,4,3,"PUM+J",0
18,"18189",772,619,611,4,8,"PUM+J",0
45,"45153",1560,1243,1230,4,13,"PUM+J",2
34,"34903",183,128,128,1,0,"PUM+J",1
6,"6061",1084,915,905,8,10,"PUM+J",0
41,"41015",5401,3984,3889,50,95,"PUM+J",1
5,"5112",95,66,64,2,2,"PUM+J",0
19,"19167",129,104,102,0,2,"PUM+J",0
9,"9236",35,29,29,1,0,"PUM+J",0
47,"47204",235,182,178,0,4,"PUM+J",0
44,"44023",18,14,14,0,0,"PUM+J",0
9,"9407",27,23,23,0,0,"PUM+J",0
20,"20038",380,296,295,0,1,"PUM+J",0
9,"9351",62,51,50,1,1,"PUM+J",0
37,"37228",325,278,273,0,5,"PUM+J",1
34,"34904",300,220,220,0,0,"PUM+J",0
16,"16082",271,207,206,3,1,"PUM+J",0
5,"5188",41,36,34,0,2,"PUM+J",0
19,"19168",266,211,206,4,5,"PUM+J",0
40,"40084",53,40,39,0,1,"PUM+J",1
37,"37189",114,88,88,2,0,"PUM+J",1
47,"47205",355,263,258,3,5,"PUM+J",1
45,"45110",1697,1339,1326,11,13,"PUM+J",0
39,"39087",41381,32335,31995,194,340,"PUM+J",29
24,"24053",406,279,276,6,3,"PUM+J",0
9,"9239",47,39,39,0,0,"PUM+J",0
44,"44154",248,200,195,2,5,"PUM+J",0
49,"49176",610,426,426,4,0,"PUM+J",0
16,"16215",237,157,153,1,4,"PUM+J",0
31,"31115",160,116,116,3,0,"PUM+J",0
6,"6063",2938,2299,2264,11,35,"PUM+J",1
6,"6031",461,316,301,1,15,"PUM+J",0
18,"18159",999,828,824,1,4,"PUM+J",1
6,"6097",2283,1803,1762,10,41,"PUM+J",0
19,"19071",8155,6327,6242,35,85,"PUM+J",11
22,"22250",344,271,264,6,7,"PUM+J",0
20,"20071",15036,11090,11025,59,65,"PUM+J",7
49,"49100",286,210,208,2,2,"PUM+J",1
26,"26126",29,29,29,1,0,"PUM+J",0
39,"39088",59,51,51,0,0,"PUM+J",0
9,"9077",30,22,22,0,0,"PUM+J",0
37,"37230",214,176,176,0,0,"PUM+J",0
5,"5231",151,126,126,0,0,"PUM+J",0
50,"50107",988,837,828,11,9,"PUM+J",1
31,"31117",589,420,419,5,1,"PUM+J",0
37,"37073",620,481,471,6,10,"PUM+J",0
50,"50195",53,42,41,0,1,"PUM+J",0
34,"34211",175,160,160,0,0,"PUM+J",0
5,"5116",96,77,75,0,2,"PUM+J",0
26,"26014",447,313,309,2,4,"PUM+J",0
5,"5904",112,81,81,3,0,"PUM+J",0
32,"32090",738,530,525,3,5,"PUM+J",1
39,"39005",1406,1127,1110,12,17,"PUM+J",0
5,"5232",106,87,84,1,3,"PUM+J",0
33,"33028",1158,635,630,6,5,"PUM+J",0
45,"45160",1095,913,905,2,8,"PUM+J",1
41,"41019",4895,3518,3462,36,56,"PUM+J",6
50,"50224",65,54,54,1,0,"PUM+J",1
50,"50048",33,25,25,0,0,"PUM+J",0
50,"50137",964,790,781,9,9,"PUM+J",0
34,"34108",502,424,415,6,9,"PUM+J",1
9,"9191",33,24,24,0,0,"PUM+J",0
26,"26016",28,24,23,0,1,"PUM+J",0
23,"23054",376,296,289,1,7,"PUM+J",0
24,"24176",299,243,238,3,5,"PUM+J",0
19,"19123",36,33,32,2,1,"PUM+J",0
47,"47082",810,679,668,8,11,"PUM+J",0
50,"50282",57,47,45,0,2,"PUM+J",0
29,"29062",651,576,567,4,9,"PUM+J",0
19,"19075",61,44,43,0,1,"PUM+J",0
37,"37158",233,168,166,0,2,"PUM+J",0
28,"28183",1124,857,842,4,15,"PUM+J",1
40,"40089",214,176,170,1,6,"PUM+J",0
50,"50168",27,20,20,0,0,"PUM+J",0
24,"24221",750,563,553,6,10,"PUM+J",2
34,"34110",82,66,65,0,1,"PUM+J",0
47,"47115",276,231,223,1,8,"PUM+J",0
7,"7002",6612,4721,4672,43,49,"PUM+J",8
31,"31093",275,212,206,0,6,"PUM+J",1
5,"5144",66,51,51,0,0,"PUM+J",0
50,"50052",85,64,64,0,0,"PUM+J",0
2,"2063",1375,1067,1047,1,20,"PUM+J",2
28,"28015",20440,17084,16953,103,131,"PUM+J",20
48,"48070",528,392,390,2,2,"PUM+J",0
9,"9195",55,45,45,1,0,"PUM+J",1
18,"18094",2304,1845,1798,16,47,"PUM+J",1
47,"47178",166,144,143,4,1,"PUM+J",0
26,"26018",10441,8400,8311,64,89,"PUM+J",4
6,"6002",4314,3181,3086,44,95,"PUM+J",3
49,"49105",136,105,103,1,2,"PUM+J",0
34,"34112",39,30,30,0,0,"PUM+J",0
7,"7036",27950,20870,20707,154,163,"PUM+J",33
24,"24060",574,371,369,1,2,"PUM+J",1
9,"9248",78,64,64,0,0,"PUM+J",1
9,"9139",98,82,82,2,0,"PUM+J",0
12,"12089",4546,3353,3304,12,49,"PUM+J",3
40,"40057",1405,1176,1163,10,13,"PUM+J",2
23,"23057",732,613,611,4,2,"PUM+J",1
19,"19127",90,63,63,0,0,"PUM+J",0
42,"42110",55,43,43,0,0,"PUM+J",0
47,"47212",358,312,311,3,1,"PUM+J",0
31,"31164",545,438,433,6,5,"PUM+J",0
44,"44031",82,52,52,1,0,"PUM+J",0
12,"12118",76,64,63,0,1,"PUM+J",0
5,"5082",495,399,394,1,5,"PUM+J",1
4,"4028",202,183,181,0,2,"PUM+J",3
39,"39037",2019,1572,1560,2,12,"PUM+J",0
16,"16133",4387,3607,3544,38,63,"PUM+J",4
45,"45075",124,93,90,0,3,"PUM+J",0
19,"19265",135,107,107,1,0,"PUM+J",0
42,"42111",279,209,208,3,1,"PUM+J",1
16,"16231",50,40,40,0,0,"PUM+J",0
9,"9473",87,76,73,0,3,"PUM+J",1
5,"5162",75,58,58,0,0,"PUM+J",0
20,"20016",1524,997,997,1,0,"PUM+J",1
31,"31003",117,97,97,1,0,"PUM+J",0
24,"24182",411,302,295,4,7,"PUM+J",2
16,"16134",4383,3544,3491,34,53,"PUM+J",3
6,"6005",1691,1246,1225,15,21,"PUM+J",2
44,"44100",175,142,141,2,1,"PUM+J",0
23,"23093",3131,2428,2380,22,48,"PUM+J",2
18,"18133",2109,1632,1618,12,14,"PUM+J",0
35,"35008",6207,4733,4654,42,79,"PUM+J",6
28,"28049",57902,47976,47561,329,415,"PUM+J",60
20,"20048",184,120,120,2,0,"PUM+J",0
35,"35009",20109,15017,14803,78,214,"PUM+J",13
48,"48073",6837,4950,4921,33,29,"PUM+J",0
47,"47152",68,59,59,0,0,"PUM+J",0
44,"44063",65,55,55,1,0,"PUM+J",0
31,"31126",351,255,254,2,1,"PUM+J",3
49,"49233",85,58,58,0,0,"PUM+J",0
49,"49187",1202,930,921,8,9,"PUM+J",0
44,"44260",138,91,90,1,1,"PUM+J",0
5,"5124",92,71,70,1,1,"PUM+J",0
18,"18098",5994,4293,4247,29,46,"PUM+J",0
50,"50115",3275,2399,2355,32,44,"PUM+J",1
19,"19134",30,24,24,0,0,"PUM+J",0
16,"16012",77,65,65,0,0,"PUM+J",0
32,"32012",716,497,487,7,10,"PUM+J",0
42,"42116",42,30,30,1,0,"PUM+J",0
34,"34121",183,155,151,1,4,"PUM+J",1
19,"19268",43,42,42,0,0,"PUM+J",0
44,"44064",63,49,48,0,1,"PUM+J",0
41,"41054",713,596,588,4,8,"PUM+J",0
49,"49234",399,339,333,2,6,"PUM+J",0
29,"29036",611,448,444,3,4,"PUM+J",0
5,"5165",370,293,285,4,8,"PUM+J",1
20,"20079",18142,14055,13971,75,84,"PUM+J",13
6,"6074",4755,3719,3638,27,81,"PUM+J",4
24,"24185",452,339,332,3,7,"PUM+J",1
34,"34223",205,160,157,1,3,"PUM+J",0
18,"18909",539,432,426,1,6,"PUM+J",0
19,"19270",25,21,21,0,0,"PUM+J",0
9,"9046",24,19,19,0,0,"PUM+J",0
37,"37128",242,187,184,1,3,"PUM+J",0
5,"5047",4118,3334,3248,25,86,"PUM+J",3
49,"49030",80,66,62,0,4,"PUM+J",0
40,"40134",697,560,548,7,12,"PUM+J",1
5,"5178",345,287,283,1,4,"PUM+J",0
48,"48909",202,172,172,2,0,"PUM+J",0
9,"9424",34,24,24,0,0,"PUM+J",0
37,"37355",162,137,135,0,2,"PUM+J",1
37,"37317",288,240,238,2,2,"PUM+J",0
32,"32042",1505,1097,1091,12,6,"PUM+J",3
18,"18101",9410,7280,7181,72,99,"PUM+J",7
24,"24067",606,375,371,2,4,"PUM+J",0
31,"31009",672,510,503,4,7,"PUM+J",1
24,"24188",3820,3107,3056,33,51,"PUM+J",3
32,"32043",2512,1805,1789,16,16,"PUM+J",2
31,"31212",129,102,102,6,0,"PUM+J",1
47,"47218",979,757,745,5,12,"PUM+J",0
40,"40171",39,29,29,1,0,"PUM+J",0
18,"18911",7869,5871,5765,49,106,"PUM+J",9
45,"45174",296,253,250,3,3,"PUM+J",0
12,"12123",43,35,34,1,1,"PUM+J",0
37,"37130",178,150,150,2,0,"PUM+J",0
37,"37131",171,138,137,0,1,"PUM+J",0
37,"37205",217,177,174,0,3,"PUM+J",0
39,"39099",3149,2562,2540,22,22,"PUM+J",2
42,"42167",236,183,182,3,1,"PUM+J",0
45,"45130",302,241,235,2,6,"PUM+J",0
7,"7012",1909,1358,1343,15,15,"PUM+J",0
42,"42121",55,42,42,0,0,"PUM+J",0
31,"31214",87,66,64,0,2,"PUM+J",0
37,"37090",66,51,51,1,0,"PUM+J",0
44,"44106",153,115,111,2,4,"PUM+J",0
39,"39015",824,646,644,2,2,"PUM+J",0
14,"14002",10859,8215,8078,93,137,"PUM+J",2
28,"28130",28508,23566,23305,179,261,"PUM+J",29
9,"9377",629,494,488,4,6,"PUM+J",1
50,"50206",453,371,370,5,1,"PUM+J",1
49,"49155",80,66,65,1,1,"PUM+J",0
44,"44136",51,43,43,1,0,"PUM+J",0
6,"6145",899,744,723,1,21,"PUM+J",0
45,"45132",2376,1915,1908,13,7,"PUM+J",1
50,"50003",119,95,95,1,0,"PUM+J",0
16,"16189",262,220,220,1,0,"PUM+J",0
22,"22188",76,60,59,1,1,"PUM+J",0
24,"24086",266,211,210,0,1,"PUM+J",0
18,"18127",16822,12735,12537,106,198,"PUM+J",10
28,"28066",7515,6105,6039,40,66,"PUM+J",4
37,"37359",163,122,117,0,5,"PUM+J",0
37,"37246",5155,4153,4107,33,46,"PUM+J",9
42,"42171",114,80,79,0,1,"PUM+J",0
22,"22102",181,153,151,1,2,"PUM+J",0
45,"45180",2834,2269,2239,11,30,"PUM+J",2
33,"33041",7112,5251,5194,63,57,"PUM+J",9
49,"49197",162,129,123,2,6,"PUM+J",0
19,"19146",46,41,41,1,0,"PUM+J",0
20,"20024",391,274,274,1,0,"PUM+J",0
45,"45088",2332,1724,1695,16,29,"PUM+J",3
47,"47128",56,49,46,0,3,"PUM+J",0
5,"5013",847,708,701,0,7,"PUM+J",0
45,"45134",1609,1305,1291,6,14,"PUM+J",0
41,"41031",1215,866,848,3,18,"PUM+J",0
47,"47032",153,121,121,1,0,"PUM+J",0
34,"34038",268,198,197,0,1,"PUM+J",1
16,"16245",400,329,318,0,11,"PUM+J",2
9,"9906",1200,975,958,8,17,"PUM+J",1
37,"37051",80,59,58,0,1,"PUM+J",0
31,"31015",1990,1533,1508,17,25,"PUM+J",4
6,"6014",6535,4757,4679,36,78,"PUM+J",2
50,"50294",64,49,47,0,2,"PUM+J",0
37,"37249",38,28,28,0,0,"PUM+J",0
28,"28165",1910,1443,1430,11,13,"PUM+J",1
41,"41903",6769,5018,4919,73,99,"PUM+J",2
16,"16106",2708,2200,2163,17,37,"PUM+J",0
14,"14066",5756,4396,4310,36,86,"PUM+J",6
22,"22232",87,66,65,2,1,"PUM+J",0
32,"32019",11512,8281,8161,96,120,"PUM+J",9
29,"29011",2871,1955,1926,11,29,"PUM+J",1
31,"31017",370,288,286,3,2,"PUM+J",1
18,"18916",1778,1249,1236,9,13,"PUM+J",0
37,"37212",101,85,83,0,2,"PUM+J",0
33,"33074",3376,2345,2311,41,34,"PUM+J",0
19,"19102",92,80,80,0,0,"PUM+J",0
6,"6016",2943,2283,2247,24,36,"PUM+J",0
6,"6082",393,314,305,5,9,"PUM+J",0
16,"16023",507,401,398,2,3,"PUM+J",1
5,"5253",78,62,60,0,2,"PUM+J",0
14,"14067",3870,3057,2998,24,59,"PUM+J",2
45,"45138",1055,889,874,5,15,"PUM+J",1
37,"37251",107,79,79,1,0,"PUM+J",0
5,"5175",149,122,119,1,3,"PUM+J",0
49,"49202",172,125,124,2,1,"PUM+J",0
22,"22117",2414,1798,1784,18,14,"PUM+J",0
5,"5214",27,22,22,0,0,"PUM+J",0
4,"4046",848,653,649,5,4,"PUM+J",1
26,"26034",612,509,497,5,12,"PUM+J",0
45,"45001",1837,1371,1340,12,31,"PUM+J",0
37,"37100",77,60,59,1,1,"PUM+J",0
29,"29013",1602,1262,1238,12,24,"PUM+J",1
5,"5254",181,155,153,0,2,"PUM+J",0
16,"16249",1938,1544,1529,13,15,"PUM+J",0
16,"16109",41,33,33,3,0,"PUM+J",0
29,"29068",7716,5347,5230,58,117,"PUM+J",7
24,"24117",412,336,335,0,1,"PUM+J",0
22,"22107",100,68,67,0,1,"PUM+J",0
39,"39002",3414,2630,2578,23,52,"PUM+J",2
44,"44013",11250,8525,8420,95,105,"PUM+J",10
50,"50124",399,316,316,3,0,"PUM+J",0
31,"31101",1412,1097,1087,11,10,"PUM+J",0
49,"49204",57,42,42,0,0,"PUM+J",0
9,"9274",1045,875,867,8,8,"PUM+J",0
37,"37329",39,36,36,0,0,"PUM+J",0
48,"48085",10637,8270,8223,54,47,"PUM+J",5
44,"44112",408,303,293,2,10,"PUM+J",0
44,"44206",103,83,82,0,1,"PUM+J",0
48,"48004",326,261,260,3,1,"PUM+J",0
37,"37266",70,58,56,0,2,"PUM+J",0
9,"9455",43,37,36,0,1,"PUM+J",0
9,"9440",80,66,66,0,0,"PUM+J",0
6,"6086",1174,869,862,4,7,"PUM+J",0
47,"47227",55,46,46,0,0,"PUM+J",0
28,"28137",1744,1385,1366,8,19,"PUM+J",5
44,"44077",74,55,54,0,1,"PUM+J",0
42,"42181",391,319,317,0,2,"PUM+J",0
16,"16041",339,271,267,2,4,"PUM+J",0
16,"16027",701,540,531,2,9,"PUM+J",1
2,"2046",1132,975,953,10,22,"PUM+J",0
4,"4009",151,126,124,3,2,"PUM+J",0
47,"47100",119,104,102,2,2,"PUM+J",0
28,"28138",63,49,49,0,0,"PUM+J",0
28,"28063",254,203,202,2,1,"PUM+J",0
16,"16253",308,250,249,2,1,"PUM+J",0
42,"42007",109,89,89,1,0,"PUM+J",0
19,"19054",167,144,141,2,3,"PUM+J",0
45,"45190",458,378,365,2,13,"PUM+J",0
22,"22035",226,174,174,0,0,"PUM+J",1
31,"31902",4649,3620,3598,34,22,"PUM+J",22
45,"45143",1190,940,925,3,15,"PUM+J",1
50,"50252",5057,3661,3613,36,48,"PUM+J",2
48,"48087",432,357,356,0,1,"PUM+J",1
23,"23009",12808,10348,10233,66,115,"PUM+J",8
18,"18044",164,113,112,0,1,"PUM+J",0
44,"44115",102,96,95,0,1,"PUM+J",0
49,"49208",364,260,255,5,5,"PUM+J",0
9,"9065",138,118,117,1,1,"PUM+J",0
23,"23075",3220,2559,2524,18,35,"PUM+J",4
24,"24164",362,221,220,1,1,"PUM+J",0
24,"24083",1005,800,791,7,9,"PUM+J",2
37,"37333",202,138,137,4,1,"PUM+J",0
23,"23010",14241,10186,10015,68,171,"PUM+J",7
49,"49251",161,125,124,0,1,"PUM+J",0
34,"34094",61,44,44,0,0,"PUM+J",0
32,"32025",1013,773,761,7,12,"PUM+J",0
19,"19290",851,581,577,5,4,"PUM+J",1
12,"12106",1163,980,951,7,29,"PUM+J",0
22,"22113",470,369,369,2,0,"PUM+J",0
41,"41039",31500,23692,23345,234,347,"PUM+J",22
44,"44018",16,16,16,0,0,"PUM+J",0
22,"22158",11951,8877,8801,69,76,"PUM+J",10
5,"5182",731,494,490,6,4,"PUM+J",0
49,"49252",304,244,241,6,3,"PUM+J",0
24,"24006",487,393,387,3,6,"PUM+J",1
16,"16032",277,224,223,1,1,"PUM+J",0
29,"29063",303,243,239,1,4,"PUM+J",0
50,"50235",2412,1826,1807,22,19,"PUM+J",1
22,"22174",462,381,377,0,4,"PUM+J",0
22,"22244",46,37,37,2,0,"PUM+J",0
50,"50160",2150,1652,1619,14,33,"PUM+J",1
4,"4053",12500,9437,9298,56,139,"PUM+J",12
28,"28173",519,417,412,4,5,"PUM+J",0
37,"37183",386,296,294,4,2,"PUM+J",2
42,"42011",17,11,11,0,0,"PUM+J",0
19,"19161",211,165,163,2,2,"PUM+J",0
49,"49130",158,131,131,5,0,"PUM+J",0
40,"40219",565,451,432,2,19,"PUM+J",1
26,"26158",246,207,206,2,1,"PUM+J",0
5,"5066",439,373,367,2,6,"PUM+J",2
24,"24125",421,298,289,2,9,"PUM+J",0
50,"50161",103,80,80,0,0,"PUM+J",0
48,"48091",1090,862,857,9,5,"PUM+J",0
50,"50042",16,16,16,0,0,"PUM+J",0
44,"44086",421,332,327,3,5,"PUM+J",0
34,"34901",1071,854,847,4,7,"PUM+J",0
50,"50218",110,92,92,0,0,"PUM+J",0
5,"5147",147,119,117,0,2,"PUM+J",0
28,"28067",4361,3548,3509,14,39,"PUM+J",5
28,"28175",935,775,767,3,8,"PUM+J",2
41,"41069",29569,21075,20657,361,418,"PUM+J",22
44,"44020",22,18,18,0,0,"PUM+J",0
48,"48092",869,676,674,9,2,"PUM+J",0
24,"24089",101353,78253,77375,776,878,"PUM+J",110
24,"24211",263,219,214,3,5,"PUM+J",0
49,"49013",229,176,175,4,1,"PUM+J",0
50,"50190",675,565,553,5,12,"PUM+J",1
37,"37224",189,168,165,0,3,"PUM+J",0
16,"16118",1350,1126,1093,6,33,"PUM+J",0
34,"34902",123,98,98,4,0,"PUM+J",0
28,"28068",11554,9122,9022,44,100,"PUM+J",9
19,"19013",114,99,99,0,0,"PUM+J",0
44,"44088",23,21,21,0,0,"PUM+J",0
32,"32001",5105,3760,3715,37,45,"PUM+J",3
24,"24090",326,213,213,2,0,"PUM+J",0
26,"26045",11,11,11,0,0,"PUM+J",0
34,"34101",45,39,38,0,1,"PUM+J",0
40,"40189",479,392,380,2,12,"PUM+J",1
41,"41042",5849,4730,4692,20,38,"PUM+J",0
6,"6094",1459,1017,1008,8,9,"PUM+J",0
45,"45152",547,448,442,1,6,"PUM+J",0
49,"49220",139,110,104,2,6,"PUM+J",0
45,"45199",3107,2221,2184,8,37,"PUM+J",3
18,"18049",596,485,481,0,4,"PUM+J",1
45,"45016",4442,3621,3583,21,38,"PUM+J",4
19,"19181",55,47,46,1,1,"PUM+J",0
18,"18018",554,457,451,0,6,"PUM+J",0
9,"9129",89,75,75,0,0,"PUM+J",0
37,"37340",142,101,101,0,0,"PUM+J",0
22,"22248",104,83,82,0,1,"PUM+J",0
9,"9074",834,697,694,8,3,"PUM+J",2
19,"19016",57,40,40,0,0,"PUM+J",0
32,"32002",2022,1510,1485,8,25,"PUM+J",1
45,"45063",380,294,289,0,5,"PUM+J",0
6,"6161",288,226,222,1,4,"PUM+J",2
37,"37188",160,115,112,3,3,"PUM+J",0
5,"5152",655,537,534,3,3,"PUM+J",0
45,"45155",319,261,253,1,8,"PUM+J",0
24,"24104",245,173,172,1,1,"PUM+J",0
42,"42192",38,26,26,1,0,"PUM+J",0
5,"5035",96,78,78,0,0,"PUM+J",0
44,"44090",66,49,49,0,0,"PUM+J",0
49,"49099",98,75,74,0,1,"PUM+J",0
28,"28082",6063,4939,4889,46,50,"PUM+J",10
5,"5153",87,65,65,1,0,"PUM+J",0
49,"49137",170,138,134,0,4,"PUM+J",0
47,"47206",78,64,64,0,0,"PUM+J",0
50,"50135",88,74,74,3,0,"PUM+J",0
42,"42029",131,98,97,2,1,"PUM+J",0
4,"4033",125,98,95,0,3,"PUM+J",0
37,"37241",164,129,127,0,2,"PUM+J",0
9,"9409",110,87,87,0,0,"PUM+J",0
12,"12140",1140,936,922,7,14,"PUM+J",0
20,"20009",11343,8168,8106,46,62,"PUM+J",8
45,"45019",7545,5831,5740,52,91,"PUM+J",13
41,"41073",1685,1172,1157,13,15,"PUM+J",1
9,"9132",171,136,130,1,6,"PUM+J",1
41,"41045",5854,4287,4200,58,87,"PUM+J",11
9,"9456",137,104,104,0,0,"PUM+J",0
5,"5076",473,417,413,7,4,"PUM+J",1
16,"16042",1108,948,938,3,10,"PUM+J",0
28,"28150",3187,2640,2604,20,36,"PUM+J",5
5,"5903",138,94,92,0,2,"PUM+J",0
28,"28118",61,52,51,0,1,"PUM+J",0
4,"4021",180,146,143,0,3,"PUM+J",0
6,"6098",534,421,411,8,10,"PUM+J",0
50,"50223",916,751,745,13,6,"PUM+J",1
18,"18124",359,269,267,0,2,"PUM+J",0
18,"18161",251,222,220,1,2,"PUM+J",0
24,"24136",496,375,371,2,4,"PUM+J",0
44,"44093",79,73,73,4,0,"PUM+J",0
19,"19040",57,40,40,0,0,"PUM+J",0
12,"12022",328,273,269,1,4,"PUM+J",0
9,"9412",765,564,558,7,6,"PUM+J",2
22,"22172",520,412,407,3,5,"PUM+J",1
33,"33058",1664,1205,1176,5,29,"PUM+J",0
19,"19172",50,35,35,1,0,"PUM+J",0
19,"19274",950,753,741,7,12,"PUM+J",2
6,"6099",1162,833,813,6,20,"PUM+J",2
16,"16128",51,44,44,0,0,"PUM+J",0
40,"40194",39191,31175,30785,250,390,"PUM+J",55
40,"40054",107,91,88,0,3,"PUM+J",0
37,"37345",150,134,133,0,1,"PUM+J",0
16,"16129",90,78,77,0,1,"PUM+J",0
5,"5157",235,175,174,2,1,"PUM+J",0
22,"22083",445,379,372,5,7,"PUM+J",0
44,"44094",123,112,112,0,0,"PUM+J",1
9,"9136",173,130,128,0,2,"PUM+J",0
23,"23024",12224,9586,9329,46,257,"PUM+J",10
49,"49227",313,255,254,1,1,"PUM+J",1
48,"48008",615,454,448,4,6,"PUM+J",1
26,"26170",427,343,338,2,5,"PUM+J",0
35,"35004",41728,23957,23683,219,274,"PUM+J",31
26,"26052",148,113,113,1,0,"PUM+J",0
34,"34215",162,143,142,3,1,"PUM+J",0
23,"23090",1219,1014,1004,5,10,"PUM+J",0
42,"42123",158,118,118,2,0,"PUM+J",0
16,"16258",172,128,128,2,0,"PUM+J",0
37,"37145",244,187,185,3,2,"PUM+J",0
19,"19174",91,69,69,0,0,"PUM+J",0
20,"20013",5430,4144,4119,19,25,"PUM+J",2
31,"31202",4345,3132,3085,36,47,"PUM+J",6
42,"42023",60,49,48,0,1,"PUM+J",0
45,"45163",8340,6486,6363,38,123,"PUM+J",12
24,"24222",14431,11296,11135,117,161,"PUM+J",15
44,"44060",37,28,28,0,0,"PUM+J",0
6,"6035",865,678,670,4,8,"PUM+J",0
9,"9467",60,46,46,0,0,"PUM+J",0
31,"31041",1659,1245,1228,23,17,"PUM+J",8
48,"48009",772,628,622,2,6,"PUM+J",0
45,"45118",2088,1562,1540,11,22,"PUM+J",4
24,"24223",2540,1971,1929,37,42,"PUM+J",2
39,"39092",871,635,629,2,6,"PUM+J",0
9,"9362",205,177,177,3,0,"PUM+J",0
48,"48904",3542,2832,2811,27,21,"PUM+J",4
42,"42159",40,36,35,0,1,"PUM+J",1
50,"50902",79,69,69,0,0,"PUM+J",0
45,"45027",327,276,273,0,3,"PUM+J",0
12,"12026",835,656,639,4,17,"PUM+J",0
44,"44192",349,288,284,1,4,"PUM+J",0
29,"29032",6657,5314,5190,30,124,"PUM+J",9
34,"34113",40,37,37,0,0,"PUM+J",0
28,"28902",523,418,415,2,3,"PUM+J",0
22,"22129",163,117,116,0,1,"PUM+J",0
9,"9140",115,88,88,2,0,"PUM+J",0
37,"37123",162,122,117,3,5,"PUM+J",1
47,"47180",57,46,46,1,0,"PUM+J",0
9,"9250",259,215,214,1,1,"PUM+J",0
19,"19311",87,71,71,2,0,"PUM+J",1
5,"5161",550,444,434,2,10,"PUM+J",1
22,"22015",300,232,226,5,6,"PUM+J",0
9,"9198",100,80,79,0,1,"PUM+J",0
31,"31044",294,243,242,5,1,"PUM+J",0
40,"40093",76,68,67,0,1,"PUM+J",0
44,"44129",36,29,29,0,0,"PUM+J",0
26,"26021",2752,2132,2105,10,27,"PUM+J",1
16,"16049",144,111,108,1,3,"PUM+J",0
19,"19033",48,42,41,0,1,"PUM+J",0
42,"42026",22,20,20,0,0,"PUM+J",0
16,"16094",120,89,88,0,1,"PUM+J",1
37,"37125",227,171,169,0,2,"PUM+J",0
50,"50230",1134,853,846,6,7,"PUM+J",0
31,"31248",270,158,154,6,4,"PUM+J",0
40,"40130",128,102,96,0,6,"PUM+J",0
4,"4045",1704,1355,1326,12,29,"PUM+J",2
44,"44033",244,174,172,0,2,"PUM+J",0
32,"32067",1193,827,818,10,9,"PUM+J",0
6,"6105",604,406,400,2,6,"PUM+J",0
52,"52001",54124,34068,33749,237,319,"PUM+J",39
48,"48013",79423,59100,58630,458,470,"PUM+J",87
31,"31005",281,202,201,5,1,"PUM+J",0
31,"31127",135,96,96,0,0,"PUM+J",0
9,"9422",32,27,26,2,1,"PUM+J",0
22,"22017",822,664,660,5,4,"PUM+J",0
50,"50231",257,210,207,3,3,"PUM+J",0
34,"34029",659,557,551,5,6,"PUM+J",0
35,"35010",3797,2601,2572,9,29,"PUM+J",3
45,"45154",1479,1163,1149,5,14,"PUM+J",3
32,"32068",1419,998,987,4,11,"PUM+J",0
45,"45033",298,224,221,1,3,"PUM+J",0
40,"40202",55,38,38,0,0,"PUM+J",0
29,"29003",922,740,727,3,13,"PUM+J",0
20,"20049",4159,3024,3004,11,20,"PUM+J",1
19,"19037",132,114,112,0,2,"PUM+J",0
18,"18170",324,225,224,1,1,"PUM+J",0
47,"47027",2775,2246,2222,14,24,"PUM+J",4
24,"24132",615,405,404,5,1,"PUM+J",1
18,"18087",182514,141305,139588,865,1717,"PUM+J",227
26,"26166",147,136,136,2,0,"PUM+J",0
50,"50018",893,705,696,3,9,"PUM+J",1
47,"47154",146,122,118,2,4,"PUM+J",0
31,"31251",3152,2437,2402,12,35,"PUM+J",10
44,"44132",58,47,47,0,0,"PUM+J",0
6,"6041",457,381,374,5,7,"PUM+J",0
39,"39012",6737,5391,5314,52,77,"PUM+J",2
9,"9257",86,74,71,0,3,"PUM+J",0
44,"44175",113,84,82,1,2,"PUM+J",0
18,"18147",3644,2492,2441,18,51,"PUM+J",5
22,"22136",749,579,576,5,3,"PUM+J",0
9,"9095",112,70,68,1,2,"PUM+J",0
39,"39041",1767,1437,1417,18,20,"PUM+J",0
33,"33067",747,608,596,9,12,"PUM+J",0
9,"9425",476,366,362,1,4,"PUM+J",0
48,"48910",2802,2082,2073,3,9,"PUM+J",4
49,"49114",40,33,32,1,1,"PUM+J",0
50,"50001",88,71,70,0,1,"PUM+J",0
26,"26026",1265,1061,1049,2,12,"PUM+J",0
50,"50233",104,82,82,0,0,"PUM+J",0
31,"31253",119,106,105,0,1,"PUM+J",0
34,"34124",63,58,58,0,0,"PUM+J",0
7,"7044",8791,6335,6196,66,139,"PUM+J",9
49,"49126",273,161,160,1,1,"PUM+J",0
24,"24068",443,343,336,1,7,"PUM+J",0
16,"16142",120,95,95,0,0,"PUM+J",0
16,"16015",351,251,250,4,1,"PUM+J",1
2,"2071",1058,912,906,2,6,"PUM+J",1
42,"42032",142,120,120,0,0,"PUM+J",0
32,"32081",2035,1592,1565,14,27,"PUM+J",0
48,"48077",3376,2656,2647,11,9,"PUM+J",2
19,"19323",34,29,29,0,0,"PUM+J",0
50,"50059",754,599,589,6,10,"PUM+J",0
22,"22021",1884,1465,1450,13,15,"PUM+J",3
44,"44007",152,120,117,0,3,"PUM+J",1
48,"48911",388,323,322,3,1,"PUM+J",0
34,"34175",87,67,66,0,1,"PUM+J",0
28,"28024",168,146,145,1,1,"PUM+J",0
42,"42212",62,48,47,1,1,"PUM+J",0
9,"9102",33,26,25,0,1,"PUM+J",0
2,"2073",4844,3828,3772,28,56,"PUM+J",3
35,"35014",11908,7101,6947,63,154,"PUM+J",6
19,"19324",160,128,123,1,5,"PUM+J",0
19,"19042",21,19,18,1,1,"PUM+J",0
28,"28055",907,671,666,5,5,"PUM+J",0
34,"34036",238,199,198,1,1,"PUM+J",0
16,"16102",1163,951,943,16,8,"PUM+J",1
5,"5131",95,72,71,0,1,"PUM+J",0
4,"4012",187,163,162,1,1,"PUM+J",0
9,"9304",192,164,161,2,3,"PUM+J",0
26,"26171",156,131,127,0,4,"PUM+J",0
39,"39026",1720,1322,1312,5,10,"PUM+J",0
49,"49210",448,372,370,3,2,"PUM+J",0
48,"48913",1224,977,967,6,10,"PUM+J",1
50,"50150",621,451,450,2,1,"PUM+J",1
50,"50236",101,82,80,1,2,"PUM+J",0
29,"29009",1441,1097,1073,8,24,"PUM+J",0
49,"49118",194,151,151,1,0,"PUM+J",1
49,"49157",192,153,149,0,4,"PUM+J",0
41,"41087",10496,7661,7477,57,184,"PUM+J",17
31,"31014",266,195,195,4,0,"PUM+J",0
18,"18105",3822,2688,2650,12,38,"PUM+J",1
44,"44169",310,250,245,4,5,"PUM+J",0
23,"23901",1139,946,934,3,12,"PUM+J",1
42,"42172",28,25,25,1,0,"PUM+J",0
9,"9105",97,81,76,1,5,"PUM+J",1
5,"5055",540,448,445,1,3,"PUM+J",0
19,"19327",397,333,332,0,1,"PUM+J",0
7,"7015",21976,14458,14297,205,161,"PUM+J",20
23,"23002",17399,13575,13341,97,234,"PUM+J",16
31,"31259",476,347,346,0,1,"PUM+J",0
16,"16020",9,5,5,0,0,"PUM+J",0
18,"18070",289,224,222,3,2,"PUM+J",0
23,"23037",520,431,425,6,6,"PUM+J",0
19,"19192",1759,1367,1360,3,7,"PUM+J",2
50,"50121",277,220,218,2,2,"PUM+J",0
16,"16104",55,46,46,0,0,"PUM+J",0
48,"48082",37396,27913,27694,172,219,"PUM+J",29
5,"5173",59,52,52,0,0,"PUM+J",0
49,"49082",343,288,286,8,2,"PUM+J",0
45,"45090",368,287,286,1,1,"PUM+J",0
37,"37173",1420,1077,1058,13,19,"PUM+J",3
20,"20056",4075,2983,2942,12,41,"PUM+J",1
34,"34232",735,595,584,8,11,"PUM+J",1
49,"49133",291,213,211,0,2,"PUM+J",0
9,"9434",1280,1089,1077,12,12,"PUM+J",1
19,"19331",2643,2043,2009,11,34,"PUM+J",9
22,"22063",159,133,132,2,1,"PUM+J",1
12,"12039",792,688,680,3,8,"PUM+J",0
24,"24036",272,181,179,4,2,"PUM+J",0
33,"33013",429,320,316,1,4,"PUM+J",0
44,"44234",70,57,57,1,0,"PUM+J",0
50,"50007",49,34,34,0,0,"PUM+J",0
31,"31058",202,163,160,2,3,"PUM+J",1
47,"47065",817,658,653,2,5,"PUM+J",1
50,"50182",3675,2846,2810,36,36,"PUM+J",3
37,"37174",983,788,768,0,20,"PUM+J",0
24,"24011",189,122,121,1,1,"PUM+J",0
37,"37150",36,31,31,0,0,"PUM+J",0
19,"19332",85,70,70,1,0,"PUM+J",1
5,"5058",72,52,52,0,0,"PUM+J",0
42,"42001",251,186,186,2,0,"PUM+J",0
44,"44012",310,240,238,5,2,"PUM+J",0
16,"16248",862,730,720,10,10,"PUM+J",1
5,"5136",84,64,64,2,0,"PUM+J",0
50,"50093",83,66,66,1,0,"PUM+J",0
26,"26035",16,14,13,0,1,"PUM+J",0
22,"22150",461,368,362,1,6,"PUM+J",0
50,"50296",382,288,272,1,16,"PUM+J",0
5,"5017",86,74,73,0,1,"PUM+J",1
28,"28020",169,110,109,0,1,"PUM+J",0
16,"16269",393,322,317,3,5,"PUM+J",0
12,"12073",132,110,107,1,3,"PUM+J",0
28,"28168",1329,976,969,3,7,"PUM+J",1
16,"16152",32,28,28,1,0,"PUM+J",0
5,"5060",109,88,88,0,0,"PUM+J",0
12,"12102",521,442,434,2,8,"PUM+J",0
34,"34184",49,39,38,0,1,"PUM+J",0
20,"20059",8867,6792,6759,21,33,"PUM+J",1
16,"16096",280,239,234,3,5,"PUM+J",0
49,"49222",370,284,282,2,2,"PUM+J",0
12,"12121",1044,941,915,4,26,"PUM+J",0
9,"9184",7,5,5,0,0,"PUM+J",0
14,"14070",1284,988,969,5,19,"PUM+J",0
6,"6019",2012,1539,1495,14,44,"PUM+J",3
22,"22032",107,74,74,2,0,"PUM+J",1
6,"6119",681,551,547,1,4,"PUM+J",0
9,"9115",91,71,66,2,5,"PUM+J",1
16,"16124",1826,1482,1455,6,27,"PUM+J",0
22,"22124",182,148,148,1,0,"PUM+J",0
45,"45050",489,381,363,3,18,"PUM+J",2
40,"40005",25,21,21,0,0,"PUM+J",0
37,"37058",56,41,41,0,0,"PUM+J",0
50,"50126",2262,1736,1708,20,28,"PUM+J",0
31,"31022",483,349,345,3,4,"PUM+J",0
28,"28170",2487,1840,1810,10,30,"PUM+J",0
40,"40006",22,18,18,0,0,"PUM+J",0
5,"5179",199,181,175,0,6,"PUM+J",0
9,"9442",370,305,301,5,4,"PUM+J",0
18,"18183",624,442,441,1,1,"PUM+J",2
44,"44082",89,72,69,0,3,"PUM+J",0
44,"44177",101,75,75,1,0,"PUM+J",0
49,"49088",82,59,59,0,0,"PUM+J",0
34,"34156",50,43,43,0,0,"PUM+J",0
26,"26128",96,74,74,1,0,"PUM+J",0
34,"34157",2364,1881,1846,13,35,"PUM+J",4
32,"32052",1819,1399,1379,15,20,"PUM+J",2
16,"16086",881,751,747,3,4,"PUM+J",1
24,"24121",616,491,484,4,7,"PUM+J",0
31,"31240",513,385,385,6,0,"PUM+J",1
18,"18149",5401,4290,4212,28,78,"PUM+J",1
34,"34139",160,119,118,0,1,"PUM+J",0
38,"38050",2436,1564,1529,12,35,"PUM+J",2
42,"42088",60,53,53,0,0,"PUM+J",0
40,"40216",774,670,665,11,5,"PUM+J",0
31,"31105",1478,1203,1189,21,14,"PUM+J",1
45,"45054",3831,2980,2944,11,36,"PUM+J",2
44,"44084",55,45,45,0,0,"PUM+J",0
47,"47229",231,174,168,0,6,"PUM+J",0
16,"16115",47,35,35,0,0,"PUM+J",0
39,"39025",8703,6954,6854,39,100,"PUM+J",7
45,"45055",998,844,828,4,16,"PUM+J",1
40,"40113",408,339,335,6,4,"PUM+J",2
41,"41010",4573,3407,3345,27,62,"PUM+J",3
9,"9395",122,95,94,0,1,"PUM+J",0
31,"31229",38,36,36,2,0,"PUM+J",0
47,"47230",288,236,233,1,3,"PUM+J",0
34,"34243",320,260,258,1,2,"PUM+J",0
37,"37194",237,182,181,0,1,"PUM+J",0
41,"41058",17860,12850,12598,152,252,"PUM+J",15
33,"33040",4566,3205,3150,50,55,"PUM+J",4
49,"49181",335,227,224,2,3,"PUM+J",0
32,"32063",1819,1313,1287,6,26,"PUM+J",1
28,"28035",1394,1057,1043,3,14,"PUM+J",1
37,"37335",389,308,301,3,7,"PUM+J",0
47,"47042",50,41,39,0,2,"PUM+J",0
2,"2051",1665,1253,1222,6,31,"PUM+J",0
2,"2050",90,75,75,0,0,"PUM+J",0
24,"24124",346,231,226,2,5,"PUM+J",0
40,"40185",815,624,618,4,6,"PUM+J",1
12,"12135",36194,27266,26961,192,305,"PUM+J",37
26,"26006",1825,1496,1470,8,26,"PUM+J",4
22,"22245",306,266,263,0,3,"PUM+J",0
6,"6157",397,296,292,1,4,"PUM+J",0
7,"7025",446,363,362,4,1,"PUM+J",1
29,"29076",2335,1661,1614,11,47,"PUM+J",6
37,"37260",139,109,109,0,0,"PUM+J",1
9,"9287",199,169,168,1,1,"PUM+J",0
42,"42050",27,21,21,1,0,"PUM+J",0
50,"50071",127,89,88,0,1,"PUM+J",0
7,"7059",3035,2257,2226,13,31,"PUM+J",4
6,"6026",815,661,653,5,8,"PUM+J",0
29,"29020",3280,2531,2485,23,46,"PUM+J",3
5,"5108",40,28,28,0,0,"PUM+J",0
38,"38023",125528,88323,87456,598,867,"PUM+J",124
5,"5067",74,61,60,0,1,"PUM+J",0
50,"50131",210,157,156,0,1,"PUM+J",0
29,"29054",42393,30327,30108,218,219,"PUM+J",38
5,"5109",441,363,356,5,7,"PUM+J",0
26,"26007",481,391,383,0,8,"PUM+J",0
41,"41041",9760,7835,7646,44,189,"PUM+J",1
16,"16264",390,338,328,2,10,"PUM+J",0
32,"32085",10634,7655,7551,66,104,"PUM+J",4
12,"12137",37,27,27,0,0,"PUM+J",0
9,"9141",602,501,493,4,8,"PUM+J",3
23,"23015",1332,1066,1048,4,18,"PUM+J",0
18,"18016",308,232,231,5,1,"PUM+J",1
40,"40120",196,176,169,0,7,"PUM+J",0
37,"37149",61,56,54,1,2,"PUM+J",0
50,"50073",2117,1735,1706,13,29,"PUM+J",2
32,"32057",514,367,365,5,2,"PUM+J",2
12,"12109",653,544,533,3,11,"PUM+J",2
37,"37112",152,104,103,0,1,"PUM+J",0
16,"16038",28,21,21,0,0,"PUM+J",0
47,"47171",384,315,311,5,4,"PUM+J",0
48,"48002",7777,6034,5981,48,53,"PUM+J",3
26,"26009",391,317,314,2,3,"PUM+J",0
22,"22131",83,65,65,0,0,"PUM+J",0
40,"40025",128,109,106,1,3,"PUM+J",0
44,"44120",219,158,152,1,6,"PUM+J",0
34,"34058",185,161,161,1,0,"PUM+J",0
28,"28009",14500,11656,11564,62,92,"PUM+J",13
44,"44121",53,38,38,2,0,"PUM+J",0
37,"37113",409,330,329,3,1,"PUM+J",0
26,"26098",99,77,77,1,0,"PUM+J",0
4,"4017",1276,907,900,4,7,"PUM+J",0
42,"42191",180,129,129,1,0,"PUM+J",0
20,"20007",327,235,230,2,5,"PUM+J",4
9,"9144",44,37,37,2,0,"PUM+J",0
48,"48064",613,494,492,1,2,"PUM+J",1
14,"14068",516,405,400,1,5,"PUM+J",1
9,"9256",333,260,256,2,4,"PUM+J",0
31,"31237",186,151,149,1,2,"PUM+J",0
12,"12139",302,219,217,3,2,"PUM+J",2
37,"37265",208,184,181,1,3,"PUM+J",0
16,"16165",55,49,48,1,1,"PUM+J",0
31,"31114",374,291,286,4,5,"PUM+J",1
26,"26165",337,289,284,0,5,"PUM+J",0
37,"37302",262,182,181,2,1,"PUM+J",0
47,"47163",280,238,232,2,6,"PUM+J",0
9,"9273",51,46,46,3,0,"PUM+J",0
4,"4019",232,181,179,0,2,"PUM+J",0
31,"31075",118,96,95,2,1,"PUM+J",0
28,"28159",594,493,491,5,2,"PUM+J",0
44,"44216",26922,20603,20279,204,324,"PUM+J",12
35,"35029",4357,2869,2832,32,37,"PUM+J",3
5,"5902",293,246,242,1,4,"PUM+J",0
45,"45203",2713,2092,2053,16,39,"PUM+J",9
42,"42152",67,47,46,0,1,"PUM+J",0
6,"6141",1688,1308,1291,16,17,"PUM+J",0
44,"44014",2499,2015,1963,25,52,"PUM+J",5
6,"6130",186,159,154,0,5,"PUM+J",0
45,"45157",2261,1627,1603,8,24,"PUM+J",2
50,"50136",534,416,405,2,11,"PUM+J",0
7,"7031",24784,16683,16527,160,156,"PUM+J",18
22,"22045",73,57,56,0,1,"PUM+J",0
12,"12141",92,81,81,0,0,"PUM+J",0
42,"42018",131,102,102,1,0,"PUM+J",0
34,"34061",96,77,77,2,0,"PUM+J",0
49,"49178",747,574,564,4,10,"PUM+J",1
19,"19021",976,744,724,5,20,"PUM+J",1
9,"9133",38,33,33,0,0,"PUM+J",0
19,"19073",16,13,13,0,0,"PUM+J",0
49,"49263",45,37,37,0,0,"PUM+J",0
49,"49153",151,110,108,0,2,"PUM+J",0
9,"9208",179,130,127,1,3,"PUM+J",0
34,"34225",5001,4070,4021,48,49,"PUM+J",9
44,"44055",77,58,56,0,2,"PUM+J",0
49,"49102",183,136,135,2,1,"PUM+J",0
50,"50280",301,246,240,1,6,"PUM+J",0
9,"9261",449,343,342,5,1,"PUM+J",0
6,"6110",137,106,105,0,1,"PUM+J",0
33,"33069",3419,2557,2533,32,24,"PUM+J",1
20,"20072",4752,3445,3412,24,33,"PUM+J",6
24,"24029",695,521,520,4,1,"PUM+J",0
19,"19305",135,104,103,3,1,"PUM+J",0
19,"19260",38,33,31,1,2,"PUM+J",0
16,"16087",226,191,184,3,7,"PUM+J",0
48,"48068",1528,1218,1211,5,7,"PUM+J",0
49,"49226",239,207,200,3,7,"PUM+J",0
45,"45070",1406,1201,1188,4,13,"PUM+J",5
26,"26089",111800,87863,86778,700,1085,"PUM+J",108
44,"44219",173,142,136,1,6,"PUM+J",0
4,"4064",2879,2196,2179,12,17,"PUM+J",0
19,"19218",45,34,34,1,0,"PUM+J",0
14,"14022",3886,3080,3043,18,37,"PUM+J",0
28,"28014",34047,26858,26575,178,283,"PUM+J",29
40,"40019",29,26,26,0,0,"PUM+J",0
49,"49142",249,175,173,0,2,"PUM+J",0
49,"49156",230,189,182,0,7,"PUM+J",1
44,"44019",68,42,42,0,0,"PUM+J",0
34,"34004",5533,4345,4286,41,59,"PUM+J",11
9,"9020",237,184,180,5,4,"PUM+J",0
9,"9228",157,136,136,0,0,"PUM+J",0
26,"26130",201,164,163,0,1,"PUM+J",1
45,"45072",661,525,517,3,8,"PUM+J",1
47,"47148",423,342,339,2,3,"PUM+J",1
9,"9137",180,149,147,1,2,"PUM+J",1
29,"29030",774,660,657,3,3,"PUM+J",0
16,"16131",127,90,90,1,0,"PUM+J",1
32,"32064",480,348,346,2,2,"PUM+J",0
40,"40091",108,93,93,1,0,"PUM+J",0
16,"16007",1159,975,968,10,7,"PUM+J",1
31,"31176",2930,2204,2134,33,70,"PUM+J",11
5,"5210",79,57,57,0,0,"PUM+J",1
28,"28078",40,37,37,0,0,"PUM+J",0
40,"40069",74,65,65,0,0,"PUM+J",0
18,"18164",1794,1225,1205,9,20,"PUM+J",0
23,"23025",2727,2125,2090,8,35,"PUM+J",0
5,"5236",106,77,77,0,0,"PUM+J",0
38,"38033",3594,2512,2467,11,45,"PUM+J",3
2,"2028",118,99,98,4,1,"PUM+J",0
37,"37348",100,79,79,0,0,"PUM+J",0
16,"16227",108,85,85,1,0,"PUM+J",0
49,"49108",454,325,322,2,3,"PUM+J",1
42,"42063",47,31,28,0,3,"PUM+J",0
45,"45166",1564,1298,1279,6,19,"PUM+J",2
5,"5160",296,236,232,1,4,"PUM+J",0
9,"9249",50,39,39,0,0,"PUM+J",0
26,"26147",34,30,29,0,1,"PUM+J",0
50,"50228",250,217,214,3,3,"PUM+J",2
39,"39093",302,256,256,2,0,"PUM+J",0
50,"50172",178,134,131,3,3,"PUM+J",0
49,"49186",235,181,178,4,3,"PUM+J",0
29,"29089",3161,2477,2426,19,51,"PUM+J",0
37,"37097",44,29,29,0,0,"PUM+J",0
24,"24062",130,90,90,2,0,"PUM+J",0
28,"28018",4068,3367,3344,15,23,"PUM+J",6
37,"37237",304,238,234,0,4,"PUM+J",0
16,"16176",31,22,22,0,0,"PUM+J",0
19,"19224",102,91,90,1,1,"PUM+J",0
19,"19179",76,66,64,1,2,"PUM+J",0
24,"24225",992,762,751,5,11,"PUM+J",0
40,"40094",364,284,279,1,5,"PUM+J",1
5,"5044",250,189,189,1,0,"PUM+J",0
32,"32066",551,399,396,1,3,"PUM+J",1
42,"42204",54,45,43,2,2,"PUM+J",0
37,"37040",382,319,316,1,3,"PUM+J",0
32,"32048",864,550,544,1,6,"PUM+J",0
44,"44173",102,85,80,0,5,"PUM+J",0
50,"50143",546,409,401,5,8,"PUM+J",0
39,"39038",1506,1093,1076,2,17,"PUM+J",0
22,"22016",566,423,420,4,3,"PUM+J",1
18,"18134",6069,4431,4345,30,86,"PUM+J",8
34,"34133",105,88,86,1,2,"PUM+J",0
24,"24025",289,234,226,4,8,"PUM+J",0
49,"49272",77,55,51,0,4,"PUM+J",0
40,"40903",77,63,62,0,1,"PUM+J",0
45,"45094",367,290,288,4,2,"PUM+J",0
5,"5240",3323,2389,2346,16,43,"PUM+J",3
44,"44195",84,66,65,1,1,"PUM+J",0
39,"39058",800,574,573,1,1,"PUM+J",0
16,"16137",37,27,25,0,2,"PUM+J",0
9,"9045",274,199,196,1,3,"PUM+J",1
37,"37353",122,95,95,1,0,"PUM+J",0
6,"6007",1433,1078,1071,5,7,"PUM+J",0
22,"22905",287,226,224,2,2,"PUM+J",0
34,"34074",683,545,540,4,5,"PUM+J",0
45,"45125",2263,1871,1842,10,29,"PUM+J",3
19,"19018",141,112,110,0,2,"PUM+J",0
48,"48095",2326,1691,1680,11,11,"PUM+J",2
22,"22249",118,93,93,2,0,"PUM+J",0
9,"9202",22,22,22,2,0,"PUM+J",0
37,"37342",255,200,199,1,1,"PUM+J",0
33,"33006",1480,1001,992,9,9,"PUM+J",2
22,"22182",233,178,174,1,4,"PUM+J",0
29,"29037",215,179,179,0,0,"PUM+J",1
44,"44065",57,37,36,0,1,"PUM+J",0
34,"34185",68,53,51,1,2,"PUM+J",0
9,"9014",192,143,142,0,1,"PUM+J",0
5,"5075",99,79,79,1,0,"PUM+J",0
12,"12074",761,659,645,7,14,"PUM+J",0
32,"32070",512,307,304,8,3,"PUM+J",0
39,"39097",679,437,435,2,2,"PUM+J",0
22,"22019",175,151,151,0,0,"PUM+J",0
31,"31171",669,516,502,3,14,"PUM+J",0
26,"26025",89,77,77,0,0,"PUM+J",0
6,"6043",686,553,544,6,9,"PUM+J",0
26,"26179",41,33,32,0,1,"PUM+J",0
23,"23063",3764,2812,2781,22,31,"PUM+J",0
44,"44165",173,136,135,2,1,"PUM+J",0
5,"5049",410,310,305,3,5,"PUM+J",1
16,"16055",679,478,477,4,1,"PUM+J",0
47,"47185",87,77,77,0,0,"PUM+J",0
12,"12132",484,415,412,4,3,"PUM+J",0
9,"9225",81,62,62,0,0,"PUM+J",0
42,"42195",92,53,53,1,0,"PUM+J",0
39,"39070",123,101,99,0,2,"PUM+J",1
16,"16043",88,71,71,1,0,"PUM+J",0
5,"5038",113,89,88,0,1,"PUM+J",0
41,"41037",3192,2505,2479,15,26,"PUM+J",1
12,"12133",60,53,52,1,1,"PUM+J",0
12,"12012",2613,2217,2180,6,37,"PUM+J",3
20,"20901",1412,1034,1030,2,4,"PUM+J",0
44,"44046",43,32,32,0,0,"PUM+J",0
44,"44037",449,334,331,1,3,"PUM+J",0
41,"41001",1565,1224,1213,8,11,"PUM+J",1
42,"42211",81,74,73,2,1,"PUM+J",0
32,"32044",809,625,617,2,8,"PUM+J",0
2,"2036",95,75,75,0,0,"PUM+J",0
47,"47156",150,128,128,2,0,"PUM+J",0
23,"23034",2490,2033,1999,15,34,"PUM+J",1
29,"29007",28584,21525,21318,202,207,"PUM+J",28
23,"23033",1319,1076,1057,8,19,"PUM+J",1
44,"44168",184,137,136,4,1,"PUM+J",0
37,"37107",10483,7732,7633,78,99,"PUM+J",7
12,"12045",328,275,271,2,4,"PUM+J",1
2,"2037",22952,16040,15815,101,225,"PUM+J",19
41,"41002",1427,1057,1024,5,33,"PUM+J",0
12,"12134",135,102,100,0,2,"PUM+J",0
16,"16006",110,99,98,1,1,"PUM+J",1
37,"37195",37,29,29,1,0,"PUM+J",0
41,"41093",19012,15637,15525,97,112,"PUM+J",23
44,"44190",65,45,43,0,2,"PUM+J",0
35,"35023",11694,8785,8607,67,178,"PUM+J",8
48,"48018",867,605,603,3,2,"PUM+J",0
9,"9103",200,179,179,1,0,"PUM+J",0
19,"19044",284,226,223,1,3,"PUM+J",0
50,"50061",193,173,169,1,4,"PUM+J",0
38,"38012",2310,1705,1687,6,18,"PUM+J",2
45,"45179",495,383,382,3,1,"PUM+J",1
5,"5054",1203,946,927,5,19,"PUM+J",0
19,"19234",45,32,32,0,0,"PUM+J",0
47,"47168",30,29,29,0,0,"PUM+J",0
26,"26106",76,66,65,0,1,"PUM+J",0
16,"16060",722,571,560,3,11,"PUM+J",1
18,"18152",906,692,686,1,6,"PUM+J",0
40,"40174",324,254,250,2,4,"PUM+J",0
24,"24155",442,374,371,6,3,"PUM+J",2
39,"39045",351,280,277,1,3,"PUM+J",0
5,"5094",132,109,108,1,1,"PUM+J",0
32,"32046",1098,793,782,5,11,"PUM+J",3
28,"28056",914,715,703,4,12,"PUM+J",1
42,"42216",26,20,20,1,0,"PUM+J",0
45,"45042",183,141,137,0,4,"PUM+J",0
37,"37361",81,63,61,0,2,"PUM+J",0
5,"5211",430,364,357,6,7,"PUM+J",0
24,"24114",2893,2017,1989,17,28,"PUM+J",2
45,"45043",783,670,664,6,6,"PUM+J",2
22,"22162",129,99,99,0,0,"PUM+J",0
7,"7016",2931,2201,2178,31,23,"PUM+J",1
6,"6114",127,109,108,0,1,"PUM+J",0
40,"40070",148,110,107,1,3,"PUM+J",1
34,"34180",64,55,55,2,0,"PUM+J",1
47,"47232",100,76,76,1,0,"PUM+J",0
9,"9405",129,99,97,1,2,"PUM+J",0
38,"38024",15310,10234,10088,82,146,"PUM+J",8
34,"34132",107,84,83,0,1,"PUM+J",0
24,"24115",53267,39733,39172,433,561,"PUM+J",70
5,"5135",398,324,320,2,4,"PUM+J",0
34,"34233",128,118,117,2,1,"PUM+J",1
18,"18144",803,650,640,2,10,"PUM+J",0
9,"9269",29,25,23,1,2,"PUM+J",0
28,"28028",1820,1493,1483,8,10,"PUM+J",3
40,"40035",135,111,110,0,1,"PUM+J",0
44,"44075",326,275,263,0,12,"PUM+J",0
18,"18179",503,346,343,3,3,"PUM+J",0
37,"37327",179,154,150,0,4,"PUM+J",0
37,"37027",235,188,184,2,4,"PUM+J",0
29,"29056",1061,783,772,4,11,"PUM+J",1
20,"20037",103,77,77,0,0,"PUM+J",0
50,"50277",49,37,37,3,0,"PUM+J",0
32,"32021",874,616,615,4,1,"PUM+J",1
42,"42176",27,22,22,2,0,"PUM+J",0
48,"48023",580,493,489,0,4,"PUM+J",0
20,"20068",188,142,142,1,0,"PUM+J",0
28,"28060",1565,1262,1247,5,15,"PUM+J",1
28,"28135",985,762,756,1,6,"PUM+J",2
20,"20028",2258,1579,1574,9,5,"PUM+J",1
37,"37004",24,19,19,0,0,"PUM+J",0
9,"9221",492,413,409,0,4,"PUM+J",2
9,"9220",70,59,58,0,1,"PUM+J",0
31,"31006",1877,1453,1436,16,17,"PUM+J",3
24,"24214",634,473,471,3,2,"PUM+J",0
26,"26111",250,209,205,2,4,"PUM+J",0
12,"12009",17859,13054,12911,98,143,"PUM+J",21
44,"44076",2110,1725,1691,22,34,"PUM+J",1
38,"38047",1756,1276,1259,6,17,"PUM+J",0
40,"40004",445,348,341,0,7,"PUM+J",0
47,"47036",205,162,157,1,5,"PUM+J",0
50,"50202",131,90,88,1,2,"PUM+J",0
37,"37139",187,162,157,2,5,"PUM+J",0
40,"40083",72,53,51,3,2,"PUM+J",0
23,"23084",907,685,670,0,15,"PUM+J",1
44,"44004",379,312,310,5,2,"PUM+J",0
49,"49223",716,552,548,0,4,"PUM+J",0
44,"44153",1749,1264,1243,11,21,"PUM+J",0
5,"5257",135,104,104,0,0,"PUM+J",1
19,"19154",59,48,47,0,1,"PUM+J",0
4,"4020",286,218,217,1,1,"PUM+J",0
26,"26049",153,115,115,1,0,"PUM+J",0
19,"19319",4583,3640,3585,24,55,"PUM+J",5
29,"29082",34113,26248,26002,304,246,"PUM+J",41
49,"49205",367,286,282,5,4,"PUM+J",1
29,"29070",43090,30294,29928,243,366,"PUM+J",43
19,"19004",59,52,52,0,0,"PUM+J",0
24,"24015",2209,1714,1672,19,42,"PUM+J",2
22,"22236",236,207,203,2,4,"PUM+J",0
9,"9172",168,132,132,1,0,"PUM+J",0
24,"24203",95,72,72,0,0,"PUM+J",1
6,"6153",20240,15464,15210,134,254,"PUM+J",15
16,"16198",1299,1044,1027,11,17,"PUM+J",0
18,"18011",4376,3286,3248,18,38,"PUM+J",7
49,"49007",365,271,265,7,6,"PUM+J",0
37,"37142",566,446,444,6,2,"PUM+J",1
49,"49191",266,216,214,1,2,"PUM+J",0
31,"31091",327,224,224,1,0,"PUM+J",0
45,"45005",227,180,174,5,6,"PUM+J",0
4,"4022",357,261,261,0,0,"PUM+J",0
32,"32080",286,223,220,1,3,"PUM+J",0
45,"45159",85,75,74,0,1,"PUM+J",0
39,"39089",134,99,98,0,1,"PUM+J",0
45,"45022",393,290,288,3,2,"PUM+J",1
5,"5051",162,135,131,0,4,"PUM+J",0
22,"22069",418,337,334,5,3,"PUM+J",0
6,"6010",1075,859,846,8,13,"PUM+J",0
26,"26003",389,329,328,1,1,"PUM+J",0
50,"50096",36,22,22,0,0,"PUM+J",0
22,"22157",183,136,134,1,2,"PUM+J",0
49,"49090",193,153,151,0,2,"PUM+J",0
31,"31903",6862,4962,4915,31,47,"PUM+J",18
49,"49061",145,111,108,0,3,"PUM+J",0
9,"9356",43,36,36,0,0,"PUM+J",0
22,"22072",194,141,140,0,1,"PUM+J",0
2,"2012",1825,1541,1509,8,32,"PUM+J",0
37,"37061",207,160,160,0,0,"PUM+J",0
50,"50051",800,615,608,3,7,"PUM+J",0
42,"42059",20,13,13,0,0,"PUM+J",0
45,"45193",589,512,507,6,5,"PUM+J",0
26,"26157",282,233,232,1,1,"PUM+J",1
5,"5078",100,87,86,0,1,"PUM+J",0
12,"12004",4177,3225,3187,13,38,"PUM+J",3
45,"45131",264,226,225,0,1,"PUM+J",1
44,"44179",325,233,231,7,2,"PUM+J",0
49,"49209",474,338,334,4,4,"PUM+J",0
9,"9194",1969,1526,1511,14,15,"PUM+J",4
40,"40078",151,123,122,2,1,"PUM+J",0
22,"22203",76,61,61,0,0,"PUM+J",0
16,"16033",1644,1345,1320,11,25,"PUM+J",1
9,"9123",43,39,38,0,1,"PUM+J",0
31,"31906",2683,2040,2023,28,17,"PUM+J",6
19,"19293",1905,1513,1499,10,14,"PUM+J",1
44,"44085",49,31,31,0,0,"PUM+J",0
26,"26119",177,150,147,2,3,"PUM+J",1
49,"49228",55,47,47,0,0,"PUM+J",0
9,"9006",59,37,36,1,1,"PUM+J",0
9,"9398",74,59,58,1,1,"PUM+J",0
9,"9055",48,34,34,1,0,"PUM+J",0
49,"49131",238,182,178,0,4,"PUM+J",0
9,"9022",61,54,54,0,0,"PUM+J",1
2,"2015",1433,1234,1214,7,20,"PUM+J",1
24,"24047",720,531,523,2,8,"PUM+J",0
19,"19249",28,28,28,0,0,"PUM+J",0
12,"12079",419,346,336,2,10,"PUM+J",0
9,"9400",310,250,247,4,3,"PUM+J",0
34,"34147",160,125,124,1,1,"PUM+J",1
6,"6092",555,428,419,3,9,"PUM+J",0
48,"48061",799,636,636,2,0,"PUM+J",0
38,"38053",3763,2628,2588,21,40,"PUM+J",2
42,"42037",29,19,18,0,1,"PUM+J",0
48,"48001",5885,4359,4334,35,25,"PUM+J",3
31,"31260",1249,904,901,15,3,"PUM+J",5
39,"39075",136968,104358,103487,690,871,"PUM+J",72
41,"41096",6134,4926,4845,44,81,"PUM+J",7
20,"20077",5254,4083,4059,22,24,"PUM+J",3
44,"44062",31,24,23,1,1,"PUM+J",0
49,"49066",449,319,314,4,5,"PUM+J",0
45,"45105",380,284,275,2,9,"PUM+J",1
4,"4056",164,135,133,1,2,"PUM+J",0
42,"42145",134,108,108,0,0,"PUM+J",0
39,"39085",6964,5489,5445,28,44,"PUM+J",3
20,"20067",30618,21972,21854,138,118,"PUM+J",21
45,"45061",2485,1850,1822,7,28,"PUM+J",4
41,"41051",2311,1770,1734,5,36,"PUM+J",0
29,"29012",9718,7243,7123,47,120,"PUM+J",5
16,"16121",233,183,179,0,4,"PUM+J",0
50,"50102",820,653,642,9,11,"PUM+J",1
23,"23016",384,316,311,0,5,"PUM+J",1
47,"47151",28,22,22,0,0,"PUM+J",0
48,"48012",2071,1685,1674,7,11,"PUM+J",3
47,"47055",192,157,154,1,3,"PUM+J",0
19,"19299",102,78,78,1,0,"PUM+J",0
7,"7029",4366,3270,3229,25,41,"PUM+J",4
31,"31113",127,84,83,1,1,"PUM+J",0
42,"42162",2325,1721,1699,16,22,"PUM+J",1
31,"31249",1823,1381,1373,21,8,"PUM+J",2
4,"4018",252,215,213,1,2,"PUM+J",0
41,"41043",667,475,453,3,22,"PUM+J",0
37,"37328",164,127,127,4,0,"PUM+J",0
18,"18029",1813,1183,1169,9,14,"PUM+J",2
5,"5085",30,27,27,0,0,"PUM+J",0
29,"29002",1150,851,842,4,9,"PUM+J",0
39,"39039",546,431,428,0,3,"PUM+J",0
31,"31236",1318,958,950,8,8,"PUM+J",4
9,"9408",42,33,33,0,0,"PUM+J",0
47,"47047",202,164,161,3,3,"PUM+J",0
48,"48065",3303,2541,2524,15,17,"PUM+J",1
9,"9295",54,38,38,0,0,"PUM+J",0
2,"2056",1643,1330,1308,4,22,"PUM+J",1
49,"49005",128,87,85,1,2,"PUM+J",0
24,"24092",745,606,601,6,5,"PUM+J",1
28,"28070",113,94,94,2,0,"PUM+J",0
32,"32059",1703,1248,1228,12,20,"PUM+J",1
18,"18193",14802,11165,10973,110,192,"PUM+J",19
48,"48014",1242,915,910,4,5,"PUM+J",0
28,"28051",1640,1301,1292,9,9,"PUM+J",1
34,"34208",47,38,38,0,0,"PUM+J",0
31,"31034",31,27,26,0,1,"PUM+J",0
16,"16140",19,16,16,0,0,"PUM+J",0
26,"26113",31,30,30,0,0,"PUM+J",0
34,"34238",305,261,260,2,1,"PUM+J",0
41,"41008",1040,840,822,4,18,"PUM+J",1
16,"16125",1599,1314,1295,9,19,"PUM+J",0
28,"28072",6088,5001,4961,23,40,"PUM+J",9
22,"22168",23,21,20,0,1,"PUM+J",0
5,"5048",106,98,94,1,4,"PUM+J",0
5,"5155",46,36,36,0,0,"PUM+J",0
44,"44054",94,79,79,0,0,"PUM+J",0
18,"18053",1561,1102,1099,3,3,"PUM+J",3
37,"37117",1553,1245,1230,14,15,"PUM+J",1
19,"19303",40,35,35,0,0,"PUM+J",0
31,"31239",281,215,212,7,3,"PUM+J",0
20,"20041",234,156,151,2,5,"PUM+J",0
34,"34107",73,54,54,2,0,"PUM+J",0
44,"44045",368,302,298,8,4,"PUM+J",0
31,"31226",574,380,377,3,3,"PUM+J",0
22,"22226",771,598,591,6,7,"PUM+J",0
26,"26127",186,162,159,1,3,"PUM+J",0
5,"5159",228,160,159,2,1,"PUM+J",0
22,"22170",668,529,520,4,9,"PUM+J",1
49,"49225",127,81,81,0,0,"PUM+J",1
49,"49237",143,95,93,0,2,"PUM+J",0
41,"41065",22550,16215,16010,189,205,"PUM+J",19
33,"33038",2234,1669,1644,16,25,"PUM+J",1
24,"24205",981,744,732,8,12,"PUM+J",0
39,"39098",1379,1154,1144,7,10,"PUM+J",1
12,"12114",194,161,160,2,1,"PUM+J",0
47,"47050",3898,3084,3047,36,37,"PUM+J",2
9,"9079",48,42,42,1,0,"PUM+J",0
37,"37233",56,46,46,2,0,"PUM+J",2
42,"42183",106,83,83,1,0,"PUM+J",0
16,"16242",308,266,263,2,3,"PUM+J",0
44,"44156",46,36,33,1,3,"PUM+J",0
7,"7045",1300,1038,1030,6,8,"PUM+J",3
12,"12056",257,218,216,1,2,"PUM+J",0
31,"31255",103,87,84,0,3,"PUM+J",0
24,"24122",1319,983,969,3,14,"PUM+J",1
44,"44027",149,120,119,0,1,"PUM+J",0
34,"34228",76,62,62,0,0,"PUM+J",0
48,"48079",395,313,312,2,1,"PUM+J",0
33,"33050",558,381,375,2,6,"PUM+J",0
12,"12013",137,113,113,0,0,"PUM+J",0
5,"5040",64,51,51,1,0,"PUM+J",0
45,"45025",1219,926,913,5,13,"PUM+J",0
26,"26118",72,63,60,1,3,"PUM+J",0
9,"9084",167,132,127,4,5,"PUM+J",1
28,"28153",795,566,564,5,2,"PUM+J",7
47,"47052",6752,5665,5589,57,76,"PUM+J",6
42,"42108",10,7,7,0,0,"PUM+J",0
22,"22254",1094,857,850,11,7,"PUM+J",1
34,"34216",60,46,46,0,0,"PUM+J",0
9,"9247",22,18,18,0,0,"PUM+J",0
37,"37036",57,42,41,0,1,"PUM+J",0
23,"23067",2421,1909,1873,13,36,"PUM+J",0
44,"44096",153,120,112,1,8,"PUM+J",0
18,"18003",14413,11095,10883,92,212,"PUM+J",15
9,"9230",33,28,28,0,0,"PUM+J",0
16,"16191",858,707,701,8,6,"PUM+J",0
2,"2031",541,432,425,0,7,"PUM+J",0
32,"32009",10590,7661,7574,68,87,"PUM+J",8
42,"42024",86,66,66,3,0,"PUM+J",0
50,"50053",650,505,497,4,8,"PUM+J",0
6,"6103",4753,3656,3598,35,58,"PUM+J",22
20,"20045",46866,33932,33700,191,232,"PUM+J",63
22,"22901",714,521,508,3,13,"PUM+J",1
45,"45119",3485,2478,2430,21,48,"PUM+J",1
24,"24180",1101,844,833,8,11,"PUM+J",0
41,"41050",5180,4217,4149,34,68,"PUM+J",2
48,"48021",1336,990,983,4,7,"PUM+J",0
49,"49256",242,204,202,4,2,"PUM+J",0
39,"39102",2255,1711,1698,11,13,"PUM+J",2
40,"40220",62,48,48,0,0,"PUM+J",0
12,"12006",174,149,149,2,0,"PUM+J",0
24,"24196",1918,1446,1422,9,24,"PUM+J",2
29,"29043",2474,1764,1720,25,44,"PUM+J",1
6,"6104",656,530,524,6,6,"PUM+J",2
6,"6126",2142,1619,1594,9,25,"PUM+J",2
26,"26135",153,123,123,1,0,"PUM+J",0
39,"39065",232,190,189,5,1,"PUM+J",0
32,"32010",360,276,273,3,3,"PUM+J",0
45,"45029",188,160,159,0,1,"PUM+J",0
9,"9251",365,278,277,0,1,"PUM+J",1
19,"19082",99,76,75,0,1,"PUM+J",0
50,"50267",573,440,434,7,6,"PUM+J",0
37,"37001",172,133,133,0,0,"PUM+J",0
48,"48906",753,611,608,1,3,"PUM+J",0
37,"37054",238,200,196,3,4,"PUM+J",0
2,"2066",223,172,169,1,3,"PUM+J",0
7,"7050",3442,2303,2275,28,28,"PUM+J",3
40,"40108",110,91,90,0,1,"PUM+J",0
31,"31139",155,105,105,0,0,"PUM+J",0
14,"14027",7876,6227,6103,81,124,"PUM+J",6
41,"41052",3027,2357,2288,14,69,"PUM+J",2
49,"49122",778,586,573,6,13,"PUM+J",2
7,"7040",288348,192799,191053,1586,1746,"PUM+J",258
22,"22006",272,206,201,2,5,"PUM+J",0
20,"20078",1145,882,879,4,3,"PUM+J",0
44,"44101",51,43,42,1,1,"PUM+J",0
22,"22137",1015,741,733,9,8,"PUM+J",0
26,"26010",85,68,68,1,0,"PUM+J",0
34,"34088",264,211,207,1,4,"PUM+J",0
50,"50154",116,98,98,0,0,"PUM+J",0
47,"47224",97,74,74,0,0,"PUM+J",0
16,"16051",126,102,100,0,2,"PUM+J",0
16,"16901",630,498,492,4,6,"PUM+J",0
7,"7041",2097,1662,1634,20,28,"PUM+J",0
12,"12120",161,138,138,0,0,"PUM+J",0
40,"40201",43,39,37,0,2,"PUM+J",0
31,"31250",2748,1995,1982,21,13,"PUM+J",4
22,"22018",308,234,232,2,2,"PUM+J",0
32,"32087",1675,1313,1288,18,25,"PUM+J",2
29,"29058",1538,1079,1062,5,17,"PUM+J",3
33,"33059",4403,3007,2942,42,65,"PUM+J",2
37,"37245",335,240,240,5,0,"PUM+J",0
42,"42016",20,13,13,0,0,"PUM+J",0
40,"40122",525,442,434,2,8,"PUM+J",0
6,"6162",2895,2289,2254,11,35,"PUM+J",1
7,"7009",741,554,544,4,10,"PUM+J",0
45,"45034",1291,1066,1039,7,27,"PUM+J",2
28,"28001",80,64,64,0,0,"PUM+J",0
19,"19070",67,53,51,0,2,"PUM+J",0
23,"23085",2182,1733,1717,7,16,"PUM+J",1
12,"12112",110,97,96,1,1,"PUM+J",0
45,"45004",552,434,434,4,0,"PUM+J",3
32,"32088",1610,1040,1019,11,21,"PUM+J",0
22,"22906",174,137,134,5,3,"PUM+J",0
19,"19302",52,43,41,1,2,"PUM+J",0
9,"9258",171,142,141,2,1,"PUM+J",0
45,"45035",293,228,223,1,5,"PUM+J",0
16,"16098",520,441,439,6,2,"PUM+J",0
16,"16239",118,89,88,0,1,"PUM+J",0
45,"45173",9729,7664,7558,46,106,"PUM+J",7
34,"34033",17,15,15,0,0,"PUM+J",0
24,"24150",224,176,174,2,2,"PUM+J",0
5,"5128",342,274,267,1,7,"PUM+J",1
24,"24095",307,237,235,0,2,"PUM+J",0
44,"44006",223,171,169,2,2,"PUM+J",0
40,"40215",83,69,69,0,0,"PUM+J",0
9,"9345",117,96,95,1,1,"PUM+J",0
12,"12098",533,446,440,4,6,"PUM+J",0
44,"44266",102,89,86,1,3,"PUM+J",0
5,"5192",93,81,78,0,3,"PUM+J",0
41,"41046",3006,2464,2427,13,37,"PUM+J",1
44,"44187",193,155,151,1,4,"PUM+J",0
44,"44208",26,22,22,0,0,"PUM+J",0
32,"32071",1378,963,954,7,9,"PUM+J",0
5,"5259",106,87,87,0,0,"PUM+J",0
41,"41028",2071,1741,1713,18,28,"PUM+J",1
2,"2072",1525,1146,1112,4,34,"PUM+J",0
33,"33039",1641,1251,1243,6,8,"PUM+J",0
45,"45038",3505,2749,2705,16,44,"PUM+J",3
2,"2024",3374,2657,2613,23,44,"PUM+J",2
42,"42051",15,10,10,0,0,"PUM+J",0
18,"18083",228,189,188,1,1,"PUM+J",0
16,"16101",139,123,122,0,1,"PUM+J",0
20,"20063",8061,6042,5999,36,43,"PUM+J",3
16,"16044",43,31,30,0,1,"PUM+J",0
49,"49168",93,74,74,0,0,"PUM+J",0
26,"26004",66,54,54,0,0,"PUM+J",0
50,"50129",213,151,149,5,2,"PUM+J",0
42,"42213",25,16,16,0,0,"PUM+J",0
24,"24110",1154,895,880,5,15,"PUM+J",1
18,"18150",6903,5149,5063,42,86,"PUM+J",3
42,"42185",25,20,20,0,0,"PUM+J",0
49,"49143",194,141,135,2,6,"PUM+J",0
22,"22127",529,434,432,4,2,"PUM+J",2
45,"45177",2023,1693,1651,11,42,"PUM+J",3
26,"26144",188,161,160,1,1,"PUM+J",0
49,"49240",185,141,136,0,5,"PUM+J",0
34,"34127",80,64,64,1,0,"PUM+J",0
33,"33071",563,413,407,2,6,"PUM+J",2
2,"2075",1718,1470,1448,4,22,"PUM+J",4
16,"16190",4957,4006,3945,36,61,"PUM+J",1
4,"4013",143321,101501,100814,750,687,"PUM+J",141
19,"19307",26,23,23,0,0,"PUM+J",0
18,"18176",241,182,180,0,2,"PUM+J",0
5,"5093",353,275,269,0,6,"PUM+J",1
7,"7018",379,287,286,1,1,"PUM+J",1
16,"16108",43,40,39,1,1,"PUM+J",0
42,"42028",76,65,65,1,0,"PUM+J",1
44,"44071",585,449,447,6,2,"PUM+J",1
24,"24074",96,73,73,0,0,"PUM+J",0
2,"2039",952,798,789,9,9,"PUM+J",0
37,"37336",52,46,45,3,1,"PUM+J",0
45,"45181",2337,1846,1818,7,28,"PUM+J",0
37,"37172",853,601,590,4,11,"PUM+J",2
22,"22190",122,89,89,0,0,"PUM+J",0
18,"18143",949,757,740,5,17,"PUM+J",4
40,"40010",111,95,94,0,1,"PUM+J",1
40,"40208",720,592,585,4,7,"PUM+J",0
28,"28037",1578,1196,1180,5,16,"PUM+J",0
7,"7030",1590,1234,1202,8,32,"PUM+J",1
5,"5156",234,153,151,0,2,"PUM+J",0
16,"16263",966,763,755,2,8,"PUM+J",0
39,"39094",841,676,670,3,6,"PUM+J",0
40,"40176",375,325,322,6,3,"PUM+J",0
16,"16279",174,125,125,0,0,"PUM+J",0
26,"26122",116,98,97,0,1,"PUM+J",1
49,"49219",7221,5301,5186,62,115,"PUM+J",6
22,"22144",257,207,204,1,3,"PUM+J",0
41,"41061",2144,1763,1712,7,51,"PUM+J",0
40,"40211",69,58,58,1,0,"PUM+J",0
42,"42218",75,52,51,0,1,"PUM+J",0
42,"42052",17,15,15,0,0,"PUM+J",0
12,"12128",1362,1099,1076,9,23,"PUM+J",2
12,"12071",1267,1021,1006,11,15,"PUM+J",1
24,"24157",2545,2028,1972,25,56,"PUM+J",2
31,"31098",1962,1562,1544,14,18,"PUM+J",2
6,"6160",3019,2252,2209,10,43,"PUM+J",1
12,"12138",19179,14217,14006,124,211,"PUM+J",11
39,"39029",636,512,512,5,0,"PUM+J",0
28,"28079",2374366,1872679,1859094,11998,13585,"PUM+J",2650
22,"22247",30,21,21,0,0,"PUM+J",0
29,"29080",6895,5005,4934,59,71,"PUM+J",4
2,"2079",2823,2303,2253,22,50,"PUM+J",6
12,"12110",219,168,166,1,2,"PUM+J",0
45,"45015",662,506,500,2,6,"PUM+J",0
28,"28022",36550,31559,31436,207,123,"PUM+J",31
19,"19322",26,21,21,1,0,"PUM+J",0
24,"24210",527,387,386,0,1,"PUM+J",0
26,"26176",53,48,48,0,0,"PUM+J",0
5,"5164",17,12,12,0,0,"PUM+J",0
37,"37126",30,26,26,0,0,"PUM+J",0
19,"19317",127,98,97,0,1,"PUM+J",0
24,"24227",1548,1148,1128,5,20,"PUM+J",1
41,"41044",7698,5967,5898,59,69,"PUM+J",7
22,"22234",745,587,578,11,9,"PUM+J",0
12,"12130",420,345,341,0,4,"PUM+J",0
5,"5177",139,117,117,0,0,"PUM+J",0
33,"33045",4382,3214,3156,23,58,"PUM+J",0
29,"29069",86694,58863,58127,561,736,"PUM+J",95
44,"44067",108,82,78,0,4,"PUM+J",0
19,"19060",157,128,125,0,3,"PUM+J",0
28,"28074",140580,113723,112489,776,1234,"PUM+J",157
12,"12018",283,242,235,0,7,"PUM+J",0
29,"29051",41793,29275,28764,249,511,"PUM+J",33
28,"28041",4788,4012,3973,23,39,"PUM+J",6
41,"41017",15712,12048,11896,118,152,"PUM+J",16
16,"16026",93,70,68,1,2,"PUM+J",0
6,"6085",3410,2719,2663,28,56,"PUM+J",1
50,"50125",345,264,261,3,3,"PUM+J",0
2,"2082",95,83,83,0,0,"PUM+J",0
40,"40214",196,167,163,1,4,"PUM+J",0
16,"16001",64,51,51,0,0,"PUM+J",0
44,"44123",99,69,69,1,0,"PUM+J",0
50,"50166",236,200,198,1,2,"PUM+J",0
5,"5154",34,25,25,1,0,"PUM+J",0
50,"50057",1332,1001,986,10,15,"PUM+J",0
37,"37379",173,152,152,0,0,"PUM+J",0
5,"5258",107,96,96,2,0,"PUM+J",0
19,"19053",1929,1472,1458,9,14,"PUM+J",1
9,"9224",159,135,132,0,3,"PUM+J",0
37,"37217",59,48,46,1,2,"PUM+J",0
37,"37019",140,118,117,1,1,"PUM+J",0
50,"50186",37,28,28,0,0,"PUM+J",0
24,"24107",214,170,170,2,0,"PUM+J",0
12,"12011",4582,3511,3431,27,80,"PUM+J",4
34,"34177",176,154,152,2,2,"PUM+J",1
48,"48050",187,153,149,0,4,"PUM+J",0
16,"16135",118,86,85,0,1,"PUM+J",0
19,"19010",9,10,10,0,0,"PUM+J",0
20,"20065",2943,2145,2124,11,21,"PUM+J",0
16,"16126",729,622,616,5,6,"PUM+J",3
9,"9411",154,118,118,0,0,"PUM+J",0
31,"31254",1920,1457,1435,8,22,"PUM+J",7
45,"45053",7834,6440,6333,46,107,"PUM+J",4
37,"37143",375,308,306,2,2,"PUM+J",1
31,"31228",494,383,382,0,1,"PUM+J",1
12,"12105",816,639,625,5,14,"PUM+J",0
19,"19289",23,19,19,0,0,"PUM+J",0
34,"34241",18,17,14,4,3,"PUM+J",1
32,"32056",1520,1125,1116,6,9,"PUM+J",0
44,"44089",52,44,44,0,0,"PUM+J",0
39,"39043",1523,1246,1220,10,26,"PUM+J",0
24,"24152",447,301,296,1,5,"PUM+J",1
44,"44267",71,53,52,0,1,"PUM+J",0
18,"18162",929,730,719,4,11,"PUM+J",1
37,"37182",78,57,57,0,0,"PUM+J",0
37,"37157",78,64,64,0,0,"PUM+J",0
31,"31904",1561,1139,1130,7,9,"PUM+J",6
50,"50159",641,527,526,8,1,"PUM+J",0
49,"49129",821,628,616,5,12,"PUM+J",0
22,"22187",294,244,243,2,1,"PUM+J",0
7,"7035",1596,1242,1234,13,8,"PUM+J",1
19,"19008",37,32,32,1,0,"PUM+J",0
44,"44116",76,62,62,0,0,"PUM+J",0
31,"31905",2968,2253,2236,21,17,"PUM+J",12
29,"29052",222,156,153,2,3,"PUM+J",0
37,"37221",394,299,299,2,0,"PUM+J",0
16,"16259",27,22,21,0,1,"PUM+J",0
42,"42107",67,48,48,0,0,"PUM+J",0
9,"9229",183,136,136,2,0,"PUM+J",1
31,"31108",1829,1460,1437,16,23,"PUM+J",1
20,"20074",11503,8767,8720,26,47,"PUM+J",4
40,"40155",3835,3165,3121,43,44,"PUM+J",5
18,"18069",497,374,366,4,8,"PUM+J",0
9,"9235",140,105,102,0,3,"PUM+J",0
5,"5163",1705,1360,1345,4,15,"PUM+J",0
34,"34240",87,65,63,3,2,"PUM+J",0
49,"49203",287,229,223,2,6,"PUM+J",0
38,"38046",9271,7297,7212,53,85,"PUM+J",5
14,"14014",2509,2071,2030,7,41,"PUM+J",6
42,"42012",29,23,23,0,0,"PUM+J",0
44,"44158",1166,921,904,7,17,"PUM+J",1
44,"44180",72,61,61,0,0,"PUM+J",0
16,"16034",155,124,122,1,2,"PUM+J",0
26,"26120",1460,1130,1109,3,21,"PUM+J",3
28,"28007",126831,103108,102202,710,906,"PUM+J",135
9,"9416",60,44,44,0,0,"PUM+J",0
24,"24168",439,365,360,3,5,"PUM+J",0
44,"44024",28,25,24,0,1,"PUM+J",0
19,"19006",757,556,548,7,8,"PUM+J",0
37,"37119",95,78,77,0,1,"PUM+J",0
6,"6066",1725,1297,1286,9,11,"PUM+J",0
5,"5233",226,198,197,0,1,"PUM+J",0
50,"50088",282,233,227,2,6,"PUM+J",0
31,"31011",709,515,511,4,4,"PUM+J",1
50,"50903",2238,1750,1732,11,18,"PUM+J",1
24,"24022",306,227,224,1,3,"PUM+J",0
37,"37338",78,66,64,0,2,"PUM+J",0
14,"14016",1283,1005,994,4,11,"PUM+J",4
49,"49014",116,89,88,2,1,"PUM+J",0
16,"16036",122,98,97,1,1,"PUM+J",0
34,"34116",55,45,45,0,0,"PUM+J",0
45,"45151",546,434,431,0,3,"PUM+J",0
22,"22246",71,50,50,0,0,"PUM+J",1
22,"22116",1369,1025,1003,8,22,"PUM+J",3
49,"49134",166,111,111,2,0,"PUM+J",0
45,"45092",223,204,204,1,0,"PUM+J",0
47,"47191",115,85,84,0,1,"PUM+J",0
32,"32020",2460,1899,1876,6,23,"PUM+J",2
9,"9908",427,294,290,6,4,"PUM+J",1
41,"41071",5598,3993,3915,34,78,"PUM+J",3
14,"14017",10945,8514,8386,90,128,"PUM+J",4
32,"32061",1070,862,855,8,7,"PUM+J",1
50,"50220",43,37,37,0,0,"PUM+J",0
29,"29071",979,718,712,14,6,"PUM+J",0
7,"7054",22958,14097,13908,123,189,"PUM+J",21
34,"34037",276,224,223,2,1,"PUM+J",1
29,"29042",14447,10383,10199,98,184,"PUM+J",9
42,"42079",21,18,18,1,0,"PUM+J",0
23,"23071",1720,1348,1330,6,18,"PUM+J",0
6,"6051",1543,1206,1188,3,18,"PUM+J",0
6,"6139",502,429,421,5,8,"PUM+J",0
19,"19036",248,213,210,1,3,"PUM+J",0
34,"34168",45,39,39,0,0,"PUM+J",0
28,"28148",88647,70218,69546,570,672,"PUM+J",103
31,"31033",46,29,28,0,1,"PUM+J",0
33,"33056",4877,3469,3420,30,49,"PUM+J",1
28,"28071",64,56,54,0,2,"PUM+J",0
22,"22214",118,98,97,1,1,"PUM+J",0
50,"50237",102,81,81,3,0,"PUM+J",0
12,"12108",438,382,379,4,3,"PUM+J",0
6,"6903",2027,1607,1594,16,13,"PUM+J",1
37,"37104",25,18,18,0,0,"PUM+J",0
2,"2060",1280,1039,1020,5,19,"PUM+J",0
44,"44092",70,56,55,1,1,"PUM+J",0
16,"16013",26,21,20,0,1,"PUM+J",0
6,"6008",613,540,532,0,8,"PUM+J",0
20,"20019",9912,7226,7195,51,31,"PUM+J",6
42,"42164",1589,1201,1172,10,29,"PUM+J",0
19,"19019",14,10,10,0,0,"PUM+J",0
40,"40225",1098,902,882,4,20,"PUM+J",0
23,"23073",4389,3400,3363,13,37,"PUM+J",5
37,"37215",134,97,96,3,1,"PUM+J",0
47,"47143",110,78,78,1,0,"PUM+J",0
18,"18158",8010,5524,5449,23,75,"PUM+J",1
20,"20070",1083,831,823,2,8,"PUM+J",0
40,"40204",151,109,104,1,5,"PUM+J",0
50,"50171",96,78,78,1,0,"PUM+J",0
40,"40086",660,570,548,3,22,"PUM+J",0
2,"2022",344,252,252,1,0,"PUM+J",0
47,"47207",260,213,211,2,2,"PUM+J",0
37,"37304",159,105,105,0,0,"PUM+J",0
35,"35005",1017,751,743,1,8,"PUM+J",3
26,"26002",827,643,639,5,4,"PUM+J",0
28,"28076",425,354,349,3,5,"PUM+J",0
31,"31121",65,51,51,0,0,"PUM+J",0
4,"4030",1066,783,776,5,7,"PUM+J",1
2,"2067",1129,866,852,4,14,"PUM+J",3
44,"44010",184,137,137,1,0,"PUM+J",0
16,"16113",3067,2416,2383,15,33,"PUM+J",1
37,"37155",68,52,52,0,0,"PUM+J",0
26,"26043",349,272,268,2,4,"PUM+J",0
35,"35006",31309,23434,23019,221,415,"PUM+J",40
23,"23098",838,721,715,2,6,"PUM+J",0
22,"22242",63,47,45,1,2,"PUM+J",0
48,"48017",13150,9546,9504,38,42,"PUM+J",2
37,"37077",252,216,213,2,3,"PUM+J",0
35,"35016",300503,203470,201240,1598,2230,"PUM+J",457
33,"33055",1492,1156,1121,6,35,"PUM+J",1
37,"37226",150,119,119,2,0,"PUM+J",0
32,"32053",1363,1114,1098,14,16,"PUM+J",0
22,"22112",9516,7043,6956,84,87,"PUM+J",13
39,"39007",393,300,298,1,2,"PUM+J",0
44,"44199",39,39,38,5,1,"PUM+J",0
24,"24005",345,255,250,2,5,"PUM+J",0
42,"42197",68,56,56,0,0,"PUM+J",0
7,"7024",7294,4213,4160,44,53,"PUM+J",10
29,"29073",1645,1200,1185,13,15,"PUM+J",3
37,"37181",264,185,184,1,1,"PUM+J",0
2,"2085",309,264,263,4,1,"PUM+J",0
28,"28065",130679,106997,105975,762,1022,"PUM+J",134
9,"9052",29,17,17,1,0,"PUM+J",0
45,"45071",1802,1488,1465,0,23,"PUM+J",0
32,"32035",1370,881,872,5,9,"PUM+J",2
22,"22253",57,48,47,0,1,"PUM+J",0
45,"45078",1328,1152,1133,6,19,"PUM+J",0
33,"33064",250,175,174,0,1,"PUM+J",0
24,"24099",155,121,121,1,0,"PUM+J",0
44,"44009",799,621,611,7,10,"PUM+J",1
37,"37234",317,224,222,1,2,"PUM+J",0
50,"50225",1532,1072,1064,10,8,"PUM+J",2
24,"24213",170,140,139,0,1,"PUM+J",0
33,"33024",225188,169937,168490,1483,1447,"PUM+J",218
22,"22164",43,33,31,0,2,"PUM+J",0
5,"5037",219,143,142,2,1,"PUM+J",0
39,"39051",73,65,64,0,1,"PUM+J",0
44,"44213",65,46,46,0,0,"PUM+J",0
47,"47138",219,182,177,1,5,"PUM+J",0
26,"26015",180,145,142,1,3,"PUM+J",0
44,"44118",158,126,122,1,4,"PUM+J",0
50,"50199",325,238,232,3,6,"PUM+J",2
50,"50211",237,177,173,0,4,"PUM+J",1
48,"48043",4539,3566,3556,22,10,"PUM+J",7
47,"47149",45,39,39,1,0,"PUM+J",0
40,"40092",113,86,84,2,2,"PUM+J",0
48,"48010",474,368,368,0,0,"PUM+J",0
16,"16061",941,790,763,8,27,"PUM+J",0
5,"5256",112,94,92,1,2,"PUM+J",0
49,"49154",109,64,63,0,1,"PUM+J",0
26,"26040",63,51,50,0,1,"PUM+J",0
49,"49094",213,138,138,0,0,"PUM+J",0
14,"14019",6408,5163,5086,58,77,"PUM+J",11
42,"42082",7,7,7,0,0,"PUM+J",0
9,"9166",98,77,77,1,0,"PUM+J",0
16,"16156",82,65,65,0,0,"PUM+J",0
9,"9231",59,43,43,1,0,"PUM+J",0
16,"16119",179,128,128,0,0,"PUM+J",0
28,"28156",1084,885,880,6,5,"PUM+J",1
16,"16009",54,49,49,0,0,"PUM+J",0
22,"22052",885,708,702,6,6,"PUM+J",1
6,"6137",933,730,723,5,7,"PUM+J",0
37,"37250",332,232,231,1,1,"PUM+J",0
44,"44002",46,42,42,0,0,"PUM+J",0
37,"37350",404,310,307,0,3,"PUM+J",0
39,"39090",772,619,609,1,10,"PUM+J",0
29,"29098",1235,953,935,12,18,"PUM+J",0
6,"6146",1048,837,819,4,18,"PUM+J",1
18,"18006",4087,3109,3042,28,67,"PUM+J",2
20,"20027",2758,1980,1958,19,22,"PUM+J",1
9,"9098",477,372,360,4,12,"PUM+J",2
41,"41005",9250,6925,6809,69,116,"PUM+J",10
37,"37204",255,197,195,0,2,"PUM+J",0
5,"5103",66,48,48,0,0,"PUM+J",0
19,"19020",46,35,34,1,1,"PUM+J",0
5,"5022",1571,1295,1282,5,13,"PUM+J",1
18,"18148",803,652,648,0,4,"PUM+J",0
19,"19011",236,181,181,0,0,"PUM+J",0
16,"16271",595,513,511,2,2,"PUM+J",0
5,"5090",77,70,69,0,1,"PUM+J",1
31,"31238",115,101,100,2,1,"PUM+J",1
50,"50208",1748,1360,1344,11,16,"PUM+J",2
24,"24194",266,199,199,1,0,"PUM+J",0
22,"22002",106,95,94,0,1,"PUM+J",0
22,"22181",88,60,59,1,1,"PUM+J",1
6,"6106",413,267,263,3,4,"PUM+J",0
39,"39086",362,273,268,1,5,"PUM+J",0
37,"37240",939,694,686,3,8,"PUM+J",2
50,"50177",276,226,223,0,3,"PUM+J",0
42,"42188",43,35,34,1,1,"PUM+J",0
35,"35002",24129,16979,16736,116,243,"PUM+J",25
26,"26011",7229,5355,5277,64,78,"PUM+J",2
34,"34141",176,154,152,0,2,"PUM+J",0
37,"37003",107,82,82,1,0,"PUM+J",0
35,"35011",24705,17099,16823,129,276,"PUM+J",21
7,"7042",10785,7256,7191,60,65,"PUM+J",9
26,"26028",139,120,117,1,3,"PUM+J",0
37,"37005",67,48,48,2,0,"PUM+J",0
45,"45146",101,86,85,0,1,"PUM+J",0
6,"6122",6562,4837,4723,43,114,"PUM+J",7
45,"45141",849,677,665,4,12,"PUM+J",1
12,"12103",90,75,70,1,5,"PUM+J",1
37,"37154",129,106,102,3,4,"PUM+J",0
50,"50086",178,121,119,2,2,"PUM+J",0
5,"5186",1558,1255,1247,9,8,"PUM+J",2
50,"50100",306,238,235,3,3,"PUM+J",0
23,"23012",4018,2835,2804,15,31,"PUM+J",4
40,"40072",224,198,194,3,4,"PUM+J",0
23,"23055",46343,33603,33225,243,378,"PUM+J",20
7,"7043",3430,2465,2438,24,27,"PUM+J",5
14,"14013",16604,12618,12388,155,230,"PUM+J",15
29,"29094",59350,42199,41749,419,450,"PUM+J",61
24,"24098",1149,882,863,7,19,"PUM+J",2
16,"16276",21,18,18,1,0,"PUM+J",0
35,"35027",10499,7651,7530,57,121,"PUM+J",4
41,"41055",14804,10863,10720,79,143,"PUM+J",9
44,"44122",1284,995,984,15,11,"PUM+J",1
20,"20081",7655,5629,5601,22,28,"PUM+J",6
9,"9155",25,20,20,0,0,"PUM+J",0
29,"29077",214,158,156,1,2,"PUM+J",0
16,"16116",77,59,59,0,0,"PUM+J",0
44,"44039",202,166,165,3,1,"PUM+J",1
28,"28006",80622,64905,64483,400,422,"PUM+J",83
39,"39055",1075,836,829,8,7,"PUM+J",0
45,"45058",352,270,269,5,1,"PUM+J",0
6,"6088",12505,9311,9140,93,171,"PUM+J",9
44,"44017",272,221,219,0,2,"PUM+J",0
34,"34201",171,139,139,0,0,"PUM+J",0
9,"9120",38,32,31,2,1,"PUM+J",0
42,"42008",56,41,41,0,0,"PUM+J",0
18,"18067",681,511,507,3,4,"PUM+J",0
37,"37065",271,187,184,0,3,"PUM+J",0
47,"47001",52,47,46,0,1,"PUM+J",0
9,"9076",24,17,17,1,0,"PUM+J",0
24,"24093",338,239,232,3,7,"PUM+J",2
24,"24207",278,242,235,0,7,"PUM+J",1
6,"6155",1825,1316,1292,21,24,"PUM+J",1
6,"6038",790,583,574,4,9,"PUM+J",0
45,"45106",7395,5971,5861,40,110,"PUM+J",11
24,"24206",1611,1286,1268,7,18,"PUM+J",0
22,"22243",39,28,28,0,0,"PUM+J",0
16,"16275",12,12,12,0,0,"PUM+J",0
19,"19330",67,60,60,0,0,"PUM+J",0
37,"37102",379,297,291,3,6,"PUM+J",1
4,"4016",2128,1643,1621,4,22,"PUM+J",1
31,"31109",1664,1290,1283,10,7,"PUM+J",4
39,"39010",610,518,512,1,6,"PUM+J",2
45,"45014",4020,2910,2854,22,56,"PUM+J",5
16,"16157",190,163,161,1,2,"PUM+J",0
34,"34137",24,23,22,2,1,"PUM+J",0
50,"50089",8584,6951,6912,34,39,"PUM+J",11
24,"24120",311,209,209,0,0,"PUM+J",1
45,"45052",3134,2670,2652,23,18,"PUM+J",3
35,"35021",15014,10909,10792,71,117,"PUM+J",8
45,"45017",260,218,213,1,5,"PUM+J",0
48,"48086",2015,1504,1486,6,18,"PUM+J",1
37,"37007",399,311,306,3,5,"PUM+J",1
32,"32018",1179,950,936,3,14,"PUM+J",1
7,"7064",5528,3793,3765,23,28,"PUM+J",3
48,"48011",9652,7293,7251,37,42,"PUM+J",8
41,"41020",12992,8679,8524,117,155,"PUM+J",6
39,"39004",1483,1181,1163,4,18,"PUM+J",0
19,"19280",3611,2805,2767,25,38,"PUM+J",8
19,"19001",41,33,33,0,0,"PUM+J",0
42,"42205",85,64,62,0,2,"PUM+J",0
48,"48020",272959,203643,202331,1472,1312,"PUM+J",272
39,"39018",4272,3533,3476,17,57,"PUM+J",4
5,"5174",65,53,52,1,1,"PUM+J",0
40,"40198",24,20,20,0,0,"PUM+J",0
50,"50219",4283,3274,3213,53,61,"PUM+J",5
24,"24088",995,813,802,12,11,"PUM+J",0
18,"18177",373,253,252,1,1,"PUM+J",0
28,"28011",420,315,311,1,4,"PUM+J",0
50,"50142",24,18,18,0,0,"PUM+J",0
22,"22193",269,220,217,2,3,"PUM+J",0
23,"23058",8817,6964,6873,48,91,"PUM+J",10
32,"32016",724,543,535,3,8,"PUM+J",0
39,"39081",437,356,347,2,9,"PUM+J",0
9,"9232",140,110,107,0,3,"PUM+J",0
16,"16145",425,362,357,8,5,"PUM+J",0
6,"6107",1570,1117,1106,9,11,"PUM+J",1
49,"49017",259,196,195,0,1,"PUM+J",0
6,"6095",9511,7338,7152,116,186,"PUM+J",17
41,"41036",3917,2944,2885,27,59,"PUM+J",3
9,"9088",64,42,42,4,0,"PUM+J",0
45,"45156",3338,2805,2750,9,55,"PUM+J",4
40,"40081",119,96,95,2,1,"PUM+J",0
18,"18132",3124,2575,2548,17,27,"PUM+J",0
9,"9241",247,192,188,2,4,"PUM+J",0
44,"44197",50,35,35,0,0,"PUM+J",0
9,"9415",275,206,204,0,2,"PUM+J",1
2,"2074",5891,4435,4375,41,60,"PUM+J",5
37,"37164",238,194,193,4,1,"PUM+J",0
20,"20051",6775,5124,5091,24,33,"PUM+J",2
5,"5185",90,71,70,0,1,"PUM+J",0
2,"2053",2885,2313,2282,13,31,"PUM+J",2
40,"40095",464,379,369,2,10,"PUM+J",0
23,"23092",27662,21206,20981,170,225,"PUM+J",13
49,"49171",610,477,473,8,4,"PUM+J",0
49,"49109",562,445,444,5,1,"PUM+J",1
6,"6101",442,359,354,2,5,"PUM+J",0
44,"44196",125,96,95,2,1,"PUM+J",0
44,"44149",100,74,73,0,1,"PUM+J",0
49,"49107",116,82,81,1,1,"PUM+J",0
26,"26138",4545,3433,3374,27,59,"PUM+J",3
9,"9227",113,93,91,0,2,"PUM+J",0
31,"31068",2816,2194,2136,17,58,"PUM+J",1
12,"12090",104,85,83,1,2,"PUM+J",0
50,"50174",83,58,58,0,0,"PUM+J",0
38,"38034",3998,3033,2993,19,40,"PUM+J",3
9,"9418",73,58,55,2,3,"PUM+J",0
5,"5105",336,272,266,2,6,"PUM+J",1
12,"12025",121,102,99,0,3,"PUM+J",0
7,"7020",3692,2833,2808,42,25,"PUM+J",4
47,"47048",175,148,148,0,0,"PUM+J",0
2,"2029",3327,2586,2556,15,30,"PUM+J",1
37,"37122",203,174,174,1,0,"PUM+J",1
28,"28155",485,414,409,0,5,"PUM+J",0
23,"23091",679,575,571,3,4,"PUM+J",1
47,"47174",270,215,208,2,7,"PUM+J",0
37,"37152",402,308,302,1,6,"PUM+J",0
19,"19129",27,25,25,0,0,"PUM+J",0
9,"9223",43,39,39,1,0,"PUM+J",0
19,"19031",10,8,8,0,0,"PUM+J",0
32,"32054",86475,64472,63712,676,760,"PUM+J",102
24,"24101",384,285,283,4,2,"PUM+J",0
24,"24106",218,164,162,0,2,"PUM+J",0
49,"49096",157,129,123,2,6,"PUM+J",0
42,"42160",247,195,194,4,1,"PUM+J",0
26,"26022",187,153,148,0,5,"PUM+J",0
50,"50176",222,161,156,3,5,"PUM+J",0
50,"50054",56,48,47,0,1,"PUM+J",0
50,"50215",20,18,18,0,0,"PUM+J",0
39,"39009",3307,2545,2526,11,19,"PUM+J",0
26,"26125",2663,2042,2011,32,31,"PUM+J",0
45,"45087",8198,6375,6281,36,94,"PUM+J",9
14,"14045",3013,2508,2468,13,40,"PUM+J",1
26,"26023",435,351,347,5,4,"PUM+J",0
37,"37184",290,199,195,0,4,"PUM+J",1
28,"28112",154,137,137,1,0,"PUM+J",0
5,"5166",160,128,123,1,5,"PUM+J",0
37,"37148",404,321,315,2,6,"PUM+J",0
33,"33063",374,284,283,3,1,"PUM+J",0
12,"12027",17473,12829,12683,90,146,"PUM+J",11
39,"39084",874,718,712,4,6,"PUM+J",1
41,"41023",7975,5918,5812,51,106,"PUM+J",2
44,"44257",154,110,109,1,1,"PUM+J",1
48,"48903",1807,1471,1462,6,9,"PUM+J",0
22,"22130",10128,7355,7294,61,61,"PUM+J",9
22,"22220",150,120,117,0,3,"PUM+J",0
31,"31124",207,151,150,2,1,"PUM+J",0
39,"39027",3066,2511,2467,15,44,"PUM+J",0
44,"44087",68,56,54,0,2,"PUM+J",0
1,"1057",243,202,199,0,3,"PUM+J",0
1,"1044",231,171,166,0,5,"PUM+J",0
1,"1021",469,333,330,1,3,"PUM+J",0
1,"1014",366,283,277,7,6,"PUM+J",1
1,"1011",215,179,175,3,4,"PUM+J",0
1,"1043",2337,1669,1656,18,13,"PUM+J",0
1,"1058",1403,958,951,4,7,"PUM+J",0
1,"1039",195,157,153,0,4,"PUM+J",0
1,"1030",143,118,117,1,1,"PUM+J",0
1,"1041",152,107,103,2,4,"PUM+J",1
1,"1055",840,608,602,10,6,"PUM+J",0
1,"1034",150,111,111,2,0,"PUM+J",0
1,"1002",8035,6227,6159,17,68,"PUM+J",16
1,"1053",592,376,373,2,3,"PUM+J",0
1,"1063",1830,1363,1353,4,10,"PUM+J",1
1,"1013",703,491,487,2,4,"PUM+J",0
1,"1031",1163,948,928,6,20,"PUM+J",3
1,"1051",3558,2448,2433,14,15,"PUM+J",3
1,"1902",730,551,545,6,6,"PUM+J",2
1,"1020",320,239,238,1,1,"PUM+J",0
1,"1003",1179,908,903,6,5,"PUM+J",0
1,"1061",152,129,129,2,0,"PUM+J",0
1,"1017",816,579,574,2,5,"PUM+J",4
1,"1018",1408,998,993,6,5,"PUM+J",2
1,"1047",967,686,673,8,13,"PUM+J",0
1,"1006",176,127,127,2,0,"PUM+J",0
1,"1008",802,576,570,3,6,"PUM+J",0
1,"1032",500,372,362,1,10,"PUM+J",0
1,"1036",14772,10850,10746,69,104,"PUM+J",10
1,"1052",268,188,187,1,1,"PUM+J",0
1,"1033",656,533,525,1,8,"PUM+J",0
1,"1054",1013,729,726,2,3,"PUM+J",0
1,"1901",2474,1655,1631,13,24,"PUM+J",4
1,"1028",1068,774,772,7,2,"PUM+J",1
1,"1046",631,464,461,0,3,"PUM+J",0
1,"1059",189037,133121,131768,792,1353,"PUM+J",268
1,"1009",1265,920,914,6,6,"PUM+J",4
1,"1027",430,295,293,2,2,"PUM+J",1
1,"1056",205,134,134,0,0,"PUM+J",0
1,"1060",201,174,166,1,8,"PUM+J",0
1,"1016",421,236,229,3,7,"PUM+J",0
1,"1042",907,723,721,4,2,"PUM+J",0
1,"1022",761,577,569,5,8,"PUM+J",1
1,"1062",315,236,229,2,7,"PUM+J",0
1,"1010",2315,1789,1770,14,19,"PUM+J",4
1,"1037",585,426,425,1,1,"PUM+J",4
1,"1001",2005,1438,1419,4,19,"PUM+J",3
1,"1004",1356,1007,998,3,9,"PUM+J",2
1,"1049",132,100,100,1,0,"PUM+J",0
1,"1023",262,210,206,3,4,"PUM+J",0
1,"1019",148,121,121,0,0,"PUM+J",0
44,"44145",972,741,732,11,9,"PYLN",0
44,"44125",65,50,50,0,0,"PYLN",0
50,"50116",170,132,131,0,1,"PYLN",0
44,"44033",244,174,172,0,2,"PYLN",1
50,"50290",358,272,266,6,6,"PYLN",0
22,"22223",74,63,63,1,0,"PYLN",0
44,"44236",59,44,44,0,0,"PYLN",0
22,"22068",65,46,44,1,2,"PYLN",0
22,"22013",275,218,217,6,1,"PYLN",0
50,"50124",399,316,316,3,0,"PYLN",0
50,"50058",63,54,53,2,1,"PYLN",0
50,"50052",85,64,64,0,0,"PYLN",0
50,"50223",916,751,745,13,6,"PYLN",0
22,"22244",46,37,37,2,0,"PYLN",0
22,"22081",243,187,186,0,1,"PYLN",0
50,"50019",64,48,47,0,1,"PYLN",0
22,"22206",182,145,145,0,0,"PYLN",1
50,"50110",336,268,266,1,2,"PYLN",0
50,"50297",502835,394653,391387,3269,3266,"PYLN",422
22,"22149",308,247,246,3,1,"PYLN",0
22,"22181",88,60,59,1,1,"PYLN",1
50,"50080",34,29,29,0,0,"PYLN",0
44,"44108",300,228,224,5,4,"PYLN",0
22,"22096",320,274,272,2,2,"PYLN",0
50,"50287",252,200,196,7,4,"PYLN",0
50,"50136",534,416,405,2,11,"PYLN",0
50,"50132",771,589,576,2,13,"PYLN",0
22,"22078",438,326,323,3,3,"PYLN",0
44,"44129",36,29,29,0,0,"PYLN",0
50,"50047",43,32,31,1,1,"PYLN",0
22,"22905",287,226,224,2,2,"PYLN",0
44,"44195",84,66,65,1,1,"PYLN",0
44,"44222",122,102,102,1,0,"PYLN",0
50,"50166",236,200,198,1,2,"PYLN",0
44,"44010",184,137,137,1,0,"PYLN",0
50,"50283",69,53,52,3,1,"PYLN",0
44,"44113",72,51,50,0,1,"PYLN",0
50,"50044",222,161,161,3,0,"PYLN",0
44,"44127",57,45,45,0,0,"PYLN",0
44,"44225",103,82,81,0,1,"PYLN",0
50,"50148",290,229,227,2,2,"PYLN",3
50,"50241",595,434,423,3,11,"PYLN",1
50,"50156",209,174,171,1,3,"PYLN",0
22,"22225",2610,1867,1843,15,24,"PYLN",1
50,"50185",136,103,102,0,1,"PYLN",2
44,"44070",55,45,45,0,0,"PYLN",0
44,"44241",506,416,407,1,9,"PYLN",0
44,"44111",78,64,64,1,0,"PYLN",0
22,"22234",745,587,578,11,9,"PYLN",0
22,"22903",622,538,533,3,5,"PYLN",1
22,"22212",70,56,56,0,0,"PYLN",0
22,"22032",107,74,74,2,0,"PYLN",0
50,"50232",160,116,114,2,2,"PYLN",0
22,"22193",269,220,217,2,3,"PYLN",1
44,"44204",27,22,22,0,0,"PYLN",0
44,"44197",50,35,35,0,0,"PYLN",0
50,"50258",53,33,33,3,0,"PYLN",0
44,"44262",143,115,112,0,3,"PYLN",0
50,"50086",178,121,119,2,2,"PYLN",0
50,"50082",84,63,63,0,0,"PYLN",0
50,"50293",392,295,293,6,2,"PYLN",0
50,"50163",3787,3041,3022,31,19,"PYLN",2
22,"22199",6926,5113,5051,44,62,"PYLN",10
22,"22054",1617,1196,1183,15,13,"PYLN",4
22,"22142",94,80,80,2,0,"PYLN",0
44,"44190",65,45,43,0,2,"PYLN",0
22,"22057",364,286,284,3,2,"PYLN",0
44,"44039",202,166,165,3,1,"PYLN",1
50,"50219",4283,3274,3213,53,61,"PYLN",4
22,"22088",143,111,111,1,0,"PYLN",0
50,"50274",66,48,47,0,1,"PYLN",0
50,"50151",603,490,489,3,1,"PYLN",0
44,"44192",349,288,284,1,4,"PYLN",0
44,"44016",436,334,331,1,3,"PYLN",0
22,"22050",93,79,79,2,0,"PYLN",0
44,"44176",153,124,124,0,0,"PYLN",0
50,"50149",33,25,25,1,0,"PYLN",0
22,"22151",88,66,65,0,1,"PYLN",0
44,"44246",1590,1173,1150,11,23,"PYLN",2
22,"22172",520,412,407,3,5,"PYLN",1
22,"22103",676,520,517,6,3,"PYLN",1
22,"22186",191,165,164,2,1,"PYLN",0
44,"44173",102,85,80,0,5,"PYLN",0
22,"22177",97,81,81,1,0,"PYLN",0
50,"50010",66,56,55,2,1,"PYLN",1
50,"50064",438,368,362,1,6,"PYLN",1
44,"44191",722,567,561,7,6,"PYLN",0
22,"22124",182,148,148,1,0,"PYLN",0
50,"50189",678,544,534,5,10,"PYLN",2
50,"50198",49,43,43,1,0,"PYLN",0
44,"44040",191,164,158,2,6,"PYLN",0
22,"22163",419,363,361,1,2,"PYLN",0
22,"22077",362,301,293,3,8,"PYLN",0
50,"50028",77,59,58,1,1,"PYLN",0
22,"22105",101,82,82,4,0,"PYLN",0
44,"44088",23,21,21,0,0,"PYLN",0
50,"50153",922,705,704,6,1,"PYLN",0
22,"22042",117,96,95,1,1,"PYLN",0
50,"50011",116,100,99,0,1,"PYLN",0
50,"50233",104,82,82,0,0,"PYLN",0
44,"44218",31,25,25,2,0,"PYLN",0
50,"50289",51,40,38,1,2,"PYLN",0
50,"50027",224,170,165,1,5,"PYLN",0
50,"50173",149,107,105,0,2,"PYLN",0
22,"22221",90,58,56,0,2,"PYLN",0
22,"22106",20,15,15,0,0,"PYLN",0
50,"50236",101,82,80,1,2,"PYLN",0
22,"22001",214,162,162,0,0,"PYLN",0
44,"44109",102,71,70,1,1,"PYLN",0
44,"44158",1166,921,904,7,17,"PYLN",0
44,"44135",102,85,85,0,0,"PYLN",0
22,"22059",1139,867,855,10,12,"PYLN",1
44,"44093",79,73,73,4,0,"PYLN",0
44,"44126",317,226,222,1,4,"PYLN",0
22,"22175",184,139,137,1,2,"PYLN",0
44,"44132",58,47,47,0,0,"PYLN",0
50,"50161",103,80,80,0,0,"PYLN",0
50,"50171",96,78,78,1,0,"PYLN",1
50,"50154",116,98,98,0,0,"PYLN",1
22,"22066",748,576,567,6,9,"PYLN",1
50,"50183",319,242,241,4,1,"PYLN",0
22,"22011",97,78,75,2,3,"PYLN",0
50,"50174",83,58,58,0,0,"PYLN",0
22,"22016",566,423,420,4,3,"PYLN",1
50,"50046",167,134,130,3,4,"PYLN",0
44,"44026",95,76,75,2,1,"PYLN",0
50,"50150",621,451,450,2,1,"PYLN",0
22,"22052",885,708,702,6,6,"PYLN",0
22,"22232",87,66,65,2,1,"PYLN",0
50,"50125",345,264,261,3,3,"PYLN",0
44,"44005",46,31,31,1,0,"PYLN",0
22,"22090",85,66,66,1,0,"PYLN",0
44,"44150",26,21,21,0,0,"PYLN",0
50,"50190",675,565,553,5,12,"PYLN",0
22,"22236",236,207,203,2,4,"PYLN",0
44,"44120",219,158,152,1,6,"PYLN",0
44,"44224",21,15,15,0,0,"PYLN",0
44,"44169",310,250,245,4,5,"PYLN",0
22,"22162",129,99,99,0,0,"PYLN",0
50,"50195",53,42,41,0,1,"PYLN",0
22,"22019",175,151,151,0,0,"PYLN",0
44,"44045",368,302,298,8,4,"PYLN",1
44,"44103",123,101,100,1,1,"PYLN",0
44,"44185",93,73,72,1,1,"PYLN",0
50,"50279",73,61,60,2,1,"PYLN",0
50,"50126",2262,1736,1708,20,28,"PYLN",0
50,"50042",16,16,16,0,0,"PYLN",0
50,"50217",431,346,344,0,2,"PYLN",0
50,"50100",306,238,235,3,3,"PYLN",0
50,"50001",88,71,70,0,1,"PYLN",0
44,"44266",102,89,86,1,3,"PYLN",0
50,"50229",65,57,56,0,1,"PYLN",0
44,"44142",28,21,21,0,0,"PYLN",0
50,"50227",110,74,73,2,1,"PYLN",0
22,"22082",285,230,226,2,4,"PYLN",1
50,"50144",31,26,25,0,1,"PYLN",0
22,"22044",234,184,183,3,1,"PYLN",0
44,"44071",585,449,447,6,2,"PYLN",1
50,"50205",74,58,57,0,1,"PYLN",0
44,"44007",152,120,117,0,3,"PYLN",0
44,"44102",27,22,22,0,0,"PYLN",0
44,"44219",173,142,136,1,6,"PYLN",0
50,"50193",663,536,516,1,20,"PYLN",0
50,"50040",86,71,71,0,0,"PYLN",0
22,"22907",1444,1149,1137,12,12,"PYLN",2
22,"22095",65,57,56,1,1,"PYLN",0
50,"50247",842,621,616,7,5,"PYLN",0
50,"50057",1332,1001,986,10,15,"PYLN",2
22,"22037",112,96,96,0,0,"PYLN",0
50,"50060",170,137,135,2,2,"PYLN",0
44,"44136",51,43,43,1,0,"PYLN",0
22,"22155",65,54,54,0,0,"PYLN",0
22,"22110",707,531,528,2,3,"PYLN",0
50,"50215",20,18,18,0,0,"PYLN",0
50,"50067",13788,10562,10413,107,149,"PYLN",9
50,"50098",162,121,120,3,1,"PYLN",0
22,"22087",58,47,47,0,0,"PYLN",0
50,"50286",75,58,55,0,3,"PYLN",0
50,"50207",93,68,67,2,1,"PYLN",0
44,"44114",238,188,184,1,4,"PYLN",0
22,"22174",462,381,377,0,4,"PYLN",0
50,"50032",242,179,176,1,3,"PYLN",3
22,"22023",389,313,305,6,8,"PYLN",0
50,"50022",504,396,386,11,10,"PYLN",0
44,"44244",68,48,48,4,0,"PYLN",0
22,"22039",805,667,662,5,5,"PYLN",2
44,"44105",69,54,54,1,0,"PYLN",0
22,"22204",1119,836,832,9,4,"PYLN",1
50,"50179",264,231,228,0,3,"PYLN",0
44,"44017",272,221,219,0,2,"PYLN",0
44,"44036",23,20,20,0,0,"PYLN",0
44,"44221",384,320,315,2,5,"PYLN",0
50,"50264",147,122,120,0,2,"PYLN",0
44,"44208",26,22,22,0,0,"PYLN",0
50,"50246",38,28,28,0,0,"PYLN",0
50,"50256",74,46,45,0,1,"PYLN",1
50,"50234",242,194,187,3,7,"PYLN",0
50,"50240",965,720,702,9,18,"PYLN",0
44,"44031",82,52,52,1,0,"PYLN",0
44,"44020",22,18,18,0,0,"PYLN",0
22,"22069",418,337,334,5,3,"PYLN",0
44,"44263",377,296,285,3,11,"PYLN",1
22,"22157",183,136,134,1,2,"PYLN",0
44,"44184",38,28,26,0,2,"PYLN",0
44,"44178",53,39,39,0,0,"PYLN",0
22,"22136",749,579,576,5,3,"PYLN",0
50,"50242",93,72,70,0,2,"PYLN",0
50,"50122",67,55,54,0,1,"PYLN",0
50,"50111",183,144,142,2,2,"PYLN",0
44,"44181",66,58,57,0,1,"PYLN",0
50,"50181",1000,770,754,7,16,"PYLN",2
44,"44212",41,32,32,0,0,"PYLN",0
22,"22041",152,121,119,2,2,"PYLN",0
50,"50006",908,705,689,3,16,"PYLN",2
44,"44232",368,284,273,2,11,"PYLN",0
50,"50172",178,134,131,3,3,"PYLN",0
44,"44257",154,110,109,1,1,"PYLN",0
50,"50092",300,234,230,1,4,"PYLN",0
50,"50248",502,390,377,6,13,"PYLN",2
22,"22099",465,365,362,3,3,"PYLN",1
44,"44213",65,46,46,0,0,"PYLN",0
50,"50182",3675,2846,2810,36,36,"PYLN",9
44,"44234",70,57,57,1,0,"PYLN",0
44,"44012",310,240,238,5,2,"PYLN",0
50,"50225",1532,1072,1064,10,8,"PYLN",4
50,"50143",546,409,401,5,8,"PYLN",0
44,"44096",153,120,112,1,8,"PYLN",0
50,"50070",49,28,28,0,0,"PYLN",0
50,"50061",193,173,169,1,4,"PYLN",0
50,"50141",109,90,90,1,0,"PYLN",3
22,"22128",192,155,154,2,1,"PYLN",0
50,"50036",100,80,80,0,0,"PYLN",0
44,"44146",170,148,146,3,2,"PYLN",0
22,"22061",6583,5027,4973,51,54,"PYLN",6
22,"22020",119,91,87,1,4,"PYLN",0
50,"50167",215,181,179,1,2,"PYLN",0
22,"22075",119,87,87,1,0,"PYLN",0
50,"50255",197,162,160,2,2,"PYLN",0
44,"44152",67,48,48,2,0,"PYLN",1
50,"50104",326,264,259,4,5,"PYLN",0
22,"22167",473,392,384,4,8,"PYLN",0
44,"44174",409,306,300,3,6,"PYLN",0
44,"44013",11250,8525,8420,95,105,"PYLN",4
44,"44229",143,110,108,4,2,"PYLN",1
50,"50231",257,210,207,3,3,"PYLN",0
22,"22173",218,162,160,1,2,"PYLN",0
50,"50257",163,136,134,1,2,"PYLN",0
44,"44223",73,58,58,0,0,"PYLN",0
50,"50094",1518,1172,1155,20,17,"PYLN",1
44,"44196",125,96,95,2,1,"PYLN",0
50,"50066",2835,2199,2177,19,22,"PYLN",1
50,"50037",127,93,93,0,0,"PYLN",0
22,"22906",174,137,134,5,3,"PYLN",0
44,"44077",74,55,54,0,1,"PYLN",1
44,"44175",113,84,82,1,2,"PYLN",0
44,"44044",83,65,64,2,1,"PYLN",0
50,"50091",40,35,35,0,0,"PYLN",0
50,"50063",61,54,54,0,0,"PYLN",0
50,"50203",1057,849,837,9,12,"PYLN",1
44,"44268",32,30,30,0,0,"PYLN",0
50,"50029",604,475,467,7,8,"PYLN",0
44,"44237",368,299,293,2,6,"PYLN",2
50,"50251",8207,6352,6242,46,110,"PYLN",13
44,"44025",5825,4337,4197,50,140,"PYLN",6
44,"44151",182,139,138,1,1,"PYLN",0
22,"22008",155,127,125,0,2,"PYLN",1
50,"50160",2150,1652,1619,14,33,"PYLN",2
50,"50213",93,76,75,0,1,"PYLN",0
50,"50014",119,85,85,0,0,"PYLN",0
50,"50120",55,43,43,2,0,"PYLN",0
22,"22195",234,193,192,0,1,"PYLN",0
50,"50261",205,171,167,1,4,"PYLN",0
44,"44137",188,148,146,0,2,"PYLN",1
50,"50137",964,790,781,9,9,"PYLN",0
22,"22229",108,80,80,2,0,"PYLN",0
44,"44097",126,91,90,2,1,"PYLN",0
50,"50075",72,59,59,1,0,"PYLN",0
50,"50056",405,332,330,4,2,"PYLN",0
44,"44037",449,334,331,1,3,"PYLN",0
22,"22058",191,157,157,3,0,"PYLN",0
44,"44115",102,96,95,0,1,"PYLN",0
50,"50078",231,173,171,0,2,"PYLN",0
50,"50108",52,43,42,0,1,"PYLN",0
44,"44076",2110,1725,1691,22,34,"PYLN",0
50,"50178",276,193,193,4,0,"PYLN",0
22,"22187",294,244,243,2,1,"PYLN",0
22,"22909",301,233,231,4,2,"PYLN",0
22,"22036",88,76,75,0,1,"PYLN",0
44,"44047",229,125,124,2,1,"PYLN",0
44,"44209",815,606,592,2,14,"PYLN",0
22,"22083",445,379,372,5,7,"PYLN",0
50,"50187",56,43,43,0,0,"PYLN",1
50,"50235",2412,1826,1807,22,19,"PYLN",0
50,"50159",641,527,526,8,1,"PYLN",0
50,"50119",872,684,680,4,4,"PYLN",0
44,"44116",76,62,62,0,0,"PYLN",0
44,"44059",550,446,437,7,9,"PYLN",0
50,"50079",227,182,178,1,4,"PYLN",2
22,"22049",74,63,63,0,0,"PYLN",0
50,"50170",364,286,279,1,7,"PYLN",0
44,"44210",743,600,594,8,6,"PYLN",0
44,"44085",49,31,31,0,0,"PYLN",0
22,"22253",57,48,47,0,1,"PYLN",0
50,"50013",200,166,166,3,0,"PYLN",0
44,"44054",94,79,79,0,0,"PYLN",0
44,"44032",17,13,13,0,0,"PYLN",0
22,"22131",83,65,65,0,0,"PYLN",0
44,"44009",799,621,611,7,10,"PYLN",1
44,"44019",68,42,42,0,0,"PYLN",0
50,"50041",17,14,14,0,0,"PYLN",0
22,"22143",197,134,132,1,2,"PYLN",2
44,"44201",478,417,412,3,5,"PYLN",0
44,"44101",51,43,42,1,1,"PYLN",0
44,"44060",37,28,28,0,0,"PYLN",0
22,"22251",334,269,263,4,6,"PYLN",0
22,"22046",714,592,587,13,5,"PYLN",0
50,"50048",33,25,25,0,0,"PYLN",0
44,"44006",223,171,169,2,2,"PYLN",0
50,"50131",210,157,156,0,1,"PYLN",0
44,"44180",72,61,61,0,0,"PYLN",0
50,"50902",79,69,69,0,0,"PYLN",0
22,"22062",154,115,115,1,0,"PYLN",0
22,"22230",288,229,228,3,1,"PYLN",1
50,"50253",382,318,315,2,3,"PYLN",0
50,"50084",66,47,47,0,0,"PYLN",0
50,"50250",56,45,45,0,0,"PYLN",0
22,"22007",756,576,571,5,5,"PYLN",0
22,"22218",40,32,31,1,1,"PYLN",0
44,"44128",59,46,45,0,1,"PYLN",0
44,"44267",71,53,52,0,1,"PYLN",0
22,"22176",170,136,135,0,1,"PYLN",1
44,"44050",3115,2333,2299,27,34,"PYLN",3
22,"22130",10128,7355,7294,61,61,"PYLN",7
44,"44172",295,220,218,4,2,"PYLN",0
44,"44243",27,24,23,0,1,"PYLN",0
50,"50209",2747,1993,1975,29,18,"PYLN",2
44,"44087",68,56,54,0,2,"PYLN",0
50,"50191",445,341,337,2,4,"PYLN",0
50,"50285",650,466,462,7,4,"PYLN",0
50,"50025",4516,3417,3364,35,53,"PYLN",2
50,"50113",584,505,495,3,10,"PYLN",0
44,"44062",31,24,23,1,1,"PYLN",0
50,"50054",56,48,47,0,1,"PYLN",0
50,"50273",32,24,24,0,0,"PYLN",0
44,"44252",75,56,56,1,0,"PYLN",0
44,"44075",326,275,263,0,12,"PYLN",0
50,"50083",84,70,68,0,2,"PYLN",0
22,"22133",108,85,83,1,2,"PYLN",0
22,"22024",222,179,177,1,2,"PYLN",0
44,"44048",53,47,47,0,0,"PYLN",0
50,"50114",132,111,111,1,0,"PYLN",0
50,"50204",2394,1876,1855,21,21,"PYLN",0
44,"44052",74,50,49,0,1,"PYLN",0
50,"50176",222,161,156,3,5,"PYLN",0
44,"44211",35,24,24,0,0,"PYLN",0
50,"50140",157,108,108,0,0,"PYLN",0
44,"44029",579,466,457,3,9,"PYLN",0
44,"44235",89,67,66,2,1,"PYLN",1
44,"44131",27,22,22,0,0,"PYLN",0
50,"50008",5185,3753,3711,35,42,"PYLN",4
50,"50268",42,33,32,1,1,"PYLN",0
22,"22107",100,68,67,0,1,"PYLN",0
50,"50202",131,90,88,1,2,"PYLN",0
50,"50050",86,65,65,1,0,"PYLN",0
50,"50039",467,366,364,3,2,"PYLN",0
50,"50002",125,96,91,1,5,"PYLN",0
22,"22249",118,93,93,2,0,"PYLN",0
22,"22018",308,234,232,2,2,"PYLN",0
22,"22122",65,58,58,3,0,"PYLN",0
22,"22182",233,178,174,1,4,"PYLN",0
50,"50175",924,713,710,9,3,"PYLN",2
50,"50184",90,79,79,0,0,"PYLN",0
50,"50155",90,70,69,0,1,"PYLN",0
44,"44024",28,25,24,0,1,"PYLN",0
22,"22168",23,21,20,0,1,"PYLN",0
50,"50146",190,152,149,0,3,"PYLN",0
44,"44014",2499,2015,1963,25,52,"PYLN",2
22,"22055",310,258,255,2,3,"PYLN",2
50,"50288",3444,2689,2668,24,21,"PYLN",4
50,"50076",75,64,63,0,1,"PYLN",0
50,"50260",32,28,28,0,0,"PYLN",0
50,"50123",436,344,338,1,6,"PYLN",0
44,"44042",114,84,84,0,0,"PYLN",0
22,"22048",12593,9614,9528,82,86,"PYLN",12
50,"50035",75,63,62,0,1,"PYLN",14
44,"44148",76,64,63,0,1,"PYLN",0
44,"44179",325,233,231,7,2,"PYLN",1
50,"50065",55,43,43,1,0,"PYLN",0
22,"22085",96,82,81,0,1,"PYLN",0
22,"22102",181,153,151,1,2,"PYLN",0
50,"50147",751,564,559,3,5,"PYLN",0
50,"50292",129,113,113,1,0,"PYLN",0
50,"50252",5057,3661,3613,36,48,"PYLN",1
44,"44066",87,66,65,0,1,"PYLN",0
50,"50017",1779,1386,1373,14,13,"PYLN",1
44,"44055",77,58,56,0,2,"PYLN",0
22,"22213",2923,2261,2221,24,40,"PYLN",0
44,"44187",193,155,151,1,4,"PYLN",0
50,"50020",802,606,600,7,6,"PYLN",0
44,"44177",101,75,75,1,0,"PYLN",0
44,"44067",108,82,78,0,4,"PYLN",0
22,"22006",272,206,201,2,5,"PYLN",1
50,"50165",1783,1359,1330,20,29,"PYLN",1
50,"50093",83,66,66,1,0,"PYLN",0
50,"50012",96,79,79,1,0,"PYLN",1
22,"22908",188,133,131,0,2,"PYLN",4
50,"50196",102,83,81,2,2,"PYLN",2
50,"50138",47,42,42,1,0,"PYLN",0
22,"22112",9516,7043,6956,84,87,"PYLN",4
50,"50030",201,138,136,1,2,"PYLN",1
22,"22141",114,86,85,0,1,"PYLN",0
44,"44264",248,175,171,0,4,"PYLN",0
44,"44068",643,518,511,9,7,"PYLN",2
22,"22072",194,141,140,0,1,"PYLN",0
50,"50206",453,371,370,5,1,"PYLN",3
44,"44038",98,83,80,0,3,"PYLN",0
44,"44200",39,25,25,0,0,"PYLN",0
50,"50031",139,97,90,0,7,"PYLN",0
50,"50003",119,95,95,1,0,"PYLN",0
50,"50139",322,257,256,0,1,"PYLN",1
44,"44018",16,16,16,0,0,"PYLN",0
50,"50222",1570,1126,1105,17,21,"PYLN",1
44,"44092",70,56,55,1,1,"PYLN",0
44,"44217",31,25,25,0,0,"PYLN",0
22,"22207",121,78,78,1,0,"PYLN",0
50,"50055",3627,2627,2571,41,56,"PYLN",1
50,"50004",478,380,376,2,4,"PYLN",1
22,"22217",372,296,290,5,6,"PYLN",0
50,"50262",1163,930,912,15,18,"PYLN",1
22,"22028",362,284,282,5,2,"PYLN",0
22,"22254",1094,857,850,11,7,"PYLN",0
44,"44003",17,14,14,0,0,"PYLN",0
44,"44022",463,342,326,6,16,"PYLN",1
22,"22189",178,143,143,0,0,"PYLN",0
50,"50280",301,246,240,1,6,"PYLN",0
44,"44112",408,303,293,2,10,"PYLN",1
22,"22014",233,185,182,3,3,"PYLN",0
44,"44118",158,126,122,1,4,"PYLN",0
22,"22017",822,664,660,5,4,"PYLN",0
50,"50237",102,81,81,3,0,"PYLN",1
44,"44231",36,33,32,0,1,"PYLN",0
22,"22111",146,115,115,1,0,"PYLN",0
44,"44056",457,352,341,4,11,"PYLN",0
44,"44198",181,151,145,1,6,"PYLN",0
44,"44159",37,32,32,1,0,"PYLN",0
44,"44099",649,457,450,2,7,"PYLN",0
44,"44011",48,32,32,1,0,"PYLN",0
44,"44110",37,33,33,0,0,"PYLN",0
50,"50152",1368,1061,1043,6,18,"PYLN",0
50,"50162",137,112,110,2,2,"PYLN",0
44,"44171",182,130,128,0,2,"PYLN",0
50,"50294",64,49,47,0,2,"PYLN",1
50,"50072",195,164,161,3,3,"PYLN",0
44,"44141",127,100,100,0,0,"PYLN",0
44,"44100",175,142,141,2,1,"PYLN",0
50,"50903",2238,1750,1732,11,18,"PYLN",0
22,"22220",150,120,117,0,3,"PYLN",0
44,"44021",104,86,85,2,1,"PYLN",0
44,"44002",46,42,42,0,0,"PYLN",0
22,"22027",306,230,225,3,5,"PYLN",0
44,"44247",287,216,215,6,1,"PYLN",0
22,"22127",529,434,432,4,2,"PYLN",0
22,"22243",39,28,28,0,0,"PYLN",0
44,"44157",64,38,38,1,0,"PYLN",0
50,"50109",98,69,67,3,2,"PYLN",1
22,"22164",43,33,31,0,2,"PYLN",0
50,"50026",421,340,328,4,12,"PYLN",0
22,"22178",103,84,84,2,0,"PYLN",0
22,"22114",124,86,82,1,4,"PYLN",0
44,"44265",181,153,148,1,5,"PYLN",0
44,"44258",53,44,44,0,0,"PYLN",0
44,"44238",2294,1763,1743,10,20,"PYLN",0
44,"44167",39,30,30,0,0,"PYLN",0
44,"44205",634,444,426,9,18,"PYLN",0
22,"22239",88,71,71,0,0,"PYLN",0
50,"50296",382,288,272,1,16,"PYLN",0
22,"22079",114,89,88,1,1,"PYLN",0
22,"22197",439,356,353,10,3,"PYLN",0
22,"22021",1884,1465,1450,13,15,"PYLN",2
44,"44043",88,67,65,1,2,"PYLN",0
50,"50224",65,54,54,1,0,"PYLN",0
50,"50243",311,252,247,1,5,"PYLN",0
50,"50214",18,10,10,0,0,"PYLN",0
44,"44023",18,14,14,0,0,"PYLN",0
44,"44216",26922,20603,20279,204,324,"PYLN",16
50,"50259",84,58,58,0,0,"PYLN",0
44,"44004",379,312,310,5,2,"PYLN",0
50,"50212",32,29,29,1,0,"PYLN",0
44,"44064",63,49,48,0,1,"PYLN",0
50,"50269",279,189,186,1,3,"PYLN",0
44,"44144",325,249,247,1,2,"PYLN",1
50,"50009",97,72,71,1,1,"PYLN",0
22,"22029",119,103,103,0,0,"PYLN",0
50,"50018",893,705,696,3,9,"PYLN",0
22,"22045",73,57,56,0,1,"PYLN",0
44,"44207",130,101,101,1,0,"PYLN",0
50,"50106",127,97,96,0,1,"PYLN",0
44,"44080",284,214,212,1,2,"PYLN",3
44,"44261",722,584,578,8,6,"PYLN",0
22,"22060",1172,906,901,13,5,"PYLN",0
44,"44065",57,37,36,0,1,"PYLN",0
22,"22250",344,271,264,6,7,"PYLN",1
44,"44123",99,69,69,1,0,"PYLN",0
44,"44164",20,18,18,0,0,"PYLN",1
22,"22063",159,133,132,2,1,"PYLN",0
50,"50216",240,189,181,3,8,"PYLN",0
22,"22203",76,61,61,0,0,"PYLN",1
50,"50239",63,47,47,0,0,"PYLN",0
44,"44082",89,72,69,0,3,"PYLN",0
44,"44165",173,136,135,2,1,"PYLN",0
50,"50089",8584,6951,6912,34,39,"PYLN",3
50,"50023",208,165,164,2,1,"PYLN",0
44,"44227",72,61,61,0,0,"PYLN",0
22,"22248",104,83,82,0,1,"PYLN",1
44,"44051",2588,2034,1997,26,37,"PYLN",2
22,"22125",39429,29988,29612,337,376,"PYLN",45
50,"50118",2110,1622,1605,19,17,"PYLN",1
22,"22053",786,573,567,3,6,"PYLN",0
50,"50059",754,599,589,6,10,"PYLN",1
44,"44249",46,37,37,1,0,"PYLN",0
50,"50208",1748,1360,1344,11,16,"PYLN",1
50,"50266",121,85,80,0,5,"PYLN",0
50,"50271",248,197,189,2,8,"PYLN",0
44,"44106",153,115,111,2,4,"PYLN",1
44,"44046",43,32,32,0,0,"PYLN",0
50,"50281",68,55,52,0,3,"PYLN",0
22,"22227",199,155,154,1,1,"PYLN",1
50,"50263",176,119,116,0,3,"PYLN",0
22,"22214",118,98,97,1,1,"PYLN",1
44,"44189",48,36,36,0,0,"PYLN",0
22,"22202",145,127,126,0,1,"PYLN",0
50,"50088",282,233,227,2,6,"PYLN",1
50,"50129",213,151,149,5,2,"PYLN",0
44,"44008",1565,1158,1138,8,20,"PYLN",0
44,"44084",55,45,45,0,0,"PYLN",0
50,"50272",13174,10143,10042,103,101,"PYLN",10
22,"22113",470,369,369,2,0,"PYLN",0
44,"44230",152,112,111,1,1,"PYLN",0
50,"50254",174,123,122,0,1,"PYLN",0
50,"50200",475,416,407,4,9,"PYLN",1
50,"50245",76,58,58,0,0,"PYLN",0
22,"22188",76,60,59,1,1,"PYLN",0
50,"50130",362,252,249,1,3,"PYLN",0
44,"44240",149,121,121,0,0,"PYLN",0
50,"50298",5427,4373,4323,30,50,"PYLN",5
50,"50267",573,440,434,7,6,"PYLN",5
50,"50099",3042,2299,2265,20,34,"PYLN",2
50,"50901",140,108,108,0,0,"PYLN",0
50,"50188",27,24,24,0,0,"PYLN",0
22,"22043",93,68,67,1,1,"PYLN",0
22,"22064",162,121,121,0,0,"PYLN",2
50,"50277",49,37,37,3,0,"PYLN",1
22,"22200",239,181,178,0,3,"PYLN",2
50,"50117",125,100,100,3,0,"PYLN",0
22,"22119",1256,963,954,5,9,"PYLN",0
50,"50071",127,89,88,0,1,"PYLN",0
44,"44133",15,12,12,0,0,"PYLN",1
50,"50211",237,177,173,0,4,"PYLN",0
50,"50045",1198,957,951,3,6,"PYLN",0
50,"50244",191,153,150,1,3,"PYLN",0
44,"44027",149,120,119,0,1,"PYLN",0
50,"50062",1863,1441,1416,9,25,"PYLN",2
44,"44138",118,90,89,2,1,"PYLN",0
22,"22144",257,207,204,1,3,"PYLN",0
50,"50090",134,108,108,0,0,"PYLN",0
22,"22051",91,78,78,1,0,"PYLN",1
50,"50228",250,217,214,3,3,"PYLN",0
22,"22246",71,50,50,0,0,"PYLN",1
22,"22025",1035,764,755,24,9,"PYLN",0
22,"22116",1369,1025,1003,8,22,"PYLN",0
50,"50101",832,625,614,1,11,"PYLN",0
22,"22076",288,228,226,1,2,"PYLN",1
50,"50034",787,568,556,3,12,"PYLN",2
22,"22158",11951,8877,8801,69,76,"PYLN",4
50,"50142",24,18,18,0,0,"PYLN",1
22,"22003",132,114,114,0,0,"PYLN",0
44,"44160",440,311,306,2,5,"PYLN",0
50,"50085",183,136,136,1,0,"PYLN",0
50,"50270",38,32,30,1,2,"PYLN",0
22,"22184",168,142,139,2,3,"PYLN",0
44,"44035",105,86,84,1,2,"PYLN",0
50,"50194",81,59,59,1,0,"PYLN",0
44,"44163",114,92,92,0,0,"PYLN",0
22,"22084",555,438,433,5,5,"PYLN",1
44,"44041",58,48,44,1,4,"PYLN",0
50,"50201",444,357,354,1,3,"PYLN",0
44,"44130",27,24,24,0,0,"PYLN",0
50,"50164",388,279,272,2,7,"PYLN",0
44,"44143",394,327,327,2,0,"PYLN",0
22,"22156",296,246,242,3,4,"PYLN",1
22,"22137",1015,741,733,9,8,"PYLN",0
50,"50038",1405,1112,1099,13,13,"PYLN",0
22,"22165",452,360,356,1,4,"PYLN",0
50,"50073",2117,1735,1706,13,29,"PYLN",0
50,"50074",6166,4547,4444,33,103,"PYLN",5
22,"22139",78,60,60,0,0,"PYLN",0
22,"22150",461,368,362,1,6,"PYLN",1
22,"22009",585,439,435,4,4,"PYLN",0
50,"50177",276,226,223,0,3,"PYLN",2
50,"50128",27,24,24,0,0,"PYLN",0
22,"22129",163,117,116,0,1,"PYLN",2
44,"44124",73,58,57,0,1,"PYLN",0
44,"44153",1749,1264,1243,11,21,"PYLN",0
50,"50278",177,137,137,2,0,"PYLN",0
50,"50105",279,216,213,4,3,"PYLN",0
50,"50115",3275,2399,2355,32,44,"PYLN",0
44,"44260",138,91,90,1,1,"PYLN",0
22,"22135",174,132,132,5,0,"PYLN",1
22,"22109",266,207,205,3,2,"PYLN",0
50,"50135",88,74,74,3,0,"PYLN",0
22,"22209",159,139,136,5,3,"PYLN",0
50,"50218",110,92,92,0,0,"PYLN",0
44,"44251",242,197,187,0,10,"PYLN",0
50,"50221",32,22,22,0,0,"PYLN",0
44,"44154",248,200,195,2,5,"PYLN",0
22,"22228",529,421,417,3,4,"PYLN",0
44,"44028",171,140,138,1,2,"PYLN",0
44,"44155",1056,830,813,9,17,"PYLN",1
44,"44220",113,92,89,0,3,"PYLN",0
22,"22222",517,407,398,5,9,"PYLN",1
22,"22208",194,159,156,1,3,"PYLN",2
50,"50102",820,653,642,9,11,"PYLN",2
50,"50276",119,91,91,1,0,"PYLN",0
22,"22233",80,50,50,0,0,"PYLN",0
50,"50107",988,837,828,11,9,"PYLN",0
50,"50157",286,226,220,0,6,"PYLN",1
50,"50210",36,29,29,0,0,"PYLN",0
44,"44215",168,121,120,1,1,"PYLN",0
50,"50068",1947,1402,1389,11,13,"PYLN",3
50,"50087",29,18,18,0,0,"PYLN",0
22,"22094",98,72,71,2,1,"PYLN",0
50,"50081",491,390,384,5,6,"PYLN",0
44,"44239",22,19,19,0,0,"PYLN",0
50,"50007",49,34,34,0,0,"PYLN",1
44,"44199",39,39,38,5,1,"PYLN",0
50,"50021",25,23,23,1,0,"PYLN",0
22,"22235",88,72,72,1,0,"PYLN",0
50,"50186",37,28,28,0,0,"PYLN",0
50,"50121",277,220,218,2,2,"PYLN",0
22,"22047",241,213,212,2,1,"PYLN",0
50,"50005",239,204,201,2,3,"PYLN",1
22,"22080",264,208,202,2,6,"PYLN",0
44,"44121",53,38,38,2,0,"PYLN",0
44,"44203",9,9,9,0,0,"PYLN",0
50,"50238",86,66,66,2,0,"PYLN",0
50,"50134",118,91,89,0,2,"PYLN",0
22,"22252",118,100,99,0,1,"PYLN",0
50,"50077",206,158,157,1,1,"PYLN",0
44,"44119",119,83,82,0,1,"PYLN",0
22,"22117",2414,1798,1784,18,14,"PYLN",0
22,"22022",543,441,433,4,8,"PYLN",0
50,"50169",336,261,259,2,2,"PYLN",0
22,"22215",128,91,91,1,0,"PYLN",0
22,"22015",300,232,226,5,6,"PYLN",2
50,"50096",36,22,22,0,0,"PYLN",0
50,"50015",81,61,59,1,2,"PYLN",0
22,"22226",771,598,591,6,7,"PYLN",0
44,"44034",126,97,97,2,0,"PYLN",0
22,"22126",87,66,66,0,0,"PYLN",0
44,"44183",63,43,43,0,0,"PYLN",0
50,"50043",246,172,170,2,2,"PYLN",0
44,"44089",52,44,44,0,0,"PYLN",0
44,"44206",103,83,82,0,1,"PYLN",0
22,"22160",212,171,170,3,1,"PYLN",0
44,"44117",319,263,256,5,7,"PYLN",0
22,"22904",761,581,566,2,15,"PYLN",0
50,"50095",12136,9020,8928,99,92,"PYLN",14
44,"44086",421,332,327,3,5,"PYLN",0
44,"44147",398,293,286,3,7,"PYLN",1
44,"44053",105,81,81,0,0,"PYLN",0
22,"22247",30,21,21,0,0,"PYLN",0
44,"44090",66,49,49,0,0,"PYLN",0
44,"44156",46,36,33,1,3,"PYLN",0
50,"50180",106,84,84,1,0,"PYLN",0
22,"22067",71,52,52,0,0,"PYLN",1
44,"44226",124,87,83,2,4,"PYLN",0
50,"50282",57,47,45,0,2,"PYLN",0
44,"44161",430,320,316,1,4,"PYLN",0
50,"50033",65,50,50,1,0,"PYLN",0
22,"22190",122,89,89,0,0,"PYLN",0
50,"50192",233,189,183,0,6,"PYLN",0
44,"44001",65,51,50,0,1,"PYLN",0
22,"22901",714,521,508,3,13,"PYLN",0
22,"22242",63,47,45,1,2,"PYLN",0
22,"22002",106,95,94,0,1,"PYLN",0
22,"22089",276,216,216,2,0,"PYLN",0
44,"44228",99,83,83,0,0,"PYLN",0
50,"50230",1134,853,846,6,7,"PYLN",0
50,"50069",67,44,44,0,0,"PYLN",0
50,"50275",110,55,55,0,0,"PYLN",0
50,"50197",96,78,78,1,0,"PYLN",0
44,"44193",69,57,56,1,1,"PYLN",0
50,"50249",284,229,227,1,2,"PYLN",0
50,"50199",325,238,232,3,6,"PYLN",0
22,"22035",226,174,174,0,0,"PYLN",0
44,"44168",184,137,136,4,1,"PYLN",0
44,"44256",34,32,32,1,0,"PYLN",0
50,"50024",556,427,426,6,1,"PYLN",0
44,"44122",1284,995,984,15,11,"PYLN",2
22,"22040",144,124,120,1,4,"PYLN",0
44,"44250",19,15,15,0,0,"PYLN",0
44,"44074",444,353,346,3,7,"PYLN",0
22,"22086",209,157,155,1,2,"PYLN",0
44,"44063",65,55,55,1,0,"PYLN",0
22,"22170",668,529,520,4,9,"PYLN",0
50,"50284",132,105,104,1,1,"PYLN",0
50,"50051",800,615,608,3,7,"PYLN",1
22,"22902",208,160,156,0,4,"PYLN",0
44,"44245",245,176,171,1,5,"PYLN",0
22,"22004",124,90,88,1,2,"PYLN",0
22,"22245",306,266,263,0,3,"PYLN",0
44,"44049",796,592,578,9,14,"PYLN",0
22,"22205",459,347,345,1,2,"PYLN",0
44,"44061",75,66,65,2,1,"PYLN",0
22,"22115",347,262,261,1,1,"PYLN",0
44,"44194",104,80,80,1,0,"PYLN",0
50,"50016",44,31,31,0,0,"PYLN",0
22,"22201",266,192,192,2,0,"PYLN",0
44,"44107",205,159,158,0,1,"PYLN",0
44,"44149",100,74,73,0,1,"PYLN",0
50,"50168",27,20,20,0,0,"PYLN",0
22,"22012",102,81,80,1,1,"PYLN",0
50,"50220",43,37,37,0,0,"PYLN",0
22,"22074",275,223,221,10,2,"PYLN",0
50,"50291",93,78,77,1,1,"PYLN",0
50,"50265",74,56,56,0,0,"PYLN",0
44,"44094",123,112,112,0,0,"PYLN",1
50,"50053",650,505,497,4,8,"PYLN",0
50,"50133",100,82,82,2,0,"PYLN",0
50,"50295",49,46,46,0,0,"PYLN",1
44,"44182",198,172,171,2,1,"PYLN",0
1,"1001",2005,1438,1419,4,19,"RECORTES CE",6
46,"46056",175,156,156,3,0,"RECORTES CE",0
36,"36055",13551,9908,9682,105,226,"RECORTES CE",21
18,"18017",18148,12712,12523,96,189,"RECORTES CE",23
50,"50044",222,161,161,3,0,"RECORTES CE",0
25,"25176",307,262,259,1,3,"RECORTES CE",0
8,"8274",4674,3710,3698,12,12,"RECORTES CE",6
18,"18120",257,219,217,1,2,"RECORTES CE",0
50,"50045",1198,957,951,3,6,"RECORTES CE",3
23,"23082",1875,1402,1389,7,13,"RECORTES CE",1
12,"12017",148,120,116,0,4,"RECORTES CE",0
43,"43107",383,308,308,1,0,"RECORTES CE",0
36,"36056",4961,3719,3635,30,84,"RECORTES CE",6
31,"31113",127,84,83,1,1,"RECORTES CE",0
18,"18121",130,104,103,3,1,"RECORTES CE",0
48,"48094",3125,2407,2388,12,19,"RECORTES CE",0
1,"1002",8035,6227,6159,17,68,"RECORTES CE",19
15,"15001",4689,3422,3362,52,60,"RECORTES CE",4
8,"8039",402,334,334,2,0,"RECORTES CE",0
18,"18018",554,457,451,0,6,"RECORTES CE",0
23,"23084",907,685,670,0,15,"RECORTES CE",0
50,"50046",167,134,130,3,4,"RECORTES CE",1
12,"12018",283,242,235,0,7,"RECORTES CE",0
1,"1003",1179,908,903,6,5,"RECORTES CE",0
33,"33055",1492,1156,1121,6,35,"RECORTES CE",2
4,"4019",232,181,179,0,2,"RECORTES CE",0
36,"36057",238171,181891,180030,1636,1861,"RECORTES CE",314
31,"31114",374,291,286,4,5,"RECORTES CE",0
18,"18020",501,365,358,2,7,"RECORTES CE",0
33,"33056",4877,3469,3420,30,49,"RECORTES CE",2
46,"46059",1240,1038,1030,3,8,"RECORTES CE",0
29,"29058",1538,1079,1062,5,17,"RECORTES CE",1
22,"22007",756,576,571,5,5,"RECORTES CE",1
31,"31115",160,116,116,3,0,"RECORTES CE",0
8,"8040",11004,8468,8431,24,37,"RECORTES CE",14
12,"12020",120,107,107,0,0,"RECORTES CE",0
36,"36058",4942,3470,3402,37,68,"RECORTES CE",3
23,"23085",2182,1733,1717,7,16,"RECORTES CE",1
50,"50047",43,32,31,1,1,"RECORTES CE",0
4,"4020",286,218,217,1,1,"RECORTES CE",0
1,"1004",1356,1007,998,3,9,"RECORTES CE",2
15,"15003",1701,1234,1210,10,24,"RECORTES CE",0
33,"33057",1538,1129,1097,14,32,"RECORTES CE",1
18,"18021",17869,13238,13004,110,234,"RECORTES CE",21
8,"8041",10692,7805,7732,48,73,"RECORTES CE",16
1,"1006",176,127,127,2,0,"RECORTES CE",1
8,"8277",171,150,150,0,0,"RECORTES CE",0
25,"25079",285,228,227,0,1,"RECORTES CE",0
12,"12021",4377,3528,3473,23,55,"RECORTES CE",4
4,"4021",180,146,143,0,3,"RECORTES CE",1
46,"46060",9287,7184,7110,40,74,"RECORTES CE",10
36,"36059",4663,3196,3115,31,81,"RECORTES CE",6
1,"1008",802,576,570,3,6,"RECORTES CE",2
50,"50048",33,25,25,0,0,"RECORTES CE",0
25,"25081",287,221,220,2,1,"RECORTES CE",0
15,"15005",25263,17634,17347,257,287,"RECORTES CE",39
44,"44187",193,155,151,1,4,"RECORTES CE",0
36,"36060",30432,22488,22196,199,292,"RECORTES CE",33
4,"4022",357,261,261,0,0,"RECORTES CE",0
26,"26128",96,74,74,1,0,"RECORTES CE",0
48,"48901",5151,4042,4012,22,30,"RECORTES CE",9
8,"8278",4893,4034,4018,17,16,"RECORTES CE",2
46,"46061",343,285,280,4,5,"RECORTES CE",0
50,"50050",86,65,65,1,0,"RECORTES CE",0
23,"23087",11185,8500,8363,65,137,"RECORTES CE",6
26,"26129",936,770,759,1,11,"RECORTES CE",2
18,"18023",15645,11708,11561,91,147,"RECORTES CE",14
23,"23088",6020,4779,4703,56,76,"RECORTES CE",4
31,"31119",36,26,25,0,1,"RECORTES CE",0
36,"36061",8617,6498,6391,59,107,"RECORTES CE",12
29,"29062",651,576,567,4,9,"RECORTES CE",0
43,"43906",2103,1595,1587,14,8,"RECORTES CE",1
1,"1009",1265,920,914,6,6,"RECORTES CE",0
50,"50051",800,615,608,3,7,"RECORTES CE",1
8,"8043",3378,2579,2569,20,10,"RECORTES CE",6
46,"46062",4572,3571,3510,20,61,"RECORTES CE",1
22,"22012",102,81,80,1,1,"RECORTES CE",0
8,"8121",87292,67638,67328,362,310,"RECORTES CE",92
4,"4024",3225,2558,2534,23,24,"RECORTES CE",1
50,"50298",5427,4373,4323,30,50,"RECORTES CE",9
43,"43111",2098,1496,1483,8,13,"RECORTES CE",2
23,"23090",1219,1014,1004,5,10,"RECORTES CE",2
1,"1010",2315,1789,1770,14,19,"RECORTES CE",6
18,"18024",831,682,667,6,15,"RECORTES CE",1
36,"36901",4152,3400,3338,15,62,"RECORTES CE",4
4,"4026",55,46,45,1,1,"RECORTES CE",0
12,"12025",121,102,99,0,3,"RECORTES CE",0
33,"33061",350,201,200,2,1,"RECORTES CE",0
48,"48903",1807,1471,1462,6,9,"RECORTES CE",2
6,"6002",4314,3181,3086,44,95,"RECORTES CE",9
50,"50140",157,108,108,0,0,"RECORTES CE",0
1,"1011",215,179,175,3,4,"RECORTES CE",0
50,"50901",140,108,108,0,0,"RECORTES CE",0
23,"23091",679,575,571,3,4,"RECORTES CE",0
6,"6102",1019,852,842,2,10,"RECORTES CE",0
50,"50052",85,64,64,0,0,"RECORTES CE",0
18,"18025",279,214,212,0,2,"RECORTES CE",0
36,"36902",5052,3813,3724,21,89,"RECORTES CE",3
8,"8045",71,52,49,0,3,"RECORTES CE",0
15,"15008",5631,4320,4267,64,53,"RECORTES CE",5
12,"12117",3545,2770,2698,11,72,"RECORTES CE",4
50,"50141",109,90,90,1,0,"RECORTES CE",0
31,"31123",617,392,388,3,4,"RECORTES CE",1
50,"50902",79,69,69,0,0,"RECORTES CE",0
4,"4028",202,183,181,0,2,"RECORTES CE",0
1,"1013",703,491,487,2,4,"RECORTES CE",0
8,"8281",4840,4009,3998,23,11,"RECORTES CE",6
15,"15009",10615,8066,7919,93,147,"RECORTES CE",13
50,"50053",650,505,497,4,8,"RECORTES CE",0
8,"8282",6711,5696,5677,27,19,"RECORTES CE",1
18,"18027",2604,1902,1887,6,15,"RECORTES CE",0
46,"46065",1576,1246,1228,6,18,"RECORTES CE",3
48,"48905",2490,1911,1891,16,20,"RECORTES CE",3
8,"8046",13478,10989,10939,67,50,"RECORTES CE",10
12,"12027",17473,12829,12683,90,146,"RECORTES CE",20
50,"50054",56,48,47,0,1,"RECORTES CE",0
1,"1014",366,283,277,7,6,"RECORTES CE",0
48,"48906",753,611,608,1,3,"RECORTES CE",1
6,"6005",1691,1246,1225,15,21,"RECORTES CE",1
4,"4029",8819,6149,6073,45,76,"RECORTES CE",2
31,"31125",274,211,207,7,4,"RECORTES CE",0
26,"26135",153,123,123,1,0,"RECORTES CE",0
8,"8283",6113,4832,4813,33,19,"RECORTES CE",3
18,"18028",907,766,756,0,10,"RECORTES CE",0
50,"50055",3627,2627,2571,41,56,"RECORTES CE",8
12,"12028",12955,10391,10301,68,90,"RECORTES CE",7
1,"1016",421,236,229,3,7,"RECORTES CE",0
44,"44003",17,14,14,0,0,"RECORTES CE",1
23,"23094",3729,3111,3077,16,34,"RECORTES CE",3
43,"43115",128,112,111,1,1,"RECORTES CE",0
26,"26136",92,80,80,3,0,"RECORTES CE",0
46,"46067",1744,1451,1432,4,19,"RECORTES CE",1
18,"18029",1813,1183,1169,9,14,"RECORTES CE",0
4,"4031",2249,1778,1773,2,5,"RECORTES CE",1
1,"1017",816,579,574,2,5,"RECORTES CE",2
12,"12029",673,566,556,3,10,"RECORTES CE",0
8,"8205",61279,51629,51497,360,132,"RECORTES CE",83
8,"8047",3737,2903,2876,16,27,"RECORTES CE",2
31,"31127",135,96,96,0,0,"RECORTES CE",1
50,"50144",31,26,25,0,1,"RECORTES CE",0
23,"23095",8591,6634,6571,27,63,"RECORTES CE",3
15,"15012",3611,2695,2616,36,79,"RECORTES CE",4
50,"50056",405,332,330,4,2,"RECORTES CE",1
8,"8284",12482,8959,8887,41,72,"RECORTES CE",9
6,"6007",1433,1078,1071,5,7,"RECORTES CE",0
1,"1018",1408,998,993,6,5,"RECORTES CE",0
18,"18030",567,448,442,4,6,"RECORTES CE",0
25,"25191",321,248,244,3,4,"RECORTES CE",0
31,"31128",341,255,250,3,5,"RECORTES CE",2
31,"31129",384,260,259,0,1,"RECORTES CE",0
12,"12121",1044,941,915,4,26,"RECORTES CE",1
12,"12031",3942,2976,2931,24,45,"RECORTES CE",0
44,"44196",125,96,95,2,1,"RECORTES CE",0
23,"23096",2571,2099,2063,9,36,"RECORTES CE",0
1,"1019",148,121,121,0,0,"RECORTES CE",0
50,"50057",1332,1001,986,10,15,"RECORTES CE",2
18,"18032",242,180,178,2,2,"RECORTES CE",0
8,"8127",2240,1694,1683,13,11,"RECORTES CE",3
15,"15013",6299,4549,4486,45,63,"RECORTES CE",11
8,"8285",10321,8169,8120,52,49,"RECORTES CE",6
12,"12032",23649,17680,17505,118,175,"RECORTES CE",20
25,"25093",629,489,487,4,2,"RECORTES CE",2
26,"26141",100,73,73,0,0,"RECORTES CE",0
48,"48909",202,172,172,2,0,"RECORTES CE",0
8,"8049",1320,981,977,5,4,"RECORTES CE",1
1,"1020",320,239,238,1,1,"RECORTES CE",0
50,"50058",63,54,53,2,1,"RECORTES CE",0
23,"23097",6356,4509,4462,17,47,"RECORTES CE",4
18,"18033",279,221,220,1,1,"RECORTES CE",0
22,"22020",119,91,87,1,4,"RECORTES CE",0
26,"26142",784,651,641,5,10,"RECORTES CE",1
1,"1021",469,333,330,1,3,"RECORTES CE",1
43,"43118",425,357,356,0,1,"RECORTES CE",0
6,"6010",1075,859,846,8,13,"RECORTES CE",0
48,"48911",388,323,322,3,1,"RECORTES CE",1
31,"31131",907,719,712,8,7,"RECORTES CE",1
12,"12033",1951,1528,1506,10,22,"RECORTES CE",1
50,"50059",754,599,589,6,10,"RECORTES CE",0
8,"8050",136,115,114,0,1,"RECORTES CE",0
23,"23098",838,721,715,2,6,"RECORTES CE",0
15,"15015",2883,2079,2049,21,30,"RECORTES CE",2
4,"4036",223,188,186,1,2,"RECORTES CE",0
26,"26143",242,190,189,0,1,"RECORTES CE",0
18,"18034",486,376,374,4,2,"RECORTES CE",0
22,"22021",1884,1465,1450,13,15,"RECORTES CE",1
1,"1022",761,577,569,5,8,"RECORTES CE",4
8,"8287",1057,877,871,7,6,"RECORTES CE",0
31,"31133",35,28,28,0,0,"RECORTES CE",0
12,"12034",1400,1108,1080,7,28,"RECORTES CE",0
46,"46072",3542,3008,2961,33,47,"RECORTES CE",1
8,"8051",18437,14951,14887,85,64,"RECORTES CE",7
50,"50060",170,137,135,2,2,"RECORTES CE",1
22,"22909",301,233,231,4,2,"RECORTES CE",0
15,"15016",4569,3171,3146,18,25,"RECORTES CE",3
27,"27062",584,467,466,3,1,"RECORTES CE",0
31,"31134",175,130,128,1,2,"RECORTES CE",0
18,"18035",1190,965,952,4,13,"RECORTES CE",1
6,"6012",3233,2515,2492,15,23,"RECORTES CE",0
1,"1023",262,210,206,3,4,"RECORTES CE",0
8,"8052",139,111,110,0,1,"RECORTES CE",0
43,"43119",838,630,628,4,2,"RECORTES CE",2
25,"25097",84,72,72,1,0,"RECORTES CE",0
46,"46164",12073,8987,8836,63,151,"RECORTES CE",21
12,"12036",546,428,420,9,8,"RECORTES CE",0
46,"46073",1077,867,862,10,5,"RECORTES CE",0
23,"23101",352,273,271,0,2,"RECORTES CE",0
25,"25098",232,172,170,2,2,"RECORTES CE",0
50,"50061",193,173,169,1,4,"RECORTES CE",0
18,"18036",3970,3197,3149,26,48,"RECORTES CE",5
43,"43120",421,302,297,2,5,"RECORTES CE",0
26,"26145",237,207,204,0,3,"RECORTES CE",0
15,"15018",1087,771,761,8,10,"RECORTES CE",2
22,"22024",222,179,177,1,2,"RECORTES CE",2
1,"1027",430,295,293,2,2,"RECORTES CE",2
44,"44201",478,417,412,3,5,"RECORTES CE",0
46,"46074",2678,2158,2135,13,23,"RECORTES CE",4
8,"8053",2865,2105,2098,17,7,"RECORTES CE",1
48,"48914",325,286,285,0,1,"RECORTES CE",1
23,"23901",1139,946,934,3,12,"RECORTES CE",1
18,"18143",949,757,740,5,17,"RECORTES CE",0
31,"31136",452,337,333,5,4,"RECORTES CE",4
18,"18037",528,435,426,2,9,"RECORTES CE",0
23,"23902",2229,1843,1820,7,23,"RECORTES CE",0
4,"4043",511,423,421,3,2,"RECORTES CE",0
1,"1028",1068,774,772,7,2,"RECORTES CE",0
50,"50062",1863,1441,1416,9,25,"RECORTES CE",4
46,"46075",147,136,134,2,2,"RECORTES CE",0
48,"48915",347,259,259,4,0,"RECORTES CE",0
12,"12038",156,110,109,1,1,"RECORTES CE",0
50,"50063",61,54,54,0,0,"RECORTES CE",0
31,"31138",954,699,698,8,1,"RECORTES CE",3
18,"18144",803,650,640,2,10,"RECORTES CE",1
1,"1030",143,118,117,1,1,"RECORTES CE",1
6,"6115",1243,898,876,3,22,"RECORTES CE",1
43,"43122",111,98,97,0,1,"RECORTES CE",0
44,"44011",48,32,32,1,0,"RECORTES CE",0
18,"18038",1047,810,787,4,23,"RECORTES CE",0
50,"50064",438,368,362,1,6,"RECORTES CE",1
8,"8055",541,443,442,2,1,"RECORTES CE",0
44,"44204",27,22,22,0,0,"RECORTES CE",0
8,"8291",4919,3865,3854,28,11,"RECORTES CE",7
12,"12039",792,688,680,3,8,"RECORTES CE",0
6,"6016",2943,2283,2247,24,36,"RECORTES CE",1
1,"1031",1163,948,928,6,20,"RECORTES CE",2
23,"23904",2604,1727,1701,7,26,"RECORTES CE",0
4,"4045",1704,1355,1326,12,29,"RECORTES CE",2
6,"6017",257,211,210,1,1,"RECORTES CE",0
18,"18039",3382,2517,2490,20,27,"RECORTES CE",1
46,"46077",7344,5873,5761,49,112,"RECORTES CE",6
12,"12040",118683,91285,90499,666,786,"RECORTES CE",139
1,"1032",500,372,362,1,10,"RECORTES CE",0
29,"29068",7716,5347,5230,58,117,"RECORTES CE",9
27,"27901",2275,1542,1531,27,11,"RECORTES CE",4
25,"25102",661,517,511,8,6,"RECORTES CE",0
31,"31263",231,154,154,0,0,"RECORTES CE",0
39,"39021",467,392,385,2,7,"RECORTES CE",0
8,"8056",42727,33215,33054,220,161,"RECORTES CE",68
50,"50065",55,43,43,1,0,"RECORTES CE",0
15,"15022",5574,3846,3798,41,48,"RECORTES CE",6
44,"44205",634,444,426,9,18,"RECORTES CE",0
46,"46078",28394,20928,20748,156,180,"RECORTES CE",41
18,"18040",226,146,145,0,1,"RECORTES CE",0
23,"23905",1840,1358,1341,9,17,"RECORTES CE",2
1,"1033",656,533,525,1,8,"RECORTES CE",1
18,"18042",418,344,340,7,4,"RECORTES CE",1
17,"17093",922,716,715,2,1,"RECORTES CE",0
8,"8293",228,187,187,1,0,"RECORTES CE",0
6,"6019",2012,1539,1495,14,44,"RECORTES CE",0
43,"43124",472,379,373,1,6,"RECORTES CE",1
8,"8057",61,50,50,0,0,"RECORTES CE",0
31,"31142",1390,994,982,8,12,"RECORTES CE",0
46,"46170",3408,2769,2720,16,49,"RECORTES CE",4
46,"46079",313,252,248,1,4,"RECORTES CE",0
31,"31143",93,58,52,0,6,"RECORTES CE",0
50,"50066",2835,2199,2177,19,22,"RECORTES CE",5
1,"1034",150,111,111,2,0,"RECORTES CE",1
50,"50067",13788,10562,10413,107,149,"RECORTES CE",35
44,"44207",130,101,101,1,0,"RECORTES CE",0
39,"39023",6523,5205,5144,22,61,"RECORTES CE",2
8,"8058",1787,1357,1340,5,17,"RECORTES CE",1
25,"25205",562,451,447,7,4,"RECORTES CE",0
31,"31901",15510,12225,12133,114,92,"RECORTES CE",38
18,"18043",130,93,93,0,0,"RECORTES CE",0
31,"31144",763,504,503,1,1,"RECORTES CE",0
46,"46080",985,799,788,5,11,"RECORTES CE",0
6,"6020",1739,1420,1387,5,33,"RECORTES CE",0
8,"8295",11184,8566,8529,43,37,"RECORTES CE",18
43,"43125",890,700,698,12,2,"RECORTES CE",0
1,"1036",14772,10850,10746,69,104,"RECORTES CE",27
15,"15025",1000,639,631,6,8,"RECORTES CE",0
4,"4050",751,522,519,1,3,"RECORTES CE",0
25,"25104",122,91,91,0,0,"RECORTES CE",0
31,"31145",161,131,129,1,2,"RECORTES CE",0
33,"33078",126,87,85,0,2,"RECORTES CE",0
18,"18044",164,113,112,0,1,"RECORTES CE",0
6,"6021",908,708,698,9,10,"RECORTES CE",0
46,"46081",9993,7972,7882,51,90,"RECORTES CE",5
22,"22036",88,76,75,0,1,"RECORTES CE",0
1,"1037",585,426,425,1,1,"RECORTES CE",0
50,"50068",1947,1402,1389,11,13,"RECORTES CE",4
12,"12044",452,403,400,4,3,"RECORTES CE",0
43,"43126",1211,1005,999,4,6,"RECORTES CE",0
18,"18150",6903,5149,5063,42,86,"RECORTES CE",4
17,"17007",1752,1430,1422,2,8,"RECORTES CE",0
8,"8060",135,111,109,0,2,"RECORTES CE",0
31,"31146",29,25,25,1,0,"RECORTES CE",0
50,"50159",641,527,526,8,1,"RECORTES CE",1
6,"6022",2634,2156,2112,7,44,"RECORTES CE",4
46,"46082",4958,3801,3759,21,42,"RECORTES CE",4
1,"1039",195,157,153,0,4,"RECORTES CE",0
50,"50069",67,44,44,0,0,"RECORTES CE",0
6,"6023",4170,3088,3045,18,43,"RECORTES CE",4
12,"12045",328,275,271,2,4,"RECORTES CE",0
43,"43127",759,630,626,3,4,"RECORTES CE",0
18,"18045",1060,748,737,10,11,"RECORTES CE",0
44,"44018",16,16,16,0,0,"RECORTES CE",0
20,"20003",551,401,399,2,2,"RECORTES CE",0
31,"31147",106,88,86,3,2,"RECORTES CE",1
50,"50245",76,58,58,0,0,"RECORTES CE",0
43,"43128",905,751,747,4,4,"RECORTES CE",0
17,"17008",3594,2763,2741,16,22,"RECORTES CE",0
1,"1041",152,107,103,2,4,"RECORTES CE",1
8,"8297",135,111,111,1,0,"RECORTES CE",0
18,"18046",1753,1206,1185,1,21,"RECORTES CE",2
50,"50070",49,28,28,0,0,"RECORTES CE",0
4,"4053",12500,9437,9298,56,139,"RECORTES CE",11
8,"8061",1590,1236,1233,8,3,"RECORTES CE",1
1,"1042",907,723,721,4,2,"RECORTES CE",1
12,"12046",182,161,161,1,0,"RECORTES CE",0
18,"18152",906,692,686,1,6,"RECORTES CE",0
26,"26042",799,605,596,5,9,"RECORTES CE",0
4,"4054",352,280,278,2,2,"RECORTES CE",0
50,"50071",127,89,88,0,1,"RECORTES CE",0
46,"46084",1503,1225,1195,1,30,"RECORTES CE",0
1,"1043",2337,1669,1656,18,13,"RECORTES CE",7
6,"6025",5096,3981,3904,28,77,"RECORTES CE",4
18,"18047",6074,4437,4353,33,84,"RECORTES CE",7
4,"4055",366,315,314,3,1,"RECORTES CE",0
8,"8298",26980,20900,20817,91,83,"RECORTES CE",18
44,"44211",35,24,24,0,0,"RECORTES CE",0
12,"12048",249,181,175,2,6,"RECORTES CE",0
31,"31150",199,140,139,2,1,"RECORTES CE",0
25,"25111",113,90,89,0,1,"RECORTES CE",0
15,"15030",199972,151737,150397,1576,1340,"RECORTES CE",306
8,"8062",1004,829,826,11,3,"RECORTES CE",0
8,"8063",467,406,405,3,1,"RECORTES CE",1
31,"31151",57,42,42,1,0,"RECORTES CE",1
25,"25112",268,214,212,2,2,"RECORTES CE",0
1,"1044",231,171,166,0,5,"RECORTES CE",1
43,"43130",177,145,145,0,0,"RECORTES CE",0
10,"10094",228,180,180,0,0,"RECORTES CE",0
50,"50162",137,112,110,2,2,"RECORTES CE",0
18,"18048",2462,1873,1832,16,41,"RECORTES CE",1
12,"12049",421,339,329,2,10,"RECORTES CE",1
6,"6027",645,572,568,0,4,"RECORTES CE",0
4,"4056",164,135,133,1,2,"RECORTES CE",0
46,"46177",4778,3767,3711,17,56,"RECORTES CE",8
18,"18049",596,485,481,0,4,"RECORTES CE",0
4,"4057",1260,970,953,10,17,"RECORTES CE",0
25,"25113",1116,912,908,8,4,"RECORTES CE",0
50,"50073",2117,1735,1706,13,29,"RECORTES CE",1
1,"1046",631,464,461,0,3,"RECORTES CE",1
50,"50248",502,390,377,6,13,"RECORTES CE",0
50,"50163",3787,3041,3022,31,19,"RECORTES CE",10
18,"18154",975,701,699,3,2,"RECORTES CE",0
50,"50164",388,279,272,2,7,"RECORTES CE",2
50,"50074",6166,4547,4444,33,103,"RECORTES CE",14
8,"8300",5892,4912,4880,24,32,"RECORTES CE",6
46,"46087",109,98,98,1,0,"RECORTES CE",0
4,"4058",342,256,256,0,0,"RECORTES CE",0
15,"15032",3413,2487,2414,28,73,"RECORTES CE",1
1,"1047",967,686,673,8,13,"RECORTES CE",1
3,"3004",599,465,458,4,7,"RECORTES CE",1
6,"6028",4109,3613,3538,17,75,"RECORTES CE",3
44,"44215",168,121,120,1,1,"RECORTES CE",1
17,"17013",2774,2180,2173,15,7,"RECORTES CE",4
31,"31154",211,125,124,2,1,"RECORTES CE",0
15,"15033",2422,1887,1866,13,21,"RECORTES CE",8
8,"8065",1180,967,964,4,3,"RECORTES CE",5
18,"18050",1670,1231,1213,9,18,"RECORTES CE",1
46,"46088",150,129,127,0,2,"RECORTES CE",2
8,"8301",49135,38575,38398,272,177,"RECORTES CE",109
31,"31033",46,29,28,0,1,"RECORTES CE",0
29,"29081",261,212,210,2,2,"RECORTES CE",0
1,"1049",132,100,100,1,0,"RECORTES CE",0
25,"25115",801,638,637,4,1,"RECORTES CE",0
50,"50075",72,59,59,1,0,"RECORTES CE",0
18,"18051",1090,800,795,13,5,"RECORTES CE",0
17,"17014",63,51,50,0,1,"RECORTES CE",0
8,"8066",1463,1185,1181,9,4,"RECORTES CE",2
26,"26166",147,136,136,2,0,"RECORTES CE",0
12,"12052",539,453,439,5,14,"RECORTES CE",0
46,"46089",2170,1692,1672,6,20,"RECORTES CE",1
8,"8302",9373,7001,6934,61,67,"RECORTES CE",4
4,"4060",407,308,304,1,4,"RECORTES CE",2
10,"10902",735,537,521,2,16,"RECORTES CE",0
22,"22045",73,57,56,0,1,"RECORTES CE",0
50,"50076",75,64,63,0,1,"RECORTES CE",0
4,"4061",622,501,494,4,7,"RECORTES CE",2
1,"1051",3558,2448,2433,14,15,"RECORTES CE",4
18,"18053",1561,1102,1099,3,3,"RECORTES CE",4
8,"8067",5728,4535,4513,21,22,"RECORTES CE",1
17,"17015",12819,10133,10078,38,55,"RECORTES CE",8
1,"1052",268,188,187,1,1,"RECORTES CE",0
46,"46090",1633,1413,1392,5,21,"RECORTES CE",1
12,"12053",2030,1656,1636,10,20,"RECORTES CE",0
32,"32089",1220,872,857,15,15,"RECORTES CE",1
21,"21016",993,770,744,6,26,"RECORTES CE",0
6,"6032",78,65,64,0,1,"RECORTES CE",0
4,"4062",4460,3466,3425,12,41,"RECORTES CE",4
8,"8303",256,215,213,1,2,"RECORTES CE",0
18,"18161",251,222,220,1,2,"RECORTES CE",0
1,"1053",592,376,373,2,3,"RECORTES CE",1
18,"18054",838,649,648,8,1,"RECORTES CE",0
50,"50077",206,158,157,1,1,"RECORTES CE",0
25,"25119",2245,1798,1792,10,6,"RECORTES CE",0
46,"46091",115,99,99,0,0,"RECORTES CE",0
15,"15036",56248,40194,39764,508,430,"RECORTES CE",78
50,"50078",231,173,171,0,2,"RECORTES CE",0
12,"12055",106,85,83,2,2,"RECORTES CE",0
31,"31159",1105,880,871,3,9,"RECORTES CE",0
8,"8068",6878,5456,5437,25,19,"RECORTES CE",16
6,"6033",1269,1026,1010,4,16,"RECORTES CE",0
22,"22047",241,213,212,2,1,"RECORTES CE",0
4,"4063",1063,847,835,5,12,"RECORTES CE",2
1,"1054",1013,729,726,2,3,"RECORTES CE",2
25,"25120",92704,68713,68361,445,352,"RECORTES CE",94
18,"18056",3418,2523,2478,22,45,"RECORTES CE",2
46,"46092",263,182,179,1,3,"RECORTES CE",0
43,"43135",341,283,280,4,3,"RECORTES CE",0
8,"8069",3280,2691,2680,17,11,"RECORTES CE",3
12,"12901",3357,2693,2675,19,18,"RECORTES CE",4
50,"50079",227,182,178,1,4,"RECORTES CE",1
8,"8305",27533,21656,21539,96,117,"RECORTES CE",18
4,"4064",2879,2196,2179,12,17,"RECORTES CE",2
31,"31160",105,87,86,1,1,"RECORTES CE",0
39,"39035",9169,7135,7045,40,90,"RECORTES CE",5
26,"26053",195,161,160,3,1,"RECORTES CE",1
4,"4065",368,287,284,2,3,"RECORTES CE",0
15,"15038",2123,1441,1413,25,28,"RECORTES CE",1
12,"12902",2248,1678,1653,7,25,"RECORTES CE",4
12,"12057",578,485,473,3,12,"RECORTES CE",0
46,"46093",2134,1700,1687,8,13,"RECORTES CE",0
1,"1055",840,608,602,10,6,"RECORTES CE",0
18,"18057",5540,4306,4246,30,60,"RECORTES CE",6
26,"26054",292,235,231,2,4,"RECORTES CE",0
1,"1056",205,134,134,0,0,"RECORTES CE",1
18,"18164",1794,1225,1205,9,20,"RECORTES CE",0
18,"18059",4253,3166,3123,22,43,"RECORTES CE",0
8,"8306",527,390,388,2,2,"RECORTES CE",1
4,"4066",13488,9324,9255,73,69,"RECORTES CE",2
25,"25122",1925,1505,1497,23,8,"RECORTES CE",1
46,"46185",364,315,310,1,5,"RECORTES CE",0
46,"46094",20691,15841,15672,88,169,"RECORTES CE",27
31,"31163",2002,1507,1475,14,32,"RECORTES CE",6
50,"50080",34,29,29,0,0,"RECORTES CE",0
6,"6135",1096,915,902,3,13,"RECORTES CE",0
10,"10106",127,108,106,0,2,"RECORTES CE",0
12,"12058",64,56,56,0,0,"RECORTES CE",0
17,"17110",1329,1064,1054,5,10,"RECORTES CE",0
1,"1057",243,202,199,0,3,"RECORTES CE",0
18,"18061",1000,827,822,1,5,"RECORTES CE",1
17,"17020",3671,3021,3006,11,15,"RECORTES CE",3
25,"25123",189,151,151,0,0,"RECORTES CE",0
31,"31164",545,438,433,6,5,"RECORTES CE",2
46,"46095",578,467,458,1,9,"RECORTES CE",0
25,"25023",4527,3621,3601,23,20,"RECORTES CE",3
1,"1058",1403,958,951,4,7,"RECORTES CE",2
8,"8071",241,200,200,0,0,"RECORTES CE",0
50,"50081",491,390,384,5,6,"RECORTES CE",0
12,"12059",228,191,188,0,3,"RECORTES CE",0
18,"18062",11041,8531,8355,71,176,"RECORTES CE",5
22,"22051",91,78,78,1,0,"RECORTES CE",0
8,"8308",137,118,118,0,0,"RECORTES CE",0
50,"50082",84,63,63,0,0,"RECORTES CE",0
43,"43064",2017,1569,1558,9,11,"RECORTES CE",2
25,"25124",157,114,114,0,0,"RECORTES CE",0
8,"8072",10699,8226,8193,45,33,"RECORTES CE",9
4,"4069",4757,3633,3588,25,45,"RECORTES CE",4
26,"26175",47,40,40,2,0,"RECORTES CE",0
15,"15041",9581,7223,7082,96,141,"RECORTES CE",13
12,"12060",430,368,365,1,3,"RECORTES CE",0
38,"38004",4490,3242,3202,18,40,"RECORTES CE",7
44,"44224",21,15,15,0,0,"RECORTES CE",0
43,"43139",1999,1552,1539,10,13,"RECORTES CE",0
1,"1059",189037,133121,131768,792,1353,"RECORTES CE",416
29,"29001",4199,3380,3341,20,39,"RECORTES CE",1
46,"46097",958,764,756,6,8,"RECORTES CE",0
17,"17022",7008,5386,5354,22,32,"RECORTES CE",6
1,"1060",201,174,166,1,8,"RECORTES CE",0
8,"8073",62572,48770,48527,255,243,"RECORTES CE",125
20,"20017",8484,6294,6263,25,31,"RECORTES CE",6
29,"29002",1150,851,842,4,9,"RECORTES CE",0
6,"6039",1807,1506,1474,13,32,"RECORTES CE",0
18,"18063",1217,712,702,6,10,"RECORTES CE",0
12,"12061",380,277,274,2,3,"RECORTES CE",0
31,"31167",831,651,636,3,15,"RECORTES CE",2
25,"25125",389,303,300,1,3,"RECORTES CE",0
44,"44225",103,82,81,0,1,"RECORTES CE",0
46,"46098",2403,1807,1772,8,35,"RECORTES CE",1
50,"50084",66,47,47,0,0,"RECORTES CE",0
8,"8074",11054,8273,8235,34,38,"RECORTES CE",17
20,"20018",11218,8145,8109,41,36,"RECORTES CE",2
38,"38006",41302,23632,23415,133,217,"RECORTES CE",41
4,"4071",363,303,301,2,2,"RECORTES CE",0
8,"8902",3937,3176,3164,17,12,"RECORTES CE",7
15,"15044",1209,889,876,4,13,"RECORTES CE",2
29,"29003",922,740,727,3,13,"RECORTES CE",0
18,"18064",366,307,306,0,1,"RECORTES CE",0
1,"1061",152,129,129,2,0,"RECORTES CE",1
46,"46190",50023,37273,36976,250,297,"RECORTES CE",100
50,"50085",183,136,136,1,0,"RECORTES CE",2
22,"22055",310,258,255,2,3,"RECORTES CE",1
12,"12063",44,37,37,1,0,"RECORTES CE",0
4,"4072",314,245,240,0,5,"RECORTES CE",0
1,"1062",315,236,229,2,7,"RECORTES CE",3
25,"25127",214,172,172,0,0,"RECORTES CE",0
15,"15045",3629,2263,2237,9,26,"RECORTES CE",2
4,"4073",336,243,243,0,0,"RECORTES CE",0
31,"31170",45,37,36,2,1,"RECORTES CE",0
18,"18065",591,482,468,4,14,"RECORTES CE",0
29,"29004",295,233,226,0,7,"RECORTES CE",0
6,"6042",981,714,705,4,9,"RECORTES CE",0
8,"8075",4059,3127,3119,14,8,"RECORTES CE",3
46,"46100",281,210,205,0,5,"RECORTES CE",0
12,"12064",80,75,73,1,2,"RECORTES CE",0
31,"31049",679,512,505,2,7,"RECORTES CE",2
1,"1063",1830,1363,1353,4,10,"RECORTES CE",2
6,"6043",686,553,544,6,9,"RECORTES CE",4
50,"50086",178,121,119,2,2,"RECORTES CE",0
29,"29005",4499,3202,3171,37,31,"RECORTES CE",5
18,"18066",2108,1537,1525,9,12,"RECORTES CE",1
25,"25128",127,87,87,0,0,"RECORTES CE",0
44,"44227",72,61,61,0,0,"RECORTES CE",0
1,"1901",2474,1655,1631,13,24,"RECORTES CE",12
4,"4074",2887,2062,2038,16,24,"RECORTES CE",2
8,"8076",16497,12734,12667,82,67,"RECORTES CE",17
31,"31172",365,287,275,4,12,"RECORTES CE",4
20,"20021",186,112,112,0,0,"RECORTES CE",0
12,"12065",171,150,147,0,3,"RECORTES CE",0
46,"46101",816,696,687,3,9,"RECORTES CE",1
44,"44228",99,83,83,0,0,"RECORTES CE",0
29,"29095",3304,2536,2470,22,66,"RECORTES CE",3
29,"29006",665,491,483,5,8,"RECORTES CE",0
8,"8077",34578,27617,27501,134,116,"RECORTES CE",53
18,"18067",681,511,507,3,4,"RECORTES CE",0
50,"50087",29,18,18,0,0,"RECORTES CE",0
6,"6044",29204,21778,21492,203,286,"RECORTES CE",19
22,"22059",1139,867,855,10,12,"RECORTES CE",5
8,"8905",2308,1943,1938,7,5,"RECORTES CE",2
46,"46102",19635,15330,15207,95,123,"RECORTES CE",23
1,"1902",730,551,545,6,6,"RECORTES CE",0
12,"12067",523,423,416,1,7,"RECORTES CE",0
25,"25130",183,142,140,0,2,"RECORTES CE",0
4,"4076",1221,951,933,8,18,"RECORTES CE",1
31,"31174",107,70,70,0,0,"RECORTES CE",1
8,"8078",219,176,172,1,4,"RECORTES CE",0
29,"29007",28584,21525,21318,202,207,"RECORTES CE",61
4,"4077",302,275,275,1,0,"RECORTES CE",0
50,"50088",282,233,227,2,6,"RECORTES CE",0
46,"46103",1338,1056,1042,5,14,"RECORTES CE",0
18,"18068",1606,1293,1277,11,16,"RECORTES CE",0
31,"31175",64,50,50,0,0,"RECORTES CE",0
50,"50179",264,231,228,0,3,"RECORTES CE",0
22,"22188",76,60,59,1,1,"RECORTES CE",0
20,"20024",391,274,274,1,0,"RECORTES CE",1
32,"32017",1202,821,815,6,6,"RECORTES CE",1
4,"4078",1110,819,814,2,5,"RECORTES CE",0
50,"50089",8584,6951,6912,34,39,"RECORTES CE",11
29,"29009",1441,1097,1073,8,24,"RECORTES CE",0
15,"15049",1091,805,796,8,9,"RECORTES CE",0
38,"38012",2310,1705,1687,6,18,"RECORTES CE",0
25,"25131",402,321,320,1,1,"RECORTES CE",1
18,"18069",497,374,366,4,8,"RECORTES CE",0
46,"46104",1891,1515,1481,17,34,"RECORTES CE",5
31,"31176",2930,2204,2134,33,70,"RECORTES CE",11
12,"12069",53,45,44,1,1,"RECORTES CE",0
8,"8079",334,284,282,0,2,"RECORTES CE",0
15,"15050",1748,1038,1027,15,11,"RECORTES CE",0
44,"44231",36,33,32,0,1,"RECORTES CE",0
29,"29099",969,757,735,5,22,"RECORTES CE",0
27,"27002",1546,1136,1103,9,33,"RECORTES CE",0
50,"50090",134,108,108,0,0,"RECORTES CE",0
32,"32018",1179,950,936,3,14,"RECORTES CE",0
36,"36013",2242,1468,1452,15,16,"RECORTES CE",1
4,"4079",54086,38415,38134,239,281,"RECORTES CE",64
46,"46105",16132,11703,11582,64,121,"RECORTES CE",14
18,"18070",289,224,222,3,2,"RECORTES CE",0
12,"12070",499,434,430,3,4,"RECORTES CE",0
29,"29010",1632,1372,1319,4,53,"RECORTES CE",2
8,"8080",39,30,30,0,0,"RECORTES CE",0
50,"50181",1000,770,754,7,16,"RECORTES CE",1
4,"4080",199,158,157,0,1,"RECORTES CE",0
27,"27003",1772,1271,1241,6,30,"RECORTES CE",0
15,"15051",4562,3302,3249,36,53,"RECORTES CE",1
25,"25133",686,528,527,2,1,"RECORTES CE",0
50,"50091",40,35,35,0,0,"RECORTES CE",0
31,"31179",483,348,344,2,4,"RECORTES CE",0
46,"46106",1466,1156,1142,3,14,"RECORTES CE",2
4,"4081",346,272,271,2,1,"RECORTES CE",0
18,"18071",5612,4271,4184,29,87,"RECORTES CE",6
29,"29011",2871,1955,1926,11,29,"RECORTES CE",0
12,"12071",1267,1021,1006,11,15,"RECORTES CE",1
50,"50092",300,234,230,1,4,"RECORTES CE",1
8,"8159",14323,11399,11359,57,40,"RECORTES CE",23
29,"29901",44578,31840,31537,286,303,"RECORTES CE",53
25,"25134",603,492,490,1,2,"RECORTES CE",1
17,"17032",1742,1235,1224,6,11,"RECORTES CE",2
29,"29012",9718,7243,7123,47,120,"RECORTES CE",9
46,"46107",1849,1501,1480,5,21,"RECORTES CE",0
8,"8081",353,299,297,2,2,"RECORTES CE",0
18,"18072",664,481,473,0,8,"RECORTES CE",0
22,"22195",234,193,192,0,1,"RECORTES CE",2
31,"31180",197,155,154,2,1,"RECORTES CE",0
12,"12072",1082,901,889,15,12,"RECORTES CE",0
4,"4082",277,198,196,1,2,"RECORTES CE",0
50,"50093",83,66,66,1,0,"RECORTES CE",0
10,"10001",283,233,232,3,1,"RECORTES CE",0
29,"29902",2592,1841,1817,18,24,"RECORTES CE",1
44,"44235",89,67,66,2,1,"RECORTES CE",0
29,"29013",1602,1262,1238,12,24,"RECORTES CE",0
8,"8082",1143,868,861,4,7,"RECORTES CE",3
6,"6051",1543,1206,1188,3,18,"RECORTES CE",1
38,"38016",1178,654,648,6,6,"RECORTES CE",1
18,"18074",264,207,205,0,2,"RECORTES CE",1
23,"23040",1443,1164,1149,3,15,"RECORTES CE",1
12,"12073",132,110,107,1,3,"RECORTES CE",0
43,"43148",90763,69756,69423,299,333,"RECORTES CE",83
27,"27006",2458,1713,1666,27,47,"RECORTES CE",0
20,"20029",4272,3257,3239,18,18,"RECORTES CE",0
10,"10003",540,388,386,4,2,"RECORTES CE",0
50,"50094",1518,1172,1155,20,17,"RECORTES CE",2
44,"44236",59,44,44,0,0,"RECORTES CE",0
29,"29014",222,151,150,6,1,"RECORTES CE",0
46,"46109",6174,4763,4639,30,124,"RECORTES CE",10
8,"8083",1672,1478,1471,7,7,"RECORTES CE",0
38,"38017",30646,18576,18373,100,203,"RECORTES CE",33
39,"39050",255,188,184,2,4,"RECORTES CE",0
18,"18076",790,607,604,1,3,"RECORTES CE",1
12,"12074",761,659,645,7,14,"RECORTES CE",0
15,"15055",4485,3097,3057,39,40,"RECORTES CE",3
18,"18077",471,372,366,5,6,"RECORTES CE",1
17,"17034",7205,5337,5291,16,46,"RECORTES CE",4
31,"31062",1075,870,861,10,9,"RECORTES CE",5
6,"6053",590,461,444,7,17,"RECORTES CE",0
46,"46110",21317,15839,15699,89,140,"RECORTES CE",31
25,"25137",8686,6327,6296,46,31,"RECORTES CE",4
38,"38018",4455,3242,3198,24,44,"RECORTES CE",1
50,"50095",12136,9020,8928,99,92,"RECORTES CE",11
10,"10005",530,407,384,3,23,"RECORTES CE",0
43,"43150",1238,1034,1026,6,8,"RECORTES CE",1
8,"8084",1167,941,936,6,5,"RECORTES CE",0
29,"29016",263,217,217,0,0,"RECORTES CE",0
12,"12075",107,89,87,0,2,"RECORTES CE",0
17,"17035",550,460,460,3,0,"RECORTES CE",0
4,"4086",1643,1226,1209,6,17,"RECORTES CE",0
38,"38019",13758,8870,8776,46,94,"RECORTES CE",8
46,"46111",11326,8603,8492,55,111,"RECORTES CE",15
6,"6154",2799,2075,2022,15,53,"RECORTES CE",2
30,"30002",9735,7319,7227,33,92,"RECORTES CE",6
8,"8085",976,812,811,2,1,"RECORTES CE",1
29,"29017",6428,4943,4871,32,72,"RECORTES CE",8
10,"10006",1230,1006,995,8,11,"RECORTES CE",1
18,"18078",710,561,554,4,7,"RECORTES CE",0
12,"12076",76,64,64,1,0,"RECORTES CE",0
25,"25138",547,440,436,1,4,"RECORTES CE",0
31,"31186",288,220,216,1,4,"RECORTES CE",1
18,"18184",2170,1688,1656,3,32,"RECORTES CE",2
46,"46203",3544,2851,2810,21,41,"RECORTES CE",2
46,"46112",542,460,454,0,6,"RECORTES CE",0
6,"6055",1998,1552,1523,9,29,"RECORTES CE",2
38,"38020",15899,11057,10924,90,133,"RECORTES CE",21
15,"15057",12051,8814,8660,89,154,"RECORTES CE",16
50,"50098",162,121,120,3,1,"RECORTES CE",0
29,"29018",1996,1523,1481,11,42,"RECORTES CE",2
36,"36020",2184,1621,1599,13,22,"RECORTES CE",4
43,"43151",109,98,98,0,0,"RECORTES CE",0
12,"12077",4790,3594,3565,39,29,"RECORTES CE",8
18,"18079",3469,2667,2623,16,44,"RECORTES CE",3
4,"4089",694,516,510,1,6,"RECORTES CE",1
6,"6056",454,378,376,1,2,"RECORTES CE",0
50,"50099",3042,2299,2265,20,34,"RECORTES CE",3
46,"46113",2527,1906,1892,12,14,"RECORTES CE",3
44,"44240",149,121,121,0,0,"RECORTES CE",1
15,"15058",28606,22203,22022,261,181,"RECORTES CE",38
38,"38021",1599,1079,1057,8,22,"RECORTES CE",2
31,"31188",296,200,197,0,3,"RECORTES CE",0
4,"4090",312,253,249,0,4,"RECORTES CE",0
8,"8087",149,135,133,0,2,"RECORTES CE",0
31,"31189",1127,781,775,10,6,"RECORTES CE",5
18,"18082",827,587,577,5,10,"RECORTES CE",1
8,"8245",77805,57956,57666,313,290,"RECORTES CE",142
10,"10010",2213,1499,1470,6,29,"RECORTES CE",2
12,"12078",333,238,235,1,3,"RECORTES CE",0
46,"46114",574,457,452,1,5,"RECORTES CE",1
3,"3031",41857,28648,28362,163,286,"RECORTES CE",43
50,"50100",306,238,235,3,3,"RECORTES CE",0
44,"44241",506,416,407,1,9,"RECORTES CE",2
38,"38022",18629,12903,12759,84,144,"RECORTES CE",11
29,"29020",3280,2531,2485,23,46,"RECORTES CE",2
8,"8088",12248,9945,9904,57,41,"RECORTES CE",8
50,"50189",678,544,534,5,10,"RECORTES CE",0
6,"6058",1980,1519,1493,13,26,"RECORTES CE",2
17,"17039",1740,1385,1380,8,5,"RECORTES CE",0
18,"18083",228,189,188,1,1,"RECORTES CE",0
12,"12079",419,346,336,2,10,"RECORTES CE",0
46,"46115",352,261,260,0,1,"RECORTES CE",0
43,"43153",11092,8327,8291,34,36,"RECORTES CE",12
50,"50101",832,625,614,1,11,"RECORTES CE",0
29,"29021",159,121,120,0,1,"RECORTES CE",2
44,"44243",27,24,23,0,1,"RECORTES CE",0
6,"6059",1759,1300,1285,12,15,"RECORTES CE",1
6,"6159",2339,1577,1507,25,70,"RECORTES CE",3
38,"38024",15310,10234,10088,82,146,"RECORTES CE",17
15,"15061",5199,3694,3601,40,93,"RECORTES CE",2
4,"4092",2789,2207,2173,6,34,"RECORTES CE",6
4,"4093",1919,1346,1326,10,20,"RECORTES CE",1
18,"18084",4458,3467,3417,17,50,"RECORTES CE",3
18,"18085",701,465,460,1,5,"RECORTES CE",0
6,"6060",5723,4401,4323,31,78,"RECORTES CE",1
10,"10013",266,203,202,2,1,"RECORTES CE",0
29,"29022",171,144,143,0,1,"RECORTES CE",0
50,"50191",445,341,337,2,4,"RECORTES CE",0
25,"25143",84,72,71,0,1,"RECORTES CE",0
29,"29023",2290,1569,1550,3,19,"RECORTES CE",3
8,"8168",394,287,287,1,0,"RECORTES CE",1
8,"8090",137,113,113,2,0,"RECORTES CE",0
17,"17041",218,166,165,3,1,"RECORTES CE",0
46,"46208",1070,875,866,2,9,"RECORTES CE",0
50,"50102",820,653,642,9,11,"RECORTES CE",1
46,"46117",500,407,399,1,8,"RECORTES CE",2
12,"12081",602,488,481,0,7,"RECORTES CE",0
22,"22078",438,326,323,3,3,"RECORTES CE",0
18,"18086",339,291,289,0,2,"RECORTES CE",0
4,"4094",209,156,154,0,2,"RECORTES CE",0
50,"50104",326,264,259,4,5,"RECORTES CE",0
43,"43155",22619,16724,16624,101,100,"RECORTES CE",10
31,"31194",326,251,250,1,1,"RECORTES CE",1
22,"22208",194,159,156,1,3,"RECORTES CE",0
22,"22079",114,89,88,1,1,"RECORTES CE",0
46,"46209",1901,1517,1500,5,17,"RECORTES CE",2
46,"46118",3670,2930,2894,25,36,"RECORTES CE",4
10,"10015",627,488,475,0,13,"RECORTES CE",0
12,"12082",9573,7672,7570,55,102,"RECORTES CE",1
29,"29024",372,265,250,3,15,"RECORTES CE",1
31,"31195",171,125,125,2,0,"RECORTES CE",0
15,"15065",7151,5281,5165,63,116,"RECORTES CE",11
29,"29025",41515,29572,29311,221,261,"RECORTES CE",58
43,"43156",3956,2993,2965,23,28,"RECORTES CE",2
4,"4096",281,239,237,1,2,"RECORTES CE",0
8,"8091",5413,4301,4283,20,18,"RECORTES CE",9
30,"30010",6857,5533,5457,38,76,"RECORTES CE",7
46,"46210",344,265,258,2,7,"RECORTES CE",0
46,"46119",752,627,614,8,13,"RECORTES CE",0
25,"25146",221,172,170,3,2,"RECORTES CE",0
50,"50105",279,216,213,4,3,"RECORTES CE",0
18,"18087",182514,141305,139588,865,1717,"RECORTES CE",228
50,"50106",127,97,96,0,1,"RECORTES CE",0
15,"15066",4008,2931,2886,30,45,"RECORTES CE",5
29,"29026",1010,747,736,3,11,"RECORTES CE",2
27,"27017",961,667,654,1,13,"RECORTES CE",0
8,"8092",3714,2912,2889,8,23,"RECORTES CE",1
31,"31197",65,56,56,0,0,"RECORTES CE",0
38,"38028",22035,15684,15522,86,162,"RECORTES CE",33
18,"18088",1530,1152,1142,0,10,"RECORTES CE",0
46,"46120",1183,958,936,3,22,"RECORTES CE",2
30,"30011",4695,3665,3610,16,55,"RECORTES CE",2
29,"29027",2309,1716,1692,18,24,"RECORTES CE",2
6,"6064",850,658,647,2,11,"RECORTES CE",0
27,"27018",3232,2114,2089,24,25,"RECORTES CE",1
12,"12084",17723,13501,13281,118,220,"RECORTES CE",10
25,"25251",713,562,558,4,4,"RECORTES CE",1
8,"8093",24,20,20,0,0,"RECORTES CE",0
50,"50107",988,837,828,11,9,"RECORTES CE",1
4,"4098",1455,1097,1087,9,10,"RECORTES CE",3
43,"43158",77,61,61,1,0,"RECORTES CE",0
15,"15067",7953,6004,5925,51,79,"RECORTES CE",9
46,"46121",111,96,94,2,2,"RECORTES CE",0
10,"10019",1416,1120,1094,3,26,"RECORTES CE",0
25,"25149",1378,1108,1102,3,6,"RECORTES CE",0
22,"22082",285,230,226,2,4,"RECORTES CE",1
18,"18089",14540,10725,10583,65,142,"RECORTES CE",12
32,"32034",1074,855,846,1,9,"RECORTES CE",0
12,"12085",5079,3504,3459,13,45,"RECORTES CE",4
4,"4099",4931,3781,3719,24,62,"RECORTES CE",5
31,"31199",141,96,94,0,2,"RECORTES CE",0
44,"44056",457,352,341,4,11,"RECORTES CE",1
29,"29028",1224,875,858,4,17,"RECORTES CE",6
44,"44250",19,15,15,0,0,"RECORTES CE",0
46,"46122",2730,2103,2071,19,32,"RECORTES CE",3
29,"29029",380,294,287,2,7,"RECORTES CE",0
50,"50108",52,43,42,0,1,"RECORTES CE",0
18,"18093",2756,1902,1885,8,17,"RECORTES CE",0
12,"12087",25,19,18,2,1,"RECORTES CE",0
31,"31200",748,555,546,5,9,"RECORTES CE",5
38,"38030",1945,1430,1420,6,10,"RECORTES CE",0
44,"44251",242,197,187,0,10,"RECORTES CE",0
43,"43013",4392,3341,3321,14,20,"RECORTES CE",4
31,"31201",151084,115375,114510,1072,865,"RECORTES CE",381
15,"15069",6588,4914,4830,58,84,"RECORTES CE",7
46,"46214",16415,12723,12610,74,113,"RECORTES CE",13
50,"50109",98,69,67,3,2,"RECORTES CE",0
46,"46123",1948,1469,1446,5,23,"RECORTES CE",0
29,"29030",774,660,657,3,3,"RECORTES CE",0
4,"4101",4375,3161,3112,34,49,"RECORTES CE",2
18,"18903",851,644,636,1,8,"RECORTES CE",1
8,"8095",67,53,52,0,1,"RECORTES CE",0
8,"8096",43555,34070,33871,194,199,"RECORTES CE",78
18,"18094",2304,1845,1798,16,47,"RECORTES CE",1
27,"27021",1649,1080,1048,14,32,"RECORTES CE",1
50,"50110",336,268,266,1,2,"RECORTES CE",0
43,"43160",1322,1051,1045,0,6,"RECORTES CE",5
18,"18095",2002,1566,1537,11,29,"RECORTES CE",2
6,"6068",431,324,317,4,7,"RECORTES CE",0
46,"46124",785,680,675,5,5,"RECORTES CE",0
25,"25152",144,106,106,1,0,"RECORTES CE",0
31,"31203",30,22,22,1,0,"RECORTES CE",0
22,"22085",96,82,81,0,1,"RECORTES CE",0
14,"14054",13796,11042,10799,102,243,"RECORTES CE",7
43,"43161",17113,12944,12881,64,63,"RECORTES CE",11
29,"29031",1559,1139,1113,13,26,"RECORTES CE",0
27,"27022",4683,3131,3059,30,72,"RECORTES CE",4
43,"43014",14357,10596,10542,60,54,"RECORTES CE",11
6,"6069",3005,2172,2133,24,39,"RECORTES CE",3
18,"18096",344,265,265,2,0,"RECORTES CE",0
12,"12089",4546,3353,3304,12,49,"RECORTES CE",6
46,"46125",846,681,675,1,6,"RECORTES CE",0
21,"21058",2556,1732,1709,21,23,"RECORTES CE",3
10,"10025",379,328,317,3,11,"RECORTES CE",3
8,"8097",1080,891,880,2,11,"RECORTES CE",0
50,"50111",183,144,142,2,2,"RECORTES CE",0
31,"31205",420,312,310,7,2,"RECORTES CE",3
29,"29032",6657,5314,5190,30,124,"RECORTES CE",5
50,"50199",325,238,232,3,6,"RECORTES CE",0
46,"46126",5574,4565,4528,25,37,"RECORTES CE",8
18,"18097",995,708,702,4,6,"RECORTES CE",0
43,"43162",4418,3467,3453,20,14,"RECORTES CE",6
6,"6071",238,197,193,0,4,"RECORTES CE",1
38,"38034",3998,3033,2993,19,40,"RECORTES CE",4
10,"10026",656,515,507,8,8,"RECORTES CE",3
29,"29033",1089,776,761,2,15,"RECORTES CE",1
31,"31206",2082,1610,1589,15,21,"RECORTES CE",6
30,"30017",11477,8952,8844,62,108,"RECORTES CE",8
27,"27024",1451,1122,1102,5,20,"RECORTES CE",0
50,"50113",584,505,495,3,10,"RECORTES CE",1
18,"18906",911,722,716,4,6,"RECORTES CE",1
12,"12091",176,131,130,0,1,"RECORTES CE",0
29,"29034",467,374,373,1,1,"RECORTES CE",2
46,"46127",2740,2174,2147,11,27,"RECORTES CE",3
10,"10027",76,66,66,0,0,"RECORTES CE",0
44,"44063",65,55,55,1,0,"RECORTES CE",0
8,"8178",451,389,388,3,1,"RECORTES CE",0
43,"43016",3445,2628,2608,11,20,"RECORTES CE",3
38,"38035",10384,6657,6596,50,61,"RECORTES CE",15
8,"8099",753,565,561,2,4,"RECORTES CE",0
27,"27025",2743,2191,2138,31,53,"RECORTES CE",4
6,"6072",2225,1777,1752,20,25,"RECORTES CE",1
43,"43163",26013,18942,18796,89,146,"RECORTES CE",28
18,"18098",5994,4293,4247,29,46,"RECORTES CE",0
50,"50114",132,111,111,1,0,"RECORTES CE",0
12,"12092",126,108,106,1,2,"RECORTES CE",0
50,"50115",3275,2399,2355,32,44,"RECORTES CE",5
29,"29035",1505,1151,1133,6,18,"RECORTES CE",0
31,"31208",2562,2067,2036,16,31,"RECORTES CE",2
8,"8100",2092,1792,1782,16,10,"RECORTES CE",0
25,"25156",784,608,605,4,3,"RECORTES CE",0
29,"29036",611,448,444,3,4,"RECORTES CE",0
43,"43164",306,228,228,0,0,"RECORTES CE",0
31,"31209",147,116,116,0,0,"RECORTES CE",1
3,"3045",213,178,173,4,5,"RECORTES CE",0
18,"18908",784,599,581,0,18,"RECORTES CE",1
18,"18099",1581,1279,1245,5,34,"RECORTES CE",4
12,"12093",165,128,126,0,2,"RECORTES CE",0
6,"6074",4755,3719,3638,27,81,"RECORTES CE",1
38,"38037",12803,8628,8517,48,111,"RECORTES CE",19
46,"46129",512,408,400,4,8,"RECORTES CE",2
30,"30020",6431,4991,4940,19,51,"RECORTES CE",0
43,"43165",572,492,492,1,0,"RECORTES CE",0
43,"43018",385,335,334,3,1,"RECORTES CE",0
22,"22090",85,66,66,1,0,"RECORTES CE",0
29,"29037",215,179,179,0,0,"RECORTES CE",0
18,"18100",7981,5900,5769,44,131,"RECORTES CE",3
15,"15076",2514,1709,1683,19,26,"RECORTES CE",3
25,"25157",162,137,137,4,0,"RECORTES CE",0
46,"46130",857,680,669,6,11,"RECORTES CE",0
50,"50116",170,132,131,0,1,"RECORTES CE",0
10,"10031",164,136,135,0,1,"RECORTES CE",0
50,"50117",125,100,100,3,0,"RECORTES CE",0
38,"38038",164468,112475,111577,728,898,"RECORTES CE",334
10,"10154",177,134,133,1,1,"RECORTES CE",0
12,"12001",1033,834,825,8,9,"RECORTES CE",2
27,"27028",78798,58316,57546,629,770,"RECORTES CE",119
25,"25158",1606,1291,1277,5,14,"RECORTES CE",2
8,"8102",28794,22420,22317,92,103,"RECORTES CE",29
7,"7010",5070,3815,3777,47,38,"RECORTES CE",4
6,"6076",824,631,620,0,11,"RECORTES CE",0
46,"46131",49504,37495,37064,259,431,"RECORTES CE",46
18,"18101",9410,7280,7181,72,99,"RECORTES CE",12
29,"29038",18683,12820,12666,168,154,"RECORTES CE",27
12,"12095",950,763,756,9,7,"RECORTES CE",0
50,"50118",2110,1622,1605,19,17,"RECORTES CE",3
50,"50205",74,58,57,0,1,"RECORTES CE",0
25,"25161",343,243,243,0,0,"RECORTES CE",0
43,"43166",1628,1292,1285,3,7,"RECORTES CE",3
10,"10033",403,306,302,6,4,"RECORTES CE",0
8,"8103",640,507,505,4,2,"RECORTES CE",1
25,"25060",69,49,49,1,0,"RECORTES CE",0
43,"43167",384,334,333,2,1,"RECORTES CE",0
29,"29039",2728,2084,2050,14,34,"RECORTES CE",2
46,"46132",2196,1877,1853,10,24,"RECORTES CE",2
6,"6077",321,260,256,4,4,"RECORTES CE",0
18,"18102",8227,6100,5969,32,131,"RECORTES CE",4
38,"38040",5446,3513,3462,13,51,"RECORTES CE",3
10,"10034",336,269,267,0,2,"RECORTES CE",0
44,"44168",184,137,136,4,1,"RECORTES CE",0
12,"12096",744,588,580,7,8,"RECORTES CE",0
41,"41029",13483,10357,10199,120,158,"RECORTES CE",18
15,"15079",1466,1076,1052,11,24,"RECORTES CE",0
31,"31214",87,66,64,0,2,"RECORTES CE",0
50,"50119",872,684,680,4,4,"RECORTES CE",0
29,"29040",1936,1419,1395,7,24,"RECORTES CE",4
46,"46133",472,374,374,2,0,"RECORTES CE",0
18,"18103",722,556,555,3,1,"RECORTES CE",0
6,"6078",506,415,410,1,5,"RECORTES CE",0
6,"6079",644,492,487,3,5,"RECORTES CE",0
12,"12097",65,54,54,1,0,"RECORTES CE",0
25,"25163",236,181,179,3,2,"RECORTES CE",0
43,"43168",84,65,65,1,0,"RECORTES CE",0
31,"31215",4669,3580,3508,35,72,"RECORTES CE",10
10,"10036",306,240,237,2,3,"RECORTES CE",0
46,"46134",2380,1836,1825,5,11,"RECORTES CE",0
29,"29041",3599,2570,2532,22,38,"RECORTES CE",3
8,"8104",653,516,516,2,0,"RECORTES CE",0
46,"46225",348,279,273,2,6,"RECORTES CE",0
25,"25164",357,264,261,4,3,"RECORTES CE",1
50,"50120",55,43,43,2,0,"RECORTES CE",1
30,"30025",5001,3951,3898,27,53,"RECORTES CE",9
8,"8105",9724,7557,7505,49,52,"RECORTES CE",8
18,"18105",3822,2688,2650,12,38,"RECORTES CE",2
29,"29042",14447,10383,10199,98,184,"RECORTES CE",22
12,"12098",533,446,440,4,6,"RECORTES CE",0
22,"22102",181,153,151,1,2,"RECORTES CE",0
6,"6080",1890,1482,1467,18,15,"RECORTES CE",1
10,"10038",83,70,69,0,1,"RECORTES CE",0
17,"17060",408,311,311,1,0,"RECORTES CE",0
38,"38043",19265,14000,13856,115,144,"RECORTES CE",30
50,"50121",277,220,218,2,2,"RECORTES CE",0
15,"15081",982,755,741,11,14,"RECORTES CE",2
29,"29043",2474,1764,1720,25,44,"RECORTES CE",4
6,"6081",1042,825,811,4,14,"RECORTES CE",2
22,"22103",676,520,517,6,3,"RECORTES CE",0
18,"18106",415,300,295,0,5,"RECORTES CE",0
12,"12099",586,449,434,3,15,"RECORTES CE",0
43,"43170",878,706,704,7,2,"RECORTES CE",1
8,"8106",7469,5816,5795,34,21,"RECORTES CE",10
25,"25166",172,137,136,1,1,"RECORTES CE",0
44,"44267",71,53,52,0,1,"RECORTES CE",0
31,"31220",742,620,615,2,5,"RECORTES CE",3
46,"46136",2619,2030,2003,24,27,"RECORTES CE",2
50,"50122",67,55,54,0,1,"RECORTES CE",0
8,"8187",153380,120687,120090,637,597,"RECORTES CE",252
17,"17062",5978,4358,4334,26,24,"RECORTES CE",3
18,"18107",924,694,680,3,14,"RECORTES CE",0
29,"29044",757,540,533,7,7,"RECORTES CE",0
25,"25910",91,70,67,2,3,"RECORTES CE",0
29,"29045",1681,1263,1242,9,21,"RECORTES CE",4
8,"8107",11900,9303,9187,43,116,"RECORTES CE",50
15,"15083",1036,784,768,7,16,"RECORTES CE",0
38,"38045",3549,2149,2109,6,40,"RECORTES CE",3
46,"46137",242,200,200,3,0,"RECORTES CE",1
7,"7017",882,652,646,6,6,"RECORTES CE",2
18,"18108",826,677,669,3,8,"RECORTES CE",0
50,"50123",436,344,338,1,6,"RECORTES CE",0
17,"17154",99,84,83,0,1,"RECORTES CE",1
50,"50295",49,46,46,0,0,"RECORTES CE",0
31,"31222",58,38,38,3,0,"RECORTES CE",0
3,"3054",336,277,272,2,5,"RECORTES CE",1
25,"25167",226,185,185,2,0,"RECORTES CE",0
12,"12101",356,297,289,2,8,"RECORTES CE",0
41,"41034",23480,16510,16250,230,260,"RECORTES CE",27
29,"29046",2540,1896,1855,13,41,"RECORTES CE",3
46,"46138",360,305,303,2,2,"RECORTES CE",0
14,"14068",516,405,400,1,5,"RECORTES CE",1
50,"50124",399,316,316,3,0,"RECORTES CE",0
8,"8108",5192,4204,4189,26,15,"RECORTES CE",9
17,"17064",326,263,261,2,2,"RECORTES CE",2
30,"30029",12055,9003,8882,58,121,"RECORTES CE",6
29,"29047",1103,909,898,2,11,"RECORTES CE",0
31,"31223",959,718,711,8,7,"RECORTES CE",3
18,"18109",599,452,448,3,4,"RECORTES CE",0
12,"12102",521,442,434,2,8,"RECORTES CE",0
8,"8189",122,106,106,0,0,"RECORTES CE",0
43,"43172",337,261,257,2,4,"RECORTES CE",0
46,"46139",4512,3612,3567,25,45,"RECORTES CE",4
10,"10043",754,578,572,3,6,"RECORTES CE",0
43,"43173",99,80,78,0,2,"RECORTES CE",0
4,"4007",731,570,569,0,1,"RECORTES CE",0
6,"6085",3410,2719,2663,28,56,"RECORTES CE",1
18,"18111",2849,2193,2160,24,33,"RECORTES CE",1
25,"25169",167,118,117,0,1,"RECORTES CE",0
50,"50125",345,264,261,3,3,"RECORTES CE",0
22,"22236",236,207,203,2,4,"RECORTES CE",0
12,"12103",90,75,70,1,5,"RECORTES CE",0
38,"38048",3957,2889,2842,12,47,"RECORTES CE",3
29,"29048",1370,1149,1135,10,14,"RECORTES CE",1
50,"50126",2262,1736,1708,20,28,"RECORTES CE",2
46,"46140",377,312,312,2,0,"RECORTES CE",0
22,"22110",707,531,528,2,3,"RECORTES CE",0
8,"8268",971,746,737,3,9,"RECORTES CE",0
3,"3057",177,148,147,0,1,"RECORTES CE",1
27,"27039",4430,3437,3353,53,84,"RECORTES CE",4
8,"8110",13592,10111,10058,50,53,"RECORTES CE",24
17,"17066",27323,18373,18269,98,104,"RECORTES CE",13
18,"18112",110,80,76,0,4,"RECORTES CE",0
25,"25170",261,230,228,4,2,"RECORTES CE",0
31,"31226",574,380,377,3,3,"RECORTES CE",0
12,"12104",6814,5486,5406,35,80,"RECORTES CE",4
46,"46141",437,367,360,5,7,"RECORTES CE",0
18,"18114",591,443,437,2,6,"RECORTES CE",0
50,"50128",27,24,24,0,0,"RECORTES CE",0
22,"22111",146,115,115,1,0,"RECORTES CE",0
10,"10046",187,154,152,0,2,"RECORTES CE",0
15,"15088",3415,2349,2323,28,26,"RECORTES CE",0
38,"38049",2683,1781,1743,18,38,"RECORTES CE",3
10,"10169",494,405,395,1,10,"RECORTES CE",0
43,"43175",537,426,419,5,7,"RECORTES CE",0
10,"10047",937,772,760,3,12,"RECORTES CE",1
12,"12105",816,639,625,5,14,"RECORTES CE",0
46,"46142",761,580,565,4,15,"RECORTES CE",0
8,"8111",215,200,199,4,1,"RECORTES CE",0
38,"38050",2436,1564,1529,12,35,"RECORTES CE",5
17,"17067",697,581,578,4,3,"RECORTES CE",1
22,"22112",9516,7043,6956,84,87,"RECORTES CE",12
10,"10048",204,156,154,0,2,"RECORTES CE",0
27,"27041",2238,1640,1615,10,25,"RECORTES CE",1
8,"8192",5679,4605,4589,20,16,"RECORTES CE",6
15,"15089",4324,3258,3200,33,58,"RECORTES CE",5
31,"31229",38,36,36,2,0,"RECORTES CE",1
27,"27042",1648,1247,1233,21,14,"RECORTES CE",2
18,"18115",2650,1988,1975,20,13,"RECORTES CE",0
50,"50129",213,151,149,5,2,"RECORTES CE",0
46,"46143",4230,3255,3200,20,55,"RECORTES CE",6
25,"25172",1779,1407,1405,3,2,"RECORTES CE",2
3,"3060",106,84,84,0,0,"RECORTES CE",0
43,"43176",746,588,586,7,2,"RECORTES CE",1
22,"22243",39,28,28,0,0,"RECORTES CE",0
17,"17160",14733,10833,10766,43,67,"RECORTES CE",16
39,"39082",1622,1261,1252,16,9,"RECORTES CE",1
17,"17161",1018,859,855,1,4,"RECORTES CE",1
29,"29052",222,156,153,2,3,"RECORTES CE",3
25,"25173",1649,1278,1262,5,16,"RECORTES CE",0
50,"50130",362,252,249,1,3,"RECORTES CE",0
31,"31230",95,79,79,0,0,"RECORTES CE",1
46,"46144",628,511,505,1,6,"RECORTES CE",0
18,"18116",2853,2265,2233,15,32,"RECORTES CE",2
22,"22114",124,86,82,1,4,"RECORTES CE",0
12,"12107",351,312,306,1,6,"RECORTES CE",0
38,"38052",1280,893,887,4,6,"RECORTES CE",2
25,"25174",390,324,324,0,0,"RECORTES CE",0
30,"30035",19268,14248,14103,92,145,"RECORTES CE",26
29,"29053",1694,1263,1245,18,18,"RECORTES CE",3
32,"32055",1230,908,889,5,19,"RECORTES CE",0
44,"44086",421,332,327,3,5,"RECORTES CE",0
8,"8194",25674,17691,17585,115,106,"RECORTES CE",36
50,"50131",210,157,156,0,1,"RECORTES CE",0
8,"8114",18648,14251,14170,69,81,"RECORTES CE",36
43,"43177",284,243,242,0,1,"RECORTES CE",0
18,"18117",507,402,396,5,6,"RECORTES CE",0
12,"12108",438,382,379,4,3,"RECORTES CE",2
29,"29054",42393,30327,30108,218,219,"RECORTES CE",66
15,"15092",6250,4358,4297,28,61,"RECORTES CE",10
50,"50043",246,172,170,2,2,"RECORTES CE",0
10,"10052",166,124,123,0,1,"RECORTES CE",0
8,"8195",76,69,69,0,0,"RECORTES CE",0
50,"50132",771,589,576,2,13,"RECORTES CE",3
29,"29055",1880,1493,1470,15,23,"RECORTES CE",2
46,"46146",1641,1314,1281,11,33,"RECORTES CE",1
4,"4015",118,97,97,2,0,"RECORTES CE",0
18,"18119",1712,1352,1317,11,35,"RECORTES CE",0
22,"22116",1369,1025,1003,8,22,"RECORTES CE",0
50,"50133",100,82,82,2,0,"RECORTES CE",0
12,"12109",653,544,533,3,11,"RECORTES CE",0
27,"27045",944,700,698,13,2,"RECORTES CE",1
8,"8115",3825,2994,2975,12,19,"RECORTES CE",5
39,"39001",2065,1669,1643,16,26,"RECORTES CE",1
31,"31111",91,69,69,1,0,"RECORTES CE",0
20,"20067",30618,21972,21854,138,118,"RECORTES CE",40
8,"8116",558,459,459,0,0,"RECORTES CE",1
46,"46147",17133,12260,12120,59,140,"RECORTES CE",13
30,"30038",15674,11755,11675,59,80,"RECORTES CE",19
26,"26009",391,317,314,2,3,"RECORTES CE",1
15,"15093",4048,2761,2720,41,41,"RECORTES CE",1
41,"41043",667,475,453,3,22,"RECORTES CE",0
10,"10054",524,435,422,1,13,"RECORTES CE",0
12,"12110",219,168,166,1,2,"RECORTES CE",0
50,"50134",118,91,89,0,2,"RECORTES CE",1
27,"27046",1448,1074,1063,7,11,"RECORTES CE",1
3,"3064",5004,3782,3736,20,46,"RECORTES CE",8
31,"31235",157,121,118,0,3,"RECORTES CE",1
29,"29057",341,236,233,0,3,"RECORTES CE",0
50,"50220",43,37,37,0,0,"RECORTES CE",2
31,"31236",1318,958,950,8,8,"RECORTES CE",3
6,"6095",9511,7338,7152,116,186,"RECORTES CE",7
15,"15901",3359,2237,2205,35,32,"RECORTES CE",4
17,"17165",634,516,512,3,4,"RECORTES CE",1
39,"39002",3414,2630,2578,23,52,"RECORTES CE",4
12,"12111",334,283,279,4,4,"RECORTES CE",0
8,"8117",2480,2055,2050,16,5,"RECORTES CE",2
22,"22249",118,93,93,2,0,"RECORTES CE",1
15,"15902",4522,3220,3159,47,61,"RECORTES CE",2
50,"50221",32,22,22,0,0,"RECORTES CE",0
50,"50135",88,74,74,3,0,"RECORTES CE",1
46,"46149",344,260,256,2,4,"RECORTES CE",0
8,"8198",4640,3713,3691,23,22,"RECORTES CE",8
31,"31237",186,151,149,1,2,"RECORTES CE",2
22,"22122",65,58,58,3,0,"RECORTES CE",1
27,"27048",2019,1499,1467,23,32,"RECORTES CE",0
21,"21014",4065,3192,3148,22,44,"RECORTES CE",5
18,"18122",16001,11761,11556,110,205,"RECORTES CE",13
12,"12112",110,97,96,1,1,"RECORTES CE",0
29,"29059",2643,2086,2042,8,44,"RECORTES CE",1
8,"8118",17542,14101,14059,56,42,"RECORTES CE",15
20,"20070",1083,831,823,2,8,"RECORTES CE",1
43,"43903",2333,1717,1700,11,17,"RECORTES CE",0
50,"50136",534,416,405,2,11,"RECORTES CE",0
25,"25180",228,176,174,1,2,"RECORTES CE",0
10,"10058",993,739,723,4,16,"RECORTES CE",2
22,"22250",344,271,264,6,7,"RECORTES CE",0
18,"18123",288,219,219,2,0,"RECORTES CE",0
39,"39004",1483,1181,1163,4,18,"RECORTES CE",1
50,"50222",1570,1126,1105,17,21,"RECORTES CE",0
17,"17167",2609,2122,2102,14,20,"RECORTES CE",1
8,"8119",6838,5352,5326,31,26,"RECORTES CE",13
12,"12113",87,65,64,0,1,"RECORTES CE",0
31,"31239",281,215,212,7,3,"RECORTES CE",0
25,"25181",175,136,135,0,1,"RECORTES CE",0
46,"46151",757,586,579,0,7,"RECORTES CE",0
22,"22125",39429,29988,29612,337,376,"RECORTES CE",85
18,"18124",359,269,267,0,2,"RECORTES CE",1
29,"29060",671,511,506,1,5,"RECORTES CE",0
31,"31240",513,385,385,6,0,"RECORTES CE",0
3,"3068",42,40,40,3,0,"RECORTES CE",0
43,"43904",2861,2083,2058,27,25,"RECORTES CE",0
20,"20072",4752,3445,3412,24,33,"RECORTES CE",6
50,"50137",964,790,781,9,9,"RECORTES CE",1
6,"6099",1162,833,813,6,20,"RECORTES CE",0
12,"12114",194,161,160,2,1,"RECORTES CE",0
46,"46243",124,105,104,0,1,"RECORTES CE",0
46,"46152",87,69,69,0,0,"RECORTES CE",0
29,"29061",1033,840,821,5,19,"RECORTES CE",2
3,"3069",3311,2356,2327,12,29,"RECORTES CE",8
50,"50224",65,54,54,1,0,"RECORTES CE",0
4,"4023",120,95,95,2,0,"RECORTES CE",0
50,"50138",47,42,42,1,0,"RECORTES CE",0
22,"22126",87,66,66,0,0,"RECORTES CE",0
8,"8120",7048,5892,5881,49,11,"RECORTES CE",4
12,"12115",208,170,167,1,3,"RECORTES CE",0
18,"18126",1450,1115,1087,11,28,"RECORTES CE",0
8,"8201",447,327,324,5,3,"RECORTES CE",0
46,"46244",59626,44018,43679,342,339,"RECORTES CE",67
50,"50139",322,257,256,0,1,"RECORTES CE",0
46,"46153",435,364,356,1,8,"RECORTES CE",0
6,"6100",852,681,677,3,4,"RECORTES CE",0
30,"30901",10529,8488,8375,37,113,"RECORTES CE",14
10,"10062",393,339,334,0,5,"RECORTES CE",0
22,"22253",57,48,47,0,1,"RECORTES CE",0
22,"22127",529,434,432,4,2,"RECORTES CE",3
27,"27052",862,645,640,4,5,"RECORTES CE",0
31,"31243",302,241,237,5,4,"RECORTES CE",1
6,"6001",659,539,534,7,5,"RECORTES CE",0
20,"20074",11503,8767,8720,26,47,"RECORTES CE",6
18,"18127",16822,12735,12537,106,198,"RECORTES CE",27
27,"27053",501,384,373,1,11,"RECORTES CE",0
8,"8122",1716,1260,1254,8,6,"RECORTES CE",5
10,"10063",161,141,141,1,0,"RECORTES CE",0
12,"12116",67,57,57,0,0,"RECORTES CE",0
25,"25185",679,493,491,6,2,"RECORTES CE",1
39,"39008",13900,10895,10767,81,128,"RECORTES CE",5
10,"10186",944,781,758,1,23,"RECORTES CE",1
3,"3071",3988,3125,3088,28,37,"RECORTES CE",2
50,"50227",110,74,73,2,1,"RECORTES CE",0
18,"18128",342,274,272,1,2,"RECORTES CE",0
48,"48009",772,628,622,2,6,"RECORTES CE",0
17,"17171",172,143,141,0,2,"RECORTES CE",0
46,"46155",993,785,772,2,13,"RECORTES CE",1
29,"29065",194,150,150,0,0,"RECORTES CE",0
43,"43907",4359,3370,3346,22,24,"RECORTES CE",15
4,"4027",226,147,147,1,0,"RECORTES CE",1
22,"22014",233,185,182,3,3,"RECORTES CE",1
50,"50228",250,217,214,3,3,"RECORTES CE",0
17,"17080",144,124,124,2,0,"RECORTES CE",0
22,"22129",163,117,116,0,1,"RECORTES CE",0
27,"27054",1145,907,890,5,17,"RECORTES CE",0
8,"8123",19489,16197,16135,58,62,"RECORTES CE",18
18,"18132",3124,2575,2548,17,27,"RECORTES CE",0
7,"7038",2025,1581,1556,14,25,"RECORTES CE",2
6,"6103",4753,3656,3598,35,58,"RECORTES CE",0
50,"50142",24,18,18,0,0,"RECORTES CE",0
12,"12118",76,64,63,0,1,"RECORTES CE",0
39,"39009",3307,2545,2526,11,19,"RECORTES CE",0
25,"25186",207,174,173,7,1,"RECORTES CE",0
8,"8124",37130,29069,28915,146,154,"RECORTES CE",58
29,"29066",346,266,266,2,0,"RECORTES CE",0
22,"22130",10128,7355,7294,61,61,"RECORTES CE",25
27,"27055",1197,857,851,2,6,"RECORTES CE",1
31,"31247",147,117,115,0,2,"RECORTES CE",0
31,"31003",117,97,97,1,0,"RECORTES CE",0
18,"18133",2109,1632,1618,12,14,"RECORTES CE",0
39,"39010",610,518,512,1,6,"RECORTES CE",1
46,"46157",2960,2329,2296,12,33,"RECORTES CE",3
10,"10067",10245,7850,7701,80,149,"RECORTES CE",8
50,"50143",546,409,401,5,8,"RECORTES CE",2
8,"8125",25485,19719,19627,101,92,"RECORTES CE",50
31,"31248",270,158,154,6,4,"RECORTES CE",0
25,"25190",257,215,215,0,0,"RECORTES CE",0
44,"44101",51,43,42,1,1,"RECORTES CE",0
22,"22131",83,65,65,0,0,"RECORTES CE",0
50,"50230",1134,853,846,6,7,"RECORTES CE",0
18,"18134",6069,4431,4345,30,86,"RECORTES CE",5
17,"17083",2961,2321,2300,12,21,"RECORTES CE",2
20,"20078",1145,882,879,4,3,"RECORTES CE",0
46,"46158",1040,805,796,4,9,"RECORTES CE",1
39,"39011",1575,1249,1242,3,7,"RECORTES CE",0
27,"27057",11097,7917,7735,88,182,"RECORTES CE",15
15,"15011",15481,11249,11037,105,212,"RECORTES CE",12
31,"31249",1823,1381,1373,21,8,"RECORTES CE",4
12,"12120",161,138,138,0,0,"RECORTES CE",0
22,"22904",761,581,566,2,15,"RECORTES CE",1
31,"31006",1877,1453,1436,16,17,"RECORTES CE",3
31,"31250",2748,1995,1982,21,13,"RECORTES CE",5
46,"46159",23051,17496,17359,104,137,"RECORTES CE",33
39,"39096",670,523,518,2,5,"RECORTES CE",0
22,"22135",174,132,132,5,0,"RECORTES CE",0
18,"18135",4434,3169,3105,23,64,"RECORTES CE",1
3,"3076",8736,6571,6467,40,104,"RECORTES CE",3
10,"10070",669,516,513,1,3,"RECORTES CE",1
48,"48908",249,214,213,0,1,"RECORTES CE",1
8,"8206",737,625,624,3,1,"RECORTES CE",0
39,"39012",6737,5391,5314,52,77,"RECORTES CE",6
31,"31251",3152,2437,2402,12,35,"RECORTES CE",5
7,"7042",10785,7256,7191,60,65,"RECORTES CE",14
50,"50146",190,152,149,0,3,"RECORTES CE",0
46,"46160",1907,1508,1485,5,23,"RECORTES CE",1
18,"18136",1782,1382,1359,12,23,"RECORTES CE",0
27,"27059",2055,1508,1471,13,37,"RECORTES CE",1
31,"31252",83,57,57,0,0,"RECORTES CE",1
48,"48015",33109,24697,24475,161,222,"RECORTES CE",44
25,"25192",724,564,558,4,6,"RECORTES CE",2
44,"44005",46,31,31,1,0,"RECORTES CE",0
22,"22136",749,579,576,5,3,"RECORTES CE",9
10,"10072",835,632,625,3,7,"RECORTES CE",0
31,"31008",63,51,49,1,2,"RECORTES CE",1
12,"12122",767,655,646,3,9,"RECORTES CE",0
8,"8128",577,454,451,0,3,"RECORTES CE",0
46,"46161",1472,1200,1172,7,28,"RECORTES CE",1
50,"50147",751,564,559,3,5,"RECORTES CE",0
17,"17177",567,459,457,2,2,"RECORTES CE",0
10,"10195",7557,5790,5691,38,99,"RECORTES CE",10
6,"6109",3843,3228,3106,26,122,"RECORTES CE",1
18,"18137",1002,776,773,0,3,"RECORTES CE",0
48,"48016",5437,4282,4248,21,34,"RECORTES CE",10
27,"27060",2463,1695,1669,12,26,"RECORTES CE",2
22,"22137",1015,741,733,9,8,"RECORTES CE",1
39,"39014",901,709,704,5,5,"RECORTES CE",0
12,"12123",43,35,34,1,1,"RECORTES CE",0
8,"8129",484,406,405,3,1,"RECORTES CE",1
44,"44007",152,120,117,0,3,"RECORTES CE",1
50,"50148",290,229,227,2,2,"RECORTES CE",0
22,"22139",78,60,60,0,0,"RECORTES CE",0
12,"12124",1840,1477,1460,8,17,"RECORTES CE",0
18,"18138",2482,1698,1668,20,30,"RECORTES CE",1
10,"10075",236,186,182,1,4,"RECORTES CE",0
50,"50149",33,25,25,1,0,"RECORTES CE",0
27,"27061",1016,784,763,9,21,"RECORTES CE",2
39,"39015",824,646,644,2,2,"RECORTES CE",0
46,"46163",1856,1522,1501,4,21,"RECORTES CE",2
39,"39016",23868,19029,18839,108,190,"RECORTES CE",16
31,"31256",96,64,64,0,0,"RECORTES CE",0
22,"22141",114,86,85,0,1,"RECORTES CE",0
8,"8130",108,89,86,2,3,"RECORTES CE",0
39,"39100",849,650,644,9,6,"RECORTES CE",0
12,"12125",222,189,187,0,2,"RECORTES CE",0
20,"20903",4803,3514,3481,24,33,"RECORTES CE",10
18,"18140",42374,29390,29025,221,365,"RECORTES CE",18
3,"3080",1328,1077,1064,4,13,"RECORTES CE",0
10,"10077",637,501,499,3,2,"RECORTES CE",2
50,"50150",621,451,450,2,1,"RECORTES CE",0
14,"14003",1258,989,968,12,21,"RECORTES CE",1
25,"25197",141,109,108,0,1,"RECORTES CE",0
35,"35014",11908,7101,6947,63,154,"RECORTES CE",28
4,"4038",3110,2235,2203,23,32,"RECORTES CE",1
39,"39017",553,416,409,0,7,"RECORTES CE",0
31,"31257",903,690,679,6,11,"RECORTES CE",2
3,"3081",1494,1163,1141,5,22,"RECORTES CE",0
18,"18141",384,269,264,0,5,"RECORTES CE",2
25,"25002",467,357,356,2,1,"RECORTES CE",0
17,"17089",5695,4211,4194,13,17,"RECORTES CE",3
50,"50151",603,490,489,3,1,"RECORTES CE",1
8,"8131",741,585,585,4,0,"RECORTES CE",0
12,"12126",24347,19023,18749,152,274,"RECORTES CE",14
22,"22143",197,134,132,1,2,"RECORTES CE",0
26,"26031",98,89,87,0,2,"RECORTES CE",0
43,"43121",591,463,462,0,1,"RECORTES CE",0
31,"31259",476,347,346,0,1,"RECORTES CE",3
7,"7048",18412,11528,11412,112,116,"RECORTES CE",36
27,"27064",1503,1078,1039,12,39,"RECORTES CE",3
25,"25200",323,253,252,0,1,"RECORTES CE",0
12,"12127",67,50,50,1,0,"RECORTES CE",0
6,"6114",127,109,108,0,1,"RECORTES CE",0
25,"25003",3721,2828,2815,19,13,"RECORTES CE",1
46,"46166",8202,6482,6399,39,83,"RECORTES CE",8
50,"50152",1368,1061,1043,6,18,"RECORTES CE",0
8,"8132",361,281,281,2,0,"RECORTES CE",1
3,"3083",5487,3993,3934,28,59,"RECORTES CE",7
50,"50238",86,66,66,2,0,"RECORTES CE",0
31,"31016",7752,6114,6064,47,50,"RECORTES CE",24
39,"39019",2229,1785,1751,15,34,"RECORTES CE",1
48,"48021",1336,990,983,4,7,"RECORTES CE",0
25,"25201",110,89,89,0,0,"RECORTES CE",0
31,"31017",370,288,286,3,2,"RECORTES CE",3
50,"50153",922,705,704,6,1,"RECORTES CE",2
46,"46167",345,255,255,0,0,"RECORTES CE",0
3,"3084",497,429,429,4,0,"RECORTES CE",0
22,"22149",308,247,246,3,1,"RECORTES CE",0
18,"18145",10869,8532,8405,69,127,"RECORTES CE",10
22,"22027",306,230,225,3,5,"RECORTES CE",0
8,"8133",128,98,98,5,0,"RECORTES CE",0
31,"31261",237,174,173,3,1,"RECORTES CE",2
23,"23004",421,356,355,2,1,"RECORTES CE",0
25,"25005",274,202,202,2,0,"RECORTES CE",1
29,"29067",430670,312817,309994,2768,2823,"RECORTES CE",813
44,"44012",310,240,238,5,2,"RECORTES CE",0
46,"46168",1982,1543,1522,5,21,"RECORTES CE",4
12,"12129",1801,1382,1356,17,26,"RECORTES CE",0
25,"25202",108,75,75,0,0,"RECORTES CE",0
18,"18146",937,690,682,6,8,"RECORTES CE",1
50,"50240",965,720,702,9,18,"RECORTES CE",0
48,"48023",580,493,489,0,4,"RECORTES CE",0
8,"8214",6966,5648,5633,21,15,"RECORTES CE",6
25,"25006",317,246,245,3,1,"RECORTES CE",1
23,"23005",29940,19587,19330,191,257,"RECORTES CE",18
44,"44112",408,303,293,2,10,"RECORTES CE",1
4,"4047",2230,1806,1785,8,21,"RECORTES CE",5
8,"8134",842,649,646,3,3,"RECORTES CE",0
50,"50154",116,98,98,0,0,"RECORTES CE",0
12,"12130",420,345,341,0,4,"RECORTES CE",0
26,"26035",16,14,13,0,1,"RECORTES CE",0
18,"18147",3644,2492,2441,18,51,"RECORTES CE",3
29,"29069",86694,58863,58127,561,736,"RECORTES CE",119
6,"6118",157,125,125,1,0,"RECORTES CE",0
22,"22029",119,103,103,0,0,"RECORTES CE",0
22,"22151",88,66,65,0,1,"RECORTES CE",1
25,"25204",1191,936,930,5,6,"RECORTES CE",1
10,"10206",201,146,144,1,2,"RECORTES CE",0
29,"29070",43090,30294,29928,243,366,"RECORTES CE",104
17,"17094",1068,772,766,1,6,"RECORTES CE",0
41,"41063",2713,1988,1944,17,44,"RECORTES CE",1
8,"8135",6735,5445,5421,36,24,"RECORTES CE",10
50,"50155",90,70,69,0,1,"RECORTES CE",0
8,"8136",11614,9159,9079,84,80,"RECORTES CE",22
50,"50156",209,174,171,1,3,"RECORTES CE",2
39,"39022",969,740,732,2,8,"RECORTES CE",2
17,"17186",3824,3115,3098,15,17,"RECORTES CE",4
25,"25007",1392,1089,1083,4,6,"RECORTES CE",2
8,"8216",25,19,19,0,0,"RECORTES CE",0
43,"43051",9092,6577,6502,26,75,"RECORTES CE",5
21,"21003",677,505,489,3,16,"RECORTES CE",0
10,"10087",1606,1239,1223,5,16,"RECORTES CE",1
46,"46171",16429,12527,12373,61,154,"RECORTES CE",17
10,"10208",121,94,94,2,0,"RECORTES CE",0
6,"6120",3373,2757,2719,10,38,"RECORTES CE",3
29,"29071",979,718,712,14,6,"RECORTES CE",3
18,"18148",803,652,648,0,4,"RECORTES CE",0
12,"12132",484,415,412,4,3,"RECORTES CE",0
17,"17095",19938,13998,13918,69,80,"RECORTES CE",23
18,"18149",5401,4290,4212,28,78,"RECORTES CE",2
25,"25008",1088,867,857,7,10,"RECORTES CE",0
10,"10088",196,139,138,0,1,"RECORTES CE",0
8,"8137",274,232,229,0,3,"RECORTES CE",0
46,"46172",5412,3878,3832,18,46,"RECORTES CE",10
50,"50157",286,226,220,0,6,"RECORTES CE",0
29,"29072",3277,2628,2592,16,36,"RECORTES CE",3
12,"12133",60,53,52,1,1,"RECORTES CE",0
8,"8217",25355,20935,20855,110,80,"RECORTES CE",33
20,"20001",257,174,172,1,2,"RECORTES CE",0
25,"25206",250,189,188,2,1,"RECORTES CE",0
44,"44115",102,96,95,0,1,"RECORTES CE",0
22,"22157",183,136,134,1,2,"RECORTES CE",0
20,"20002",355,258,257,8,1,"RECORTES CE",0
25,"25009",605,505,491,5,14,"RECORTES CE",0
8,"8218",8104,6419,6389,34,30,"RECORTES CE",4
46,"46173",1319,1084,1062,6,22,"RECORTES CE",1
22,"22202",145,127,126,0,1,"RECORTES CE",0
8,"8138",4432,3435,3413,10,22,"RECORTES CE",1
29,"29073",1645,1200,1185,13,15,"RECORTES CE",1
12,"12134",135,102,100,0,2,"RECORTES CE",0
22,"22158",11951,8877,8801,69,76,"RECORTES CE",17
25,"25207",6430,4899,4867,41,32,"RECORTES CE",3
39,"39025",8703,6954,6854,39,100,"RECORTES CE",6
3,"3091",241,201,196,0,5,"RECORTES CE",0
25,"25010",196,156,155,2,1,"RECORTES CE",0
17,"17097",199,172,170,1,2,"RECORTES CE",0
31,"31026",132,116,112,0,4,"RECORTES CE",0
29,"29074",781,606,597,2,9,"RECORTES CE",0
46,"46174",949,789,770,4,19,"RECORTES CE",0
43,"43054",2792,2145,2134,21,11,"RECORTES CE",2
50,"50160",2150,1652,1619,14,33,"RECORTES CE",1
6,"6123",4512,3358,3266,28,92,"RECORTES CE",3
39,"39026",1720,1322,1312,5,10,"RECORTES CE",0
18,"18151",259,194,193,3,1,"RECORTES CE",1
12,"12135",36194,27266,26961,192,305,"RECORTES CE",30
31,"31906",2683,2040,2023,28,17,"RECORTES CE",7
3,"3092",6688,5444,5370,36,74,"RECORTES CE",7
20,"20004",227,156,154,4,2,"RECORTES CE",0
50,"50161",103,80,80,0,0,"RECORTES CE",0
29,"29075",12890,9033,8949,73,84,"RECORTES CE",11
46,"46175",428,367,354,3,13,"RECORTES CE",0
39,"39027",3066,2511,2467,15,44,"RECORTES CE",1
10,"10214",217,175,175,1,0,"RECORTES CE",0
3,"3001",345,285,282,1,3,"RECORTES CE",0
6,"6125",1679,1348,1324,5,24,"RECORTES CE",0
8,"8140",4778,3756,3737,19,19,"RECORTES CE",2
12,"12136",2606,2262,2223,17,39,"RECORTES CE",0
25,"25209",1550,1192,1172,4,20,"RECORTES CE",0
29,"29076",2335,1661,1614,11,47,"RECORTES CE",4
18,"18153",8796,6686,6594,59,92,"RECORTES CE",1
25,"25210",1079,867,853,4,14,"RECORTES CE",0
8,"8141",4573,3611,3595,26,16,"RECORTES CE",2
46,"46176",2045,1450,1434,12,16,"RECORTES CE",0
43,"43129",4611,3528,3495,21,33,"RECORTES CE",1
3,"3002",3631,2841,2801,16,40,"RECORTES CE",7
3,"3094",9626,7206,7138,42,68,"RECORTES CE",7
22,"22163",419,363,361,1,2,"RECORTES CE",2
50,"50247",842,621,616,7,5,"RECORTES CE",0
8,"8221",12699,10571,10537,53,34,"RECORTES CE",13
12,"12137",37,27,27,0,0,"RECORTES CE",0
29,"29077",214,158,156,1,2,"RECORTES CE",0
25,"25013",2108,1570,1557,12,13,"RECORTES CE",2
39,"39028",3870,3131,3094,19,37,"RECORTES CE",3
43,"43056",806,616,613,5,3,"RECORTES CE",0
44,"44022",463,342,326,6,16,"RECORTES CE",0
6,"6126",2142,1619,1594,9,25,"RECORTES CE",0
3,"3003",455,395,388,0,7,"RECORTES CE",0
8,"8142",139,126,126,1,0,"RECORTES CE",0
29,"29079",2335,1796,1765,7,31,"RECORTES CE",3
26,"26163",124,106,104,1,2,"RECORTES CE",0
48,"48032",5773,4504,4476,5,28,"RECORTES CE",3
8,"8222",1819,1484,1476,11,8,"RECORTES CE",0
50,"50249",284,229,227,1,2,"RECORTES CE",3
20,"20007",327,235,230,2,5,"RECORTES CE",0
46,"46178",4943,3684,3641,21,43,"RECORTES CE",1
25,"25212",224,195,195,2,0,"RECORTES CE",1
10,"10096",3326,2553,2501,14,52,"RECORTES CE",1
32,"32002",2022,1510,1485,8,25,"RECORTES CE",2
43,"43131",4772,3432,3401,18,31,"RECORTES CE",4
44,"44121",53,38,38,2,0,"RECORTES CE",0
18,"18157",1148,914,898,8,16,"RECORTES CE",1
44,"44023",18,14,14,0,0,"RECORTES CE",0
6,"6128",4415,3345,3288,34,57,"RECORTES CE",2
10,"10097",106,88,85,3,3,"RECORTES CE",0
12,"12139",302,219,217,3,2,"RECORTES CE",0
39,"39030",1895,1374,1358,6,16,"RECORTES CE",1
46,"46179",2116,1723,1678,18,45,"RECORTES CE",2
20,"20008",704,455,449,6,6,"RECORTES CE",0
44,"44122",1284,995,984,15,11,"RECORTES CE",2
26,"26165",337,289,284,0,5,"RECORTES CE",0
26,"26048",22,22,22,0,0,"RECORTES CE",0
3,"3097",996,833,816,4,17,"RECORTES CE",0
10,"10098",381,310,309,1,1,"RECORTES CE",0
50,"50165",1783,1359,1330,20,29,"RECORTES CE",3
25,"25215",505,299,299,4,0,"RECORTES CE",0
39,"39031",1245,990,983,5,7,"RECORTES CE",1
50,"50018",893,705,696,3,9,"RECORTES CE",0
3,"3005",7903,6247,6195,37,52,"RECORTES CE",5
18,"18158",8010,5524,5449,23,75,"RECORTES CE",5
20,"20009",11343,8168,8106,46,62,"RECORTES CE",15
50,"50166",236,200,198,1,2,"RECORTES CE",1
12,"12140",1140,936,922,7,14,"RECORTES CE",4
6,"6030",169,147,146,1,1,"RECORTES CE",0
50,"50251",8207,6352,6242,46,110,"RECORTES CE",10
29,"29082",34113,26248,26002,304,246,"RECORTES CE",53
6,"6130",186,159,154,0,5,"RECORTES CE",0
3,"3006",494,413,409,1,4,"RECORTES CE",0
17,"17105",247,194,194,1,0,"RECORTES CE",0
8,"8145",2701,2156,2144,7,12,"RECORTES CE",2
46,"46253",114,85,85,2,0,"RECORTES CE",0
18,"18159",999,828,824,1,4,"RECORTES CE",0
12,"12141",92,81,81,0,0,"RECORTES CE",0
29,"29083",2062,1607,1574,9,33,"RECORTES CE",1
39,"39032",1426,1156,1141,8,15,"RECORTES CE",0
50,"50019",64,48,47,0,1,"RECORTES CE",1
3,"3007",169,145,141,0,4,"RECORTES CE",0
31,"31036",895,665,659,8,6,"RECORTES CE",3
20,"20011",1633,1297,1287,2,10,"RECORTES CE",0
7,"7901",594,454,446,6,8,"RECORTES CE",0
50,"50167",215,181,179,1,2,"RECORTES CE",0
3,"3099",42876,32576,32172,192,404,"RECORTES CE",24
25,"25217",10819,8163,8120,64,43,"RECORTES CE",4
46,"46182",1310,988,977,5,11,"RECORTES CE",3
39,"39033",540,430,423,1,7,"RECORTES CE",0
8,"8146",1358,1086,1079,2,7,"RECORTES CE",1
12,"12142",145,123,121,1,2,"RECORTES CE",0
3,"3008",159,127,126,0,1,"RECORTES CE",0
41,"41075",10279,7543,7370,96,173,"RECORTES CE",3
23,"23020",1524,1363,1348,12,15,"RECORTES CE",3
50,"50168",27,20,20,0,0,"RECORTES CE",0
10,"10102",503,407,403,3,4,"RECORTES CE",0
32,"32006",1434,1033,1019,8,14,"RECORTES CE",0
6,"6133",1799,1476,1453,12,23,"RECORTES CE",0
44,"44125",65,50,50,0,0,"RECORTES CE",0
46,"46183",6028,4620,4534,29,86,"RECORTES CE",5
3,"3009",46121,36093,35720,235,373,"RECORTES CE",78
18,"18162",929,730,719,4,11,"RECORTES CE",1
50,"50169",336,261,259,2,2,"RECORTES CE",3
31,"31039",92,72,70,1,2,"RECORTES CE",0
8,"8147",17282,13644,13560,94,84,"RECORTES CE",31
22,"22173",218,162,160,1,2,"RECORTES CE",3
10,"10103",426,330,327,0,3,"RECORTES CE",1
8,"8227",2410,1882,1877,10,5,"RECORTES CE",2
25,"25020",274,221,221,2,0,"RECORTES CE",0
36,"36031",562,455,450,2,5,"RECORTES CE",5
32,"32007",1412,1011,1001,9,10,"RECORTES CE",2
10,"10104",5151,3862,3782,22,80,"RECORTES CE",5
44,"44126",317,226,222,1,4,"RECORTES CE",1
18,"18163",315,246,241,1,5,"RECORTES CE",1
20,"20013",5430,4144,4119,19,25,"RECORTES CE",1
8,"8148",2334,1803,1794,6,9,"RECORTES CE",3
6,"6134",530,337,331,3,6,"RECORTES CE",0
38,"38001",20907,12323,12197,70,126,"RECORTES CE",25
32,"32092",482,337,334,2,3,"RECORTES CE",0
25,"25121",635,436,429,1,7,"RECORTES CE",1
10,"10105",2476,1798,1760,21,38,"RECORTES CE",2
25,"25220",994,822,816,3,6,"RECORTES CE",0
3,"3010",336,295,280,0,15,"RECORTES CE",0
50,"50170",364,286,279,1,7,"RECORTES CE",0
43,"43062",259,223,220,2,3,"RECORTES CE",0
29,"29087",371,266,263,2,3,"RECORTES CE",1
25,"25022",107,88,88,0,0,"RECORTES CE",0
31,"31041",1659,1245,1228,23,17,"RECORTES CE",2
44,"44127",57,45,45,0,0,"RECORTES CE",0
50,"50256",74,46,45,0,1,"RECORTES CE",0
11,"11003",1240,898,876,7,22,"RECORTES CE",1
26,"26055",39,35,35,1,0,"RECORTES CE",0
8,"8149",984,770,768,3,2,"RECORTES CE",1
20,"20015",1237,975,967,8,8,"RECORTES CE",0
3,"3011",8014,5870,5810,38,60,"RECORTES CE",11
50,"50171",96,78,78,1,0,"RECORTES CE",0
46,"46186",19529,15294,15125,69,169,"RECORTES CE",24
17,"17111",958,772,771,3,1,"RECORTES CE",0
4,"4067",520,387,379,1,8,"RECORTES CE",0
44,"44031",82,52,52,1,0,"RECORTES CE",0
18,"18165",4251,3113,3073,20,40,"RECORTES CE",6
3,"3012",1133,910,897,7,13,"RECORTES CE",0
32,"32010",360,276,273,3,3,"RECORTES CE",0
10,"10108",203,131,130,1,1,"RECORTES CE",0
29,"29089",3161,2477,2426,19,51,"RECORTES CE",2
8,"8150",251,211,211,0,0,"RECORTES CE",0
50,"50172",178,134,131,3,3,"RECORTES CE",0
43,"43138",2648,1926,1896,8,30,"RECORTES CE",1
46,"46187",1304,991,982,8,9,"RECORTES CE",3
22,"22177",97,81,81,1,0,"RECORTES CE",0
21,"21023",2051,1356,1332,5,24,"RECORTES CE",2
6,"6137",933,730,723,5,7,"RECORTES CE",1
3,"3013",1070,882,869,3,13,"RECORTES CE",1
18,"18167",1850,1330,1317,17,13,"RECORTES CE",1
29,"29090",1653,1215,1200,8,15,"RECORTES CE",2
10,"10109",1730,1208,1181,12,27,"RECORTES CE",1
8,"8151",448,378,377,2,1,"RECORTES CE",0
25,"25223",911,732,723,6,9,"RECORTES CE",1
46,"46188",693,591,585,3,6,"RECORTES CE",1
44,"44033",244,174,172,0,2,"RECORTES CE",0
32,"32011",918,526,521,6,5,"RECORTES CE",1
50,"50258",53,33,33,3,0,"RECORTES CE",0
14,"14027",7876,6227,6103,81,124,"RECORTES CE",5
3,"3106",564,485,479,4,6,"RECORTES CE",1
50,"50173",149,107,105,0,2,"RECORTES CE",0
3,"3014",238879,176118,174768,1105,1350,"RECORTES CE",370
17,"17114",23269,17558,17474,91,84,"RECORTES CE",15
18,"18168",781,613,604,6,9,"RECORTES CE",2
41,"41081",29840,22819,22465,228,354,"RECORTES CE",37
29,"29091",9407,6859,6719,63,140,"RECORTES CE",6
46,"46189",473,412,408,2,4,"RECORTES CE",0
31,"31046",53,39,39,0,0,"RECORTES CE",0
44,"44034",126,97,97,2,0,"RECORTES CE",0
44,"44131",27,22,22,0,0,"RECORTES CE",0
50,"50259",84,58,58,0,0,"RECORTES CE",0
50,"50174",83,58,58,0,0,"RECORTES CE",0
3,"3015",12807,9782,9634,63,148,"RECORTES CE",10
8,"8152",116,94,94,0,0,"RECORTES CE",0
22,"22181",88,60,59,1,1,"RECORTES CE",0
18,"18170",324,225,224,1,1,"RECORTES CE",0
29,"29092",579,434,426,5,8,"RECORTES CE",1
10,"10112",1518,1168,1151,4,17,"RECORTES CE",3
8,"8232",1786,1444,1434,9,10,"RECORTES CE",0
32,"32013",2017,1388,1380,5,8,"RECORTES CE",1
20,"20019",9912,7226,7195,51,31,"RECORTES CE",14
39,"39041",1767,1437,1417,18,20,"RECORTES CE",0
46,"46008",2624,2036,1996,9,40,"RECORTES CE",2
29,"29093",2164,1704,1678,4,26,"RECORTES CE",0
23,"23030",1208,1022,1011,6,11,"RECORTES CE",0
20,"20020",113,67,67,0,0,"RECORTES CE",1
18,"18171",2111,1679,1638,8,41,"RECORTES CE",0
50,"50175",924,713,710,9,3,"RECORTES CE",0
22,"22182",233,178,174,1,4,"RECORTES CE",2
3,"3016",91,77,77,1,0,"RECORTES CE",0
46,"46191",1949,1541,1505,7,36,"RECORTES CE",5
17,"17205",211,184,184,1,0,"RECORTES CE",0
38,"38008",5658,4126,4056,19,70,"RECORTES CE",5
46,"46263",239,204,200,3,4,"RECORTES CE",0
26,"26062",86,74,72,1,2,"RECORTES CE",0
8,"8007",6775,5447,5419,21,28,"RECORTES CE",9
25,"25226",242,184,183,4,1,"RECORTES CE",0
50,"50176",222,161,156,3,5,"RECORTES CE",0
18,"18173",8972,6594,6459,58,135,"RECORTES CE",8
3,"3017",379,321,311,1,10,"RECORTES CE",0
44,"44036",23,20,20,0,0,"RECORTES CE",0
10,"10114",962,754,737,2,17,"RECORTES CE",1
39,"39042",5930,4722,4676,26,46,"RECORTES CE",6
31,"31050",6002,4111,4061,58,50,"RECORTES CE",8
8,"8008",179,139,138,0,1,"RECORTES CE",0
46,"46192",790,599,586,8,13,"RECORTES CE",0
50,"50262",1163,930,912,15,18,"RECORTES CE",0
44,"44037",449,334,331,1,3,"RECORTES CE",0
32,"32015",830,543,541,4,2,"RECORTES CE",1
3,"3018",12439,9387,9283,50,104,"RECORTES CE",4
11,"11012",97629,73036,72347,715,689,"RECORTES CE",257
22,"22186",191,165,164,2,1,"RECORTES CE",1
50,"50177",276,226,223,0,3,"RECORTES CE",1
39,"39043",1523,1246,1220,10,26,"RECORTES CE",0
18,"18174",434,362,357,0,5,"RECORTES CE",0
46,"46193",8964,7206,7156,27,50,"RECORTES CE",10
10,"10116",3728,2849,2776,27,73,"RECORTES CE",8
3,"3019",15465,12156,11988,80,168,"RECORTES CE",7
29,"29096",2756,2061,2018,21,43,"RECORTES CE",5
8,"8235",3829,3176,3167,14,9,"RECORTES CE",5
20,"20022",854,621,621,7,0,"RECORTES CE",0
41,"41001",1565,1224,1213,8,11,"RECORTES CE",2
18,"18175",11786,8883,8730,58,153,"RECORTES CE",9
6,"6144",512,422,416,1,6,"RECORTES CE",1
50,"50178",276,193,193,4,0,"RECORTES CE",1
8,"8156",11155,8956,8923,60,33,"RECORTES CE",12
46,"46194",15813,11654,11511,83,143,"RECORTES CE",15
10,"10117",243,156,154,1,2,"RECORTES CE",0
39,"39044",3868,3019,2985,8,34,"RECORTES CE",3
25,"25032",67,53,53,0,0,"RECORTES CE",0
8,"8236",1557,1204,1202,2,2,"RECORTES CE",1
23,"23034",2490,2033,1999,15,34,"RECORTES CE",0
43,"43070",238,194,193,1,1,"RECORTES CE",0
31,"31053",503,375,370,4,5,"RECORTES CE",2
14,"14033",1265,994,985,9,9,"RECORTES CE",4
6,"6145",899,744,723,1,21,"RECORTES CE",0
3,"3020",95,84,84,2,0,"RECORTES CE",1
25,"25230",1555,1221,1208,8,13,"RECORTES CE",0
41,"41002",1427,1057,1024,5,33,"RECORTES CE",1
31,"31054",454,322,318,4,4,"RECORTES CE",0
39,"39045",351,280,277,1,3,"RECORTES CE",0
18,"18176",241,182,180,0,2,"RECORTES CE",0
44,"44039",202,166,165,3,1,"RECORTES CE",0
29,"29098",1235,953,935,12,18,"RECORTES CE",0
25,"25231",494,410,408,2,2,"RECORTES CE",0
46,"46013",17712,14181,14075,88,106,"RECORTES CE",17
3,"3114",1581,1263,1237,9,26,"RECORTES CE",1
3,"3021",5578,4720,4626,35,94,"RECORTES CE",8
50,"50265",74,56,56,0,0,"RECORTES CE",0
22,"22190",122,89,89,0,0,"RECORTES CE",0
6,"6147",338,262,258,2,4,"RECORTES CE",0
26,"26068",79,62,62,1,0,"RECORTES CE",0
41,"41087",10496,7661,7477,57,184,"RECORTES CE",10
18,"18177",373,253,252,1,1,"RECORTES CE",0
50,"50180",106,84,84,1,0,"RECORTES CE",1
50,"50266",121,85,80,0,5,"RECORTES CE",0
21,"21034",1159,863,845,4,18,"RECORTES CE",0
43,"43145",4209,3409,3391,9,18,"RECORTES CE",3
3,"3022",137,122,119,0,3,"RECORTES CE",0
44,"44141",127,100,100,0,0,"RECORTES CE",0
20,"20026",204,182,159,3,23,"RECORTES CE",0
29,"29100",2378,1711,1686,22,25,"RECORTES CE",0
44,"44041",58,48,44,1,4,"RECORTES CE",0
32,"32019",11512,8281,8161,96,120,"RECORTES CE",2
46,"46197",1926,1473,1455,9,18,"RECORTES CE",2
6,"6148",957,762,746,12,16,"RECORTES CE",1
18,"18178",671,535,532,0,3,"RECORTES CE",0
50,"50182",3675,2846,2810,36,36,"RECORTES CE",13
32,"32020",2460,1899,1876,6,23,"RECORTES CE",0
39,"39047",1976,1564,1538,8,26,"RECORTES CE",2
3,"3023",1379,1216,1199,6,17,"RECORTES CE",2
25,"25035",366,306,302,2,4,"RECORTES CE",0
43,"43146",41,35,35,0,0,"RECORTES CE",0
31,"31058",202,163,160,2,3,"RECORTES CE",0
44,"44042",114,84,84,0,0,"RECORTES CE",0
26,"26070",155,133,132,0,1,"RECORTES CE",0
46,"46198",871,707,693,4,14,"RECORTES CE",0
20,"20027",2758,1980,1958,19,22,"RECORTES CE",0
18,"18179",503,346,343,3,3,"RECORTES CE",0
23,"23039",2154,1644,1605,6,39,"RECORTES CE",0
21,"21037",459,363,357,4,6,"RECORTES CE",4
50,"50183",319,242,241,4,1,"RECORTES CE",0
3,"3117",377,320,313,1,7,"RECORTES CE",1
3,"3024",3948,3210,3164,14,46,"RECORTES CE",1
20,"20028",2258,1579,1574,9,5,"RECORTES CE",1
18,"18180",627,442,435,4,7,"RECORTES CE",0
44,"44043",88,67,65,1,2,"RECORTES CE",0
8,"8160",316,252,247,2,5,"RECORTES CE",0
46,"46199",5842,4451,4414,23,37,"RECORTES CE",7
29,"29903",493,358,354,6,4,"RECORTES CE",0
17,"17125",131,98,97,1,1,"RECORTES CE",0
6,"6151",1054,791,778,2,13,"RECORTES CE",1
43,"43001",694,543,543,5,0,"RECORTES CE",0
4,"4083",1740,1342,1326,4,16,"RECORTES CE",1
3,"3025",1292,1009,991,7,18,"RECORTES CE",0
50,"50184",90,79,79,0,0,"RECORTES CE",0
48,"48054",24938,19329,19197,124,132,"RECORTES CE",48
25,"25037",366,286,284,3,2,"RECORTES CE",0
31,"31061",48,46,46,0,0,"RECORTES CE",1
43,"43002",1875,1367,1348,11,19,"RECORTES CE",3
8,"8161",11625,8521,8470,44,51,"RECORTES CE",18
44,"44044",83,65,64,2,1,"RECORTES CE",0
25,"25238",205,163,163,2,0,"RECORTES CE",0
29,"29904",417,337,335,2,2,"RECORTES CE",0
10,"10126",1470,1114,1104,7,10,"RECORTES CE",2
11,"11021",4926,3592,3486,50,106,"RECORTES CE",10
18,"18181",202,150,148,0,2,"RECORTES CE",0
50,"50185",136,103,102,0,1,"RECORTES CE",1
17,"17126",318,279,279,0,0,"RECORTES CE",1
3,"3026",1316,1040,1024,5,16,"RECORTES CE",1
25,"25038",1482,1111,1094,11,17,"RECORTES CE",0
31,"31183",713,569,555,6,14,"RECORTES CE",1
30,"30001",4539,3615,3567,16,48,"RECORTES CE",2
46,"46201",62,47,47,0,0,"RECORTES CE",0
25,"25239",595,367,366,3,1,"RECORTES CE",0
18,"18182",1917,1391,1381,7,10,"RECORTES CE",1
32,"32023",1132,867,862,7,5,"RECORTES CE",0
8,"8162",2124,1659,1651,7,8,"RECORTES CE",6
20,"20031",183,125,125,2,0,"RECORTES CE",0
32,"32024",4835,3484,3439,23,45,"RECORTES CE",3
39,"39051",73,65,64,0,1,"RECORTES CE",0
3,"3120",2421,1823,1786,9,37,"RECORTES CE",3
3,"3027",172,156,153,0,3,"RECORTES CE",2
8,"8163",19497,14616,14548,67,68,"RECORTES CE",17
46,"46202",17660,13782,13645,93,137,"RECORTES CE",25
18,"18183",624,442,441,1,1,"RECORTES CE",0
26,"26075",321,266,265,0,1,"RECORTES CE",1
48,"48057",5745,4391,4376,13,15,"RECORTES CE",1
39,"39052",18957,15123,14985,106,138,"RECORTES CE",15
41,"41009",1167,820,805,4,15,"RECORTES CE",1
50,"50186",37,28,28,0,0,"RECORTES CE",0
20,"20032",8681,6491,6429,22,62,"RECORTES CE",8
3,"3028",964,804,795,6,9,"RECORTES CE",0
44,"44046",43,32,32,0,0,"RECORTES CE",0
21,"21042",15579,8742,8579,138,163,"RECORTES CE",11
8,"8244",6041,4994,4970,33,24,"RECORTES CE",7
31,"31065",1859,1383,1366,16,17,"RECORTES CE",1
17,"17129",144,120,120,1,0,"RECORTES CE",0
8,"8164",934,784,776,1,8,"RECORTES CE",0
10,"10130",1747,1352,1321,12,31,"RECORTES CE",1
32,"32053",1363,1114,1098,14,16,"RECORTES CE",0
41,"41010",4573,3407,3345,27,62,"RECORTES CE",2
25,"25242",689,539,531,0,8,"RECORTES CE",0
4,"4088",2435,1708,1693,6,15,"RECORTES CE",1
50,"50187",56,43,43,0,0,"RECORTES CE",0
30,"30003",25046,17860,17668,99,192,"RECORTES CE",18
3,"3029",244,174,167,1,7,"RECORTES CE",0
20,"20033",854,675,671,5,4,"RECORTES CE",0
18,"18185",542,454,453,2,1,"RECORTES CE",1
46,"46204",6657,5262,5204,27,58,"RECORTES CE",4
43,"43005",3643,2765,2749,22,16,"RECORTES CE",5
8,"8018",2551,1998,1984,6,14,"RECORTES CE",0
50,"50188",27,24,24,0,0,"RECORTES CE",0
25,"25243",3730,2637,2606,20,31,"RECORTES CE",3
8,"8165",1664,1315,1311,9,4,"RECORTES CE",3
20,"20034",3154,2336,2315,20,21,"RECORTES CE",3
3,"3030",563,474,466,2,8,"RECORTES CE",0
39,"39054",4528,3614,3575,23,39,"RECORTES CE",3
17,"17038",380,312,308,3,4,"RECORTES CE",0
43,"43152",434,357,356,0,1,"RECORTES CE",0
44,"44148",76,64,63,0,1,"RECORTES CE",0
46,"46205",14233,11274,11145,55,129,"RECORTES CE",13
18,"18187",512,388,387,0,1,"RECORTES CE",0
3,"3124",460,401,390,2,11,"RECORTES CE",0
41,"41012",3368,2416,2361,23,55,"RECORTES CE",1
32,"32027",1000,762,747,5,15,"RECORTES CE",0
23,"23046",2331,1953,1926,3,27,"RECORTES CE",2
43,"43006",676,531,525,4,6,"RECORTES CE",1
11,"11027",68637,48919,48441,519,478,"RECORTES CE",123
50,"50274",66,48,47,0,1,"RECORTES CE",0
10,"10133",1154,971,955,3,16,"RECORTES CE",0
8,"8166",962,753,745,7,8,"RECORTES CE",0
46,"46206",557,461,455,6,6,"RECORTES CE",0
26,"26080",453,385,383,2,2,"RECORTES CE",0
39,"39055",1075,836,829,8,7,"RECORTES CE",1
18,"18188",1648,1295,1276,4,19,"RECORTES CE",0
25,"25245",430,346,342,1,4,"RECORTES CE",0
32,"32028",1550,1176,1171,10,5,"RECORTES CE",0
3,"3032",99,87,87,0,0,"RECORTES CE",0
50,"50190",675,565,553,5,12,"RECORTES CE",3
8,"8247",980,832,828,3,4,"RECORTES CE",0
46,"46207",6686,5220,5137,36,83,"RECORTES CE",13
41,"41013",4807,3480,3425,30,55,"RECORTES CE",3
14,"14046",4443,3550,3486,38,64,"RECORTES CE",3
10,"10135",1241,995,981,5,14,"RECORTES CE",0
8,"8167",6048,4833,4822,48,11,"RECORTES CE",9
44,"44050",3115,2333,2299,27,34,"RECORTES CE",4
21,"21047",1869,1242,1206,8,36,"RECORTES CE",3
43,"43007",640,510,509,0,1,"RECORTES CE",0
3,"3033",102,87,85,0,2,"RECORTES CE",1
46,"46025",2455,2002,1981,6,21,"RECORTES CE",4
43,"43008",307,202,200,1,2,"RECORTES CE",0
23,"23049",1747,1321,1305,11,16,"RECORTES CE",2
48,"48062",293,247,245,0,2,"RECORTES CE",0
18,"18189",772,619,611,4,8,"RECORTES CE",0
3,"3034",1391,1107,1090,7,17,"RECORTES CE",0
44,"44051",2588,2034,1997,26,37,"RECORTES CE",3
30,"30008",14450,10832,10675,60,157,"RECORTES CE",32
32,"32030",944,690,685,7,5,"RECORTES CE",0
26,"26082",100,85,85,0,0,"RECORTES CE",0
25,"25248",880,714,713,4,1,"RECORTES CE",0
41,"41015",5401,3984,3889,50,95,"RECORTES CE",10
50,"50192",233,189,183,0,6,"RECORTES CE",0
31,"31072",5320,4046,3958,40,88,"RECORTES CE",11
25,"25145",76,66,66,1,0,"RECORTES CE",0
8,"8169",48284,37528,37326,218,202,"RECORTES CE",89
8,"8249",272,248,248,2,0,"RECORTES CE",0
50,"50277",49,37,37,3,0,"RECORTES CE",0
43,"43082",351,303,297,1,6,"RECORTES CE",0
44,"44052",74,50,49,0,1,"RECORTES CE",0
18,"18192",1466,1171,1156,1,15,"RECORTES CE",0
43,"43009",1391,1086,1078,3,8,"RECORTES CE",1
39,"39058",800,574,573,1,1,"RECORTES CE",0
50,"50193",663,536,516,1,20,"RECORTES CE",0
3,"3035",632,529,525,2,4,"RECORTES CE",1
20,"20039",2144,1704,1692,11,12,"RECORTES CE",0
30,"30009",12689,10036,9909,50,127,"RECORTES CE",8
25,"25047",972,784,781,8,3,"RECORTES CE",1
6,"6162",2895,2289,2254,11,35,"RECORTES CE",0
31,"31074",390,310,307,5,3,"RECORTES CE",0
8,"8250",7182,5461,5421,38,40,"RECORTES CE",11
46,"46058",1734,1349,1325,9,24,"RECORTES CE",1
18,"18193",14802,11165,10973,110,192,"RECORTES CE",16
8,"8170",442,338,338,0,0,"RECORTES CE",0
3,"3130",43,23,23,0,0,"RECORTES CE",0
14,"14049",16282,12515,12301,121,214,"RECORTES CE",16
43,"43010",337,286,284,2,2,"RECORTES CE",0
44,"44154",248,200,195,2,5,"RECORTES CE",0
6,"6901",2117,1686,1655,17,31,"RECORTES CE",2
31,"31075",118,96,95,2,1,"RECORTES CE",0
3,"3036",86,77,75,2,2,"RECORTES CE",0
41,"41017",15712,12048,11896,118,152,"RECORTES CE",15
50,"50194",81,59,59,1,0,"RECORTES CE",0
18,"18194",2045,1394,1370,11,24,"RECORTES CE",0
48,"48066",347,291,291,0,0,"RECORTES CE",0
22,"22212",70,56,56,0,0,"RECORTES CE",0
41,"41018",9410,6987,6882,52,105,"RECORTES CE",2
6,"6902",1663,1273,1252,4,21,"RECORTES CE",0
3,"3131",179,147,139,0,8,"RECORTES CE",0
50,"50223",916,751,745,13,6,"RECORTES CE",0
43,"43011",1079,912,909,1,3,"RECORTES CE",1
3,"3037",341,289,284,1,5,"RECORTES CE",1
50,"50280",301,246,240,1,6,"RECORTES CE",3
44,"44055",77,58,56,0,2,"RECORTES CE",0
50,"50195",53,42,41,0,1,"RECORTES CE",0
32,"32033",676,480,468,4,12,"RECORTES CE",0
6,"6065",298,258,255,1,3,"RECORTES CE",0
3,"3132",515,417,414,4,3,"RECORTES CE",0
18,"18901",488,335,329,2,6,"RECORTES CE",0
20,"20042",3172,2247,2231,9,16,"RECORTES CE",1
14,"14051",1348,1064,1048,7,16,"RECORTES CE",1
3,"3038",335,275,267,1,8,"RECORTES CE",0
30,"30012",9069,7397,7266,53,131,"RECORTES CE",5
25,"25252",557,424,422,4,2,"RECORTES CE",0
50,"50020",802,606,600,7,6,"RECORTES CE",2
10,"10143",141,118,113,1,5,"RECORTES CE",0
46,"46213",15504,11420,11232,124,188,"RECORTES CE",20
43,"43012",3647,3028,3019,15,9,"RECORTES CE",2
3,"3039",89,70,70,0,0,"RECORTES CE",0
8,"8172",20417,16196,16144,88,52,"RECORTES CE",34
50,"50196",102,83,81,2,2,"RECORTES CE",0
18,"18902",755,611,595,1,16,"RECORTES CE",0
50,"50197",96,78,78,1,0,"RECORTES CE",0
39,"39062",1841,1511,1500,9,11,"RECORTES CE",1
32,"32035",1370,881,872,5,9,"RECORTES CE",0
23,"23055",46343,33603,33225,243,378,"RECORTES CE",35
11,"11037",5644,4567,4433,34,134,"RECORTES CE",5
31,"31079",67,60,60,0,0,"RECORTES CE",0
31,"31080",490,393,390,2,3,"RECORTES CE",2
50,"50225",1532,1072,1064,10,8,"RECORTES CE",1
8,"8174",392,330,330,4,0,"RECORTES CE",0
20,"20043",1734,1254,1248,5,6,"RECORTES CE",2
7,"7002",6612,4721,4672,43,49,"RECORTES CE",13
25,"25051",1510,1176,1172,6,4,"RECORTES CE",1
44,"44059",550,446,437,7,9,"RECORTES CE",0
3,"3040",258,223,217,1,6,"RECORTES CE",0
30,"30014",1585,1226,1202,3,24,"RECORTES CE",2
8,"8175",3368,2496,2486,16,10,"RECORTES CE",1
18,"18904",743,555,545,1,10,"RECORTES CE",0
46,"46215",1397,1104,1093,12,11,"RECORTES CE",0
20,"20044",364,263,262,0,1,"RECORTES CE",0
48,"48070",528,392,390,2,2,"RECORTES CE",0
30,"30015",19372,14430,14283,91,147,"RECORTES CE",16
3,"3041",6093,4444,4398,13,46,"RECORTES CE",6
7,"7003",12374,7550,7442,51,108,"RECORTES CE",17
41,"41094",6447,4998,4912,43,86,"RECORTES CE",4
50,"50198",49,43,43,1,0,"RECORTES CE",0
22,"22217",372,296,290,5,6,"RECORTES CE",0
46,"46216",5252,4291,4263,23,28,"RECORTES CE",2
39,"39064",1341,1103,1094,5,9,"RECORTES CE",0
25,"25254",711,576,571,5,5,"RECORTES CE",0
32,"32037",681,534,523,6,11,"RECORTES CE",1
8,"8019",1117818,875679,872180,4327,3499,"RECORTES CE",1771
30,"30016",152709,110165,109114,717,1051,"RECORTES CE",313
15,"15071",7805,5476,5401,62,75,"RECORTES CE",14
8,"8176",161,132,131,2,1,"RECORTES CE",0
7,"7004",4033,2898,2860,28,38,"RECORTES CE",2
3,"3042",1462,1025,1008,3,17,"RECORTES CE",1
41,"41022",4269,3158,3110,16,48,"RECORTES CE",2
18,"18905",15550,11394,11230,132,164,"RECORTES CE",16
31,"31083",50,41,41,1,0,"RECORTES CE",1
44,"44061",75,66,65,2,1,"RECORTES CE",0
7,"7005",6975,4824,4775,43,49,"RECORTES CE",1
20,"20046",1248,918,909,11,9,"RECORTES CE",0
46,"46217",893,733,723,6,10,"RECORTES CE",0
44,"44062",31,24,23,1,1,"RECORTES CE",0
50,"50200",475,416,407,4,9,"RECORTES CE",1
3,"3043",2899,2466,2434,21,32,"RECORTES CE",0
39,"39066",877,711,705,5,6,"RECORTES CE",1
25,"25055",163,130,129,0,1,"RECORTES CE",0
22,"22220",150,120,117,0,3,"RECORTES CE",1
7,"7006",5332,3769,3722,25,47,"RECORTES CE",3
33,"33033",9439,6565,6468,78,97,"RECORTES CE",9
8,"8177",39,31,31,0,0,"RECORTES CE",0
50,"50201",444,357,354,1,3,"RECORTES CE",0
46,"46218",1031,907,885,6,22,"RECORTES CE",1
30,"30018",8326,6544,6438,25,106,"RECORTES CE",11
50,"50286",75,58,55,0,3,"RECORTES CE",0
43,"43090",1169,749,742,2,7,"RECORTES CE",1
8,"8257",103,86,86,1,0,"RECORTES CE",0
39,"39067",759,582,575,3,7,"RECORTES CE",0
25,"25902",542,449,439,3,10,"RECORTES CE",0
3,"3044",4557,3650,3600,17,50,"RECORTES CE",4
21,"21061",5089,3358,3290,42,68,"RECORTES CE",2
48,"48073",6837,4950,4921,33,29,"RECORTES CE",2
43,"43017",116,98,98,1,0,"RECORTES CE",0
18,"18907",1774,1426,1415,10,11,"RECORTES CE",0
10,"10151",198,161,157,2,4,"RECORTES CE",0
25,"25056",213,163,163,3,0,"RECORTES CE",0
46,"46219",122,105,104,0,1,"RECORTES CE",0
50,"50202",131,90,88,1,2,"RECORTES CE",0
44,"44064",63,49,48,0,1,"RECORTES CE",0
44,"44163",114,92,92,0,0,"RECORTES CE",0
25,"25057",214,162,161,0,1,"RECORTES CE",2
41,"41098",5152,4046,3986,24,60,"RECORTES CE",4
30,"30019",25846,18755,18517,172,238,"RECORTES CE",12
3,"3139",23061,16378,16178,128,200,"RECORTES CE",35
43,"43091",123,93,93,1,0,"RECORTES CE",0
46,"46220",48968,35430,34964,306,466,"RECORTES CE",62
25,"25903",229,189,188,0,1,"RECORTES CE",0
8,"8179",611,496,493,2,3,"RECORTES CE",0
26,"26100",56,46,46,0,0,"RECORTES CE",0
7,"7008",6047,4570,4513,31,57,"RECORTES CE",8
46,"46038",307,243,241,0,2,"RECORTES CE",0
3,"3046",1619,1213,1190,17,23,"RECORTES CE",1
50,"50028",77,59,58,1,1,"RECORTES CE",0
41,"41026",4300,3561,3521,18,40,"RECORTES CE",1
18,"18909",539,432,426,1,6,"RECORTES CE",0
22,"22225",2610,1867,1843,15,24,"RECORTES CE",5
50,"50288",3444,2689,2668,24,21,"RECORTES CE",4
46,"46221",345,294,294,0,0,"RECORTES CE",0
50,"50203",1057,849,837,9,12,"RECORTES CE",2
41,"41027",3966,2830,2784,32,46,"RECORTES CE",0
3,"3047",9711,6910,6791,36,119,"RECORTES CE",15
39,"39069",1928,1650,1627,9,23,"RECORTES CE",0
44,"44065",57,37,36,0,1,"RECORTES CE",0
50,"50289",51,40,38,1,2,"RECORTES CE",0
41,"41100",967,765,727,8,38,"RECORTES CE",0
48,"48076",284,226,224,1,2,"RECORTES CE",0
18,"18910",730,491,487,0,4,"RECORTES CE",0
43,"43019",1336,1020,1008,4,12,"RECORTES CE",0
14,"14061",688,567,556,2,11,"RECORTES CE",0
50,"50204",2394,1876,1855,21,21,"RECORTES CE",3
46,"46222",394,325,324,1,1,"RECORTES CE",1
32,"32042",1505,1097,1091,12,6,"RECORTES CE",1
26,"26102",6057,4672,4579,37,93,"RECORTES CE",4
3,"3048",4971,3808,3739,19,69,"RECORTES CE",13
20,"20051",6775,5124,5091,24,33,"RECORTES CE",8
48,"48077",3376,2656,2647,11,9,"RECORTES CE",2
8,"8260",18400,14471,14406,87,65,"RECORTES CE",20
12,"12002",115,99,97,0,2,"RECORTES CE",0
44,"44067",108,82,78,0,4,"RECORTES CE",0
30,"30022",17056,12158,11954,126,204,"RECORTES CE",15
14,"14001",3443,2724,2675,24,49,"RECORTES CE",0
46,"46223",7781,6057,5995,42,62,"RECORTES CE",5
30,"30023",3875,3107,3068,20,39,"RECORTES CE",5
18,"18911",7869,5871,5765,49,106,"RECORTES CE",8
3,"3049",12143,9418,9302,47,116,"RECORTES CE",9
25,"25906",210,157,155,0,2,"RECORTES CE",0
50,"50206",453,371,370,5,1,"RECORTES CE",0
20,"20052",1070,833,827,2,6,"RECORTES CE",1
17,"17057",968,826,822,1,4,"RECORTES CE",0
39,"39072",324,206,204,4,2,"RECORTES CE",0
31,"31092",685,514,511,6,3,"RECORTES CE",1
44,"44068",643,518,511,9,7,"RECORTES CE",0
17,"17150",1426,1199,1192,8,7,"RECORTES CE",1
46,"46224",154,124,124,2,0,"RECORTES CE",0
30,"30024",60183,45738,45317,290,421,"RECORTES CE",53
20,"20053",4848,3479,3451,27,28,"RECORTES CE",5
3,"3050",19334,14377,14253,71,124,"RECORTES CE",25
18,"18912",1367,990,984,5,6,"RECORTES CE",0
43,"43021",345,270,269,3,1,"RECORTES CE",0
25,"25907",497,389,386,2,3,"RECORTES CE",0
22,"22228",529,421,417,3,4,"RECORTES CE",4
7,"7013",7231,5372,5253,43,119,"RECORTES CE",5
8,"8183",4563,3628,3613,9,15,"RECORTES CE",5
12,"12004",4177,3225,3187,13,38,"RECORTES CE",4
20,"20054",459,313,312,1,1,"RECORTES CE",0
7,"7014",7778,4724,4669,50,55,"RECORTES CE",6
50,"50207",93,68,67,2,1,"RECORTES CE",0
4,"4001",1014,768,763,9,5,"RECORTES CE",2
10,"10159",317,241,240,0,1,"RECORTES CE",0
18,"18913",781,590,577,5,13,"RECORTES CE",0
21,"21069",1667,1214,1198,13,16,"RECORTES CE",0
43,"43096",98,82,82,0,0,"RECORTES CE",0
23,"23066",4299,3603,3545,13,58,"RECORTES CE",3
43,"43022",1435,1130,1123,8,7,"RECORTES CE",0
3,"3051",344,312,307,2,5,"RECORTES CE",0
50,"50208",1748,1360,1344,11,16,"RECORTES CE",1
25,"25909",140,108,107,2,1,"RECORTES CE",0
8,"8184",54876,41661,41447,248,214,"RECORTES CE",73
17,"17151",185,150,150,1,0,"RECORTES CE",0
46,"46226",31,27,27,0,0,"RECORTES CE",0
18,"18914",1657,1315,1278,5,37,"RECORTES CE",0
50,"50293",392,295,293,6,2,"RECORTES CE",1
33,"33042",4243,3137,3103,36,34,"RECORTES CE",9
46,"46044",4198,3399,3337,13,62,"RECORTES CE",6
50,"50209",2747,1993,1975,29,18,"RECORTES CE",8
3,"3052",967,805,790,4,15,"RECORTES CE",0
30,"30026",16252,11142,10977,65,165,"RECORTES CE",21
39,"39074",7041,5612,5551,31,61,"RECORTES CE",4
10,"10161",82,50,50,1,0,"RECORTES CE",1
44,"44074",444,353,346,3,7,"RECORTES CE",0
8,"8185",197,172,171,2,1,"RECORTES CE",0
46,"46227",888,708,693,6,15,"RECORTES CE",0
30,"30027",49767,39111,38724,245,387,"RECORTES CE",59
18,"18915",731,539,532,1,7,"RECORTES CE",0
10,"10039",402,302,301,0,1,"RECORTES CE",0
3,"3053",7469,5950,5865,26,85,"RECORTES CE",3
22,"22232",87,66,65,2,1,"RECORTES CE",0
43,"43024",1556,1154,1137,3,17,"RECORTES CE",1
7,"7016",2931,2201,2178,31,23,"RECORTES CE",3
39,"39075",136968,104358,103487,690,871,"RECORTES CE",110
25,"25064",98,88,88,0,0,"RECORTES CE",0
25,"25911",424,332,331,1,1,"RECORTES CE",0
46,"46228",2417,1953,1913,13,40,"RECORTES CE",3
50,"50210",36,29,29,0,0,"RECORTES CE",0
44,"44173",102,85,80,0,5,"RECORTES CE",0
30,"30028",6400,4364,4289,30,75,"RECORTES CE",1
4,"4005",533,448,442,0,6,"RECORTES CE",0
33,"33044",177352,134444,133352,1391,1092,"RECORTES CE",237
8,"8029",3560,3027,3019,13,8,"RECORTES CE",3
26,"26110",150,128,124,1,4,"RECORTES CE",0
21,"21073",1891,1191,1156,17,35,"RECORTES CE",1
18,"18916",1778,1249,1236,9,13,"RECORTES CE",1
7,"7018",379,287,286,1,1,"RECORTES CE",2
8,"8266",43383,35117,34994,178,123,"RECORTES CE",55
46,"46229",911,755,752,5,3,"RECORTES CE",0
31,"31100",256,181,178,1,3,"RECORTES CE",0
23,"23071",1720,1348,1330,6,18,"RECORTES CE",2
8,"8188",115,95,95,0,0,"RECORTES CE",0
43,"43025",590,476,472,0,4,"RECORTES CE",1
44,"44076",2110,1725,1691,22,34,"RECORTES CE",0
50,"50296",382,288,272,1,16,"RECORTES CE",2
3,"3055",5247,4042,3991,24,51,"RECORTES CE",7
50,"50211",237,177,173,0,4,"RECORTES CE",0
4,"4006",7218,5002,4940,33,62,"RECORTES CE",6
10,"10165",253,212,210,1,2,"RECORTES CE",0
48,"48085",10637,8270,8223,54,47,"RECORTES CE",15
46,"46230",14084,10694,10599,67,95,"RECORTES CE",9
43,"43026",765,614,613,3,1,"RECORTES CE",0
12,"12009",17859,13054,12911,98,143,"RECORTES CE",10
43,"43099",286,234,234,0,0,"RECORTES CE",0
21,"21075",335,256,249,0,7,"RECORTES CE",0
50,"50037",127,93,93,0,0,"RECORTES CE",0
50,"50212",32,29,29,1,0,"RECORTES CE",0
22,"22235",88,72,72,1,0,"RECORTES CE",0
3,"3056",8629,6838,6737,38,101,"RECORTES CE",8
20,"20060",88,75,75,0,0,"RECORTES CE",0
36,"36048",5244,3859,3786,33,73,"RECORTES CE",4
32,"32051",1407,1158,1153,12,5,"RECORTES CE",2
46,"46231",2401,1780,1770,8,10,"RECORTES CE",1
39,"39078",1406,1101,1090,7,11,"RECORTES CE",0
50,"50213",93,76,75,0,1,"RECORTES CE",0
44,"44176",153,124,124,0,0,"RECORTES CE",0
46,"46049",268,231,228,1,3,"RECORTES CE",1
48,"48086",2015,1504,1486,6,18,"RECORTES CE",1
21,"21076",2142,1573,1551,24,22,"RECORTES CE",5
43,"43027",164,137,137,0,0,"RECORTES CE",0
26,"26001",198,171,165,1,6,"RECORTES CE",1
30,"30031",500,435,433,3,2,"RECORTES CE",0
17,"17158",468,337,336,1,1,"RECORTES CE",0
26,"26114",74,62,60,0,2,"RECORTES CE",0
46,"46232",872,714,706,3,8,"RECORTES CE",0
22,"22239",88,71,71,0,0,"RECORTES CE",0
7,"7021",230,183,178,3,5,"RECORTES CE",0
7,"7022",11615,8055,7934,91,121,"RECORTES CE",14
20,"20061",4392,3278,3264,11,14,"RECORTES CE",3
50,"50214",18,10,10,0,0,"RECORTES CE",0
3,"3058",4967,4031,3967,24,64,"RECORTES CE",3
39,"39080",3505,2735,2701,8,34,"RECORTES CE",3
30,"30032",2851,2256,2218,14,38,"RECORTES CE",6
21,"21078",2646,1926,1895,14,31,"RECORTES CE",3
44,"44082",89,72,69,0,3,"RECORTES CE",0
8,"8191",5270,4176,4162,19,14,"RECORTES CE",8
46,"46233",3781,2901,2847,22,54,"RECORTES CE",4
4,"4010",580,445,434,2,11,"RECORTES CE",1
31,"31105",1478,1203,1189,21,14,"RECORTES CE",3
20,"20062",945,727,726,3,1,"RECORTES CE",2
3,"3059",20590,15909,15766,96,143,"RECORTES CE",27
30,"30033",10363,8115,7979,54,136,"RECORTES CE",6
43,"43028",2766,2007,1988,7,19,"RECORTES CE",2
41,"41038",102179,76348,75425,819,923,"RECORTES CE",149
20,"20063",8061,6042,5999,36,43,"RECORTES CE",3
50,"50215",20,18,18,0,0,"RECORTES CE",0
30,"30034",1075,852,831,4,21,"RECORTES CE",1
46,"46234",327,264,263,5,1,"RECORTES CE",0
26,"26004",66,54,54,0,0,"RECORTES CE",0
50,"50216",240,189,181,3,8,"RECORTES CE",0
44,"44084",55,45,45,0,0,"RECORTES CE",0
6,"6089",608,524,519,3,5,"RECORTES CE",0
43,"43029",314,253,252,0,1,"RECORTES CE",0
26,"26118",72,63,60,1,3,"RECORTES CE",0
25,"25073",546,420,418,2,2,"RECORTES CE",0
48,"48089",3463,2746,2732,10,14,"RECORTES CE",3
14,"14013",16604,12618,12388,155,230,"RECORTES CE",26
8,"8193",984,792,790,5,2,"RECORTES CE",2
3,"3061",1054,830,816,3,14,"RECORTES CE",1
26,"26005",2480,1687,1661,5,26,"RECORTES CE",3
46,"46235",21270,15754,15592,101,162,"RECORTES CE",12
22,"22244",46,37,37,2,0,"RECORTES CE",0
20,"20064",12436,8730,8652,59,78,"RECORTES CE",14
31,"31108",1829,1460,1437,16,23,"RECORTES CE",7
50,"50217",431,346,344,0,2,"RECORTES CE",0
26,"26006",1825,1496,1470,8,26,"RECORTES CE",2
44,"44180",72,61,61,0,0,"RECORTES CE",0
8,"8272",165,133,133,0,0,"RECORTES CE",0
50,"50042",16,16,16,0,0,"RECORTES CE",0
25,"25074",180,157,155,2,2,"RECORTES CE",0
12,"12015",114,99,98,0,1,"RECORTES CE",0
33,"33051",6811,4879,4809,63,70,"RECORTES CE",10
43,"43030",482,373,372,2,1,"RECORTES CE",1
32,"32056",1520,1125,1116,6,9,"RECORTES CE",0
50,"50218",110,92,92,0,0,"RECORTES CE",0
43,"43031",1446,1180,1178,7,2,"RECORTES CE",2
4,"4014",149,109,108,0,1,"RECORTES CE",0
36,"36053",5784,4407,4327,28,80,"RECORTES CE",6
3,"3062",221,182,180,1,2,"RECORTES CE",0
22,"22115",347,262,261,1,1,"RECORTES CE",1
46,"46237",7148,5537,5472,36,65,"RECORTES CE",8
23,"23080",1721,1370,1355,8,15,"RECORTES CE",2
30,"30037",19254,14416,14217,67,199,"RECORTES CE",25
41,"41041",9760,7835,7646,44,189,"RECORTES CE",5
10,"10175",1361,1031,997,8,34,"RECORTES CE",2
32,"32085",10634,7655,7551,66,104,"RECORTES CE",6
20,"20066",439,327,326,0,1,"RECORTES CE",0
50,"50219",4283,3274,3213,53,61,"RECORTES CE",9
43,"43032",466,379,379,1,0,"RECORTES CE",0
26,"26008",1822,1436,1420,14,16,"RECORTES CE",0
3,"3063",27121,19869,19713,131,156,"RECORTES CE",30
48,"48001",5885,4359,4334,35,25,"RECORTES CE",6
6,"6093",4345,3356,3281,18,75,"RECORTES CE",3
25,"25076",134,94,93,0,1,"RECORTES CE",0
46,"46238",13105,9717,9610,57,107,"RECORTES CE",13
43,"43106",793,656,651,2,5,"RECORTES CE",0
31,"31112",93,71,70,0,1,"RECORTES CE",0
44,"44182",198,172,171,2,1,"RECORTES CE",0
7,"7028",920,686,676,8,10,"RECORTES CE",2
6,"6127",2809,2285,2258,13,27,"RECORTES CE",3
8,"8196",19444,15361,15263,90,98,"RECORTES CE",18
26,"26010",85,68,68,1,0,"RECORTES CE",0
10,"10177",1695,1358,1323,9,35,"RECORTES CE",2
33,"33054",1611,1145,1124,8,21,"RECORTES CE",1
4,"4017",1276,907,900,4,7,"RECORTES CE",0
44,"44089",52,44,44,0,0,"RECORTES CE",0
46,"46239",453,372,366,2,6,"RECORTES CE",1
10,"10055",696,527,512,1,15,"RECORTES CE",0
8,"8197",7896,6197,6174,28,23,"RECORTES CE",8
39,"39086",362,273,268,1,5,"RECORTES CE",1
43,"43033",768,609,607,3,2,"RECORTES CE",0
46,"46057",474,319,313,1,6,"RECORTES CE",0
14,"14018",3611,2802,2741,25,61,"RECORTES CE",4
26,"26124",776,635,624,5,11,"RECORTES CE",0
30,"30039",20191,14552,14380,96,172,"RECORTES CE",26
8,"8275",248,223,222,1,1,"RECORTES CE",0
3,"3065",169399,128218,127256,967,962,"RECORTES CE",177
46,"46240",206,175,169,2,6,"RECORTES CE",0
17,"17166",547,460,459,2,1,"RECORTES CE",0
8,"8276",233,180,180,0,0,"RECORTES CE",0
32,"32059",1703,1248,1228,12,20,"RECORTES CE",1
48,"48004",326,261,260,3,1,"RECORTES CE",0
50,"50250",56,45,45,0,0,"RECORTES CE",1
23,"23018",2268,1738,1722,8,16,"RECORTES CE",0
30,"30040",705,600,596,1,4,"RECORTES CE",2
3,"3066",41802,31046,30696,285,350,"RECORTES CE",50
44,"44090",66,49,49,0,0,"RECORTES CE",0
10,"10180",4168,2735,2680,18,55,"RECORTES CE",2
25,"25179",171,134,134,1,0,"RECORTES CE",0
43,"43034",468,393,393,0,0,"RECORTES CE",0
39,"39088",59,51,51,0,0,"RECORTES CE",0
41,"41045",5854,4287,4200,58,87,"RECORTES CE",3
43,"43035",235,205,203,7,2,"RECORTES CE",0
26,"26013",323,258,256,1,2,"RECORTES CE",1
8,"8199",651,542,542,4,0,"RECORTES CE",0
3,"3067",93,87,87,0,0,"RECORTES CE",0
17,"17076",122,101,100,1,1,"RECORTES CE",1
44,"44123",99,69,69,1,0,"RECORTES CE",0
30,"30041",13970,9796,9682,80,114,"RECORTES CE",23
48,"48005",113,80,80,0,0,"RECORTES CE",0
46,"46181",16908,12749,12597,82,152,"RECORTES CE",11
46,"46242",330,279,279,0,0,"RECORTES CE",1
26,"26014",447,313,309,2,4,"RECORTES CE",1
22,"22251",334,269,263,4,6,"RECORTES CE",0
17,"17197",131,113,113,1,0,"RECORTES CE",0
35,"35003",5582,3441,3391,26,50,"RECORTES CE",7
31,"31117",589,420,419,5,1,"RECORTES CE",1
15,"15004",4873,3689,3623,31,66,"RECORTES CE",3
8,"8200",62161,48645,48330,261,315,"RECORTES CE",113
18,"18022",13804,9877,9714,92,163,"RECORTES CE",7
48,"48006",309,265,265,0,0,"RECORTES CE",0
17,"17077",567,434,434,2,0,"RECORTES CE",0
43,"43036",865,605,602,1,3,"RECORTES CE",1
22,"22011",97,78,75,2,3,"RECORTES CE",0
39,"39090",772,619,609,1,10,"RECORTES CE",0
30,"30043",25401,20378,19992,131,386,"RECORTES CE",31
31,"31241",125,100,100,2,0,"RECORTES CE",0
44,"44189",48,36,36,0,0,"RECORTES CE",1
10,"10905",632,491,485,4,6,"RECORTES CE",1
26,"26015",180,145,142,1,3,"RECORTES CE",0
22,"22252",118,100,99,0,1,"RECORTES CE",0
26,"26016",28,24,23,0,1,"RECORTES CE",0
17,"17169",2497,2047,2042,8,5,"RECORTES CE",3
48,"48007",385,281,279,1,2,"RECORTES CE",1
48,"48902",18971,14015,13895,101,120,"RECORTES CE",39
25,"25182",1043,842,839,9,3,"RECORTES CE",2
43,"43037",17902,12787,12695,63,92,"RECORTES CE",14
20,"20073",4698,3530,3515,29,15,"RECORTES CE",2
3,"3070",2106,1554,1528,9,26,"RECORTES CE",1
15,"15006",5169,3527,3436,32,91,"RECORTES CE",5
6,"6067",1915,1393,1370,7,23,"RECORTES CE",0
12,"12024",133,117,117,0,0,"RECORTES CE",0
32,"32063",1819,1313,1287,6,26,"RECORTES CE",1
44,"44096",153,120,112,1,8,"RECORTES CE",0
41,"41076",2143,1419,1403,14,16,"RECORTES CE",0
21,"21019",584,441,425,10,16,"RECORTES CE",0
14,"14023",2007,1734,1711,9,23,"RECORTES CE",0
46,"46245",528,430,426,2,4,"RECORTES CE",0
43,"43038",21861,16504,16406,112,98,"RECORTES CE",16
8,"8280",95,78,78,1,0,"RECORTES CE",0
26,"26018",10441,8400,8311,64,89,"RECORTES CE",14
39,"39092",871,635,629,2,6,"RECORTES CE",0
30,"30902",8225,5797,5715,22,82,"RECORTES CE",14
22,"22128",192,155,154,2,1,"RECORTES CE",0
10,"10064",1409,1103,1072,6,31,"RECORTES CE",1
31,"31244",156,95,94,5,1,"RECORTES CE",0
7,"7036",27950,20870,20707,154,163,"RECORTES CE",58
8,"8202",12843,10074,10025,57,49,"RECORTES CE",10
44,"44191",722,567,561,7,6,"RECORTES CE",4
29,"29064",437,319,315,2,4,"RECORTES CE",0
46,"46246",1042,860,838,2,22,"RECORTES CE",2
31,"31122",4946,3915,3882,59,33,"RECORTES CE",18
43,"43039",105,85,85,0,0,"RECORTES CE",0
35,"35006",31309,23434,23019,221,415,"RECORTES CE",76
6,"6003",766,625,610,3,15,"RECORTES CE",0
31,"31245",77,60,59,4,1,"RECORTES CE",0
3,"3072",348,297,295,2,2,"RECORTES CE",0
31,"31002",433,324,324,4,0,"RECORTES CE",1
20,"20076",7025,5263,5237,31,26,"RECORTES CE",4
26,"26019",350,270,256,3,14,"RECORTES CE",4
8,"8203",2472,1884,1873,4,11,"RECORTES CE",1
33,"33062",388,250,245,9,5,"RECORTES CE",0
46,"46247",961,695,687,3,8,"RECORTES CE",0
39,"39093",302,256,256,2,0,"RECORTES CE",1
32,"32066",551,399,396,1,3,"RECORTES CE",0
50,"50903",2238,1750,1732,11,18,"RECORTES CE",4
44,"44100",175,142,141,2,1,"RECORTES CE",0
41,"41051",2311,1770,1734,5,36,"RECORTES CE",0
8,"8204",3115,2548,2534,22,14,"RECORTES CE",3
3,"3073",222,200,196,3,4,"RECORTES CE",0
50,"50229",65,57,56,0,1,"RECORTES CE",7
43,"43040",326,278,276,0,2,"RECORTES CE",2
15,"15010",1819,1194,1181,16,13,"RECORTES CE",3
39,"39094",841,676,670,3,6,"RECORTES CE",0
10,"10189",2527,1958,1907,12,51,"RECORTES CE",4
31,"31004",32,26,26,0,0,"RECORTES CE",0
46,"46248",4886,3672,3613,25,59,"RECORTES CE",4
35,"35008",6207,4733,4654,42,79,"RECORTES CE",14
3,"3074",1750,1433,1427,3,6,"RECORTES CE",0
22,"22903",622,538,533,3,5,"RECORTES CE",0
31,"31126",351,255,254,2,1,"RECORTES CE",0
7,"7040",288348,192799,191053,1586,1746,"RECORTES CE",482
4,"4030",1066,783,776,5,7,"RECORTES CE",0
46,"46249",9159,7113,7012,73,101,"RECORTES CE",10
43,"43041",228,179,177,3,2,"RECORTES CE",0
44,"44194",104,80,80,1,0,"RECORTES CE",0
52,"52001",54124,34068,33749,237,319,"RECORTES CE",99
3,"3075",149,125,125,0,0,"RECORTES CE",0
32,"32068",1419,998,987,4,11,"RECORTES CE",0
10,"10191",523,406,398,3,8,"RECORTES CE",0
35,"35009",20109,15017,14803,78,214,"RECORTES CE",21
48,"48907",340,283,281,1,2,"RECORTES CE",0
26,"26138",4545,3433,3374,27,59,"RECORTES CE",3
10,"10069",785,609,596,2,13,"RECORTES CE",4
50,"50231",257,210,207,3,3,"RECORTES CE",0
33,"33065",1084,761,746,18,15,"RECORTES CE",4
4,"4032",5698,4168,4138,20,30,"RECORTES CE",1
26,"26023",435,351,347,5,4,"RECORTES CE",0
46,"46068",345,308,307,4,1,"RECORTES CE",1
48,"48014",1242,915,910,4,5,"RECORTES CE",2
26,"26139",55,43,43,0,0,"RECORTES CE",0
33,"33066",42882,30942,30529,401,413,"RECORTES CE",41
26,"26024",210,171,169,1,2,"RECORTES CE",0
22,"22018",308,234,232,2,2,"RECORTES CE",0
31,"31048",160,133,132,2,1,"RECORTES CE",0
31,"31007",126,101,95,3,6,"RECORTES CE",1
21,"21027",50,40,39,0,1,"RECORTES CE",0
43,"43042",2198,1820,1816,8,4,"RECORTES CE",2
50,"50232",160,116,114,2,2,"RECORTES CE",0
43,"43043",3289,2624,2613,14,11,"RECORTES CE",3
4,"4033",125,98,95,0,3,"RECORTES CE",0
8,"8207",2014,1736,1730,9,6,"RECORTES CE",3
22,"22906",174,137,134,5,3,"RECORTES CE",1
3,"3077",1374,1131,1114,9,17,"RECORTES CE",0
32,"32070",512,307,304,8,3,"RECORTES CE",1
6,"6009",228,190,187,2,3,"RECORTES CE",0
50,"50233",104,82,82,0,0,"RECORTES CE",0
8,"8208",5760,4660,4643,25,17,"RECORTES CE",7
41,"41055",14804,10863,10720,79,143,"RECORTES CE",6
4,"4034",165,107,106,1,1,"RECORTES CE",0
43,"43117",143,114,113,0,1,"RECORTES CE",0
8,"8286",2919,2210,2199,15,11,"RECORTES CE",1
25,"25193",767,614,606,6,8,"RECORTES CE",0
39,"39098",1379,1154,1144,7,10,"RECORTES CE",1
4,"4035",8433,6246,6196,33,50,"RECORTES CE",5
26,"26026",1265,1061,1049,2,12,"RECORTES CE",0
43,"43044",3949,3060,3032,31,28,"RECORTES CE",5
3,"3078",474,372,371,2,1,"RECORTES CE",0
26,"26027",143,101,98,1,3,"RECORTES CE",0
31,"31010",5728,4211,4153,30,58,"RECORTES CE",11
25,"25031",57,39,39,0,0,"RECORTES CE",0
31,"31132",148,121,121,2,0,"RECORTES CE",0
48,"48017",13150,9546,9504,38,42,"RECORTES CE",11
8,"8209",6896,5269,5244,25,25,"RECORTES CE",7
50,"50234",242,194,187,3,7,"RECORTES CE",0
44,"44106",153,115,111,2,4,"RECORTES CE",0
39,"39099",3149,2562,2540,22,22,"RECORTES CE",0
3,"3079",18403,14632,14382,114,250,"RECORTES CE",21
48,"48018",867,605,603,3,2,"RECORTES CE",0
7,"7045",1300,1038,1030,6,8,"RECORTES CE",2
41,"41057",253,189,188,0,1,"RECORTES CE",0
14,"14002",10859,8215,8078,93,137,"RECORTES CE",5
32,"32072",3687,2715,2682,22,33,"RECORTES CE",2
31,"31012",771,571,564,5,7,"RECORTES CE",2
20,"20902",14229,10567,10495,53,72,"RECORTES CE",21
50,"50235",2412,1826,1807,22,19,"RECORTES CE",4
26,"26065",58,49,47,0,2,"RECORTES CE",1
43,"43045",146,128,127,0,1,"RECORTES CE",0
8,"8288",1676,1196,1182,6,14,"RECORTES CE",0
8,"8210",4584,3455,3435,23,20,"RECORTES CE",2
31,"31013",626,427,422,5,5,"RECORTES CE",3
44,"44200",39,25,25,0,0,"RECORTES CE",0
10,"10199",159,123,123,1,0,"RECORTES CE",0
15,"15017",19860,14930,14706,204,224,"RECORTES CE",27
50,"50264",147,122,120,0,2,"RECORTES CE",0
31,"31135",112,76,75,2,1,"RECORTES CE",0
39,"39101",236,173,171,1,2,"RECORTES CE",2
17,"17181",3467,2664,2648,10,16,"RECORTES CE",5
44,"44009",799,621,611,7,10,"RECORTES CE",1
50,"50236",101,82,80,1,2,"RECORTES CE",0
32,"32074",993,737,734,4,3,"RECORTES CE",1
48,"48913",1224,977,967,6,10,"RECORTES CE",1
50,"50237",102,81,81,3,0,"RECORTES CE",0
14,"14004",1981,1522,1509,8,13,"RECORTES CE",4
31,"31014",266,195,195,4,0,"RECORTES CE",0
43,"43047",4209,2878,2856,23,22,"RECORTES CE",4
41,"41059",35105,27781,27472,261,309,"RECORTES CE",41
10,"10079",858,694,684,1,10,"RECORTES CE",1
33,"33011",10659,6448,6332,119,116,"RECORTES CE",3
3,"3082",12936,9025,8931,57,94,"RECORTES CE",19
17,"17001",580,459,454,3,5,"RECORTES CE",0
17,"17182",272,220,220,3,0,"RECORTES CE",0
39,"39102",2255,1711,1698,11,13,"RECORTES CE",1
31,"31015",1990,1533,1508,17,25,"RECORTES CE",4
22,"22025",1035,764,755,24,9,"RECORTES CE",0
39,"39018",4272,3533,3476,17,57,"RECORTES CE",4
8,"8212",491,406,402,1,4,"RECORTES CE",0
33,"33073",8186,5090,5023,65,67,"RECORTES CE",4
15,"15019",26006,18323,18075,280,248,"RECORTES CE",42
25,"25100",184,145,144,1,1,"RECORTES CE",0
8,"8054",9155,7468,7428,43,40,"RECORTES CE",13
31,"31260",1249,904,901,15,3,"RECORTES CE",4
15,"15020",3593,2491,2469,18,22,"RECORTES CE",3
26,"26033",163,143,142,3,1,"RECORTES CE",1
17,"17183",255,216,216,0,0,"RECORTES CE",0
8,"8213",6547,5270,5245,23,25,"RECORTES CE",4
17,"17002",564,491,488,3,3,"RECORTES CE",1
43,"43048",763,614,609,7,5,"RECORTES CE",2
50,"50239",63,47,47,0,0,"RECORTES CE",0
10,"10082",1810,1495,1476,9,19,"RECORTES CE",1
14,"14006",1321,1155,1127,4,28,"RECORTES CE",0
48,"48022",2316,1645,1631,11,14,"RECORTES CE",0
6,"6116",1512,1158,1144,3,14,"RECORTES CE",1
33,"33013",429,320,316,1,4,"RECORTES CE",0
10,"10204",419,342,339,4,3,"RECORTES CE",0
8,"8240",9453,7807,7776,21,31,"RECORTES CE",3
3,"3085",269,243,237,0,6,"RECORTES CE",0
14,"14007",15042,10970,10758,86,212,"RECORTES CE",16
43,"43049",727,589,584,2,5,"RECORTES CE",1
31,"31018",422,317,312,4,5,"RECORTES CE",2
4,"4046",848,653,649,5,4,"RECORTES CE",0
17,"17003",102,75,75,0,0,"RECORTES CE",0
31,"31262",234,201,199,2,2,"RECORTES CE",2
26,"26071",8662,6409,6288,52,121,"RECORTES CE",13
10,"10083",96,74,73,0,1,"RECORTES CE",0
14,"14038",32692,24015,23679,213,336,"RECORTES CE",32
35,"35019",32841,21136,20850,125,286,"RECORTES CE",33
31,"31019",1808,1392,1378,18,14,"RECORTES CE",8
8,"8215",2589,2044,2034,19,10,"RECORTES CE",3
21,"21001",610,480,461,3,19,"RECORTES CE",1
31,"31264",177,107,105,2,2,"RECORTES CE",1
14,"14008",2785,1942,1910,15,32,"RECORTES CE",3
7,"7052",4816,3276,3258,39,18,"RECORTES CE",9
3,"3086",166,143,143,1,0,"RECORTES CE",0
21,"21002",15922,11918,11773,119,145,"RECORTES CE",24
31,"31020",433,273,272,1,1,"RECORTES CE",1
32,"32078",1108,794,781,15,13,"RECORTES CE",0
33,"33015",1428,1003,993,7,10,"RECORTES CE",0
14,"14009",2669,1863,1844,19,19,"RECORTES CE",0
50,"50241",595,434,423,3,11,"RECORTES CE",2
22,"22032",107,74,74,2,0,"RECORTES CE",0
44,"44113",72,51,50,0,1,"RECORTES CE",0
32,"32079",1287,1016,1006,6,10,"RECORTES CE",3
3,"3088",5810,4380,4313,31,67,"RECORTES CE",3
48,"48025",860,694,694,3,0,"RECORTES CE",1
25,"25103",136,103,102,2,1,"RECORTES CE",0
15,"15023",6318,4501,4436,40,65,"RECORTES CE",6
27,"27007",2756,2148,2084,29,64,"RECORTES CE",0
23,"23007",3026,2317,2301,13,16,"RECORTES CE",1
33,"33077",1118,772,761,4,11,"RECORTES CE",0
50,"50242",93,72,70,0,2,"RECORTES CE",0
44,"44016",436,334,331,1,3,"RECORTES CE",0
14,"14010",4001,3106,3068,15,38,"RECORTES CE",3
21,"21004",1593,1114,1085,16,29,"RECORTES CE",2
22,"22035",226,174,174,0,0,"RECORTES CE",0
3,"3089",9497,6952,6794,55,158,"RECORTES CE",9
26,"26038",81,61,61,0,0,"RECORTES CE",0
48,"48026",1139,920,913,4,7,"RECORTES CE",2
31,"31902",4649,3620,3598,34,22,"RECORTES CE",17
50,"50243",311,252,247,1,5,"RECORTES CE",0
7,"7055",7897,5264,5176,47,88,"RECORTES CE",9
31,"31023",7609,6371,6319,70,52,"RECORTES CE",25
23,"23009",12808,10348,10233,66,115,"RECORTES CE",8
26,"26039",38,34,34,0,0,"RECORTES CE",0
10,"10210",492,362,358,3,4,"RECORTES CE",1
14,"14011",572,498,495,5,3,"RECORTES CE",0
17,"17096",164,113,113,1,0,"RECORTES CE",0
43,"43052",934,765,756,2,9,"RECORTES CE",0
31,"31024",99,54,54,1,0,"RECORTES CE",0
6,"6121",3268,2558,2531,26,27,"RECORTES CE",3
3,"3090",17881,13593,13437,108,156,"RECORTES CE",11
48,"48027",22668,17326,17224,95,102,"RECORTES CE",22
10,"10089",1328,1014,982,20,32,"RECORTES CE",0
23,"23010",14241,10186,10015,68,171,"RECORTES CE",14
50,"50272",13174,10143,10042,103,101,"RECORTES CE",21
6,"6155",1825,1316,1292,21,24,"RECORTES CE",3
7,"7056",5245,3883,3841,32,42,"RECORTES CE",11
50,"50244",191,153,150,1,3,"RECORTES CE",1
31,"31025",763,562,557,6,5,"RECORTES CE",0
35,"35023",11694,8785,8607,67,178,"RECORTES CE",16
22,"22037",112,96,96,0,0,"RECORTES CE",0
17,"17189",1476,1278,1275,2,3,"RECORTES CE",1
4,"4052",12767,9352,9269,90,83,"RECORTES CE",10
26,"26041",114,84,84,0,0,"RECORTES CE",0
23,"23011",2134,1649,1614,11,35,"RECORTES CE",2
33,"33020",13000,9476,9338,108,138,"RECORTES CE",22
21,"21007",6318,4614,4524,50,90,"RECORTES CE",57
50,"50273",32,24,24,0,0,"RECORTES CE",0
41,"41067",7227,5367,5271,56,96,"RECORTES CE",4
15,"15028",1393,1076,1063,8,13,"RECORTES CE",1
8,"8219",15629,12910,12865,58,45,"RECORTES CE",18
10,"10213",534,447,441,5,6,"RECORTES CE",1
17,"17190",838,681,677,0,4,"RECORTES CE",0
31,"31027",814,623,610,8,13,"RECORTES CE",1
21,"21008",2613,1803,1777,6,26,"RECORTES CE",2
25,"25011",5260,3908,3871,30,37,"RECORTES CE",6
31,"31149",2271,1645,1628,9,17,"RECORTES CE",0
26,"26160",732,578,574,4,4,"RECORTES CE",0
32,"32083",821,592,587,7,5,"RECORTES CE",0
15,"15029",5403,3682,3622,62,60,"RECORTES CE",0
14,"14014",2509,2071,2030,7,41,"RECORTES CE",0
6,"6124",1656,1323,1296,5,27,"RECORTES CE",1
48,"48030",601,490,489,0,1,"RECORTES CE",0
50,"50246",38,28,28,0,0,"RECORTES CE",0
44,"44118",158,126,122,1,4,"RECORTES CE",0
21,"21009",835,575,557,0,18,"RECORTES CE",3
31,"31028",220,147,147,0,0,"RECORTES CE",0
3,"3093",19713,15195,14988,108,207,"RECORTES CE",18
26,"26044",51,44,42,0,2,"RECORTES CE",0
25,"25012",2342,1748,1739,10,9,"RECORTES CE",2
7,"7060",2665,1976,1964,14,12,"RECORTES CE",4
41,"41069",29569,21075,20657,361,418,"RECORTES CE",51
3,"3125",336,259,257,1,2,"RECORTES CE",1
14,"14015",2067,1575,1551,16,24,"RECORTES CE",1
6,"6026",815,661,653,5,8,"RECORTES CE",0
50,"50275",110,55,55,0,0,"RECORTES CE",0
22,"22041",152,121,119,2,2,"RECORTES CE",0
31,"31029",916,661,647,7,14,"RECORTES CE",5
44,"44119",119,83,82,0,1,"RECORTES CE",0
31,"31030",135,105,105,3,0,"RECORTES CE",1
8,"8299",377,318,317,0,1,"RECORTES CE",0
21,"21011",3473,2543,2513,14,30,"RECORTES CE",1
14,"14016",1283,1005,994,4,11,"RECORTES CE",0
22,"22042",117,96,95,1,1,"RECORTES CE",0
44,"44213",65,46,46,0,0,"RECORTES CE",0
25,"25014",249,203,200,2,3,"RECORTES CE",0
3,"3095",4740,3702,3657,23,45,"RECORTES CE",5
41,"41070",6397,4987,4921,55,66,"RECORTES CE",4
44,"44120",219,158,152,1,6,"RECORTES CE",0
11,"11030",22973,16087,15853,165,234,"RECORTES CE",38
41,"41071",5598,3993,3915,34,78,"RECORTES CE",4
46,"46250",581614,454786,451184,2675,3602,"RECORTES CE",696
23,"23016",384,316,311,0,5,"RECORTES CE",0
17,"17012",1171,916,914,10,2,"RECORTES CE",3
22,"22165",452,360,356,1,4,"RECORTES CE",0
14,"14017",10945,8514,8386,90,128,"RECORTES CE",7
27,"27015",4020,2809,2730,33,79,"RECORTES CE",4
31,"31153",2173,1591,1580,10,11,"RECORTES CE",2
3,"3096",5779,4433,4352,30,81,"RECORTES CE",12
31,"31032",1678,1285,1269,25,16,"RECORTES CE",1
43,"43057",38,31,31,1,0,"RECORTES CE",0
25,"25015",335,262,260,8,2,"RECORTES CE",1
6,"6161",288,226,222,1,4,"RECORTES CE",0
43,"43058",96,77,77,0,0,"RECORTES CE",0
23,"23017",1480,1227,1202,6,25,"RECORTES CE",0
35,"35028",10044,6188,6105,52,83,"RECORTES CE",11
43,"43132",363,292,291,2,1,"RECORTES CE",0
3,"3129",1218,994,982,5,12,"RECORTES CE",0
48,"48064",613,494,492,1,2,"RECORTES CE",1
44,"44024",28,25,24,0,1,"RECORTES CE",0
48,"48034",12639,9519,9443,77,76,"RECORTES CE",20
10,"10901",1177,818,805,1,13,"RECORTES CE",1
31,"31034",31,27,26,0,1,"RECORTES CE",0
25,"25249",176,139,138,1,1,"RECORTES CE",0
39,"39059",7577,5978,5916,47,62,"RECORTES CE",2
46,"46252",128,106,106,2,0,"RECORTES CE",0
6,"6129",573,455,451,2,4,"RECORTES CE",0
25,"25016",2083,1590,1587,8,3,"RECORTES CE",2
14,"14019",6408,5163,5086,58,77,"RECORTES CE",8
21,"21015",654,363,359,8,4,"RECORTES CE",2
22,"22168",23,21,20,0,1,"RECORTES CE",0
48,"48065",3303,2541,2524,15,17,"RECORTES CE",5
43,"43059",250,214,214,1,0,"RECORTES CE",0
32,"32088",1610,1040,1019,11,21,"RECORTES CE",2
35,"35030",9949,6611,6462,65,149,"RECORTES CE",15
3,"3098",518,412,400,1,12,"RECORTES CE",0
26,"26049",153,115,115,1,0,"RECORTES CE",0
44,"44217",31,25,25,0,0,"RECORTES CE",0
14,"14050",2352,1840,1801,11,39,"RECORTES CE",4
50,"50252",5057,3661,3613,36,48,"RECORTES CE",1
25,"25118",327,241,239,2,2,"RECORTES CE",0
10,"10018",1630,1149,1112,12,37,"RECORTES CE",1
21,"21052",4429,2951,2891,19,60,"RECORTES CE",5
14,"14020",338,240,233,2,7,"RECORTES CE",0
6,"6131",1063,880,874,5,6,"RECORTES CE",1
17,"17044",6930,5514,5493,26,21,"RECORTES CE",10
48,"48036",24038,18180,18050,94,130,"RECORTES CE",28
8,"8225",94,81,81,1,0,"RECORTES CE",0
44,"44124",73,58,57,0,1,"RECORTES CE",0
46,"46254",943,751,734,4,17,"RECORTES CE",6
25,"25019",4646,3224,3199,22,25,"RECORTES CE",4
31,"31158",248,182,177,2,5,"RECORTES CE",0
43,"43060",2684,2158,2152,8,6,"RECORTES CE",0
21,"21017",2325,1450,1419,22,31,"RECORTES CE",4
3,"3100",496,402,395,2,7,"RECORTES CE",0
6,"6132",829,598,593,0,5,"RECORTES CE",0
26,"26169",68,61,61,2,0,"RECORTES CE",0
14,"14021",260397,195951,193914,2025,2037,"RECORTES CE",378
50,"50253",382,318,315,2,3,"RECORTES CE",0
31,"31078",2419,1924,1899,18,25,"RECORTES CE",7
43,"43061",38,28,28,0,0,"RECORTES CE",0
26,"26052",148,113,113,1,0,"RECORTES CE",0
17,"17018",494,405,402,1,3,"RECORTES CE",0
31,"31038",1336,992,981,8,11,"RECORTES CE",3
46,"46255",3209,2415,2381,18,34,"RECORTES CE",1
3,"3101",4911,3827,3772,20,55,"RECORTES CE",2
25,"25218",86,79,79,0,0,"RECORTES CE",0
14,"14022",3886,3080,3043,18,37,"RECORTES CE",2
35,"35032",3348,2585,2542,20,43,"RECORTES CE",1
48,"48038",1158,891,891,2,0,"RECORTES CE",0
26,"26170",427,343,338,2,5,"RECORTES CE",0
10,"10184",740,607,597,5,10,"RECORTES CE",0
31,"31120",383,264,260,3,4,"RECORTES CE",0
46,"46256",7211,5263,5209,27,54,"RECORTES CE",7
32,"32091",1703,1312,1306,4,6,"RECORTES CE",1
10,"10022",412,319,316,1,3,"RECORTES CE",0
17,"17048",6251,4565,4537,20,28,"RECORTES CE",4
14,"14053",5925,4442,4348,75,94,"RECORTES CE",6
8,"8228",288,239,239,2,0,"RECORTES CE",0
50,"50255",197,162,160,2,2,"RECORTES CE",1
46,"46002",1215,963,959,5,4,"RECORTES CE",0
8,"8001",9079,7383,7341,40,42,"RECORTES CE",20
25,"25021",2541,1891,1882,14,9,"RECORTES CE",1
21,"21020",353,242,236,3,6,"RECORTES CE",0
3,"3102",7226,5600,5516,28,84,"RECORTES CE",11
11,"11002",4200,3287,3257,5,30,"RECORTES CE",0
46,"46257",5428,4237,4190,23,47,"RECORTES CE",4
39,"39036",971,794,787,5,7,"RECORTES CE",0
8,"8002",220,184,183,2,1,"RECORTES CE",0
44,"44029",579,466,457,3,9,"RECORTES CE",0
23,"23025",2727,2125,2090,8,35,"RECORTES CE",0
8,"8307",49310,38223,38022,162,201,"RECORTES CE",64
46,"46003",953,828,811,5,17,"RECORTES CE",0
48,"48040",1309,979,973,5,6,"RECORTES CE",0
6,"6036",4958,3785,3728,22,57,"RECORTES CE",3
43,"43063",536,401,397,1,4,"RECORTES CE",1
3,"3103",245,212,211,4,1,"RECORTES CE",0
43,"43137",1905,1515,1499,15,16,"RECORTES CE",3
8,"8229",521,435,433,3,2,"RECORTES CE",0
8,"8003",7183,5761,5742,39,19,"RECORTES CE",3
14,"14025",2857,2482,2436,14,46,"RECORTES CE",2
33,"33002",9474,6779,6662,74,117,"RECORTES CE",5
3,"3104",27091,21366,21119,250,247,"RECORTES CE",44
31,"31043",32,24,24,0,0,"RECORTES CE",0
50,"50257",163,136,134,1,2,"RECORTES CE",0
17,"17021",122,98,98,0,0,"RECORTES CE",0
8,"8230",7666,6202,6168,30,34,"RECORTES CE",8
48,"48041",686,581,579,2,2,"RECORTES CE",0
31,"31165",2763,2121,2091,21,30,"RECORTES CE",8
44,"44223",73,58,58,0,0,"RECORTES CE",0
44,"44032",17,13,13,0,0,"RECORTES CE",0
36,"36002",3076,2225,2185,19,40,"RECORTES CE",5
3,"3105",5471,4099,4003,14,96,"RECORTES CE",6
6,"6038",790,583,574,4,9,"RECORTES CE",1
25,"25024",352,273,272,0,1,"RECORTES CE",0
14,"14026",2014,1502,1474,10,28,"RECORTES CE",0
26,"26057",51,47,47,1,0,"RECORTES CE",0
31,"31044",294,243,242,5,1,"RECORTES CE",0
48,"48042",1365,1136,1130,7,6,"RECORTES CE",1
26,"26058",143,116,115,2,1,"RECORTES CE",0
46,"46260",2647,2136,2113,8,23,"RECORTES CE",2
33,"33003",612,373,369,6,4,"RECORTES CE",1
21,"21024",466,355,341,4,14,"RECORTES CE",0
8,"8231",21132,15940,15880,75,60,"RECORTES CE",21
11,"11006",24522,16656,16392,220,264,"RECORTES CE",28
8,"8005",6380,5122,5106,18,16,"RECORTES CE",5
41,"41080",1240,940,913,11,27,"RECORTES CE",0
25,"25025",1378,996,983,8,13,"RECORTES CE",1
31,"31045",509,395,390,5,5,"RECORTES CE",1
33,"33004",65515,48686,48245,511,441,"RECORTES CE",102
44,"44130",27,24,24,0,0,"RECORTES CE",0
4,"4070",1545,1192,1182,7,10,"RECORTES CE",1
46,"46261",1709,1367,1340,14,27,"RECORTES CE",2
11,"11007",18020,11346,11152,176,194,"RECORTES CE",29
39,"39039",546,431,428,0,3,"RECORTES CE",0
6,"6040",987,747,739,6,8,"RECORTES CE",0
31,"31168",241,203,199,2,4,"RECORTES CE",2
15,"15043",4978,3631,3572,39,59,"RECORTES CE",4
43,"43066",155,121,121,1,0,"RECORTES CE",0
8,"8006",11774,9039,8981,33,58,"RECORTES CE",10
36,"36004",10123,7396,7273,93,123,"RECORTES CE",16
25,"25027",977,765,763,4,2,"RECORTES CE",0
14,"14028",307,258,257,0,1,"RECORTES CE",0
48,"48044",62054,49055,48840,373,215,"RECORTES CE",90
3,"3107",2769,2011,1986,10,25,"RECORTES CE",4
43,"43140",2438,1847,1837,16,10,"RECORTES CE",1
21,"21026",253,189,183,1,6,"RECORTES CE",1
33,"33036",11335,8356,8243,92,113,"RECORTES CE",8
50,"50260",32,28,28,0,0,"RECORTES CE",0
26,"26178",71,57,56,1,1,"RECORTES CE",0
44,"44164",20,18,18,0,0,"RECORTES CE",0
38,"38007",1625,1124,1104,2,20,"RECORTES CE",2
3,"3109",2976,2375,2345,11,30,"RECORTES CE",2
43,"43067",528,450,445,1,5,"RECORTES CE",0
44,"44132",58,47,47,0,0,"RECORTES CE",0
50,"50261",205,171,167,1,4,"RECORTES CE",0
25,"25029",1607,1270,1265,6,5,"RECORTES CE",1
8,"8233",1846,1485,1478,8,7,"RECORTES CE",0
10,"10113",2258,1695,1657,6,38,"RECORTES CE",4
48,"48046",12644,9809,9744,46,65,"RECORTES CE",10
26,"26179",41,33,32,0,1,"RECORTES CE",0
44,"44103",123,101,100,1,1,"RECORTES CE",0
11,"11010",6351,4472,4385,140,87,"RECORTES CE",9
41,"41083",1128,865,859,6,6,"RECORTES CE",0
8,"8234",3373,2742,2734,25,8,"RECORTES CE",3
14,"14030",7797,6116,6036,54,80,"RECORTES CE",12
25,"25030",123,90,90,1,0,"RECORTES CE",0
44,"44133",15,12,12,0,0,"RECORTES CE",0
3,"3110",312,271,269,1,2,"RECORTES CE",1
48,"48047",149,115,115,1,0,"RECORTES CE",0
17,"17026",543,450,449,4,1,"RECORTES CE",0
43,"43093",3884,2956,2933,14,23,"RECORTES CE",4
43,"43068",483,367,365,5,2,"RECORTES CE",0
26,"26180",223,182,177,3,5,"RECORTES CE",0
21,"21029",1509,1183,1160,14,23,"RECORTES CE",4
14,"14031",566,453,446,2,7,"RECORTES CE",0
3,"3902",10578,7654,7530,56,124,"RECORTES CE",11
44,"44135",102,85,85,0,0,"RECORTES CE",0
31,"31051",234,183,182,2,1,"RECORTES CE",1
17,"17207",2411,2006,1992,8,14,"RECORTES CE",3
3,"3111",5565,4183,4149,29,34,"RECORTES CE",2
50,"50263",176,119,116,0,3,"RECORTES CE",2
23,"23033",1319,1076,1057,8,19,"RECORTES CE",2
43,"43069",178,146,146,0,0,"RECORTES CE",0
33,"33008",1705,1285,1273,9,12,"RECORTES CE",0
31,"31052",103,79,78,0,1,"RECORTES CE",0
6,"6045",476,368,362,3,6,"RECORTES CE",1
36,"36008",21884,16428,16170,165,258,"RECORTES CE",35
38,"38010",3974,2814,2777,20,37,"RECORTES CE",3
14,"14032",393,328,321,2,7,"RECORTES CE",0
3,"3112",637,526,520,0,6,"RECORTES CE",2
43,"43143",51,45,44,0,1,"RECORTES CE",0
46,"46904",805,643,628,13,15,"RECORTES CE",1
8,"8262",6919,5090,5060,33,30,"RECORTES CE",4
11,"11013",2332,1747,1713,16,34,"RECORTES CE",1
33,"33009",869,595,591,5,4,"RECORTES CE",2
38,"38011",21563,15380,15214,69,166,"RECORTES CE",40
22,"22060",1172,906,901,13,5,"RECORTES CE",4
12,"12068",41,26,25,1,1,"RECORTES CE",0
44,"44038",98,83,80,0,3,"RECORTES CE",0
8,"8010",4207,3327,3304,13,23,"RECORTES CE",6
48,"48049",545,448,448,0,0,"RECORTES CE",1
50,"50292",129,113,113,1,0,"RECORTES CE",0
3,"3113",4342,3194,3154,23,40,"RECORTES CE",3
41,"41086",16209,11006,10881,116,125,"RECORTES CE",16
18,"18003",14413,11095,10883,92,212,"RECORTES CE",14
6,"6046",1250,1010,995,7,15,"RECORTES CE",0
8,"8237",1662,1334,1327,7,7,"RECORTES CE",2
33,"33010",1724,1211,1202,15,9,"RECORTES CE",0
22,"22189",178,143,143,0,0,"RECORTES CE",1
26,"26067",20,19,19,0,0,"RECORTES CE",0
44,"44137",188,148,146,0,2,"RECORTES CE",0
17,"17029",199,160,157,1,3,"RECORTES CE",0
11,"11015",64073,43152,42713,710,439,"RECORTES CE",89
46,"46014",3130,2488,2462,7,26,"RECORTES CE",3
10,"10120",156,110,108,0,2,"RECORTES CE",1
21,"21070",6222,4413,4322,47,91,"RECORTES CE",6
50,"50005",239,204,201,2,3,"RECORTES CE",0
17,"17210",580,449,445,2,4,"RECORTES CE",0
14,"14034",304,246,239,1,7,"RECORTES CE",0
8,"8238",14851,12472,12428,50,44,"RECORTES CE",18
25,"25034",2288,1733,1719,9,14,"RECORTES CE",1
31,"31177",251,172,168,1,4,"RECORTES CE",2
44,"44232",368,284,273,2,11,"RECORTES CE",0
8,"8012",1721,1340,1331,8,9,"RECORTES CE",1
3,"3115",255,222,221,2,1,"RECORTES CE",0
25,"25132",143,118,118,0,0,"RECORTES CE",0
11,"11017",3194,2265,2221,38,44,"RECORTES CE",2
17,"17211",831,694,691,1,3,"RECORTES CE",0
23,"23038",3785,3182,3162,16,20,"RECORTES CE",4
33,"33012",5105,3601,3566,46,35,"RECORTES CE",7
31,"31057",1741,1365,1344,12,21,"RECORTES CE",3
50,"50006",908,705,689,3,16,"RECORTES CE",1
8,"8239",460,380,378,2,2,"RECORTES CE",0
41,"41005",9250,6925,6809,69,116,"RECORTES CE",9
50,"50267",573,440,434,7,6,"RECORTES CE",2
3,"3116",1159,901,884,3,17,"RECORTES CE",3
43,"43072",93,74,74,0,0,"RECORTES CE",0
38,"38014",1341,991,981,6,10,"RECORTES CE",0
36,"36014",1872,1373,1345,14,28,"RECORTES CE",4
39,"39048",1765,1429,1420,4,9,"RECORTES CE",4
21,"21036",203,147,143,0,4,"RECORTES CE",1
41,"41089",6629,4904,4814,48,90,"RECORTES CE",5
6,"6083",46489,34360,33989,270,371,"RECORTES CE",43
48,"48053",904,738,728,5,10,"RECORTES CE",2
15,"15052",4104,2928,2878,30,50,"RECORTES CE",5
38,"38015",4067,2951,2926,22,25,"RECORTES CE",0
43,"43147",521,446,442,4,4,"RECORTES CE",0
33,"33014",8771,6425,6368,51,57,"RECORTES CE",13
32,"32021",874,616,615,4,1,"RECORTES CE",0
25,"25036",184,144,143,0,1,"RECORTES CE",0
43,"43073",84,68,67,0,1,"RECORTES CE",0
31,"31059",183,145,143,0,2,"RECORTES CE",0
32,"32077",1104,820,815,10,5,"RECORTES CE",1
50,"50268",42,33,32,1,1,"RECORTES CE",0
15,"15084",3059,2236,2217,20,19,"RECORTES CE",2
46,"46017",32990,23940,23694,155,246,"RECORTES CE",31
31,"31060",14185,10582,10485,103,97,"RECORTES CE",53
26,"26072",285,252,247,1,5,"RECORTES CE",1
8,"8241",69,56,56,0,0,"RECORTES CE",0
44,"44143",394,327,327,2,0,"RECORTES CE",0
3,"3118",2426,1741,1718,8,23,"RECORTES CE",2
43,"43074",1812,1419,1412,4,7,"RECORTES CE",0
10,"10002",359,284,279,2,5,"RECORTES CE",0
31,"31182",30,28,28,1,0,"RECORTES CE",1
21,"21038",1076,786,771,8,15,"RECORTES CE",0
50,"50269",279,189,186,1,3,"RECORTES CE",0
23,"23072",1885,1485,1468,5,17,"RECORTES CE",1
8,"8015",156003,117736,117183,704,553,"RECORTES CE",231
21,"21039",299,226,223,7,3,"RECORTES CE",0
4,"4084",341,258,255,0,3,"RECORTES CE",0
44,"44144",325,249,247,1,2,"RECORTES CE",0
29,"29015",32064,23769,23461,213,308,"RECORTES CE",44
26,"26073",94,72,68,0,4,"RECORTES CE",0
46,"46018",567,483,479,3,4,"RECORTES CE",0
4,"4085",371,305,303,2,2,"RECORTES CE",0
3,"3119",17223,13244,13116,75,128,"RECORTES CE",29
14,"14070",1284,988,969,5,19,"RECORTES CE",1
31,"31225",35,29,29,1,0,"RECORTES CE",0
43,"43075",86,71,69,0,2,"RECORTES CE",0
6,"6086",1174,869,862,4,7,"RECORTES CE",1
50,"50010",66,56,55,2,1,"RECORTES CE",1
11,"11022",48682,28113,27794,294,319,"RECORTES CE",76
8,"8242",222,180,180,0,0,"RECORTES CE",0
14,"14040",3755,3047,3006,21,41,"RECORTES CE",0
25,"25039",261,216,216,1,0,"RECORTES CE",0
43,"43076",460,378,377,2,1,"RECORTES CE",1
44,"44145",972,741,732,11,9,"RECORTES CE",0
31,"31063",83,63,60,2,3,"RECORTES CE",0
6,"6054",5454,4329,4190,46,139,"RECORTES CE",4
21,"21041",112810,77371,76488,900,883,"RECORTES CE",241
11,"11023",9372,7032,6950,94,82,"RECORTES CE",6
29,"29050",398,274,269,2,5,"RECORTES CE",1
23,"23043",518,398,397,0,1,"RECORTES CE",0
10,"10128",5628,4238,4126,43,112,"RECORTES CE",5
14,"14041",3115,2449,2376,45,73,"RECORTES CE",3
50,"50271",248,197,189,2,8,"RECORTES CE",1
3,"3121",21787,15670,15453,81,217,"RECORTES CE",13
31,"31064",1387,1174,1163,9,11,"RECORTES CE",1
4,"4087",156,117,116,1,1,"RECORTES CE",0
50,"50096",36,22,22,0,0,"RECORTES CE",0
10,"10007",630,513,507,4,6,"RECORTES CE",0
10,"10129",348,263,250,0,13,"RECORTES CE",0
33,"33019",2882,1981,1939,8,42,"RECORTES CE",1
8,"8017",2827,2192,2182,16,10,"RECORTES CE",4
50,"50040",86,71,71,0,0,"RECORTES CE",0
14,"14042",18727,15069,14837,201,232,"RECORTES CE",25
22,"22072",194,141,140,0,1,"RECORTES CE",0
3,"3122",43704,31952,31681,218,271,"RECORTES CE",72
23,"23045",2057,1519,1507,7,12,"RECORTES CE",1
26,"26077",17,17,17,0,0,"RECORTES CE",0
48,"48059",400,329,325,0,4,"RECORTES CE",2
31,"31066",812,636,628,10,8,"RECORTES CE",2
25,"25041",528,399,396,4,3,"RECORTES CE",1
10,"10171",355,261,255,0,6,"RECORTES CE",0
29,"29019",864,687,679,7,8,"RECORTES CE",0
46,"46052",508,436,426,3,10,"RECORTES CE",0
46,"46022",15325,11197,11072,70,125,"RECORTES CE",18
25,"25042",208,160,160,1,0,"RECORTES CE",0
3,"3123",7576,5900,5814,36,86,"RECORTES CE",9
11,"11026",4695,3656,3564,18,92,"RECORTES CE",12
36,"36021",12099,9105,8974,85,131,"RECORTES CE",21
30,"30004",1126,884,876,5,8,"RECORTES CE",0
10,"10132",365,276,271,2,5,"RECORTES CE",0
26,"26078",86,71,70,1,1,"RECORTES CE",0
17,"17218",570,468,465,5,3,"RECORTES CE",1
50,"50013",200,166,166,3,0,"RECORTES CE",0
10,"10050",1015,831,823,2,8,"RECORTES CE",0
14,"14044",1620,1279,1264,12,15,"RECORTES CE",2
48,"48060",3620,2615,2606,13,9,"RECORTES CE",2
36,"36022",9061,6640,6482,47,158,"RECORTES CE",8
31,"31068",2816,2194,2136,17,58,"RECORTES CE",8
22,"22075",119,87,87,1,0,"RECORTES CE",0
27,"27012",1276,776,768,9,8,"RECORTES CE",0
25,"25043",801,613,606,1,7,"RECORTES CE",2
30,"30005",30193,22648,22419,136,229,"RECORTES CE",28
8,"8246",1672,1412,1406,7,6,"RECORTES CE",0
4,"4091",326,267,266,3,1,"RECORTES CE",0
43,"43079",356,306,305,1,1,"RECORTES CE",0
36,"36023",8279,6187,6085,46,102,"RECORTES CE",4
48,"48061",799,636,636,2,0,"RECORTES CE",1
17,"17220",805,673,665,2,8,"RECORTES CE",0
26,"26007",481,391,383,0,8,"RECORTES CE",1
50,"50015",81,61,59,1,2,"RECORTES CE",0
31,"31110",84,72,72,3,0,"RECORTES CE",0
8,"8037",1930,1618,1610,10,8,"RECORTES CE",0
43,"43080",227,195,195,0,0,"RECORTES CE",0
10,"10012",564,469,464,1,5,"RECORTES CE",0
31,"31070",2628,1930,1881,16,49,"RECORTES CE",8
36,"36024",16395,12372,12165,102,207,"RECORTES CE",23
26,"26081",15,14,14,1,0,"RECORTES CE",0
43,"43154",126,111,111,0,0,"RECORTES CE",0
31,"31071",15,13,13,0,0,"RECORTES CE",0
3,"3127",351,290,277,2,13,"RECORTES CE",1
44,"44244",68,48,48,4,0,"RECORTES CE",0
17,"17222",105,95,95,1,0,"RECORTES CE",0
22,"22077",362,301,293,3,8,"RECORTES CE",1
27,"27014",3162,2181,2139,17,42,"RECORTES CE",3
3,"3128",4295,3007,2982,24,25,"RECORTES CE",9
50,"50276",119,91,91,1,0,"RECORTES CE",0
17,"17073",1939,1695,1693,7,2,"RECORTES CE",0
46,"46026",1202,1012,997,1,15,"RECORTES CE",0
8,"8248",5616,4378,4365,32,13,"RECORTES CE",5
48,"48063",356,277,274,2,3,"RECORTES CE",0
25,"25045",54,31,31,5,0,"RECORTES CE",1
43,"43081",633,532,531,7,1,"RECORTES CE",0
14,"14047",1629,1300,1285,18,15,"RECORTES CE",2
44,"44183",63,43,43,0,0,"RECORTES CE",0
17,"17223",800,623,616,5,7,"RECORTES CE",0
26,"26083",354,295,291,1,4,"RECORTES CE",1
6,"6062",576,435,430,0,5,"RECORTES CE",1
44,"44152",67,48,48,2,0,"RECORTES CE",0
50,"50017",1779,1386,1373,14,13,"RECORTES CE",3
17,"17074",532,436,426,2,10,"RECORTES CE",0
31,"31073",296,218,217,3,1,"RECORTES CE",0
50,"50278",177,137,137,2,0,"RECORTES CE",0
33,"33025",8996,6369,6309,81,60,"RECORTES CE",10
44,"44184",38,28,26,0,2,"RECORTES CE",0
20,"20069",147441,111102,110598,762,504,"RECORTES CE",194
38,"38026",33514,26298,26076,191,222,"RECORTES CE",30
44,"44246",1590,1173,1150,11,23,"RECORTES CE",0
26,"26084",7187,5620,5558,36,62,"RECORTES CE",12
10,"10016",327,260,259,1,1,"RECORTES CE",0
25,"25078",1001,807,805,5,2,"RECORTES CE",1
17,"17103",5084,3575,3543,13,32,"RECORTES CE",11
50,"50279",73,61,60,2,1,"RECORTES CE",0
36,"36027",4380,3262,3206,26,56,"RECORTES CE",1
43,"43157",345,303,303,0,0,"RECORTES CE",0
10,"10017",772,595,591,3,4,"RECORTES CE",0
44,"44247",287,216,215,6,1,"RECORTES CE",2
31,"31116",58,45,43,2,2,"RECORTES CE",0
44,"44185",93,73,72,1,1,"RECORTES CE",0
26,"26086",15,15,15,0,0,"RECORTES CE",0
26,"26087",170,136,135,3,1,"RECORTES CE",0
23,"23052",1108,949,931,8,18,"RECORTES CE",0
22,"22081",243,187,186,0,1,"RECORTES CE",0
32,"32061",1070,862,855,8,7,"RECORTES CE",1
25,"25148",219,168,168,1,0,"RECORTES CE",0
25,"25048",1632,1274,1264,7,10,"RECORTES CE",0
7,"7032",20888,14257,14096,108,161,"RECORTES CE",44
10,"10181",680,548,542,2,6,"RECORTES CE",0
26,"26088",41,38,38,0,0,"RECORTES CE",1
31,"31077",5407,4148,4081,39,67,"RECORTES CE",13
22,"22009",585,439,435,4,4,"RECORTES CE",0
11,"11035",13715,9510,9385,128,125,"RECORTES CE",28
43,"43084",521,424,423,2,1,"RECORTES CE",0
27,"27019",8189,6148,6039,94,109,"RECORTES CE",10
46,"46212",1590,1209,1192,4,17,"RECORTES CE",2
17,"17046",710,574,571,3,3,"RECORTES CE",0
8,"8252",24729,19751,19642,125,109,"RECORTES CE",52
21,"21053",3287,2375,2322,17,53,"RECORTES CE",2
17,"17139",1394,1163,1154,3,9,"RECORTES CE",0
50,"50281",68,55,52,0,3,"RECORTES CE",0
44,"44156",46,36,33,1,3,"RECORTES CE",0
26,"26089",111800,87863,86778,700,1085,"RECORTES CE",145
6,"6903",2027,1607,1594,16,13,"RECORTES CE",0
11,"11036",687,457,447,7,10,"RECORTES CE",1
44,"44094",123,112,112,0,0,"RECORTES CE",0
33,"33029",323,172,170,2,2,"RECORTES CE",0
3,"3133",41499,26593,26308,151,285,"RECORTES CE",98
25,"25050",3269,2457,2446,23,11,"RECORTES CE",0
14,"14052",9080,5999,5909,63,90,"RECORTES CE",8
8,"8253",128,113,113,0,0,"RECORTES CE",0
50,"50282",57,47,45,0,2,"RECORTES CE",0
41,"41093",19012,15637,15525,97,112,"RECORTES CE",37
21,"21055",7218,5328,5215,41,113,"RECORTES CE",6
46,"46032",5692,4518,4476,22,42,"RECORTES CE",6
17,"17227",139,106,106,0,0,"RECORTES CE",0
25,"25082",295,229,229,2,0,"RECORTES CE",0
17,"17198",433,332,329,0,3,"RECORTES CE",0
26,"26091",147,132,131,1,1,"RECORTES CE",0
41,"41048",2198,1561,1512,22,49,"RECORTES CE",1
44,"44157",64,38,38,1,0,"RECORTES CE",0
44,"44190",65,45,43,0,2,"RECORTES CE",0
41,"41020",12992,8679,8524,117,155,"RECORTES CE",14
35,"35033",6403,4565,4502,34,63,"RECORTES CE",2
3,"3134",141,119,117,0,2,"RECORTES CE",0
25,"25151",736,592,584,1,8,"RECORTES CE",0
31,"31081",334,259,256,7,3,"RECORTES CE",0
26,"26092",109,84,82,1,2,"RECORTES CE",0
43,"43086",5263,4046,4021,17,25,"RECORTES CE",3
26,"26093",48,38,38,0,0,"RECORTES CE",0
12,"12088",57,54,54,0,0,"RECORTES CE",0
33,"33031",33854,23523,23143,307,380,"RECORTES CE",33
3,"3135",192,157,155,0,2,"RECORTES CE",1
50,"50283",69,53,52,3,1,"RECORTES CE",0
20,"20075",4346,3158,3134,19,24,"RECORTES CE",7
43,"43088",2026,1565,1562,9,3,"RECORTES CE",1
31,"31082",623,433,433,3,0,"RECORTES CE",0
11,"11040",398,348,342,4,6,"RECORTES CE",0
14,"14024",1859,1461,1418,10,43,"RECORTES CE",1
20,"20045",46866,33932,33700,191,232,"RECORTES CE",63
48,"48071",6038,4711,4674,27,37,"RECORTES CE",8
31,"31204",36,27,27,1,0,"RECORTES CE",0
50,"50284",132,105,104,1,1,"RECORTES CE",0
22,"22218",40,32,31,1,1,"RECORTES CE",0
8,"8255",137,105,105,1,0,"RECORTES CE",0
43,"43089",281,209,208,0,1,"RECORTES CE",0
3,"3136",410,329,323,3,6,"RECORTES CE",1
26,"26094",69,56,56,0,0,"RECORTES CE",0
6,"6070",7686,6083,5948,44,135,"RECORTES CE",7
17,"17050",674,585,582,5,3,"RECORTES CE",0
50,"50285",650,466,462,7,4,"RECORTES CE",0
44,"44257",154,110,109,1,1,"RECORTES CE",0
14,"14056",23513,17065,16684,147,381,"RECORTES CE",12
31,"31084",1948,1483,1472,9,11,"RECORTES CE",1
25,"25053",1092,879,873,8,6,"RECORTES CE",1
8,"8256",691,571,568,3,3,"RECORTES CE",0
3,"3137",657,484,480,5,4,"RECORTES CE",0
44,"44160",440,311,306,2,5,"RECORTES CE",1
22,"22087",58,47,47,0,0,"RECORTES CE",0
21,"21060",12235,8053,7929,93,124,"RECORTES CE",14
23,"23059",5728,4259,4187,18,72,"RECORTES CE",3
48,"48072",970,735,730,1,5,"RECORTES CE",0
41,"41023",7975,5918,5812,51,106,"RECORTES CE",2
22,"22088",143,111,111,1,0,"RECORTES CE",0
11,"11042",1155,870,852,7,18,"RECORTES CE",4
31,"31085",502,401,399,5,2,"RECORTES CE",2
51,"51001",59934,38342,37884,322,458,"RECORTES CE",155
26,"26096",260,221,212,2,9,"RECORTES CE",0
20,"20047",462,337,335,2,2,"RECORTES CE",0
11,"11901",5698,4167,4080,81,87,"RECORTES CE",6
14,"14057",6139,5054,4964,51,90,"RECORTES CE",4
3,"3138",3183,2390,2359,16,31,"RECORTES CE",7
31,"31207",285,209,206,1,3,"RECORTES CE",0
10,"10068",711,576,556,2,20,"RECORTES CE",0
31,"31086",13640,11040,10966,116,74,"RECORTES CE",38
14,"14058",7859,5854,5745,51,109,"RECORTES CE",75
44,"44161",430,320,316,1,4,"RECORTES CE",1
25,"25155",618,493,489,2,4,"RECORTES CE",1
38,"38036",6831,4947,4829,58,118,"RECORTES CE",10
22,"22089",276,216,216,2,0,"RECORTES CE",1
26,"26099",1216,993,973,14,20,"RECORTES CE",0
4,"4904",1879,1328,1322,4,6,"RECORTES CE",5
6,"6073",700,506,492,11,14,"RECORTES CE",0
44,"44260",138,91,90,1,1,"RECORTES CE",0
50,"50287",252,200,196,7,4,"RECORTES CE",0
17,"17054",347,271,271,0,0,"RECORTES CE",1
32,"32040",1418,1083,1075,3,8,"RECORTES CE",0
48,"48075",2067,1591,1565,11,26,"RECORTES CE",2
32,"32041",759,510,502,2,8,"RECORTES CE",0
3,"3140",26027,19805,19438,230,367,"RECORTES CE",26
41,"41099",3968,2666,2642,23,24,"RECORTES CE",3
14,"14059",687,571,563,7,8,"RECORTES CE",1
10,"10193",1412,1158,1145,4,13,"RECORTES CE",0
43,"43092",7235,5200,5174,21,26,"RECORTES CE",6
10,"10030",472,323,318,1,5,"RECORTES CE",1
43,"43116",463,381,379,2,2,"RECORTES CE",0
25,"25058",4358,3269,3254,7,15,"RECORTES CE",0
14,"14060",3694,2878,2798,26,80,"RECORTES CE",1
31,"31210",186,156,156,1,0,"RECORTES CE",1
31,"31089",228,187,184,0,3,"RECORTES CE",0
8,"8259",6904,5626,5601,27,25,"RECORTES CE",8
17,"17055",143,126,125,0,1,"RECORTES CE",0
23,"23062",1418,1206,1190,5,16,"RECORTES CE",0
17,"17902",1306,1076,1074,3,2,"RECORTES CE",0
26,"26101",34,27,27,0,0,"RECORTES CE",0
46,"46039",2121,1730,1698,19,32,"RECORTES CE",1
12,"12094",875,694,682,2,12,"RECORTES CE",0
8,"8180",27072,21218,21100,126,118,"RECORTES CE",40
21,"21065",255,178,173,2,5,"RECORTES CE",2
3,"3901",1109,827,820,5,7,"RECORTES CE",2
17,"17056",1766,1438,1433,9,5,"RECORTES CE",2
31,"31090",141,86,86,0,0,"RECORTES CE",1
39,"39070",123,101,99,0,2,"RECORTES CE",0
50,"50029",604,475,467,7,8,"RECORTES CE",0
31,"31212",129,102,102,6,0,"RECORTES CE",0
50,"50290",358,272,266,6,6,"RECORTES CE",1
22,"22907",1444,1149,1137,12,12,"RECORTES CE",1
15,"15077",8155,5554,5433,59,121,"RECORTES CE",7
32,"32043",2512,1805,1789,16,16,"RECORTES CE",1
33,"33038",2234,1669,1644,16,25,"RECORTES CE",3
14,"14062",963,753,745,4,8,"RECORTES CE",0
15,"15046",6163,4625,4497,49,128,"RECORTES CE",9
46,"46071",470,382,366,0,16,"RECORTES CE",1
43,"43094",2120,1659,1646,9,13,"RECORTES CE",2
8,"8261",2378,1821,1815,14,6,"RECORTES CE",2
44,"44167",39,30,30,0,0,"RECORTES CE",0
48,"48078",37991,28582,28382,202,200,"RECORTES CE",39
50,"50291",93,78,77,1,1,"RECORTES CE",0
3,"3903",2577,1996,1973,11,23,"RECORTES CE",3
46,"46041",327,251,250,2,1,"RECORTES CE",0
10,"10157",245,185,185,1,0,"RECORTES CE",2
21,"21067",402,300,299,2,1,"RECORTES CE",1
12,"12003",943,745,731,6,14,"RECORTES CE",0
26,"26104",11,9,9,0,0,"RECORTES CE",0
48,"48912",2331,1843,1833,7,10,"RECORTES CE",0
36,"36041",13621,10098,9939,97,159,"RECORTES CE",25
8,"8025",1535,1221,1214,7,7,"RECORTES CE",1
3,"3904",1420,1112,1095,5,17,"RECORTES CE",2
44,"44107",205,159,158,0,1,"RECORTES CE",0
43,"43095",2564,1995,1984,14,11,"RECORTES CE",0
25,"25061",80,59,58,0,1,"RECORTES CE",0
31,"31093",275,212,206,0,6,"RECORTES CE",0
48,"48079",395,313,312,2,1,"RECORTES CE",0
22,"22099",465,365,362,3,3,"RECORTES CE",1
15,"15080",1640,1177,1150,9,27,"RECORTES CE",0
41,"41030",500,419,410,6,9,"RECORTES CE",0
41,"41901",2703,2242,2201,29,41,"RECORTES CE",1
22,"22142",94,80,80,2,0,"RECORTES CE",0
31,"31094",105,78,76,0,2,"RECORTES CE",0
44,"44265",181,153,148,1,5,"RECORTES CE",0
10,"10078",370,289,278,4,11,"RECORTES CE",0
14,"14064",300,231,227,6,4,"RECORTES CE",0
27,"27032",3194,2268,2223,20,45,"RECORTES CE",3
44,"44070",55,45,45,0,0,"RECORTES CE",0
44,"44169",310,250,245,4,5,"RECORTES CE",0
8,"8263",21151,16360,16269,116,91,"RECORTES CE",29
38,"38042",3781,2799,2774,11,25,"RECORTES CE",1
25,"25062",695,578,573,3,5,"RECORTES CE",0
31,"31095",72,61,60,0,1,"RECORTES CE",2
4,"4002",1039,798,792,7,6,"RECORTES CE",1
50,"50033",65,50,50,1,0,"RECORTES CE",0
35,"35015",10728,6233,6108,54,125,"RECORTES CE",15
14,"14065",1813,1439,1421,11,18,"RECORTES CE",1
25,"25165",276,221,219,1,2,"RECORTES CE",0
17,"17061",183,148,148,0,0,"RECORTES CE",0
31,"31219",81,60,59,1,1,"RECORTES CE",0
26,"26107",91,78,77,0,1,"RECORTES CE",0
31,"31096",101,85,84,3,1,"RECORTES CE",0
12,"12006",174,149,149,2,0,"RECORTES CE",0
31,"31097",10521,7602,7550,76,52,"RECORTES CE",21
8,"8264",4535,3623,3613,13,10,"RECORTES CE",5
25,"25063",95,61,61,0,0,"RECORTES CE",0
43,"43097",399,341,341,1,0,"RECORTES CE",0
41,"41903",6769,5018,4919,73,99,"RECORTES CE",9
4,"4003",17540,12174,12051,75,123,"RECORTES CE",12
8,"8265",1590,1339,1334,6,5,"RECORTES CE",0
17,"17153",188,162,162,0,0,"RECORTES CE",0
50,"50294",64,49,47,0,2,"RECORTES CE",0
18,"18005",362,268,265,0,3,"RECORTES CE",0
50,"50034",787,568,556,3,12,"RECORTES CE",0
33,"33043",658,462,455,4,7,"RECORTES CE",0
4,"4004",400,320,315,2,5,"RECORTES CE",1
43,"43171",14705,11002,10956,62,46,"RECORTES CE",29
43,"43098",354,291,291,1,0,"RECORTES CE",0
31,"31098",1962,1562,1544,14,18,"RECORTES CE",8
14,"14067",3870,3057,2998,24,59,"RECORTES CE",5
27,"27035",180,127,123,0,4,"RECORTES CE",0
41,"41904",1792,1171,1162,16,9,"RECORTES CE",1
17,"17184",1264,1068,1060,5,8,"RECORTES CE",2
10,"10041",1025,840,825,6,15,"RECORTES CE",0
46,"46046",884,654,643,3,11,"RECORTES CE",1
50,"50035",75,63,62,0,1,"RECORTES CE",0
17,"17063",173,157,156,2,1,"RECORTES CE",0
25,"25067",706,537,532,4,5,"RECORTES CE",0
44,"44075",326,275,263,0,12,"RECORTES CE",0
38,"38046",9271,7297,7212,53,85,"RECORTES CE",23
31,"31099",49,43,43,0,0,"RECORTES CE",0
10,"10042",88,59,59,0,0,"RECORTES CE",0
25,"25912",843,685,684,4,1,"RECORTES CE",0
50,"50036",100,80,80,0,0,"RECORTES CE",0
22,"22197",439,356,353,10,3,"RECORTES CE",0
25,"25068",531,402,399,6,3,"RECORTES CE",0
22,"22234",745,587,578,11,9,"RECORTES CE",0
18,"18007",741,533,527,6,6,"RECORTES CE",0
44,"44174",409,306,300,3,6,"RECORTES CE",0
22,"22107",100,68,67,0,1,"RECORTES CE",1
48,"48084",21858,15943,15796,116,147,"RECORTES CE",33
15,"15085",3220,2284,2239,23,45,"RECORTES CE",4
8,"8267",6748,5389,5362,28,27,"RECORTES CE",10
43,"43100",3489,2820,2816,15,4,"RECORTES CE",4
8,"8031",2336,1886,1882,11,4,"RECORTES CE",2
30,"30030",320172,249965,247884,1497,2081,"RECORTES CE",510
26,"26151",411,353,351,3,2,"RECORTES CE",0
36,"36047",2287,1601,1585,14,16,"RECORTES CE",1
14,"14069",7376,5511,5398,47,113,"RECORTES CE",3
33,"33046",483,370,367,6,3,"RECORTES CE",0
25,"25069",425,329,327,1,2,"RECORTES CE",1
31,"31102",136,75,75,2,0,"RECORTES CE",1
15,"15086",2785,2015,1987,14,28,"RECORTES CE",4
10,"10044",1404,1092,1077,7,15,"RECORTES CE",2
4,"4008",464,386,383,4,3,"RECORTES CE",0
31,"31265",78,52,47,1,5,"RECORTES CE",0
25,"25136",96,79,79,2,0,"RECORTES CE",0
12,"12010",237,203,198,1,5,"RECORTES CE",0
22,"22124",182,148,148,1,0,"RECORTES CE",0
18,"18010",532,420,416,2,4,"RECORTES CE",1
26,"26113",31,30,30,0,0,"RECORTES CE",0
4,"4009",151,126,124,3,2,"RECORTES CE",0
18,"18011",4376,3286,3248,18,38,"RECORTES CE",4
33,"33047",1074,841,835,12,6,"RECORTES CE",2
10,"10045",970,739,735,6,4,"RECORTES CE",1
43,"43101",145,122,122,1,0,"RECORTES CE",0
15,"15087",5692,3883,3838,53,45,"RECORTES CE",8
36,"36049",7019,5414,5283,48,131,"RECORTES CE",13
12,"12043",560,460,450,2,10,"RECORTES CE",0
14,"14071",884,641,634,2,7,"RECORTES CE",0
12,"12011",4582,3511,3431,27,80,"RECORTES CE",2
32,"32080",286,223,220,1,3,"RECORTES CE",1
31,"31104",1751,1306,1280,1,26,"RECORTES CE",10
48,"48087",432,357,356,0,1,"RECORTES CE",0
25,"25071",42,32,31,0,1,"RECORTES CE",0
8,"8269",2712,2258,2250,19,8,"RECORTES CE",2
14,"14072",999,763,754,4,9,"RECORTES CE",1
31,"31227",8111,6198,6129,69,69,"RECORTES CE",29
25,"25171",2127,1639,1630,8,9,"RECORTES CE",1
21,"21005",15697,9910,9778,72,132,"RECORTES CE",19
8,"8270",18837,14541,14497,66,44,"RECORTES CE",19
43,"43102",463,384,379,2,5,"RECORTES CE",0
36,"36050",7650,5616,5506,48,110,"RECORTES CE",11
26,"26117",2097,1680,1647,17,33,"RECORTES CE",1
41,"41066",1310,1027,1010,1,17,"RECORTES CE",2
4,"4011",2757,2171,2136,11,35,"RECORTES CE",3
31,"31106",718,585,581,3,4,"RECORTES CE",0
23,"23076",768,653,646,3,7,"RECORTES CE",2
14,"14073",2772,2124,2069,18,55,"RECORTES CE",3
44,"44178",53,39,39,0,0,"RECORTES CE",0
29,"29051",41793,29275,28764,249,511,"RECORTES CE",52
38,"38051",7326,5418,5352,27,66,"RECORTES CE",9
7,"7024",7294,4213,4160,44,53,"RECORTES CE",10
4,"4012",187,163,162,1,1,"RECORTES CE",0
48,"48028",691,576,573,1,3,"RECORTES CE",0
8,"8034",784,648,646,1,2,"RECORTES CE",0
32,"32082",1178,880,872,12,8,"RECORTES CE",1
10,"10212",1645,1283,1238,7,45,"RECORTES CE",4
31,"31905",2968,2253,2236,21,17,"RECORTES CE",9
43,"43103",905,746,740,8,6,"RECORTES CE",1
4,"4013",143321,101501,100814,750,687,"RECORTES CE",166
8,"8271",67,57,57,0,0,"RECORTES CE",0
6,"6090",824,602,578,4,24,"RECORTES CE",2
23,"23077",611,483,479,0,4,"RECORTES CE",1
46,"46053",537,459,457,2,2,"RECORTES CE",0
15,"15059",10255,7423,7262,122,161,"RECORTES CE",12
15,"15091",1103,773,758,16,15,"RECORTES CE",2
41,"41040",11111,8768,8679,76,89,"RECORTES CE",11
31,"31231",108,73,70,1,3,"RECORTES CE",0
10,"10173",558,445,439,0,6,"RECORTES CE",2
26,"26043",349,272,268,2,4,"RECORTES CE",0
8,"8036",163,134,133,0,1,"RECORTES CE",0
31,"31109",1664,1290,1283,10,7,"RECORTES CE",5
43,"43104",1762,1410,1401,5,9,"RECORTES CE",1
14,"14075",557,429,411,5,18,"RECORTES CE",1
38,"38053",3763,2628,2588,21,40,"RECORTES CE",3
6,"6092",555,428,419,3,9,"RECORTES CE",0
8,"8273",2353,1944,1934,9,10,"RECORTES CE",3
22,"22245",306,266,263,0,3,"RECORTES CE",0
43,"43105",156,132,132,3,0,"RECORTES CE",0
33,"33052",704,520,513,5,7,"RECORTES CE",0
46,"46085",11075,8106,8011,54,95,"RECORTES CE",10
31,"31908",1064,810,803,2,7,"RECORTES CE",2
26,"26161",8,7,7,0,0,"RECORTES CE",0
48,"48092",869,676,674,9,2,"RECORTES CE",0
22,"22246",71,50,50,0,0,"RECORTES CE",0
4,"4016",2128,1643,1621,4,22,"RECORTES CE",0
26,"26122",116,98,97,0,1,"RECORTES CE",0
44,"44087",68,56,54,0,2,"RECORTES CE",0
43,"43901",8750,6057,6004,43,53,"RECORTES CE",2
22,"22003",132,114,114,0,0,"RECORTES CE",0
48,"48093",888,720,715,2,5,"RECORTES CE",1
23,"23081",1483,1137,1109,7,28,"RECORTES CE",0
31,"31234",149,115,114,0,1,"RECORTES CE",0
29,"29056",1061,783,772,4,11,"RECORTES CE",3
8,"8038",1525,1228,1220,2,8,"RECORTES CE",1
8,"8064",1920,1516,1506,6,10,"RECORTES CE",0
35,"35027",10499,7651,7530,57,121,"RECORTES CE",12
6,"6094",1459,1017,1008,8,9,"RECORTES CE",0
44,"44088",23,21,21,0,0,"RECORTES CE",0
22,"22004",124,90,88,1,2,"RECORTES CE",0
7,"7062",7902,4889,4828,58,61,"RECORTES CE",8
12,"12050",1230,987,972,10,15,"RECORTES CE",1
26,"26164",51,37,37,1,0,"RECORTES CE",0
26,"26123",124,112,110,0,2,"RECORTES CE",0
48,"48003",14444,11233,11162,43,71,"RECORTES CE",14
32,"32058",5225,3915,3857,35,58,"RECORTES CE",5
10,"10178",729,567,559,4,8,"RECORTES CE",1
25,"25077",440,331,330,1,1,"RECORTES CE",0
21,"21013",10570,7195,7089,73,106,"RECORTES CE",14
17,"17194",78,62,62,0,0,"RECORTES CE",0
6,"6029",1183,946,935,12,11,"RECORTES CE",1
4,"4018",252,215,213,1,2,"RECORTES CE",0
43,"43902",2743,1996,1980,16,16,"RECORTES CE",1
17,"17102",548,439,435,3,4,"RECORTES CE",0
10,"10138",540,422,415,3,7,"RECORTES CE",0
22,"22006",272,206,201,2,5,"RECORTES CE",0
26,"26125",2663,2042,2011,32,31,"RECORTES CE",1
39,"39003",258,205,202,3,3,"RECORTES CE",0
15,"15002",24007,18075,17857,216,218,"RECORTES CE",47
15,"15034",2724,1832,1811,8,21,"RECORTES CE",3
41,"41044",7698,5967,5898,59,69,"RECORTES CE",11
17,"17224",302,233,231,2,2,"RECORTES CE",0
10,"10057",126,97,96,2,1,"RECORTES CE",1
17,"17075",334,282,281,5,1,"RECORTES CE",0
48,"48095",2326,1691,1680,11,11,"RECORTES CE",2
46,"46180",651,525,519,0,6,"RECORTES CE",1
38,"38027",5545,3937,3896,22,41,"RECORTES CE",5
35,"35029",4357,2869,2832,32,37,"RECORTES CE",7
17,"17043",167,135,134,0,1,"RECORTES CE",0
43,"43108",1778,1374,1365,6,9,"RECORTES CE",0
22,"22008",155,127,125,0,2,"RECORTES CE",0
46,"46150",1797,1275,1257,9,18,"RECORTES CE",1
48,"48096",6510,5247,5185,36,62,"RECORTES CE",6
26,"26140",239,199,194,1,5,"RECORTES CE",2
44,"44025",5825,4337,4197,50,140,"RECORTES CE",10
26,"26167",50,38,38,1,0,"RECORTES CE",0
31,"31157",3470,2507,2473,32,34,"RECORTES CE",9
32,"32005",827,628,622,4,6,"RECORTES CE",0
33,"33027",769,505,497,14,8,"RECORTES CE",1
35,"35002",24129,16979,16736,116,243,"RECORTES CE",69
11,"11034",2331,1708,1670,17,38,"RECORTES CE",1
23,"23019",1479,1209,1183,3,26,"RECORTES CE",0
22,"22046",714,592,587,13,5,"RECORTES CE",0
43,"43109",2704,1937,1922,16,15,"RECORTES CE",2
26,"26127",186,162,159,1,3,"RECORTES CE",0
6,"6098",534,421,411,8,10,"RECORTES CE",0
48,"48097",1316,979,976,4,3,"RECORTES CE",0
10,"10060",935,670,658,4,12,"RECORTES CE",0
33,"33058",1664,1205,1176,5,29,"RECORTES CE",3
10,"10182",124,91,90,0,1,"RECORTES CE",0
44,"44218",31,25,25,2,0,"RECORTES CE",0
32,"32062",766,582,579,1,3,"RECORTES CE",0
39,"39089",134,99,98,0,1,"RECORTES CE",0
39,"39005",1406,1127,1110,12,17,"RECORTES CE",0
44,"44093",79,73,73,4,0,"RECORTES CE",0
44,"44027",149,120,119,0,1,"RECORTES CE",0
6,"6066",1725,1297,1286,9,11,"RECORTES CE",0
50,"50297",502835,394653,391387,3269,3266,"RECORTES CE",1085
17,"17078",336,252,251,3,1,"RECORTES CE",1
43,"43110",251,184,184,1,0,"RECORTES CE",0
8,"8279",155280,121081,120515,802,566,"RECORTES CE",266
33,"33059",4403,3007,2942,42,65,"RECORTES CE",1
29,"29085",138,100,98,0,2,"RECORTES CE",0
30,"30013",7467,5621,5553,26,68,"RECORTES CE",3
21,"21018",1719,1167,1139,9,28,"RECORTES CE",0
31,"31242",264,194,194,2,0,"RECORTES CE",0
44,"44220",113,92,89,0,3,"RECORTES CE",0
7,"7035",1596,1242,1234,13,8,"RECORTES CE",0
26,"26130",201,164,163,0,1,"RECORTES CE",0
35,"35004",41728,23957,23683,219,274,"RECORTES CE",37
39,"39007",393,300,298,1,2,"RECORTES CE",0
6,"6034",167,115,115,1,0,"RECORTES CE",0
29,"29063",303,243,239,1,4,"RECORTES CE",0
10,"10144",920,731,723,4,8,"RECORTES CE",0
43,"43136",10463,7789,7749,36,40,"RECORTES CE",6
29,"29086",774,537,532,1,5,"RECORTES CE",0
31,"31121",65,51,51,0,0,"RECORTES CE",0
17,"17170",180,147,147,2,0,"RECORTES CE",0
26,"26131",34,34,34,1,0,"RECORTES CE",0
22,"22013",275,218,217,6,1,"RECORTES CE",0
25,"25085",141,118,117,2,1,"RECORTES CE",0
22,"22254",1094,857,850,11,7,"RECORTES CE",0
6,"6035",865,678,670,4,8,"RECORTES CE",0
44,"44221",384,320,315,2,5,"RECORTES CE",0
31,"31162",48,34,33,1,1,"RECORTES CE",2
20,"20014",1156,772,765,4,7,"RECORTES CE",0
44,"44097",126,91,90,2,1,"RECORTES CE",0
10,"10187",430,316,311,0,5,"RECORTES CE",0
33,"33001",1504,875,864,15,11,"RECORTES CE",0
17,"17049",3204,2634,2615,9,19,"RECORTES CE",1
25,"25086",521,414,411,2,3,"RECORTES CE",0
26,"26132",106,87,87,0,0,"RECORTES CE",0
46,"46064",525,427,424,4,3,"RECORTES CE",0
12,"12026",835,656,639,4,17,"RECORTES CE",1
44,"44099",649,457,450,2,7,"RECORTES CE",1
22,"22901",714,521,508,3,13,"RECORTES CE",1
48,"48904",3542,2832,2811,27,21,"RECORTES CE",0
44,"44192",349,288,284,1,4,"RECORTES CE",0
43,"43113",397,325,323,2,2,"RECORTES CE",0
46,"46156",2024,1642,1628,7,14,"RECORTES CE",0
35,"35007",518,405,401,0,4,"RECORTES CE",0
39,"39037",2019,1572,1560,2,12,"RECORTES CE",3
33,"33063",374,284,283,3,1,"RECORTES CE",0
31,"31246",128,105,101,3,4,"RECORTES CE",1
25,"25087",56,49,49,0,0,"RECORTES CE",0
26,"26134",83,70,67,0,3,"RECORTES CE",0
22,"22015",300,232,226,5,6,"RECORTES CE",0
46,"46066",1285,1058,1043,6,15,"RECORTES CE",0
26,"26020",454,347,337,4,10,"RECORTES CE",0
43,"43114",375,306,305,0,1,"RECORTES CE",0
20,"20077",5254,4083,4059,22,24,"RECORTES CE",2
48,"48012",2071,1685,1674,7,11,"RECORTES CE",0
25,"25189",2164,1591,1583,11,8,"RECORTES CE",1
25,"25088",95,85,83,0,2,"RECORTES CE",0
44,"44002",46,42,42,0,0,"RECORTES CE",0
22,"22221",90,58,56,0,2,"RECORTES CE",1
22,"22016",566,423,420,4,3,"RECORTES CE",0
22,"22052",885,708,702,6,6,"RECORTES CE",0
23,"23093",3131,2428,2380,22,48,"RECORTES CE",1
31,"31166",250,184,184,2,0,"RECORTES CE",0
27,"27056",1206,896,880,9,16,"RECORTES CE",0
17,"17082",436,341,339,0,2,"RECORTES CE",0
6,"6006",4494,3395,3325,24,70,"RECORTES CE",5
6,"6105",604,406,400,2,6,"RECORTES CE",1
17,"17203",165,135,135,0,0,"RECORTES CE",0
17,"17174",162,132,132,4,0,"RECORTES CE",0
25,"25089",97,72,71,1,1,"RECORTES CE",0
39,"39095",2240,1809,1778,12,31,"RECORTES CE",1
6,"6139",502,429,421,5,8,"RECORTES CE",0
17,"17023",27144,20301,20146,120,155,"RECORTES CE",36
38,"38005",5666,3795,3761,24,34,"RECORTES CE",8
22,"22133",108,85,83,1,2,"RECORTES CE",0
10,"10111",1306,1006,994,12,12,"RECORTES CE",2
7,"7041",2097,1662,1634,20,28,"RECORTES CE",4
22,"22017",822,664,660,5,4,"RECORTES CE",0
6,"6106",413,267,263,3,4,"RECORTES CE",0
41,"41053",21618,16549,16150,194,399,"RECORTES CE",25
8,"8048",569,442,442,2,0,"RECORTES CE",0
44,"44004",379,312,310,5,2,"RECORTES CE",0
25,"25092",127,101,99,1,2,"RECORTES CE",0
31,"31169",2205,1597,1568,17,29,"RECORTES CE",1
44,"44195",84,66,65,1,1,"RECORTES CE",0
44,"44102",27,22,22,0,0,"RECORTES CE",0
46,"46262",213,170,165,1,5,"RECORTES CE",1
31,"31047",236,181,179,5,2,"RECORTES CE",0
10,"10071",124,85,84,0,1,"RECORTES CE",0
26,"26061",1552,1228,1194,14,34,"RECORTES CE",0
17,"17024",285,228,227,0,1,"RECORTES CE",0
33,"33067",747,608,596,9,12,"RECORTES CE",0
46,"46069",157,130,129,0,1,"RECORTES CE",0
6,"6008",613,540,532,0,8,"RECORTES CE",0
6,"6108",2249,1726,1684,22,42,"RECORTES CE",2
22,"22019",175,151,151,0,0,"RECORTES CE",0
39,"39097",679,437,435,2,2,"RECORTES CE",0
44,"44080",284,214,212,1,2,"RECORTES CE",0
26,"26025",89,77,77,0,0,"RECORTES CE",0
7,"7043",3430,2465,2438,24,27,"RECORTES CE",3
17,"17147",7959,6164,6130,45,34,"RECORTES CE",7
8,"8294",2063,1644,1643,10,1,"RECORTES CE",3
31,"31130",322,237,235,7,2,"RECORTES CE",0
35,"35012",10765,6327,6270,32,57,"RECORTES CE",13
31,"31009",672,510,503,4,7,"RECORTES CE",1
33,"33068",1047,624,620,8,4,"RECORTES CE",0
25,"25094",139,116,116,0,0,"RECORTES CE",0
48,"48910",2802,2082,2073,3,9,"RECORTES CE",3
17,"17086",1745,1223,1210,7,13,"RECORTES CE",1
31,"31253",119,106,105,0,1,"RECORTES CE",1
46,"46902",356,300,296,8,4,"RECORTES CE",2
41,"41056",3694,3044,3009,36,35,"RECORTES CE",3
32,"32071",1378,963,954,7,9,"RECORTES CE",0
10,"10073",721,553,546,4,7,"RECORTES CE",0
44,"44006",223,171,169,2,2,"RECORTES CE",0
17,"17903",889,726,721,4,5,"RECORTES CE",0
10,"10115",3488,2878,2816,15,62,"RECORTES CE",2
46,"46162",1177,954,938,4,16,"RECORTES CE",1
44,"44198",181,151,145,1,6,"RECORTES CE",0
26,"26181",14,14,14,0,0,"RECORTES CE",0
4,"4075",5427,3989,3961,15,28,"RECORTES CE",6
25,"25096",888,663,661,2,2,"RECORTES CE",0
23,"23099",4822,3687,3633,28,54,"RECORTES CE",4
17,"17087",222,177,176,0,1,"RECORTES CE",0
26,"26028",139,120,117,1,3,"RECORTES CE",0
10,"10197",108,84,84,0,0,"RECORTES CE",0
22,"22022",543,441,433,4,8,"RECORTES CE",1
44,"44199",39,39,38,5,1,"RECORTES CE",0
31,"31255",103,87,84,0,3,"RECORTES CE",0
33,"33070",3293,2499,2473,32,26,"RECORTES CE",6
44,"44008",1565,1158,1138,8,20,"RECORTES CE",0
29,"29097",4168,3086,3009,37,77,"RECORTES CE",6
44,"44229",143,110,108,4,2,"RECORTES CE",0
10,"10158",337,269,267,0,2,"RECORTES CE",0
4,"4037",1221,975,960,8,15,"RECORTES CE",0
26,"26144",188,161,160,1,1,"RECORTES CE",0
26,"26029",36,29,28,0,1,"RECORTES CE",0
25,"25001",139,104,103,1,1,"RECORTES CE",0
27,"27063",1715,1236,1198,10,38,"RECORTES CE",1
6,"6112",383,334,334,1,0,"RECORTES CE",0
17,"17088",578,468,468,1,0,"RECORTES CE",1
44,"44108",300,228,224,5,4,"RECORTES CE",0
46,"46012",929,727,707,3,20,"RECORTES CE",3
6,"6013",265,227,221,0,6,"RECORTES CE",0
43,"43144",1236,1025,1021,8,4,"RECORTES CE",1
33,"33071",563,413,407,2,6,"RECORTES CE",0
26,"26030",17,17,17,0,0,"RECORTES CE",0
22,"22023",389,313,305,6,8,"RECORTES CE",0
7,"7047",2371,1775,1747,13,28,"RECORTES CE",7
48,"48019",3461,2647,2633,12,14,"RECORTES CE",8
43,"43046",90,73,73,1,0,"RECORTES CE",0
4,"4041",330,248,247,1,1,"RECORTES CE",0
12,"12037",17,17,17,1,0,"RECORTES CE",1
8,"8289",4457,3605,3594,20,11,"RECORTES CE",10
26,"26146",86,69,69,1,0,"RECORTES CE",0
25,"25033",1121,899,890,5,9,"RECORTES CE",0
20,"20025",1116,835,830,2,5,"RECORTES CE",0
31,"31055",263,199,197,3,2,"RECORTES CE",0
10,"10201",179,157,156,1,1,"RECORTES CE",0
6,"6014",6535,4757,4679,36,78,"RECORTES CE",1
25,"25099",1291,981,978,2,3,"RECORTES CE",2
26,"26147",34,30,29,0,1,"RECORTES CE",0
8,"8290",1534,1289,1284,9,5,"RECORTES CE",0
33,"33072",1455,973,963,14,10,"RECORTES CE",0
20,"20905",153,124,124,1,0,"RECORTES CE",0
44,"44203",9,9,9,0,0,"RECORTES CE",0
22,"22144",257,207,204,1,3,"RECORTES CE",0
10,"10080",360,256,246,0,10,"RECORTES CE",0
26,"26032",45,37,37,1,0,"RECORTES CE",0
20,"20906",130,99,98,1,1,"RECORTES CE",0
10,"10202",588,469,459,0,10,"RECORTES CE",2
27,"27065",12076,8393,8183,128,210,"RECORTES CE",7
17,"17091",398,310,305,2,5,"RECORTES CE",0
21,"21071",211,155,152,3,3,"RECORTES CE",1
21,"21035",9726,6628,6520,78,108,"RECORTES CE",5
4,"4044",1533,1190,1176,8,14,"RECORTES CE",0
12,"12128",1362,1099,1076,9,23,"RECORTES CE",0
26,"26148",150,128,124,1,4,"RECORTES CE",0
46,"46076",591,497,487,0,10,"RECORTES CE",1
44,"44111",78,64,64,1,0,"RECORTES CE",0
31,"31139",155,105,105,0,0,"RECORTES CE",1
25,"25233",285,231,229,2,2,"RECORTES CE",1
17,"17123",345,304,303,4,1,"RECORTES CE",0
17,"17212",142,117,117,2,0,"RECORTES CE",0
31,"31221",1235,944,938,11,6,"RECORTES CE",5
17,"17124",1599,1258,1254,6,4,"RECORTES CE",0
17,"17092",3467,2660,2633,17,27,"RECORTES CE",4
25,"25101",543,454,449,1,5,"RECORTES CE",1
15,"15021",5244,3884,3806,70,78,"RECORTES CE",6
8,"8292",1062,835,831,3,4,"RECORTES CE",1
39,"39020",23931,17782,17566,126,216,"RECORTES CE",25
43,"43123",71092,53689,53369,241,320,"RECORTES CE",71
26,"26150",100,83,83,0,0,"RECORTES CE",0
31,"31140",115,83,83,2,0,"RECORTES CE",1
33,"33045",4382,3214,3156,23,58,"RECORTES CE",3
39,"39049",306,209,208,4,1,"RECORTES CE",0
31,"31181",134,94,93,1,1,"RECORTES CE",0
22,"22028",362,284,282,5,2,"RECORTES CE",0
6,"6018",740,543,536,5,7,"RECORTES CE",0
44,"44013",11250,8525,8420,95,105,"RECORTES CE",10
17,"17185",2275,1777,1768,7,9,"RECORTES CE",1
46,"46169",32294,24909,24676,157,233,"RECORTES CE",47
31,"31141",107,76,74,0,2,"RECORTES CE",0
10,"10084",1294,899,869,5,30,"RECORTES CE",1
12,"12041",100,76,75,0,1,"RECORTES CE",0
27,"27902",7150,5067,4953,74,114,"RECORTES CE",10
50,"50009",97,72,71,1,1,"RECORTES CE",0
6,"6052",3969,3043,2970,21,73,"RECORTES CE",2
10,"10125",862,655,639,4,16,"RECORTES CE",0
22,"22155",65,54,54,0,0,"RECORTES CE",0
7,"7053",1164,956,948,4,8,"RECORTES CE",2
10,"10085",319,240,236,1,4,"RECORTES CE",1
26,"26152",27,23,23,1,0,"RECORTES CE",0
17,"17005",460,336,331,0,5,"RECORTES CE",0
4,"4048",1496,1109,1102,4,7,"RECORTES CE",1
44,"44014",2499,2015,1963,25,52,"RECORTES CE",3
10,"10004",690,529,517,8,12,"RECORTES CE",1
10,"10167",307,238,237,1,1,"RECORTES CE",0
31,"31156",239,191,191,1,0,"RECORTES CE",0
6,"6031",461,316,301,1,15,"RECORTES CE",0
41,"41008",1040,840,822,4,18,"RECORTES CE",1
27,"27008",1345,965,946,17,19,"RECORTES CE",3
36,"36028",4069,3012,2960,27,52,"RECORTES CE",4
26,"26153",10,9,9,0,0,"RECORTES CE",0
4,"4049",5603,4104,4054,27,50,"RECORTES CE",3
23,"23008",1434,1155,1133,6,22,"RECORTES CE",2
7,"7054",22958,14097,13908,123,189,"RECORTES CE",34
22,"22156",296,246,242,3,4,"RECORTES CE",1
15,"15024",4346,3210,3151,19,59,"RECORTES CE",8
15,"15056",5648,4033,3979,39,54,"RECORTES CE",3
35,"35021",15014,10909,10792,71,117,"RECORTES CE",42
17,"17128",316,255,252,1,3,"RECORTES CE",0
31,"31185",470,335,332,6,3,"RECORTES CE",1
26,"26002",827,643,639,5,4,"RECORTES CE",0
32,"32052",1819,1399,1379,15,20,"RECORTES CE",2
39,"39024",1815,1436,1420,14,16,"RECORTES CE",1
4,"4051",406,343,339,1,4,"RECORTES CE",0
25,"25105",103,89,88,1,1,"RECORTES CE",0
11,"11024",6583,4774,4682,40,92,"RECORTES CE",5
8,"8296",1843,1520,1514,10,6,"RECORTES CE",1
17,"17188",169,139,138,1,1,"RECORTES CE",0
43,"43004",6274,4744,4691,39,53,"RECORTES CE",2
44,"44017",272,221,219,0,2,"RECORTES CE",0
23,"23044",4719,3817,3749,18,68,"RECORTES CE",3
32,"32081",2035,1592,1565,14,27,"RECORTES CE",2
48,"48058",946,724,715,3,9,"RECORTES CE",0
32,"32025",1013,773,761,7,12,"RECORTES CE",1
25,"25040",10614,7791,7734,58,57,"RECORTES CE",2
26,"26155",149,119,119,0,0,"RECORTES CE",0
25,"25109",214,179,176,3,3,"RECORTES CE",0
15,"15027",1555,1227,1204,18,23,"RECORTES CE",0
6,"6122",6562,4837,4723,43,114,"RECORTES CE",5
14,"14012",6076,4579,4489,38,90,"RECORTES CE",5
26,"26157",282,233,232,1,1,"RECORTES CE",1
25,"25139",491,390,388,3,2,"RECORTES CE",1
8,"8086",14017,10746,10677,89,69,"RECORTES CE",27
44,"44047",229,125,124,2,1,"RECORTES CE",1
10,"10008",1291,1015,997,16,18,"RECORTES CE",2
32,"32026",2659,1988,1957,26,31,"RECORTES CE",2
10,"10131",12808,9377,9254,67,123,"RECORTES CE",16
17,"17037",114,98,98,6,0,"RECORTES CE",1
25,"25208",333,252,249,0,3,"RECORTES CE",0
46,"46083",15374,11259,11096,56,163,"RECORTES CE",23
17,"17009",4051,3263,3248,14,15,"RECORTES CE",1
8,"8139",177,156,156,0,0,"RECORTES CE",0
10,"10091",350,293,291,1,2,"RECORTES CE",0
31,"31148",92,67,65,4,2,"RECORTES CE",0
26,"26158",246,207,206,2,1,"RECORTES CE",1
35,"35024",14243,9496,9394,65,102,"RECORTES CE",20
6,"6091",3668,2839,2776,26,63,"RECORTES CE",1
7,"7058",2857,2258,2233,18,25,"RECORTES CE",5
41,"41068",13936,10692,10530,73,162,"RECORTES CE",6
44,"44149",100,74,73,0,1,"RECORTES CE",1
10,"10092",266,216,211,18,5,"RECORTES CE",1
33,"33021",4361,3098,3043,31,55,"RECORTES CE",4
25,"25244",362,296,294,2,2,"RECORTES CE",1
44,"44020",22,18,18,0,0,"RECORTES CE",0
22,"22162",129,99,99,0,0,"RECORTES CE",0
23,"23012",4018,2835,2804,15,31,"RECORTES CE",0
20,"20005",1267,884,882,2,2,"RECORTES CE",0
17,"17099",78,59,59,0,0,"RECORTES CE",1
17,"17010",327,264,263,2,1,"RECORTES CE",0
10,"10215",413,305,301,2,4,"RECORTES CE",0
35,"35025",1773,1247,1235,9,12,"RECORTES CE",0
6,"6158",13362,10282,10112,73,170,"RECORTES CE",17
25,"25142",365,300,299,2,1,"RECORTES CE",0
22,"22205",459,347,345,1,2,"RECORTES CE",1
7,"7027",22047,14986,14853,139,133,"RECORTES CE",27
30,"30006",829,731,727,4,4,"RECORTES CE",0
23,"23014",2552,2056,2020,11,36,"RECORTES CE",1
26,"26121",30,21,21,1,0,"RECORTES CE",0
44,"44021",104,86,85,2,1,"RECORTES CE",0
15,"15031",23779,17963,17787,213,176,"RECORTES CE",52
10,"10216",1522,1195,1167,9,28,"RECORTES CE",1
50,"50072",195,164,161,3,3,"RECORTES CE",0
8,"8089",34019,26317,26191,170,126,"RECORTES CE",52
10,"10095",314,260,255,2,5,"RECORTES CE",0
17,"17100",195,157,154,0,3,"RECORTES CE",0
17,"17134",223,189,189,1,0,"RECORTES CE",0
31,"31152",1270,937,929,19,8,"RECORTES CE",5
32,"32001",5105,3760,3715,37,45,"RECORTES CE",7
15,"15062",5652,3803,3728,25,75,"RECORTES CE",8
14,"14902",1121,928,900,7,28,"RECORTES CE",0
10,"10217",521,436,432,0,4,"RECORTES CE",1
39,"39029",636,512,512,5,0,"RECORTES CE",0
22,"22043",93,68,67,1,1,"RECORTES CE",0
31,"31193",1438,1129,1123,13,6,"RECORTES CE",8
10,"10014",1829,1448,1419,12,29,"RECORTES CE",3
38,"38025",7088,5166,5089,39,77,"RECORTES CE",15
44,"44245",245,176,171,1,5,"RECORTES CE",0
22,"22119",1256,963,954,5,9,"RECORTES CE",1
22,"22248",104,83,82,0,1,"RECORTES CE",0
8,"8143",2719,2121,2109,10,12,"RECORTES CE",3
29,"29080",6895,5005,4934,59,71,"RECORTES CE",15
21,"21049",3282,2294,2214,21,80,"RECORTES CE",4
15,"15064",2127,1608,1577,29,31,"RECORTES CE",4
25,"25114",95,79,79,0,0,"RECORTES CE",0
12,"12051",448,324,319,2,5,"RECORTES CE",0
4,"4095",690,508,502,2,6,"RECORTES CE",0
27,"27047",1525,1026,1008,5,18,"RECORTES CE",0
44,"44153",1749,1264,1243,11,21,"RECORTES CE",3
36,"36026",19924,14342,14132,171,210,"RECORTES CE",22
4,"4059",1025,742,731,3,11,"RECORTES CE",0
31,"31155",241,181,180,3,1,"RECORTES CE",0
26,"26011",7229,5355,5277,64,78,"RECORTES CE",7
32,"32003",889,667,654,3,13,"RECORTES CE",0
7,"7063",1420,1139,1129,10,10,"RECORTES CE",0
41,"41072",4037,3256,3221,19,35,"RECORTES CE",1
44,"44053",105,81,81,0,0,"RECORTES CE",0
8,"8144",713,565,563,5,2,"RECORTES CE",1
11,"11033",21702,14645,14436,190,209,"RECORTES CE",32
6,"6063",2938,2299,2264,11,35,"RECORTES CE",1
20,"20040",15753,11440,11364,69,76,"RECORTES CE",15
46,"46028",388,324,319,1,5,"RECORTES CE",0
41,"41073",1685,1172,1157,13,15,"RECORTES CE",0
43,"43133",5605,4202,4168,21,34,"RECORTES CE",3
17,"17196",242,198,198,1,0,"RECORTES CE",0
8,"8903",197,177,176,0,1,"RECORTES CE",0
17,"17116",354,283,282,0,1,"RECORTES CE",0
44,"44054",94,79,79,0,0,"RECORTES CE",0
25,"25250",330,261,258,1,3,"RECORTES CE",0
23,"23042",317,234,232,1,2,"RECORTES CE",1
20,"20010",1528,1156,1151,5,5,"RECORTES CE",1
7,"7065",2302,1633,1603,10,30,"RECORTES CE",5
8,"8904",10514,7733,7697,38,36,"RECORTES CE",17
31,"31171",669,516,502,3,14,"RECORTES CE",0
20,"20041",234,156,151,2,5,"RECORTES CE",0
44,"44155",1056,830,813,9,17,"RECORTES CE",2
44,"44026",95,76,75,2,1,"RECORTES CE",0
22,"22170",668,529,520,4,9,"RECORTES CE",6
8,"8304",816,686,678,1,8,"RECORTES CE",0
43,"43134",273,224,223,5,1,"RECORTES CE",2
10,"10101",179,140,138,2,2,"RECORTES CE",1
17,"17016",719,584,581,1,3,"RECORTES CE",0
46,"46030",796,653,633,7,20,"RECORTES CE",0
29,"29084",27218,19648,19352,173,296,"RECORTES CE",25
32,"32090",738,530,525,3,5,"RECORTES CE",1
8,"8226",926,811,807,1,4,"RECORTES CE",0
25,"25049",155,113,111,0,2,"RECORTES CE",0
7,"7033",28373,17884,17684,201,200,"RECORTES CE",24
43,"43905",14941,10510,10446,40,64,"RECORTES CE",11
10,"10020",1576,1259,1225,9,34,"RECORTES CE",0
4,"4100",9266,6046,5988,49,58,"RECORTES CE",5
22,"22083",445,379,372,5,7,"RECORTES CE",0
44,"44219",173,142,136,1,6,"RECORTES CE",0
15,"15037",4031,2700,2677,13,23,"RECORTES CE",3
25,"25150",165,136,133,0,3,"RECORTES CE",0
23,"23021",517,446,440,0,6,"RECORTES CE",0
10,"10021",5045,3932,3840,32,92,"RECORTES CE",5
22,"22048",12593,9614,9528,82,86,"RECORTES CE",24
48,"48008",615,454,448,4,6,"RECORTES CE",0
17,"17107",269,221,219,2,2,"RECORTES CE",0
7,"7034",1064,906,900,6,6,"RECORTES CE",1
22,"22187",294,244,243,2,1,"RECORTES CE",0
33,"33060",14132,9960,9794,135,166,"RECORTES CE",15
25,"25253",145,122,121,0,1,"RECORTES CE",0
46,"46042",3348,2825,2774,11,51,"RECORTES CE",1
17,"17141",6072,4251,4221,14,30,"RECORTES CE",13
39,"39063",954,726,722,4,4,"RECORTES CE",0
38,"38031",29154,22871,22598,143,273,"RECORTES CE",37
31,"31161",345,286,279,4,7,"RECORTES CE",1
46,"46184",26453,21076,20810,172,266,"RECORTES CE",20
8,"8070",266,232,232,0,0,"RECORTES CE",0
31,"31040",173,139,139,1,0,"RECORTES CE",0
22,"22174",462,381,377,0,4,"RECORTES CE",0
15,"15039",1224,874,850,11,24,"RECORTES CE",1
15,"15070",8797,6312,6173,108,139,"RECORTES CE",7
4,"4102",14110,9871,9765,90,106,"RECORTES CE",9
10,"10146",1513,1128,1104,6,24,"RECORTES CE",0
50,"50023",208,165,164,2,1,"RECORTES CE",0
17,"17200",623,512,510,1,2,"RECORTES CE",0
44,"44158",1166,921,904,7,17,"RECORTES CE",0
10,"10024",675,518,505,4,13,"RECORTES CE",2
25,"25052",1562,1273,1264,3,9,"RECORTES CE",1
35,"35034",8396,4599,4546,55,53,"RECORTES CE",11
10,"10065",200,149,149,0,0,"RECORTES CE",0
17,"17142",2673,2250,2241,14,9,"RECORTES CE",1
38,"38002",972,678,640,3,38,"RECORTES CE",2
41,"41078",2459,1910,1895,24,15,"RECORTES CE",3
32,"32009",10590,7661,7574,68,87,"RECORTES CE",9
26,"26173",6,6,6,0,0,"RECORTES CE",0
25,"25221",117,92,92,0,0,"RECORTES CE",0
10,"10107",1030,840,828,5,12,"RECORTES CE",0
26,"26056",403,334,328,2,6,"RECORTES CE",0
15,"15040",2675,2011,1979,20,32,"RECORTES CE",3
39,"39065",232,190,189,5,1,"RECORTES CE",0
36,"36001",2401,1739,1715,19,24,"RECORTES CE",1
38,"38003",1510,1058,1047,4,11,"RECORTES CE",2
4,"4068",174,134,134,0,0,"RECORTES CE",0
26,"26174",132,116,116,5,0,"RECORTES CE",0
20,"20016",1524,997,997,1,0,"RECORTES CE",1
10,"10148",32986,23987,23589,201,398,"RECORTES CE",75
25,"25222",66,57,57,0,0,"RECORTES CE",0
46,"46259",462,395,394,2,1,"RECORTES CE",1
41,"41079",9293,7137,6979,80,158,"RECORTES CE",10
46,"46096",257,220,217,0,3,"RECORTES CE",0
23,"23027",716,524,518,2,6,"RECORTES CE",1
39,"39038",1506,1093,1076,2,17,"RECORTES CE",2
8,"8901",240,203,201,1,2,"RECORTES CE",0
32,"32067",1193,827,818,10,9,"RECORTES CE",1
15,"15042",2955,2057,2002,16,55,"RECORTES CE",2
15,"15073",21760,14900,14630,181,270,"RECORTES CE",37
6,"6138",1013,783,767,3,16,"RECORTES CE",0
26,"26109",73,66,66,0,0,"RECORTES CE",0
22,"22053",786,573,567,3,6,"RECORTES CE",1
32,"32039",1142,895,890,7,5,"RECORTES CE",2
46,"46036",558,391,379,2,12,"RECORTES CE",0
36,"36003",10038,7747,7632,79,115,"RECORTES CE",13
10,"10150",331,277,272,6,5,"RECORTES CE",0
10,"10110",2224,1618,1559,5,59,"RECORTES CE",2
21,"21025",3898,2765,2705,39,60,"RECORTES CE",8
26,"26176",53,48,48,0,0,"RECORTES CE",0
27,"27026",2315,1620,1599,17,21,"RECORTES CE",0
7,"7007",414,326,324,2,2,"RECORTES CE",3
33,"33035",11226,8326,8252,112,74,"RECORTES CE",7
50,"50083",84,70,68,0,2,"RECORTES CE",0
46,"46128",1581,1324,1287,2,37,"RECORTES CE",0
23,"23060",19153,14444,14281,87,163,"RECORTES CE",6
46,"46037",1109,927,918,4,9,"RECORTES CE",0
11,"11008",17840,12434,12236,181,198,"RECORTES CE",29
25,"25224",126,98,98,0,0,"RECORTES CE",0
22,"22054",1617,1196,1183,15,13,"RECORTES CE",7
17,"17115",278,226,222,2,4,"RECORTES CE",0
20,"20049",4159,3024,3004,11,20,"RECORTES CE",1
36,"36037",2554,1839,1793,6,46,"RECORTES CE",1
39,"39040",4267,3428,3385,24,43,"RECORTES CE",6
26,"26177",301,250,246,2,4,"RECORTES CE",0
23,"23061",7691,5636,5531,51,105,"RECORTES CE",2
31,"31088",5675,4331,4285,59,46,"RECORTES CE",20
46,"46099",772,620,614,1,6,"RECORTES CE",0
7,"7009",741,554,544,4,10,"RECORTES CE",2
10,"10153",283,204,199,0,5,"RECORTES CE",0
6,"6141",1688,1308,1291,16,17,"RECORTES CE",0
33,"33006",1480,1001,992,9,9,"RECORTES CE",0
48,"48045",5194,4138,4098,25,40,"RECORTES CE",1
44,"44226",124,87,83,2,4,"RECORTES CE",0
17,"17025",1170,972,967,6,5,"RECORTES CE",1
12,"12042",574,486,479,8,7,"RECORTES CE",0
12,"12131",59,50,50,0,0,"RECORTES CE",0
21,"21028",370,300,293,1,7,"RECORTES CE",0
31,"31211",17,13,13,1,0,"RECORTES CE",0
25,"25017",232,184,181,0,3,"RECORTES CE",0
10,"10127",4706,3508,3423,23,85,"RECORTES CE",4
44,"44045",368,302,298,8,4,"RECORTES CE",0
43,"43149",684,533,533,4,0,"RECORTES CE",0
46,"46019",8948,7150,7067,40,83,"RECORTES CE",7
17,"17148",1531,1165,1153,4,12,"RECORTES CE",2
6,"6142",259,214,208,1,6,"RECORTES CE",1
43,"43142",1083,850,842,8,8,"RECORTES CE",0
22,"22057",364,286,284,3,2,"RECORTES CE",0
29,"29094",59350,42199,41749,419,450,"RECORTES CE",54
44,"44262",143,115,112,0,3,"RECORTES CE",0
38,"38039",11112,8233,8161,54,72,"RECORTES CE",21
8,"8181",8061,6442,6402,28,40,"RECORTES CE",10
6,"6143",3370,2635,2589,23,46,"RECORTES CE",1
46,"46010",950,727,718,6,9,"RECORTES CE",3
7,"7044",8791,6335,6196,66,139,"RECORTES CE",13
11,"11011",1736,1285,1249,7,36,"RECORTES CE",0
25,"25194",415,325,325,3,0,"RECORTES CE",0
8,"8155",6960,5427,5390,39,37,"RECORTES CE",9
18,"18001",230,173,170,1,3,"RECORTES CE",0
15,"15078",78678,60510,59882,621,628,"RECORTES CE",140
25,"25129",159,115,115,2,0,"RECORTES CE",0
38,"38009",4299,3105,3069,16,36,"RECORTES CE",4
46,"46903",6285,5035,4996,27,39,"RECORTES CE",4
22,"22096",320,274,272,2,2,"RECORTES CE",0
26,"26183",66,50,50,0,0,"RECORTES CE",0
46,"46011",7523,5320,5235,28,85,"RECORTES CE",1
31,"31173",846,686,674,5,12,"RECORTES CE",0
26,"26064",2337,1764,1724,14,40,"RECORTES CE",1
32,"32016",724,543,535,3,8,"RECORTES CE",0
15,"15048",5048,3791,3730,38,61,"RECORTES CE",4
44,"44264",248,175,171,0,4,"RECORTES CE",0
10,"10035",1806,1320,1282,12,38,"RECORTES CE",0
39,"39081",437,356,347,2,9,"RECORTES CE",0
38,"38041",6970,5288,5258,38,30,"RECORTES CE",10
21,"21068",962,562,550,14,12,"RECORTES CE",0
21,"21902",1144,829,824,9,5,"RECORTES CE",2
21,"21031",1172,807,764,5,43,"RECORTES CE",1
23,"23001",920,769,766,3,3,"RECORTES CE",1
27,"27001",2209,1290,1251,25,39,"RECORTES CE",1
17,"17119",73,58,58,2,0,"RECORTES CE",0
25,"25140",773,573,571,5,2,"RECORTES CE",1
36,"36042",18072,13314,13091,130,223,"RECORTES CE",26
17,"17028",297,238,237,1,1,"RECORTES CE",1
22,"22229",108,80,80,2,0,"RECORTES CE",0
10,"10118",281,242,242,2,0,"RECORTES CE",0
11,"11014",17141,11836,11705,214,131,"RECORTES CE",14
22,"22061",6583,5027,4973,51,54,"RECORTES CE",5
48,"48050",187,153,149,0,4,"RECORTES CE",0
26,"26066",259,216,212,3,4,"RECORTES CE",0
46,"46195",1982,1562,1554,2,8,"RECORTES CE",0
6,"6047",837,677,669,6,8,"RECORTES CE",0
41,"41003",2371,1801,1760,8,41,"RECORTES CE",5
10,"10119",574,458,455,0,3,"RECORTES CE",0
17,"17209",615,519,517,2,2,"RECORTES CE",2
20,"20055",17378,12565,12482,55,83,"RECORTES CE",17
10,"10160",237,189,183,3,6,"RECORTES CE",2
27,"27033",598,423,415,1,8,"RECORTES CE",0
17,"17120",820,604,598,3,6,"RECORTES CE",0
44,"44171",182,130,128,0,2,"RECORTES CE",0
46,"46135",9827,7928,7883,44,45,"RECORTES CE",12
17,"17030",650,479,477,4,2,"RECORTES CE",3
44,"44040",191,164,158,2,6,"RECORTES CE",0
11,"11016",15051,10188,10042,131,146,"RECORTES CE",12
22,"22230",288,229,228,3,1,"RECORTES CE",0
38,"38013",3019,2023,1991,12,32,"RECORTES CE",3
17,"17121",229,184,184,1,0,"RECORTES CE",0
14,"14035",5817,4373,4314,44,59,"RECORTES CE",1
8,"8158",3108,2458,2453,13,5,"RECORTES CE",6
25,"25232",1356,1066,1061,2,5,"RECORTES CE",1
6,"6049",974,732,712,7,20,"RECORTES CE",2
41,"41088",512,383,377,1,6,"RECORTES CE",1
31,"31178",472,354,348,3,6,"RECORTES CE",3
10,"10121",7914,5924,5809,36,115,"RECORTES CE",7
14,"14066",5756,4396,4310,36,86,"RECORTES CE",1
27,"27004",1149,741,722,2,19,"RECORTES CE",0
41,"41004",57465,41004,40321,571,683,"RECORTES CE",106
44,"44234",70,57,57,1,0,"RECORTES CE",0
44,"44142",28,21,21,0,0,"RECORTES CE",0
22,"22063",159,133,132,2,1,"RECORTES CE",1
17,"17031",182,130,129,0,1,"RECORTES CE",0
20,"20057",194,143,143,0,0,"RECORTES CE",0
32,"32048",864,550,544,1,6,"RECORTES CE",0
39,"39057",2367,1831,1796,14,35,"RECORTES CE",5
20,"20037",103,77,77,0,0,"RECORTES CE",0
11,"11018",1446,1126,1100,6,26,"RECORTES CE",2
50,"50007",49,34,34,0,0,"RECORTES CE",0
14,"14037",3182,2388,2319,22,69,"RECORTES CE",2
46,"46016",1075,887,880,8,7,"RECORTES CE",0
7,"7051",5414,3610,3575,37,35,"RECORTES CE",10
10,"10123",575,470,465,2,5,"RECORTES CE",0
22,"22064",162,121,121,0,0,"RECORTES CE",0
10,"10137",404,346,344,3,2,"RECORTES CE",0
35,"35018",13056,8699,8618,73,81,"RECORTES CE",30
46,"46148",1509,1208,1195,7,13,"RECORTES CE",1
20,"20058",739,555,551,4,4,"RECORTES CE",0
6,"6084",1065,904,890,8,14,"RECORTES CE",1
15,"15053",7548,5364,5309,44,55,"RECORTES CE",9
46,"46108",426,346,342,1,4,"RECORTES CE",0
8,"8014",2000,1578,1567,5,11,"RECORTES CE",2
48,"48024",999,813,811,2,2,"RECORTES CE",1
22,"22066",748,576,567,6,9,"RECORTES CE",3
15,"15054",31802,22002,21676,368,326,"RECORTES CE",51
20,"20059",8867,6792,6759,21,33,"RECORTES CE",5
50,"50008",5185,3753,3711,35,42,"RECORTES CE",13
7,"7019",164,124,124,0,0,"RECORTES CE",0
23,"23006",4582,3607,3543,32,64,"RECORTES CE",3
26,"26036",17013,12543,12354,95,189,"RECORTES CE",11
32,"32022",1238,924,916,5,8,"RECORTES CE",2
22,"22067",71,52,52,0,0,"RECORTES CE",0
6,"6152",1285,952,935,4,17,"RECORTES CE",0
31,"31101",1412,1097,1087,11,10,"RECORTES CE",8
23,"23041",491,383,382,0,1,"RECORTES CE",0
33,"33016",18904,14376,14235,168,141,"RECORTES CE",23
27,"27038",923,688,677,12,11,"RECORTES CE",0
17,"17214",723,584,580,7,4,"RECORTES CE",0
44,"44077",74,55,54,0,1,"RECORTES CE",0
39,"39060",6693,5459,5394,29,65,"RECORTES CE",5
7,"7064",5528,3793,3765,23,28,"RECORTES CE",14
4,"4097",242,184,184,0,0,"RECORTES CE",0
41,"41036",3917,2944,2885,27,59,"RECORTES CE",2
15,"15035",11208,8175,8068,105,107,"RECORTES CE",21
10,"10100",783,584,566,7,18,"RECORTES CE",0
8,"8171",2066,1607,1597,7,10,"RECORTES CE",1
46,"46211",1837,1490,1462,11,28,"RECORTES CE",0
36,"36038",66806,50974,50429,507,545,"RECORTES CE",100
44,"44237",368,299,293,2,6,"RECORTES CE",0
22,"22068",65,46,44,1,2,"RECORTES CE",0
31,"31184",65,48,46,0,2,"RECORTES CE",0
17,"17187",625,530,529,4,1,"RECORTES CE",0
36,"36018",3073,2184,2144,9,40,"RECORTES CE",2
43,"43174",144,128,127,0,1,"RECORTES CE",0
29,"29049",2926,2197,2165,9,32,"RECORTES CE",5
17,"17215",2227,1936,1925,12,11,"RECORTES CE",2
44,"44249",46,37,37,1,0,"RECORTES CE",0
50,"50011",116,100,99,0,1,"RECORTES CE",0
27,"27009",2022,1514,1488,17,26,"RECORTES CE",0
17,"17216",155,127,124,0,3,"RECORTES CE",0
26,"26115",23,21,19,0,2,"RECORTES CE",0
44,"44238",2294,1763,1743,10,20,"RECORTES CE",0
25,"25240",1385,1116,1110,10,6,"RECORTES CE",1
18,"18012",2143,1651,1634,8,17,"RECORTES CE",1
22,"22069",418,337,334,5,3,"RECORTES CE",3
6,"6088",12505,9311,9140,93,171,"RECORTES CE",9
26,"26076",116,93,91,0,2,"RECORTES CE",0
12,"12012",2613,2217,2180,6,37,"RECORTES CE",3
26,"26003",389,329,328,1,1,"RECORTES CE",0
48,"48088",133,99,98,2,1,"RECORTES CE",1
7,"7023",3757,2777,2735,43,42,"RECORTES CE",4
31,"31187",101,68,68,1,0,"RECORTES CE",0
22,"22113",470,369,369,2,0,"RECORTES CE",0
31,"31228",494,383,382,0,1,"RECORTES CE",3
33,"33049",6044,4152,4079,56,73,"RECORTES CE",2
27,"27010",4402,3015,2940,49,75,"RECORTES CE",8
50,"50254",174,123,122,0,1,"RECORTES CE",0
10,"10049",3758,3167,3086,19,81,"RECORTES CE",5
41,"41039",31500,23692,23345,234,347,"RECORTES CE",17
32,"32045",2360,1712,1689,18,23,"RECORTES CE",1
12,"12013",137,113,113,0,0,"RECORTES CE",0
25,"25072",5874,4468,4450,24,18,"RECORTES CE",4
44,"44147",398,293,286,3,7,"RECORTES CE",0
27,"27011",2358,1582,1558,12,24,"RECORTES CE",1
32,"32036",1261,954,938,9,16,"RECORTES CE",0
22,"22074",275,223,221,10,2,"RECORTES CE",0
10,"10009",263,196,193,2,3,"RECORTES CE",0
17,"17132",1333,1088,1080,9,8,"RECORTES CE",0
15,"15090",1125,811,800,7,11,"RECORTES CE",1
6,"6057",537,442,433,1,9,"RECORTES CE",0
44,"44210",743,600,594,8,6,"RECORTES CE",2
20,"20065",2943,2145,2124,11,21,"RECORTES CE",2
6,"6157",397,296,292,1,4,"RECORTES CE",0
48,"48090",6016,4700,4639,24,61,"RECORTES CE",0
12,"12014",167,131,127,1,4,"RECORTES CE",0
10,"10051",433,338,332,0,6,"RECORTES CE",2
31,"31217",334,233,225,3,8,"RECORTES CE",1
22,"22204",1119,836,832,9,4,"RECORTES CE",1
20,"20035",484,384,384,2,0,"RECORTES CE",1
21,"21046",1714,1097,1071,13,26,"RECORTES CE",2
44,"44049",796,592,578,9,14,"RECORTES CE",0
11,"11028",32791,24276,24028,279,248,"RECORTES CE",75
38,"38023",125528,88323,87456,598,867,"RECORTES CE",296
25,"25141",152,118,118,1,0,"RECORTES CE",0
27,"27013",3684,2997,2935,26,62,"RECORTES CE",5
43,"43055",1988,1631,1622,7,9,"RECORTES CE",0
44,"44181",66,58,57,0,1,"RECORTES CE",0
17,"17162",156,114,111,1,3,"RECORTES CE",0
15,"15060",5843,4360,4281,65,79,"RECORTES CE",12
21,"21010",14976,9475,9352,145,123,"RECORTES CE",11
22,"22076",288,228,226,1,2,"RECORTES CE",0
48,"48031",308,236,236,0,0,"RECORTES CE",0
17,"17040",551,465,459,4,6,"RECORTES CE",0
17,"17221",4152,3260,3247,11,13,"RECORTES CE",5
31,"31192",157,133,130,1,3,"RECORTES CE",2
41,"41014",2486,1939,1878,6,61,"RECORTES CE",0
31,"31233",93,72,70,1,2,"RECORTES CE",0
12,"12080",1900,1604,1575,10,29,"RECORTES CE",1
32,"32029",436,340,337,1,3,"RECORTES CE",0
26,"26045",11,11,11,0,0,"RECORTES CE",0
25,"25247",147,100,100,2,0,"RECORTES CE",0
30,"30007",6484,4774,4727,25,47,"RECORTES CE",6
17,"17164",3932,3078,3054,8,24,"RECORTES CE",4
48,"48002",7777,6034,5981,48,53,"RECORTES CE",8
10,"10136",285,223,223,1,0,"RECORTES CE",0
12,"12119",137,107,104,1,3,"RECORTES CE",0
23,"23070",3808,2598,2565,34,33,"RECORTES CE",6
17,"17135",395,309,307,0,2,"RECORTES CE",0
22,"22117",2414,1798,1784,18,14,"RECORTES CE",1
44,"44151",182,139,138,1,1,"RECORTES CE",0
36,"36025",2137,1387,1381,7,6,"RECORTES CE",5
11,"11031",76294,54123,53583,589,540,"RECORTES CE",134
10,"10028",82,60,59,0,1,"RECORTES CE",0
17,"17052",134,104,104,1,0,"RECORTES CE",0
32,"32086",2563,1699,1686,19,13,"RECORTES CE",0
23,"23028",6131,4696,4635,24,61,"RECORTES CE",5
20,"20068",188,142,142,1,0,"RECORTES CE",0
10,"10218",1083,810,796,3,14,"RECORTES CE",0
27,"27016",6973,5139,5064,66,75,"RECORTES CE",10
17,"17042",408,313,311,0,2,"RECORTES CE",0
22,"22167",473,392,384,4,8,"RECORTES CE",0
17,"17136",195,156,155,0,1,"RECORTES CE",0
11,"11032",54469,33144,32810,461,334,"RECORTES CE",55
32,"32031",1014,764,756,5,8,"RECORTES CE",2
46,"46027",932,769,755,1,14,"RECORTES CE",4
10,"10179",277,220,219,0,1,"RECORTES CE",0
10,"10219",1212,814,806,8,8,"RECORTES CE",1
10,"10056",532,434,428,3,6,"RECORTES CE",0
7,"7030",1590,1234,1202,8,32,"RECORTES CE",1
41,"41016",7767,5937,5829,56,108,"RECORTES CE",3
8,"8223",1886,1434,1425,4,9,"RECORTES CE",3
32,"32032",7932,5956,5831,55,125,"RECORTES CE",7
6,"6096",207,168,167,1,1,"RECORTES CE",1
26,"26012",33,28,26,0,2,"RECORTES CE",0
33,"33026",8270,5540,5474,69,66,"RECORTES CE",3
31,"31196",31,28,28,0,0,"RECORTES CE",1
35,"35001",4571,3523,3463,8,60,"RECORTES CE",8
21,"21051",221,180,177,1,3,"RECORTES CE",0
20,"20050",270,186,183,3,3,"RECORTES CE",0
25,"25904",162,147,147,3,0,"RECORTES CE",2
22,"22094",98,72,71,2,1,"RECORTES CE",0
20,"20071",15036,11090,11025,59,65,"RECORTES CE",16
11,"11009",580,429,420,2,9,"RECORTES CE",1
10,"10099",559,412,401,3,11,"RECORTES CE",0
50,"50038",1405,1112,1099,13,13,"RECORTES CE",3
39,"39079",8861,6827,6745,47,82,"RECORTES CE",6
6,"6087",2030,1592,1571,16,21,"RECORTES CE",1
8,"8023",6915,5339,5299,26,40,"RECORTES CE",10
46,"46009",3140,2582,2536,14,46,"RECORTES CE",4
10,"10059",325,234,232,1,2,"RECORTES CE",0
10,"10903",796,623,614,4,9,"RECORTES CE",1
8,"8251",5127,3972,3940,17,32,"RECORTES CE",4
10,"10141",289,224,223,0,1,"RECORTES CE",0
31,"31198",37,32,32,0,0,"RECORTES CE",0
17,"17168",379,332,329,0,3,"RECORTES CE",0
44,"44105",69,54,54,1,0,"RECORTES CE",0
22,"22213",2923,2261,2221,24,40,"RECORTES CE",1
31,"31118",158,120,116,2,4,"RECORTES CE",1
17,"17226",895,673,669,3,4,"RECORTES CE",0
38,"38029",1493,839,823,5,16,"RECORTES CE",1
10,"10142",840,641,639,5,2,"RECORTES CE",0
41,"41092",7679,5668,5568,61,100,"RECORTES CE",5
31,"31254",1920,1457,1435,8,22,"RECORTES CE",4
41,"41084",2815,2177,2111,3,66,"RECORTES CE",0
10,"10156",100,78,78,0,0,"RECORTES CE",0
21,"21054",8157,6002,5869,60,133,"RECORTES CE",9
10,"10183",958,748,735,3,13,"RECORTES CE",3
15,"15068",4849,3435,3392,55,43,"RECORTES CE",6
27,"27020",3380,2764,2713,32,51,"RECORTES CE",0
39,"39006",1721,1332,1315,3,17,"RECORTES CE",2
48,"48068",1528,1218,1211,5,7,"RECORTES CE",0
36,"36030",3946,2847,2810,26,37,"RECORTES CE",5
7,"7001",3628,2792,2753,18,39,"RECORTES CE",4
39,"39034",257,167,162,2,5,"RECORTES CE",1
11,"11001",4342,2928,2870,32,58,"RECORTES CE",4
44,"44136",51,43,43,1,0,"RECORTES CE",0
17,"17208",976,772,768,5,4,"RECORTES CE",3
23,"23065",1550,1199,1186,4,13,"RECORTES CE",0
14,"14063",1000,767,757,4,10,"RECORTES CE",1
26,"26105",2211,1744,1723,19,21,"RECORTES CE",2
29,"29008",15183,10716,10555,93,161,"RECORTES CE",15
44,"44028",171,140,138,1,2,"RECORTES CE",0
27,"27031",15212,10826,10649,125,177,"RECORTES CE",22
31,"31202",4345,3132,3085,36,47,"RECORTES CE",9
10,"10023",791,619,614,1,5,"RECORTES CE",0
48,"48069",13094,10021,9954,49,67,"RECORTES CE",10
44,"44252",75,56,56,1,0,"RECORTES CE",0
38,"38032",13536,9924,9867,63,57,"RECORTES CE",40
21,"21057",995,631,629,3,2,"RECORTES CE",0
17,"17109",698,558,553,1,5,"RECORTES CE",1
48,"48039",256,218,217,1,1,"RECORTES CE",3
23,"23056",3062,2332,2281,13,51,"RECORTES CE",3
36,"36032",3537,2676,2626,16,50,"RECORTES CE",3
26,"26172",25,23,23,0,0,"RECORTES CE",0
8,"8254",1753,1485,1482,3,3,"RECORTES CE",0
22,"22040",144,124,120,1,4,"RECORTES CE",0
7,"7015",21976,14458,14297,205,161,"RECORTES CE",28
46,"46165",7298,5744,5697,38,47,"RECORTES CE",12
8,"8044",4136,3193,3175,11,18,"RECORTES CE",4
17,"17230",499,397,393,0,4,"RECORTES CE",0
4,"4103",1439,1120,1108,16,12,"RECORTES CE",1
33,"33032",11086,8028,7849,129,179,"RECORTES CE",11
14,"14055",18446,13919,13711,148,208,"RECORTES CE",17
25,"25255",395,321,318,2,3,"RECORTES CE",0
27,"27023",2470,1833,1797,20,36,"RECORTES CE",1
4,"4901",494,381,378,0,3,"RECORTES CE",0
46,"46034",1811,1407,1389,13,18,"RECORTES CE",1
22,"22176",170,136,135,0,1,"RECORTES CE",0
38,"38033",3594,2512,2467,11,45,"RECORTES CE",1
44,"44159",37,32,32,1,0,"RECORTES CE",0
15,"15072",9436,6962,6860,60,102,"RECORTES CE",16
8,"8098",2409,1916,1912,9,4,"RECORTES CE",4
12,"12090",104,85,83,1,2,"RECORTES CE",0
23,"23092",27662,21206,20981,170,225,"RECORTES CE",22
25,"25154",118,94,94,0,0,"RECORTES CE",0
4,"4902",45395,31127,30881,251,246,"RECORTES CE",28
43,"43015",119,101,101,0,0,"RECORTES CE",0
17,"17144",210,171,170,0,1,"RECORTES CE",0
41,"41096",6134,4926,4845,44,81,"RECORTES CE",4
7,"7039",4970,3557,3489,36,68,"RECORTES CE",9
50,"50025",4516,3417,3364,35,53,"RECORTES CE",5
17,"17112",194,154,152,2,2,"RECORTES CE",0
44,"44258",53,44,44,0,0,"RECORTES CE",0
27,"27066",12633,9139,8911,84,228,"RECORTES CE",16
8,"8013",1280,1040,1031,5,9,"RECORTES CE",0
7,"7061",9564,6678,6583,67,95,"RECORTES CE",11
22,"22178",103,84,84,2,0,"RECORTES CE",0
41,"41052",3027,2357,2288,14,69,"RECORTES CE",2
8,"8021",61,47,45,0,2,"RECORTES CE",0
4,"4903",4308,3102,3075,17,27,"RECORTES CE",3
10,"10190",521,372,361,2,11,"RECORTES CE",0
48,"48013",79423,59100,58630,458,470,"RECORTES CE",124
22,"22150",461,368,362,1,6,"RECORTES CE",0
26,"26034",612,509,497,5,12,"RECORTES CE",1
48,"48043",4539,3566,3556,22,10,"RECORTES CE",3
22,"22222",517,407,398,5,9,"RECORTES CE",1
50,"50026",421,340,328,4,12,"RECORTES CE",1
17,"17145",1432,1113,1103,7,10,"RECORTES CE",2
36,"36046",4043,3157,3084,27,73,"RECORTES CE",6
39,"39068",649,515,509,7,6,"RECORTES CE",0
41,"41025",2019,1492,1439,7,53,"RECORTES CE",0
21,"21062",1386,893,885,15,8,"RECORTES CE",3
10,"10029",380,320,315,1,5,"RECORTES CE",0
17,"17146",3127,2404,2381,11,23,"RECORTES CE",8
8,"8022",12219,9089,9038,42,51,"RECORTES CE",3
10,"10192",767,625,614,1,11,"RECORTES CE",0
35,"35010",3797,2601,2572,9,29,"RECORTES CE",3
31,"31087",181,136,135,6,1,"RECORTES CE",1
22,"22044",234,184,183,3,1,"RECORTES CE",1
17,"17195",342,296,295,3,1,"RECORTES CE",0
17,"17137",3467,2925,2912,15,13,"RECORTES CE",0
22,"22223",74,63,63,1,0,"RECORTES CE",0
36,"36005",8122,5895,5776,65,119,"RECORTES CE",8
17,"17084",231,181,180,1,1,"RECORTES CE",0
11,"11903",1791,1234,1211,16,23,"RECORTES CE",3
6,"6075",475,379,369,2,10,"RECORTES CE",0
44,"44261",722,584,578,8,6,"RECORTES CE",0
27,"27027",1806,1392,1354,18,38,"RECORTES CE",3
10,"10207",464,349,340,3,9,"RECORTES CE",1
17,"17065",324,254,253,0,1,"RECORTES CE",0
44,"44092",70,56,55,1,1,"RECORTES CE",0
8,"8101",174954,129953,129198,680,755,"RECORTES CE",354
32,"32004",1671,907,899,7,8,"RECORTES CE",0
17,"17138",845,650,646,0,4,"RECORTES CE",0
46,"46029",20423,15450,15274,100,176,"RECORTES CE",23
10,"10140",1082,868,855,8,13,"RECORTES CE",1
41,"41064",5611,3763,3667,47,96,"RECORTES CE",2
10,"10168",320,209,202,1,7,"RECORTES CE",0
43,"43003",350,266,264,3,2,"RECORTES CE",0
44,"44165",173,136,135,2,1,"RECORTES CE",0
8,"8024",357,301,298,1,3,"RECORTES CE",0
10,"10032",1596,1263,1243,5,20,"RECORTES CE",2
15,"15014",3836,2739,2698,38,41,"RECORTES CE",5
36,"36007",1618,1163,1133,7,30,"RECORTES CE",1
44,"44197",50,35,35,0,0,"RECORTES CE",0
21,"21077",1725,1307,1286,10,21,"RECORTES CE",0
31,"31091",327,224,224,1,0,"RECORTES CE",0
20,"20901",1412,1034,1030,2,4,"RECORTES CE",0
23,"23032",523,443,439,1,4,"RECORTES CE",1
50,"50039",467,366,364,3,2,"RECORTES CE",0
50,"50001",88,71,70,0,1,"RECORTES CE",0
26,"26103",827,655,645,3,10,"RECORTES CE",0
17,"17159",626,487,483,1,4,"RECORTES CE",0
8,"8059",344,292,290,2,2,"RECORTES CE",1
8,"8243",156,139,139,0,0,"RECORTES CE",1
32,"32044",809,625,617,2,8,"RECORTES CE",0
31,"31213",100,69,68,0,1,"RECORTES CE",0
7,"7012",1909,1358,1343,15,15,"RECORTES CE",1
44,"44263",377,296,285,3,11,"RECORTES CE",2
23,"23064",1678,1413,1404,10,9,"RECORTES CE",1
25,"25196",112,94,93,0,1,"RECORTES CE",0
21,"21079",687,503,500,5,3,"RECORTES CE",0
17,"17178",1056,804,798,3,6,"RECORTES CE",0
33,"33069",3419,2557,2533,32,24,"RECORTES CE",1
10,"10198",1071,945,924,3,21,"RECORTES CE",0
18,"18013",4152,3168,3103,16,65,"RECORTES CE",3
10,"10090",494,364,357,6,7,"RECORTES CE",0
17,"17130",322,268,268,0,0,"RECORTES CE",0
25,"25228",3115,2468,2459,19,9,"RECORTES CE",1
50,"50012",96,79,79,1,0,"RECORTES CE",0
39,"39053",213,146,145,2,1,"RECORTES CE",0
21,"21043",1857,1465,1424,7,41,"RECORTES CE",2
32,"32073",1281,941,932,9,9,"RECORTES CE",0
7,"7057",7404,5117,5028,50,89,"RECORTES CE",5
44,"44085",49,31,31,0,0,"RECORTES CE",0
17,"17180",8500,6462,6431,28,31,"RECORTES CE",5
17,"17058",170,139,139,0,0,"RECORTES CE",0
50,"50004",478,380,376,2,4,"RECORTES CE",1
8,"8026",193,161,161,1,0,"RECORTES CE",0
50,"50032",242,179,176,1,3,"RECORTES CE",0
25,"25908",221,159,158,1,1,"RECORTES CE",0
8,"8027",720,592,588,3,4,"RECORTES CE",2
44,"44230",152,112,111,1,1,"RECORTES CE",0
10,"10037",76855,60447,59702,451,745,"RECORTES CE",134
41,"41902",4600,3141,3092,48,49,"RECORTES CE",3
43,"43169",450,396,396,3,0,"RECORTES CE",1
31,"31258",7879,6189,6140,57,49,"RECORTES CE",35
44,"44109",102,71,70,1,1,"RECORTES CE",0
18,"18015",425,333,333,0,0,"RECORTES CE",0
33,"33041",7112,5251,5194,63,57,"RECORTES CE",5
21,"21033",561,428,427,4,1,"RECORTES CE",1
32,"32046",1098,793,782,5,11,"RECORTES CE",0
36,"36010",2828,2217,2184,15,33,"RECORTES CE",1
17,"17152",11026,7610,7564,70,46,"RECORTES CE",12
17,"17070",110,94,94,0,0,"RECORTES CE",0
35,"35016",300503,203470,201240,1598,2230,"RECORTES CE",638
32,"32047",1746,1272,1252,6,20,"RECORTES CE",1
32,"32075",4382,3546,3489,35,57,"RECORTES CE",3
8,"8028",1088,783,780,2,3,"RECORTES CE",2
38,"38044",2199,1443,1429,10,14,"RECORTES CE",1
22,"22105",101,82,82,4,0,"RECORTES CE",0
15,"15082",15381,11803,11642,133,161,"RECORTES CE",31
36,"36044",2539,1768,1708,18,60,"RECORTES CE",5
6,"6082",393,314,305,5,9,"RECORTES CE",0
26,"26108",290,241,237,0,4,"RECORTES CE",0
20,"20056",4075,2983,2942,12,41,"RECORTES CE",4
43,"43178",1421,1118,1113,7,5,"RECORTES CE",0
26,"26069",230,187,186,0,1,"RECORTES CE",0
23,"23069",5262,4395,4329,15,66,"RECORTES CE",4
10,"10162",528,430,424,2,6,"RECORTES CE",0
48,"48082",37396,27913,27694,172,219,"RECORTES CE",49
10,"10040",434,321,314,1,7,"RECORTES CE",0
22,"22106",20,15,15,0,0,"RECORTES CE",0
44,"44268",32,30,30,0,0,"RECORTES CE",0
17,"17011",651,544,544,4,0,"RECORTES CE",1
22,"22164",43,33,31,0,2,"RECORTES CE",0
17,"17051",207,174,173,3,1,"RECORTES CE",0
22,"22207",121,78,78,1,0,"RECORTES CE",0
10,"10163",339,275,269,0,6,"RECORTES CE",0
36,"36015",4076,2903,2834,37,69,"RECORTES CE",1
18,"18006",4087,3109,3042,28,67,"RECORTES CE",2
39,"39076",3483,2770,2734,21,36,"RECORTES CE",1
27,"27005",2551,1908,1868,26,40,"RECORTES CE",5
43,"43065",382,308,304,1,4,"RECORTES CE",0
26,"26059",1122,861,841,7,20,"RECORTES CE",0
7,"7029",4366,3270,3229,25,41,"RECORTES CE",4
33,"33034",10043,6765,6671,69,94,"RECORTES CE",13
20,"20048",184,120,120,2,0,"RECORTES CE",0
25,"25234",4201,3087,3072,13,15,"RECORTES CE",1
33,"33024",225188,169937,168490,1483,1447,"RECORTES CE",382
8,"8030",5209,4318,4305,16,13,"RECORTES CE",4
32,"32049",689,468,462,3,6,"RECORTES CE",0
25,"25168",488,408,407,6,1,"RECORTES CE",0
39,"39077",236,175,173,0,2,"RECORTES CE",0
38,"38047",1756,1276,1259,6,17,"RECORTES CE",1
27,"27037",1017,759,748,10,11,"RECORTES CE",0
25,"25203",8798,6279,6231,26,48,"RECORTES CE",4
32,"32050",2280,1788,1775,19,13,"RECORTES CE",1
8,"8258",813,661,657,6,4,"RECORTES CE",1
10,"10152",446,354,350,2,4,"RECORTES CE",0
6,"6107",1570,1117,1106,9,11,"RECORTES CE",0
46,"46051",8384,6550,6452,24,98,"RECORTES CE",5
26,"26112",223,177,174,0,3,"RECORTES CE",0
46,"46048",3509,2758,2720,11,38,"RECORTES CE",0
22,"22109",266,207,205,3,2,"RECORTES CE",1
7,"7020",3692,2833,2808,42,25,"RECORTES CE",7
6,"6119",681,551,547,1,4,"RECORTES CE",0
23,"23073",4389,3400,3363,13,37,"RECORTES CE",4
27,"27049",1342,934,921,11,13,"RECORTES CE",0
6,"6097",2283,1803,1762,10,41,"RECORTES CE",0
35,"35011",24705,17099,16823,129,276,"RECORTES CE",33
7,"7031",24784,16683,16527,160,156,"RECORTES CE",31
14,"14029",4029,3089,3039,15,50,"RECORTES CE",4
31,"31238",115,101,100,2,1,"RECORTES CE",0
17,"17225",207,161,161,0,0,"RECORTES CE",0
20,"20030",21198,15734,15654,100,80,"RECORTES CE",23
33,"33050",558,381,375,2,6,"RECORTES CE",0
20,"20081",7655,5629,5601,22,28,"RECORTES CE",3
31,"31022",483,349,345,3,4,"RECORTES CE",0
27,"27040",3035,2285,2234,19,51,"RECORTES CE",1
17,"17006",1186,880,878,10,2,"RECORTES CE",1
31,"31076",2520,2110,2094,21,16,"RECORTES CE",8
10,"10209",265,184,184,2,0,"RECORTES CE",0
44,"44208",26,22,22,0,0,"RECORTES CE",0
23,"23053",9449,6379,6325,25,54,"RECORTES CE",5
10,"10904",722,549,543,7,6,"RECORTES CE",0
41,"41046",3006,2464,2427,13,37,"RECORTES CE",0
41,"41037",3192,2505,2479,15,26,"RECORTES CE",4
17,"17106",143,124,123,0,1,"RECORTES CE",0
22,"22172",520,412,407,3,5,"RECORTES CE",0
26,"26154",10,10,10,1,0,"RECORTES CE",0
44,"44177",101,75,75,1,0,"RECORTES CE",0
22,"22908",188,133,131,0,2,"RECORTES CE",1
17,"17206",155,118,115,0,3,"RECORTES CE",1
50,"50030",201,138,136,1,2,"RECORTES CE",0
35,"35022",51302,33009,32566,198,443,"RECORTES CE",82
22,"22242",63,47,45,1,2,"RECORTES CE",0
50,"50021",25,23,23,1,0,"RECORTES CE",0
22,"22214",118,98,97,1,1,"RECORTES CE",0
27,"27051",8012,5936,5832,70,104,"RECORTES CE",7
36,"36054",11074,8032,7873,77,159,"RECORTES CE",12
10,"10061",1598,1126,1114,5,12,"RECORTES CE",0
31,"31904",1561,1139,1130,7,9,"RECORTES CE",3
21,"21006",3329,2307,2262,20,45,"RECORTES CE",5
44,"44116",76,62,62,0,0,"RECORTES CE",0
23,"23054",376,296,289,1,7,"RECORTES CE",0
46,"46001",783,612,607,4,5,"RECORTES CE",1
43,"43077",455,342,339,2,3,"RECORTES CE",0
44,"44209",815,606,592,2,14,"RECORTES CE",1
50,"50003",119,95,95,1,0,"RECORTES CE",0
41,"41102",14750,10972,10677,110,295,"RECORTES CE",14
50,"50031",139,97,90,0,7,"RECORTES CE",0
18,"18002",526,400,400,0,0,"RECORTES CE",0
33,"33030",873,678,671,1,7,"RECORTES CE",0
17,"17019",1784,1472,1462,3,10,"RECORTES CE",1
18,"18014",6898,5262,5162,43,100,"RECORTES CE",8
21,"21072",10227,7947,7739,98,208,"RECORTES CE",15
8,"8113",52518,39750,39592,198,158,"RECORTES CE",41
17,"17098",303,245,245,2,0,"RECORTES CE",0
10,"10172",696,517,513,0,4,"RECORTES CE",0
22,"22001",214,162,162,0,0,"RECORTES CE",0
17,"17069",364,286,284,2,2,"RECORTES CE",1
25,"25110",2731,2121,2106,14,15,"RECORTES CE",2
36,"36052",7234,5292,5151,44,141,"RECORTES CE",3
8,"8220",2411,2119,2115,13,4,"RECORTES CE",1
46,"46043",135,119,116,1,3,"RECORTES CE",0
23,"23063",3764,2812,2781,22,31,"RECORTES CE",1
6,"6146",1048,837,819,4,18,"RECORTES CE",0
6,"6113",2677,2117,2076,13,41,"RECORTES CE",1
7,"7026",30991,19827,19602,161,225,"RECORTES CE",61
31,"31232",25574,19124,18913,236,211,"RECORTES CE",67
46,"46145",22099,16685,16499,128,186,"RECORTES CE",15
39,"39083",1074,786,777,4,9,"RECORTES CE",0
22,"22002",106,95,94,0,1,"RECORTES CE",0
7,"7037",3357,2142,2120,16,22,"RECORTES CE",6
27,"27044",2719,1848,1797,29,51,"RECORTES CE",0
14,"14045",3013,2508,2468,13,40,"RECORTES CE",2
31,"31191",3018,2365,2337,22,28,"RECORTES CE",5
23,"23026",3450,2625,2573,17,52,"RECORTES CE",0
17,"17204",596,461,460,2,1,"RECORTES CE",1
35,"35026",82764,55647,54846,499,801,"RECORTES CE",135
22,"22206",182,145,145,0,0,"RECORTES CE",0
25,"25175",176,135,135,1,0,"RECORTES CE",0
18,"18016",308,232,231,5,1,"RECORTES CE",0
38,"38901",1456,1024,1010,9,14,"RECORTES CE",4
10,"10066",161,141,137,0,4,"RECORTES CE",0
17,"17192",146,121,120,0,1,"RECORTES CE",0
46,"46116",13608,10792,10731,76,61,"RECORTES CE",12
23,"23015",1332,1066,1048,4,18,"RECORTES CE",0
23,"23048",820,644,636,1,8,"RECORTES CE",1
41,"41042",5849,4730,4692,20,38,"RECORTES CE",2
39,"39085",6964,5489,5445,28,44,"RECORTES CE",4
17,"17193",4312,3202,3179,15,23,"RECORTES CE",7
10,"10149",434,308,304,2,4,"RECORTES CE",0
48,"48083",6946,5238,5201,35,37,"RECORTES CE",4
8,"8224",878,697,695,1,2,"RECORTES CE",1
12,"12007",731,649,642,8,7,"RECORTES CE",0
26,"26046",1571,1185,1157,18,28,"RECORTES CE",4
12,"12138",19179,14217,14006,124,211,"RECORTES CE",15
22,"22247",30,21,21,0,0,"RECORTES CE",0
17,"17101",562,415,413,2,2,"RECORTES CE",0
6,"6061",1084,915,905,8,10,"RECORTES CE",0
31,"31031",220,158,157,1,1,"RECORTES CE",1
26,"26149",45,36,36,0,0,"RECORTES CE",1
31,"31005",281,202,201,5,1,"RECORTES CE",1
14,"14074",2237,1859,1839,8,20,"RECORTES CE",0
46,"46006",4468,3731,3683,22,48,"RECORTES CE",0
26,"26098",99,77,77,1,0,"RECORTES CE",0
26,"26063",118,96,95,2,1,"RECORTES CE",1
48,"48033",204,160,159,1,1,"RECORTES CE",0
25,"25177",358,270,268,1,2,"RECORTES CE",0
20,"20038",380,296,295,0,1,"RECORTES CE",0
46,"46251",2442,2017,1976,9,41,"RECORTES CE",4
25,"25046",407,349,347,1,2,"RECORTES CE",0
23,"23050",90596,69591,68903,460,688,"RECORTES CE",92
39,"39087",41381,32335,31995,194,340,"RECORTES CE",27
32,"32087",1675,1313,1288,18,25,"RECORTES CE",1
33,"33076",12147,8532,8452,104,80,"RECORTES CE",11
6,"6140",611,515,506,1,9,"RECORTES CE",0
43,"43020",2276,1831,1819,12,12,"RECORTES CE",1
20,"20012",148,113,112,0,1,"RECORTES CE",0
44,"44216",26922,20603,20279,204,324,"RECORTES CE",43
14,"14039",2575,2037,1990,14,47,"RECORTES CE",1
22,"22209",159,139,136,5,3,"RECORTES CE",0
26,"26060",75,60,60,1,0,"RECORTES CE",1
10,"10139",95,78,77,1,1,"RECORTES CE",0
17,"17085",291,248,246,0,2,"RECORTES CE",0
12,"12083",89,73,71,1,2,"RECORTES CE",0
32,"32069",4256,3358,3309,39,49,"RECORTES CE",4
17,"17176",123,110,110,1,0,"RECORTES CE",0
44,"44206",103,83,82,0,1,"RECORTES CE",1
8,"8153",559,460,458,2,2,"RECORTES CE",0
32,"32060",765,577,567,2,10,"RECORTES CE",3
41,"41054",713,596,588,4,8,"RECORTES CE",0
31,"31035",50,34,32,0,2,"RECORTES CE",0
39,"39091",1885,1512,1503,6,9,"RECORTES CE",1
10,"10185",573,463,460,3,3,"RECORTES CE",0
44,"44114",238,188,184,1,4,"RECORTES CE",0
8,"8032",2087,1607,1598,9,9,"RECORTES CE",4
25,"25070",811,677,675,4,2,"RECORTES CE",0
41,"41091",539730,412509,408312,3804,4197,"RECORTES CE",588
46,"46070",17700,13558,13437,115,121,"RECORTES CE",9
27,"27050",2842,2100,2072,19,28,"RECORTES CE",1
17,"17117",14471,10565,10504,52,61,"RECORTES CE",15
22,"22184",168,142,139,2,3,"RECORTES CE",0
20,"20907",117,88,87,0,1,"RECORTES CE",0
44,"44066",87,66,65,0,1,"RECORTES CE",0
30,"30042",2180,1727,1703,6,24,"RECORTES CE",0
23,"23035",1103,903,882,6,21,"RECORTES CE",0
36,"36039",15610,11844,11592,103,252,"RECORTES CE",22
35,"35031",7412,5593,5519,41,74,"RECORTES CE",14
12,"12022",328,273,269,1,4,"RECORTES CE",0
31,"31037",90,72,72,0,0,"RECORTES CE",0
22,"22201",266,192,192,2,0,"RECORTES CE",0
17,"17036",2643,2076,2071,12,5,"RECORTES CE",1
17,"17118",12916,9521,9460,37,61,"RECORTES CE",17
6,"6110",137,106,105,0,1,"RECORTES CE",0
35,"35013",6584,5067,4974,49,93,"RECORTES CE",7
8,"8009",9480,7649,7620,35,29,"RECORTES CE",13
48,"48081",1883,1532,1518,3,14,"RECORTES CE",2
46,"46004",1919,1641,1616,14,25,"RECORTES CE",2
17,"17149",364,314,314,0,0,"RECORTES CE",0
12,"12056",257,218,216,1,2,"RECORTES CE",0
8,"8094",1586,1310,1306,10,4,"RECORTES CE",1
43,"43085",235,198,194,0,4,"RECORTES CE",0
20,"20023",446,299,299,1,0,"RECORTES CE",1
48,"48048",543,421,419,1,2,"RECORTES CE",0
10,"10211",447,345,343,2,2,"RECORTES CE",0
17,"17173",182,156,156,0,0,"RECORTES CE",1
32,"32054",86475,64472,63712,676,760,"RECORTES CE",74
17,"17068",246,194,193,0,1,"RECORTES CE",1
12,"12106",1163,980,951,7,29,"RECORTES CE",0
8,"8112",12935,9822,9765,74,57,"RECORTES CE",6
17,"17217",353,312,311,1,1,"RECORTES CE",0
7,"7046",16718,10573,10469,94,104,"RECORTES CE",26
46,"46005",23013,17487,17286,112,201,"RECORTES CE",37
25,"25004",575,470,467,2,3,"RECORTES CE",0
25,"25183",535,419,416,4,3,"RECORTES CE",0
46,"46154",797,645,630,1,15,"RECORTES CE",1
43,"43112",250,204,204,1,0,"RECORTES CE",0
17,"17079",65381,50872,50631,242,241,"RECORTES CE",47
6,"6101",442,359,354,2,5,"RECORTES CE",0
11,"11039",9945,6824,6726,111,98,"RECORTES CE",5
22,"22049",74,63,63,0,0,"RECORTES CE",0
23,"23002",17399,13575,13341,97,234,"RECORTES CE",15
33,"33017",2997,2096,2058,29,38,"RECORTES CE",2
22,"22226",771,598,591,6,7,"RECORTES CE",1
8,"8154",701,587,586,5,1,"RECORTES CE",1
10,"10196",294,231,231,2,0,"RECORTES CE",0
23,"23067",2421,1909,1873,13,36,"RECORTES CE",3
10,"10147",1283,1038,1007,4,31,"RECORTES CE",5
22,"22175",184,139,137,1,2,"RECORTES CE",0
22,"22050",93,79,79,2,0,"RECORTES CE",0
10,"10093",393,313,303,4,10,"RECORTES CE",0
31,"31001",80,63,63,0,0,"RECORTES CE",0
17,"17081",248,192,190,0,2,"RECORTES CE",0
10,"10188",478,387,379,0,8,"RECORTES CE",0
48,"48010",474,368,368,0,0,"RECORTES CE",2
17,"17213",5535,3998,3985,20,13,"RECORTES CE",4
8,"8042",2362,1910,1904,7,6,"RECORTES CE",1
44,"44001",65,51,50,0,1,"RECORTES CE",0
17,"17172",457,352,349,1,3,"RECORTES CE",0
44,"44193",69,57,56,1,1,"RECORTES CE",0
6,"6004",1549,1276,1257,6,19,"RECORTES CE",2
36,"36034",3319,2384,2347,16,37,"RECORTES CE",4
14,"14005",6318,4464,4380,59,84,"RECORTES CE",4
32,"32038",399,274,271,3,3,"RECORTES CE",0
39,"39013",535,434,431,1,3,"RECORTES CE",0
23,"23058",8817,6964,6873,48,91,"RECORTES CE",7
8,"8004",209,194,191,0,3,"RECORTES CE",0
17,"17202",3813,2876,2851,8,25,"RECORTES CE",5
6,"6104",656,530,524,6,6,"RECORTES CE",0
48,"48011",9652,7293,7251,37,42,"RECORTES CE",18
33,"33074",3376,2345,2311,41,34,"RECORTES CE",3
41,"41082",3359,2760,2718,11,42,"RECORTES CE",1
41,"41011",15454,11892,11591,160,301,"RECORTES CE",14
10,"10176",347,266,261,2,5,"RECORTES CE",0
21,"21048",313,243,237,4,6,"RECORTES CE",0
6,"6160",3019,2252,2209,10,43,"RECORTES CE",41
33,"33023",3271,2448,2397,35,51,"RECORTES CE",2
26,"26022",187,153,148,0,5,"RECORTES CE",0
41,"41097",3135,2355,2308,11,47,"RECORTES CE",0
33,"33064",250,175,174,0,1,"RECORTES CE",0
36,"36035",14571,11096,10917,105,179,"RECORTES CE",17
44,"44179",325,233,231,7,2,"RECORTES CE",0
17,"17234",179,147,146,2,1,"RECORTES CE",0
33,"33007",1398,960,951,9,9,"RECORTES CE",2
31,"31107",1680,1330,1312,16,18,"RECORTES CE",3
26,"26168",5515,4130,4077,36,53,"RECORTES CE",9
41,"41090",3507,2766,2694,15,72,"RECORTES CE",1
6,"6150",780,637,635,2,2,"RECORTES CE",1
15,"15074",3919,2865,2808,33,57,"RECORTES CE",8
27,"27058",3322,2551,2512,22,39,"RECORTES CE",2
20,"20079",18142,14055,13971,75,84,"RECORTES CE",9
22,"22905",287,226,224,2,2,"RECORTES CE",0
32,"32012",716,497,487,7,10,"RECORTES CE",0
25,"25126",284,233,232,1,1,"RECORTES CE",0
46,"46007",12284,9370,9265,65,105,"RECORTES CE",16
25,"25227",664,517,517,1,0,"RECORTES CE",0
50,"50014",119,85,85,0,0,"RECORTES CE",1
50,"50002",125,96,91,1,5,"RECORTES CE",0
7,"7902",1091,776,743,10,33,"RECORTES CE",3
46,"46200",1848,1560,1539,6,21,"RECORTES CE",0
36,"36017",17419,12867,12610,120,257,"RECORTES CE",14
33,"33005",1376,929,916,14,13,"RECORTES CE",1
44,"44212",41,32,32,0,0,"RECORTES CE",0
10,"10086",303,249,244,3,5,"RECORTES CE",0
31,"31224",875,684,677,10,7,"RECORTES CE",0
25,"25216",241,199,199,2,0,"RECORTES CE",0
48,"48035",404,334,331,2,3,"RECORTES CE",0
21,"21064",6641,4689,4597,66,92,"RECORTES CE",5
35,"35017",27216,17531,17102,133,429,"RECORTES CE",31
6,"6156",1171,919,901,10,18,"RECORTES CE",0
46,"46015",7477,5857,5808,33,49,"RECORTES CE",8
22,"22039",805,667,662,5,5,"RECORTES CE",3
50,"50270",38,32,30,1,2,"RECORTES CE",0
33,"33040",4566,3205,3150,50,55,"RECORTES CE",10
6,"6153",20240,15464,15210,134,254,"RECORTES CE",15
21,"21040",3181,2303,2227,21,76,"RECORTES CE",5
26,"26074",107,97,96,2,1,"RECORTES CE",0
32,"32014",1045,775,769,5,6,"RECORTES CE",0
48,"48056",989,791,785,4,6,"RECORTES CE",1
36,"36029",16086,12196,12005,126,191,"RECORTES CE",11
25,"25905",369,308,307,1,1,"RECORTES CE",0
26,"26050",130,97,97,0,0,"RECORTES CE",0
41,"41049",9493,7463,7312,78,151,"RECORTES CE",6
26,"26106",76,66,65,0,1,"RECORTES CE",0
10,"10155",1082,825,819,4,6,"RECORTES CE",1
31,"31903",6862,4962,4915,31,47,"RECORTES CE",23
46,"46020",3792,3028,2973,11,55,"RECORTES CE",0
41,"41065",22550,16215,16010,189,205,"RECORTES CE",23
22,"22058",191,157,157,3,0,"RECORTES CE",0
33,"33048",136,87,87,1,0,"RECORTES CE",0
23,"23075",3220,2559,2524,18,35,"RECORTES CE",2
36,"36019",1463,1041,1030,14,11,"RECORTES CE",0
21,"21030",1879,1523,1504,14,19,"RECORTES CE",0
6,"6048",824,714,702,2,12,"RECORTES CE",0
48,"48074",3273,2480,2460,14,20,"RECORTES CE",6
17,"17090",544,469,468,0,1,"RECORTES CE",0
44,"44110",37,33,33,0,0,"RECORTES CE",0
41,"41060",15100,11304,11105,113,199,"RECORTES CE",14
6,"6111",493,374,370,2,4,"RECORTES CE",0
36,"36051",14315,10396,10223,70,173,"RECORTES CE",10
46,"46031",10521,7735,7607,62,128,"RECORTES CE",7
43,"43053",188,153,149,0,4,"RECORTES CE",1
50,"50027",224,170,165,1,5,"RECORTES CE",0
17,"17163",2824,2358,2351,13,7,"RECORTES CE",0
32,"32057",514,367,365,5,2,"RECORTES CE",0
11,"11025",4388,3092,3045,30,47,"RECORTES CE",6
44,"44239",22,19,19,0,0,"RECORTES CE",0
41,"41061",2144,1763,1712,7,51,"RECORTES CE",1
41,"41035",1060,803,788,8,15,"RECORTES CE",0
25,"25075",131,102,102,0,0,"RECORTES CE",0
7,"7050",3442,2303,2275,28,28,"RECORTES CE",6
22,"22233",80,50,50,0,0,"RECORTES CE",0
41,"41058",17860,12850,12598,152,252,"RECORTES CE",17
22,"22160",212,171,170,3,1,"RECORTES CE",0
46,"46023",328,277,269,1,8,"RECORTES CE",0
8,"8035",12871,9574,9538,31,36,"RECORTES CE",14
36,"36009",4445,3081,2997,26,84,"RECORTES CE",5
20,"20904",89,50,49,0,1,"RECORTES CE",0
31,"31216",3871,2861,2832,32,29,"RECORTES CE",11
41,"41077",8631,6441,6289,46,152,"RECORTES CE",10
35,"35005",1017,751,743,1,8,"RECORTES CE",0
48,"48080",9946,7574,7499,46,75,"RECORTES CE",15
22,"22084",555,438,433,5,5,"RECORTES CE",0
48,"48037",684,537,531,4,6,"RECORTES CE",0
26,"26079",620,526,521,0,5,"RECORTES CE",0
46,"46024",444,339,335,1,4,"RECORTES CE",1
12,"12005",8052,6056,5935,50,121,"RECORTES CE",12
8,"8157",8547,6949,6918,39,31,"RECORTES CE",39
41,"41031",1215,866,848,3,18,"RECORTES CE",0
21,"21021",12469,8238,8097,76,141,"RECORTES CE",9
31,"31907",11205,9216,9140,121,76,"RECORTES CE",39
39,"39046",1343,1002,988,8,14,"RECORTES CE",0
44,"44010",184,137,137,1,0,"RECORTES CE",0
36,"36036",2556,1953,1914,14,39,"RECORTES CE",4
36,"36040",2517,1895,1853,18,42,"RECORTES CE",5
7,"7011",28642,19567,19396,147,171,"RECORTES CE",45
41,"41019",4895,3518,3462,36,56,"RECORTES CE",5
22,"22227",199,155,154,1,1,"RECORTES CE",0
27,"27034",1025,647,636,4,11,"RECORTES CE",0
6,"6015",117934,87081,86114,785,967,"RECORTES CE",128
31,"31137",198,106,103,3,3,"RECORTES CE",0
20,"20006",254,169,169,0,0,"RECORTES CE",0
10,"10076",793,597,585,4,12,"RECORTES CE",0
44,"44175",113,84,82,1,2,"RECORTES CE",0
22,"22080",264,208,202,2,6,"RECORTES CE",0
10,"10081",184,142,140,4,2,"RECORTES CE",0
32,"32076",1974,1492,1472,17,20,"RECORTES CE",3
44,"44035",105,86,84,1,2,"RECORTES CE",0
25,"25044",178,145,144,6,1,"RECORTES CE",0
25,"25211",672,513,512,6,1,"RECORTES CE",1
44,"44129",36,29,29,0,0,"RECORTES CE",0
22,"22215",128,91,91,1,0,"RECORTES CE",0
12,"12100",1281,1118,1102,5,16,"RECORTES CE",0
23,"23903",3499,2738,2714,7,24,"RECORTES CE",2
26,"26162",112,95,94,0,1,"RECORTES CE",0
11,"11038",13613,10879,10676,101,203,"RECORTES CE",22
21,"21012",286,238,233,4,5,"RECORTES CE",5
6,"6050",4042,3246,3163,27,83,"RECORTES CE",1
36,"36045",24478,18627,18327,157,300,"RECORTES CE",43
23,"23074",2971,2410,2378,8,32,"RECORTES CE",1
25,"25059",813,621,612,3,9,"RECORTES CE",0
30,"30021",9441,6664,6591,32,73,"RECORTES CE",10
44,"44222",122,102,102,1,0,"RECORTES CE",0
32,"32064",480,348,346,2,2,"RECORTES CE",0
46,"46040",995,807,794,7,13,"RECORTES CE",0
48,"48067",1134,877,872,5,5,"RECORTES CE",0
14,"14048",1189,948,933,5,15,"RECORTES CE",1
17,"17004",533,445,441,3,4,"RECORTES CE",1
6,"6117",1401,1089,1067,6,22,"RECORTES CE",1
41,"41062",2175,1763,1746,8,17,"RECORTES CE",0
33,"33075",253,139,135,1,4,"RECORTES CE",0
25,"25135",1000,773,769,2,4,"RECORTES CE",1
33,"33022",813,555,543,6,12,"RECORTES CE",0
10,"10011",532,439,435,3,4,"RECORTES CE",0
46,"46241",389,318,313,4,5,"RECORTES CE",2
46,"46196",140,115,114,0,1,"RECORTES CE",0
25,"25153",192,152,150,1,2,"RECORTES CE",0
41,"41047",10411,8348,8242,84,106,"RECORTES CE",16
48,"48055",2596,2023,2005,12,18,"RECORTES CE",3
22,"22199",6926,5113,5051,44,62,"RECORTES CE",6
43,"43050",2634,1881,1868,13,13,"RECORTES CE",3
31,"31124",207,151,150,2,1,"RECORTES CE",1
21,"21059",220,184,180,0,4,"RECORTES CE",0
22,"22902",208,160,156,0,4,"RECORTES CE",1
26,"26126",29,29,29,1,0,"RECORTES CE",0
25,"25225",541,427,420,4,7,"RECORTES CE",0
26,"26040",63,51,50,0,1,"RECORTES CE",0
27,"27043",1219,814,797,6,17,"RECORTES CE",1
25,"25901",287,209,207,1,2,"RECORTES CE",0
48,"48052",1567,1309,1300,4,9,"RECORTES CE",1
46,"46086",80,69,69,0,0,"RECORTES CE",0
25,"25219",149,118,118,1,0,"RECORTES CE",0
21,"21044",17955,11674,11479,136,195,"RECORTES CE",75
48,"48029",8613,6697,6642,52,55,"RECORTES CE",15
21,"21056",2922,2307,2228,27,79,"RECORTES CE",2
8,"8016",1812,1454,1448,6,6,"RECORTES CE",1
22,"22200",239,181,178,0,3,"RECORTES CE",1
23,"23031",765,659,647,4,12,"RECORTES CE",0
26,"26119",177,150,147,2,3,"RECORTES CE",0
21,"21032",1801,1401,1378,8,23,"RECORTES CE",0
26,"26111",250,209,205,2,4,"RECORTES CE",1
17,"17201",143,120,120,0,0,"RECORTES CE",0
27,"27029",1427,1068,1047,13,21,"RECORTES CE",3
44,"44266",102,89,86,1,3,"RECORTES CE",0
22,"22095",65,57,56,1,1,"RECORTES CE",0
26,"26051",210,178,176,1,2,"RECORTES CE",0
10,"10174",171,129,127,0,2,"RECORTES CE",0
39,"39061",3488,2833,2798,18,35,"RECORTES CE",6
23,"23037",520,431,425,6,6,"RECORTES CE",0
6,"6011",24665,18486,18253,178,233,"RECORTES CE",25
39,"39071",422,318,316,0,2,"RECORTES CE",0
46,"46035",6855,5500,5422,34,78,"RECORTES CE",4
22,"22193",269,220,217,2,3,"RECORTES CE",0
31,"31011",709,515,511,4,4,"RECORTES CE",5
33,"33039",1641,1251,1243,6,8,"RECORTES CE",1
17,"17143",144,115,115,0,0,"RECORTES CE",0
46,"46021",23977,18032,17879,125,153,"RECORTES CE",30
15,"15047",2269,1531,1497,25,34,"RECORTES CE",2
11,"11029",5423,3161,3105,55,56,"RECORTES CE",5
21,"21063",2620,2037,1992,11,45,"RECORTES CE",2
41,"41007",12438,9009,8775,135,234,"RECORTES CE",8
25,"25913",86,77,77,0,0,"RECORTES CE",0
8,"8020",5172,4337,4327,26,10,"RECORTES CE",6
20,"20036",13192,9864,9806,67,58,"RECORTES CE",14
15,"15007",3179,2333,2304,22,29,"RECORTES CE",3
14,"14043",7408,5721,5619,76,102,"RECORTES CE",4
10,"10194",524,440,435,4,5,"RECORTES CE",0
10,"10166",313,211,202,0,9,"RECORTES CE",0
50,"50016",44,31,31,0,0,"RECORTES CE",0
12,"12016",1550,1281,1260,11,21,"RECORTES CE",0
17,"17228",285,229,229,1,0,"RECORTES CE",0
43,"43078",843,653,644,4,9,"RECORTES CE",0
26,"26171",156,131,127,0,4,"RECORTES CE",0
44,"44019",68,42,42,0,0,"RECORTES CE",0
6,"6024",1133,963,941,5,22,"RECORTES CE",0
31,"31103",39,27,27,0,0,"RECORTES CE",0
44,"44146",170,148,146,3,2,"RECORTES CE",0
46,"46258",2636,2100,2079,9,21,"RECORTES CE",4
8,"8126",8865,7125,7098,33,27,"RECORTES CE",13
18,"18004",687,521,515,4,6,"RECORTES CE",0
26,"26017",354,293,290,4,3,"RECORTES CE",1
41,"41074",2998,2364,2322,17,42,"RECORTES CE",0
10,"10200",341,262,261,0,1,"RECORTES CE",0
21,"21045",227,181,178,1,3,"RECORTES CE",0
26,"26047",1879,1569,1549,10,20,"RECORTES CE",2
7,"7059",3035,2257,2226,13,31,"RECORTES CE",2
21,"21050",12522,8425,8312,84,113,"RECORTES CE",16
44,"44256",34,32,32,1,0,"RECORTES CE",0
17,"17191",166,145,144,2,1,"RECORTES CE",0
43,"43141",105,86,86,0,0,"RECORTES CE",0
26,"26037",131,99,98,1,1,"RECORTES CE",0
43,"43083",144,116,113,1,3,"RECORTES CE",0
20,"20080",7709,5629,5588,28,41,"RECORTES CE",7
31,"31069",830,639,638,3,1,"RECORTES CE",2
17,"17047",4968,3447,3429,22,18,"RECORTES CE",4
44,"44172",295,220,218,4,2,"RECORTES CE",1
44,"44150",26,21,21,0,0,"RECORTES CE",0
10,"10170",239,180,179,1,1,"RECORTES CE",0
11,"11005",4520,3212,3128,23,84,"RECORTES CE",5
41,"41032",3843,3018,2944,17,74,"RECORTES CE",0
7,"7049",1480,1092,1075,10,17,"RECORTES CE",1
6,"6041",457,381,374,5,7,"RECORTES CE",0
50,"50041",17,14,14,0,0,"RECORTES CE",0
50,"50022",504,396,386,11,10,"RECORTES CE",0
31,"31067",1896,1418,1397,17,21,"RECORTES CE",5
10,"10134",553,396,392,2,4,"RECORTES CE",0
31,"31021",60,47,47,3,0,"RECORTES CE",0
6,"6149",10203,8194,8051,72,143,"RECORTES CE",5
14,"14036",3676,2850,2766,40,84,"RECORTES CE",1
41,"41033",4965,3634,3580,27,54,"RECORTES CE",3
23,"23024",12224,9586,9329,46,257,"RECORTES CE",10
33,"33018",2819,2072,2044,28,28,"RECORTES CE",4
44,"44048",53,47,47,0,0,"RECORTES CE",1
46,"46050",186,157,154,1,3,"RECORTES CE",0
41,"41024",22737,15687,15398,167,289,"RECORTES CE",16
23,"23029",806,651,637,0,14,"RECORTES CE",0
6,"6136",1510,1189,1160,7,29,"RECORTES CE",1
17,"17901",983,790,789,3,1,"RECORTES CE",2
10,"10053",279,226,224,5,2,"RECORTES CE",0
48,"48051",216,157,157,0,0,"RECORTES CE",0
21,"21066",495,401,396,4,5,"RECORTES CE",0
36,"36006",11468,8959,8782,66,177,"RECORTES CE",18
41,"41101",6016,4524,4480,42,44,"RECORTES CE",2
23,"23086",11442,8618,8431,80,187,"RECORTES CE",33
44,"44128",59,46,45,0,1,"RECORTES CE",0
10,"10124",858,710,701,3,9,"RECORTES CE",0
44,"44060",37,28,28,0,0,"RECORTES CE",0
11,"11902",3656,2427,2383,29,44,"RECORTES CE",3
39,"39056",2268,1847,1830,7,17,"RECORTES CE",1
39,"39084",874,718,712,4,6,"RECORTES CE",0
11,"11041",9858,6916,6763,70,153,"RECORTES CE",9
26,"26095",95,78,78,1,0,"RECORTES CE",0
14,"14901",915,795,782,8,13,"RECORTES CE",0
22,"22062",154,115,115,1,0,"RECORTES CE",0
8,"8182",2892,2217,2204,18,13,"RECORTES CE",1
17,"17140",639,539,527,4,12,"RECORTES CE",0
10,"10122",220,171,164,0,7,"RECORTES CE",0
33,"33028",1158,635,630,6,5,"RECORTES CE",0
22,"22203",76,61,61,0,0,"RECORTES CE",0
33,"33053",1079,738,729,6,9,"RECORTES CE",0
8,"8190",258,216,215,1,1,"RECORTES CE",0
44,"44117",319,263,256,5,7,"RECORTES CE",0
17,"17175",564,381,381,1,0,"RECORTES CE",1
17,"17157",124,107,107,0,0,"RECORTES CE",0
36,"36016",1064,707,696,7,11,"RECORTES CE",0
46,"46047",532,447,441,4,6,"RECORTES CE",0
17,"17233",2328,1924,1912,6,12,"RECORTES CE",0
26,"26021",2752,2132,2105,10,27,"RECORTES CE",2
39,"39073",10200,8230,8150,65,80,"RECORTES CE",3
8,"8011",1745,1414,1407,10,7,"RECORTES CE",0
8,"8211",33731,27698,27561,126,137,"RECORTES CE",41
17,"17155",14861,10307,10234,52,73,"RECORTES CE",19
7,"7025",446,363,362,4,1,"RECORTES CE",0
23,"23047",1579,1260,1247,13,13,"RECORTES CE",3
8,"8033",13218,10480,10435,50,45,"RECORTES CE",13
35,"35020",5933,4140,4088,14,52,"RECORTES CE",2
36,"36043",4682,3345,3303,17,42,"RECORTES CE",9
10,"10205",1965,1344,1300,8,44,"RECORTES CE",2
48,"48091",1090,862,857,9,5,"RECORTES CE",1
31,"31190",45,41,41,4,0,"RECORTES CE",0
17,"17027",2866,2375,2364,8,11,"RECORTES CE",1
43,"43071",891,713,706,6,7,"RECORTES CE",1
31,"31042",2695,2071,2043,21,28,"RECORTES CE",8
43,"43159",81,63,62,0,1,"RECORTES CE",0
41,"41028",2071,1741,1713,18,28,"RECORTES CE",0
12,"12008",224,197,194,1,3,"RECORTES CE",0
41,"41021",21397,15585,15334,201,251,"RECORTES CE",19
17,"17071",1128,978,978,3,0,"RECORTES CE",0
17,"17133",1273,1048,1043,7,5,"RECORTES CE",1
46,"46045",1243,1033,1018,3,15,"RECORTES CE",3
46,"46055",1284,1031,1021,2,10,"RECORTES CE",5
46,"46054",11390,8717,8604,52,113,"RECORTES CE",12
22,"22086",209,157,155,1,2,"RECORTES CE",0
23,"23051",2727,2060,2023,5,37,"RECORTES CE",2
10,"10203",4428,3212,3152,25,60,"RECORTES CE",6
33,"33037",33247,23529,23210,297,319,"RECORTES CE",49
21,"21022",186,132,129,0,3,"RECORTES CE",1
31,"31056",185,141,134,3,7,"RECORTES CE",0
46,"46033",196,169,168,3,1,"RECORTES CE",0
41,"41095",39970,27911,27583,389,328,"RECORTES CE",70
17,"17199",6955,5328,5308,23,20,"RECORTES CE",4
6,"6037",1668,1137,1125,6,12,"RECORTES CE",0
17,"17033",5587,4157,4130,13,27,"RECORTES CE",1
21,"21074",2698,1979,1945,15,34,"RECORTES CE",3
41,"41085",4170,3337,3270,27,67,"RECORTES CE",4
10,"10164",720,474,461,3,13,"RECORTES CE",0
23,"23079",3639,2859,2818,20,41,"RECORTES CE",0
23,"23057",732,613,611,4,2,"RECORTES CE",0
41,"41050",5180,4217,4149,34,68,"RECORTES CE",3
32,"32065",630,478,474,5,4,"RECORTES CE",1
27,"27030",3134,2209,2162,27,47,"RECORTES CE",3
17,"17232",149,117,116,0,1,"RECORTES CE",0
23,"23003",8644,6604,6523,36,81,"RECORTES CE",8
11,"11020",166423,117732,116448,1427,1284,"RECORTES CE",316
46,"46063",1783,1368,1345,9,23,"RECORTES CE",1
10,"10145",125,106,104,1,2,"RECORTES CE",0
30,"30036",15256,10884,10703,56,181,"RECORTES CE",17
8,"8109",208,184,183,0,1,"RECORTES CE",0
36,"36033",12244,9553,9358,80,195,"RECORTES CE",20
15,"15075",12785,9638,9519,121,119,"RECORTES CE",14
43,"43023",214,186,186,1,0,"RECORTES CE",1
26,"26120",1460,1130,1109,3,21,"RECORTES CE",1
32,"32008",8572,6301,6216,65,85,"RECORTES CE",11
48,"48020",272959,203643,202331,1472,1312,"RECORTES CE",387
46,"46236",937,764,755,5,9,"RECORTES CE",1
11,"11019",1753,1353,1295,7,58,"RECORTES CE",2
50,"50024",556,427,426,6,1,"RECORTES CE",0
44,"44071",585,449,447,6,2,"RECORTES CE",0
11,"11004",89545,60056,59323,741,733,"RECORTES CE",140
29,"29088",2694,2019,1951,31,68,"RECORTES CE",0
44,"44138",118,90,89,2,1,"RECORTES CE",0
32,"32084",902,636,631,2,5,"RECORTES CE",0
41,"41006",2738,1971,1945,16,26,"RECORTES CE",1
49,"49058",298,244,242,1,2,"RECORTES CE",0
37,"37180",68,39,39,1,0,"RECORTES CE",0
34,"34224",42,30,29,0,1,"RECORTES CE",0
24,"24176",299,243,238,3,5,"RECORTES CE",0
24,"24067",606,375,371,2,4,"RECORTES CE",0
34,"34068",29,24,23,0,1,"RECORTES CE",0
19,"19308",60,57,57,1,0,"RECORTES CE",0
28,"28164",3202,2553,2530,19,23,"RECORTES CE",4
47,"47123",461,391,390,3,1,"RECORTES CE",1
5,"5061",261,214,208,0,6,"RECORTES CE",0
47,"47007",4036,3261,3217,25,44,"RECORTES CE",6
19,"19044",284,226,223,1,3,"RECORTES CE",1
24,"24109",876,635,619,3,16,"RECORTES CE",0
24,"24040",412,322,320,2,2,"RECORTES CE",0
2,"2074",5891,4435,4375,41,60,"RECORTES CE",5
37,"37132",325,232,231,0,1,"RECORTES CE",0
16,"16132",34,26,26,0,0,"RECORTES CE",1
5,"5101",277,224,222,0,2,"RECORTES CE",0
40,"40206",162,132,128,2,4,"RECORTES CE",0
42,"42092",62,42,41,1,1,"RECORTES CE",0
37,"37290",134,113,112,0,1,"RECORTES CE",0
16,"16091",64,46,46,1,0,"RECORTES CE",0
13,"13025",296,260,256,1,4,"RECORTES CE",0
9,"9358",248,186,179,1,7,"RECORTES CE",0
5,"5012",121,100,97,0,3,"RECORTES CE",0
49,"49194",340,236,233,3,3,"RECORTES CE",0
16,"16906",71,52,52,1,0,"RECORTES CE",0
28,"28078",40,37,37,0,0,"RECORTES CE",0
40,"40062",57,49,49,0,0,"RECORTES CE",0
42,"42079",21,18,18,1,0,"RECORTES CE",0
42,"42205",85,64,62,0,2,"RECORTES CE",0
9,"9214",641,454,445,5,9,"RECORTES CE",0
16,"16152",32,28,28,1,0,"RECORTES CE",0
49,"49050",504,351,351,3,0,"RECORTES CE",0
34,"34047",1738,1439,1420,8,19,"RECORTES CE",3
24,"24060",574,371,369,1,2,"RECORTES CE",0
47,"47101",1644,1354,1337,9,17,"RECORTES CE",0
5,"5118",68,44,43,0,1,"RECORTES CE",0
24,"24206",1611,1286,1268,7,18,"RECORTES CE",2
34,"34036",238,199,198,1,1,"RECORTES CE",1
40,"40138",2127,1729,1696,18,33,"RECORTES CE",1
5,"5184",240,207,204,1,3,"RECORTES CE",0
34,"34051",91,81,79,0,2,"RECORTES CE",0
16,"16067",119,96,93,2,3,"RECORTES CE",0
40,"40055",32,26,25,0,1,"RECORTES CE",0
19,"19086",1392,1095,1083,7,12,"RECORTES CE",3
28,"28031",2140,1642,1614,11,28,"RECORTES CE",0
49,"49024",637,465,461,2,4,"RECORTES CE",0
34,"34074",683,545,540,4,5,"RECORTES CE",2
5,"5142",90,83,81,0,2,"RECORTES CE",0
34,"34025",53,37,37,2,0,"RECORTES CE",0
9,"9274",1045,875,867,8,8,"RECORTES CE",2
19,"19115",32,23,23,0,0,"RECORTES CE",0
49,"49156",230,189,182,0,7,"RECORTES CE",0
47,"47194",292,245,243,1,2,"RECORTES CE",1
45,"45041",3897,2959,2904,28,55,"RECORTES CE",4
9,"9311",59,47,46,0,1,"RECORTES CE",0
49,"49241",240,199,199,1,0,"RECORTES CE",0
5,"5198",71,51,51,0,0,"RECORTES CE",0
24,"24146",251,206,204,1,2,"RECORTES CE",0
2,"2001",695,567,559,3,8,"RECORTES CE",0
19,"19248",76,56,56,0,0,"RECORTES CE",0
28,"28170",2487,1840,1810,10,30,"RECORTES CE",3
19,"19333",105,74,73,1,1,"RECORTES CE",0
13,"13042",888,699,686,2,13,"RECORTES CE",0
24,"24005",345,255,250,2,5,"RECORTES CE",0
40,"40161",35,28,26,0,2,"RECORTES CE",0
42,"42062",20,14,13,0,1,"RECORTES CE",0
2,"2082",95,83,83,0,0,"RECORTES CE",0
40,"40218",84,62,62,0,0,"RECORTES CE",1
9,"9449",92,75,74,1,1,"RECORTES CE",0
45,"45078",1328,1152,1133,6,19,"RECORTES CE",0
34,"34066",57,52,48,1,4,"RECORTES CE",1
37,"37126",30,26,26,0,0,"RECORTES CE",0
49,"49201",285,243,243,7,0,"RECORTES CE",0
28,"28047",42847,33561,33215,216,346,"RECORTES CE",79
45,"45039",208,176,176,0,0,"RECORTES CE",0
9,"9001",30,27,27,0,0,"RECORTES CE",0
24,"24223",2540,1971,1929,37,42,"RECORTES CE",3
24,"24149",146,123,123,0,0,"RECORTES CE",0
19,"19250",15,13,13,0,0,"RECORTES CE",0
37,"37258",137,99,98,1,1,"RECORTES CE",0
42,"42003",66,55,55,0,0,"RECORTES CE",0
40,"40201",43,39,37,0,2,"RECORTES CE",0
19,"19109",33,30,30,1,0,"RECORTES CE",0
42,"42058",102,84,84,0,0,"RECORTES CE",0
24,"24031",210,180,176,0,4,"RECORTES CE",0
5,"5209",75,58,57,0,1,"RECORTES CE",0
47,"47126",44,42,42,1,0,"RECORTES CE",0
45,"45011",275,241,238,2,3,"RECORTES CE",0
9,"9047",54,46,45,0,1,"RECORTES CE",0
40,"40103",146,125,123,0,2,"RECORTES CE",0
37,"37074",140,107,106,1,1,"RECORTES CE",0
28,"28169",1553,1280,1273,15,7,"RECORTES CE",2
45,"45144",740,605,598,7,7,"RECORTES CE",1
13,"13049",747,566,553,4,13,"RECORTES CE",0
47,"47228",439,353,352,1,1,"RECORTES CE",0
37,"37042",41,32,31,1,1,"RECORTES CE",0
42,"42178",101,75,75,0,0,"RECORTES CE",0
9,"9343",93,73,72,1,1,"RECORTES CE",0
34,"34032",37,34,34,1,0,"RECORTES CE",0
37,"37207",325,260,258,1,2,"RECORTES CE",2
5,"5242",686,588,585,11,3,"RECORTES CE",1
28,"28053",6840,5797,5739,32,58,"RECORTES CE",13
49,"49090",193,153,151,0,2,"RECORTES CE",0
45,"45075",124,93,90,0,3,"RECORTES CE",0
28,"28171",4382,3202,3134,11,68,"RECORTES CE",3
40,"40034",75,63,62,1,1,"RECORTES CE",0
16,"16098",520,441,439,6,2,"RECORTES CE",0
37,"37177",265,209,208,0,1,"RECORTES CE",0
19,"19071",8155,6327,6242,35,85,"RECORTES CE",29
37,"37279",726,570,562,6,8,"RECORTES CE",1
40,"40039",180,147,144,1,3,"RECORTES CE",0
2,"2006",561,482,480,2,2,"RECORTES CE",0
34,"34135",399,320,315,4,5,"RECORTES CE",0
24,"24020",434,302,299,1,3,"RECORTES CE",0
37,"37310",172,125,124,3,1,"RECORTES CE",0
42,"42119",145,90,89,6,1,"RECORTES CE",1
19,"19196",90,77,70,1,7,"RECORTES CE",0
19,"19007",435,328,319,1,9,"RECORTES CE",0
37,"37256",195,152,150,0,2,"RECORTES CE",1
47,"47215",48,44,44,0,0,"RECORTES CE",0
28,"28059",4515,3573,3542,12,31,"RECORTES CE",7
24,"24117",412,336,335,0,1,"RECORTES CE",0
9,"9438",561,485,473,6,12,"RECORTES CE",2
16,"16060",722,571,560,3,11,"RECORTES CE",0
34,"34190",49,36,36,3,0,"RECORTES CE",0
37,"37040",382,319,316,1,3,"RECORTES CE",0
9,"9334",48,37,35,0,2,"RECORTES CE",1
34,"34089",140,119,114,2,5,"RECORTES CE",0
5,"5103",66,48,48,0,0,"RECORTES CE",0
42,"42094",603,484,475,10,9,"RECORTES CE",0
2,"2019",2368,2009,1975,5,34,"RECORTES CE",2
34,"34050",185,156,156,2,0,"RECORTES CE",1
9,"9149",34,27,27,0,0,"RECORTES CE",0
47,"47113",142,117,117,1,0,"RECORTES CE",0
45,"45008",142,121,121,0,0,"RECORTES CE",0
40,"40088",268,200,200,0,0,"RECORTES CE",0
49,"49209",474,338,334,4,4,"RECORTES CE",1
9,"9102",33,26,25,0,1,"RECORTES CE",0
42,"42168",108,85,85,1,0,"RECORTES CE",0
49,"49271",181,147,144,1,3,"RECORTES CE",0
19,"19309",21,18,17,0,1,"RECORTES CE",0
24,"24002",233,183,183,1,0,"RECORTES CE",0
19,"19006",757,556,548,7,8,"RECORTES CE",1
2,"2081",18331,14219,13987,108,232,"RECORTES CE",16
42,"42200",76,54,53,0,1,"RECORTES CE",0
37,"37146",102,86,86,1,0,"RECORTES CE",0
40,"40194",39191,31175,30785,250,390,"RECORTES CE",51
9,"9048",1380,1070,1039,8,31,"RECORTES CE",3
2,"2042",818,631,620,1,11,"RECORTES CE",0
37,"37355",162,137,135,0,2,"RECORTES CE",0
42,"42039",210,147,141,2,6,"RECORTES CE",0
45,"45035",293,228,223,1,5,"RECORTES CE",1
47,"47102",264,217,211,1,6,"RECORTES CE",0
16,"16157",190,163,161,1,2,"RECORTES CE",0
24,"24125",421,298,289,2,9,"RECORTES CE",0
16,"16111",163,125,122,1,3,"RECORTES CE",0
34,"34019",110,92,91,2,1,"RECORTES CE",0
34,"34056",1949,1537,1511,7,26,"RECORTES CE",6
19,"19222",96,73,72,2,1,"RECORTES CE",0
9,"9354",33,29,29,2,0,"RECORTES CE",0
19,"19126",1687,1306,1285,9,21,"RECORTES CE",5
9,"9460",167,149,149,5,0,"RECORTES CE",0
45,"45069",1817,1460,1438,4,22,"RECORTES CE",0
24,"24079",872,671,665,4,6,"RECORTES CE",0
28,"28135",985,762,756,1,6,"RECORTES CE",0
16,"16014",563,444,443,4,1,"RECORTES CE",0
49,"49048",114,85,85,0,0,"RECORTES CE",0
19,"19189",115,93,92,0,1,"RECORTES CE",3
9,"9034",292,239,238,2,1,"RECORTES CE",0
28,"28034",370,284,280,0,4,"RECORTES CE",0
19,"19121",264,219,217,0,2,"RECORTES CE",0
40,"40108",110,91,90,0,1,"RECORTES CE",1
49,"49260",700,558,548,8,10,"RECORTES CE",1
47,"47232",100,76,76,1,0,"RECORTES CE",0
37,"37001",172,133,133,0,0,"RECORTES CE",0
28,"28165",1910,1443,1430,11,13,"RECORTES CE",2
40,"40234",376,307,299,2,8,"RECORTES CE",1
9,"9179",38,32,32,0,0,"RECORTES CE",0
40,"40012",238,178,175,4,3,"RECORTES CE",0
24,"24197",736,556,552,7,4,"RECORTES CE",0
28,"28091",5474,4027,3977,26,50,"RECORTES CE",2
9,"9151",445,358,354,3,4,"RECORTES CE",1
34,"34099",52,45,41,0,4,"RECORTES CE",0
9,"9443",152,115,112,0,3,"RECORTES CE",0
24,"24084",152,113,113,0,0,"RECORTES CE",0
37,"37253",133,107,103,0,4,"RECORTES CE",0
49,"49162",175,134,131,1,3,"RECORTES CE",1
37,"37083",176,160,156,1,4,"RECORTES CE",0
47,"47112",2570,2098,2075,13,23,"RECORTES CE",0
45,"45076",564,389,388,2,1,"RECORTES CE",0
28,"28002",3281,2481,2455,24,26,"RECORTES CE",2
49,"49079",103,91,79,1,12,"RECORTES CE",0
40,"40068",22,21,21,0,0,"RECORTES CE",0
37,"37262",69,60,60,0,0,"RECORTES CE",0
37,"37024",88,69,69,0,0,"RECORTES CE",0
28,"28107",442,336,325,3,11,"RECORTES CE",1
13,"13071",38130,27060,26802,237,258,"RECORTES CE",49
24,"24081",122,91,88,0,3,"RECORTES CE",0
16,"16904",451,386,383,3,3,"RECORTES CE",0
47,"47134",148,127,126,6,1,"RECORTES CE",0
16,"16195",458,368,364,3,4,"RECORTES CE",2
5,"5099",457,392,389,2,3,"RECORTES CE",0
24,"24011",189,122,121,1,1,"RECORTES CE",0
37,"37292",94,76,73,1,3,"RECORTES CE",0
28,"28168",1329,976,969,3,7,"RECORTES CE",1
42,"42196",8,6,6,0,0,"RECORTES CE",0
45,"45092",223,204,204,1,0,"RECORTES CE",0
42,"42218",75,52,51,0,1,"RECORTES CE",0
9,"9138",87,74,72,2,2,"RECORTES CE",1
24,"24008",9025,6803,6702,79,101,"RECORTES CE",7
5,"5041",995,776,767,3,9,"RECORTES CE",2
19,"19244",74,54,54,0,0,"RECORTES CE",0
42,"42046",46,35,33,2,2,"RECORTES CE",0
37,"37278",789,618,613,8,5,"RECORTES CE",0
40,"40213",95,83,80,1,3,"RECORTES CE",0
24,"24066",449,329,324,3,5,"RECORTES CE",0
45,"45003",550,435,431,4,4,"RECORTES CE",0
47,"47089",132,116,115,1,1,"RECORTES CE",0
9,"9046",24,19,19,0,0,"RECORTES CE",0
24,"24001",168,105,104,0,1,"RECORTES CE",0
19,"19059",74,53,46,0,7,"RECORTES CE",1
5,"5216",213,166,165,0,1,"RECORTES CE",0
47,"47003",204,171,168,4,3,"RECORTES CE",0
47,"47206",78,64,64,0,0,"RECORTES CE",0
47,"47213",108,84,84,0,0,"RECORTES CE",0
47,"47097",307,258,256,4,2,"RECORTES CE",0
47,"47058",202,154,153,3,1,"RECORTES CE",1
45,"45112",1841,1250,1220,7,30,"RECORTES CE",1
47,"47065",817,658,653,2,5,"RECORTES CE",0
47,"47217",1973,1569,1541,19,28,"RECORTES CE",3
19,"19279",51,44,44,0,0,"RECORTES CE",0
19,"19238",44,30,30,1,0,"RECORTES CE",0
13,"13036",766,626,617,0,9,"RECORTES CE",1
2,"2009",19456,15229,15007,152,222,"RECORTES CE",14
40,"40207",800,662,652,6,10,"RECORTES CE",0
47,"47017",198,162,160,1,2,"RECORTES CE",0
16,"16225",59,40,40,0,0,"RECORTES CE",0
49,"49075",134,118,114,1,4,"RECORTES CE",0
34,"34146",53,47,46,0,1,"RECORTES CE",0
34,"34199",1159,910,880,7,30,"RECORTES CE",1
9,"9190",86,68,67,0,1,"RECORTES CE",0
9,"9277",107,92,89,0,3,"RECORTES CE",1
34,"34049",329,251,247,5,4,"RECORTES CE",1
19,"19212",674,528,519,2,9,"RECORTES CE",1
42,"42105",46,37,37,1,0,"RECORTES CE",0
37,"37189",114,88,88,2,0,"RECORTES CE",0
9,"9189",126,102,96,0,6,"RECORTES CE",0
16,"16084",50,36,32,0,4,"RECORTES CE",1
47,"47214",1364,1112,1074,7,38,"RECORTES CE",1
37,"37312",244,198,197,1,1,"RECORTES CE",0
16,"16158",511,428,417,4,11,"RECORTES CE",0
24,"24114",2893,2017,1989,17,28,"RECORTES CE",1
49,"49095",279,221,217,0,4,"RECORTES CE",0
2,"2049",796,582,574,1,8,"RECORTES CE",1
49,"49009",389,305,304,2,1,"RECORTES CE",0
40,"40230",95,70,67,0,3,"RECORTES CE",1
37,"37257",49,40,40,1,0,"RECORTES CE",0
47,"47177",100,80,79,0,1,"RECORTES CE",0
16,"16005",232,175,172,0,3,"RECORTES CE",1
42,"42184",56,42,41,1,1,"RECORTES CE",0
49,"49028",105,94,93,1,1,"RECORTES CE",0
16,"16219",81,64,63,0,1,"RECORTES CE",0
9,"9159",61,52,51,0,1,"RECORTES CE",1
9,"9003",184,143,142,2,1,"RECORTES CE",2
5,"5087",149,112,111,1,1,"RECORTES CE",0
37,"37317",288,240,238,2,2,"RECORTES CE",0
2,"2022",344,252,252,1,0,"RECORTES CE",0
37,"37251",107,79,79,1,0,"RECORTES CE",0
2,"2035",1946,1592,1576,15,16,"RECORTES CE",4
37,"37297",401,319,315,2,4,"RECORTES CE",1
28,"28102",891,681,666,4,15,"RECORTES CE",1
47,"47175",6704,5296,5222,52,74,"RECORTES CE",8
24,"24174",469,360,354,5,6,"RECORTES CE",0
28,"28120",1209,991,974,3,17,"RECORTES CE",0
9,"9467",60,46,46,0,0,"RECORTES CE",0
9,"9085",472,371,365,3,6,"RECORTES CE",2
19,"19326",2343,1789,1768,9,21,"RECORTES CE",4
19,"19289",23,19,19,0,0,"RECORTES CE",0
16,"16112",1468,1108,1096,6,12,"RECORTES CE",1
49,"49016",229,189,187,2,2,"RECORTES CE",0
24,"24142",24730,18823,18504,201,319,"RECORTES CE",12
47,"47168",30,29,29,0,0,"RECORTES CE",0
16,"16047",214,175,174,4,1,"RECORTES CE",0
34,"34001",39,32,32,3,0,"RECORTES CE",0
42,"42127",38,27,27,1,0,"RECORTES CE",0
9,"9173",129,102,102,0,0,"RECORTES CE",0
45,"45102",3585,2724,2676,20,48,"RECORTES CE",4
28,"28033",4082,3172,3140,13,32,"RECORTES CE",7
5,"5029",99,69,69,0,0,"RECORTES CE",0
5,"5185",90,71,70,0,1,"RECORTES CE",0
49,"49269",220,163,162,1,1,"RECORTES CE",0
47,"47193",1609,1347,1332,9,15,"RECORTES CE",4
19,"19159",87,77,76,0,1,"RECORTES CE",0
5,"5237",155,131,129,1,2,"RECORTES CE",0
34,"34217",1251,1053,1042,7,11,"RECORTES CE",6
9,"9231",59,43,43,1,0,"RECORTES CE",0
9,"9024",150,116,114,0,2,"RECORTES CE",1
42,"42052",17,15,15,0,0,"RECORTES CE",0
9,"9198",100,80,79,0,1,"RECORTES CE",0
37,"37338",78,66,64,0,2,"RECORTES CE",0
37,"37186",96,79,79,0,0,"RECORTES CE",0
9,"9288",88,73,71,1,2,"RECORTES CE",1
24,"24169",2809,2165,2146,18,19,"RECORTES CE",1
40,"40177",140,114,113,1,1,"RECORTES CE",1
42,"42056",28,25,24,0,1,"RECORTES CE",0
9,"9315",393,291,286,4,5,"RECORTES CE",1
9,"9441",92,81,81,1,0,"RECORTES CE",1
5,"5005",171,142,142,2,0,"RECORTES CE",1
40,"40143",83,73,73,2,0,"RECORTES CE",0
19,"19331",2643,2043,2009,11,34,"RECORTES CE",5
16,"16002",195,166,164,1,2,"RECORTES CE",0
40,"40044",139,105,103,2,2,"RECORTES CE",0
37,"37313",534,413,411,1,2,"RECORTES CE",0
24,"24183",752,549,543,8,6,"RECORTES CE",0
42,"42115",95,77,77,1,0,"RECORTES CE",0
47,"47198",66,47,47,0,0,"RECORTES CE",0
45,"45103",362,306,299,0,7,"RECORTES CE",0
49,"49012",73,45,45,0,0,"RECORTES CE",0
49,"49059",88,72,71,0,1,"RECORTES CE",0
42,"42054",19,15,15,0,0,"RECORTES CE",0
24,"24052",139,99,99,0,0,"RECORTES CE",1
5,"5073",289,239,238,0,1,"RECORTES CE",0
19,"19087",17,14,14,0,0,"RECORTES CE",1
9,"9044",53,49,47,1,2,"RECORTES CE",0
47,"47077",237,187,183,2,4,"RECORTES CE",0
5,"5244",41,32,32,0,0,"RECORTES CE",0
28,"28058",141251,112674,111423,778,1251,"RECORTES CE",291
37,"37070",528,422,417,2,5,"RECORTES CE",0
37,"37197",87,63,63,0,0,"RECORTES CE",0
49,"49132",313,252,249,0,3,"RECORTES CE",0
2,"2053",2885,2313,2282,13,31,"RECORTES CE",4
45,"45197",1894,1525,1499,6,26,"RECORTES CE",0
37,"37366",41,30,30,0,0,"RECORTES CE",0
47,"47098",556,480,475,4,5,"RECORTES CE",0
5,"5086",76,64,61,0,3,"RECORTES CE",0
9,"9169",97,86,85,0,1,"RECORTES CE",0
28,"28093",2142,1751,1728,9,23,"RECORTES CE",2
40,"40109",72,59,54,1,5,"RECORTES CE",0
5,"5217",54,44,43,0,1,"RECORTES CE",0
49,"49223",716,552,548,0,4,"RECORTES CE",0
19,"19270",25,21,21,0,0,"RECORTES CE",0
13,"13054",4914,3946,3890,31,56,"RECORTES CE",3
19,"19136",12,12,12,0,0,"RECORTES CE",0
37,"37202",989,838,828,7,10,"RECORTES CE",1
49,"49043",265,210,208,1,2,"RECORTES CE",0
34,"34082",80,68,68,0,0,"RECORTES CE",0
40,"40069",74,65,65,0,0,"RECORTES CE",0
47,"47068",30,23,23,0,0,"RECORTES CE",0
37,"37019",140,118,117,1,1,"RECORTES CE",0
5,"5132",881,634,626,2,8,"RECORTES CE",2
40,"40130",128,102,96,0,6,"RECORTES CE",0
9,"9199",94,72,70,0,2,"RECORTES CE",1
5,"5088",29,23,23,0,0,"RECORTES CE",0
37,"37088",199,151,149,1,2,"RECORTES CE",0
37,"37155",68,52,52,0,0,"RECORTES CE",0
13,"13051",336,272,271,1,1,"RECORTES CE",0
42,"42162",2325,1721,1699,16,22,"RECORTES CE",2
16,"16043",88,71,71,1,0,"RECORTES CE",0
9,"9084",167,132,127,4,5,"RECORTES CE",1
13,"13027",3223,2343,2309,22,34,"RECORTES CE",5
34,"34034",115,96,95,3,1,"RECORTES CE",1
9,"9033",81,69,68,1,1,"RECORTES CE",0
16,"16169",51,36,32,0,4,"RECORTES CE",0
2,"2023",515,442,435,1,7,"RECORTES CE",0
19,"19245",1145,904,880,8,24,"RECORTES CE",0
28,"28060",1565,1262,1247,5,15,"RECORTES CE",4
24,"24172",415,240,237,1,3,"RECORTES CE",0
28,"28043",6166,4404,4320,30,84,"RECORTES CE",7
45,"45095",660,528,519,3,9,"RECORTES CE",0
2,"2065",443,373,370,0,3,"RECORTES CE",0
19,"19075",61,44,43,0,1,"RECORTES CE",2
19,"19105",2540,2013,1988,13,25,"RECORTES CE",6
47,"47010",14572,12316,12186,102,130,"RECORTES CE",22
42,"42059",20,13,13,0,0,"RECORTES CE",0
5,"5008",208,168,163,1,5,"RECORTES CE",0
42,"42212",62,48,47,1,1,"RECORTES CE",1
42,"42021",68,44,44,2,0,"RECORTES CE",0
16,"16101",139,123,122,0,1,"RECORTES CE",0
5,"5104",33,24,23,0,1,"RECORTES CE",0
9,"9035",284,213,210,1,3,"RECORTES CE",1
37,"37206",91,66,63,1,3,"RECORTES CE",0
34,"34229",58,42,40,1,2,"RECORTES CE",0
9,"9052",29,17,17,1,0,"RECORTES CE",0
47,"47187",75,54,53,0,1,"RECORTES CE",0
16,"16198",1299,1044,1027,11,17,"RECORTES CE",0
9,"9208",179,130,127,1,3,"RECORTES CE",0
16,"16053",391,334,327,4,7,"RECORTES CE",1
42,"42124",58,41,41,0,0,"RECORTES CE",0
9,"9110",77,57,57,0,0,"RECORTES CE",0
40,"40120",196,176,169,0,7,"RECORTES CE",0
34,"34076",545,475,473,2,2,"RECORTES CE",0
19,"19322",26,21,21,1,0,"RECORTES CE",0
2,"2038",266,217,216,1,1,"RECORTES CE",0
45,"45118",2088,1562,1540,11,22,"RECORTES CE",2
24,"24112",299,226,223,1,3,"RECORTES CE",0
45,"45132",2376,1915,1908,13,7,"RECORTES CE",2
13,"13015",5226,4010,3959,20,51,"RECORTES CE",5
28,"28154",5525,4283,4222,24,61,"RECORTES CE",6
49,"49008",431,293,289,2,4,"RECORTES CE",0
42,"42187",59,51,49,1,2,"RECORTES CE",0
19,"19045",127,107,107,1,0,"RECORTES CE",0
42,"42108",10,7,7,0,0,"RECORTES CE",0
5,"5107",55,43,43,2,0,"RECORTES CE",0
5,"5235",139,106,101,0,5,"RECORTES CE",0
37,"37235",219,170,166,4,4,"RECORTES CE",0
28,"28108",3642,2878,2841,16,37,"RECORTES CE",6
42,"42183",106,83,83,1,0,"RECORTES CE",0
24,"24156",220,146,144,2,2,"RECORTES CE",0
47,"47128",56,49,46,0,3,"RECORTES CE",0
37,"37097",44,29,29,0,0,"RECORTES CE",0
45,"45120",121,96,96,0,0,"RECORTES CE",0
5,"5117",193,169,167,0,2,"RECORTES CE",0
47,"47117",286,240,235,0,5,"RECORTES CE",0
47,"47095",41,36,34,2,2,"RECORTES CE",0
40,"40208",720,592,585,4,7,"RECORTES CE",1
2,"2028",118,99,98,4,1,"RECORTES CE",0
49,"49146",274,213,209,1,4,"RECORTES CE",0
40,"40129",164,129,128,2,1,"RECORTES CE",0
42,"42217",34,26,26,0,0,"RECORTES CE",0
9,"9140",115,88,88,2,0,"RECORTES CE",0
40,"40071",43,37,31,0,6,"RECORTES CE",1
49,"49147",249,197,196,1,1,"RECORTES CE",0
49,"49082",343,288,286,8,2,"RECORTES CE",0
49,"49173",344,220,216,1,4,"RECORTES CE",0
16,"16238",464,387,383,2,4,"RECORTES CE",0
5,"5127",608,499,496,0,3,"RECORTES CE",0
49,"49197",162,129,123,2,6,"RECORTES CE",1
16,"16248",862,730,720,10,10,"RECORTES CE",0
45,"45081",19138,15010,14829,110,181,"RECORTES CE",39
40,"40158",15,13,13,1,0,"RECORTES CE",0
19,"19145",41,38,38,0,0,"RECORTES CE",0
16,"16102",1163,951,943,16,8,"RECORTES CE",0
2,"2078",899,705,691,3,14,"RECORTES CE",2
40,"40001",706,597,590,7,7,"RECORTES CE",0
34,"34234",68,59,57,0,2,"RECORTES CE",0
5,"5239",231,177,174,1,3,"RECORTES CE",0
28,"28124",59,52,52,0,0,"RECORTES CE",0
37,"37200",196,145,145,0,0,"RECORTES CE",0
45,"45087",8198,6375,6281,36,94,"RECORTES CE",6
49,"49055",95,83,83,1,0,"RECORTES CE",0
9,"9368",28,21,21,1,0,"RECORTES CE",0
37,"37376",2164,1606,1581,15,25,"RECORTES CE",2
34,"34168",45,39,39,0,0,"RECORTES CE",0
9,"9220",70,59,58,0,1,"RECORTES CE",1
28,"28029",562,459,456,2,3,"RECORTES CE",2
19,"19050",15,13,13,0,0,"RECORTES CE",0
5,"5034",14,12,12,0,0,"RECORTES CE",0
37,"37365",166,132,131,1,1,"RECORTES CE",0
9,"9060",128,111,111,1,0,"RECORTES CE",0
28,"28182",198,169,169,1,0,"RECORTES CE",0
24,"24161",295,223,219,0,4,"RECORTES CE",0
37,"37081",871,725,717,4,8,"RECORTES CE",0
13,"13023",8950,6359,6271,76,88,"RECORTES CE",7
16,"16066",2298,1932,1885,17,47,"RECORTES CE",4
19,"19051",61,54,54,0,0,"RECORTES CE",0
37,"37056",40,33,33,0,0,"RECORTES CE",0
24,"24065",2175,1695,1660,18,35,"RECORTES CE",2
42,"42131",52,37,37,0,0,"RECORTES CE",0
19,"19302",52,43,41,1,2,"RECORTES CE",0
24,"24080",207,162,161,0,1,"RECORTES CE",0
45,"45080",3,3,3,0,0,"RECORTES CE",0
9,"9390",569,464,459,5,5,"RECORTES CE",0
16,"16026",93,70,68,1,2,"RECORTES CE",0
47,"47132",39,33,33,0,0,"RECORTES CE",0
9,"9114",76,63,63,0,0,"RECORTES CE",0
42,"42123",158,118,118,2,0,"RECORTES CE",1
34,"34238",305,261,260,2,1,"RECORTES CE",0
9,"9115",91,71,66,2,5,"RECORTES CE",1
47,"47221",100,84,83,1,1,"RECORTES CE",0
16,"16103",239,203,203,0,0,"RECORTES CE",0
40,"40901",414,331,328,8,3,"RECORTES CE",1
34,"34086",99,92,90,2,2,"RECORTES CE",1
37,"37330",318,255,248,2,7,"RECORTES CE",0
19,"19199",19,17,16,0,1,"RECORTES CE",0
47,"47038",101,79,79,0,0,"RECORTES CE",0
16,"16055",679,478,477,4,1,"RECORTES CE",2
28,"28012",918,727,711,6,16,"RECORTES CE",0
45,"45067",2289,1860,1820,17,40,"RECORTES CE",0
34,"34107",73,54,54,2,0,"RECORTES CE",0
2,"2047",107,89,88,1,1,"RECORTES CE",0
9,"9301",648,545,536,7,9,"RECORTES CE",6
40,"40076",6537,5130,5012,22,118,"RECORTES CE",10
2,"2010",1798,1494,1469,6,25,"RECORTES CE",0
47,"47008",22,15,15,0,0,"RECORTES CE",0
49,"49207",217,151,148,4,3,"RECORTES CE",0
5,"5192",93,81,78,0,3,"RECORTES CE",0
40,"40229",28,24,24,0,0,"RECORTES CE",0
19,"19259",28,24,24,0,0,"RECORTES CE",0
49,"49033",666,515,508,1,7,"RECORTES CE",1
19,"19118",10,10,10,1,0,"RECORTES CE",0
45,"45175",614,512,504,3,8,"RECORTES CE",0
9,"9154",124,101,101,3,0,"RECORTES CE",0
16,"16142",120,95,95,0,0,"RECORTES CE",0
16,"16129",90,78,77,0,1,"RECORTES CE",0
40,"40172",45,37,37,0,0,"RECORTES CE",0
42,"42009",77,69,69,2,0,"RECORTES CE",0
37,"37294",11787,9201,9083,76,118,"RECORTES CE",11
28,"28172",9751,7994,7928,38,66,"RECORTES CE",12
45,"45100",179,150,148,1,2,"RECORTES CE",0
9,"9174",781,625,608,3,17,"RECORTES CE",2
9,"9429",55,41,41,0,0,"RECORTES CE",0
13,"13074",944,826,813,1,13,"RECORTES CE",0
40,"40078",151,123,122,2,1,"RECORTES CE",1
24,"24044",152,116,114,0,2,"RECORTES CE",0
16,"16243",379,323,318,5,5,"RECORTES CE",0
9,"9014",192,143,142,0,1,"RECORTES CE",2
16,"16153",936,786,768,7,18,"RECORTES CE",0
34,"34230",17,13,13,0,0,"RECORTES CE",0
49,"49084",268,226,223,9,3,"RECORTES CE",0
49,"49096",157,129,123,2,6,"RECORTES CE",0
40,"40170",1307,1066,1054,7,12,"RECORTES CE",5
9,"9335",87,71,71,0,0,"RECORTES CE",1
37,"37283",119,96,96,0,0,"RECORTES CE",0
47,"47031",196,155,155,3,0,"RECORTES CE",0
34,"34037",276,224,223,2,1,"RECORTES CE",0
34,"34096",50,44,44,0,0,"RECORTES CE",0
9,"9229",183,136,136,2,0,"RECORTES CE",0
37,"37063",60,45,45,1,0,"RECORTES CE",0
47,"47188",99,77,77,0,0,"RECORTES CE",0
28,"28035",1394,1057,1043,3,14,"RECORTES CE",0
9,"9416",60,44,44,0,0,"RECORTES CE",0
24,"24167",716,516,505,4,11,"RECORTES CE",1
9,"9068",24,18,18,0,0,"RECORTES CE",0
9,"9196",135,108,107,0,1,"RECORTES CE",0
34,"34216",60,46,46,0,0,"RECORTES CE",1
2,"2051",1665,1253,1222,6,31,"RECORTES CE",3
19,"19147",45,36,36,0,0,"RECORTES CE",0
13,"13018",766,644,634,0,10,"RECORTES CE",1
49,"49037",177,146,143,1,3,"RECORTES CE",0
34,"34232",735,595,584,8,11,"RECORTES CE",2
9,"9055",48,34,34,1,0,"RECORTES CE",0
5,"5069",74,63,62,0,1,"RECORTES CE",1
16,"16062",25,21,21,0,0,"RECORTES CE",0
5,"5013",847,708,701,0,7,"RECORTES CE",1
28,"28145",2640,2014,1987,11,27,"RECORTES CE",3
34,"34006",79,73,70,3,3,"RECORTES CE",1
9,"9448",201,161,161,1,0,"RECORTES CE",0
40,"40221",48,42,42,0,0,"RECORTES CE",0
5,"5212",197,138,136,0,2,"RECORTES CE",0
34,"34055",263,214,213,3,1,"RECORTES CE",2
49,"49172",481,316,310,2,6,"RECORTES CE",0
24,"24129",111,91,91,1,0,"RECORTES CE",0
16,"16106",2708,2200,2163,17,37,"RECORTES CE",1
2,"2017",777,588,584,0,4,"RECORTES CE",0
42,"42128",46,41,41,0,0,"RECORTES CE",0
5,"5170",50,38,38,0,0,"RECORTES CE",0
37,"37170",1370,1009,990,10,19,"RECORTES CE",1
13,"13055",615,475,465,5,10,"RECORTES CE",0
47,"47028",30,17,17,0,0,"RECORTES CE",0
9,"9170",209,164,159,0,5,"RECORTES CE",1
34,"34081",60,48,48,0,0,"RECORTES CE",0
13,"13016",661,508,495,2,13,"RECORTES CE",0
34,"34101",45,39,38,0,1,"RECORTES CE",0
47,"47203",58,48,48,0,0,"RECORTES CE",0
19,"19116",12,9,9,1,0,"RECORTES CE",0
45,"45153",1560,1243,1230,4,13,"RECORTES CE",2
47,"47035",902,715,707,5,8,"RECORTES CE",1
28,"28134",63352,51185,50776,336,409,"RECORTES CE",116
5,"5199",37,31,31,0,0,"RECORTES CE",0
2,"2067",1129,866,852,4,14,"RECORTES CE",0
49,"49110",345,222,220,2,2,"RECORTES CE",0
24,"24012",285,204,202,2,2,"RECORTES CE",0
19,"19034",23,23,22,0,1,"RECORTES CE",0
49,"49246",217,180,177,2,3,"RECORTES CE",0
45,"45108",482,385,382,0,3,"RECORTES CE",0
13,"13037",790,633,620,3,13,"RECORTES CE",1
19,"19066",50,43,43,0,0,"RECORTES CE",0
42,"42084",20,16,16,0,0,"RECORTES CE",0
24,"24092",745,606,601,6,5,"RECORTES CE",0
16,"16083",45,29,28,0,1,"RECORTES CE",0
9,"9027",48,41,39,0,2,"RECORTES CE",0
13,"13024",891,636,628,2,8,"RECORTES CE",0
24,"24118",104,66,66,0,0,"RECORTES CE",0
9,"9013",44,37,37,0,0,"RECORTES CE",0
37,"37086",104,88,88,0,0,"RECORTES CE",0
5,"5201",499,414,407,2,7,"RECORTES CE",0
45,"45079",349,272,272,1,0,"RECORTES CE",0
40,"40180",277,231,224,3,7,"RECORTES CE",1
47,"47153",104,76,75,0,1,"RECORTES CE",0
42,"42117",133,109,106,0,3,"RECORTES CE",0
40,"40904",341,302,300,4,2,"RECORTES CE",0
9,"9440",80,66,66,0,0,"RECORTES CE",0
16,"16270",156,124,124,1,0,"RECORTES CE",0
5,"5153",87,65,65,1,0,"RECORTES CE",0
42,"42100",31,27,27,0,0,"RECORTES CE",1
13,"13039",14212,10929,10761,107,168,"RECORTES CE",22
49,"49018",288,225,222,1,3,"RECORTES CE",0
49,"49169",34,28,26,0,2,"RECORTES CE",0
37,"37208",69,52,51,0,1,"RECORTES CE",0
9,"9054",89,69,68,1,1,"RECORTES CE",0
2,"2079",2823,2303,2253,22,50,"RECORTES CE",4
24,"24115",53267,39733,39172,433,561,"RECORTES CE",62
47,"47018",36,31,29,0,2,"RECORTES CE",0
45,"45020",1239,987,973,4,14,"RECORTES CE",1
5,"5230",65,58,58,4,0,"RECORTES CE",0
19,"19170",189,116,116,0,0,"RECORTES CE",0
42,"42019",511,384,378,7,6,"RECORTES CE",0
19,"19321",34,29,29,0,0,"RECORTES CE",1
19,"19304",220,177,175,1,2,"RECORTES CE",1
16,"16003",133,111,110,1,1,"RECORTES CE",0
37,"37343",66,50,48,1,2,"RECORTES CE",0
42,"42087",51,45,44,1,1,"RECORTES CE",0
45,"45021",2605,1987,1950,23,37,"RECORTES CE",5
24,"24095",307,237,235,0,2,"RECORTES CE",0
28,"28085",4141,3337,3296,13,41,"RECORTES CE",2
34,"34062",150,108,107,1,1,"RECORTES CE",0
37,"37104",25,18,18,0,0,"RECORTES CE",0
16,"16253",308,250,249,2,1,"RECORTES CE",0
16,"16254",203,168,166,1,2,"RECORTES CE",0
24,"24164",362,221,220,1,1,"RECORTES CE",0
37,"37332",70,53,53,0,0,"RECORTES CE",0
16,"16202",741,573,568,4,5,"RECORTES CE",1
49,"49020",261,215,210,2,5,"RECORTES CE",0
45,"45054",3831,2980,2944,11,36,"RECORTES CE",3
37,"37269",430,331,325,2,6,"RECORTES CE",0
5,"5193",180,156,156,2,0,"RECORTES CE",1
45,"45115",2586,2158,2114,8,44,"RECORTES CE",4
5,"5078",100,87,86,0,1,"RECORTES CE",0
9,"9082",36,34,34,0,0,"RECORTES CE",0
37,"37382",164,135,134,0,1,"RECORTES CE",0
47,"47050",3898,3084,3047,36,37,"RECORTES CE",5
5,"5260",97,81,80,1,1,"RECORTES CE",2
45,"45023",2248,1799,1784,16,15,"RECORTES CE",5
19,"19023",127,98,96,0,2,"RECORTES CE",0
47,"47020",272,228,225,5,3,"RECORTES CE",0
9,"9020",237,184,180,5,4,"RECORTES CE",1
5,"5130",94,86,86,0,0,"RECORTES CE",0
42,"42098",9,8,8,0,0,"RECORTES CE",0
9,"9224",159,135,132,0,3,"RECORTES CE",0
16,"16064",651,575,569,4,6,"RECORTES CE",1
9,"9373",406,284,268,3,16,"RECORTES CE",0
47,"47099",155,135,133,0,2,"RECORTES CE",0
19,"19233",82,72,72,1,0,"RECORTES CE",0
9,"9380",73,53,53,0,0,"RECORTES CE",0
19,"19009",247,190,187,0,3,"RECORTES CE",0
5,"5222",152,111,109,0,2,"RECORTES CE",0
37,"37159",79,68,68,0,0,"RECORTES CE",0
49,"49064",483,319,317,1,2,"RECORTES CE",0
37,"37079",80,69,68,2,1,"RECORTES CE",0
49,"49011",212,166,165,7,1,"RECORTES CE",0
37,"37195",37,29,29,1,0,"RECORTES CE",0
37,"37184",290,199,195,0,4,"RECORTES CE",0
5,"5081",37,29,29,0,0,"RECORTES CE",0
16,"16277",109,82,82,0,0,"RECORTES CE",0
40,"40115",156,131,130,4,1,"RECORTES CE",0
16,"16117",1022,822,809,6,13,"RECORTES CE",1
13,"13001",1195,947,943,5,4,"RECORTES CE",0
47,"47149",45,39,39,1,0,"RECORTES CE",0
47,"47094",123,110,109,1,1,"RECORTES CE",0
34,"34039",62,49,49,0,0,"RECORTES CE",0
13,"13017",247,189,188,2,1,"RECORTES CE",1
28,"28007",126831,103108,102202,710,906,"RECORTES CE",243
16,"16104",55,46,46,0,0,"RECORTES CE",0
9,"9039",56,44,44,0,0,"RECORTES CE",0
49,"49013",229,176,175,4,1,"RECORTES CE",0
34,"34069",2184,1737,1701,16,36,"RECORTES CE",3
16,"16278",63,51,51,0,0,"RECORTES CE",0
49,"49065",1073,789,777,3,12,"RECORTES CE",0
49,"49025",159,126,124,0,2,"RECORTES CE",0
37,"37110",103,84,82,0,2,"RECORTES CE",0
5,"5043",75,62,62,0,0,"RECORTES CE",0
13,"13095",72,60,60,1,0,"RECORTES CE",0
19,"19209",41,35,34,0,1,"RECORTES CE",0
45,"45105",380,284,275,2,9,"RECORTES CE",0
19,"19081",27,19,19,0,0,"RECORTES CE",0
45,"45198",1790,1488,1464,5,24,"RECORTES CE",0
34,"34084",155,127,126,1,1,"RECORTES CE",0
5,"5079",68,56,56,0,0,"RECORTES CE",0
47,"47093",797,628,615,6,13,"RECORTES CE",0
49,"49165",55,53,50,0,3,"RECORTES CE",0
9,"9215",365,267,264,1,3,"RECORTES CE",0
47,"47127",138,92,89,1,3,"RECORTES CE",1
49,"49134",166,111,111,2,0,"RECORTES CE",0
34,"34167",110,88,88,0,0,"RECORTES CE",0
37,"37162",209,156,153,1,3,"RECORTES CE",0
40,"40094",364,284,279,1,5,"RECORTES CE",1
49,"49232",84,71,70,0,1,"RECORTES CE",0
9,"9366",75,60,60,2,0,"RECORTES CE",0
47,"47119",87,66,65,1,1,"RECORTES CE",0
47,"47087",368,292,288,3,4,"RECORTES CE",0
42,"42068",78,62,61,2,1,"RECORTES CE",0
9,"9476",60,50,50,0,0,"RECORTES CE",0
16,"16176",31,22,22,0,0,"RECORTES CE",0
16,"16163",60,50,50,0,0,"RECORTES CE",0
16,"16266",358,281,279,3,2,"RECORTES CE",1
16,"16135",118,86,85,0,1,"RECORTES CE",0
5,"5124",92,71,70,1,1,"RECORTES CE",0
34,"34221",170,138,136,2,2,"RECORTES CE",0
47,"47172",135,119,119,0,0,"RECORTES CE",1
47,"47066",1407,1131,1122,11,9,"RECORTES CE",0
34,"34182",753,609,604,6,5,"RECORTES CE",0
37,"37328",164,127,127,4,0,"RECORTES CE",2
37,"37302",262,182,181,2,1,"RECORTES CE",0
19,"19197",27,22,22,0,0,"RECORTES CE",0
49,"49042",230,179,174,1,5,"RECORTES CE",0
45,"45049",423,340,335,1,5,"RECORTES CE",0
34,"34046",44,31,31,0,0,"RECORTES CE",0
5,"5018",24,18,17,0,1,"RECORTES CE",0
9,"9202",22,22,22,2,0,"RECORTES CE",0
49,"49204",57,42,42,0,0,"RECORTES CE",0
42,"42042",49,42,42,1,0,"RECORTES CE",0
34,"34184",49,39,38,0,1,"RECORTES CE",0
45,"45171",1326,1032,1013,6,19,"RECORTES CE",0
13,"13009",1397,1145,1123,4,22,"RECORTES CE",2
16,"16185",35,29,29,0,0,"RECORTES CE",1
37,"37277",77,56,56,0,0,"RECORTES CE",0
19,"19088",95,82,82,2,0,"RECORTES CE",0
47,"47154",146,122,118,2,4,"RECORTES CE",0
42,"42165",419,288,285,8,3,"RECORTES CE",0
49,"49129",821,628,616,5,12,"RECORTES CE",0
28,"28114",143,104,104,0,0,"RECORTES CE",0
42,"42148",9,9,9,0,0,"RECORTES CE",0
37,"37087",910,755,747,3,8,"RECORTES CE",3
19,"19228",29,22,22,0,0,"RECORTES CE",0
37,"37203",146,113,112,0,1,"RECORTES CE",0
34,"34124",63,58,58,0,0,"RECORTES CE",0
9,"9098",477,372,360,4,12,"RECORTES CE",1
34,"34123",1637,1376,1354,8,22,"RECORTES CE",4
34,"34210",103,90,90,1,0,"RECORTES CE",0
37,"37267",182,153,150,1,3,"RECORTES CE",0
40,"40017",84,74,71,2,3,"RECORTES CE",0
37,"37032",549,431,430,3,1,"RECORTES CE",0
47,"47080",35,23,21,0,2,"RECORTES CE",0
9,"9485",56,50,50,2,0,"RECORTES CE",0
42,"42209",135,107,100,5,7,"RECORTES CE",0
28,"28023",5090,4252,4212,31,40,"RECORTES CE",1
19,"19230",548,437,430,1,7,"RECORTES CE",2
45,"45022",393,290,288,3,2,"RECORTES CE",0
40,"40053",83,62,62,1,0,"RECORTES CE",0
28,"28181",20669,17314,17205,101,109,"RECORTES CE",24
37,"37192",355,234,227,5,7,"RECORTES CE",0
49,"49102",183,136,135,2,1,"RECORTES CE",1
47,"47091",74,64,63,1,1,"RECORTES CE",0
5,"5090",77,70,69,0,1,"RECORTES CE",0
9,"9191",33,24,24,0,0,"RECORTES CE",0
5,"5051",162,135,131,0,4,"RECORTES CE",2
16,"16240",100,77,76,0,1,"RECORTES CE",0
19,"19277",16,13,13,0,0,"RECORTES CE",0
24,"24189",5816,4434,4382,49,52,"RECORTES CE",6
19,"19142",249,178,177,1,1,"RECORTES CE",0
37,"37281",39,34,33,0,1,"RECORTES CE",0
34,"34228",76,62,62,0,0,"RECORTES CE",0
2,"2061",618,504,500,7,4,"RECORTES CE",0
19,"19231",10,7,7,0,0,"RECORTES CE",0
16,"16017",340,281,271,2,10,"RECORTES CE",0
28,"28162",2771,2264,2243,6,21,"RECORTES CE",6
37,"37010",923,739,735,2,4,"RECORTES CE",1
16,"16189",262,220,220,1,0,"RECORTES CE",0
45,"45176",3841,2992,2952,16,40,"RECORTES CE",6
45,"45126",239,173,168,0,5,"RECORTES CE",0
9,"9372",204,176,175,1,1,"RECORTES CE",0
42,"42086",33,21,19,0,2,"RECORTES CE",0
28,"28056",914,715,703,4,12,"RECORTES CE",4
19,"19160",905,618,613,3,5,"RECORTES CE",3
5,"5092",146,118,116,0,2,"RECORTES CE",0
19,"19096",101,81,79,1,2,"RECORTES CE",0
49,"49267",97,73,68,1,5,"RECORTES CE",0
13,"13061",5639,4119,4071,56,48,"RECORTES CE",5
34,"34177",176,154,152,2,2,"RECORTES CE",0
16,"16019",185,147,147,0,0,"RECORTES CE",0
42,"42171",114,80,79,0,1,"RECORTES CE",0
9,"9104",47,39,39,0,0,"RECORTES CE",0
5,"5054",1203,946,927,5,19,"RECORTES CE",0
37,"37134",212,156,148,0,8,"RECORTES CE",1
19,"19234",45,32,32,0,0,"RECORTES CE",0
5,"5159",228,160,159,2,1,"RECORTES CE",0
45,"45026",218,177,172,0,5,"RECORTES CE",0
28,"28099",1923,1490,1475,7,15,"RECORTES CE",3
9,"9361",112,94,94,1,0,"RECORTES CE",1
37,"37160",606,431,418,6,13,"RECORTES CE",1
47,"47116",403,321,320,3,1,"RECORTES CE",0
9,"9007",55,37,37,0,0,"RECORTES CE",0
9,"9906",1200,975,958,8,17,"RECORTES CE",1
9,"9163",578,490,481,5,9,"RECORTES CE",0
9,"9382",30,24,23,0,1,"RECORTES CE",0
49,"49185",156,126,120,1,6,"RECORTES CE",0
9,"9108",432,332,326,1,6,"RECORTES CE",1
37,"37323",476,380,377,7,3,"RECORTES CE",0
34,"34131",58,51,51,0,0,"RECORTES CE",0
16,"16022",78,70,70,0,0,"RECORTES CE",0
24,"24100",754,602,598,7,4,"RECORTES CE",0
16,"16148",546,481,479,1,2,"RECORTES CE",0
37,"37052",278,201,199,2,2,"RECORTES CE",0
40,"40057",1405,1176,1163,10,13,"RECORTES CE",1
49,"49026",201,163,162,0,1,"RECORTES CE",0
24,"24076",1286,998,981,8,17,"RECORTES CE",3
16,"16246",452,348,340,1,8,"RECORTES CE",0
24,"24010",8268,5968,5847,66,121,"RECORTES CE",2
45,"45106",7395,5971,5861,40,110,"RECORTES CE",6
2,"2002",435,358,352,2,6,"RECORTES CE",0
2,"2037",22952,16040,15815,101,225,"RECORTES CE",24
34,"34196",88,74,74,4,0,"RECORTES CE",0
28,"28090",9128,7590,7516,54,74,"RECORTES CE",9
19,"19082",99,76,75,0,1,"RECORTES CE",0
37,"37287",309,215,214,3,1,"RECORTES CE",0
42,"42038",34,27,27,1,0,"RECORTES CE",0
37,"37054",238,200,196,3,4,"RECORTES CE",0
34,"34181",422,324,321,3,3,"RECORTES CE",1
5,"5097",476,332,327,0,5,"RECORTES CE",0
13,"13020",4729,3461,3416,34,45,"RECORTES CE",6
19,"19317",127,98,97,0,1,"RECORTES CE",0
24,"24103",264,162,161,1,1,"RECORTES CE",0
49,"49187",1202,930,921,8,9,"RECORTES CE",1
5,"5214",27,22,22,0,0,"RECORTES CE",0
45,"45169",186,135,134,0,1,"RECORTES CE",0
13,"13097",2205,1764,1742,6,22,"RECORTES CE",0
42,"42083",26,22,22,0,0,"RECORTES CE",0
37,"37016",574,464,455,3,9,"RECORTES CE",1
42,"42041",31,23,23,1,0,"RECORTES CE",0
45,"45093",154,124,123,0,1,"RECORTES CE",0
9,"9130",66,55,52,0,3,"RECORTES CE",0
42,"42192",38,26,26,1,0,"RECORTES CE",0
2,"2056",1643,1330,1308,4,22,"RECORTES CE",1
49,"49175",205,150,149,2,1,"RECORTES CE",0
40,"40122",525,442,434,2,8,"RECORTES CE",2
42,"42055",165,124,122,2,2,"RECORTES CE",0
37,"37057",209,165,162,2,3,"RECORTES CE",0
9,"9352",107,86,86,2,0,"RECORTES CE",0
37,"37265",208,184,181,1,3,"RECORTES CE",0
45,"45187",3976,3365,3308,24,57,"RECORTES CE",1
42,"42207",47,41,41,0,0,"RECORTES CE",0
49,"49151",593,453,444,5,9,"RECORTES CE",0
19,"19169",33,26,25,0,1,"RECORTES CE",0
19,"19153",22,22,22,0,0,"RECORTES CE",0
45,"45141",849,677,665,4,12,"RECORTES CE",0
19,"19242",77,67,67,0,0,"RECORTES CE",0
49,"49205",367,286,282,5,4,"RECORTES CE",0
49,"49164",139,103,102,2,1,"RECORTES CE",0
28,"28136",680,569,563,0,6,"RECORTES CE",0
19,"19003",29,28,28,2,0,"RECORTES CE",0
9,"9025",108,73,72,0,1,"RECORTES CE",0
42,"42208",20,16,16,0,0,"RECORTES CE",0
16,"16251",1809,1469,1443,11,26,"RECORTES CE",0
24,"24202",7559,5449,5363,63,86,"RECORTES CE",4
45,"45189",616,506,498,2,8,"RECORTES CE",1
49,"49006",142,111,111,1,0,"RECORTES CE",0
28,"28001",80,64,64,0,0,"RECORTES CE",0
37,"37255",42,31,31,2,0,"RECORTES CE",0
40,"40203",958,801,788,6,13,"RECORTES CE",0
37,"37167",177,159,158,3,1,"RECORTES CE",0
24,"24068",443,343,336,1,7,"RECORTES CE",0
34,"34033",17,15,15,0,0,"RECORTES CE",0
28,"28118",61,52,51,0,1,"RECORTES CE",0
49,"49044",78,64,64,1,0,"RECORTES CE",0
37,"37179",196,172,169,0,3,"RECORTES CE",0
5,"5022",1571,1295,1282,5,13,"RECORTES CE",2
37,"37217",59,48,46,1,2,"RECORTES CE",0
34,"34139",160,119,118,0,1,"RECORTES CE",0
45,"45190",458,378,365,2,13,"RECORTES CE",1
49,"49249",63,52,52,1,0,"RECORTES CE",0
37,"37020",425,341,339,4,2,"RECORTES CE",2
40,"40136",106,82,81,0,1,"RECORTES CE",0
42,"42045",276,212,209,2,3,"RECORTES CE",0
37,"37143",375,308,306,2,2,"RECORTES CE",0
49,"49077",159,104,103,0,1,"RECORTES CE",0
19,"19290",851,581,577,5,4,"RECORTES CE",0
2,"2085",309,264,263,4,1,"RECORTES CE",0
37,"37370",308,256,254,2,2,"RECORTES CE",0
9,"9120",38,32,31,2,1,"RECORTES CE",0
19,"19201",60,45,45,0,0,"RECORTES CE",0
28,"28109",1622,1205,1192,3,13,"RECORTES CE",5
37,"37219",165,101,97,2,4,"RECORTES CE",0
34,"34242",93,66,64,1,2,"RECORTES CE",0
40,"40007",68,58,58,0,0,"RECORTES CE",0
5,"5143",62,51,51,0,0,"RECORTES CE",0
16,"16031",36,25,25,0,0,"RECORTES CE",0
19,"19057",72,59,58,0,1,"RECORTES CE",0
40,"40113",408,339,335,6,4,"RECORTES CE",0
37,"37144",338,275,273,1,2,"RECORTES CE",1
19,"19106",76,57,57,0,0,"RECORTES CE",1
5,"5178",345,287,283,1,4,"RECORTES CE",0
24,"24153",233,187,183,1,4,"RECORTES CE",0
19,"19247",142,118,117,2,1,"RECORTES CE",0
42,"42078",1005,769,756,6,13,"RECORTES CE",0
28,"28110",2003,1596,1571,7,25,"RECORTES CE",2
34,"34243",320,260,258,1,2,"RECORTES CE",0
24,"24193",365,286,285,0,1,"RECORTES CE",1
9,"9021",51,36,35,1,1,"RECORTES CE",0
40,"40009",40,34,34,0,0,"RECORTES CE",0
9,"9281",135,104,102,1,2,"RECORTES CE",0
49,"49255",396,324,323,3,1,"RECORTES CE",1
28,"28111",622,492,487,1,5,"RECORTES CE",0
42,"42142",45,35,35,0,0,"RECORTES CE",0
13,"13030",120,97,96,0,1,"RECORTES CE",0
37,"37222",86,64,62,0,2,"RECORTES CE",0
9,"9283",44,33,33,0,0,"RECORTES CE",0
47,"47189",151,126,123,0,3,"RECORTES CE",0
9,"9398",74,59,58,1,1,"RECORTES CE",0
2,"2901",2185,1633,1613,9,20,"RECORTES CE",1
37,"37284",314,241,237,2,4,"RECORTES CE",1
19,"19162",67,50,48,0,2,"RECORTES CE",0
40,"40140",79,58,58,0,0,"RECORTES CE",1
34,"34083",1664,1244,1229,10,15,"RECORTES CE",2
47,"47170",43,34,32,0,2,"RECORTES CE",0
24,"24089",101353,78253,77375,776,878,"RECORTES CE",86
34,"34179",26,20,19,0,1,"RECORTES CE",0
24,"24127",268,204,201,3,3,"RECORTES CE",0
37,"37299",229,175,168,0,7,"RECORTES CE",0
16,"16264",390,338,328,2,10,"RECORTES CE",0
40,"40152",748,637,620,6,17,"RECORTES CE",0
24,"24049",1415,1146,1134,8,12,"RECORTES CE",1
37,"37067",3254,2742,2714,29,28,"RECORTES CE",7
45,"45013",1671,1320,1298,4,22,"RECORTES CE",1
5,"5225",353,300,297,2,3,"RECORTES CE",1
13,"13079",12265,9441,9218,123,223,"RECORTES CE",14
16,"16035",238,190,188,0,2,"RECORTES CE",0
37,"37249",38,28,28,0,0,"RECORTES CE",0
40,"40210",98,70,70,0,0,"RECORTES CE",0
9,"9265",47,38,36,2,2,"RECORTES CE",0
45,"45071",1802,1488,1465,0,23,"RECORTES CE",1
49,"49053",915,726,715,5,11,"RECORTES CE",1
24,"24090",326,213,213,2,0,"RECORTES CE",0
19,"19193",23,20,20,0,0,"RECORTES CE",0
47,"47014",47,43,43,1,0,"RECORTES CE",0
28,"28069",56,47,45,2,2,"RECORTES CE",0
16,"16265",20,20,19,0,1,"RECORTES CE",0
16,"16121",233,183,179,0,4,"RECORTES CE",0
42,"42190",92,74,73,1,1,"RECORTES CE",0
19,"19252",60,49,47,0,2,"RECORTES CE",0
9,"9270",159,119,117,4,2,"RECORTES CE",0
34,"34071",161,138,138,0,0,"RECORTES CE",0
34,"34028",134,110,107,3,3,"RECORTES CE",0
24,"24024",638,463,452,8,11,"RECORTES CE",0
13,"13021",417,343,343,0,0,"RECORTES CE",0
28,"28177",10722,9093,9029,64,64,"RECORTES CE",12
49,"49259",79,62,61,0,1,"RECORTES CE",0
24,"24131",677,468,463,1,5,"RECORTES CE",0
16,"16082",271,207,206,3,1,"RECORTES CE",1
19,"19254",43,36,36,0,0,"RECORTES CE",0
47,"47162",68,55,55,0,0,"RECORTES CE",0
49,"49004",111,77,77,4,0,"RECORTES CE",0
5,"5254",181,155,153,0,2,"RECORTES CE",0
45,"45017",260,218,213,1,5,"RECORTES CE",0
49,"49085",918,673,660,5,13,"RECORTES CE",0
42,"42085",178,133,133,3,0,"RECORTES CE",0
28,"28106",78429,59182,58471,417,711,"RECORTES CE",169
9,"9061",148,129,129,0,0,"RECORTES CE",0
49,"49273",166,111,110,0,1,"RECORTES CE",0
19,"19067",69,53,50,1,3,"RECORTES CE",0
19,"19334",44,37,37,0,0,"RECORTES CE",0
49,"49005",128,87,85,1,2,"RECORTES CE",0
19,"19038",22,19,19,0,0,"RECORTES CE",0
45,"45018",551,399,397,3,2,"RECORTES CE",1
45,"45156",3338,2805,2750,9,55,"RECORTES CE",2
19,"19018",141,112,110,0,2,"RECORTES CE",0
37,"37341",48,36,36,0,0,"RECORTES CE",0
37,"37030",81,68,65,0,3,"RECORTES CE",0
37,"37303",181,137,137,1,0,"RECORTES CE",0
34,"34060",135,111,110,0,1,"RECORTES CE",0
24,"24170",1839,1417,1391,7,26,"RECORTES CE",1
28,"28117",98,89,87,2,2,"RECORTES CE",0
47,"47227",55,46,46,0,0,"RECORTES CE",0
40,"40028",105,96,96,1,0,"RECORTES CE",0
49,"49152",483,327,322,2,5,"RECORTES CE",2
49,"49177",260,165,162,2,3,"RECORTES CE",0
5,"5115",516,397,395,3,2,"RECORTES CE",1
9,"9077",30,22,22,0,0,"RECORTES CE",0
45,"45204",634,500,497,1,3,"RECORTES CE",0
9,"9133",38,33,33,0,0,"RECORTES CE",1
42,"42195",92,53,53,1,0,"RECORTES CE",0
47,"47049",91,66,64,0,2,"RECORTES CE",0
5,"5076",473,417,413,7,4,"RECORTES CE",0
13,"13056",11657,9236,9142,85,94,"RECORTES CE",20
49,"49101",147,99,96,0,3,"RECORTES CE",0
34,"34156",50,43,43,0,0,"RECORTES CE",0
34,"34018",205,181,177,2,4,"RECORTES CE",0
5,"5904",112,81,81,3,0,"RECORTES CE",0
49,"49263",45,37,37,0,0,"RECORTES CE",0
16,"16042",1108,948,938,3,10,"RECORTES CE",0
45,"45159",85,75,74,0,1,"RECORTES CE",0
16,"16273",303,236,231,2,5,"RECORTES CE",0
19,"19200",64,56,56,0,0,"RECORTES CE",0
19,"19216",130,100,99,1,1,"RECORTES CE",0
47,"47081",41,36,36,0,0,"RECORTES CE",0
9,"9355",87,69,67,1,2,"RECORTES CE",0
9,"9302",98,75,73,0,2,"RECORTES CE",1
9,"9463",250,203,201,6,2,"RECORTES CE",0
16,"16044",43,31,30,0,1,"RECORTES CE",0
13,"13089",1609,1336,1299,10,37,"RECORTES CE",1
42,"42155",142,92,92,0,0,"RECORTES CE",0
40,"40054",107,91,88,0,3,"RECORTES CE",0
19,"19306",22,19,19,0,0,"RECORTES CE",0
42,"42197",68,56,56,0,0,"RECORTES CE",0
47,"47146",278,232,230,3,2,"RECORTES CE",0
9,"9135",40,34,34,0,0,"RECORTES CE",1
19,"19218",45,34,34,1,0,"RECORTES CE",0
2,"2024",3374,2657,2613,23,44,"RECORTES CE",1
16,"16088",101,85,85,1,0,"RECORTES CE",0
28,"28183",1124,857,842,4,15,"RECORTES CE",0
37,"37154",129,106,102,3,4,"RECORTES CE",0
28,"28025",404,314,305,3,9,"RECORTES CE",0
47,"47103",255,215,214,3,1,"RECORTES CE",1
24,"24071",967,755,741,7,14,"RECORTES CE",0
5,"5106",28,22,22,0,0,"RECORTES CE",0
34,"34160",134,114,112,0,2,"RECORTES CE",0
2,"2062",386,287,285,4,2,"RECORTES CE",0
40,"40184",248,205,203,0,2,"RECORTES CE",2
9,"9306",98,82,81,1,1,"RECORTES CE",0
16,"16172",349,278,275,3,3,"RECORTES CE",0
5,"5195",206,157,157,0,0,"RECORTES CE",2
28,"28015",20440,17084,16953,103,131,"RECORTES CE",34
47,"47148",423,342,339,2,3,"RECORTES CE",1
19,"19078",50,38,37,0,1,"RECORTES CE",0
37,"37122",203,174,174,1,0,"RECORTES CE",0
34,"34112",39,30,30,0,0,"RECORTES CE",0
28,"28088",286,193,193,2,0,"RECORTES CE",2
37,"37335",389,308,301,3,7,"RECORTES CE",0
5,"5196",57,45,42,0,3,"RECORTES CE",0
19,"19263",22,13,12,0,1,"RECORTES CE",0
24,"24007",753,569,563,4,6,"RECORTES CE",0
24,"24179",299,239,238,3,1,"RECORTES CE",0
34,"34246",69,53,53,0,0,"RECORTES CE",0
19,"19235",98,82,81,0,1,"RECORTES CE",0
37,"37324",335,276,274,1,2,"RECORTES CE",0
37,"37173",1420,1077,1058,13,19,"RECORTES CE",0
42,"42189",53,44,42,0,2,"RECORTES CE",0
45,"45028",3628,2916,2863,16,53,"RECORTES CE",5
24,"24061",1736,1350,1328,10,22,"RECORTES CE",0
24,"24143",495,388,380,2,8,"RECORTES CE",1
37,"37124",196,153,153,2,0,"RECORTES CE",0
40,"40198",24,20,20,0,0,"RECORTES CE",0
5,"5197",100,84,83,0,1,"RECORTES CE",0
16,"16174",168,143,141,1,2,"RECORTES CE",0
34,"34163",46,40,40,1,0,"RECORTES CE",0
13,"13003",449,346,343,0,3,"RECORTES CE",0
47,"47054",613,501,498,0,3,"RECORTES CE",1
37,"37038",751,607,592,4,15,"RECORTES CE",1
13,"13034",58768,46017,45585,385,432,"RECORTES CE",109
16,"16079",26,17,17,0,0,"RECORTES CE",0
37,"37035",165,134,134,0,0,"RECORTES CE",0
37,"37300",547,392,391,5,1,"RECORTES CE",0
28,"28039",125,103,103,2,0,"RECORTES CE",0
49,"49002",58,49,43,0,6,"RECORTES CE",0
34,"34057",462,345,330,3,15,"RECORTES CE",2
13,"13050",479,399,394,2,5,"RECORTES CE",0
16,"16094",120,89,88,0,1,"RECORTES CE",0
28,"28018",4068,3367,3344,15,23,"RECORTES CE",5
49,"49148",264,146,136,1,10,"RECORTES CE",1
5,"5083",141,104,103,2,1,"RECORTES CE",0
45,"45122",5516,4611,4561,28,50,"RECORTES CE",8
49,"49027",126,88,88,0,0,"RECORTES CE",0
9,"9043",186,128,128,1,0,"RECORTES CE",1
34,"34087",122,105,105,0,0,"RECORTES CE",0
19,"19132",93,72,72,0,0,"RECORTES CE",0
16,"16011",23,18,18,0,0,"RECORTES CE",0
13,"13005",23187,18379,18119,174,260,"RECORTES CE",35
9,"9310",15,14,13,1,1,"RECORTES CE",0
28,"28125",3216,2459,2444,11,15,"RECORTES CE",6
40,"40059",108,90,89,0,1,"RECORTES CE",0
49,"49149",365,285,282,2,3,"RECORTES CE",0
9,"9129",89,75,75,0,0,"RECORTES CE",0
45,"45201",3620,2465,2419,10,46,"RECORTES CE",6
34,"34904",300,220,220,0,0,"RECORTES CE",1
45,"45001",1837,1371,1340,12,31,"RECORTES CE",4
9,"9183",47,41,41,0,0,"RECORTES CE",0
40,"40156",281,223,222,1,1,"RECORTES CE",0
49,"49017",259,196,195,0,1,"RECORTES CE",1
19,"19255",72,51,51,0,0,"RECORTES CE",1
49,"49150",123,90,90,3,0,"RECORTES CE",0
40,"40132",46,32,31,1,1,"RECORTES CE",0
16,"16096",280,239,234,3,5,"RECORTES CE",0
24,"24160",645,481,475,1,6,"RECORTES CE",1
40,"40168",28,22,22,0,0,"RECORTES CE",0
28,"28021",576,387,386,3,1,"RECORTES CE",0
45,"45033",298,224,221,1,3,"RECORTES CE",0
24,"24229",388,312,307,2,5,"RECORTES CE",0
16,"16097",139,121,120,1,1,"RECORTES CE",1
49,"49189",192,132,128,1,4,"RECORTES CE",0
16,"16237",98,83,83,0,0,"RECORTES CE",0
49,"49030",80,66,62,0,4,"RECORTES CE",0
28,"28094",959,736,729,6,7,"RECORTES CE",1
19,"19089",25,19,19,1,0,"RECORTES CE",0
37,"37216",294,248,247,2,1,"RECORTES CE",1
19,"19053",1929,1472,1458,9,14,"RECORTES CE",3
49,"49190",50,45,45,1,0,"RECORTES CE",0
28,"28160",8629,6922,6856,34,66,"RECORTES CE",19
19,"19271",41,26,26,0,0,"RECORTES CE",0
9,"9424",34,24,24,0,0,"RECORTES CE",0
5,"5205",79,66,66,0,0,"RECORTES CE",0
42,"42071",163,111,108,2,3,"RECORTES CE",0
9,"9425",476,366,362,1,4,"RECORTES CE",2
42,"42057",147,95,93,3,2,"RECORTES CE",1
16,"16126",729,622,616,5,6,"RECORTES CE",0
9,"9259",227,198,197,2,1,"RECORTES CE",1
34,"34174",178,150,149,2,1,"RECORTES CE",1
49,"49153",151,110,108,0,2,"RECORTES CE",0
16,"16056",453,323,321,1,2,"RECORTES CE",1
37,"37280",71,41,40,0,1,"RECORTES CE",0
42,"42073",73,58,57,0,1,"RECORTES CE",0
49,"49076",328,260,258,6,2,"RECORTES CE",0
13,"13012",382,279,277,2,2,"RECORTES CE",0
24,"24096",108,69,69,0,0,"RECORTES CE",0
9,"9101",74,57,57,0,0,"RECORTES CE",0
37,"37090",66,51,51,1,0,"RECORTES CE",0
9,"9209",4419,3407,3338,37,69,"RECORTES CE",9
49,"49116",360,255,248,5,7,"RECORTES CE",0
45,"45084",2121,1708,1676,16,32,"RECORTES CE",1
40,"40205",229,185,180,1,5,"RECORTES CE",1
37,"37009",196,142,141,1,1,"RECORTES CE",0
40,"40101",923,737,728,8,9,"RECORTES CE",2
37,"37358",164,142,135,2,7,"RECORTES CE",1
49,"49078",142,113,113,1,0,"RECORTES CE",0
28,"28024",168,146,145,1,1,"RECORTES CE",0
34,"34079",1715,1421,1402,10,19,"RECORTES CE",1
45,"45085",1511,1141,1128,9,13,"RECORTES CE",1
9,"9051",163,134,133,1,1,"RECORTES CE",0
47,"47030",941,759,740,3,19,"RECORTES CE",3
5,"5208",38,31,31,0,0,"RECORTES CE",0
37,"37320",88,67,67,1,0,"RECORTES CE",0
9,"9902",446,345,341,0,4,"RECORTES CE",4
9,"9137",180,149,147,1,2,"RECORTES CE",0
9,"9083",27,24,23,0,1,"RECORTES CE",0
24,"24123",716,514,507,2,7,"RECORTES CE",0
34,"34176",127,106,104,2,2,"RECORTES CE",1
37,"37092",1889,1459,1447,16,12,"RECORTES CE",1
49,"49035",222,195,195,2,0,"RECORTES CE",0
16,"16244",708,627,617,1,10,"RECORTES CE",0
16,"16018",381,313,312,2,1,"RECORTES CE",0
28,"28097",125,100,100,0,0,"RECORTES CE",0
28,"28131",13432,10500,10387,81,113,"RECORTES CE",18
47,"47001",52,47,46,0,1,"RECORTES CE",0
37,"37133",101,84,80,0,4,"RECORTES CE",0
37,"37359",163,122,117,0,5,"RECORTES CE",0
16,"16190",4957,4006,3945,36,61,"RECORTES CE",1
5,"5171",67,57,51,1,6,"RECORTES CE",0
34,"34024",25,17,16,1,1,"RECORTES CE",0
37,"37247",173,144,143,1,1,"RECORTES CE",0
37,"37012",145,116,114,0,2,"RECORTES CE",0
40,"40233",396,323,320,2,3,"RECORTES CE",0
42,"42080",150,116,116,1,0,"RECORTES CE",0
24,"24021",1602,1211,1194,7,17,"RECORTES CE",2
24,"24113",351,277,272,2,5,"RECORTES CE",1
42,"42173",29702,22141,21776,301,365,"RECORTES CE",48
16,"16192",43,30,29,0,1,"RECORTES CE",0
5,"5211",430,364,357,6,7,"RECORTES CE",0
9,"9056",4812,3585,3533,36,52,"RECORTES CE",5
19,"19098",18,18,17,0,1,"RECORTES CE",0
45,"45043",783,670,664,6,6,"RECORTES CE",0
24,"24155",442,374,371,6,3,"RECORTES CE",1
5,"5055",540,448,445,1,3,"RECORTES CE",0
42,"42037",29,19,18,0,1,"RECORTES CE",0
28,"28101",229,183,182,2,1,"RECORTES CE",1
5,"5173",59,52,52,0,0,"RECORTES CE",0
49,"49159",269,214,213,1,1,"RECORTES CE",1
47,"47129",855,715,696,3,19,"RECORTES CE",1
19,"19148",42,35,33,0,2,"RECORTES CE",0
28,"28166",347,287,286,1,1,"RECORTES CE",0
9,"9164",150,116,114,0,2,"RECORTES CE",1
5,"5186",1558,1255,1247,9,8,"RECORTES CE",2
19,"19047",55,47,47,0,0,"RECORTES CE",0
37,"37363",107,81,80,0,1,"RECORTES CE",0
24,"24050",105,88,87,3,1,"RECORTES CE",0
47,"47161",3945,3370,3344,20,26,"RECORTES CE",2
19,"19194",94,76,76,0,0,"RECORTES CE",0
37,"37137",99,65,65,0,0,"RECORTES CE",0
24,"24036",272,181,179,4,2,"RECORTES CE",0
16,"16023",507,401,398,2,3,"RECORTES CE",1
37,"37099",61,46,46,1,0,"RECORTES CE",0
42,"42129",678,540,539,1,1,"RECORTES CE",2
13,"13066",2604,2182,2146,6,36,"RECORTES CE",1
5,"5135",398,324,320,2,4,"RECORTES CE",1
19,"19181",55,47,46,1,1,"RECORTES CE",0
34,"34042",292,244,243,3,1,"RECORTES CE",0
24,"24078",336,259,255,0,4,"RECORTES CE",0
47,"47130",99,76,76,2,0,"RECORTES CE",0
24,"24159",1746,1393,1368,6,25,"RECORTES CE",0
13,"13067",342,298,295,0,3,"RECORTES CE",0
42,"42219",40,33,32,1,1,"RECORTES CE",0
37,"37288",276,225,224,5,1,"RECORTES CE",0
19,"19284",10,9,9,1,0,"RECORTES CE",0
19,"19240",51,42,41,1,1,"RECORTES CE",3
34,"34045",73,67,65,0,2,"RECORTES CE",0
24,"24214",634,473,471,3,2,"RECORTES CE",0
19,"19152",550,413,405,3,8,"RECORTES CE",0
37,"37101",142,119,117,0,2,"RECORTES CE",0
47,"47225",74,61,60,0,1,"RECORTES CE",0
5,"5177",139,117,117,0,0,"RECORTES CE",2
37,"37029",193,139,133,1,6,"RECORTES CE",0
9,"9332",140,103,102,0,1,"RECORTES CE",0
5,"5215",159,126,124,0,2,"RECORTES CE",0
2,"2008",1123,857,842,9,15,"RECORTES CE",1
5,"5126",62,53,52,0,1,"RECORTES CE",0
37,"37214",116,87,87,4,0,"RECORTES CE",0
49,"49041",414,309,307,4,2,"RECORTES CE",0
5,"5138",289,224,223,2,1,"RECORTES CE",0
13,"13070",766,620,604,6,16,"RECORTES CE",0
47,"47226",149,124,123,0,1,"RECORTES CE",1
9,"9389",64,50,50,0,0,"RECORTES CE",0
45,"45050",489,381,363,3,18,"RECORTES CE",1
40,"40004",445,348,341,0,7,"RECORTES CE",0
49,"49086",111,94,93,1,1,"RECORTES CE",4
9,"9062",40,39,39,0,0,"RECORTES CE",0
19,"19090",90,73,72,1,1,"RECORTES CE",0
45,"45127",764,582,577,3,5,"RECORTES CE",1
34,"34185",68,53,51,1,2,"RECORTES CE",0
2,"2045",3617,3020,2969,38,51,"RECORTES CE",2
40,"40145",1105,906,899,2,7,"RECORTES CE",2
45,"45142",7800,6245,6143,67,102,"RECORTES CE",3
49,"49126",273,161,160,1,1,"RECORTES CE",0
49,"49206",794,584,570,7,14,"RECORTES CE",0
45,"45005",227,180,174,5,6,"RECORTES CE",0
19,"19040",57,40,40,0,0,"RECORTES CE",0
37,"37243",90,71,70,0,1,"RECORTES CE",0
16,"16199",28,23,23,1,0,"RECORTES CE",0
40,"40148",228,185,180,0,5,"RECORTES CE",0
40,"40216",774,670,665,11,5,"RECORTES CE",1
9,"9117",71,55,53,0,2,"RECORTES CE",0
37,"37142",566,446,444,6,2,"RECORTES CE",0
24,"24042",61,47,47,1,0,"RECORTES CE",0
42,"42135",70,46,45,0,1,"RECORTES CE",0
24,"24082",860,690,678,12,12,"RECORTES CE",0
16,"16070",28,26,26,1,0,"RECORTES CE",0
24,"24163",4073,3269,3231,36,38,"RECORTES CE",1
5,"5063",31,27,27,0,0,"RECORTES CE",0
47,"47196",28,24,24,0,0,"RECORTES CE",0
49,"49046",242,178,175,0,3,"RECORTES CE",0
9,"9338",231,193,189,2,4,"RECORTES CE",1
49,"49250",1194,954,939,8,15,"RECORTES CE",3
49,"49128",533,428,424,7,4,"RECORTES CE",1
28,"28003",170,148,148,1,0,"RECORTES CE",1
40,"40183",116,103,103,0,0,"RECORTES CE",0
45,"45192",2412,2103,2068,7,35,"RECORTES CE",0
37,"37369",125,95,93,0,2,"RECORTES CE",0
37,"37293",106,75,74,0,1,"RECORTES CE",0
16,"16156",82,65,65,0,0,"RECORTES CE",0
16,"16203",10167,7720,7591,49,129,"RECORTES CE",6
9,"9019",144,113,109,1,4,"RECORTES CE",0
45,"45055",998,844,828,4,16,"RECORTES CE",0
19,"19246",42,30,30,0,0,"RECORTES CE",0
28,"28096",19809,15584,15392,118,192,"RECORTES CE",28
45,"45177",2023,1693,1651,11,42,"RECORTES CE",2
49,"49117",437,340,335,1,5,"RECORTES CE",0
45,"45101",3709,3052,3002,14,50,"RECORTES CE",2
37,"37022",245,200,196,2,4,"RECORTES CE",0
37,"37296",298,241,239,2,2,"RECORTES CE",0
42,"42090",88,69,68,2,1,"RECORTES CE",2
2,"2014",350,285,280,1,5,"RECORTES CE",2
5,"5262",323,254,254,0,0,"RECORTES CE",0
19,"19112",53,41,40,1,1,"RECORTES CE",0
16,"16204",241,198,196,1,2,"RECORTES CE",0
13,"13031",2471,2044,2020,15,24,"RECORTES CE",4
28,"28006",80622,64905,64483,400,422,"RECORTES CE",136
37,"37371",258,176,175,0,1,"RECORTES CE",0
28,"28174",1840,1363,1349,10,14,"RECORTES CE",5
24,"24124",346,231,226,2,5,"RECORTES CE",0
42,"42011",17,11,11,0,0,"RECORTES CE",0
45,"45195",2072,1615,1583,4,32,"RECORTES CE",4
16,"16033",1644,1345,1320,11,25,"RECORTES CE",2
28,"28036",2675,2135,2093,17,42,"RECORTES CE",4
16,"16074",28,23,23,0,0,"RECORTES CE",0
16,"16205",107,80,79,0,1,"RECORTES CE",1
13,"13032",1084,842,831,9,11,"RECORTES CE",1
5,"5094",132,109,108,1,1,"RECORTES CE",0
5,"5147",147,119,117,0,2,"RECORTES CE",0
42,"42051",15,10,10,0,0,"RECORTES CE",0
47,"47013",90,80,78,4,2,"RECORTES CE",0
9,"9071",40,32,32,0,0,"RECORTES CE",0
49,"49171",610,477,473,8,4,"RECORTES CE",1
49,"49094",213,138,138,0,0,"RECORTES CE",0
37,"37147",172,130,127,3,3,"RECORTES CE",0
13,"13078",8936,6820,6733,46,87,"RECORTES CE",7
9,"9346",89,69,68,1,1,"RECORTES CE",0
47,"47043",309,276,273,1,3,"RECORTES CE",0
49,"49257",310,205,202,2,3,"RECORTES CE",0
34,"34009",30,26,26,0,0,"RECORTES CE",0
45,"45060",158,118,118,0,0,"RECORTES CE",0
37,"37337",139,114,114,0,0,"RECORTES CE",0
16,"16209",111,97,97,0,0,"RECORTES CE",0
9,"9907",1507,1198,1174,16,24,"RECORTES CE",7
9,"9180",133,104,99,1,5,"RECORTES CE",0
2,"2005",545,443,436,5,7,"RECORTES CE",0
49,"49038",94,68,68,1,0,"RECORTES CE",0
5,"5030",43,36,36,0,0,"RECORTES CE",0
19,"19298",55,47,47,0,0,"RECORTES CE",0
40,"40082",106,83,81,0,2,"RECORTES CE",0
40,"40154",23,20,20,0,0,"RECORTES CE",0
49,"49015",201,157,155,0,2,"RECORTES CE",0
42,"42053",21,15,15,0,0,"RECORTES CE",0
49,"49054",849,641,629,5,12,"RECORTES CE",1
9,"9128",78,63,61,1,2,"RECORTES CE",0
37,"37187",555,437,433,0,4,"RECORTES CE",0
9,"9011",73,50,49,0,1,"RECORTES CE",3
37,"37150",36,31,31,0,0,"RECORTES CE",0
28,"28009",14500,11656,11564,62,92,"RECORTES CE",16
37,"37028",137,111,107,1,4,"RECORTES CE",0
16,"16038",28,21,21,0,0,"RECORTES CE",0
47,"47109",171,130,130,1,0,"RECORTES CE",0
5,"5227",340,237,234,0,3,"RECORTES CE",0
16,"16122",249,197,196,3,1,"RECORTES CE",0
5,"5112",95,66,64,2,2,"RECORTES CE",0
24,"24171",349,201,198,4,3,"RECORTES CE",0
47,"47110",438,352,347,4,5,"RECORTES CE",0
45,"45186",2945,2319,2280,11,39,"RECORTES CE",2
49,"49135",588,409,405,0,4,"RECORTES CE",1
47,"47142",124,94,92,0,2,"RECORTES CE",0
42,"42016",20,13,13,0,0,"RECORTES CE",0
13,"13038",1604,1251,1216,14,35,"RECORTES CE",3
37,"37289",218,159,158,0,1,"RECORTES CE",0
49,"49136",312,227,220,3,7,"RECORTES CE",0
16,"16039",367,263,262,2,1,"RECORTES CE",0
34,"34208",47,38,38,0,0,"RECORTES CE",0
45,"45094",367,290,288,4,2,"RECORTES CE",1
37,"37229",139,110,106,2,4,"RECORTES CE",0
9,"9131",480,412,402,2,10,"RECORTES CE",1
34,"34104",233,190,189,1,1,"RECORTES CE",1
45,"45203",2713,2092,2053,16,39,"RECORTES CE",6
34,"34154",76,59,58,0,1,"RECORTES CE",0
9,"9297",313,268,267,6,1,"RECORTES CE",0
47,"47079",54,48,48,0,0,"RECORTES CE",0
28,"28179",1450,1115,1100,3,15,"RECORTES CE",3
45,"45111",53,43,41,0,2,"RECORTES CE",0
40,"40225",1098,902,882,4,20,"RECORTES CE",2
5,"5021",1871,1469,1440,15,29,"RECORTES CE",2
37,"37178",99,82,82,0,0,"RECORTES CE",0
9,"9032",103,72,72,0,0,"RECORTES CE",0
16,"16085",135,109,109,1,0,"RECORTES CE",0
19,"19303",40,35,35,0,0,"RECORTES CE",0
9,"9298",75,62,62,1,0,"RECORTES CE",0
34,"34061",96,77,77,2,0,"RECORTES CE",0
40,"40052",72,56,56,0,0,"RECORTES CE",2
5,"5036",116,100,100,0,0,"RECORTES CE",0
19,"19215",144,121,119,0,2,"RECORTES CE",0
49,"49178",747,574,564,4,10,"RECORTES CE",1
28,"28150",3187,2640,2604,20,36,"RECORTES CE",6
24,"24016",507,314,311,2,3,"RECORTES CE",0
16,"16216",278,243,240,0,3,"RECORTES CE",0
5,"5116",96,77,75,0,2,"RECORTES CE",0
40,"40159",132,101,101,0,0,"RECORTES CE",0
42,"42103",554,448,442,2,6,"RECORTES CE",2
16,"16086",881,751,747,3,4,"RECORTES CE",1
19,"19258",84,69,66,1,3,"RECORTES CE",0
34,"34157",2364,1881,1846,13,35,"RECORTES CE",2
19,"19073",16,13,13,0,0,"RECORTES CE",0
49,"49179",346,233,232,0,1,"RECORTES CE",1
19,"19122",81,64,64,1,0,"RECORTES CE",0
49,"49141",296,220,218,0,2,"RECORTES CE",0
45,"45114",560,441,436,0,5,"RECORTES CE",0
13,"13043",209,167,167,1,0,"RECORTES CE",0
5,"5232",106,87,84,1,3,"RECORTES CE",1
45,"45901",780,593,587,3,6,"RECORTES CE",2
28,"28013",41563,32024,31693,194,331,"RECORTES CE",50
19,"19022",571,443,434,7,9,"RECORTES CE",1
47,"47176",202,138,138,1,0,"RECORTES CE",0
13,"13044",2569,1984,1951,12,33,"RECORTES CE",3
24,"24018",174,141,139,0,2,"RECORTES CE",0
42,"42106",14,12,12,0,0,"RECORTES CE",0
49,"49180",138,95,95,0,0,"RECORTES CE",1
49,"49226",239,207,200,3,7,"RECORTES CE",0
9,"9192",55,48,47,2,1,"RECORTES CE",0
9,"9466",112,87,85,2,2,"RECORTES CE",0
40,"40089",214,176,170,1,6,"RECORTES CE",0
9,"9464",33,27,27,0,0,"RECORTES CE",0
9,"9176",59,50,47,2,3,"RECORTES CE",0
34,"34022",1019,856,849,8,7,"RECORTES CE",0
19,"19076",19,18,18,0,0,"RECORTES CE",0
24,"24098",1149,882,863,7,19,"RECORTES CE",0
37,"37309",37,27,27,0,0,"RECORTES CE",0
19,"19220",2536,1833,1813,9,20,"RECORTES CE",4
34,"34215",162,143,142,3,1,"RECORTES CE",0
24,"24059",821,575,572,3,3,"RECORTES CE",0
42,"42107",67,48,48,0,0,"RECORTES CE",0
9,"9195",55,45,45,1,0,"RECORTES CE",1
40,"40162",387,286,278,3,8,"RECORTES CE",0
13,"13046",693,558,547,0,11,"RECORTES CE",0
42,"42158",94,78,78,0,0,"RECORTES CE",0
49,"49229",113,88,87,0,1,"RECORTES CE",0
28,"28046",4776,3944,3912,22,32,"RECORTES CE",8
9,"9037",106,97,97,0,0,"RECORTES CE",0
19,"19027",131,98,96,0,2,"RECORTES CE",0
37,"37036",57,42,41,0,1,"RECORTES CE",0
37,"37196",72,56,53,0,3,"RECORTES CE",0
42,"42061",272,207,204,2,3,"RECORTES CE",0
45,"45164",172,143,143,1,0,"RECORTES CE",1
37,"37336",52,46,45,3,1,"RECORTES CE",0
42,"42201",23,20,20,0,0,"RECORTES CE",0
5,"5121",262,201,199,0,2,"RECORTES CE",1
19,"19129",27,25,25,0,0,"RECORTES CE",0
28,"28902",523,418,415,2,3,"RECORTES CE",1
16,"16008",83,65,65,0,0,"RECORTES CE",1
49,"49108",454,325,322,2,3,"RECORTES CE",1
47,"47212",358,312,311,3,1,"RECORTES CE",0
45,"45074",401,335,326,3,9,"RECORTES CE",0
45,"45027",327,276,273,0,3,"RECORTES CE",0
42,"42159",40,36,35,0,1,"RECORTES CE",0
19,"19177",61,49,48,0,1,"RECORTES CE",0
40,"40022",193,162,159,2,3,"RECORTES CE",0
9,"9472",52,45,44,0,1,"RECORTES CE",0
16,"16228",176,150,150,1,0,"RECORTES CE",0
5,"5082",495,399,394,1,5,"RECORTES CE",0
42,"42013",37,29,29,0,0,"RECORTES CE",0
37,"37082",745,546,536,2,10,"RECORTES CE",0
5,"5109",441,363,356,5,7,"RECORTES CE",1
42,"42095",1857,1498,1473,21,25,"RECORTES CE",6
9,"9365",27,19,19,1,0,"RECORTES CE",0
24,"24145",618,443,435,3,8,"RECORTES CE",0
47,"47024",232,189,188,0,1,"RECORTES CE",0
47,"47055",192,157,154,1,3,"RECORTES CE",0
9,"9251",365,278,277,0,1,"RECORTES CE",2
2,"2030",2978,2357,2315,13,42,"RECORTES CE",2
40,"40165",74,56,54,1,2,"RECORTES CE",0
9,"9419",67,53,52,0,1,"RECORTES CE",0
37,"37199",129,97,97,0,0,"RECORTES CE",0
28,"28157",682,530,516,1,14,"RECORTES CE",1
24,"24182",411,302,295,4,7,"RECORTES CE",0
34,"34120",63965,50687,50117,471,570,"RECORTES CE",118
40,"40902",117,96,96,1,0,"RECORTES CE",1
45,"45031",2824,2104,2068,20,36,"RECORTES CE",5
19,"19314",45,38,38,1,0,"RECORTES CE",0
9,"9253",106,88,85,2,3,"RECORTES CE",0
9,"9421",242,197,196,2,1,"RECORTES CE",3
37,"37314",82,72,68,0,4,"RECORTES CE",0
34,"34072",143,130,128,1,2,"RECORTES CE",0
13,"13053",14075,10930,10798,98,132,"RECORTES CE",18
37,"37228",325,278,273,0,5,"RECORTES CE",0
49,"49123",532,406,402,2,4,"RECORTES CE",0
49,"49203",287,229,223,2,6,"RECORTES CE",0
47,"47006",186,153,149,1,4,"RECORTES CE",0
16,"16025",25,21,21,0,0,"RECORTES CE",1
37,"37188",160,115,112,3,3,"RECORTES CE",1
49,"49029",614,497,488,9,9,"RECORTES CE",1
42,"42029",131,98,97,2,1,"RECORTES CE",0
49,"49071",715,500,499,3,1,"RECORTES CE",0
37,"37165",31,22,21,0,1,"RECORTES CE",0
28,"28020",169,110,109,0,1,"RECORTES CE",0
24,"24105",1498,1188,1177,18,11,"RECORTES CE",0
47,"47122",2016,1655,1617,15,38,"RECORTES CE",1
34,"34031",26,24,24,0,0,"RECORTES CE",0
19,"19227",73,55,53,0,2,"RECORTES CE",0
40,"40134",697,560,548,7,12,"RECORTES CE",0
37,"37316",716,576,565,4,11,"RECORTES CE",1
13,"13902",449,362,360,2,2,"RECORTES CE",0
2,"2070",384,318,318,2,0,"RECORTES CE",0
2,"2033",1870,1503,1463,11,40,"RECORTES CE",2
9,"9206",55,47,47,1,0,"RECORTES CE",0
40,"40061",65,50,48,2,2,"RECORTES CE",0
42,"42030",89,72,72,0,0,"RECORTES CE",1
37,"37242",80,65,64,1,1,"RECORTES CE",0
37,"37166",199,146,144,0,2,"RECORTES CE",0
13,"13903",493,412,406,1,6,"RECORTES CE",0
24,"24187",845,641,630,6,11,"RECORTES CE",1
9,"9095",112,70,68,1,2,"RECORTES CE",0
37,"37007",399,311,306,3,5,"RECORTES CE",0
40,"40905",128,101,100,4,1,"RECORTES CE",0
5,"5048",106,98,94,1,4,"RECORTES CE",0
2,"2034",1324,1088,1083,10,5,"RECORTES CE",1
45,"45174",296,253,250,3,3,"RECORTES CE",0
28,"28095",1677,1310,1293,4,17,"RECORTES CE",0
47,"47155",3410,2694,2660,21,34,"RECORTES CE",6
19,"19091",23,19,19,0,0,"RECORTES CE",0
5,"5206",29,21,20,1,1,"RECORTES CE",0
24,"24107",214,170,170,2,0,"RECORTES CE",0
13,"13011",4506,3111,3044,29,67,"RECORTES CE",6
24,"24029",695,521,520,4,1,"RECORTES CE",0
24,"24151",445,334,328,3,6,"RECORTES CE",0
19,"19272",65,58,56,1,2,"RECORTES CE",0
9,"9901",340,256,255,1,1,"RECORTES CE",1
40,"40029",24,21,21,0,0,"RECORTES CE",0
40,"40063",6944,5479,5352,39,127,"RECORTES CE",9
9,"9050",52,36,36,0,0,"RECORTES CE",3
42,"42120",132,89,87,0,2,"RECORTES CE",0
37,"37319",93,67,65,1,2,"RECORTES CE",0
24,"24069",39,27,27,0,0,"RECORTES CE",0
9,"9211",1362,1065,1050,16,15,"RECORTES CE",7
37,"37357",258,0,0,0,0,"RECORTES CE",0
42,"42121",55,42,42,0,0,"RECORTES CE",0
5,"5052",87,77,77,0,0,"RECORTES CE",2
19,"19188",43,34,33,0,1,"RECORTES CE",0
37,"37282",194,148,146,1,2,"RECORTES CE",0
47,"47061",243,203,197,3,6,"RECORTES CE",0
2,"2036",95,75,75,0,0,"RECORTES CE",0
47,"47157",495,428,426,3,2,"RECORTES CE",0
24,"24190",146,109,109,1,0,"RECORTES CE",1
28,"28055",907,671,666,5,5,"RECORTES CE",0
16,"16045",185,142,141,0,1,"RECORTES CE",0
45,"45086",493,373,368,0,5,"RECORTES CE",0
9,"9378",29,21,20,0,1,"RECORTES CE",2
37,"37321",149,121,121,0,0,"RECORTES CE",0
47,"47220",154,119,119,1,0,"RECORTES CE",0
9,"9903",3139,2379,2352,27,27,"RECORTES CE",7
9,"9103",200,179,179,1,0,"RECORTES CE",1
24,"24191",108,89,89,0,0,"RECORTES CE",0
37,"37322",2466,1764,1723,17,41,"RECORTES CE",2
37,"37011",99,75,73,0,2,"RECORTES CE",0
24,"24110",1154,895,880,5,15,"RECORTES CE",1
45,"45040",1276,842,828,4,14,"RECORTES CE",0
28,"28163",429,361,345,4,16,"RECORTES CE",2
24,"24032",102,84,83,0,1,"RECORTES CE",0
24,"24154",955,702,691,3,11,"RECORTES CE",0
47,"47158",858,672,663,8,9,"RECORTES CE",0
9,"9325",177,117,117,2,0,"RECORTES CE",0
40,"40033",67,57,57,1,0,"RECORTES CE",0
49,"49036",508,361,355,6,6,"RECORTES CE",0
34,"34130",198,165,161,2,4,"RECORTES CE",0
24,"24033",205,146,146,3,0,"RECORTES CE",0
34,"34038",268,198,197,0,1,"RECORTES CE",0
47,"47159",831,703,693,0,10,"RECORTES CE",0
5,"5133",67,48,48,0,0,"RECORTES CE",0
34,"34231",217,184,178,0,6,"RECORTES CE",1
9,"9326",154,129,127,4,2,"RECORTES CE",0
37,"37209",410,288,283,3,5,"RECORTES CE",0
49,"49158",203,163,155,0,8,"RECORTES CE",0
47,"47033",204,167,167,2,0,"RECORTES CE",0
42,"42216",26,20,20,1,0,"RECORTES CE",0
28,"28027",1200,920,906,4,14,"RECORTES CE",6
2,"2077",54,45,44,0,1,"RECORTES CE",0
2,"2004",606,504,499,5,5,"RECORTES CE",0
45,"45090",368,287,286,1,1,"RECORTES CE",0
9,"9009",158,139,137,4,2,"RECORTES CE",1
40,"40106",183,153,151,2,2,"RECORTES CE",0
19,"19237",40,33,33,0,0,"RECORTES CE",0
37,"37325",90,70,70,0,0,"RECORTES CE",0
45,"45136",5825,4314,4260,22,54,"RECORTES CE",5
40,"40141",833,644,627,5,17,"RECORTES CE",1
34,"34220",149,133,132,0,1,"RECORTES CE",0
5,"5057",2401,1949,1917,19,32,"RECORTES CE",3
9,"9218",347,277,271,0,6,"RECORTES CE",0
9,"9058",395,325,317,1,8,"RECORTES CE",1
13,"13065",2813,1993,1971,13,22,"RECORTES CE",12
49,"49083",50,41,41,1,0,"RECORTES CE",0
19,"19283",32,26,26,0,0,"RECORTES CE",0
19,"19048",19,13,13,0,0,"RECORTES CE",0
47,"47004",1136,950,939,5,11,"RECORTES CE",1
47,"47191",115,85,84,0,1,"RECORTES CE",0
40,"40035",135,111,110,0,1,"RECORTES CE",0
37,"37212",101,85,83,0,2,"RECORTES CE",0
49,"49202",172,125,124,2,1,"RECORTES CE",0
9,"9167",53,39,36,0,3,"RECORTES CE",0
5,"5017",86,74,73,0,1,"RECORTES CE",0
24,"24037",337,234,234,1,0,"RECORTES CE",0
40,"40212",27,22,20,0,2,"RECORTES CE",0
45,"45139",145,118,117,1,1,"RECORTES CE",0
37,"37100",77,60,59,1,1,"RECORTES CE",0
45,"45185",7600,6094,5999,19,95,"RECORTES CE",11
40,"40036",502,413,406,11,7,"RECORTES CE",1
37,"37138",219,180,176,1,4,"RECORTES CE",1
37,"37151",143,112,111,1,1,"RECORTES CE",0
2,"2020",431,359,356,3,3,"RECORTES CE",0
45,"45109",2786,2273,2206,9,67,"RECORTES CE",3
42,"42097",14,7,7,0,0,"RECORTES CE",0
24,"24199",405,302,297,3,5,"RECORTES CE",1
34,"34088",264,211,207,1,4,"RECORTES CE",0
34,"34134",40,31,31,1,0,"RECORTES CE",0
9,"9388",33,28,28,0,0,"RECORTES CE",0
28,"28061",22564,18245,18064,117,181,"RECORTES CE",30
19,"19002",57,45,45,0,0,"RECORTES CE",0
24,"24039",1954,1563,1552,28,11,"RECORTES CE",2
16,"16109",41,33,33,3,0,"RECORTES CE",0
5,"5901",253,173,171,1,2,"RECORTES CE",1
40,"40074",245,219,214,5,5,"RECORTES CE",1
37,"37018",110,86,85,1,1,"RECORTES CE",0
47,"47067",153,119,119,3,0,"RECORTES CE",0
16,"16250",65,41,41,0,0,"RECORTES CE",0
13,"13040",841,690,666,2,24,"RECORTES CE",0
34,"34017",889,743,738,6,5,"RECORTES CE",3
16,"16197",66,45,45,0,0,"RECORTES CE",0
37,"37140",642,422,418,2,4,"RECORTES CE",0
47,"47133",2776,2317,2292,28,25,"RECORTES CE",6
37,"37103",414,309,309,4,0,"RECORTES CE",0
42,"42181",391,319,317,0,2,"RECORTES CE",1
19,"19198",17,17,17,0,0,"RECORTES CE",0
19,"19052",21,16,16,0,0,"RECORTES CE",0
19,"19287",136,107,105,3,2,"RECORTES CE",0
49,"49007",365,271,265,7,6,"RECORTES CE",0
34,"34137",24,23,22,2,1,"RECORTES CE",0
16,"16154",4752,3798,3732,37,66,"RECORTES CE",7
34,"34189",53,39,39,1,0,"RECORTES CE",0
45,"45098",2110,1675,1652,6,23,"RECORTES CE",2
24,"24121",616,491,484,4,7,"RECORTES CE",0
49,"49166",1192,916,899,10,17,"RECORTES CE",1
9,"9337",114,93,93,0,0,"RECORTES CE",0
16,"16068",127,104,104,4,0,"RECORTES CE",0
47,"47039",166,134,134,0,0,"RECORTES CE",0
42,"42182",51,42,42,1,0,"RECORTES CE",0
16,"16155",488,411,408,3,3,"RECORTES CE",0
19,"19005",91,63,63,0,0,"RECORTES CE",1
34,"34241",18,17,14,4,3,"RECORTES CE",0
40,"40041",967,773,764,9,9,"RECORTES CE",2
9,"9064",305,251,249,3,2,"RECORTES CE",4
42,"42088",60,53,53,0,0,"RECORTES CE",0
5,"5219",37,30,30,0,0,"RECORTES CE",0
24,"24043",122,71,69,0,2,"RECORTES CE",0
37,"37021",69,52,51,1,1,"RECORTES CE",0
49,"49091",248,185,183,4,2,"RECORTES CE",0
49,"49168",93,74,74,0,0,"RECORTES CE",0
40,"40112",2772,2255,2223,21,32,"RECORTES CE",6
42,"42089",57,48,48,1,0,"RECORTES CE",0
9,"9339",126,105,105,1,0,"RECORTES CE",0
47,"47040",61,45,44,0,1,"RECORTES CE",0
5,"5181",46,39,39,0,0,"RECORTES CE",0
19,"19110",56,47,47,0,0,"RECORTES CE",0
34,"34158",286,194,194,0,0,"RECORTES CE",0
24,"24165",327,236,233,1,3,"RECORTES CE",0
9,"9280",27,22,22,0,0,"RECORTES CE",0
49,"49010",348,301,295,6,6,"RECORTES CE",0
42,"42076",201,157,151,0,6,"RECORTES CE",0
16,"16032",277,224,223,1,1,"RECORTES CE",0
9,"9067",407,285,278,2,7,"RECORTES CE",0
9,"9175",119,93,93,0,0,"RECORTES CE",0
28,"28065",130679,106997,105975,762,1022,"RECORTES CE",243
13,"13076",461,377,369,0,8,"RECORTES CE",0
16,"16258",172,128,128,2,0,"RECORTES CE",0
24,"24046",899,678,663,7,15,"RECORTES CE",1
49,"49092",116,87,86,0,1,"RECORTES CE",0
28,"28066",7515,6105,6039,40,66,"RECORTES CE",10
40,"40185",815,624,618,4,6,"RECORTES CE",0
37,"37183",386,296,294,4,2,"RECORTES CE",0
47,"47012",101,80,80,0,0,"RECORTES CE",0
47,"47042",50,41,39,0,2,"RECORTES CE",1
34,"34004",5533,4345,4286,41,59,"RECORTES CE",9
45,"45057",224,188,184,0,4,"RECORTES CE",0
45,"45010",389,280,280,3,0,"RECORTES CE",2
5,"5145",47,27,27,1,0,"RECORTES CE",0
49,"49214",664,519,510,2,9,"RECORTES CE",0
19,"19010",9,10,10,0,0,"RECORTES CE",0
24,"24087",586,469,460,4,9,"RECORTES CE",0
45,"45149",539,448,440,0,8,"RECORTES CE",0
47,"47199",71,59,59,3,0,"RECORTES CE",0
19,"19296",27,24,24,0,0,"RECORTES CE",0
24,"24210",527,387,386,0,1,"RECORTES CE",0
5,"5067",74,61,60,0,1,"RECORTES CE",0
37,"37373",700,522,514,0,8,"RECORTES CE",0
5,"5027",260,217,211,3,6,"RECORTES CE",0
37,"37148",404,321,315,2,6,"RECORTES CE",1
5,"5224",100,91,90,1,1,"RECORTES CE",0
49,"49256",242,204,202,4,2,"RECORTES CE",1
40,"40186",34,29,29,0,0,"RECORTES CE",0
47,"47105",175,152,149,1,3,"RECORTES CE",0
5,"5108",40,28,28,0,0,"RECORTES CE",0
24,"24211",263,219,214,3,5,"RECORTES CE",0
47,"47200",71,62,62,0,0,"RECORTES CE",0
24,"24009",278,154,151,2,3,"RECORTES CE",0
19,"19013",114,99,99,0,0,"RECORTES CE",0
34,"34147",160,125,124,1,1,"RECORTES CE",0
16,"16161",52,47,47,0,0,"RECORTES CE",0
45,"45045",1331,1001,990,2,11,"RECORTES CE",0
13,"13035",955,739,720,6,19,"RECORTES CE",1
40,"40047",32,25,25,0,0,"RECORTES CE",0
5,"5070",30,28,28,0,0,"RECORTES CE",0
49,"49014",116,89,88,2,1,"RECORTES CE",1
19,"19165",41,36,36,0,0,"RECORTES CE",0
47,"47044",323,282,279,1,3,"RECORTES CE",0
40,"40189",479,392,380,2,12,"RECORTES CE",0
28,"28146",1792,1308,1293,8,15,"RECORTES CE",1
49,"49220",139,110,104,2,6,"RECORTES CE",0
34,"34903",183,128,128,1,0,"RECORTES CE",1
45,"45107",3423,2806,2770,18,36,"RECORTES CE",7
9,"9236",35,29,29,1,0,"RECORTES CE",0
40,"40190",48,40,39,0,1,"RECORTES CE",0
9,"9451",238,211,207,2,4,"RECORTES CE",1
40,"40048",35,29,29,0,0,"RECORTES CE",0
37,"37340",142,101,101,0,0,"RECORTES CE",0
37,"37339",308,227,226,0,1,"RECORTES CE",0
47,"47204",235,182,178,0,4,"RECORTES CE",0
2,"2055",1057,770,755,6,15,"RECORTES CE",1
49,"49098",204,157,153,2,4,"RECORTES CE",0
19,"19167",129,104,102,0,2,"RECORTES CE",0
9,"9012",92,76,75,0,1,"RECORTES CE",0
28,"28030",1815,1438,1395,10,43,"RECORTES CE",1
5,"5100",267,217,212,1,5,"RECORTES CE",0
40,"40073",385,339,335,6,4,"RECORTES CE",0
42,"42149",387,311,308,3,3,"RECORTES CE",0
9,"9238",941,573,567,8,6,"RECORTES CE",0
16,"16040",85,72,72,1,0,"RECORTES CE",0
40,"40083",72,53,51,3,2,"RECORTES CE",0
9,"9454",42,37,36,0,1,"RECORTES CE",0
49,"49057",105,85,81,2,4,"RECORTES CE",0
24,"24053",406,279,276,6,3,"RECORTES CE",0
19,"19119",75,68,66,2,2,"RECORTES CE",0
37,"37241",164,129,127,0,2,"RECORTES CE",0
37,"37116",69,51,51,0,0,"RECORTES CE",0
19,"19168",266,211,206,4,5,"RECORTES CE",0
49,"49176",610,426,426,4,0,"RECORTES CE",0
19,"19120",108,90,90,1,0,"RECORTES CE",0
19,"19135",93,76,72,0,4,"RECORTES CE",0
37,"37353",122,95,95,1,0,"RECORTES CE",0
2,"2021",1014,836,827,5,9,"RECORTES CE",0
47,"47174",270,215,208,2,7,"RECORTES CE",0
47,"47144",75,63,63,1,0,"RECORTES CE",0
34,"34155",120,104,103,0,1,"RECORTES CE",0
9,"9353",76,64,63,2,1,"RECORTES CE",0
45,"45066",7770,6064,5962,21,102,"RECORTES CE",13
37,"37304",159,105,105,0,0,"RECORTES CE",0
24,"24094",1326,982,966,4,16,"RECORTES CE",4
49,"49100",286,210,208,2,2,"RECORTES CE",1
9,"9456",137,104,104,0,0,"RECORTES CE",0
40,"40124",234,175,168,3,7,"RECORTES CE",0
37,"37117",1553,1245,1230,14,15,"RECORTES CE",0
24,"24134",3294,2540,2479,25,61,"RECORTES CE",2
19,"19171",5302,4297,4238,24,59,"RECORTES CE",5
28,"28073",12751,9940,9838,63,102,"RECORTES CE",20
13,"13087",23207,17321,17032,202,289,"RECORTES CE",43
40,"40193",221,163,161,5,2,"RECORTES CE",1
9,"9411",154,118,118,0,0,"RECORTES CE",1
19,"19021",976,744,724,5,20,"RECORTES CE",3
34,"34077",381,301,293,2,8,"RECORTES CE",0
24,"24175",1831,1433,1412,17,21,"RECORTES CE",1
37,"37268",108,72,70,0,2,"RECORTES CE",0
42,"42154",99,81,81,1,0,"RECORTES CE",0
16,"16004",227,193,191,0,2,"RECORTES CE",0
28,"28074",140580,113723,112489,776,1234,"RECORTES CE",316
37,"37119",95,78,77,0,1,"RECORTES CE",1
19,"19217",42,38,38,0,0,"RECORTES CE",0
40,"40018",75,60,60,0,0,"RECORTES CE",0
19,"19123",36,33,32,2,1,"RECORTES CE",0
28,"28044",6193,5040,4991,31,49,"RECORTES CE",7
2,"2060",1280,1039,1020,5,19,"RECORTES CE",1
45,"45160",1095,913,905,2,8,"RECORTES CE",1
9,"9413",408,313,310,2,3,"RECORTES CE",2
40,"40195",813,630,623,5,7,"RECORTES CE",3
24,"24097",204,155,155,7,0,"RECORTES CE",0
34,"34109",63,42,41,0,1,"RECORTES CE",0
19,"19095",11,10,10,1,0,"RECORTES CE",0
9,"9356",43,36,36,0,0,"RECORTES CE",0
45,"45116",680,547,537,4,10,"RECORTES CE",0
24,"24019",341,279,272,0,7,"RECORTES CE",0
19,"19124",380,271,268,0,3,"RECORTES CE",0
37,"37194",237,182,181,0,1,"RECORTES CE",0
37,"37234",317,224,222,1,2,"RECORTES CE",0
49,"49104",335,245,240,1,5,"RECORTES CE",0
9,"9304",192,164,161,2,3,"RECORTES CE",2
34,"34110",82,66,65,0,1,"RECORTES CE",0
16,"16275",12,12,12,0,0,"RECORTES CE",0
24,"24141",101,78,78,0,0,"RECORTES CE",0
34,"34023",5098,4016,3973,48,43,"RECORTES CE",16
37,"37271",351,286,280,0,6,"RECORTES CE",0
5,"5080",44,31,29,0,2,"RECORTES CE",0
49,"49181",335,227,224,2,3,"RECORTES CE",1
16,"16006",110,99,98,1,1,"RECORTES CE",0
47,"47115",276,231,223,1,8,"RECORTES CE",0
2,"2027",283,239,238,3,1,"RECORTES CE",1
19,"19176",230,184,183,0,1,"RECORTES CE",0
24,"24099",155,121,121,1,0,"RECORTES CE",0
47,"47083",83,66,65,1,1,"RECORTES CE",1
16,"16007",1159,975,968,10,7,"RECORTES CE",1
34,"34161",22,17,16,0,1,"RECORTES CE",0
37,"37172",853,601,590,4,11,"RECORTES CE",0
37,"37272",133,106,106,1,0,"RECORTES CE",0
47,"47022",59,56,54,1,2,"RECORTES CE",0
37,"37236",127,90,86,0,4,"RECORTES CE",0
42,"42063",47,31,28,0,3,"RECORTES CE",0
16,"16009",54,49,49,0,0,"RECORTES CE",0
24,"24180",1101,844,833,8,11,"RECORTES CE",0
16,"16048",409,331,330,1,1,"RECORTES CE",0
47,"47085",16381,12697,12540,129,157,"RECORTES CE",14
2,"2064",374,318,315,3,3,"RECORTES CE",0
40,"40163",41,38,38,0,0,"RECORTES CE",6
19,"19127",90,63,63,0,0,"RECORTES CE",0
9,"9471",142,113,112,3,1,"RECORTES CE",1
42,"42202",20,12,11,0,1,"RECORTES CE",0
28,"28089",3842,3087,3048,12,39,"RECORTES CE",5
28,"28155",485,414,409,0,5,"RECORTES CE",0
24,"24022",306,227,224,1,3,"RECORTES CE",0
13,"13004",996,769,763,3,6,"RECORTES CE",0
37,"37161",121,88,88,0,0,"RECORTES CE",0
19,"19064",64,56,56,0,0,"RECORTES CE",0
49,"49067",336,236,232,0,4,"RECORTES CE",0
16,"16231",50,40,40,0,0,"RECORTES CE",0
5,"5122",119,90,88,1,2,"RECORTES CE",0
13,"13096",7533,5766,5696,43,70,"RECORTES CE",6
16,"16279",174,125,125,0,0,"RECORTES CE",1
5,"5084",69,46,46,0,0,"RECORTES CE",1
42,"42204",54,45,43,2,2,"RECORTES CE",0
47,"47151",28,22,22,0,0,"RECORTES CE",0
28,"28049",57902,47976,47561,329,415,"RECORTES CE",74
5,"5163",1705,1360,1345,4,15,"RECORTES CE",2
37,"37003",107,82,82,1,0,"RECORTES CE",0
42,"42161",135,104,104,0,0,"RECORTES CE",0
16,"16050",220,182,179,1,3,"RECORTES CE",1
42,"42027",73,63,63,0,0,"RECORTES CE",0
9,"9143",27,18,18,0,0,"RECORTES CE",0
37,"37275",101,69,67,0,2,"RECORTES CE",0
37,"37351",269,234,233,6,1,"RECORTES CE",0
5,"5176",223,173,166,2,7,"RECORTES CE",0
37,"37085",5002,3994,3951,40,43,"RECORTES CE",3
47,"47025",114,98,98,0,0,"RECORTES CE",0
28,"28050",4367,3411,3384,14,27,"RECORTES CE",6
34,"34152",125,104,101,0,3,"RECORTES CE",1
19,"19300",788,664,652,2,12,"RECORTES CE",3
49,"49221",234,138,130,1,8,"RECORTES CE",1
16,"16123",66,43,43,0,0,"RECORTES CE",0
40,"40202",55,38,38,0,0,"RECORTES CE",0
37,"37127",200,145,145,1,0,"RECORTES CE",0
28,"28092",153428,121511,120211,807,1300,"RECORTES CE",248
47,"47088",105,90,90,0,0,"RECORTES CE",0
37,"37128",242,187,184,1,3,"RECORTES CE",0
34,"34073",180,149,145,2,4,"RECORTES CE",0
19,"19269",94,75,75,0,0,"RECORTES CE",0
24,"24185",452,339,332,3,7,"RECORTES CE",0
5,"5229",82,67,67,1,0,"RECORTES CE",0
16,"16139",324,249,249,2,0,"RECORTES CE",0
37,"37005",67,48,48,2,0,"RECORTES CE",0
37,"37354",5467,3960,3910,31,50,"RECORTES CE",9
45,"45034",1291,1066,1039,7,27,"RECORTES CE",0
9,"9455",43,37,36,0,1,"RECORTES CE",0
16,"16124",1826,1482,1455,6,27,"RECORTES CE",0
49,"49113",166,139,139,1,0,"RECORTES CE",0
16,"16013",26,21,20,0,1,"RECORTES CE",0
9,"9482",35,28,28,0,0,"RECORTES CE",2
49,"49275",51218,38135,37628,388,507,"RECORTES CE",54
47,"47184",541,447,441,0,6,"RECORTES CE",0
5,"5002",1890,1497,1468,8,29,"RECORTES CE",8
5,"5166",160,128,123,1,5,"RECORTES CE",0
37,"37006",117,81,81,2,0,"RECORTES CE",0
5,"5167",225,181,175,1,6,"RECORTES CE",1
40,"40099",52,46,44,0,2,"RECORTES CE",0
19,"19039",59,56,55,1,1,"RECORTES CE",0
9,"9316",108,89,89,0,0,"RECORTES CE",0
19,"19185",27,19,19,0,0,"RECORTES CE",0
9,"9483",189,153,150,1,3,"RECORTES CE",0
5,"5243",81,63,62,1,1,"RECORTES CE",0
49,"49032",287,224,222,0,2,"RECORTES CE",0
2,"2071",1058,912,906,2,6,"RECORTES CE",0
40,"40204",151,109,104,1,5,"RECORTES CE",0
34,"34171",941,702,688,9,14,"RECORTES CE",5
49,"49088",82,59,59,0,0,"RECORTES CE",0
19,"19139",26,20,20,1,0,"RECORTES CE",0
37,"37089",62,51,50,0,1,"RECORTES CE",0
40,"40100",263,219,215,1,4,"RECORTES CE",0
9,"9317",19,19,19,1,0,"RECORTES CE",0
16,"16016",216,175,174,3,1,"RECORTES CE",0
37,"37008",4222,3431,3393,19,38,"RECORTES CE",3
24,"24108",348,268,265,2,3,"RECORTES CE",0
19,"19042",21,19,18,1,1,"RECORTES CE",1
9,"9261",449,343,342,5,1,"RECORTES CE",0
19,"19041",167,133,129,1,4,"RECORTES CE",0
37,"37205",217,177,174,0,3,"RECORTES CE",0
47,"47060",231,198,195,4,3,"RECORTES CE",1
34,"34175",87,67,66,0,1,"RECORTES CE",0
49,"49154",109,64,63,0,1,"RECORTES CE",0
13,"13059",196,169,168,0,1,"RECORTES CE",0
42,"42008",56,41,41,0,0,"RECORTES CE",0
2,"2073",4844,3828,3772,28,56,"RECORTES CE",6
19,"19232",58,49,49,0,0,"RECORTES CE",0
49,"49155",80,66,65,1,1,"RECORTES CE",0
40,"40031",540,429,424,6,5,"RECORTES CE",1
19,"19043",99,87,84,2,3,"RECORTES CE",1
16,"16143",15,10,10,1,0,"RECORTES CE",0
42,"42213",25,16,16,0,0,"RECORTES CE",0
19,"19278",24,24,24,0,0,"RECORTES CE",0
37,"37049",127,89,89,0,0,"RECORTES CE",0
24,"24070",3941,3007,2947,27,60,"RECORTES CE",4
13,"13060",272,219,214,4,5,"RECORTES CE",0
5,"5246",52,39,39,0,0,"RECORTES CE",0
34,"34127",80,64,64,1,0,"RECORTES CE",0
37,"37246",5155,4153,4107,33,46,"RECORTES CE",5
16,"16909",661,540,535,1,5,"RECORTES CE",0
5,"5053",80,57,57,2,0,"RECORTES CE",0
9,"9430",22,20,20,0,0,"RECORTES CE",1
9,"9266",103,85,85,0,0,"RECORTES CE",0
47,"47062",157,134,134,0,0,"RECORTES CE",0
28,"28026",6703,5422,5367,21,55,"RECORTES CE",7
9,"9431",120,98,98,3,0,"RECORTES CE",0
37,"37360",215,158,153,3,5,"RECORTES CE",0
16,"16020",9,5,5,0,0,"RECORTES CE",0
9,"9177",1127,883,877,6,6,"RECORTES CE",0
37,"37051",80,59,58,0,1,"RECORTES CE",0
28,"28100",4409,3425,3382,20,43,"RECORTES CE",3
16,"16191",858,707,701,8,6,"RECORTES CE",0
9,"9105",97,81,76,1,5,"RECORTES CE",1
45,"45180",2834,2269,2239,11,30,"RECORTES CE",3
24,"24074",96,73,73,0,0,"RECORTES CE",0
45,"45089",1432,1159,1134,5,25,"RECORTES CE",0
42,"42125",75,62,62,2,0,"RECORTES CE",0
37,"37135",1163,934,924,8,10,"RECORTES CE",1
45,"45042",183,141,137,0,4,"RECORTES CE",0
37,"37285",366,273,272,1,1,"RECORTES CE",0
47,"47190",95,81,81,1,0,"RECORTES CE",0
37,"37361",81,63,61,0,2,"RECORTES CE",0
37,"37013",107,73,72,0,1,"RECORTES CE",0
47,"47223",152,123,120,2,3,"RECORTES CE",0
5,"5015",68,48,48,1,0,"RECORTES CE",0
9,"9434",1280,1089,1077,12,12,"RECORTES CE",4
37,"37362",4729,3769,3720,36,49,"RECORTES CE",6
45,"45135",4173,3402,3349,18,53,"RECORTES CE",3
5,"5251",56,39,39,0,0,"RECORTES CE",0
16,"16193",58,51,51,2,0,"RECORTES CE",0
9,"9437",270,227,224,2,3,"RECORTES CE",0
9,"9109",1066,686,650,11,36,"RECORTES CE",7
42,"42175",21,15,15,0,0,"RECORTES CE",0
45,"45184",201,133,132,0,1,"RECORTES CE",0
5,"5174",65,53,52,1,1,"RECORTES CE",0
47,"47096",126,106,105,0,1,"RECORTES CE",0
47,"47224",97,74,74,0,0,"RECORTES CE",0
34,"34041",84,73,72,3,1,"RECORTES CE",1
45,"45137",1567,1155,1139,11,16,"RECORTES CE",2
19,"19049",9,8,8,0,0,"RECORTES CE",0
49,"49122",778,586,573,6,13,"RECORTES CE",0
49,"49244",49,32,32,1,0,"RECORTES CE",0
37,"37015",205,131,130,2,1,"RECORTES CE",0
16,"16108",43,40,39,1,1,"RECORTES CE",0
19,"19104",18,16,16,0,0,"RECORTES CE",0
19,"19211",356,301,300,0,1,"RECORTES CE",1
16,"16150",94,75,75,1,0,"RECORTES CE",0
37,"37176",130,103,103,1,0,"RECORTES CE",0
37,"37213",83,65,64,0,1,"RECORTES CE",0
24,"24038",3048,2360,2315,23,45,"RECORTES CE",0
9,"9272",259,197,195,2,2,"RECORTES CE",0
19,"19285",20,18,18,0,0,"RECORTES CE",0
19,"19318",23,18,18,0,0,"RECORTES CE",0
37,"37017",222,177,177,1,0,"RECORTES CE",0
5,"5060",109,88,88,0,0,"RECORTES CE",0
40,"40003",121,91,89,1,2,"RECORTES CE",0
9,"9168",272,222,216,3,6,"RECORTES CE",0
49,"49124",237,169,166,1,3,"RECORTES CE",1
40,"40144",18,16,16,0,0,"RECORTES CE",0
9,"9273",51,46,46,3,0,"RECORTES CE",0
9,"9221",492,413,409,0,4,"RECORTES CE",2
28,"28158",678,547,540,1,7,"RECORTES CE",0
28,"28116",759,621,618,7,3,"RECORTES CE",1
5,"5189",396,325,321,1,4,"RECORTES CE",3
13,"13069",618,488,469,3,19,"RECORTES CE",0
16,"16110",91,80,80,0,0,"RECORTES CE",0
42,"42070",32,24,24,0,0,"RECORTES CE",0
47,"47057",273,204,200,0,4,"RECORTES CE",0
16,"16215",237,157,153,1,4,"RECORTES CE",0
28,"28083",9665,7794,7737,56,57,"RECORTES CE",16
5,"5140",106,91,89,0,2,"RECORTES CE",0
49,"49125",1401,1031,1010,7,21,"RECORTES CE",2
42,"42043",3838,2897,2855,18,42,"RECORTES CE",3
2,"2046",1132,975,953,10,22,"RECORTES CE",0
19,"19286",742,610,603,4,7,"RECORTES CE",2
45,"45096",987,829,813,3,16,"RECORTES CE",1
42,"42044",53,41,39,0,2,"RECORTES CE",0
47,"47164",350,290,286,2,4,"RECORTES CE",0
42,"42134",2652,2028,1989,17,39,"RECORTES CE",3
9,"9391",361,286,283,3,3,"RECORTES CE",2
37,"37331",188,130,130,1,0,"RECORTES CE",0
37,"37059",117,106,100,0,6,"RECORTES CE",0
13,"13026",415,342,340,1,2,"RECORTES CE",1
5,"5062",166,136,133,0,3,"RECORTES CE",0
40,"40111",52,44,44,0,0,"RECORTES CE",1
13,"13072",729,542,531,3,11,"RECORTES CE",0
19,"19054",167,144,141,2,3,"RECORTES CE",0
9,"9458",484,408,401,5,7,"RECORTES CE",1
9,"9063",214,185,184,0,1,"RECORTES CE",1
5,"5180",82,61,60,0,1,"RECORTES CE",1
16,"16030",22,19,19,1,0,"RECORTES CE",0
24,"24003",608,430,418,0,12,"RECORTES CE",0
40,"40006",22,18,18,0,0,"RECORTES CE",0
24,"24136",496,375,371,2,4,"RECORTES CE",0
2,"2084",305,221,215,1,6,"RECORTES CE",0
2,"2048",1178,989,967,7,22,"RECORTES CE",1
16,"16071",20,18,18,0,0,"RECORTES CE",0
16,"16113",3067,2416,2383,15,33,"RECORTES CE",1
24,"24122",1319,983,969,3,14,"RECORTES CE",2
34,"34094",61,44,44,0,0,"RECORTES CE",0
40,"40077",932,747,730,9,17,"RECORTES CE",7
9,"9279",167,131,128,2,3,"RECORTES CE",0
40,"40149",486,383,376,3,7,"RECORTES CE",2
24,"24137",1052,815,803,14,12,"RECORTES CE",0
34,"34063",87,77,77,1,0,"RECORTES CE",0
34,"34140",96,69,69,1,0,"RECORTES CE",0
49,"49047",100,72,72,0,0,"RECORTES CE",1
34,"34192",82,68,68,0,0,"RECORTES CE",0
2,"2013",135,113,110,0,3,"RECORTES CE",0
40,"40043",1791,1472,1447,9,25,"RECORTES CE",1
19,"19202",17,13,13,0,0,"RECORTES CE",0
9,"9122",88,64,64,0,0,"RECORTES CE",0
28,"28005",136050,108267,107316,772,951,"RECORTES CE",255
9,"9340",76,56,56,1,0,"RECORTES CE",0
19,"19203",29,25,25,0,0,"RECORTES CE",0
47,"47231",4458,3677,3651,47,26,"RECORTES CE",5
37,"37259",36,29,29,0,0,"RECORTES CE",0
19,"19058",7375,6122,6061,34,61,"RECORTES CE",11
5,"5066",439,373,367,2,6,"RECORTES CE",0
34,"34143",157,125,120,1,5,"RECORTES CE",0
9,"9446",12,8,8,0,0,"RECORTES CE",0
34,"34005",792,659,645,5,14,"RECORTES CE",0
34,"34098",783,614,605,3,9,"RECORTES CE",2
19,"19293",1905,1513,1499,10,14,"RECORTES CE",4
42,"42141",114,89,89,0,0,"RECORTES CE",1
37,"37372",134,104,104,0,0,"RECORTES CE",0
45,"45148",275,209,209,1,0,"RECORTES CE",0
13,"13092",1715,1434,1425,1,9,"RECORTES CE",0
47,"47169",61,53,53,0,0,"RECORTES CE",0
19,"19204",149,112,112,1,0,"RECORTES CE",0
16,"16263",966,763,755,2,8,"RECORTES CE",0
16,"16034",155,124,122,1,2,"RECORTES CE",0
34,"34053",200,176,171,5,5,"RECORTES CE",0
42,"42144",423,338,336,4,2,"RECORTES CE",1
37,"37065",271,187,184,0,3,"RECORTES CE",0
42,"42093",35,29,29,2,0,"RECORTES CE",0
34,"34201",171,139,139,0,0,"RECORTES CE",0
9,"9400",310,250,247,4,3,"RECORTES CE",0
9,"9023",1178,982,966,14,16,"RECORTES CE",1
19,"19208",41,34,34,0,0,"RECORTES CE",0
49,"49052",179,125,123,1,2,"RECORTES CE",0
16,"16078",41517,31810,31486,340,324,"RECORTES CE",63
9,"9308",62,48,48,0,0,"RECORTES CE",0
40,"40119",166,133,132,1,1,"RECORTES CE",0
19,"19163",60,46,44,0,2,"RECORTES CE",0
19,"19061",53,45,45,0,0,"RECORTES CE",0
34,"34149",21,18,18,0,0,"RECORTES CE",0
16,"16160",60,44,43,1,1,"RECORTES CE",0
28,"28038",5155,4142,4090,20,52,"RECORTES CE",4
9,"9127",52,45,45,1,0,"RECORTES CE",0
45,"45015",662,506,500,2,6,"RECORTES CE",1
47,"47106",44,35,35,0,0,"RECORTES CE",0
28,"28113",36716,29939,29607,224,332,"RECORTES CE",57
37,"37374",1147,946,923,4,23,"RECORTES CE",0
40,"40081",119,96,95,2,1,"RECORTES CE",0
19,"19065",114,92,91,0,1,"RECORTES CE",0
45,"45199",3107,2221,2184,8,37,"RECORTES CE",9
19,"19210",18,18,17,0,1,"RECORTES CE",0
40,"40013",56,47,47,0,0,"RECORTES CE",0
37,"37149",61,56,54,1,2,"RECORTES CE",0
19,"19016",57,40,40,0,0,"RECORTES CE",0
9,"9073",963,799,787,7,12,"RECORTES CE",3
34,"34011",386,326,321,2,5,"RECORTES CE",0
24,"24130",418,331,326,0,5,"RECORTES CE",0
37,"37264",55,42,42,0,0,"RECORTES CE",0
37,"37239",206,184,181,3,3,"RECORTES CE",0
9,"9074",834,697,694,8,3,"RECORTES CE",1
5,"5267",107,71,70,3,1,"RECORTES CE",0
24,"24091",585,433,423,1,10,"RECORTES CE",0
49,"49174",130,93,91,0,2,"RECORTES CE",0
9,"9182",76,65,64,0,1,"RECORTES CE",0
16,"16269",393,322,317,3,5,"RECORTES CE",0
45,"45140",1089,887,870,5,17,"RECORTES CE",1
45,"45063",380,294,289,0,5,"RECORTES CE",0
5,"5228",167,124,124,0,0,"RECORTES CE",0
34,"34058",185,161,161,1,0,"RECORTES CE",0
28,"28115",62352,53136,52912,268,224,"RECORTES CE",43
45,"45064",3998,3166,3117,17,49,"RECORTES CE",2
28,"28178",1134,949,935,1,14,"RECORTES CE",0
40,"40049",40,30,29,0,1,"RECORTES CE",0
34,"34059",402,326,320,3,6,"RECORTES CE",1
9,"9439",1054,867,851,8,16,"RECORTES CE",2
5,"5125",56,47,43,0,4,"RECORTES CE",0
47,"47183",139,118,118,1,0,"RECORTES CE",0
40,"40123",141,108,104,1,4,"RECORTES CE",1
28,"28148",88647,70218,69546,570,672,"RECORTES CE",146
37,"37329",39,36,36,0,0,"RECORTES CE",0
19,"19213",70,53,52,0,1,"RECORTES CE",0
24,"24014",7180,5189,5097,46,92,"RECORTES CE",8
5,"5204",583,486,482,4,4,"RECORTES CE",3
19,"19214",72,56,55,0,1,"RECORTES CE",0
42,"42193",16,7,7,0,0,"RECORTES CE",0
19,"19257",3283,2448,2424,21,24,"RECORTES CE",2
5,"5191",124,105,105,0,0,"RECORTES CE",0
9,"9030",119,90,89,1,1,"RECORTES CE",3
2,"2058",313,218,214,1,4,"RECORTES CE",1
28,"28180",5317,4266,4222,26,44,"RECORTES CE",2
24,"24015",2209,1714,1672,19,42,"RECORTES CE",1
5,"5903",138,94,92,0,2,"RECORTES CE",0
40,"40192",133,104,102,2,2,"RECORTES CE",1
49,"49138",208,159,154,2,5,"RECORTES CE",0
5,"5155",46,36,36,0,0,"RECORTES CE",0
45,"45113",1797,1300,1281,6,19,"RECORTES CE",0
40,"40228",494,397,391,5,6,"RECORTES CE",0
37,"37305",218,180,178,3,2,"RECORTES CE",0
16,"16167",292,235,229,1,6,"RECORTES CE",0
40,"40125",75,61,61,2,0,"RECORTES CE",0
28,"28128",445,352,352,2,0,"RECORTES CE",0
47,"47029",50,43,43,1,0,"RECORTES CE",0
49,"49225",127,81,81,0,0,"RECORTES CE",0
45,"45068",171,142,142,0,0,"RECORTES CE",0
37,"37156",4276,2621,2572,27,49,"RECORTES CE",1
49,"49139",153,111,110,1,1,"RECORTES CE",0
16,"16187",55,43,43,0,0,"RECORTES CE",0
19,"19074",65,60,60,0,0,"RECORTES CE",0
47,"47019",91,74,73,0,1,"RECORTES CE",0
49,"49264",540,372,369,1,3,"RECORTES CE",2
19,"19172",50,35,35,1,0,"RECORTES CE",0
42,"42020",4186,3027,2988,28,39,"RECORTES CE",3
24,"24030",4201,3080,3024,25,56,"RECORTES CE",3
37,"37345",150,134,133,0,1,"RECORTES CE",0
34,"34214",178,141,141,1,0,"RECORTES CE",0
24,"24177",472,330,326,3,4,"RECORTES CE",0
47,"47114",3911,2864,2807,28,57,"RECORTES CE",7
13,"13013",7050,5475,5371,39,104,"RECORTES CE",8
9,"9213",270,196,196,1,0,"RECORTES CE",1
49,"49021",14258,10333,10206,102,127,"RECORTES CE",12
37,"37307",148,110,107,2,3,"RECORTES CE",0
28,"28014",34047,26858,26575,178,283,"RECORTES CE",50
40,"40126",67,53,51,0,2,"RECORTES CE",0
28,"28152",16839,14205,14151,87,54,"RECORTES CE",24
37,"37346",252,214,213,3,1,"RECORTES CE",0
34,"34020",51,38,38,0,0,"RECORTES CE",1
42,"42022",206,161,161,1,0,"RECORTES CE",0
5,"5040",64,51,51,1,0,"RECORTES CE",0
47,"47021",72,63,63,0,0,"RECORTES CE",0
16,"16089",377,308,308,1,0,"RECORTES CE",0
37,"37078",788,670,658,6,12,"RECORTES CE",0
49,"49063",310,246,240,2,6,"RECORTES CE",0
34,"34067",129,87,87,0,0,"RECORTES CE",0
45,"45072",661,525,517,3,8,"RECORTES CE",0
40,"40231",98,80,80,2,0,"RECORTES CE",0
28,"28016",78,62,61,1,1,"RECORTES CE",0
2,"2063",1375,1067,1047,1,20,"RECORTES CE",1
47,"47178",166,144,143,4,1,"RECORTES CE",0
28,"28901",868,653,639,6,14,"RECORTES CE",2
28,"28076",425,354,349,3,5,"RECORTES CE",0
19,"19175",30,19,19,1,0,"RECORTES CE",0
9,"9006",59,37,36,1,1,"RECORTES CE",0
42,"42036",40,34,33,2,1,"RECORTES CE",0
40,"40104",284,229,224,2,5,"RECORTES CE",1
19,"19079",8,7,7,1,0,"RECORTES CE",0
45,"45073",287,226,225,1,1,"RECORTES CE",1
19,"19221",35,26,26,0,0,"RECORTES CE",0
19,"19264",34,28,28,0,0,"RECORTES CE",0
42,"42025",1134,824,813,6,11,"RECORTES CE",1
5,"5236",106,77,77,0,0,"RECORTES CE",0
37,"37080",212,173,169,0,4,"RECORTES CE",0
47,"47180",57,46,46,1,0,"RECORTES CE",1
19,"19032",146,102,101,2,1,"RECORTES CE",1
47,"47023",3057,2577,2557,21,20,"RECORTES CE",3
49,"49230",82,67,66,0,1,"RECORTES CE",0
19,"19080",65,51,51,0,0,"RECORTES CE",0
19,"19099",289,217,214,0,3,"RECORTES CE",0
9,"9327",29,22,22,0,0,"RECORTES CE",0
24,"24224",574,435,427,3,8,"RECORTES CE",0
42,"42064",85,71,71,0,0,"RECORTES CE",0
45,"45165",62598,47784,47120,345,664,"RECORTES CE",117
9,"9363",922,733,725,3,8,"RECORTES CE",3
19,"19130",61365,49363,48747,383,616,"RECORTES CE",103
24,"24063",355,261,261,2,0,"RECORTES CE",0
45,"45030",478,368,364,3,4,"RECORTES CE",1
9,"9090",50,45,45,2,0,"RECORTES CE",0
24,"24181",1414,1067,1055,14,12,"RECORTES CE",0
19,"19033",48,42,41,0,1,"RECORTES CE",2
34,"34116",55,45,45,0,0,"RECORTES CE",0
42,"42026",22,20,20,0,0,"RECORTES CE",0
47,"47086",3823,3090,3046,24,44,"RECORTES CE",1
16,"16049",144,111,108,1,3,"RECORTES CE",1
19,"19266",229,194,192,1,2,"RECORTES CE",0
5,"5123",103,85,85,1,0,"RECORTES CE",0
45,"45077",562,442,437,0,5,"RECORTES CE",0
16,"16010",137,104,101,0,3,"RECORTES CE",0
19,"19224",102,91,90,1,1,"RECORTES CE",0
24,"24102",608,457,448,3,9,"RECORTES CE",0
16,"16280",165,130,128,3,2,"RECORTES CE",0
19,"19001",41,33,33,0,0,"RECORTES CE",0
19,"19239",91,64,63,1,1,"RECORTES CE",1
47,"47005",502,420,414,2,6,"RECORTES CE",0
45,"45124",2069,1757,1718,14,39,"RECORTES CE",0
16,"16095",81,69,68,1,1,"RECORTES CE",0
40,"40166",253,214,213,1,1,"RECORTES CE",0
9,"9201",28,20,19,0,1,"RECORTES CE",0
28,"28040",16648,11709,11551,66,158,"RECORTES CE",13
9,"9093",162,138,137,1,1,"RECORTES CE",1
47,"47121",521,429,422,5,7,"RECORTES CE",1
34,"34029",659,557,551,5,6,"RECORTES CE",0
24,"24026",1099,812,799,5,13,"RECORTES CE",2
2,"2069",11414,9019,8883,54,136,"RECORTES CE",12
24,"24148",1616,1252,1237,11,15,"RECORTES CE",3
5,"5240",3323,2389,2346,16,43,"RECORTES CE",2
16,"16181",57,46,46,1,0,"RECORTES CE",0
9,"9295",54,38,38,0,0,"RECORTES CE",0
24,"24093",338,239,232,3,7,"RECORTES CE",0
28,"28082",6063,4939,4889,46,50,"RECORTES CE",19
9,"9148",79,63,63,5,0,"RECORTES CE",0
47,"47027",2775,2246,2222,14,24,"RECORTES CE",5
5,"5074",665,571,565,2,6,"RECORTES CE",0
49,"49234",399,339,333,2,6,"RECORTES CE",0
28,"28127",66441,56199,55932,327,267,"RECORTES CE",87
37,"37378",99,69,67,2,2,"RECORTES CE",0
34,"34170",51,35,35,0,0,"RECORTES CE",0
9,"9314",92,75,74,1,1,"RECORTES CE",3
28,"28052",3949,2890,2818,8,72,"RECORTES CE",4
42,"42118",21,13,13,1,0,"RECORTES CE",0
49,"49236",70,55,55,0,0,"RECORTES CE",0
40,"40110",316,254,253,2,1,"RECORTES CE",0
37,"37141",152,120,119,2,1,"RECORTES CE",0
16,"16903",996,816,806,9,10,"RECORTES CE",0
9,"9257",86,74,71,0,3,"RECORTES CE",1
45,"45173",9729,7664,7558,46,106,"RECORTES CE",13
37,"37129",252,206,202,2,4,"RECORTES CE",1
37,"37044",450,342,335,6,7,"RECORTES CE",0
16,"16186",412,358,354,1,4,"RECORTES CE",0
16,"16015",351,251,250,4,1,"RECORTES CE",1
37,"37045",28,19,18,0,1,"RECORTES CE",0
45,"45083",551,470,465,5,5,"RECORTES CE",5
28,"28022",36550,31559,31436,207,123,"RECORTES CE",34
5,"5218",105,82,81,0,1,"RECORTES CE",0
47,"47069",118,96,92,1,4,"RECORTES CE",0
49,"49192",124,102,102,2,0,"RECORTES CE",0
47,"47124",388,322,319,2,3,"RECORTES CE",0
9,"9375",42,38,38,0,0,"RECORTES CE",0
37,"37131",171,138,137,0,1,"RECORTES CE",0
45,"45053",7834,6440,6333,46,107,"RECORTES CE",7
2,"2072",1525,1146,1112,4,34,"RECORTES CE",1
47,"47218",979,757,745,5,12,"RECORTES CE",0
42,"42032",142,120,120,0,0,"RECORTES CE",0
40,"40030",428,357,350,3,7,"RECORTES CE",0
16,"16188",77,56,56,0,0,"RECORTES CE",0
47,"47070",30,26,25,0,1,"RECORTES CE",0
45,"45130",302,241,235,2,6,"RECORTES CE",0
9,"9155",25,20,20,0,0,"RECORTES CE",0
47,"47219",40,38,34,0,4,"RECORTES CE",0
16,"16242",308,266,263,2,3,"RECORTES CE",0
9,"9226",56,47,47,0,0,"RECORTES CE",0
16,"16255",136,108,108,0,0,"RECORTES CE",0
37,"37047",228,93,92,1,1,"RECORTES CE",0
28,"28129",8578,6925,6853,45,72,"RECORTES CE",11
40,"40065",469,376,373,1,3,"RECORTES CE",1
47,"47125",51,46,45,0,1,"RECORTES CE",0
5,"5010",145,119,118,1,1,"RECORTES CE",0
45,"45131",264,226,225,0,1,"RECORTES CE",1
42,"42140",14,13,12,0,1,"RECORTES CE",0
16,"16058",97,73,73,0,0,"RECORTES CE",0
34,"34080",5291,3802,3728,35,74,"RECORTES CE",9
13,"13014",481,400,395,1,5,"RECORTES CE",0
42,"42010",21,18,16,0,2,"RECORTES CE",0
19,"19325",144,87,87,1,0,"RECORTES CE",0
49,"49118",194,151,151,1,0,"RECORTES CE",0
42,"42034",44,36,36,1,0,"RECORTES CE",0
34,"34052",167,144,143,2,1,"RECORTES CE",1
37,"37221",394,299,299,2,0,"RECORTES CE",1
49,"49252",304,244,241,6,3,"RECORTES CE",2
9,"9160",80,64,64,1,0,"RECORTES CE",0
5,"5026",187,163,159,1,4,"RECORTES CE",1
45,"45179",495,383,382,3,1,"RECORTES CE",0
16,"16146",87,68,68,0,0,"RECORTES CE",0
37,"37050",67,54,54,0,0,"RECORTES CE",0
34,"34245",310,244,240,3,4,"RECORTES CE",0
5,"5263",163,121,120,0,1,"RECORTES CE",1
19,"19113",446,352,342,3,10,"RECORTES CE",1
2,"2075",1718,1470,1448,4,22,"RECORTES CE",1
40,"40176",375,325,322,6,3,"RECORTES CE",0
40,"40174",324,254,250,2,4,"RECORTES CE",0
2,"2003",133957,105024,104115,786,909,"RECORTES CE",185
9,"9162",132,102,102,1,0,"RECORTES CE",0
5,"5014",5291,4096,4044,29,52,"RECORTES CE",6
19,"19329",59,49,49,0,0,"RECORTES CE",0
28,"28057",1549,1246,1239,5,7,"RECORTES CE",1
47,"47063",89,71,71,0,0,"RECORTES CE",0
19,"19046",22148,17383,17137,125,246,"RECORTES CE",54
9,"9432",174,145,137,0,8,"RECORTES CE",0
19,"19192",1759,1367,1360,3,7,"RECORTES CE",0
37,"37298",172,126,125,0,1,"RECORTES CE",0
13,"13094",290,227,227,1,0,"RECORTES CE",0
45,"45182",987,815,800,7,15,"RECORTES CE",2
5,"5134",49,41,40,0,1,"RECORTES CE",0
24,"24034",3457,2627,2588,31,39,"RECORTES CE",3
2,"2041",321,253,251,3,2,"RECORTES CE",0
9,"9433",58,51,50,1,1,"RECORTES CE",0
24,"24196",1918,1446,1422,9,24,"RECORTES CE",1
45,"45183",2337,1743,1704,7,39,"RECORTES CE",4
42,"42082",7,7,7,0,0,"RECORTES CE",0
9,"9057",148,120,116,0,4,"RECORTES CE",0
45,"45091",374,275,274,1,1,"RECORTES CE",1
49,"49039",327,255,246,6,9,"RECORTES CE",0
49,"49160",43,29,26,0,3,"RECORTES CE",1
24,"24077",215,178,178,0,0,"RECORTES CE",0
40,"40142",52,42,40,0,2,"RECORTES CE",0
37,"37098",304,214,210,0,4,"RECORTES CE",0
19,"19102",92,80,80,0,0,"RECORTES CE",0
19,"19150",126,102,100,0,2,"RECORTES CE",0
16,"16247",63,53,53,1,0,"RECORTES CE",0
16,"16194",220,181,173,1,8,"RECORTES CE",0
37,"37175",404,321,319,8,2,"RECORTES CE",0
37,"37055",118,96,95,0,1,"RECORTES CE",0
9,"9181",277,220,219,2,1,"RECORTES CE",1
34,"34205",55,44,44,0,0,"RECORTES CE",0
28,"28080",49801,41938,41705,248,233,"RECORTES CE",53
5,"5136",84,64,64,2,0,"RECORTES CE",0
5,"5253",78,62,60,0,2,"RECORTES CE",0
47,"47192",94,82,81,2,1,"RECORTES CE",0
2,"2007",1013,820,813,6,7,"RECORTES CE",1
5,"5058",72,52,52,0,0,"RECORTES CE",1
2,"2080",499,409,400,0,9,"RECORTES CE",0
47,"47131",165,127,127,3,0,"RECORTES CE",0
37,"37139",187,162,157,2,5,"RECORTES CE",1
16,"16196",602,522,510,3,12,"RECORTES CE",0
9,"9113",460,369,364,3,5,"RECORTES CE",0
49,"49163",215,151,148,1,3,"RECORTES CE",1
24,"24201",1039,775,765,5,10,"RECORTES CE",1
40,"40037",34,19,19,0,0,"RECORTES CE",0
49,"49069",327,211,207,0,4,"RECORTES CE",0
37,"37315",86,68,67,0,1,"RECORTES CE",0
19,"19037",132,114,112,0,2,"RECORTES CE",0
42,"42151",38,31,30,0,1,"RECORTES CE",0
40,"40191",204,166,165,1,1,"RECORTES CE",0
19,"19319",4583,3640,3585,24,55,"RECORTES CE",13
49,"49222",370,284,282,2,2,"RECORTES CE",0
28,"28041",4788,4012,3973,23,39,"RECORTES CE",5
37,"37071",76,67,67,0,0,"RECORTES CE",0
19,"19256",44,32,32,0,0,"RECORTES CE",0
40,"40157",43,33,33,2,0,"RECORTES CE",0
5,"5019",44838,36021,35637,287,384,"RECORTES CE",70
45,"45004",552,434,434,4,0,"RECORTES CE",0
19,"19335",56,45,43,0,2,"RECORTES CE",0
49,"49262",370,287,286,1,1,"RECORTES CE",0
28,"28084",16103,12519,12378,82,141,"RECORTES CE",25
49,"49248",174,142,139,2,3,"RECORTES CE",0
40,"40075",153,128,127,0,1,"RECORTES CE",1
9,"9276",389,283,268,5,15,"RECORTES CE",1
9,"9275",166,130,130,2,0,"RECORTES CE",0
19,"19155",66,56,56,0,0,"RECORTES CE",0
19,"19288",22,21,21,1,0,"RECORTES CE",0
40,"40040",2495,1913,1895,20,18,"RECORTES CE",4
34,"34048",63,54,53,2,1,"RECORTES CE",0
9,"9172",168,132,132,1,0,"RECORTES CE",1
9,"9442",370,305,301,5,4,"RECORTES CE",0
34,"34211",175,160,160,0,0,"RECORTES CE",0
45,"45036",634,490,482,0,8,"RECORTES CE",0
34,"34240",87,65,63,3,2,"RECORTES CE",0
9,"9225",81,62,62,0,0,"RECORTES CE",0
5,"5141",95,82,82,0,0,"RECORTES CE",0
2,"2059",313,252,250,3,2,"RECORTES CE",0
28,"28151",3251,2483,2450,11,33,"RECORTES CE",3
9,"9243",73,57,55,0,2,"RECORTES CE",0
45,"45099",3635,2741,2684,23,57,"RECORTES CE",8
37,"37060",280,224,224,0,0,"RECORTES CE",0
28,"28064",135,110,104,1,6,"RECORTES CE",0
9,"9394",662,495,490,10,5,"RECORTES CE",1
5,"5157",235,175,174,2,1,"RECORTES CE",0
37,"37181",264,185,184,1,1,"RECORTES CE",0
9,"9119",45,26,26,0,0,"RECORTES CE",0
9,"9018",24647,18982,18715,184,267,"RECORTES CE",59
5,"5220",363,312,308,5,4,"RECORTES CE",0
37,"37233",56,46,46,2,0,"RECORTES CE",0
24,"24057",1306,1018,997,7,21,"RECORTES CE",0
34,"34108",502,424,415,6,9,"RECORTES CE",0
47,"47197",867,721,717,2,4,"RECORTES CE",0
49,"49061",145,111,108,0,3,"RECORTES CE",0
45,"45146",101,86,85,0,1,"RECORTES CE",0
47,"47071",398,345,341,2,4,"RECORTES CE",0
9,"9444",63,43,43,2,0,"RECORTES CE",0
45,"45070",1406,1201,1188,4,13,"RECORTES CE",0
5,"5024",198,142,139,2,3,"RECORTES CE",0
24,"24166",1359,1038,1011,11,27,"RECORTES CE",0
5,"5221",323,249,244,1,5,"RECORTES CE",0
24,"24221",750,563,553,6,10,"RECORTES CE",0
24,"24086",266,211,210,0,1,"RECORTES CE",0
37,"37062",77,65,63,0,2,"RECORTES CE",0
37,"37023",1586,1316,1298,12,18,"RECORTES CE",1
16,"16046",223,162,161,1,1,"RECORTES CE",0
49,"49183",93,73,71,2,2,"RECORTES CE",0
9,"9036",37,33,32,3,1,"RECORTES CE",0
16,"16073",188,159,155,0,4,"RECORTES CE",1
16,"16173",190,141,141,0,0,"RECORTES CE",2
47,"47073",116,91,89,0,2,"RECORTES CE",0
47,"47138",219,182,177,1,5,"RECORTES CE",0
24,"24209",2609,1880,1857,13,23,"RECORTES CE",0
16,"16130",536,445,444,0,1,"RECORTES CE",0
45,"45162",632,481,471,2,10,"RECORTES CE",0
9,"9905",389,308,303,2,5,"RECORTES CE",2
47,"47104",2836,2339,2267,23,72,"RECORTES CE",0
28,"28037",1578,1196,1180,5,16,"RECORTES CE",1
28,"28112",154,137,137,1,0,"RECORTES CE",1
9,"9230",33,28,28,0,0,"RECORTES CE",0
24,"24047",720,531,523,2,8,"RECORTES CE",1
19,"19114",33,25,25,1,0,"RECORTES CE",0
45,"45059",1696,1442,1415,4,27,"RECORTES CE",0
19,"19011",236,181,181,0,0,"RECORTES CE",0
37,"37025",244,209,206,0,3,"RECORTES CE",1
47,"47139",1004,790,776,2,14,"RECORTES CE",0
37,"37223",112,78,76,0,2,"RECORTES CE",1
16,"16118",1350,1126,1093,6,33,"RECORTES CE",1
5,"5161",550,444,434,2,10,"RECORTES CE",1
16,"16147",56,32,32,0,0,"RECORTES CE",0
5,"5148",23,17,17,0,0,"RECORTES CE",0
47,"47075",4775,3849,3784,38,65,"RECORTES CE",9
34,"34901",1071,854,847,4,7,"RECORTES CE",4
5,"5252",58,38,38,0,0,"RECORTES CE",0
9,"9250",259,215,214,1,1,"RECORTES CE",0
16,"16119",179,128,128,0,0,"RECORTES CE",0
42,"42014",60,44,44,1,0,"RECORTES CE",0
37,"37068",340,256,256,3,0,"RECORTES CE",0
28,"28176",13836,11415,11326,64,89,"RECORTES CE",25
19,"19015",84,74,73,0,1,"RECORTES CE",0
19,"19251",39,31,31,0,0,"RECORTES CE",0
5,"5226",65,52,52,0,0,"RECORTES CE",0
47,"47141",118,103,102,0,1,"RECORTES CE",1
37,"37225",99,90,86,1,4,"RECORTES CE",0
16,"16081",49,42,42,0,0,"RECORTES CE",0
5,"5149",100,82,79,0,3,"RECORTES CE",0
2,"2018",796,693,682,5,11,"RECORTES CE",0
34,"34204",52,41,41,1,0,"RECORTES CE",0
9,"9026",371,305,303,2,2,"RECORTES CE",0
19,"19299",102,78,78,1,0,"RECORTES CE",0
9,"9350",430,340,339,9,1,"RECORTES CE",3
24,"24198",547,402,399,4,3,"RECORTES CE",1
37,"37163",32,27,27,0,0,"RECORTES CE",0
49,"49003",869,627,624,3,3,"RECORTES CE",0
16,"16212",230,198,196,2,2,"RECORTES CE",0
9,"9407",27,23,23,0,0,"RECORTES CE",0
28,"28070",113,94,94,2,0,"RECORTES CE",0
28,"28147",990,779,769,2,10,"RECORTES CE",2
9,"9294",102,86,85,0,1,"RECORTES CE",0
47,"47046",125,107,104,1,3,"RECORTES CE",0
49,"49056",288,232,230,2,2,"RECORTES CE",0
5,"5152",655,537,534,3,3,"RECORTES CE",1
45,"45154",1479,1163,1149,5,14,"RECORTES CE",1
9,"9351",62,51,50,1,1,"RECORTES CE",0
40,"40014",56,44,43,2,1,"RECORTES CE",1
47,"47078",159,135,131,0,4,"RECORTES CE",0
34,"34012",340,271,265,2,6,"RECORTES CE",0
5,"5256",112,94,92,1,2,"RECORTES CE",0
19,"19241",35,24,23,2,1,"RECORTES CE",0
37,"37115",110,81,81,2,0,"RECORTES CE",0
47,"47216",114,102,98,0,4,"RECORTES CE",0
5,"5001",179,153,152,2,1,"RECORTES CE",0
49,"49137",170,138,134,0,4,"RECORTES CE",1
13,"13008",427,304,302,0,2,"RECORTES CE",0
5,"5165",370,293,285,4,8,"RECORTES CE",0
47,"47047",202,164,161,3,3,"RECORTES CE",0
19,"19184",62,45,45,0,0,"RECORTES CE",1
28,"28051",1640,1301,1292,9,9,"RECORTES CE",3
45,"45065",261,207,205,2,2,"RECORTES CE",0
16,"16001",64,51,51,0,0,"RECORTES CE",0
37,"37072",145,136,134,3,2,"RECORTES CE",0
13,"13010",881,680,666,4,14,"RECORTES CE",2
42,"42006",152,115,112,2,3,"RECORTES CE",1
40,"40051",34,33,31,0,2,"RECORTES CE",0
37,"37191",104,65,65,1,0,"RECORTES CE",0
24,"24216",671,504,502,3,2,"RECORTES CE",0
5,"5154",34,25,25,1,0,"RECORTES CE",0
34,"34106",113,101,101,0,0,"RECORTES CE",0
37,"37380",56,46,45,1,1,"RECORTES CE",0
9,"9242",66,53,53,1,0,"RECORTES CE",0
5,"5231",151,126,126,0,0,"RECORTES CE",0
9,"9078",37,31,31,0,0,"RECORTES CE",0
37,"37073",620,481,471,6,10,"RECORTES CE",0
13,"13057",1105,934,919,3,15,"RECORTES CE",1
19,"19156",933,756,745,1,11,"RECORTES CE",0
49,"49191",266,216,214,1,2,"RECORTES CE",0
49,"49237",143,95,93,0,2,"RECORTES CE",0
24,"24056",2762,2062,2013,24,49,"RECORTES CE",0
5,"5049",410,310,305,3,5,"RECORTES CE",1
34,"34125",79,59,58,0,1,"RECORTES CE",0
5,"5007",110,81,80,2,1,"RECORTES CE",0
5,"5037",219,143,142,2,1,"RECORTES CE",0
37,"37118",120,93,90,2,3,"RECORTES CE",0
47,"47208",56,37,37,0,0,"RECORTES CE",0
37,"37033",92,69,69,2,0,"RECORTES CE",0
24,"24902",335,266,263,1,3,"RECORTES CE",0
9,"9428",103,86,86,0,0,"RECORTES CE",0
5,"5156",234,153,151,0,2,"RECORTES CE",1
16,"16274",103,86,85,0,1,"RECORTES CE",0
9,"9244",45,35,35,0,0,"RECORTES CE",0
5,"5169",219,176,173,1,3,"RECORTES CE",0
34,"34126",254,220,219,3,1,"RECORTES CE",1
16,"16057",64,53,53,0,0,"RECORTES CE",0
28,"28119",2245,1839,1821,10,18,"RECORTES CE",2
49,"49239",617,437,420,7,17,"RECORTES CE",2
42,"42060",29,20,19,0,1,"RECORTES CE",0
5,"5158",345,279,274,2,5,"RECORTES CE",0
9,"9136",173,130,128,0,2,"RECORTES CE",1
5,"5245",348,295,290,3,5,"RECORTES CE",0
13,"13090",1023,814,796,5,18,"RECORTES CE",1
42,"42156",29,23,23,0,0,"RECORTES CE",0
28,"28075",5952,4797,4758,25,39,"RECORTES CE",9
40,"40173",142,122,117,1,5,"RECORTES CE",0
45,"45117",715,571,556,1,15,"RECORTES CE",0
28,"28087",3259,2643,2623,16,20,"RECORTES CE",3
40,"40127",35,28,28,0,0,"RECORTES CE",0
16,"16145",425,362,357,8,5,"RECORTES CE",2
28,"28143",77,62,62,0,0,"RECORTES CE",0
40,"40008",45,37,37,0,0,"RECORTES CE",0
2,"2026",832,682,673,6,9,"RECORTES CE",0
16,"16908",163,135,133,0,2,"RECORTES CE",0
16,"16131",127,90,90,1,0,"RECORTES CE",0
49,"49105",136,105,103,1,2,"RECORTES CE",0
37,"37347",464,368,359,2,9,"RECORTES CE",0
19,"19190",2302,1788,1767,13,21,"RECORTES CE",4
42,"42172",28,25,25,1,0,"RECORTES CE",0
49,"49210",448,372,370,3,2,"RECORTES CE",0
9,"9904",468,371,369,3,2,"RECORTES CE",0
37,"37096",203,162,160,1,2,"RECORTES CE",0
49,"49268",368,282,279,2,3,"RECORTES CE",0
13,"13047",5780,4553,4461,32,92,"RECORTES CE",13
9,"9307",112,87,86,0,1,"RECORTES CE",0
47,"47084",1101,880,871,7,9,"RECORTES CE",0
40,"40021",19,18,18,0,0,"RECORTES CE",0
9,"9086",661,521,518,5,3,"RECORTES CE",1
37,"37123",162,122,117,3,5,"RECORTES CE",0
40,"40128",122,95,93,2,2,"RECORTES CE",2
9,"9417",42,32,32,0,0,"RECORTES CE",0
45,"45119",3485,2478,2430,21,48,"RECORTES CE",9
5,"5172",116,95,93,0,2,"RECORTES CE",0
24,"24088",995,813,802,12,11,"RECORTES CE",0
9,"9267",113,102,101,2,1,"RECORTES CE",2
37,"37273",88,67,67,0,0,"RECORTES CE",0
45,"45166",1564,1298,1279,6,19,"RECORTES CE",2
28,"28175",935,775,767,3,8,"RECORTES CE",3
47,"47064",37,32,29,0,3,"RECORTES CE",0
9,"9141",602,501,493,4,8,"RECORTES CE",0
19,"19178",30,15,15,0,0,"RECORTES CE",0
24,"24023",262,208,206,3,2,"RECORTES CE",0
42,"42113",521,382,380,3,2,"RECORTES CE",2
37,"37238",106,88,87,1,1,"RECORTES CE",0
24,"24144",639,469,462,2,7,"RECORTES CE",2
42,"42065",23,18,18,2,0,"RECORTES CE",0
34,"34027",1046,791,783,13,8,"RECORTES CE",9
49,"49270",137,111,111,0,0,"RECORTES CE",0
37,"37002",126,81,81,0,0,"RECORTES CE",0
2,"2066",223,172,169,1,3,"RECORTES CE",0
28,"28028",1820,1493,1483,8,10,"RECORTES CE",1
24,"24226",193,136,134,2,2,"RECORTES CE",0
28,"28019",1269,990,981,4,9,"RECORTES CE",2
45,"45168",62790,50868,50335,359,533,"RECORTES CE",120
49,"49097",74,43,43,0,0,"RECORTES CE",0
24,"24158",296,226,220,2,6,"RECORTES CE",0
5,"5033",170,146,145,0,1,"RECORTES CE",0
19,"19151",1083,785,770,5,15,"RECORTES CE",1
9,"9219",27153,20116,19831,215,285,"RECORTES CE",69
42,"42116",42,30,30,1,0,"RECORTES CE",0
24,"24064",1515,1159,1141,11,18,"RECORTES CE",0
13,"13052",6313,4844,4762,38,82,"RECORTES CE",16
42,"42163",46,37,37,0,0,"RECORTES CE",1
16,"16902",127,101,101,0,0,"RECORTES CE",0
40,"40095",464,379,369,2,10,"RECORTES CE",0
28,"28126",47,35,35,0,0,"RECORTES CE",0
16,"16052",537,429,429,2,0,"RECORTES CE",0
5,"5241",3041,2242,2204,24,38,"RECORTES CE",4
40,"40097",125,96,95,1,1,"RECORTES CE",0
28,"28010",10538,8708,8635,54,73,"RECORTES CE",16
40,"40084",53,40,39,0,1,"RECORTES CE",0
9,"9094",51,46,45,0,1,"RECORTES CE",1
34,"34206",814,668,660,13,8,"RECORTES CE",1
9,"9075",103,87,87,1,0,"RECORTES CE",0
9,"9256",333,260,256,2,4,"RECORTES CE",3
19,"19019",14,10,10,0,0,"RECORTES CE",0
9,"9239",47,39,39,0,0,"RECORTES CE",0
16,"16137",37,27,25,0,2,"RECORTES CE",0
24,"24173",908,679,667,3,12,"RECORTES CE",0
24,"24133",356,267,267,4,0,"RECORTES CE",0
28,"28159",594,493,491,5,2,"RECORTES CE",0
24,"24027",1219,913,886,8,27,"RECORTES CE",1
42,"42164",1589,1201,1172,10,29,"RECORTES CE",7
19,"19154",59,48,47,0,1,"RECORTES CE",0
5,"5075",99,79,79,1,0,"RECORTES CE",0
24,"24119",695,515,501,8,14,"RECORTES CE",0
45,"45172",641,504,496,4,8,"RECORTES CE",0
16,"16140",19,16,16,0,0,"RECORTES CE",0
19,"19004",59,52,52,0,0,"RECORTES CE",0
47,"47090",2435,1956,1921,12,35,"RECORTES CE",1
42,"42031",26,19,19,1,0,"RECORTES CE",0
9,"9258",171,142,141,2,1,"RECORTES CE",0
19,"19186",78,67,67,0,0,"RECORTES CE",0
24,"24230",410,312,309,5,3,"RECORTES CE",0
37,"37204",255,197,195,0,2,"RECORTES CE",0
49,"49127",2430,1835,1799,30,36,"RECORTES CE",2
16,"16217",94,77,77,0,0,"RECORTES CE",0
40,"40182",173,126,124,1,2,"RECORTES CE",1
45,"45082",1143,976,967,7,9,"RECORTES CE",0
5,"5168",3500,2774,2730,25,44,"RECORTES CE",2
16,"16272",199,162,161,1,1,"RECORTES CE",0
9,"9134",220,155,151,1,4,"RECORTES CE",0
47,"47009",99,84,84,0,0,"RECORTES CE",1
16,"16141",130,105,105,0,0,"RECORTES CE",0
49,"49115",169,137,136,0,1,"RECORTES CE",1
24,"24901",860,642,630,7,12,"RECORTES CE",1
34,"34227",72,63,61,4,2,"RECORTES CE",0
45,"45191",521,449,446,0,3,"RECORTES CE",1
47,"47135",82,69,67,1,2,"RECORTES CE",1
42,"42033",50,45,44,1,1,"RECORTES CE",0
13,"13058",4050,3188,3128,24,60,"RECORTES CE",3
19,"19187",42,36,36,0,0,"RECORTES CE",0
19,"19157",56,40,37,0,3,"RECORTES CE",0
13,"13028",10273,8434,8273,42,161,"RECORTES CE",7
45,"45161",15266,11185,11023,69,162,"RECORTES CE",38
28,"28130",28508,23566,23305,179,261,"RECORTES CE",43
19,"19260",38,33,31,1,2,"RECORTES CE",0
37,"37245",335,240,240,5,0,"RECORTES CE",0
47,"47092",102,86,85,0,1,"RECORTES CE",0
9,"9377",629,494,488,4,6,"RECORTES CE",2
45,"45009",464,303,301,2,2,"RECORTES CE",0
5,"5064",102,83,81,2,2,"RECORTES CE",0
5,"5131",95,72,71,0,1,"RECORTES CE",0
19,"19143",1754,1422,1402,11,20,"RECORTES CE",4
13,"13075",199,157,157,0,0,"RECORTES CE",0
5,"5065",459,393,382,1,11,"RECORTES CE",1
42,"42049",109,73,72,1,1,"RECORTES CE",0
49,"49240",185,141,136,0,5,"RECORTES CE",0
9,"9445",43,36,34,1,2,"RECORTES CE",0
13,"13045",616,482,479,4,3,"RECORTES CE",0
5,"5119",24,16,16,1,0,"RECORTES CE",0
40,"40196",32,28,28,1,0,"RECORTES CE",0
49,"49130",158,131,131,5,0,"RECORTES CE",0
37,"37145",244,187,185,3,2,"RECORTES CE",0
2,"2050",90,75,75,0,0,"RECORTES CE",0
19,"19097",14,13,13,0,0,"RECORTES CE",0
49,"49093",280,239,238,2,1,"RECORTES CE",0
9,"9123",43,39,38,0,1,"RECORTES CE",0
47,"47002",18,18,18,0,0,"RECORTES CE",0
40,"40079",226,179,175,1,4,"RECORTES CE",0
19,"19294",25,19,18,0,1,"RECORTES CE",0
45,"45181",2337,1846,1818,7,28,"RECORTES CE",1
19,"19327",397,333,332,0,1,"RECORTES CE",0
13,"13063",3652,2692,2649,32,43,"RECORTES CE",2
16,"16245",400,329,318,0,11,"RECORTES CE",1
49,"49119",222,181,180,0,1,"RECORTES CE",0
2,"2040",563,516,513,3,3,"RECORTES CE",0
40,"40105",44,39,38,0,1,"RECORTES CE",0
47,"47222",86,71,71,0,0,"RECORTES CE",0
5,"5095",236,193,191,0,2,"RECORTES CE",1
9,"9268",88,71,71,0,0,"RECORTES CE",0
9,"9345",117,96,95,1,1,"RECORTES CE",0
5,"5160",296,236,232,1,4,"RECORTES CE",0
24,"24168",439,365,360,3,5,"RECORTES CE",1
28,"28133",6116,4581,4486,22,95,"RECORTES CE",3
40,"40070",148,110,107,1,3,"RECORTES CE",0
19,"19191",13,12,12,0,0,"RECORTES CE",0
37,"37014",1153,414,411,4,3,"RECORTES CE",0
9,"9384",295,222,216,1,6,"RECORTES CE",1
2,"2029",3327,2586,2556,15,30,"RECORTES CE",4
13,"13064",1836,1455,1446,18,9,"RECORTES CE",7
47,"47160",392,317,314,2,3,"RECORTES CE",0
40,"40211",69,58,58,1,0,"RECORTES CE",0
9,"9386",55,49,49,0,0,"RECORTES CE",1
16,"16107",98,76,75,1,1,"RECORTES CE",0
40,"40178",90,63,63,1,0,"RECORTES CE",0
16,"16063",113,86,83,0,3,"RECORTES CE",0
5,"5016",6354,5090,5005,40,85,"RECORTES CE",10
34,"34180",64,55,55,2,0,"RECORTES CE",0
5,"5187",1728,1394,1364,7,30,"RECORTES CE",0
9,"9166",98,77,77,1,0,"RECORTES CE",0
19,"19166",152,125,122,0,3,"RECORTES CE",0
40,"40002",34,30,30,0,0,"RECORTES CE",0
42,"42191",180,129,129,1,0,"RECORTES CE",0
37,"37226",150,119,119,2,0,"RECORTES CE",0
34,"34102",202,173,171,2,2,"RECORTES CE",0
37,"37125",227,171,169,0,2,"RECORTES CE",1
42,"42096",251,164,160,3,4,"RECORTES CE",0
45,"45047",2668,1922,1882,11,40,"RECORTES CE",6
16,"16024",123,96,95,0,1,"RECORTES CE",0
9,"9387",111,91,89,0,2,"RECORTES CE",0
2,"2043",1173,975,962,1,13,"RECORTES CE",0
13,"13022",332,264,256,1,8,"RECORTES CE",0
49,"49040",112,97,97,0,0,"RECORTES CE",0
13,"13068",1037,802,783,2,19,"RECORTES CE",1
34,"34236",147,111,111,0,0,"RECORTES CE",0
2,"2044",1049,746,737,5,9,"RECORTES CE",1
19,"19036",248,213,210,1,3,"RECORTES CE",1
37,"37252",101,80,79,1,1,"RECORTES CE",0
16,"16151",64,52,52,0,0,"RECORTES CE",0
37,"37041",73,55,55,0,0,"RECORTES CE",0
49,"49112",118,78,78,2,0,"RECORTES CE",1
45,"45002",2608,1840,1821,7,19,"RECORTES CE",1
16,"16236",865,669,665,2,4,"RECORTES CE",1
24,"24228",626,432,426,3,6,"RECORTES CE",0
42,"42017",131,104,104,2,0,"RECORTES CE",0
24,"24184",183,121,119,0,2,"RECORTES CE",0
37,"37201",237,188,187,1,1,"RECORTES CE",0
49,"49099",98,75,74,0,1,"RECORTES CE",0
40,"40015",24,24,24,1,0,"RECORTES CE",0
9,"9423",28,26,26,0,0,"RECORTES CE",0
9,"9029",144,120,118,3,2,"RECORTES CE",0
42,"42004",2294,1807,1767,22,40,"RECORTES CE",4
45,"45051",1634,1336,1290,9,46,"RECORTES CE",2
40,"40016",54,43,43,1,0,"RECORTES CE",0
16,"16041",339,271,267,2,4,"RECORTES CE",0
45,"45188",2762,2144,2098,14,46,"RECORTES CE",1
5,"5179",199,181,175,0,6,"RECORTES CE",0
37,"37266",70,58,56,0,2,"RECORTES CE",0
34,"34091",122,103,102,4,1,"RECORTES CE",0
37,"37254",175,141,140,1,1,"RECORTES CE",0
9,"9017",90,72,70,2,2,"RECORTES CE",1
19,"19108",102,92,89,0,3,"RECORTES CE",0
24,"24203",95,72,72,0,0,"RECORTES CE",0
42,"42007",109,89,89,1,0,"RECORTES CE",0
19,"19020",46,35,34,1,1,"RECORTES CE",0
34,"34225",5001,4070,4021,48,49,"RECORTES CE",11
45,"45006",1326,983,972,6,11,"RECORTES CE",4
28,"28063",254,203,202,2,1,"RECORTES CE",0
9,"9374",90,79,78,1,1,"RECORTES CE",0
37,"37356",87,66,66,0,0,"RECORTES CE",0
5,"5077",158,133,131,1,2,"RECORTES CE",0
13,"13088",589,439,429,1,10,"RECORTES CE",0
40,"40087",87,70,70,0,0,"RECORTES CE",0
2,"2011",578,461,459,2,2,"RECORTES CE",0
24,"24004",494,408,403,7,5,"RECORTES CE",0
37,"37381",139,97,95,1,2,"RECORTES CE",0
24,"24017",538,427,424,2,3,"RECORTES CE",0
9,"9065",138,118,117,1,1,"RECORTES CE",0
37,"37106",249,173,173,1,0,"RECORTES CE",0
37,"37333",202,138,137,4,1,"RECORTES CE",0
5,"5233",226,198,197,0,1,"RECORTES CE",0
47,"47209",34,25,25,0,0,"RECORTES CE",0
19,"19092",395,317,309,1,8,"RECORTES CE",0
49,"49062",105,69,69,1,0,"RECORTES CE",0
19,"19324",160,128,123,1,5,"RECORTES CE",0
16,"16087",226,191,184,3,7,"RECORTES CE",0
49,"49251",161,125,124,0,1,"RECORTES CE",0
45,"45193",589,512,507,6,5,"RECORTES CE",0
9,"9414",181,148,146,0,2,"RECORTES CE",0
47,"47147",102,85,85,0,0,"RECORTES CE",0
42,"42048",60,50,50,0,0,"RECORTES CE",0
16,"16116",77,59,59,0,0,"RECORTES CE",0
16,"16170",653,514,500,3,14,"RECORTES CE",1
9,"9194",1969,1526,1511,14,15,"RECORTES CE",2
19,"19307",26,23,23,0,0,"RECORTES CE",0
47,"47230",288,236,233,1,3,"RECORTES CE",0
19,"19219",9,7,7,0,0,"RECORTES CE",0
5,"5261",33,26,26,0,0,"RECORTES CE",0
5,"5183",123,104,96,0,8,"RECORTES CE",0
40,"40150",61,53,53,1,0,"RECORTES CE",0
47,"47052",6752,5665,5589,57,76,"RECORTES CE",9
49,"49023",909,682,674,5,8,"RECORTES CE",1
49,"49143",194,141,135,2,6,"RECORTES CE",2
40,"40091",108,93,93,1,0,"RECORTES CE",0
16,"16276",21,18,18,1,0,"RECORTES CE",0
19,"19024",8525,6587,6485,33,102,"RECORTES CE",10
19,"19161",211,165,163,2,2,"RECORTES CE",0
16,"16910",78,54,54,1,0,"RECORTES CE",0
42,"42035",741,537,523,7,14,"RECORTES CE",0
28,"28067",4361,3548,3509,14,39,"RECORTES CE",5
42,"42188",43,35,34,1,1,"RECORTES CE",0
40,"40118",47,38,37,2,1,"RECORTES CE",0
9,"9022",61,54,54,0,0,"RECORTES CE",0
47,"47074",141,122,122,2,0,"RECORTES CE",2
42,"42012",29,23,23,0,0,"RECORTES CE",0
13,"13033",1560,1278,1262,9,16,"RECORTES CE",0
40,"40080",48,39,39,0,0,"RECORTES CE",0
40,"40010",111,95,94,0,1,"RECORTES CE",0
45,"45150",414,326,320,2,6,"RECORTES CE",0
16,"16092",154,113,112,0,1,"RECORTES CE",0
45,"45012",631,516,509,2,7,"RECORTES CE",1
37,"37260",139,109,109,0,0,"RECORTES CE",1
49,"49216",147,122,114,0,8,"RECORTES CE",0
24,"24215",152,125,124,1,1,"RECORTES CE",0
28,"28071",64,56,54,0,2,"RECORTES CE",0
9,"9088",64,42,42,4,0,"RECORTES CE",0
9,"9217",349,268,266,5,2,"RECORTES CE",0
40,"40024",827,657,645,4,12,"RECORTES CE",2
28,"28008",1961,1477,1456,6,21,"RECORTES CE",5
34,"34202",28,20,20,1,0,"RECORTES CE",0
19,"19297",32,27,27,0,0,"RECORTES CE",0
42,"42145",134,108,108,0,0,"RECORTES CE",0
49,"49219",7221,5301,5186,62,115,"RECORTES CE",5
2,"2054",383,314,309,1,5,"RECORTES CE",0
9,"9450",25,17,17,0,0,"RECORTES CE",0
45,"45152",547,448,442,1,6,"RECORTES CE",1
37,"37237",304,238,234,0,4,"RECORTES CE",0
34,"34902",123,98,98,4,0,"RECORTES CE",0
16,"16134",4383,3544,3491,34,53,"RECORTES CE",1
42,"42015",32,23,23,1,0,"RECORTES CE",0
40,"40121",249,196,193,4,3,"RECORTES CE",0
47,"47171",384,315,311,5,4,"RECORTES CE",0
19,"19332",85,70,70,1,0,"RECORTES CE",1
45,"45138",1055,889,874,5,15,"RECORTES CE",0
40,"40107",92,76,74,0,2,"RECORTES CE",0
16,"16162",39,31,30,0,1,"RECORTES CE",0
9,"9348",133,105,104,0,1,"RECORTES CE",0
47,"47152",68,59,59,0,0,"RECORTES CE",0
45,"45016",4442,3621,3583,21,38,"RECORTES CE",6
37,"37114",78,64,59,0,5,"RECORTES CE",0
5,"5151",80,64,64,1,0,"RECORTES CE",0
47,"47016",70,62,61,0,1,"RECORTES CE",0
5,"5188",41,36,34,0,2,"RECORTES CE",0
16,"16213",34,29,28,0,1,"RECORTES CE",0
5,"5059",92,63,63,0,0,"RECORTES CE",0
5,"5046",39,37,37,0,0,"RECORTES CE",0
37,"37377",218,181,176,2,5,"RECORTES CE",0
42,"42177",64,55,54,6,1,"RECORTES CE",0
47,"47026",49,40,39,0,1,"RECORTES CE",0
9,"9045",274,199,196,1,3,"RECORTES CE",0
2,"2032",265,208,203,3,5,"RECORTES CE",0
34,"34103",97,84,81,0,3,"RECORTES CE",1
34,"34223",205,160,157,1,3,"RECORTES CE",0
5,"5129",116,82,76,1,6,"RECORTES CE",0
19,"19173",51,47,47,0,0,"RECORTES CE",0
37,"37240",939,694,686,3,8,"RECORTES CE",0
13,"13084",841,683,673,6,10,"RECORTES CE",3
24,"24132",615,405,404,5,1,"RECORTES CE",0
5,"5047",4118,3334,3248,25,86,"RECORTES CE",2
5,"5035",96,78,78,0,0,"RECORTES CE",0
37,"37152",402,308,302,1,6,"RECORTES CE",1
47,"47037",163,134,128,2,6,"RECORTES CE",1
28,"28062",288,243,236,0,7,"RECORTES CE",0
49,"49247",417,301,294,0,7,"RECORTES CE",0
45,"45157",2261,1627,1603,8,24,"RECORTES CE",1
28,"28072",6088,5001,4961,23,40,"RECORTES CE",14
16,"16027",701,540,531,2,9,"RECORTES CE",0
42,"42152",67,47,46,0,1,"RECORTES CE",0
47,"47048",175,148,148,0,0,"RECORTES CE",0
13,"13086",162,139,136,1,3,"RECORTES CE",0
49,"49019",228,170,164,0,6,"RECORTES CE",0
28,"28042",1266,1020,1010,2,10,"RECORTES CE",1
13,"13041",249,179,171,2,8,"RECORTES CE",0
49,"49114",40,33,32,1,1,"RECORTES CE",0
45,"45097",1044,901,890,4,11,"RECORTES CE",0
37,"37367",185,150,148,4,2,"RECORTES CE",0
47,"47185",87,77,77,0,0,"RECORTES CE",0
5,"5128",342,274,267,1,7,"RECORTES CE",0
16,"16099",184,126,121,0,5,"RECORTES CE",0
47,"47059",97,75,75,0,0,"RECORTES CE",0
37,"37318",199,152,152,1,0,"RECORTES CE",0
37,"37130",178,150,150,2,0,"RECORTES CE",0
42,"42166",57,49,49,0,0,"RECORTES CE",0
37,"37232",378,322,321,1,1,"RECORTES CE",0
16,"16128",51,44,44,0,0,"RECORTES CE",0
45,"45037",1535,1121,1105,7,16,"RECORTES CE",2
37,"37168",407,305,300,0,5,"RECORTES CE",0
47,"47186",244448,197042,195276,1561,1766,"RECORTES CE",355
40,"40906",2131,1830,1814,10,16,"RECORTES CE",7
9,"9079",48,42,42,1,0,"RECORTES CE",0
42,"42075",78,60,60,1,0,"RECORTES CE",0
16,"16100",640,570,565,1,5,"RECORTES CE",0
45,"45007",665,549,533,0,16,"RECORTES CE",1
9,"9408",42,33,33,0,0,"RECORTES CE",0
13,"13901",864,687,673,1,14,"RECORTES CE",1
9,"9321",1597,1293,1280,4,13,"RECORTES CE",6
40,"40160",93,72,72,0,0,"RECORTES CE",0
37,"37158",233,168,166,0,2,"RECORTES CE",1
13,"13029",90,77,77,0,0,"RECORTES CE",0
47,"47167",242,212,210,0,2,"RECORTES CE",0
49,"49022",280,243,241,1,2,"RECORTES CE",0
19,"19174",91,69,69,0,0,"RECORTES CE",0
37,"37091",164,108,108,3,0,"RECORTES CE",0
45,"45056",2300,1526,1501,8,25,"RECORTES CE",5
37,"37182",78,57,57,0,0,"RECORTES CE",0
19,"19262",123,98,97,0,1,"RECORTES CE",0
28,"28173",519,417,412,4,5,"RECORTES CE",0
16,"16224",77,61,60,1,1,"RECORTES CE",0
42,"42198",19,15,15,0,0,"RECORTES CE",0
40,"40020",155,125,119,4,6,"RECORTES CE",1
5,"5182",731,494,490,6,4,"RECORTES CE",0
42,"42185",25,20,20,0,0,"RECORTES CE",0
49,"49228",55,47,47,0,0,"RECORTES CE",0
16,"16259",27,22,21,0,1,"RECORTES CE",0
9,"9247",22,18,18,0,0,"RECORTES CE",0
42,"42215",735,540,529,5,11,"RECORTES CE",1
24,"24222",14431,11296,11135,117,161,"RECORTES CE",19
34,"34129",170,134,132,2,2,"RECORTES CE",3
45,"45088",2332,1724,1695,16,29,"RECORTES CE",7
37,"37171",397,297,292,1,5,"RECORTES CE",0
5,"5249",96,69,69,0,0,"RECORTES CE",0
42,"42024",86,66,66,3,0,"RECORTES CE",0
47,"47179",373,275,273,1,2,"RECORTES CE",0
9,"9038",111,95,95,0,0,"RECORTES CE",0
37,"37311",207,164,162,4,2,"RECORTES CE",0
49,"49184",170,122,121,0,1,"RECORTES CE",0
37,"37037",107,86,86,0,0,"RECORTES CE",0
28,"28122",570,457,448,3,9,"RECORTES CE",0
49,"49242",444,364,359,3,5,"RECORTES CE",1
2,"2076",318,256,250,1,6,"RECORTES CE",0
49,"49107",116,82,81,1,1,"RECORTES CE",0
28,"28144",6423,5274,5222,35,52,"RECORTES CE",5
5,"5207",645,543,540,3,3,"RECORTES CE",0
37,"37193",365,277,276,3,1,"RECORTES CE",0
34,"34222",109,81,79,1,2,"RECORTES CE",0
19,"19282",143,114,114,1,0,"RECORTES CE",0
5,"5056",94,83,83,0,0,"RECORTES CE",0
40,"40199",101,79,78,0,1,"RECORTES CE",0
45,"45121",7273,5362,5291,27,71,"RECORTES CE",8
37,"37350",404,310,307,0,3,"RECORTES CE",0
28,"28048",504,399,392,6,7,"RECORTES CE",0
16,"16093",57,47,47,0,0,"RECORTES CE",0
28,"28156",1084,885,880,6,5,"RECORTES CE",4
37,"37039",282,222,222,1,0,"RECORTES CE",0
45,"45167",1385,1143,1130,2,13,"RECORTES CE",0
9,"9473",87,76,73,0,3,"RECORTES CE",1
5,"5096",79,62,62,1,0,"RECORTES CE",0
13,"13019",5095,3758,3717,25,41,"RECORTES CE",8
9,"9908",427,294,290,6,4,"RECORTES CE",0
34,"34010",553,454,449,3,5,"RECORTES CE",4
5,"5110",706,550,546,4,4,"RECORTES CE",1
47,"47045",734,601,590,5,11,"RECORTES CE",1
9,"9292",75,62,62,2,0,"RECORTES CE",2
37,"37263",338,251,246,0,5,"RECORTES CE",0
40,"40223",228,181,181,0,0,"RECORTES CE",1
9,"9329",117,90,89,8,1,"RECORTES CE",0
19,"19195",37,29,28,2,1,"RECORTES CE",0
37,"37364",757,549,536,7,13,"RECORTES CE",0
16,"16234",23,16,16,0,0,"RECORTES CE",0
19,"19268",43,42,42,0,0,"RECORTES CE",0
49,"49188",110,87,86,0,1,"RECORTES CE",0
42,"42028",76,65,65,1,0,"RECORTES CE",0
37,"37352",201,159,158,0,1,"RECORTES CE",0
9,"9480",109,87,85,1,2,"RECORTES CE",0
2,"2068",324,274,273,0,1,"RECORTES CE",0
37,"37164",238,194,193,4,1,"RECORTES CE",1
45,"45170",199,154,150,1,4,"RECORTES CE",0
40,"40026",113,106,105,2,1,"RECORTES CE",0
28,"28104",15318,12897,12797,87,100,"RECORTES CE",21
19,"19226",41,32,32,0,0,"RECORTES CE",0
9,"9312",89,75,74,2,1,"RECORTES CE",0
34,"34122",86,68,66,0,2,"RECORTES CE",0
19,"19133",81,70,70,0,0,"RECORTES CE",0
49,"49272",77,55,51,0,4,"RECORTES CE",0
9,"9262",158,137,136,1,1,"RECORTES CE",0
47,"47143",110,78,78,1,0,"RECORTES CE",0
19,"19301",37,31,31,0,0,"RECORTES CE",0
19,"19070",67,53,51,0,2,"RECORTES CE",0
37,"37190",193,144,144,1,0,"RECORTES CE",0
47,"47173",885,708,704,7,4,"RECORTES CE",2
9,"9184",7,5,5,0,0,"RECORTES CE",0
45,"45019",7545,5831,5740,52,91,"RECORTES CE",10
5,"5902",293,246,242,1,4,"RECORTES CE",1
42,"42018",131,102,102,1,0,"RECORTES CE",0
37,"37102",379,297,291,3,6,"RECORTES CE",0
49,"49087",483,322,320,2,2,"RECORTES CE",0
42,"42194",146,111,111,0,0,"RECORTES CE",0
5,"5257",135,104,104,0,0,"RECORTES CE",0
40,"40214",196,167,163,1,4,"RECORTES CE",1
24,"24028",365,297,290,2,7,"RECORTES CE",0
5,"5258",107,96,96,2,0,"RECORTES CE",0
40,"40135",269,224,221,1,3,"RECORTES CE",0
47,"47100",119,104,102,2,2,"RECORTES CE",0
47,"47165",6822,5456,5296,62,160,"RECORTES CE",5
24,"24055",676,513,508,6,5,"RECORTES CE",0
47,"47145",586,446,440,2,6,"RECORTES CE",1
45,"45143",1190,940,925,3,15,"RECORTES CE",2
45,"45052",3134,2670,2652,23,18,"RECORTES CE",10
40,"40215",83,69,69,0,0,"RECORTES CE",4
40,"40005",25,21,21,0,0,"RECORTES CE",0
19,"19138",223,176,172,4,4,"RECORTES CE",0
37,"37344",235,171,168,1,3,"RECORTES CE",3
45,"45128",2552,1874,1839,9,35,"RECORTES CE",3
19,"19274",950,753,741,7,12,"RECORTES CE",0
45,"45129",109,84,83,0,1,"RECORTES CE",0
49,"49208",364,260,255,5,5,"RECORTES CE",0
13,"13073",497,394,390,1,4,"RECORTES CE",0
5,"5023",175,158,155,2,3,"RECORTES CE",0
2,"2012",1825,1541,1509,8,32,"RECORTES CE",0
37,"37169",176,138,137,1,1,"RECORTES CE",0
45,"45145",2613,1950,1921,13,29,"RECORTES CE",4
37,"37061",207,160,160,0,0,"RECORTES CE",1
24,"24218",444,343,341,6,2,"RECORTES CE",0
47,"47229",231,174,168,0,6,"RECORTES CE",0
19,"19182",39,32,32,0,0,"RECORTES CE",0
49,"49103",394,343,339,3,4,"RECORTES CE",0
9,"9318",58,37,37,0,0,"RECORTES CE",0
47,"47156",150,128,128,2,0,"RECORTES CE",0
49,"49266",70,51,49,2,2,"RECORTES CE",0
24,"24139",2087,1558,1540,20,18,"RECORTES CE",0
47,"47137",31,23,23,0,0,"RECORTES CE",0
37,"37108",99,80,78,2,2,"RECORTES CE",0
28,"28004",6564,4798,4767,26,31,"RECORTES CE",4
24,"24219",492,374,371,5,3,"RECORTES CE",0
5,"5039",48,47,47,0,0,"RECORTES CE",0
5,"5144",66,51,51,0,0,"RECORTES CE",0
5,"5234",46,43,43,0,0,"RECORTES CE",0
9,"9228",157,136,136,0,0,"RECORTES CE",0
28,"28153",795,566,564,5,2,"RECORTES CE",0
45,"45194",65,49,48,0,1,"RECORTES CE",0
19,"19125",40,28,28,0,0,"RECORTES CE",0
42,"42023",60,49,48,0,1,"RECORTES CE",0
28,"28138",63,49,49,0,0,"RECORTES CE",0
42,"42157",10,10,10,0,0,"RECORTES CE",0
40,"40219",565,451,432,2,19,"RECORTES CE",2
45,"45163",8340,6486,6363,38,123,"RECORTES CE",12
5,"5093",353,275,269,0,6,"RECORTES CE",0
42,"42176",27,22,22,2,0,"RECORTES CE",0
9,"9323",59,41,41,2,0,"RECORTES CE",0
40,"40045",120,92,92,1,0,"RECORTES CE",0
9,"9124",1432,1078,1054,7,24,"RECORTES CE",0
49,"49081",1322,1051,1030,11,21,"RECORTES CE",1
28,"28132",12068,9067,8954,63,113,"RECORTES CE",18
13,"13062",559,478,471,1,7,"RECORTES CE",1
16,"16061",941,790,763,8,27,"RECORTES CE",0
45,"45134",1609,1305,1291,6,14,"RECORTES CE",0
9,"9216",374,283,281,2,2,"RECORTES CE",2
40,"40046",82,69,69,1,0,"RECORTES CE",0
2,"2052",466,394,394,3,0,"RECORTES CE",1
9,"9125",552,424,421,3,3,"RECORTES CE",3
37,"37248",152,125,121,1,4,"RECORTES CE",0
45,"45196",1387,1099,1084,6,15,"RECORTES CE",0
9,"9478",45,40,40,0,0,"RECORTES CE",0
9,"9422",32,27,26,2,1,"RECORTES CE",0
49,"49193",435,303,287,1,16,"RECORTES CE",1
45,"45125",2263,1871,1842,10,29,"RECORTES CE",4
19,"19281",18,17,17,3,0,"RECORTES CE",0
42,"42167",236,183,182,3,1,"RECORTES CE",0
49,"49200",936,744,726,10,18,"RECORTES CE",1
28,"28903",35344,30490,30287,201,203,"RECORTES CE",33
9,"9010",32,27,27,1,0,"RECORTES CE",0
42,"42081",136,95,93,0,2,"RECORTES CE",0
45,"45046",2369,1860,1832,5,28,"RECORTES CE",0
37,"37250",332,232,231,1,1,"RECORTES CE",1
34,"34132",107,84,83,0,1,"RECORTES CE",1
49,"49243",109,86,83,0,3,"RECORTES CE",0
9,"9328",74,51,50,0,1,"RECORTES CE",0
37,"37027",235,188,184,2,4,"RECORTES CE",0
49,"49133",291,213,211,0,2,"RECORTES CE",0
40,"40222",163,143,142,1,1,"RECORTES CE",0
5,"5213",95,77,75,0,2,"RECORTES CE",0
47,"47076",17721,14605,14438,134,167,"RECORTES CE",28
24,"24006",487,393,387,3,6,"RECORTES CE",0
40,"40155",3835,3165,3121,43,44,"RECORTES CE",8
19,"19103",251,218,216,1,2,"RECORTES CE",0
49,"49245",253,183,182,2,1,"RECORTES CE",0
19,"19117",1611,1279,1257,7,22,"RECORTES CE",2
47,"47207",260,213,211,2,2,"RECORTES CE",0
34,"34133",105,88,86,1,2,"RECORTES CE",1
24,"24116",390,283,279,1,4,"RECORTES CE",0
9,"9059",136704,109424,108039,1134,1385,"RECORTES CE",344
16,"16065",372,306,305,2,1,"RECORTES CE",1
47,"47036",205,162,157,1,5,"RECORTES CE",0
5,"5085",30,27,27,0,0,"RECORTES CE",0
16,"16249",1938,1544,1529,13,15,"RECORTES CE",1
47,"47015",176,136,135,0,1,"RECORTES CE",0
9,"9112",104,76,76,1,0,"RECORTES CE",0
9,"9330",1480,1180,1161,8,19,"RECORTES CE",4
47,"47163",280,238,232,2,6,"RECORTES CE",0
9,"9369",422,328,325,8,3,"RECORTES CE",3
45,"45048",355,277,271,1,6,"RECORTES CE",2
19,"19134",30,24,24,0,0,"RECORTES CE",0
24,"24152",447,301,296,1,5,"RECORTES CE",0
34,"34035",100,84,82,1,2,"RECORTES CE",0
16,"16177",82,64,63,0,1,"RECORTES CE",0
19,"19305",135,104,103,3,1,"RECORTES CE",0
19,"19183",71,61,59,0,2,"RECORTES CE",0
13,"13098",1983,1537,1485,22,52,"RECORTES CE",1
19,"19017",57,50,49,0,1,"RECORTES CE",0
24,"24054",417,318,311,0,7,"RECORTES CE",0
49,"49235",422,312,301,0,11,"RECORTES CE",0
5,"5114",1264,1061,1030,3,31,"RECORTES CE",0
16,"16165",55,49,48,1,1,"RECORTES CE",0
34,"34237",573,479,472,4,7,"RECORTES CE",0
16,"16125",1599,1314,1295,9,19,"RECORTES CE",0
37,"37342",255,200,199,1,1,"RECORTES CE",0
37,"37379",173,152,152,0,0,"RECORTES CE",0
9,"9223",43,39,39,1,0,"RECORTES CE",0
13,"13085",2287,1911,1885,13,26,"RECORTES CE",2
37,"37031",336,261,258,3,3,"RECORTES CE",0
28,"28137",1744,1385,1366,8,19,"RECORTES CE",1
24,"24106",218,164,162,0,2,"RECORTES CE",0
37,"37230",214,176,176,0,0,"RECORTES CE",1
24,"24217",133,106,105,1,1,"RECORTES CE",0
37,"37231",239,204,203,6,1,"RECORTES CE",0
49,"49031",145,107,103,0,4,"RECORTES CE",1
19,"19229",57,52,52,0,0,"RECORTES CE",0
9,"9415",275,206,204,0,2,"RECORTES CE",0
24,"24150",224,176,174,2,2,"RECORTES CE",0
19,"19901",36,32,32,0,0,"RECORTES CE",1
19,"19243",36,32,31,0,1,"RECORTES CE",0
24,"24188",3820,3107,3056,33,51,"RECORTES CE",1
9,"9100",58,46,46,0,0,"RECORTES CE",0
9,"9178",40,27,27,0,0,"RECORTES CE",0
49,"49131",238,182,178,0,4,"RECORTES CE",0
49,"49167",179,140,136,2,4,"RECORTES CE",0
16,"16159",209,147,144,0,3,"RECORTES CE",0
5,"5038",113,89,88,0,1,"RECORTES CE",0
40,"40171",39,29,29,1,0,"RECORTES CE",0
16,"16905",1278,1028,1012,11,16,"RECORTES CE",1
47,"47166",251,196,189,3,7,"RECORTES CE",0
9,"9412",765,564,558,7,6,"RECORTES CE",5
2,"2016",538,405,401,4,4,"RECORTES CE",1
34,"34169",381,314,309,6,5,"RECORTES CE",0
42,"42139",21,15,15,1,0,"RECORTES CE",0
49,"49111",121,100,100,3,0,"RECORTES CE",0
45,"45038",3505,2749,2705,16,44,"RECORTES CE",15
16,"16218",187,149,148,2,1,"RECORTES CE",0
16,"16072",133,96,95,1,1,"RECORTES CE",0
49,"49034",417,320,317,0,3,"RECORTES CE",0
45,"45155",319,261,253,1,8,"RECORTES CE",0
37,"37270",183,143,140,1,3,"RECORTES CE",2
9,"9246",609,449,441,2,8,"RECORTES CE",1
16,"16171",1749,1449,1422,6,27,"RECORTES CE",0
24,"24207",278,242,235,0,7,"RECORTES CE",0
47,"47011",557,478,476,5,2,"RECORTES CE",0
47,"47210",402,300,289,2,11,"RECORTES CE",0
19,"19111",162,142,142,0,0,"RECORTES CE",0
19,"19261",32,24,24,0,0,"RECORTES CE",0
34,"34141",176,154,152,0,2,"RECORTES CE",0
9,"9360",25,22,22,0,0,"RECORTES CE",0
9,"9396",153,125,124,0,1,"RECORTES CE",1
28,"28045",35264,27864,27597,180,267,"RECORTES CE",59
45,"45158",2546,2026,2001,9,25,"RECORTES CE",2
28,"28079",2374366,1872679,1859094,11998,13585,"RECORTES CE",3599
37,"37121",556,448,444,3,4,"RECORTES CE",0
45,"45025",1219,926,913,5,13,"RECORTES CE",1
37,"37375",673,583,573,4,10,"RECORTES CE",0
24,"24051",394,290,283,3,7,"RECORTES CE",0
45,"45062",1074,888,867,4,21,"RECORTES CE",1
40,"40032",378,287,278,1,9,"RECORTES CE",0
19,"19146",46,41,41,1,0,"RECORTES CE",0
40,"40151",43,32,32,0,0,"RECORTES CE",0
13,"13082",25882,17928,17721,101,207,"RECORTES CE",42
42,"42001",251,186,186,2,0,"RECORTES CE",0
2,"2015",1433,1234,1214,7,20,"RECORTES CE",2
42,"42206",8,4,4,0,0,"RECORTES CE",0
37,"37261",217,166,163,0,3,"RECORTES CE",0
13,"13048",506,388,384,3,4,"RECORTES CE",0
40,"40092",113,86,84,2,2,"RECORTES CE",0
49,"49120",53,39,39,0,0,"RECORTES CE",0
45,"45104",421,340,335,1,5,"RECORTES CE",0
5,"5045",80,65,65,0,0,"RECORTES CE",0
5,"5259",106,87,87,0,0,"RECORTES CE",0
24,"24227",1548,1148,1128,5,20,"RECORTES CE",1
42,"42211",81,74,73,2,1,"RECORTES CE",0
47,"47182",1335,1034,1022,6,12,"RECORTES CE",2
37,"37174",983,788,768,0,20,"RECORTES CE",0
37,"37077",252,216,213,2,3,"RECORTES CE",0
37,"37306",242,184,181,2,3,"RECORTES CE",0
2,"2025",7355,5864,5693,30,171,"RECORTES CE",8
45,"45151",546,434,431,0,3,"RECORTES CE",0
13,"13080",321,246,246,1,0,"RECORTES CE",0
28,"28068",11554,9122,9022,44,100,"RECORTES CE",12
24,"24212",1002,772,764,7,8,"RECORTES CE",0
9,"9347",135,108,108,0,0,"RECORTES CE",0
5,"5265",79,59,59,0,0,"RECORTES CE",0
47,"47140",110,91,90,0,1,"RECORTES CE",0
47,"47181",165,143,143,0,0,"RECORTES CE",0
9,"9235",140,105,102,0,3,"RECORTES CE",0
49,"49170",98,75,75,1,0,"RECORTES CE",0
13,"13081",590,449,440,0,9,"RECORTES CE",0
37,"37058",56,41,41,0,0,"RECORTES CE",0
13,"13904",504,394,376,6,18,"RECORTES CE",0
37,"37301",79,69,67,0,2,"RECORTES CE",0
16,"16211",322,233,229,0,4,"RECORTES CE",1
34,"34092",260,210,206,0,4,"RECORTES CE",0
16,"16239",118,89,88,0,1,"RECORTES CE",1
37,"37368",17,15,11,0,4,"RECORTES CE",0
49,"49068",435,287,286,1,1,"RECORTES CE",0
9,"9200",58,40,40,0,0,"RECORTES CE",0
24,"24213",170,140,139,0,1,"RECORTES CE",1
28,"28054",11891,9476,9395,64,81,"RECORTES CE",24
19,"19280",3611,2805,2767,25,38,"RECORTES CE",9
47,"47205",355,263,258,3,5,"RECORTES CE",0
5,"5905",222,165,164,1,1,"RECORTES CE",0
16,"16051",126,102,100,0,2,"RECORTES CE",0
42,"42069",1491,1073,1048,20,25,"RECORTES CE",2
16,"16901",630,498,492,4,6,"RECORTES CE",1
24,"24025",289,234,226,4,8,"RECORTES CE",1
34,"34121",183,155,151,1,4,"RECORTES CE",0
24,"24205",981,744,732,8,12,"RECORTES CE",1
47,"47211",48,43,43,1,0,"RECORTES CE",0
9,"9392",49,41,41,0,0,"RECORTES CE",0
37,"37276",126,101,101,0,0,"RECORTES CE",0
34,"34136",149,105,102,0,3,"RECORTES CE",0
28,"28149",6172,5089,5038,31,51,"RECORTES CE",13
34,"34213",52,42,42,0,0,"RECORTES CE",0
9,"9227",113,93,91,0,2,"RECORTES CE",0
40,"40181",4166,3405,3337,21,68,"RECORTES CE",4
28,"28011",420,315,311,1,4,"RECORTES CE",1
47,"47111",998,806,795,6,11,"RECORTES CE",1
34,"34015",39,32,31,0,1,"RECORTES CE",1
45,"45110",1697,1339,1326,11,13,"RECORTES CE",0
47,"47051",321,274,272,1,2,"RECORTES CE",0
42,"42132",135,114,113,1,1,"RECORTES CE",0
5,"5139",66,59,59,0,0,"RECORTES CE",0
40,"40086",660,570,548,3,22,"RECORTES CE",0
28,"28032",5042,4039,3992,23,47,"RECORTES CE",6
9,"9144",44,37,37,2,0,"RECORTES CE",0
9,"9241",247,192,188,2,4,"RECORTES CE",0
9,"9139",98,82,82,2,0,"RECORTES CE",1
28,"28017",1280,1017,1012,9,5,"RECORTES CE",2
40,"40146",238,205,202,0,3,"RECORTES CE",0
24,"24162",1772,1382,1369,22,13,"RECORTES CE",0
34,"34186",47,41,41,0,0,"RECORTES CE",0
13,"13091",544,485,476,4,9,"RECORTES CE",0
5,"5072",94,86,85,1,1,"RECORTES CE",0
5,"5266",102,79,78,0,1,"RECORTES CE",0
24,"24120",311,209,209,0,0,"RECORTES CE",0
34,"34178",119,105,104,0,1,"RECORTES CE",0
16,"16012",77,65,65,0,0,"RECORTES CE",0
13,"13007",1233,1005,967,11,38,"RECORTES CE",0
40,"40060",68,46,46,0,0,"RECORTES CE",0
28,"28121",205,166,165,1,1,"RECORTES CE",0
37,"37046",10749,8133,7989,84,144,"RECORTES CE",11
47,"47053",126,100,97,0,3,"RECORTES CE",1
9,"9427",1364,1002,972,13,30,"RECORTES CE",3
37,"37218",48,29,29,0,0,"RECORTES CE",0
19,"19055",44,34,34,1,0,"RECORTES CE",0
49,"49238",268,222,216,2,6,"RECORTES CE",0
5,"5042",141,117,116,0,1,"RECORTES CE",0
40,"40131",50,47,47,0,0,"RECORTES CE",0
49,"49233",85,58,58,0,0,"RECORTES CE",0
24,"24178",72,65,65,1,0,"RECORTES CE",0
28,"28141",6246,4943,4890,44,53,"RECORTES CE",7
24,"24058",195,127,125,1,2,"RECORTES CE",0
49,"49157",192,153,149,0,4,"RECORTES CE",2
9,"9072",320,259,258,1,1,"RECORTES CE",3
9,"9409",110,87,87,0,0,"RECORTES CE",0
5,"5190",53,47,47,1,0,"RECORTES CE",0
37,"37157",78,64,64,0,0,"RECORTES CE",1
34,"34003",150,122,120,2,2,"RECORTES CE",2
37,"37107",10483,7732,7633,78,99,"RECORTES CE",9
24,"24101",384,285,283,4,2,"RECORTES CE",0
9,"9303",75,67,67,0,0,"RECORTES CE",0
47,"47041",153,119,116,2,3,"RECORTES CE",0
28,"28167",8608,7086,7015,48,71,"RECORTES CE",13
13,"13077",3399,2447,2380,30,67,"RECORTES CE",4
5,"5210",79,57,57,0,0,"RECORTES CE",0
16,"16133",4387,3607,3544,38,63,"RECORTES CE",2
2,"2031",541,432,425,0,7,"RECORTES CE",0
37,"37004",24,19,19,0,0,"RECORTES CE",0
47,"47032",153,121,121,1,0,"RECORTES CE",0
49,"49258",110,93,92,0,1,"RECORTES CE",0
34,"34151",147,99,97,1,2,"RECORTES CE",0
5,"5175",149,122,119,1,3,"RECORTES CE",0
16,"16029",102,81,81,1,0,"RECORTES CE",0
2,"2083",209,183,183,0,0,"RECORTES CE",0
9,"9406",246,203,200,4,3,"RECORTES CE",1
5,"5089",455,354,340,1,14,"RECORTES CE",2
24,"24083",1005,800,791,7,9,"RECORTES CE",2
28,"28161",51559,41390,40922,255,468,"RECORTES CE",89
13,"13093",3930,2960,2906,34,54,"RECORTES CE",4
9,"9289",1379,1002,994,9,8,"RECORTES CE",1
9,"9132",171,136,130,1,6,"RECORTES CE",1
19,"19008",37,32,32,1,0,"RECORTES CE",0
19,"19031",10,8,8,0,0,"RECORTES CE",0
16,"16206",196,146,144,3,2,"RECORTES CE",0
5,"5264",57,40,38,1,2,"RECORTES CE",0
9,"9447",43,40,40,0,0,"RECORTES CE",0
5,"5200",40,27,26,0,1,"RECORTES CE",0
37,"37244",128,99,97,1,2,"RECORTES CE",0
40,"40058",309,277,271,0,6,"RECORTES CE",0
19,"19223",101,66,66,1,0,"RECORTES CE",0
45,"45061",2485,1850,1822,7,28,"RECORTES CE",0
16,"16271",595,513,511,2,2,"RECORTES CE",1
9,"9255",84,70,70,1,0,"RECORTES CE",0
37,"37109",177,149,149,3,0,"RECORTES CE",0
24,"24073",442,328,324,2,4,"RECORTES CE",0
49,"49231",293,212,209,0,3,"RECORTES CE",0
19,"19179",76,66,64,1,2,"RECORTES CE",0
9,"9309",292,224,223,3,1,"RECORTES CE",2
45,"45029",188,160,159,0,1,"RECORTES CE",1
45,"45202",3982,3094,3055,8,39,"RECORTES CE",1
9,"9418",73,58,55,2,3,"RECORTES CE",0
9,"9152",248,197,195,0,2,"RECORTES CE",0
47,"47195",430,335,320,2,15,"RECORTES CE",0
45,"45200",4478,3666,3565,35,101,"RECORTES CE",3
9,"9016",84,55,54,0,1,"RECORTES CE",0
49,"49224",169,117,115,0,2,"RECORTES CE",0
9,"9410",2999,2175,2135,27,40,"RECORTES CE",2
45,"45147",590,506,496,2,10,"RECORTES CE",0
9,"9091",701,545,533,5,12,"RECORTES CE",2
5,"5044",250,189,189,1,0,"RECORTES CE",0
45,"45205",7342,5347,5275,30,72,"RECORTES CE",13
5,"5102",1681,1358,1329,4,29,"RECORTES CE",5
37,"37113",409,330,329,3,1,"RECORTES CE",0
24,"24041",527,371,364,4,7,"RECORTES CE",0
42,"42050",27,21,21,1,0,"RECORTES CE",0
37,"37185",537,416,405,1,11,"RECORTES CE",0
28,"28140",3139,2547,2523,12,24,"RECORTES CE",7
5,"5120",32,25,25,1,0,"RECORTES CE",0
16,"16227",108,85,85,1,0,"RECORTES CE",0
40,"40139",258,207,202,0,5,"RECORTES CE",0
40,"40179",626,540,529,2,11,"RECORTES CE",0
42,"42111",279,209,208,3,1,"RECORTES CE",0
45,"45032",444,319,313,2,6,"RECORTES CE",0
40,"40903",77,63,62,0,1,"RECORTES CE",0
47,"47056",83,71,71,0,0,"RECORTES CE",0
9,"9070",33,28,25,0,3,"RECORTES CE",0
40,"40019",29,26,26,0,0,"RECORTES CE",0
9,"9076",24,17,17,1,0,"RECORTES CE",0
16,"16166",239,176,174,3,2,"RECORTES CE",1
49,"49227",313,255,254,1,1,"RECORTES CE",0
2,"2086",2426,1738,1728,8,10,"RECORTES CE",0
5,"5194",132,111,111,0,0,"RECORTES CE",0
9,"9395",122,95,94,0,1,"RECORTES CE",0
40,"40072",224,198,194,3,4,"RECORTES CE",1
49,"49121",368,269,266,1,3,"RECORTES CE",0
40,"40224",19,16,16,0,0,"RECORTES CE",0
49,"49261",1505,1168,1149,8,19,"RECORTES CE",4
47,"47082",810,679,668,8,11,"RECORTES CE",1
19,"19225",851,664,650,3,14,"RECORTES CE",5
37,"37069",971,721,704,2,17,"RECORTES CE",1
16,"16036",122,98,97,1,1,"RECORTES CE",0
40,"40056",32,21,21,0,0,"RECORTES CE",0
19,"19060",157,128,125,0,3,"RECORTES CE",0
24,"24157",2545,2028,1972,25,56,"RECORTES CE",4
47,"47150",259,206,202,0,4,"RECORTES CE",0
42,"42174",179,132,128,1,4,"RECORTES CE",0
45,"45058",352,270,269,5,1,"RECORTES CE",1
49,"49109",562,445,444,5,1,"RECORTES CE",0
40,"40164",185,136,134,3,2,"RECORTES CE",0
37,"37026",175,148,148,2,0,"RECORTES CE",0
19,"19323",34,29,29,0,0,"RECORTES CE",0
40,"40188",83,71,71,0,0,"RECORTES CE",0
34,"34113",40,37,37,0,0,"RECORTES CE",0
34,"34093",81,70,70,0,0,"RECORTES CE",1
34,"34233",128,118,117,2,1,"RECORTES CE",0
37,"37286",203,147,142,2,5,"RECORTES CE",1
49,"49142",249,175,173,0,2,"RECORTES CE",1
37,"37215",134,97,96,3,1,"RECORTES CE",1
9,"9405",129,99,97,1,2,"RECORTES CE",1
5,"5162",75,58,58,0,0,"RECORTES CE",0
49,"49199",241,174,171,4,3,"RECORTES CE",1
45,"45133",2808,2233,2187,14,46,"RECORTES CE",2
9,"9362",205,177,177,3,0,"RECORTES CE",1
37,"37120",97,83,81,1,2,"RECORTES CE",0
37,"37349",103,69,68,0,1,"RECORTES CE",0
9,"9269",29,25,23,1,2,"RECORTES CE",0
5,"5025",82,70,70,0,0,"RECORTES CE",0
9,"9249",50,39,39,0,0,"RECORTES CE",0
49,"49145",210,133,131,1,2,"RECORTES CE",1
9,"9403",103,90,89,0,1,"RECORTES CE",1
37,"37112",152,104,103,0,1,"RECORTES CE",1
37,"37034",75,66,66,0,0,"RECORTES CE",0
45,"45123",3160,2434,2392,16,42,"RECORTES CE",3
19,"19265",135,107,107,1,0,"RECORTES CE",0
47,"47118",149,111,108,1,3,"RECORTES CE",0
13,"13083",2392,1772,1714,13,58,"RECORTES CE",1
19,"19107",315,273,270,2,3,"RECORTES CE",0
19,"19330",67,60,60,0,0,"RECORTES CE",1
2,"2039",952,798,789,9,9,"RECORTES CE",0
37,"37291",269,212,209,2,3,"RECORTES CE",0
28,"28086",5390,3992,3936,26,56,"RECORTES CE",7
49,"49265",120,93,92,1,1,"RECORTES CE",0
19,"19310",7,6,6,0,0,"RECORTES CE",0
34,"34159",370,247,244,5,3,"RECORTES CE",1
9,"9066",54,41,40,1,1,"RECORTES CE",0
19,"19291",1131,875,864,1,11,"RECORTES CE",1
5,"5164",17,12,12,0,0,"RECORTES CE",0
19,"19249",28,28,28,0,0,"RECORTES CE",0
40,"40200",38,32,31,0,1,"RECORTES CE",0
37,"37327",179,154,150,0,4,"RECORTES CE",1
9,"9287",199,169,168,1,1,"RECORTES CE",2
45,"45024",1043,832,821,5,11,"RECORTES CE",3
37,"37348",100,79,79,0,0,"RECORTES CE",0
24,"24194",266,199,199,1,0,"RECORTES CE",0
5,"5238",739,589,586,1,3,"RECORTES CE",0
5,"5247",227,182,177,1,5,"RECORTES CE",0
28,"28123",61103,52177,51832,338,345,"RECORTES CE",87
49,"49186",235,181,178,4,3,"RECORTES CE",0
42,"42153",12,10,10,1,0,"RECORTES CE",0
16,"16149",154,130,130,2,0,"RECORTES CE",0
42,"42130",51,46,45,0,1,"RECORTES CE",0
40,"40220",62,48,48,0,0,"RECORTES CE",1
9,"9248",78,64,64,0,0,"RECORTES CE",0
37,"37136",633,448,434,8,14,"RECORTES CE",0
34,"34218",445,352,345,2,7,"RECORTES CE",1
5,"5113",62,49,49,0,0,"RECORTES CE",0
24,"24104",245,173,172,1,1,"RECORTES CE",0
13,"13002",1419,1021,995,5,26,"RECORTES CE",0
19,"19311",87,71,71,2,0,"RECORTES CE",0
19,"19267",21,17,17,1,0,"RECORTES CE",1
9,"9041",26,26,26,1,0,"RECORTES CE",0
34,"34114",198,152,152,0,0,"RECORTES CE",0
34,"34100",131,100,97,1,3,"RECORTES CE",0
42,"42110",55,43,43,0,0,"RECORTES CE",0
37,"37198",203,163,162,3,1,"RECORTES CE",1
9,"9381",33,25,25,0,0,"RECORTES CE",0
47,"47034",72,57,57,1,0,"RECORTES CE",0
5,"5105",336,272,266,2,6,"RECORTES CE",0
40,"40025",128,109,106,1,3,"RECORTES CE",0
13,"13006",572,437,430,5,7,"RECORTES CE",0
34,"34070",135,101,101,1,0,"RECORTES CE",0
42,"42160",247,195,194,4,1,"RECORTES CE",2
40,"40093",76,68,67,0,1,"RECORTES CE",0
16,"16175",5079,4279,4207,40,72,"RECORTES CE",3
9,"9197",137,108,107,0,1,"RECORTES CE",0
24,"24225",992,762,751,5,11,"RECORTES CE",2
37,"37274",118473,91137,90221,811,916,"RECORTES CE",127
9,"9232",140,110,107,0,3,"RECORTES CE",0
37,"37211",212,164,163,1,1,"RECORTES CE",0
49,"49080",630,499,493,4,6,"RECORTES CE",0
2,"2057",1960,1522,1489,15,33,"RECORTES CE",1
49,"49066",449,319,314,4,5,"RECORTES CE",1
24,"24062",130,90,90,2,0,"RECORTES CE",0
16,"16115",47,35,35,0,0,"RECORTES CE",0
45,"45014",4020,2910,2854,22,56,"RECORTES CE",5
37,"37334",73,49,49,0,0,"RECORTES CE",0
34,"34165",59,51,50,1,1,"RECORTES CE",0
37,"37224",189,168,165,0,3,"RECORTES CE",0
23,"23006",4582,3607,3543,32,64,"RISA",1
23,"23019",1479,1209,1183,3,26,"RISA",0
23,"23903",3499,2738,2714,7,24,"RISA",1
23,"23024",12224,9586,9329,46,257,"RISA",7
23,"23064",1678,1413,1404,10,9,"RISA",0
23,"23008",1434,1155,1133,6,22,"RISA",0
23,"23004",421,356,355,2,1,"RISA",0
23,"23084",907,685,670,0,15,"RISA",0
23,"23031",765,659,647,4,12,"RISA",0
23,"23905",1840,1358,1341,9,17,"RISA",0
23,"23042",317,234,232,1,2,"RISA",0
23,"23060",19153,14444,14281,87,163,"RISA",3
23,"23062",1418,1206,1190,5,16,"RISA",0
23,"23018",2268,1738,1722,8,16,"RISA",0
23,"23071",1720,1348,1330,6,18,"RISA",0
23,"23097",6356,4509,4462,17,47,"RISA",3
23,"23052",1108,949,931,8,18,"RISA",0
23,"23027",716,524,518,2,6,"RISA",0
23,"23020",1524,1363,1348,12,15,"RISA",0
23,"23091",679,575,571,3,4,"RISA",0
23,"23101",352,273,271,0,2,"RISA",0
23,"23053",9449,6379,6325,25,54,"RISA",1
23,"23011",2134,1649,1614,11,35,"RISA",0
23,"23070",3808,2598,2565,34,33,"RISA",0
23,"23080",1721,1370,1355,8,15,"RISA",0
23,"23007",3026,2317,2301,13,16,"RISA",0
23,"23098",838,721,715,2,6,"RISA",0
23,"23032",523,443,439,1,4,"RISA",0
23,"23085",2182,1733,1717,7,16,"RISA",0
23,"23074",2971,2410,2378,8,32,"RISA",0
23,"23016",384,316,311,0,5,"RISA",0
23,"23001",920,769,766,3,3,"RISA",0
23,"23086",11442,8618,8431,80,187,"RISA",3
23,"23046",2331,1953,1926,3,27,"RISA",2
23,"23028",6131,4696,4635,24,61,"RISA",1
23,"23050",90596,69591,68903,460,688,"RISA",39
23,"23017",1480,1227,1202,6,25,"RISA",0
23,"23014",2552,2056,2020,11,36,"RISA",0
23,"23049",1747,1321,1305,11,16,"RISA",0
23,"23048",820,644,636,1,8,"RISA",0
23,"23058",8817,6964,6873,48,91,"RISA",3
23,"23063",3764,2812,2781,22,31,"RISA",1
23,"23021",517,446,440,0,6,"RISA",0
23,"23039",2154,1644,1605,6,39,"RISA",1
23,"23043",518,398,397,0,1,"RISA",1
23,"23073",4389,3400,3363,13,37,"RISA",2
23,"23056",3062,2332,2281,13,51,"RISA",4
23,"23029",806,651,637,0,14,"RISA",0
23,"23095",8591,6634,6571,27,63,"RISA",0
23,"23037",520,431,425,6,6,"RISA",0
23,"23099",4822,3687,3633,28,54,"RISA",4
23,"23096",2571,2099,2063,9,36,"RISA",0
23,"23069",5262,4395,4329,15,66,"RISA",2
23,"23009",12808,10348,10233,66,115,"RISA",2
23,"23081",1483,1137,1109,7,28,"RISA",0
23,"23904",2604,1727,1701,7,26,"RISA",2
23,"23088",6020,4779,4703,56,76,"RISA",3
23,"23093",3131,2428,2380,22,48,"RISA",3
23,"23082",1875,1402,1389,7,13,"RISA",0
23,"23094",3729,3111,3077,16,34,"RISA",2
23,"23040",1443,1164,1149,3,15,"RISA",0
23,"23079",3639,2859,2818,20,41,"RISA",0
23,"23092",27662,21206,20981,170,225,"RISA",10
23,"23030",1208,1022,1011,6,11,"RISA",0
23,"23902",2229,1843,1820,7,23,"RISA",0
23,"23047",1579,1260,1247,13,13,"RISA",0
23,"23045",2057,1519,1507,7,12,"RISA",0
23,"23044",4719,3817,3749,18,68,"RISA",3
23,"23034",2490,2033,1999,15,34,"RISA",1
23,"23002",17399,13575,13341,97,234,"RISA",7
23,"23061",7691,5636,5531,51,105,"RISA",2
23,"23005",29940,19587,19330,191,257,"RISA",18
23,"23059",5728,4259,4187,18,72,"RISA",2
23,"23033",1319,1076,1057,8,19,"RISA",1
23,"23026",3450,2625,2573,17,52,"RISA",2
23,"23072",1885,1485,1468,5,17,"RISA",0
23,"23067",2421,1909,1873,13,36,"RISA",1
23,"23087",11185,8500,8363,65,137,"RISA",6
23,"23015",1332,1066,1048,4,18,"RISA",0
23,"23066",4299,3603,3545,13,58,"RISA",2
23,"23901",1139,946,934,3,12,"RISA",1
23,"23055",46343,33603,33225,243,378,"RISA",21
23,"23051",2727,2060,2023,5,37,"RISA",3
23,"23075",3220,2559,2524,18,35,"RISA",4
23,"23010",14241,10186,10015,68,171,"RISA",2
23,"23054",376,296,289,1,7,"RISA",1
23,"23077",611,483,479,0,4,"RISA",0
23,"23038",3785,3182,3162,16,20,"RISA",3
23,"23057",732,613,611,4,2,"RISA",0
23,"23076",768,653,646,3,7,"RISA",0
23,"23065",1550,1199,1186,4,13,"RISA",0
23,"23003",8644,6604,6523,36,81,"RISA",3
23,"23041",491,383,382,0,1,"RISA",0
23,"23035",1103,903,882,6,21,"RISA",0
23,"23025",2727,2125,2090,8,35,"RISA",2
23,"23012",4018,2835,2804,15,31,"RISA",1
23,"23090",1219,1014,1004,5,10,"RISA",0
48,"48075",2067,1591,1565,11,26,"SOLIDARIA",0
48,"48076",284,226,224,1,2,"SOLIDARIA",0
48,"48091",1090,862,857,9,5,"SOLIDARIA",0
48,"48908",249,214,213,0,1,"SOLIDARIA",1
48,"48034",12639,9519,9443,77,76,"SOLIDARIA",10
48,"48077",3376,2656,2647,11,9,"SOLIDARIA",0
48,"48079",395,313,312,2,1,"SOLIDARIA",0
48,"48002",7777,6034,5981,48,53,"SOLIDARIA",4
48,"48020",272959,203643,202331,1472,1312,"SOLIDARIA",132
48,"48078",37991,28582,28382,202,200,"SOLIDARIA",14
48,"48033",204,160,159,1,1,"SOLIDARIA",0
48,"48051",216,157,157,0,0,"SOLIDARIA",0
48,"48909",202,172,172,2,0,"SOLIDARIA",0
48,"48014",1242,915,910,4,5,"SOLIDARIA",0
48,"48044",62054,49055,48840,373,215,"SOLIDARIA",18
48,"48015",33109,24697,24475,161,222,"SOLIDARIA",17
48,"48035",404,334,331,2,3,"SOLIDARIA",1
48,"48005",113,80,80,0,0,"SOLIDARIA",0
48,"48052",1567,1309,1300,4,9,"SOLIDARIA",0
48,"48058",946,724,715,3,9,"SOLIDARIA",0
48,"48085",10637,8270,8223,54,47,"SOLIDARIA",5
48,"48001",5885,4359,4334,35,25,"SOLIDARIA",3
48,"48062",293,247,245,0,2,"SOLIDARIA",0
48,"48060",3620,2615,2606,13,9,"SOLIDARIA",0
48,"48092",869,676,674,9,2,"SOLIDARIA",0
48,"48067",1134,877,872,5,5,"SOLIDARIA",1
48,"48026",1139,920,913,4,7,"SOLIDARIA",0
48,"48914",325,286,285,0,1,"SOLIDARIA",0
48,"48016",5437,4282,4248,21,34,"SOLIDARIA",3
48,"48911",388,323,322,3,1,"SOLIDARIA",0
48,"48043",4539,3566,3556,22,10,"SOLIDARIA",2
48,"48023",580,493,489,0,4,"SOLIDARIA",0
48,"48019",3461,2647,2633,12,14,"SOLIDARIA",0
48,"48046",12644,9809,9744,46,65,"SOLIDARIA",3
48,"48056",989,791,785,4,6,"SOLIDARIA",0
48,"48036",24038,18180,18050,94,130,"SOLIDARIA",14
48,"48081",1883,1532,1518,3,14,"SOLIDARIA",0
48,"48024",999,813,811,2,2,"SOLIDARIA",0
48,"48004",326,261,260,3,1,"SOLIDARIA",0
48,"48027",22668,17326,17224,95,102,"SOLIDARIA",8
48,"48064",613,494,492,1,2,"SOLIDARIA",0
48,"48017",13150,9546,9504,38,42,"SOLIDARIA",2
48,"48901",5151,4042,4012,22,30,"SOLIDARIA",2
48,"48007",385,281,279,1,2,"SOLIDARIA",0
48,"48095",2326,1691,1680,11,11,"SOLIDARIA",0
48,"48054",24938,19329,19197,124,132,"SOLIDARIA",14
48,"48912",2331,1843,1833,7,10,"SOLIDARIA",0
48,"48025",860,694,694,3,0,"SOLIDARIA",0
48,"48074",3273,2480,2460,14,20,"SOLIDARIA",3
48,"48055",2596,2023,2005,12,18,"SOLIDARIA",6
48,"48048",543,421,419,1,2,"SOLIDARIA",0
48,"48045",5194,4138,4098,25,40,"SOLIDARIA",3
48,"48902",18971,14015,13895,101,120,"SOLIDARIA",19
48,"48066",347,291,291,0,0,"SOLIDARIA",0
48,"48086",2015,1504,1486,6,18,"SOLIDARIA",2
48,"48069",13094,10021,9954,49,67,"SOLIDARIA",4
48,"48008",615,454,448,4,6,"SOLIDARIA",0
48,"48089",3463,2746,2732,10,14,"SOLIDARIA",61
48,"48096",6510,5247,5185,36,62,"SOLIDARIA",2
48,"48913",1224,977,967,6,10,"SOLIDARIA",0
48,"48910",2802,2082,2073,3,9,"SOLIDARIA",0
48,"48065",3303,2541,2524,15,17,"SOLIDARIA",62
48,"48070",528,392,390,2,2,"SOLIDARIA",0
48,"48029",8613,6697,6642,52,55,"SOLIDARIA",9
48,"48083",6946,5238,5201,35,37,"SOLIDARIA",3
48,"48009",772,628,622,2,6,"SOLIDARIA",0
48,"48903",1807,1471,1462,6,9,"SOLIDARIA",0
48,"48087",432,357,356,0,1,"SOLIDARIA",0
48,"48030",601,490,489,0,1,"SOLIDARIA",0
48,"48057",5745,4391,4376,13,15,"SOLIDARIA",2
48,"48006",309,265,265,0,0,"SOLIDARIA",0
48,"48037",684,537,531,4,6,"SOLIDARIA",0
48,"48097",1316,979,976,4,3,"SOLIDARIA",1
48,"48084",21858,15943,15796,116,147,"SOLIDARIA",15
48,"48080",9946,7574,7499,46,75,"SOLIDARIA",2
48,"48040",1309,979,973,5,6,"SOLIDARIA",0
48,"48010",474,368,368,0,0,"SOLIDARIA",0
48,"48047",149,115,115,1,0,"SOLIDARIA",0
48,"48904",3542,2832,2811,27,21,"SOLIDARIA",0
48,"48915",347,259,259,4,0,"SOLIDARIA",0
48,"48041",686,581,579,2,2,"SOLIDARIA",0
48,"48071",6038,4711,4674,27,37,"SOLIDARIA",1
48,"48031",308,236,236,0,0,"SOLIDARIA",0
48,"48061",799,636,636,2,0,"SOLIDARIA",1
48,"48088",133,99,98,2,1,"SOLIDARIA",1
48,"48038",1158,891,891,2,0,"SOLIDARIA",0
48,"48011",9652,7293,7251,37,42,"SOLIDARIA",5
48,"48068",1528,1218,1211,5,7,"SOLIDARIA",0
48,"48028",691,576,573,1,3,"SOLIDARIA",0
48,"48042",1365,1136,1130,7,6,"SOLIDARIA",0
48,"48021",1336,990,983,4,7,"SOLIDARIA",1
48,"48082",37396,27913,27694,172,219,"SOLIDARIA",8
48,"48905",2490,1911,1891,16,20,"SOLIDARIA",0
48,"48059",400,329,325,0,4,"SOLIDARIA",0
48,"48018",867,605,603,3,2,"SOLIDARIA",0
48,"48072",970,735,730,1,5,"SOLIDARIA",0
48,"48032",5773,4504,4476,5,28,"SOLIDARIA",0
48,"48093",888,720,715,2,5,"SOLIDARIA",0
48,"48039",256,218,217,1,1,"SOLIDARIA",0
48,"48906",753,611,608,1,3,"SOLIDARIA",1
48,"48049",545,448,448,0,0,"SOLIDARIA",1
48,"48022",2316,1645,1631,11,14,"SOLIDARIA",0
48,"48012",2071,1685,1674,7,11,"SOLIDARIA",0
48,"48053",904,738,728,5,10,"SOLIDARIA",1
48,"48090",6016,4700,4639,24,61,"SOLIDARIA",0
48,"48063",356,277,274,2,3,"SOLIDARIA",0
48,"48073",6837,4950,4921,33,29,"SOLIDARIA",0
48,"48094",3125,2407,2388,12,19,"SOLIDARIA",0
48,"48013",79423,59100,58630,458,470,"SOLIDARIA",53
48,"48050",187,153,149,0,4,"SOLIDARIA",0
48,"48003",14444,11233,11162,43,71,"SOLIDARIA",4
48,"48907",340,283,281,1,2,"SOLIDARIA",0
30,"30042",2180,1727,1703,6,24,"SOMOS REGIÓ",3
30,"30014",1585,1226,1202,3,24,"SOMOS REGIÓ",1
30,"30029",12055,9003,8882,58,121,"SOMOS REGIÓ",36
30,"30017",11477,8952,8844,62,108,"SOMOS REGIÓ",18
30,"30015",19372,14430,14283,91,147,"SOMOS REGIÓ",35
30,"30030",320172,249965,247884,1497,2081,"SOMOS REGIÓ",2105
30,"30031",500,435,433,3,2,"SOMOS REGIÓ",0
30,"30020",6431,4991,4940,19,51,"SOMOS REGIÓ",7
30,"30011",4695,3665,3610,16,55,"SOMOS REGIÓ",48
30,"30006",829,731,727,4,4,"SOMOS REGIÓ",1
30,"30037",19254,14416,14217,67,199,"SOMOS REGIÓ",412
30,"30034",1075,852,831,4,21,"SOMOS REGIÓ",42
30,"30025",5001,3951,3898,27,53,"SOMOS REGIÓ",15
30,"30026",16252,11142,10977,65,165,"SOMOS REGIÓ",29
30,"30007",6484,4774,4727,25,47,"SOMOS REGIÓ",11
30,"30019",25846,18755,18517,172,238,"SOMOS REGIÓ",111
30,"30036",15256,10884,10703,56,181,"SOMOS REGIÓ",31
30,"30018",8326,6544,6438,25,106,"SOMOS REGIÓ",13
30,"30016",152709,110165,109114,717,1051,"SOMOS REGIÓ",464
30,"30039",20191,14552,14380,96,172,"SOMOS REGIÓ",60
30,"30010",6857,5533,5457,38,76,"SOMOS REGIÓ",16
30,"30008",14450,10832,10675,60,157,"SOMOS REGIÓ",61
30,"30035",19268,14248,14103,92,145,"SOMOS REGIÓ",170
30,"30033",10363,8115,7979,54,136,"SOMOS REGIÓ",62
30,"30041",13970,9796,9682,80,114,"SOMOS REGIÓ",88
30,"30902",8225,5797,5715,22,82,"SOMOS REGIÓ",36
30,"30004",1126,884,876,5,8,"SOMOS REGIÓ",0
30,"30009",12689,10036,9909,50,127,"SOMOS REGIÓ",49
30,"30012",9069,7397,7266,53,131,"SOMOS REGIÓ",19
30,"30001",4539,3615,3567,16,48,"SOMOS REGIÓ",20
30,"30002",9735,7319,7227,33,92,"SOMOS REGIÓ",88
30,"30028",6400,4364,4289,30,75,"SOMOS REGIÓ",2
30,"30013",7467,5621,5553,26,68,"SOMOS REGIÓ",8
30,"30043",25401,20378,19992,131,386,"SOMOS REGIÓ",24
30,"30901",10529,8488,8375,37,113,"SOMOS REGIÓ",40
30,"30024",60183,45738,45317,290,421,"SOMOS REGIÓ",350
30,"30005",30193,22648,22419,136,229,"SOMOS REGIÓ",137
30,"30038",15674,11755,11675,59,80,"SOMOS REGIÓ",54
30,"30022",17056,12158,11954,126,204,"SOMOS REGIÓ",32
30,"30021",9441,6664,6591,32,73,"SOMOS REGIÓ",16
30,"30040",705,600,596,1,4,"SOMOS REGIÓ",3
30,"30032",2851,2256,2218,14,38,"SOMOS REGIÓ",5
30,"30003",25046,17860,17668,99,192,"SOMOS REGIÓ",29
30,"30027",49767,39111,38724,245,387,"SOMOS REGIÓ",197
30,"30023",3875,3107,3068,20,39,"SOMOS REGIÓ",10
44,"44103",123,101,100,1,1,"UDT",0
44,"44014",2499,2015,1963,25,52,"UDT",2
44,"44151",182,139,138,1,1,"UDT",0
44,"44121",53,38,38,2,0,"UDT",0
44,"44216",26922,20603,20279,204,324,"UDT",8
44,"44152",67,48,48,2,0,"UDT",0
44,"44260",138,91,90,1,1,"UDT",0
44,"44154",248,200,195,2,5,"UDT",0
44,"44064",63,49,48,0,1,"UDT",0
44,"44155",1056,830,813,9,17,"UDT",0
44,"44068",643,518,511,9,7,"UDT",0
44,"44244",68,48,48,4,0,"UDT",0
44,"44206",103,83,82,0,1,"UDT",0
44,"44226",124,87,83,2,4,"UDT",0
44,"44213",65,46,46,0,0,"UDT",0
44,"44195",84,66,65,1,1,"UDT",0
44,"44262",143,115,112,0,3,"UDT",0
44,"44227",72,61,61,0,0,"UDT",0
44,"44035",105,86,84,1,2,"UDT",0
44,"44246",1590,1173,1150,11,23,"UDT",0
44,"44176",153,124,124,0,0,"UDT",0
44,"44114",238,188,184,1,4,"UDT",0
44,"44158",1166,921,904,7,17,"UDT",0
44,"44237",368,299,293,2,6,"UDT",0
44,"44010",184,137,137,1,0,"UDT",0
44,"44046",43,32,32,0,0,"UDT",0
44,"44034",126,97,97,2,0,"UDT",0
44,"44038",98,83,80,0,3,"UDT",1
44,"44116",76,62,62,0,0,"UDT",0
44,"44004",379,312,310,5,2,"UDT",0
44,"44268",32,30,30,0,0,"UDT",0
44,"44236",59,44,44,0,0,"UDT",0
44,"44113",72,51,50,0,1,"UDT",0
44,"44232",368,284,273,2,11,"UDT",0
44,"44119",119,83,82,0,1,"UDT",0
44,"44235",89,67,66,2,1,"UDT",0
44,"44110",37,33,33,0,0,"UDT",0
44,"44183",63,43,43,0,0,"UDT",0
44,"44032",17,13,13,0,0,"UDT",0
44,"44130",27,24,24,0,0,"UDT",0
44,"44129",36,29,29,0,0,"UDT",0
44,"44085",49,31,31,0,0,"UDT",0
44,"44122",1284,995,984,15,11,"UDT",1
44,"44143",394,327,327,2,0,"UDT",0
44,"44247",287,216,215,6,1,"UDT",0
44,"44207",130,101,101,1,0,"UDT",0
44,"44267",71,53,52,0,1,"UDT",0
44,"44049",796,592,578,9,14,"UDT",0
44,"44024",28,25,24,0,1,"UDT",0
44,"44108",300,228,224,5,4,"UDT",0
44,"44171",182,130,128,0,2,"UDT",0
44,"44163",114,92,92,0,0,"UDT",0
44,"44089",52,44,44,0,0,"UDT",0
44,"44023",18,14,14,0,0,"UDT",0
44,"44115",102,96,95,0,1,"UDT",0
44,"44037",449,334,331,1,3,"UDT",0
44,"44099",649,457,450,2,7,"UDT",0
44,"44031",82,52,52,1,0,"UDT",0
44,"44027",149,120,119,0,1,"UDT",0
44,"44016",436,334,331,1,3,"UDT",0
44,"44090",66,49,49,0,0,"UDT",0
44,"44185",93,73,72,1,1,"UDT",0
44,"44044",83,65,64,2,1,"UDT",0
44,"44147",398,293,286,3,7,"UDT",0
44,"44261",722,584,578,8,6,"UDT",1
44,"44018",16,16,16,0,0,"UDT",0
44,"44224",21,15,15,0,0,"UDT",0
44,"44067",108,82,78,0,4,"UDT",0
44,"44240",149,121,121,0,0,"UDT",0
44,"44200",39,25,25,0,0,"UDT",0
44,"44059",550,446,437,7,9,"UDT",0
44,"44182",198,172,171,2,1,"UDT",1
44,"44208",26,22,22,0,0,"UDT",0
44,"44022",463,342,326,6,16,"UDT",0
44,"44124",73,58,57,0,1,"UDT",0
44,"44055",77,58,56,0,2,"UDT",0
44,"44012",310,240,238,5,2,"UDT",0
44,"44160",440,311,306,2,5,"UDT",0
44,"44092",70,56,55,1,1,"UDT",0
44,"44133",15,12,12,0,0,"UDT",0
44,"44161",430,320,316,1,4,"UDT",0
44,"44001",65,51,50,0,1,"UDT",0
44,"44107",205,159,158,0,1,"UDT",0
44,"44094",123,112,112,0,0,"UDT",0
44,"44178",53,39,39,0,0,"UDT",0
44,"44181",66,58,57,0,1,"UDT",0
44,"44218",31,25,25,2,0,"UDT",0
44,"44135",102,85,85,0,0,"UDT",0
44,"44184",38,28,26,0,2,"UDT",0
44,"44033",244,174,172,0,2,"UDT",0
44,"44205",634,444,426,9,18,"UDT",0
44,"44043",88,67,65,1,2,"UDT",0
44,"44071",585,449,447,6,2,"UDT",0
44,"44040",191,164,158,2,6,"UDT",1
44,"44215",168,121,120,1,1,"UDT",1
44,"44005",46,31,31,1,0,"UDT",0
44,"44077",74,55,54,0,1,"UDT",0
44,"44210",743,600,594,8,6,"UDT",0
44,"44221",384,320,315,2,5,"UDT",0
44,"44125",65,50,50,0,0,"UDT",0
44,"44080",284,214,212,1,2,"UDT",0
44,"44165",173,136,135,2,1,"UDT",0
44,"44223",73,58,58,0,0,"UDT",0
44,"44159",37,32,32,1,0,"UDT",0
44,"44251",242,197,187,0,10,"UDT",0
44,"44074",444,353,346,3,7,"UDT",0
44,"44264",248,175,171,0,4,"UDT",0
44,"44076",2110,1725,1691,22,34,"UDT",2
44,"44106",153,115,111,2,4,"UDT",0
44,"44066",87,66,65,0,1,"UDT",0
44,"44231",36,33,32,0,1,"UDT",0
44,"44109",102,71,70,1,1,"UDT",0
44,"44025",5825,4337,4197,50,140,"UDT",3
44,"44252",75,56,56,1,0,"UDT",0
44,"44061",75,66,65,2,1,"UDT",0
44,"44112",408,303,293,2,10,"UDT",0
44,"44101",51,43,42,1,1,"UDT",0
44,"44173",102,85,80,0,5,"UDT",0
44,"44148",76,64,63,0,1,"UDT",0
44,"44258",53,44,44,0,0,"UDT",0
44,"44142",28,21,21,0,0,"UDT",0
44,"44075",326,275,263,0,12,"UDT",0
44,"44011",48,32,32,1,0,"UDT",0
44,"44088",23,21,21,0,0,"UDT",0
44,"44062",31,24,23,1,1,"UDT",0
44,"44187",193,155,151,1,4,"UDT",0
44,"44150",26,21,21,0,0,"UDT",0
44,"44265",181,153,148,1,5,"UDT",0
44,"44239",22,19,19,0,0,"UDT",0
44,"44131",27,22,22,0,0,"UDT",0
44,"44225",103,82,81,0,1,"UDT",0
44,"44174",409,306,300,3,6,"UDT",0
44,"44238",2294,1763,1743,10,20,"UDT",0
44,"44029",579,466,457,3,9,"UDT",0
44,"44086",421,332,327,3,5,"UDT",0
44,"44026",95,76,75,2,1,"UDT",0
44,"44263",377,296,285,3,11,"UDT",0
44,"44082",89,72,69,0,3,"UDT",0
44,"44219",173,142,136,1,6,"UDT",1
44,"44096",153,120,112,1,8,"UDT",0
44,"44036",23,20,20,0,0,"UDT",0
44,"44249",46,37,37,1,0,"UDT",0
44,"44003",17,14,14,0,0,"UDT",0
44,"44128",59,46,45,0,1,"UDT",0
44,"44243",27,24,23,0,1,"UDT",0
44,"44144",325,249,247,1,2,"UDT",0
44,"44204",27,22,22,0,0,"UDT",0
44,"44203",9,9,9,0,0,"UDT",0
44,"44266",102,89,86,1,3,"UDT",0
44,"44141",127,100,100,0,0,"UDT",0
44,"44193",69,57,56,1,1,"UDT",0
44,"44065",57,37,36,0,1,"UDT",0
44,"44127",57,45,45,0,0,"UDT",0
44,"44199",39,39,38,5,1,"UDT",0
44,"44102",27,22,22,0,0,"UDT",0
44,"44053",105,81,81,0,0,"UDT",0
44,"44045",368,302,298,8,4,"UDT",0
44,"44013",11250,8525,8420,95,105,"UDT",0
44,"44042",114,84,84,0,0,"UDT",0
44,"44052",74,50,49,0,1,"UDT",0
44,"44234",70,57,57,1,0,"UDT",0
44,"44179",325,233,231,7,2,"UDT",0
44,"44211",35,24,24,0,0,"UDT",0
44,"44228",99,83,83,0,0,"UDT",0
44,"44137",188,148,146,0,2,"UDT",0
44,"44192",349,288,284,1,4,"UDT",0
44,"44217",31,25,25,0,0,"UDT",0
44,"44123",99,69,69,1,0,"UDT",0
44,"44169",310,250,245,4,5,"UDT",0
44,"44006",223,171,169,2,2,"UDT",0
44,"44197",50,35,35,0,0,"UDT",0
44,"44060",37,28,28,0,0,"UDT",0
44,"44050",3115,2333,2299,27,34,"UDT",1
44,"44153",1749,1264,1243,11,21,"UDT",0
44,"44201",478,417,412,3,5,"UDT",0
44,"44198",181,151,145,1,6,"UDT",0
44,"44020",22,18,18,0,0,"UDT",0
44,"44189",48,36,36,0,0,"UDT",0
44,"44084",55,45,45,0,0,"UDT",0
44,"44105",69,54,54,1,0,"UDT",0
44,"44145",972,741,732,11,9,"UDT",0
44,"44229",143,110,108,4,2,"UDT",0
44,"44167",39,30,30,0,0,"UDT",0
44,"44117",319,263,256,5,7,"UDT",0
44,"44196",125,96,95,2,1,"UDT",1
44,"44194",104,80,80,1,0,"UDT",0
44,"44245",245,176,171,1,5,"UDT",0
44,"44209",815,606,592,2,14,"UDT",0
44,"44056",457,352,341,4,11,"UDT",0
44,"44220",113,92,89,0,3,"UDT",0
44,"44132",58,47,47,0,0,"UDT",0
44,"44149",100,74,73,0,1,"UDT",0
44,"44087",68,56,54,0,2,"UDT",0
44,"44017",272,221,219,0,2,"UDT",0
44,"44157",64,38,38,1,0,"UDT",0
44,"44177",101,75,75,1,0,"UDT",0
44,"44138",118,90,89,2,1,"UDT",0
44,"44111",78,64,64,1,0,"UDT",0
44,"44063",65,55,55,1,0,"UDT",0
44,"44180",72,61,61,0,0,"UDT",0
44,"44048",53,47,47,0,0,"UDT",0
44,"44002",46,42,42,0,0,"UDT",0
44,"44028",171,140,138,1,2,"UDT",0
44,"44097",126,91,90,2,1,"UDT",0
44,"44007",152,120,117,0,3,"UDT",0
44,"44190",65,45,43,0,2,"UDT",1
44,"44093",79,73,73,4,0,"UDT",0
44,"44256",34,32,32,1,0,"UDT",0
44,"44054",94,79,79,0,0,"UDT",0
44,"44168",184,137,136,4,1,"UDT",0
44,"44009",799,621,611,7,10,"UDT",0
44,"44039",202,166,165,3,1,"UDT",0
44,"44172",295,220,218,4,2,"UDT",0
44,"44164",20,18,18,0,0,"UDT",0
44,"44191",722,567,561,7,6,"UDT",0
44,"44222",122,102,102,1,0,"UDT",0
44,"44146",170,148,146,3,2,"UDT",0
44,"44230",152,112,111,1,1,"UDT",0
44,"44019",68,42,42,0,0,"UDT",0
44,"44241",506,416,407,1,9,"UDT",0
44,"44136",51,43,43,1,0,"UDT",0
44,"44175",113,84,82,1,2,"UDT",0
44,"44120",219,158,152,1,6,"UDT",1
44,"44047",229,125,124,2,1,"UDT",0
44,"44041",58,48,44,1,4,"UDT",0
44,"44051",2588,2034,1997,26,37,"UDT",2
44,"44118",158,126,122,1,4,"UDT",0
44,"44156",46,36,33,1,3,"UDT",0
44,"44257",154,110,109,1,1,"UDT",0
44,"44212",41,32,32,0,0,"UDT",0
44,"44070",55,45,45,0,0,"UDT",0
44,"44126",317,226,222,1,4,"UDT",0
44,"44008",1565,1158,1138,8,20,"UDT",0
44,"44021",104,86,85,2,1,"UDT",0
44,"44250",19,15,15,0,0,"UDT",0
44,"44100",175,142,141,2,1,"UDT",0
46,"46171",16429,12527,12373,61,154,"UIG-SOM-CUI",80
46,"46253",114,85,85,2,0,"UIG-SOM-CUI",3
46,"46008",2624,2036,1996,9,40,"UIG-SOM-CUI",3
46,"46169",32294,24909,24676,157,233,"UIG-SOM-CUI",85
46,"46011",7523,5320,5235,28,85,"UIG-SOM-CUI",19
46,"46098",2403,1807,1772,8,35,"UIG-SOM-CUI",1
46,"46161",1472,1200,1172,7,28,"UIG-SOM-CUI",1
46,"46090",1633,1413,1392,5,21,"UIG-SOM-CUI",3
46,"46262",213,170,165,1,5,"UIG-SOM-CUI",0
46,"46104",1891,1515,1481,17,34,"UIG-SOM-CUI",5
46,"46146",1641,1314,1281,11,33,"UIG-SOM-CUI",3
46,"46217",893,733,723,6,10,"UIG-SOM-CUI",0
46,"46009",3140,2582,2536,14,46,"UIG-SOM-CUI",4
46,"46261",1709,1367,1340,14,27,"UIG-SOM-CUI",1
46,"46049",268,231,228,1,3,"UIG-SOM-CUI",3
46,"46184",26453,21076,20810,172,266,"UIG-SOM-CUI",26
46,"46165",7298,5744,5697,38,47,"UIG-SOM-CUI",29
46,"46040",995,807,794,7,13,"UIG-SOM-CUI",0
46,"46073",1077,867,862,10,5,"UIG-SOM-CUI",0
46,"46225",348,279,273,2,6,"UIG-SOM-CUI",0
46,"46209",1901,1517,1500,5,17,"UIG-SOM-CUI",0
46,"46078",28394,20928,20748,156,180,"UIG-SOM-CUI",77
46,"46100",281,210,205,0,5,"UIG-SOM-CUI",0
46,"46182",1310,988,977,5,11,"UIG-SOM-CUI",2
46,"46099",772,620,614,1,6,"UIG-SOM-CUI",0
46,"46255",3209,2415,2381,18,34,"UIG-SOM-CUI",6
46,"46210",344,265,258,2,7,"UIG-SOM-CUI",0
46,"46155",993,785,772,2,13,"UIG-SOM-CUI",1
46,"46163",1856,1522,1501,4,21,"UIG-SOM-CUI",4
46,"46170",3408,2769,2720,16,49,"UIG-SOM-CUI",3
46,"46109",6174,4763,4639,30,124,"UIG-SOM-CUI",7
46,"46058",1734,1349,1325,9,24,"UIG-SOM-CUI",2
46,"46167",345,255,255,0,0,"UIG-SOM-CUI",0
46,"46039",2121,1730,1698,19,32,"UIG-SOM-CUI",4
46,"46022",15325,11197,11072,70,125,"UIG-SOM-CUI",40
46,"46191",1949,1541,1505,7,36,"UIG-SOM-CUI",5
46,"46201",62,47,47,0,0,"UIG-SOM-CUI",0
46,"46140",377,312,312,2,0,"UIG-SOM-CUI",1
46,"46059",1240,1038,1030,3,8,"UIG-SOM-CUI",1
46,"46198",871,707,693,4,14,"UIG-SOM-CUI",2
46,"46120",1183,958,936,3,22,"UIG-SOM-CUI",2
46,"46019",8948,7150,7067,40,83,"UIG-SOM-CUI",18
46,"46188",693,591,585,3,6,"UIG-SOM-CUI",2
46,"46085",11075,8106,8011,54,95,"UIG-SOM-CUI",34
46,"46902",356,300,296,8,4,"UIG-SOM-CUI",3
46,"46111",11326,8603,8492,55,111,"UIG-SOM-CUI",39
46,"46030",796,653,633,7,20,"UIG-SOM-CUI",4
46,"46108",426,346,342,1,4,"UIG-SOM-CUI",0
46,"46017",32990,23940,23694,155,246,"UIG-SOM-CUI",120
46,"46164",12073,8987,8836,63,151,"UIG-SOM-CUI",22
46,"46010",950,727,718,6,9,"UIG-SOM-CUI",4
46,"46263",239,204,200,3,4,"UIG-SOM-CUI",1
46,"46093",2134,1700,1687,8,13,"UIG-SOM-CUI",2
46,"46231",2401,1780,1770,8,10,"UIG-SOM-CUI",1
46,"46203",3544,2851,2810,21,41,"UIG-SOM-CUI",5
46,"46122",2730,2103,2071,19,32,"UIG-SOM-CUI",4
46,"46092",263,182,179,1,3,"UIG-SOM-CUI",2
46,"46183",6028,4620,4534,29,86,"UIG-SOM-CUI",11
46,"46173",1319,1084,1062,6,22,"UIG-SOM-CUI",1
46,"46180",651,525,519,0,6,"UIG-SOM-CUI",2
46,"46252",128,106,106,2,0,"UIG-SOM-CUI",0
46,"46174",949,789,770,4,19,"UIG-SOM-CUI",0
46,"46103",1338,1056,1042,5,14,"UIG-SOM-CUI",8
46,"46082",4958,3801,3759,21,42,"UIG-SOM-CUI",10
46,"46192",790,599,586,8,13,"UIG-SOM-CUI",0
46,"46062",4572,3571,3510,20,61,"UIG-SOM-CUI",3
46,"46042",3348,2825,2774,11,51,"UIG-SOM-CUI",5
46,"46032",5692,4518,4476,22,42,"UIG-SOM-CUI",26
46,"46113",2527,1906,1892,12,14,"UIG-SOM-CUI",2
46,"46238",13105,9717,9610,57,107,"UIG-SOM-CUI",19
46,"46083",15374,11259,11096,56,163,"UIG-SOM-CUI",25
46,"46181",16908,12749,12597,82,152,"UIG-SOM-CUI",21
46,"46029",20423,15450,15274,100,176,"UIG-SOM-CUI",28
46,"46060",9287,7184,7110,40,74,"UIG-SOM-CUI",44
46,"46102",19635,15330,15207,95,123,"UIG-SOM-CUI",17
46,"46084",1503,1225,1195,1,30,"UIG-SOM-CUI",4
46,"46101",816,696,687,3,9,"UIG-SOM-CUI",2
46,"46175",428,367,354,3,13,"UIG-SOM-CUI",0
46,"46212",1590,1209,1192,4,17,"UIG-SOM-CUI",3
46,"46202",17660,13782,13645,93,137,"UIG-SOM-CUI",25
46,"46024",444,339,335,1,4,"UIG-SOM-CUI",1
46,"46074",2678,2158,2135,13,23,"UIG-SOM-CUI",3
46,"46246",1042,860,838,2,22,"UIG-SOM-CUI",0
46,"46037",1109,927,918,4,9,"UIG-SOM-CUI",1
46,"46097",958,764,756,6,8,"UIG-SOM-CUI",2
46,"46087",109,98,98,1,0,"UIG-SOM-CUI",0
46,"46256",7211,5263,5209,27,54,"UIG-SOM-CUI",29
46,"46096",257,220,217,0,3,"UIG-SOM-CUI",0
46,"46072",3542,3008,2961,33,47,"UIG-SOM-CUI",6
46,"46095",578,467,458,1,9,"UIG-SOM-CUI",0
46,"46213",15504,11420,11232,124,188,"UIG-SOM-CUI",3
46,"46247",961,695,687,3,8,"UIG-SOM-CUI",1
46,"46015",7477,5857,5808,33,49,"UIG-SOM-CUI",54
46,"46075",147,136,134,2,2,"UIG-SOM-CUI",1
46,"46065",1576,1246,1228,6,18,"UIG-SOM-CUI",10
46,"46160",1907,1508,1485,5,23,"UIG-SOM-CUI",4
46,"46028",388,324,319,1,5,"UIG-SOM-CUI",0
46,"46251",2442,2017,1976,9,41,"UIG-SOM-CUI",1
46,"46179",2116,1723,1678,18,45,"UIG-SOM-CUI",0
46,"46068",345,308,307,4,1,"UIG-SOM-CUI",0
46,"46023",328,277,269,1,8,"UIG-SOM-CUI",2
46,"46214",16415,12723,12610,74,113,"UIG-SOM-CUI",22
46,"46035",6855,5500,5422,34,78,"UIG-SOM-CUI",17
46,"46241",389,318,313,4,5,"UIG-SOM-CUI",0
46,"46177",4778,3767,3711,17,56,"UIG-SOM-CUI",42
46,"46066",1285,1058,1043,6,15,"UIG-SOM-CUI",5
46,"46076",591,497,487,0,10,"UIG-SOM-CUI",0
46,"46211",1837,1490,1462,11,28,"UIG-SOM-CUI",5
46,"46147",17133,12260,12120,59,140,"UIG-SOM-CUI",34
46,"46144",628,511,505,1,6,"UIG-SOM-CUI",1
46,"46245",528,430,426,2,4,"UIG-SOM-CUI",1
46,"46208",1070,875,866,2,9,"UIG-SOM-CUI",1
46,"46159",23051,17496,17359,104,137,"UIG-SOM-CUI",69
46,"46196",140,115,114,0,1,"UIG-SOM-CUI",0
46,"46168",1982,1543,1522,5,21,"UIG-SOM-CUI",0
46,"46205",14233,11274,11145,55,129,"UIG-SOM-CUI",27
46,"46195",1982,1562,1554,2,8,"UIG-SOM-CUI",2
46,"46050",186,157,154,1,3,"UIG-SOM-CUI",0
46,"46094",20691,15841,15672,88,169,"UIG-SOM-CUI",138
46,"46219",122,105,104,0,1,"UIG-SOM-CUI",0
46,"46229",911,755,752,5,3,"UIG-SOM-CUI",0
46,"46128",1581,1324,1287,2,37,"UIG-SOM-CUI",1
46,"46047",532,447,441,4,6,"UIG-SOM-CUI",0
46,"46145",22099,16685,16499,128,186,"UIG-SOM-CUI",31
46,"46107",1849,1501,1480,5,21,"UIG-SOM-CUI",2
46,"46086",80,69,69,0,0,"UIG-SOM-CUI",0
46,"46007",12284,9370,9265,65,105,"UIG-SOM-CUI",32
46,"46044",4198,3399,3337,13,62,"UIG-SOM-CUI",2
46,"46115",352,261,260,0,1,"UIG-SOM-CUI",0
46,"46176",2045,1450,1434,12,16,"UIG-SOM-CUI",13
46,"46240",206,175,169,2,6,"UIG-SOM-CUI",2
46,"46230",14084,10694,10599,67,95,"UIG-SOM-CUI",43
46,"46129",512,408,400,4,8,"UIG-SOM-CUI",0
46,"46139",4512,3612,3567,25,45,"UIG-SOM-CUI",3
46,"46031",10521,7735,7607,62,128,"UIG-SOM-CUI",49
46,"46001",783,612,607,4,5,"UIG-SOM-CUI",0
46,"46018",567,483,479,3,4,"UIG-SOM-CUI",0
46,"46152",87,69,69,0,0,"UIG-SOM-CUI",0
46,"46243",124,105,104,0,1,"UIG-SOM-CUI",0
46,"46187",1304,991,982,8,9,"UIG-SOM-CUI",4
46,"46221",345,294,294,0,0,"UIG-SOM-CUI",1
46,"46904",805,643,628,13,15,"UIG-SOM-CUI",5
46,"46052",508,436,426,3,10,"UIG-SOM-CUI",2
46,"46150",1797,1275,1257,9,18,"UIG-SOM-CUI",5
46,"46057",474,319,313,1,6,"UIG-SOM-CUI",1
46,"46005",23013,17487,17286,112,201,"UIG-SOM-CUI",49
46,"46130",857,680,669,6,11,"UIG-SOM-CUI",0
46,"46033",196,169,168,3,1,"UIG-SOM-CUI",0
46,"46117",500,407,399,1,8,"UIG-SOM-CUI",2
46,"46002",1215,963,959,5,4,"UIG-SOM-CUI",5
46,"46080",985,799,788,5,11,"UIG-SOM-CUI",0
46,"46026",1202,1012,997,1,15,"UIG-SOM-CUI",4
46,"46131",49504,37495,37064,259,431,"UIG-SOM-CUI",75
46,"46232",872,714,706,3,8,"UIG-SOM-CUI",2
46,"46114",574,457,452,1,5,"UIG-SOM-CUI",1
46,"46257",5428,4237,4190,23,47,"UIG-SOM-CUI",13
46,"46021",23977,18032,17879,125,153,"UIG-SOM-CUI",42
46,"46121",111,96,94,2,2,"UIG-SOM-CUI",0
46,"46254",943,751,734,4,17,"UIG-SOM-CUI",1
46,"46051",8384,6550,6452,24,98,"UIG-SOM-CUI",12
46,"46172",5412,3878,3832,18,46,"UIG-SOM-CUI",5
46,"46199",5842,4451,4414,23,37,"UIG-SOM-CUI",11
46,"46118",3670,2930,2894,25,36,"UIG-SOM-CUI",0
46,"46226",31,27,27,0,0,"UIG-SOM-CUI",0
46,"46216",5252,4291,4263,23,28,"UIG-SOM-CUI",7
46,"46088",150,129,127,0,2,"UIG-SOM-CUI",0
46,"46142",761,580,565,4,15,"UIG-SOM-CUI",0
46,"46041",327,251,250,2,1,"UIG-SOM-CUI",2
46,"46903",6285,5035,4996,27,39,"UIG-SOM-CUI",10
46,"46012",929,727,707,3,20,"UIG-SOM-CUI",0
46,"46014",3130,2488,2462,7,26,"UIG-SOM-CUI",2
46,"46193",8964,7206,7156,27,50,"UIG-SOM-CUI",25
46,"46004",1919,1641,1616,14,25,"UIG-SOM-CUI",2
46,"46038",307,243,241,0,2,"UIG-SOM-CUI",0
46,"46190",50023,37273,36976,250,297,"UIG-SOM-CUI",76
46,"46089",2170,1692,1672,6,20,"UIG-SOM-CUI",2
46,"46045",1243,1033,1018,3,15,"UIG-SOM-CUI",7
46,"46197",1926,1473,1455,9,18,"UIG-SOM-CUI",6
46,"46069",157,130,129,0,1,"UIG-SOM-CUI",0
46,"46204",6657,5262,5204,27,58,"UIG-SOM-CUI",13
46,"46106",1466,1156,1142,3,14,"UIG-SOM-CUI",0
46,"46133",472,374,374,2,0,"UIG-SOM-CUI",0
46,"46077",7344,5873,5761,49,112,"UIG-SOM-CUI",2
46,"46034",1811,1407,1389,13,18,"UIG-SOM-CUI",4
46,"46013",17712,14181,14075,88,106,"UIG-SOM-CUI",42
46,"46248",4886,3672,3613,25,59,"UIG-SOM-CUI",6
46,"46003",953,828,811,5,17,"UIG-SOM-CUI",5
46,"46110",21317,15839,15699,89,140,"UIG-SOM-CUI",46
46,"46137",242,200,200,3,0,"UIG-SOM-CUI",2
46,"46260",2647,2136,2113,8,23,"UIG-SOM-CUI",9
46,"46036",558,391,379,2,12,"UIG-SOM-CUI",1
46,"46235",21270,15754,15592,101,162,"UIG-SOM-CUI",36
46,"46006",4468,3731,3683,22,48,"UIG-SOM-CUI",5
46,"46043",135,119,116,1,3,"UIG-SOM-CUI",0
46,"46158",1040,805,796,4,9,"UIG-SOM-CUI",2
46,"46186",19529,15294,15125,69,169,"UIG-SOM-CUI",38
46,"46105",16132,11703,11582,64,121,"UIG-SOM-CUI",25
46,"46061",343,285,280,4,5,"UIG-SOM-CUI",0
46,"46067",1744,1451,1432,4,19,"UIG-SOM-CUI",2
46,"46112",542,460,454,0,6,"UIG-SOM-CUI",1
46,"46135",9827,7928,7883,44,45,"UIG-SOM-CUI",22
46,"46081",9993,7972,7882,51,90,"UIG-SOM-CUI",33
46,"46236",937,764,755,5,9,"UIG-SOM-CUI",3
46,"46223",7781,6057,5995,42,62,"UIG-SOM-CUI",28
46,"46071",470,382,366,0,16,"UIG-SOM-CUI",0
46,"46125",846,681,675,1,6,"UIG-SOM-CUI",0
46,"46206",557,461,455,6,6,"UIG-SOM-CUI",1
46,"46258",2636,2100,2079,9,21,"UIG-SOM-CUI",3
46,"46151",757,586,579,0,7,"UIG-SOM-CUI",2
46,"46194",15813,11654,11511,83,143,"UIG-SOM-CUI",40
46,"46249",9159,7113,7012,73,101,"UIG-SOM-CUI",2
46,"46156",2024,1642,1628,7,14,"UIG-SOM-CUI",7
46,"46185",364,315,310,1,5,"UIG-SOM-CUI",0
46,"46166",8202,6482,6399,39,83,"UIG-SOM-CUI",32
46,"46138",360,305,303,2,2,"UIG-SOM-CUI",3
46,"46119",752,627,614,8,13,"UIG-SOM-CUI",3
46,"46227",888,708,693,6,15,"UIG-SOM-CUI",0
46,"46116",13608,10792,10731,76,61,"UIG-SOM-CUI",15
46,"46025",2455,2002,1981,6,21,"UIG-SOM-CUI",19
46,"46259",462,395,394,2,1,"UIG-SOM-CUI",1
46,"46123",1948,1469,1446,5,23,"UIG-SOM-CUI",5
46,"46233",3781,2901,2847,22,54,"UIG-SOM-CUI",52
46,"46016",1075,887,880,8,7,"UIG-SOM-CUI",1
46,"46143",4230,3255,3200,20,55,"UIG-SOM-CUI",8
46,"46148",1509,1208,1195,7,13,"UIG-SOM-CUI",2
46,"46048",3509,2758,2720,11,38,"UIG-SOM-CUI",4
46,"46239",453,372,366,2,6,"UIG-SOM-CUI",0
46,"46149",344,260,256,2,4,"UIG-SOM-CUI",0
46,"46228",2417,1953,1913,13,40,"UIG-SOM-CUI",9
46,"46218",1031,907,885,6,22,"UIG-SOM-CUI",5
46,"46178",4943,3684,3641,21,43,"UIG-SOM-CUI",9
46,"46070",17700,13558,13437,115,121,"UIG-SOM-CUI",26
46,"46215",1397,1104,1093,12,11,"UIG-SOM-CUI",1
46,"46141",437,367,360,5,7,"UIG-SOM-CUI",0
46,"46126",5574,4565,4528,25,37,"UIG-SOM-CUI",11
46,"46220",48968,35430,34964,306,466,"UIG-SOM-CUI",39
46,"46222",394,325,324,1,1,"UIG-SOM-CUI",0
46,"46242",330,279,279,0,0,"UIG-SOM-CUI",1
46,"46189",473,412,408,2,4,"UIG-SOM-CUI",0
46,"46064",525,427,424,4,3,"UIG-SOM-CUI",0
46,"46091",115,99,99,0,0,"UIG-SOM-CUI",0
46,"46234",327,264,263,5,1,"UIG-SOM-CUI",0
46,"46054",11390,8717,8604,52,113,"UIG-SOM-CUI",25
46,"46124",785,680,675,5,5,"UIG-SOM-CUI",1
46,"46063",1783,1368,1345,9,23,"UIG-SOM-CUI",1
46,"46132",2196,1877,1853,10,24,"UIG-SOM-CUI",3
46,"46053",537,459,457,2,2,"UIG-SOM-CUI",0
46,"46237",7148,5537,5472,36,65,"UIG-SOM-CUI",33
46,"46162",1177,954,938,4,16,"UIG-SOM-CUI",1
46,"46224",154,124,124,2,0,"UIG-SOM-CUI",0
46,"46056",175,156,156,3,0,"UIG-SOM-CUI",0
46,"46079",313,252,248,1,4,"UIG-SOM-CUI",0
46,"46153",435,364,356,1,8,"UIG-SOM-CUI",0
46,"46134",2380,1836,1825,5,11,"UIG-SOM-CUI",3
46,"46207",6686,5220,5137,36,83,"UIG-SOM-CUI",9
46,"46136",2619,2030,2003,24,27,"UIG-SOM-CUI",3
46,"46250",581614,454786,451184,2675,3602,"UIG-SOM-CUI",1540
46,"46200",1848,1560,1539,6,21,"UIG-SOM-CUI",2
46,"46157",2960,2329,2296,12,33,"UIG-SOM-CUI",2
46,"46027",932,769,755,1,14,"UIG-SOM-CUI",2
46,"46020",3792,3028,2973,11,55,"UIG-SOM-CUI",14
46,"46154",797,645,630,1,15,"UIG-SOM-CUI",8
46,"46046",884,654,643,3,11,"UIG-SOM-CUI",2
46,"46127",2740,2174,2147,11,27,"UIG-SOM-CUI",1
46,"46244",59626,44018,43679,342,339,"UIG-SOM-CUI",183
46,"46055",1284,1031,1021,2,10,"UIG-SOM-CUI",1
47,"47164",350,290,286,2,4,"UNIÓN REGIO",0
47,"47207",260,213,211,2,2,"UNIÓN REGIO",1
47,"47086",3823,3090,3046,24,44,"UNIÓN REGIO",3
47,"47056",83,71,71,0,0,"UNIÓN REGIO",0
47,"47210",402,300,289,2,11,"UNIÓN REGIO",0
47,"47023",3057,2577,2557,21,20,"UNIÓN REGIO",1
47,"47184",541,447,441,0,6,"UNIÓN REGIO",0
47,"47188",99,77,77,0,0,"UNIÓN REGIO",0
47,"47167",242,212,210,0,2,"UNIÓN REGIO",0
47,"47073",116,91,89,0,2,"UNIÓN REGIO",0
47,"47165",6822,5456,5296,62,160,"UNIÓN REGIO",22
47,"47066",1407,1131,1122,11,9,"UNIÓN REGIO",0
47,"47093",797,628,615,6,13,"UNIÓN REGIO",0
47,"47114",3911,2864,2807,28,57,"UNIÓN REGIO",5
47,"47185",87,77,77,0,0,"UNIÓN REGIO",1
47,"47192",94,82,81,2,1,"UNIÓN REGIO",0
47,"47016",70,62,61,0,1,"UNIÓN REGIO",0
47,"47068",30,23,23,0,0,"UNIÓN REGIO",0
47,"47029",50,43,43,1,0,"UNIÓN REGIO",0
47,"47070",30,26,25,0,1,"UNIÓN REGIO",0
47,"47118",149,111,108,1,3,"UNIÓN REGIO",0
47,"47106",44,35,35,0,0,"UNIÓN REGIO",0
47,"47026",49,40,39,0,1,"UNIÓN REGIO",0
47,"47091",74,64,63,1,1,"UNIÓN REGIO",0
47,"47226",149,124,123,0,1,"UNIÓN REGIO",0
47,"47018",36,31,29,0,2,"UNIÓN REGIO",0
47,"47228",439,353,352,1,1,"UNIÓN REGIO",0
47,"47020",272,228,225,5,3,"UNIÓN REGIO",0
47,"47183",139,118,118,1,0,"UNIÓN REGIO",0
47,"47001",52,47,46,0,1,"UNIÓN REGIO",0
47,"47079",54,48,48,0,0,"UNIÓN REGIO",1
47,"47193",1609,1347,1332,9,15,"UNIÓN REGIO",3
47,"47187",75,54,53,0,1,"UNIÓN REGIO",1
47,"47030",941,759,740,3,19,"UNIÓN REGIO",1
47,"47065",817,658,653,2,5,"UNIÓN REGIO",0
47,"47037",163,134,128,2,6,"UNIÓN REGIO",0
47,"47092",102,86,85,0,1,"UNIÓN REGIO",0
47,"47178",166,144,143,4,1,"UNIÓN REGIO",2
47,"47147",102,85,85,0,0,"UNIÓN REGIO",0
47,"47038",101,79,79,0,0,"UNIÓN REGIO",2
47,"47031",196,155,155,3,0,"UNIÓN REGIO",0
47,"47010",14572,12316,12186,102,130,"UNIÓN REGIO",9
47,"47123",461,391,390,3,1,"UNIÓN REGIO",2
47,"47080",35,23,21,0,2,"UNIÓN REGIO",0
47,"47219",40,38,34,0,4,"UNIÓN REGIO",0
47,"47230",288,236,233,1,3,"UNIÓN REGIO",0
47,"47028",30,17,17,0,0,"UNIÓN REGIO",0
47,"47088",105,90,90,0,0,"UNIÓN REGIO",0
47,"47155",3410,2694,2660,21,34,"UNIÓN REGIO",4
47,"47141",118,103,102,0,1,"UNIÓN REGIO",0
47,"47134",148,127,126,6,1,"UNIÓN REGIO",0
47,"47101",1644,1354,1337,9,17,"UNIÓN REGIO",0
47,"47002",18,18,18,0,0,"UNIÓN REGIO",0
47,"47231",4458,3677,3651,47,26,"UNIÓN REGIO",5
47,"47032",153,121,121,1,0,"UNIÓN REGIO",1
47,"47063",89,71,71,0,0,"UNIÓN REGIO",2
47,"47117",286,240,235,0,5,"UNIÓN REGIO",0
47,"47175",6704,5296,5222,52,74,"UNIÓN REGIO",9
47,"47208",56,37,37,0,0,"UNIÓN REGIO",0
47,"47007",4036,3261,3217,25,44,"UNIÓN REGIO",9
47,"47171",384,315,311,5,4,"UNIÓN REGIO",1
47,"47170",43,34,32,0,2,"UNIÓN REGIO",0
47,"47013",90,80,78,4,2,"UNIÓN REGIO",0
47,"47131",165,127,127,3,0,"UNIÓN REGIO",0
47,"47105",175,152,149,1,3,"UNIÓN REGIO",0
47,"47139",1004,790,776,2,14,"UNIÓN REGIO",1
47,"47160",392,317,314,2,3,"UNIÓN REGIO",0
47,"47085",16381,12697,12540,129,157,"UNIÓN REGIO",21
47,"47033",204,167,167,2,0,"UNIÓN REGIO",0
47,"47057",273,204,200,0,4,"UNIÓN REGIO",0
47,"47157",495,428,426,3,2,"UNIÓN REGIO",0
47,"47006",186,153,149,1,4,"UNIÓN REGIO",0
47,"47163",280,238,232,2,6,"UNIÓN REGIO",0
47,"47156",150,128,128,2,0,"UNIÓN REGIO",1
47,"47099",155,135,133,0,2,"UNIÓN REGIO",0
47,"47198",66,47,47,0,0,"UNIÓN REGIO",0
47,"47027",2775,2246,2222,14,24,"UNIÓN REGIO",2
47,"47140",110,91,90,0,1,"UNIÓN REGIO",0
47,"47034",72,57,57,1,0,"UNIÓN REGIO",0
47,"47220",154,119,119,1,0,"UNIÓN REGIO",0
47,"47004",1136,950,939,5,11,"UNIÓN REGIO",0
47,"47224",97,74,74,0,0,"UNIÓN REGIO",0
47,"47137",31,23,23,0,0,"UNIÓN REGIO",0
47,"47011",557,478,476,5,2,"UNIÓN REGIO",0
47,"47168",30,29,29,0,0,"UNIÓN REGIO",0
47,"47232",100,76,76,1,0,"UNIÓN REGIO",0
47,"47109",171,130,130,1,0,"UNIÓN REGIO",0
47,"47045",734,601,590,5,11,"UNIÓN REGIO",2
47,"47062",157,134,134,0,0,"UNIÓN REGIO",2
47,"47059",97,75,75,0,0,"UNIÓN REGIO",0
47,"47127",138,92,89,1,3,"UNIÓN REGIO",1
47,"47052",6752,5665,5589,57,76,"UNIÓN REGIO",7
47,"47124",388,322,319,2,3,"UNIÓN REGIO",0
47,"47015",176,136,135,0,1,"UNIÓN REGIO",0
47,"47121",521,429,422,5,7,"UNIÓN REGIO",1
47,"47142",124,94,92,0,2,"UNIÓN REGIO",0
47,"47046",125,107,104,1,3,"UNIÓN REGIO",0
47,"47067",153,119,119,3,0,"UNIÓN REGIO",0
47,"47060",231,198,195,4,3,"UNIÓN REGIO",0
47,"47110",438,352,347,4,5,"UNIÓN REGIO",0
47,"47036",205,162,157,1,5,"UNIÓN REGIO",0
47,"47215",48,44,44,0,0,"UNIÓN REGIO",0
47,"47098",556,480,475,4,5,"UNIÓN REGIO",2
47,"47176",202,138,138,1,0,"UNIÓN REGIO",0
47,"47153",104,76,75,0,1,"UNIÓN REGIO",0
47,"47173",885,708,704,7,4,"UNIÓN REGIO",3
47,"47216",114,102,98,0,4,"UNIÓN REGIO",0
47,"47102",264,217,211,1,6,"UNIÓN REGIO",1
47,"47190",95,81,81,1,0,"UNIÓN REGIO",0
47,"47082",810,679,668,8,11,"UNIÓN REGIO",0
47,"47111",998,806,795,6,11,"UNIÓN REGIO",0
47,"47122",2016,1655,1617,15,38,"UNIÓN REGIO",0
47,"47154",146,122,118,2,4,"UNIÓN REGIO",0
47,"47017",198,162,160,1,2,"UNIÓN REGIO",1
47,"47044",323,282,279,1,3,"UNIÓN REGIO",1
47,"47161",3945,3370,3344,20,26,"UNIÓN REGIO",3
47,"47024",232,189,188,0,1,"UNIÓN REGIO",1
47,"47194",292,245,243,1,2,"UNIÓN REGIO",0
47,"47217",1973,1569,1541,19,28,"UNIÓN REGIO",0
47,"47133",2776,2317,2292,28,25,"UNIÓN REGIO",2
47,"47041",153,119,116,2,3,"UNIÓN REGIO",0
47,"47227",55,46,46,0,0,"UNIÓN REGIO",0
47,"47203",58,48,48,0,0,"UNIÓN REGIO",0
47,"47069",118,96,92,1,4,"UNIÓN REGIO",0
47,"47008",22,15,15,0,0,"UNIÓN REGIO",0
47,"47214",1364,1112,1074,7,38,"UNIÓN REGIO",0
47,"47195",430,335,320,2,15,"UNIÓN REGIO",1
47,"47025",114,98,98,0,0,"UNIÓN REGIO",0
47,"47042",50,41,39,0,2,"UNIÓN REGIO",0
47,"47196",28,24,24,0,0,"UNIÓN REGIO",0
47,"47218",979,757,745,5,12,"UNIÓN REGIO",0
47,"47090",2435,1956,1921,12,35,"UNIÓN REGIO",0
47,"47097",307,258,256,4,2,"UNIÓN REGIO",0
47,"47145",586,446,440,2,6,"UNIÓN REGIO",0
47,"47211",48,43,43,1,0,"UNIÓN REGIO",0
47,"47019",91,74,73,0,1,"UNIÓN REGIO",0
47,"47012",101,80,80,0,0,"UNIÓN REGIO",0
47,"47225",74,61,60,0,1,"UNIÓN REGIO",0
47,"47189",151,126,123,0,3,"UNIÓN REGIO",0
47,"47166",251,196,189,3,7,"UNIÓN REGIO",0
47,"47186",244448,197042,195276,1561,1766,"UNIÓN REGIO",283
47,"47049",91,66,64,0,2,"UNIÓN REGIO",0
47,"47125",51,46,45,0,1,"UNIÓN REGIO",0
47,"47050",3898,3084,3047,36,37,"UNIÓN REGIO",2
47,"47197",867,721,717,2,4,"UNIÓN REGIO",0
47,"47009",99,84,84,0,0,"UNIÓN REGIO",0
47,"47229",231,174,168,0,6,"UNIÓN REGIO",0
47,"47064",37,32,29,0,3,"UNIÓN REGIO",0
47,"47051",321,274,272,1,2,"UNIÓN REGIO",1
47,"47135",82,69,67,1,2,"UNIÓN REGIO",0
47,"47071",398,345,341,2,4,"UNIÓN REGIO",0
47,"47132",39,33,33,0,0,"UNIÓN REGIO",0
47,"47003",204,171,168,4,3,"UNIÓN REGIO",0
47,"47061",243,203,197,3,6,"UNIÓN REGIO",0
47,"47058",202,154,153,3,1,"UNIÓN REGIO",0
47,"47047",202,164,161,3,3,"UNIÓN REGIO",0
47,"47206",78,64,64,0,0,"UNIÓN REGIO",0
47,"47177",100,80,79,0,1,"UNIÓN REGIO",0
47,"47115",276,231,223,1,8,"UNIÓN REGIO",1
47,"47126",44,42,42,1,0,"UNIÓN REGIO",1
47,"47076",17721,14605,14438,134,167,"UNIÓN REGIO",20
47,"47035",902,715,707,5,8,"UNIÓN REGIO",0
47,"47074",141,122,122,2,0,"UNIÓN REGIO",0
47,"47083",83,66,65,1,1,"UNIÓN REGIO",0
47,"47130",99,76,76,2,0,"UNIÓN REGIO",1
47,"47021",72,63,63,0,0,"UNIÓN REGIO",0
47,"47158",858,672,663,8,9,"UNIÓN REGIO",0
47,"47221",100,84,83,1,1,"UNIÓN REGIO",0
47,"47172",135,119,119,0,0,"UNIÓN REGIO",0
47,"47148",423,342,339,2,3,"UNIÓN REGIO",2
47,"47103",255,215,214,3,1,"UNIÓN REGIO",0
47,"47169",61,53,53,0,0,"UNIÓN REGIO",0
47,"47179",373,275,273,1,2,"UNIÓN REGIO",0
47,"47199",71,59,59,3,0,"UNIÓN REGIO",0
47,"47048",175,148,148,0,0,"UNIÓN REGIO",0
47,"47054",613,501,498,0,3,"UNIÓN REGIO",0
47,"47149",45,39,39,1,0,"UNIÓN REGIO",0
47,"47128",56,49,46,0,3,"UNIÓN REGIO",0
47,"47152",68,59,59,0,0,"UNIÓN REGIO",0
47,"47043",309,276,273,1,3,"UNIÓN REGIO",0
47,"47081",41,36,36,0,0,"UNIÓN REGIO",0
47,"47222",86,71,71,0,0,"UNIÓN REGIO",0
47,"47159",831,703,693,0,10,"UNIÓN REGIO",1
47,"47138",219,182,177,1,5,"UNIÓN REGIO",1
47,"47078",159,135,131,0,4,"UNIÓN REGIO",0
47,"47075",4775,3849,3784,38,65,"UNIÓN REGIO",6
47,"47212",358,312,311,3,1,"UNIÓN REGIO",0
47,"47119",87,66,65,1,1,"UNIÓN REGIO",0
47,"47104",2836,2339,2267,23,72,"UNIÓN REGIO",2
47,"47200",71,62,62,0,0,"UNIÓN REGIO",0
47,"47223",152,123,120,2,3,"UNIÓN REGIO",0
47,"47089",132,116,115,1,1,"UNIÓN REGIO",0
47,"47014",47,43,43,1,0,"UNIÓN REGIO",0
47,"47129",855,715,696,3,19,"UNIÓN REGIO",12
47,"47040",61,45,44,0,1,"UNIÓN REGIO",0
47,"47181",165,143,143,0,0,"UNIÓN REGIO",0
47,"47084",1101,880,871,7,9,"UNIÓN REGIO",0
47,"47096",126,106,105,0,1,"UNIÓN REGIO",0
47,"47191",115,85,84,0,1,"UNIÓN REGIO",1
47,"47150",259,206,202,0,4,"UNIÓN REGIO",0
47,"47144",75,63,63,1,0,"UNIÓN REGIO",0
47,"47053",126,100,97,0,3,"UNIÓN REGIO",1
47,"47077",237,187,183,2,4,"UNIÓN REGIO",1
47,"47204",235,182,178,0,4,"UNIÓN REGIO",1
47,"47005",502,420,414,2,6,"UNIÓN REGIO",3
47,"47174",270,215,208,2,7,"UNIÓN REGIO",0
47,"47162",68,55,55,0,0,"UNIÓN REGIO",0
47,"47087",368,292,288,3,4,"UNIÓN REGIO",0
47,"47146",278,232,230,3,2,"UNIÓN REGIO",0
47,"47116",403,321,320,3,1,"UNIÓN REGIO",1
47,"47151",28,22,22,0,0,"UNIÓN REGIO",0
47,"47182",1335,1034,1022,6,12,"UNIÓN REGIO",2
47,"47095",41,36,34,2,2,"UNIÓN REGIO",0
47,"47205",355,263,258,3,5,"UNIÓN REGIO",1
47,"47180",57,46,46,1,0,"UNIÓN REGIO",0
47,"47022",59,56,54,1,2,"UNIÓN REGIO",0
47,"47039",166,134,134,0,0,"UNIÓN REGIO",0
47,"47213",108,84,84,0,0,"UNIÓN REGIO",0
47,"47100",119,104,102,2,2,"UNIÓN REGIO",0
47,"47113",142,117,117,1,0,"UNIÓN REGIO",0
47,"47143",110,78,78,1,0,"UNIÓN REGIO",0
47,"47055",192,157,154,1,3,"UNIÓN REGIO",0
47,"47209",34,25,25,0,0,"UNIÓN REGIO",0
47,"47094",123,110,109,1,1,"UNIÓN REGIO",0
47,"47112",2570,2098,2075,13,23,"UNIÓN REGIO",1
32,"32047",1746,1272,1252,6,20,"VOU",2
32,"32002",2022,1510,1485,8,25,"VOU",4
32,"32076",1974,1492,1472,17,20,"VOU",2
32,"32026",2659,1988,1957,26,31,"VOU",7
32,"32030",944,690,685,7,5,"VOU",0
32,"32068",1419,998,987,4,11,"VOU",1
32,"32048",864,550,544,1,6,"VOU",0
32,"32079",1287,1016,1006,6,10,"VOU",3
32,"32039",1142,895,890,7,5,"VOU",0
32,"32013",2017,1388,1380,5,8,"VOU",2
32,"32069",4256,3358,3309,39,49,"VOU",3
32,"32088",1610,1040,1019,11,21,"VOU",2
32,"32045",2360,1712,1689,18,23,"VOU",0
32,"32010",360,276,273,3,3,"VOU",1
32,"32082",1178,880,872,12,8,"VOU",0
32,"32051",1407,1158,1153,12,5,"VOU",0
32,"32071",1378,963,954,7,9,"VOU",0
32,"32060",765,577,567,2,10,"VOU",0
32,"32028",1550,1176,1171,10,5,"VOU",1
32,"32078",1108,794,781,15,13,"VOU",0
32,"32008",8572,6301,6216,65,85,"VOU",7
32,"32037",681,534,523,6,11,"VOU",2
32,"32070",512,307,304,8,3,"VOU",0
32,"32023",1132,867,862,7,5,"VOU",1
32,"32063",1819,1313,1287,6,26,"VOU",0
32,"32084",902,636,631,2,5,"VOU",0
32,"32017",1202,821,815,6,6,"VOU",1
32,"32003",889,667,654,3,13,"VOU",1
32,"32042",1505,1097,1091,12,6,"VOU",1
32,"32004",1671,907,899,7,8,"VOU",2
32,"32007",1412,1011,1001,9,10,"VOU",1
32,"32036",1261,954,938,9,16,"VOU",2
32,"32075",4382,3546,3489,35,57,"VOU",4
32,"32052",1819,1399,1379,15,20,"VOU",1
32,"32024",4835,3484,3439,23,45,"VOU",9
32,"32034",1074,855,846,1,9,"VOU",2
32,"32033",676,480,468,4,12,"VOU",1
32,"32031",1014,764,756,5,8,"VOU",0
32,"32077",1104,820,815,10,5,"VOU",0
32,"32086",2563,1699,1686,19,13,"VOU",0
32,"32061",1070,862,855,8,7,"VOU",1
32,"32041",759,510,502,2,8,"VOU",1
32,"32064",480,348,346,2,2,"VOU",0
32,"32092",482,337,334,2,3,"VOU",1
32,"32044",809,625,617,2,8,"VOU",2
32,"32005",827,628,622,4,6,"VOU",1
32,"32011",918,526,521,6,5,"VOU",0
32,"32022",1238,924,916,5,8,"VOU",0
32,"32046",1098,793,782,5,11,"VOU",0
32,"32015",830,543,541,4,2,"VOU",0
32,"32058",5225,3915,3857,35,58,"VOU",7
32,"32065",630,478,474,5,4,"VOU",2
32,"32087",1675,1313,1288,18,25,"VOU",2
32,"32027",1000,762,747,5,15,"VOU",0
32,"32025",1013,773,761,7,12,"VOU",1
32,"32006",1434,1033,1019,8,14,"VOU",2
32,"32073",1281,941,932,9,9,"VOU",1
32,"32019",11512,8281,8161,96,120,"VOU",8
32,"32062",766,582,579,1,3,"VOU",6
32,"32001",5105,3760,3715,37,45,"VOU",2
32,"32032",7932,5956,5831,55,125,"VOU",6
32,"32081",2035,1592,1565,14,27,"VOU",1
32,"32009",10590,7661,7574,68,87,"VOU",14
32,"32089",1220,872,857,15,15,"VOU",0
32,"32018",1179,950,936,3,14,"VOU",1
32,"32038",399,274,271,3,3,"VOU",1
32,"32040",1418,1083,1075,3,8,"VOU",0
32,"32035",1370,881,872,5,9,"VOU",0
32,"32050",2280,1788,1775,19,13,"VOU",1
32,"32057",514,367,365,5,2,"VOU",0
32,"32085",10634,7655,7551,66,104,"VOU",4
32,"32054",86475,64472,63712,676,760,"VOU",159
32,"32012",716,497,487,7,10,"VOU",2
32,"32066",551,399,396,1,3,"VOU",0
32,"32091",1703,1312,1306,4,6,"VOU",0
32,"32080",286,223,220,1,3,"VOU",0
32,"32056",1520,1125,1116,6,9,"VOU",0
32,"32016",724,543,535,3,8,"VOU",0
32,"32059",1703,1248,1228,12,20,"VOU",1
32,"32074",993,737,734,4,3,"VOU",0
32,"32014",1045,775,769,5,6,"VOU",0
32,"32067",1193,827,818,10,9,"VOU",1
32,"32021",874,616,615,4,1,"VOU",0
32,"32072",3687,2715,2682,22,33,"VOU",6
32,"32090",738,530,525,3,5,"VOU",1
32,"32049",689,468,462,3,6,"VOU",1
32,"32055",1230,908,889,5,19,"VOU",1
32,"32083",821,592,587,7,5,"VOU",0
32,"32043",2512,1805,1789,16,16,"VOU",2
32,"32029",436,340,337,1,3,"VOU",0
32,"32053",1363,1114,1098,14,16,"VOU",1
32,"32020",2460,1899,1876,6,23,"VOU",0
8,"8134",842,649,646,3,3,"VOX",11
31,"31001",80,63,63,0,0,"VOX",0
34,"34024",25,17,16,1,1,"VOX",3
3,"3015",12807,9782,9634,63,148,"VOX",1556
13,"13087",23207,17321,17032,202,289,"VOX",2173
12,"12084",17723,13501,13281,118,220,"VOX",1497
42,"42028",76,65,65,1,0,"VOX",8
24,"24214",634,473,471,3,2,"VOX",36
4,"4032",5698,4168,4138,20,30,"VOX",682
42,"42153",12,10,10,1,0,"VOX",0
47,"47138",219,182,177,1,5,"VOX",27
1,"1047",967,686,673,8,13,"VOX",54
9,"9112",104,76,76,1,0,"VOX",5
22,"22162",129,99,99,0,0,"VOX",15
9,"9012",92,76,75,0,1,"VOX",9
2,"2062",386,287,285,4,2,"VOX",47
37,"37028",137,111,107,1,4,"VOX",8
30,"30901",10529,8488,8375,37,113,"VOX",1396
42,"42019",511,384,378,7,6,"VOX",34
2,"2027",283,239,238,3,1,"VOX",36
37,"37311",207,164,162,4,2,"VOX",17
24,"24042",61,47,47,1,0,"VOX",5
50,"50150",621,451,450,2,1,"VOX",53
29,"29038",18683,12820,12666,168,154,"VOX",1912
4,"4062",4460,3466,3425,12,41,"VOX",344
29,"29083",2062,1607,1574,9,33,"VOX",128
8,"8151",448,378,377,2,1,"VOX",0
46,"46189",473,412,408,2,4,"VOX",33
46,"46188",693,591,585,3,6,"VOX",50
19,"19076",19,18,18,0,0,"VOX",4
22,"22047",241,213,212,2,1,"VOX",27
43,"43107",383,308,308,1,0,"VOX",1
37,"37260",139,109,109,0,0,"VOX",20
12,"12040",118683,91285,90499,666,786,"VOX",10735
47,"47058",202,154,153,3,1,"VOX",29
37,"37236",127,90,86,0,4,"VOX",13
19,"19239",91,64,63,1,1,"VOX",15
25,"25206",250,189,188,2,1,"VOX",2
29,"29054",42393,30327,30108,218,219,"VOX",4780
6,"6072",2225,1777,1752,20,25,"VOX",229
31,"31157",3470,2507,2473,32,34,"VOX",147
50,"50138",47,42,42,1,0,"VOX",5
9,"9355",87,69,67,1,2,"VOX",4
36,"36901",4152,3400,3338,15,62,"VOX",140
31,"31201",151084,115375,114510,1072,865,"VOX",4857
39,"39100",849,650,644,9,6,"VOX",55
25,"25203",8798,6279,6231,26,48,"VOX",173
22,"22028",362,284,282,5,2,"VOX",22
16,"16258",172,128,128,2,0,"VOX",20
37,"37353",122,95,95,1,0,"VOX",13
19,"19145",41,38,38,0,0,"VOX",2
44,"44036",23,20,20,0,0,"VOX",3
16,"16007",1159,975,968,10,7,"VOX",114
43,"43033",768,609,607,3,2,"VOX",25
28,"28167",8608,7086,7015,48,71,"VOX",996
43,"43117",143,114,113,0,1,"VOX",0
17,"17154",99,84,83,0,1,"VOX",0
3,"3069",3311,2356,2327,12,29,"VOX",336
25,"25101",543,454,449,1,5,"VOX",10
33,"33060",14132,9960,9794,135,166,"VOX",585
6,"6157",397,296,292,1,4,"VOX",48
18,"18086",339,291,289,0,2,"VOX",13
19,"19307",26,23,23,0,0,"VOX",8
17,"17188",169,139,138,1,1,"VOX",1
37,"37348",100,79,79,0,0,"VOX",20
3,"3901",1109,827,820,5,7,"VOX",68
9,"9098",477,372,360,4,12,"VOX",31
14,"14058",7859,5854,5745,51,109,"VOX",613
37,"37041",73,55,55,0,0,"VOX",16
42,"42024",86,66,66,3,0,"VOX",8
50,"50076",75,64,63,0,1,"VOX",9
25,"25105",103,89,88,1,1,"VOX",3
28,"28182",198,169,169,1,0,"VOX",34
33,"33075",253,139,135,1,4,"VOX",8
37,"37006",117,81,81,2,0,"VOX",13
39,"39058",800,574,573,1,1,"VOX",29
50,"50241",595,434,423,3,11,"VOX",52
31,"31034",31,27,26,0,1,"VOX",0
24,"24091",585,433,423,1,10,"VOX",49
31,"31005",281,202,201,5,1,"VOX",9
8,"8067",5728,4535,4513,21,22,"VOX",69
50,"50048",33,25,25,0,0,"VOX",0
37,"37121",556,448,444,3,4,"VOX",60
19,"19229",57,52,52,0,0,"VOX",10
48,"48912",2331,1843,1833,7,10,"VOX",36
25,"25250",330,261,258,1,3,"VOX",6
21,"21055",7218,5328,5215,41,113,"VOX",778
8,"8122",1716,1260,1254,8,6,"VOX",38
50,"50079",227,182,178,1,4,"VOX",16
16,"16276",21,18,18,1,0,"VOX",2
22,"22225",2610,1867,1843,15,24,"VOX",188
42,"42078",1005,769,756,6,13,"VOX",64
37,"37167",177,159,158,3,1,"VOX",8
50,"50231",257,210,207,3,3,"VOX",20
43,"43020",2276,1831,1819,12,12,"VOX",82
9,"9406",246,203,200,4,3,"VOX",31
50,"50087",29,18,18,0,0,"VOX",2
18,"18145",10869,8532,8405,69,127,"VOX",1471
13,"13082",25882,17928,17721,101,207,"VOX",3420
2,"2067",1129,866,852,4,14,"VOX",90
25,"25114",95,79,79,0,0,"VOX",0
18,"18050",1670,1231,1213,9,18,"VOX",194
16,"16047",214,175,174,4,1,"VOX",32
24,"24179",299,239,238,3,1,"VOX",22
25,"25212",224,195,195,2,0,"VOX",1
17,"17139",1394,1163,1154,3,9,"VOX",12
47,"47217",1973,1569,1541,19,28,"VOX",292
37,"37015",205,131,130,2,1,"VOX",28
8,"8024",357,301,298,1,3,"VOX",0
6,"6034",167,115,115,1,0,"VOX",15
2,"2064",374,318,315,3,3,"VOX",26
19,"19191",13,12,12,0,0,"VOX",0
19,"19259",28,24,24,0,0,"VOX",0
15,"15005",25263,17634,17347,257,287,"VOX",1094
2,"2085",309,264,263,4,1,"VOX",29
42,"42042",49,42,42,1,0,"VOX",9
50,"50085",183,136,136,1,0,"VOX",17
28,"28061",22564,18245,18064,117,181,"VOX",3329
18,"18020",501,365,358,2,7,"VOX",75
42,"42158",94,78,78,0,0,"VOX",2
25,"25209",1550,1192,1172,4,20,"VOX",13
34,"34086",99,92,90,2,2,"VOX",18
12,"12053",2030,1656,1636,10,20,"VOX",157
10,"10008",1291,1015,997,16,18,"VOX",94
4,"4080",199,158,157,0,1,"VOX",19
24,"24019",341,279,272,0,7,"VOX",10
9,"9456",137,104,104,0,0,"VOX",11
50,"50225",1532,1072,1064,10,8,"VOX",208
2,"2001",695,567,559,3,8,"VOX",84
6,"6134",530,337,331,3,6,"VOX",15
46,"46103",1338,1056,1042,5,14,"VOX",109
24,"24119",695,515,501,8,14,"VOX",37
25,"25183",535,419,416,4,3,"VOX",6
43,"43168",84,65,65,1,0,"VOX",0
31,"31082",623,433,433,3,0,"VOX",9
1,"1057",243,202,199,0,3,"VOX",8
9,"9253",106,88,85,2,3,"VOX",10
12,"12141",92,81,81,0,0,"VOX",14
6,"6131",1063,880,874,5,6,"VOX",73
2,"2071",1058,912,906,2,6,"VOX",141
45,"45062",1074,888,867,4,21,"VOX",157
19,"19288",22,21,21,1,0,"VOX",5
2,"2043",1173,975,962,1,13,"VOX",162
50,"50045",1198,957,951,3,6,"VOX",106
5,"5062",166,136,133,0,3,"VOX",30
18,"18036",3970,3197,3149,26,48,"VOX",500
50,"50056",405,332,330,4,2,"VOX",52
8,"8041",10692,7805,7732,48,73,"VOX",410
28,"28160",8629,6922,6856,34,66,"VOX",1338
25,"25102",661,517,511,8,6,"VOX",12
19,"19333",105,74,73,1,1,"VOX",4
4,"4031",2249,1778,1773,2,5,"VOX",152
50,"50075",72,59,59,1,0,"VOX",4
38,"38043",19265,14000,13856,115,144,"VOX",748
31,"31241",125,100,100,2,0,"VOX",4
37,"37354",5467,3960,3910,31,50,"VOX",624
19,"19057",72,59,58,0,1,"VOX",3
30,"30020",6431,4991,4940,19,51,"VOX",1101
24,"24228",626,432,426,3,6,"VOX",47
2,"2069",11414,9019,8883,54,136,"VOX",1501
8,"8188",115,95,95,0,0,"VOX",1
3,"3118",2426,1741,1718,8,23,"VOX",296
16,"16224",77,61,60,1,1,"VOX",11
25,"25078",1001,807,805,5,2,"VOX",13
9,"9423",28,26,26,0,0,"VOX",3
4,"4084",341,258,255,0,3,"VOX",19
20,"20013",5430,4144,4119,19,25,"VOX",29
38,"38011",21563,15380,15214,69,166,"VOX",1096
18,"18107",924,694,680,3,14,"VOX",73
31,"31225",35,29,29,1,0,"VOX",1
37,"37234",317,224,222,1,2,"VOX",31
43,"43103",905,746,740,8,6,"VOX",40
15,"15014",3836,2739,2698,38,41,"VOX",124
50,"50176",222,161,156,3,5,"VOX",19
24,"24031",210,180,176,0,4,"VOX",11
46,"46127",2740,2174,2147,11,27,"VOX",156
8,"8216",25,19,19,0,0,"VOX",0
19,"19224",102,91,90,1,1,"VOX",20
8,"8125",25485,19719,19627,101,92,"VOX",807
49,"49148",264,146,136,1,10,"VOX",23
1,"1031",1163,948,928,6,20,"VOX",45
18,"18179",503,346,343,3,3,"VOX",33
3,"3034",1391,1107,1090,7,17,"VOX",97
29,"29016",263,217,217,0,0,"VOX",23
31,"31054",454,322,318,4,4,"VOX",2
5,"5017",86,74,73,0,1,"VOX",6
6,"6054",5454,4329,4190,46,139,"VOX",373
50,"50068",1947,1402,1389,11,13,"VOX",193
34,"34093",81,70,70,0,0,"VOX",13
24,"24004",494,408,403,7,5,"VOX",44
12,"12114",194,161,160,2,1,"VOX",23
22,"22139",78,60,60,0,0,"VOX",5
19,"19274",950,753,741,7,12,"VOX",132
46,"46152",87,69,69,0,0,"VOX",12
37,"37009",196,142,141,1,1,"VOX",16
18,"18150",6903,5149,5063,42,86,"VOX",652
25,"25182",1043,842,839,9,3,"VOX",27
31,"31264",177,107,105,2,2,"VOX",4
44,"44184",38,28,26,0,2,"VOX",3
43,"43173",99,80,78,0,2,"VOX",0
1,"1003",1179,908,903,6,5,"VOX",6
29,"29059",2643,2086,2042,8,44,"VOX",107
24,"24076",1286,998,981,8,17,"VOX",139
19,"19277",16,13,13,0,0,"VOX",2
4,"4088",2435,1708,1693,6,15,"VOX",301
37,"37154",129,106,102,3,4,"VOX",13
29,"29093",2164,1704,1678,4,26,"VOX",158
44,"44207",130,101,101,1,0,"VOX",4
43,"43127",759,630,626,3,4,"VOX",10
8,"8222",1819,1484,1476,11,8,"VOX",39
24,"24028",365,297,290,2,7,"VOX",26
45,"45071",1802,1488,1465,0,23,"VOX",107
9,"9159",61,52,51,0,1,"VOX",14
38,"38048",3957,2889,2842,12,47,"VOX",135
50,"50147",751,564,559,3,5,"VOX",49
3,"3081",1494,1163,1141,5,22,"VOX",92
15,"15045",3629,2263,2237,9,26,"VOX",87
4,"4074",2887,2062,2038,16,24,"VOX",380
45,"45082",1143,976,967,7,9,"VOX",115
40,"40228",494,397,391,5,6,"VOX",24
31,"31104",1751,1306,1280,1,26,"VOX",28
29,"29902",2592,1841,1817,18,24,"VOX",126
46,"46185",364,315,310,1,5,"VOX",10
24,"24078",336,259,255,0,4,"VOX",21
2,"2059",313,252,250,3,2,"VOX",38
14,"14014",2509,2071,2030,7,41,"VOX",119
31,"31190",45,41,41,4,0,"VOX",3
15,"15008",5631,4320,4267,64,53,"VOX",332
47,"47084",1101,880,871,7,9,"VOX",90
20,"20015",1237,975,967,8,8,"VOX",0
8,"8298",26980,20900,20817,91,83,"VOX",333
20,"20005",1267,884,882,2,2,"VOX",8
37,"37025",244,209,206,0,3,"VOX",33
9,"9007",55,37,37,0,0,"VOX",2
9,"9135",40,34,34,0,0,"VOX",7
50,"50168",27,20,20,0,0,"VOX",2
8,"8296",1843,1520,1514,10,6,"VOX",55
42,"42131",52,37,37,0,0,"VOX",0
18,"18030",567,448,442,4,6,"VOX",65
50,"50175",924,713,710,9,3,"VOX",54
47,"47088",105,90,90,0,0,"VOX",12
37,"37030",81,68,65,0,3,"VOX",6
6,"6041",457,381,374,5,7,"VOX",29
50,"50190",675,565,553,5,12,"VOX",38
8,"8299",377,318,317,0,1,"VOX",5
20,"20033",854,675,671,5,4,"VOX",6
47,"47157",495,428,426,3,2,"VOX",73
1,"1041",152,107,103,2,4,"VOX",6
37,"37014",1153,414,411,4,3,"VOX",55
4,"4077",302,275,275,1,0,"VOX",18
24,"24207",278,242,235,0,7,"VOX",30
46,"46191",1949,1541,1505,7,36,"VOX",192
9,"9224",159,135,132,0,3,"VOX",18
44,"44210",743,600,594,8,6,"VOX",50
28,"28143",77,62,62,0,0,"VOX",7
50,"50044",222,161,161,3,0,"VOX",24
8,"8099",753,565,561,2,4,"VOX",9
43,"43122",111,98,97,0,1,"VOX",1
25,"25098",232,172,170,2,2,"VOX",0
30,"30028",6400,4364,4289,30,75,"VOX",444
34,"34204",52,41,41,1,0,"VOX",7
44,"44218",31,25,25,2,0,"VOX",1
31,"31099",49,43,43,0,0,"VOX",3
15,"15036",56248,40194,39764,508,430,"VOX",2628
6,"6025",5096,3981,3904,28,77,"VOX",288
26,"26046",1571,1185,1157,18,28,"VOX",72
37,"37016",574,464,455,3,9,"VOX",48
25,"25145",76,66,66,1,0,"VOX",0
19,"19254",43,36,36,0,0,"VOX",5
37,"37070",528,422,417,2,5,"VOX",78
39,"39002",3414,2630,2578,23,52,"VOX",244
37,"37114",78,64,59,0,5,"VOX",8
1,"1061",152,129,129,2,0,"VOX",2
39,"39040",4267,3428,3385,24,43,"VOX",470
18,"18056",3418,2523,2478,22,45,"VOX",250
3,"3005",7903,6247,6195,37,52,"VOX",1385
3,"3090",17881,13593,13437,108,156,"VOX",1753
8,"8293",228,187,187,1,0,"VOX",1
37,"37229",139,110,106,2,4,"VOX",28
9,"9013",44,37,37,0,0,"VOX",3
14,"14032",393,328,321,2,7,"VOX",19
37,"37018",110,86,85,1,1,"VOX",20
50,"50072",195,164,161,3,3,"VOX",39
19,"19213",70,53,52,0,1,"VOX",7
29,"29025",41515,29572,29311,221,261,"VOX",4447
37,"37378",99,69,67,2,2,"VOX",6
42,"42017",131,104,104,2,0,"VOX",12
16,"16271",595,513,511,2,2,"VOX",63
43,"43903",2333,1717,1700,11,17,"VOX",29
38,"38027",5545,3937,3896,22,41,"VOX",161
3,"3009",46121,36093,35720,235,373,"VOX",3472
6,"6001",659,539,534,7,5,"VOX",68
33,"33040",4566,3205,3150,50,55,"VOX",350
18,"18136",1782,1382,1359,12,23,"VOX",66
24,"24150",224,176,174,2,2,"VOX",15
37,"37254",175,141,140,1,1,"VOX",25
9,"9077",30,22,22,0,0,"VOX",4
46,"46120",1183,958,936,3,22,"VOX",96
34,"34133",105,88,86,1,2,"VOX",18
24,"24174",469,360,354,5,6,"VOX",35
9,"9073",963,799,787,7,12,"VOX",106
48,"48006",309,265,265,0,0,"VOX",1
34,"34068",29,24,23,0,1,"VOX",4
22,"22165",452,360,356,1,4,"VOX",24
1,"1037",585,426,425,1,1,"VOX",2
37,"37155",68,52,52,0,0,"VOX",1
24,"24163",4073,3269,3231,36,38,"VOX",522
33,"33078",126,87,85,0,2,"VOX",8
5,"5904",112,81,81,3,0,"VOX",11
42,"42120",132,89,87,0,2,"VOX",5
12,"12085",5079,3504,3459,13,45,"VOX",521
10,"10060",935,670,658,4,12,"VOX",99
2,"2011",578,461,459,2,2,"VOX",58
19,"19074",65,60,60,0,0,"VOX",5
9,"9463",250,203,201,6,2,"VOX",21
37,"37061",207,160,160,0,0,"VOX",17
50,"50253",382,318,315,2,3,"VOX",25
1,"1039",195,157,153,0,4,"VOX",1
47,"47010",14572,12316,12186,102,130,"VOX",2260
28,"28031",2140,1642,1614,11,28,"VOX",286
25,"25207",6430,4899,4867,41,32,"VOX",78
46,"46149",344,260,256,2,4,"VOX",42
44,"44189",48,36,36,0,0,"VOX",3
34,"34066",57,52,48,1,4,"VOX",11
5,"5039",48,47,47,0,0,"VOX",3
8,"8174",392,330,330,4,0,"VOX",21
19,"19218",45,34,34,1,0,"VOX",4
43,"43013",4392,3341,3321,14,20,"VOX",102
45,"45070",1406,1201,1188,4,13,"VOX",177
18,"18120",257,219,217,1,2,"VOX",11
44,"44038",98,83,80,0,3,"VOX",6
37,"37141",152,120,119,2,1,"VOX",3
5,"5065",459,393,382,1,11,"VOX",81
38,"38031",29154,22871,22598,143,273,"VOX",895
43,"43906",2103,1595,1587,14,8,"VOX",47
29,"29008",15183,10716,10555,93,161,"VOX",1977
27,"27001",2209,1290,1251,25,39,"VOX",100
9,"9410",2999,2175,2135,27,40,"VOX",159
3,"3020",95,84,84,2,0,"VOX",4
24,"24154",955,702,691,3,11,"VOX",81
28,"28150",3187,2640,2604,20,36,"VOX",562
42,"42148",9,9,9,0,0,"VOX",0
43,"43057",38,31,31,1,0,"VOX",0
24,"24082",860,690,678,12,12,"VOX",71
9,"9415",275,206,204,0,2,"VOX",19
39,"39008",13900,10895,10767,81,128,"VOX",1087
8,"8307",49310,38223,38022,162,201,"VOX",1104
42,"42092",62,42,41,1,1,"VOX",15
2,"2015",1433,1234,1214,7,20,"VOX",202
46,"46084",1503,1225,1195,1,30,"VOX",109
29,"29031",1559,1139,1113,13,26,"VOX",63
6,"6136",1510,1189,1160,7,29,"VOX",74
37,"37160",606,431,418,6,13,"VOX",38
37,"37001",172,133,133,0,0,"VOX",6
16,"16020",9,5,5,0,0,"VOX",0
6,"6147",338,262,258,2,4,"VOX",8
16,"16066",2298,1932,1885,17,47,"VOX",341
24,"24053",406,279,276,6,3,"VOX",42
10,"10003",540,388,386,4,2,"VOX",30
3,"3066",41802,31046,30696,285,350,"VOX",3321
18,"18158",8010,5524,5449,23,75,"VOX",526
12,"12096",744,588,580,7,8,"VOX",32
46,"46247",961,695,687,3,8,"VOX",69
3,"3012",1133,910,897,7,13,"VOX",117
30,"30017",11477,8952,8844,62,108,"VOX",1432
50,"50063",61,54,54,0,0,"VOX",2
37,"37054",238,200,196,3,4,"VOX",18
22,"22027",306,230,225,3,5,"VOX",36
1,"1046",631,464,461,0,3,"VOX",26
47,"47082",810,679,668,8,11,"VOX",118
8,"8124",37130,29069,28915,146,154,"VOX",1018
2,"2025",7355,5864,5693,30,171,"VOX",1028
46,"46177",4778,3767,3711,17,56,"VOX",376
29,"29034",467,374,373,1,1,"VOX",71
40,"40094",364,284,279,1,5,"VOX",46
13,"13005",23187,18379,18119,174,260,"VOX",2228
42,"42095",1857,1498,1473,21,25,"VOX",196
16,"16050",220,182,179,1,3,"VOX",30
42,"42053",21,15,15,0,0,"VOX",2
43,"43163",26013,18942,18796,89,146,"VOX",987
31,"31207",285,209,206,1,3,"VOX",4
50,"50167",215,181,179,1,2,"VOX",32
43,"43003",350,266,264,3,2,"VOX",12
24,"24193",365,286,285,0,1,"VOX",39
38,"38035",10384,6657,6596,50,61,"VOX",547
5,"5163",1705,1360,1345,4,15,"VOX",139
25,"25248",880,714,713,4,1,"VOX",6
15,"15011",15481,11249,11037,105,212,"VOX",569
22,"22133",108,85,83,1,2,"VOX",4
31,"31127",135,96,96,0,0,"VOX",5
2,"2068",324,274,273,0,1,"VOX",29
46,"46128",1581,1324,1287,2,37,"VOX",86
42,"42097",14,7,7,0,0,"VOX",1
43,"43902",2743,1996,1980,16,16,"VOX",58
47,"47078",159,135,131,0,4,"VOX",24
37,"37139",187,162,157,2,5,"VOX",12
37,"37193",365,277,276,3,1,"VOX",46
50,"50098",162,121,120,3,1,"VOX",13
42,"42046",46,35,33,2,2,"VOX",3
9,"9019",144,113,109,1,4,"VOX",8
47,"47030",941,759,740,3,19,"VOX",104
25,"25156",784,608,605,4,3,"VOX",8
2,"2032",265,208,203,3,5,"VOX",17
24,"24065",2175,1695,1660,18,35,"VOX",242
24,"24066",449,329,324,3,5,"VOX",42
38,"38037",12803,8628,8517,48,111,"VOX",413
50,"50057",1332,1001,986,10,15,"VOX",177
19,"19319",4583,3640,3585,24,55,"VOX",727
19,"19270",25,21,21,0,0,"VOX",4
47,"47216",114,102,98,0,4,"VOX",49
42,"42044",53,41,39,0,2,"VOX",1
9,"9072",320,259,258,1,1,"VOX",37
47,"47068",30,23,23,0,0,"VOX",4
29,"29015",32064,23769,23461,213,308,"VOX",2893
31,"31901",15510,12225,12133,114,92,"VOX",502
10,"10154",177,134,133,1,1,"VOX",7
37,"37279",726,570,562,6,8,"VOX",71
19,"19228",29,22,22,0,0,"VOX",0
19,"19136",12,12,12,0,0,"VOX",0
47,"47123",461,391,390,3,1,"VOX",36
10,"10018",1630,1149,1112,12,37,"VOX",108
29,"29001",4199,3380,3341,20,39,"VOX",124
8,"8901",240,203,201,1,2,"VOX",0
18,"18907",1774,1426,1415,10,11,"VOX",217
31,"31009",672,510,503,4,7,"VOX",6
2,"2022",344,252,252,1,0,"VOX",40
46,"46192",790,599,586,8,13,"VOX",69
46,"46212",1590,1209,1192,4,17,"VOX",106
14,"14041",3115,2449,2376,45,73,"VOX",123
46,"46202",17660,13782,13645,93,137,"VOX",2083
11,"11023",9372,7032,6950,94,82,"VOX",693
4,"4035",8433,6246,6196,33,50,"VOX",942
5,"5007",110,81,80,2,1,"VOX",10
50,"50290",358,272,266,6,6,"VOX",30
14,"14001",3443,2724,2675,24,49,"VOX",219
38,"38009",4299,3105,3069,16,36,"VOX",162
13,"13043",209,167,167,1,0,"VOX",15
28,"28148",88647,70218,69546,570,672,"VOX",8648
45,"45109",2786,2273,2206,9,67,"VOX",398
37,"37071",76,67,67,0,0,"VOX",12
46,"46237",7148,5537,5472,36,65,"VOX",616
46,"46112",542,460,454,0,6,"VOX",54
24,"24122",1319,983,969,3,14,"VOX",84
14,"14063",1000,767,757,4,10,"VOX",85
22,"22012",102,81,80,1,1,"VOX",13
10,"10035",1806,1320,1282,12,38,"VOX",61
31,"31174",107,70,70,0,0,"VOX",3
8,"8288",1676,1196,1182,6,14,"VOX",44
28,"28162",2771,2264,2243,6,21,"VOX",495
26,"26144",188,161,160,1,1,"VOX",17
15,"15016",4569,3171,3146,18,25,"VOX",156
36,"36031",562,455,450,2,5,"VOX",35
17,"17088",578,468,468,1,0,"VOX",4
31,"31161",345,286,279,4,7,"VOX",7
49,"49079",103,91,79,1,12,"VOX",7
24,"24191",108,89,89,0,0,"VOX",5
46,"46043",135,119,116,1,3,"VOX",15
3,"3050",19334,14377,14253,71,124,"VOX",1818
47,"47158",858,672,663,8,9,"VOX",85
6,"6145",899,744,723,1,21,"VOX",70
21,"21032",1801,1401,1378,8,23,"VOX",104
22,"22184",168,142,139,2,3,"VOX",18
9,"9048",1380,1070,1039,8,31,"VOX",90
29,"29060",671,511,506,1,5,"VOX",98
24,"24209",2609,1880,1857,13,23,"VOX",115
18,"18141",384,269,264,0,5,"VOX",43
9,"9054",89,69,68,1,1,"VOX",11
9,"9006",59,37,36,1,1,"VOX",7
28,"28901",868,653,639,6,14,"VOX",105
37,"37036",57,42,41,0,1,"VOX",4
18,"18904",743,555,545,1,10,"VOX",70
28,"28165",1910,1443,1430,11,13,"VOX",297
16,"16147",56,32,32,0,0,"VOX",7
47,"47159",831,703,693,0,10,"VOX",75
45,"45042",183,141,137,0,4,"VOX",18
34,"34130",198,165,161,2,4,"VOX",22
37,"37037",107,86,86,0,0,"VOX",14
44,"44007",152,120,117,0,3,"VOX",20
24,"24137",1052,815,803,14,12,"VOX",64
31,"31065",1859,1383,1366,16,17,"VOX",69
16,"16139",324,249,249,2,0,"VOX",33
47,"47170",43,34,32,0,2,"VOX",3
45,"45151",546,434,431,0,3,"VOX",36
9,"9023",1178,982,966,14,16,"VOX",128
44,"44232",368,284,273,2,11,"VOX",32
8,"8132",361,281,281,2,0,"VOX",0
24,"24196",1918,1446,1422,9,24,"VOX",89
1,"1058",1403,958,951,4,7,"VOX",10
49,"49002",58,49,43,0,6,"VOX",1
37,"37350",404,310,307,0,3,"VOX",32
18,"18144",803,650,640,2,10,"VOX",108
19,"19102",92,80,80,0,0,"VOX",14
8,"8265",1590,1339,1334,6,5,"VOX",18
2,"2030",2978,2357,2315,13,42,"VOX",277
48,"48012",2071,1685,1674,7,11,"VOX",11
25,"25189",2164,1591,1583,11,8,"VOX",25
18,"18154",975,701,699,3,2,"VOX",126
18,"18906",911,722,716,4,6,"VOX",123
37,"37137",99,65,65,0,0,"VOX",3
41,"41024",22737,15687,15398,167,289,"VOX",1725
4,"4082",277,198,196,1,2,"VOX",22
32,"32076",1974,1492,1472,17,20,"VOX",73
37,"37122",203,174,174,1,0,"VOX",24
45,"45138",1055,889,874,5,15,"VOX",126
45,"45047",2668,1922,1882,11,40,"VOX",443
9,"9059",136704,109424,108039,1134,1385,"VOX",12270
50,"50093",83,66,66,1,0,"VOX",8
15,"15053",7548,5364,5309,44,55,"VOX",194
16,"16065",372,306,305,2,1,"VOX",48
50,"50183",319,242,241,4,1,"VOX",41
31,"31222",58,38,38,3,0,"VOX",0
25,"25168",488,408,407,6,1,"VOX",16
14,"14007",15042,10970,10758,86,212,"VOX",1104
46,"46261",1709,1367,1340,14,27,"VOX",168
16,"16901",630,498,492,4,6,"VOX",67
42,"42055",165,124,122,2,2,"VOX",13
2,"2056",1643,1330,1308,4,22,"VOX",168
37,"37341",48,36,36,0,0,"VOX",7
9,"9352",107,86,86,2,0,"VOX",8
12,"12102",521,442,434,2,8,"VOX",42
37,"37119",95,78,77,0,1,"VOX",8
24,"24079",872,671,665,4,6,"VOX",112
43,"43026",765,614,613,3,1,"VOX",11
50,"50212",32,29,29,1,0,"VOX",6
9,"9061",148,129,129,0,0,"VOX",22
17,"17094",1068,772,766,1,6,"VOX",12
44,"44206",103,83,82,0,1,"VOX",12
1,"1034",150,111,111,2,0,"VOX",3
46,"46200",1848,1560,1539,6,21,"VOX",131
19,"19242",77,67,67,0,0,"VOX",15
8,"8242",222,180,180,0,0,"VOX",4
29,"29071",979,718,712,14,6,"VOX",67
47,"47099",155,135,133,0,2,"VOX",26
40,"40214",196,167,163,1,4,"VOX",22
26,"26140",239,199,194,1,5,"VOX",10
38,"38008",5658,4126,4056,19,70,"VOX",139
32,"32023",1132,867,862,7,5,"VOX",35
8,"8110",13592,10111,10058,50,53,"VOX",356
37,"37102",379,297,291,3,6,"VOX",42
27,"27008",1345,965,946,17,19,"VOX",34
46,"46110",21317,15839,15699,89,140,"VOX",1763
37,"37088",199,151,149,1,2,"VOX",19
22,"22106",20,15,15,0,0,"VOX",1
43,"43051",9092,6577,6502,26,75,"VOX",394
25,"25070",811,677,675,4,2,"VOX",3
47,"47228",439,353,352,1,1,"VOX",70
5,"5258",107,96,96,2,0,"VOX",12
29,"29072",3277,2628,2592,16,36,"VOX",228
39,"39080",3505,2735,2701,8,34,"VOX",264
26,"26180",223,182,177,3,5,"VOX",25
9,"9392",49,41,41,0,0,"VOX",1
50,"50107",988,837,828,11,9,"VOX",88
37,"37104",25,18,18,0,0,"VOX",1
8,"8111",215,200,199,4,1,"VOX",2
8,"8137",274,232,229,0,3,"VOX",3
50,"50128",27,24,24,0,0,"VOX",0
31,"31903",6862,4962,4915,31,47,"VOX",183
37,"37357",258,0,0,0,0,"VOX",0
18,"18114",591,443,437,2,6,"VOX",52
37,"37060",280,224,224,0,0,"VOX",35
24,"24160",645,481,475,1,6,"VOX",88
46,"46903",6285,5035,4996,27,39,"VOX",868
9,"9065",138,118,117,1,1,"VOX",10
9,"9444",63,43,43,2,0,"VOX",6
3,"3029",244,174,167,1,7,"VOX",8
44,"44264",248,175,171,0,4,"VOX",36
18,"18079",3469,2667,2623,16,44,"VOX",211
17,"17130",322,268,268,0,0,"VOX",4
41,"41038",102179,76348,75425,819,923,"VOX",10232
5,"5105",336,272,266,2,6,"VOX",34
37,"37334",73,49,49,0,0,"VOX",8
42,"42184",56,42,41,1,1,"VOX",10
49,"49117",437,340,335,1,5,"VOX",21
45,"45056",2300,1526,1501,8,25,"VOX",308
25,"25097",84,72,72,1,0,"VOX",0
43,"43005",3643,2765,2749,22,16,"VOX",83
2,"2013",135,113,110,0,3,"VOX",24
49,"49092",116,87,86,0,1,"VOX",4
29,"29074",781,606,597,2,9,"VOX",85
9,"9214",641,454,445,5,9,"VOX",48
37,"37108",99,80,78,2,2,"VOX",7
25,"25002",467,357,356,2,1,"VOX",5
27,"27018",3232,2114,2089,24,25,"VOX",91
42,"42172",28,25,25,1,0,"VOX",2
31,"31189",1127,781,775,10,6,"VOX",13
12,"12078",333,238,235,1,3,"VOX",21
18,"18152",906,692,686,1,6,"VOX",24
47,"47199",71,59,59,3,0,"VOX",4
25,"25141",152,118,118,1,0,"VOX",0
50,"50217",431,346,344,0,2,"VOX",46
19,"19294",25,19,18,0,1,"VOX",0
5,"5094",132,109,108,1,1,"VOX",19
24,"24210",527,387,386,0,1,"VOX",39
34,"34098",783,614,605,3,9,"VOX",93
10,"10051",433,338,332,0,6,"VOX",33
43,"43079",356,306,305,1,1,"VOX",11
4,"4028",202,183,181,0,2,"VOX",11
13,"13018",766,644,634,0,10,"VOX",73
18,"18106",415,300,295,0,5,"VOX",38
34,"34231",217,184,178,0,6,"VOX",28
4,"4063",1063,847,835,5,12,"VOX",151
30,"30006",829,731,727,4,4,"VOX",65
23,"23092",27662,21206,20981,170,225,"VOX",2668
31,"31110",84,72,72,3,0,"VOX",5
24,"24034",3457,2627,2588,31,39,"VOX",204
24,"24089",101353,78253,77375,776,878,"VOX",9620
8,"8037",1930,1618,1610,10,8,"VOX",22
37,"37186",96,79,79,0,0,"VOX",4
43,"43130",177,145,145,0,0,"VOX",1
9,"9141",602,501,493,4,8,"VOX",49
29,"29044",757,540,533,7,7,"VOX",44
50,"50181",1000,770,754,7,16,"VOX",118
20,"20067",30618,21972,21854,138,118,"VOX",272
10,"10176",347,266,261,2,5,"VOX",47
39,"39085",6964,5489,5445,28,44,"VOX",582
25,"25176",307,262,259,1,3,"VOX",4
47,"47045",734,601,590,5,11,"VOX",86
18,"18028",907,766,756,0,10,"VOX",87
39,"39020",23931,17782,17566,126,216,"VOX",1426
37,"37027",235,188,184,2,4,"VOX",25
2,"2079",2823,2303,2253,22,50,"VOX",198
48,"48002",7777,6034,5981,48,53,"VOX",80
5,"5266",102,79,78,0,1,"VOX",6
2,"2055",1057,770,755,6,15,"VOX",98
27,"27046",1448,1074,1063,7,11,"VOX",40
50,"50249",284,229,227,1,2,"VOX",30
10,"10055",696,527,512,1,15,"VOX",59
13,"13036",766,626,617,0,9,"VOX",68
47,"47015",176,136,135,0,1,"VOX",11
18,"18018",554,457,451,0,6,"VOX",49
48,"48094",3125,2407,2388,12,19,"VOX",24
19,"19017",57,50,49,0,1,"VOX",0
15,"15901",3359,2237,2205,35,32,"VOX",84
42,"42149",387,311,308,3,3,"VOX",32
13,"13083",2392,1772,1714,13,58,"VOX",247
49,"49221",234,138,130,1,8,"VOX",12
24,"24184",183,121,119,0,2,"VOX",10
18,"18074",264,207,205,0,2,"VOX",27
18,"18180",627,442,435,4,7,"VOX",44
37,"37177",265,209,208,0,1,"VOX",23
39,"39003",258,205,202,3,3,"VOX",21
15,"15902",4522,3220,3159,47,61,"VOX",182
8,"8117",2480,2055,2050,16,5,"VOX",50
2,"2020",431,359,356,3,3,"VOX",35
2,"2057",1960,1522,1489,15,33,"VOX",153
8,"8066",1463,1185,1181,9,4,"VOX",53
44,"44246",1590,1173,1150,11,23,"VOX",66
9,"9239",47,39,39,0,0,"VOX",4
19,"19301",37,31,31,0,0,"VOX",6
8,"8302",9373,7001,6934,61,67,"VOX",278
25,"25215",505,299,299,4,0,"VOX",38
4,"4060",407,308,304,1,4,"VOX",25
25,"25216",241,199,199,2,0,"VOX",1
37,"37178",99,82,82,0,0,"VOX",13
18,"18043",130,93,93,0,0,"VOX",10
24,"24162",1772,1382,1369,22,13,"VOX",226
46,"46231",2401,1780,1770,8,10,"VOX",116
31,"31239",281,215,212,7,3,"VOX",8
5,"5903",138,94,92,0,2,"VOX",10
42,"42018",131,102,102,1,0,"VOX",8
27,"27049",1342,934,921,11,13,"VOX",47
49,"49177",260,165,162,2,3,"VOX",15
39,"39004",1483,1181,1163,4,18,"VOX",108
2,"2034",1324,1088,1083,10,5,"VOX",130
12,"12113",87,65,64,0,1,"VOX",6
26,"26014",447,313,309,2,4,"VOX",10
3,"3037",341,289,284,1,5,"VOX",36
24,"24016",507,314,311,2,3,"VOX",21
9,"9242",66,53,53,1,0,"VOX",4
31,"31240",513,385,385,6,0,"VOX",0
42,"42045",276,212,209,2,3,"VOX",19
10,"10142",840,641,639,5,2,"VOX",40
47,"47134",148,127,126,6,1,"VOX",26
19,"19304",220,177,175,1,2,"VOX",36
39,"39089",134,99,98,0,1,"VOX",6
22,"22213",2923,2261,2221,24,40,"VOX",251
47,"47145",586,446,440,2,6,"VOX",66
42,"42196",8,6,6,0,0,"VOX",0
18,"18093",2756,1902,1885,8,17,"VOX",321
45,"45160",1095,913,905,2,8,"VOX",171
5,"5038",113,89,88,0,1,"VOX",7
46,"46233",3781,2901,2847,22,54,"VOX",272
40,"40216",774,670,665,11,5,"VOX",99
42,"42139",21,15,15,1,0,"VOX",1
21,"21018",1719,1167,1139,9,28,"VOX",57
42,"42212",62,48,47,1,1,"VOX",8
40,"40183",116,103,103,0,0,"VOX",9
50,"50254",174,123,122,0,1,"VOX",6
43,"43135",341,283,280,4,3,"VOX",2
50,"50197",96,78,78,1,0,"VOX",6
18,"18094",2304,1845,1798,16,47,"VOX",210
28,"28183",1124,857,842,4,15,"VOX",103
8,"8095",67,53,52,0,1,"VOX",1
12,"12087",25,19,18,2,1,"VOX",0
50,"50051",800,615,608,3,7,"VOX",58
44,"44096",153,120,112,1,8,"VOX",6
24,"24221",750,563,553,6,10,"VOX",101
5,"5040",64,51,51,1,0,"VOX",10
9,"9247",22,18,18,0,0,"VOX",2
10,"10185",573,463,460,3,3,"VOX",33
6,"6156",1171,919,901,10,18,"VOX",58
1,"1056",205,134,134,0,0,"VOX",0
17,"17109",698,558,553,1,5,"VOX",9
37,"37092",1889,1459,1447,16,12,"VOX",272
37,"37134",212,156,148,0,8,"VOX",28
36,"36902",5052,3813,3724,21,89,"VOX",174
37,"37196",72,56,53,0,3,"VOX",1
2,"2063",1375,1067,1047,1,20,"VOX",161
40,"40128",122,95,93,2,2,"VOX",11
49,"49105",136,105,103,1,2,"VOX",10
30,"30015",19372,14430,14283,91,147,"VOX",2460
5,"5041",995,776,767,3,9,"VOX",130
5,"5026",187,163,159,1,4,"VOX",18
45,"45026",218,177,172,0,5,"VOX",37
5,"5160",296,236,232,1,4,"VOX",27
4,"4103",1439,1120,1108,16,12,"VOX",191
43,"43039",105,85,85,0,0,"VOX",0
22,"22901",714,521,508,3,13,"VOX",28
25,"25255",395,321,318,2,3,"VOX",13
30,"30026",16252,11142,10977,65,165,"VOX",2360
40,"40092",113,86,84,2,2,"VOX",5
2,"2053",2885,2313,2282,13,31,"VOX",266
13,"13094",290,227,227,1,0,"VOX",17
50,"50101",832,625,614,1,11,"VOX",53
37,"37299",229,175,168,0,7,"VOX",23
50,"50257",163,136,134,1,2,"VOX",11
47,"47023",3057,2577,2557,21,20,"VOX",499
46,"46248",4886,3672,3613,25,59,"VOX",584
24,"24181",1414,1067,1055,14,12,"VOX",141
19,"19081",27,19,19,0,0,"VOX",0
47,"47150",259,206,202,0,4,"VOX",17
20,"20036",13192,9864,9806,67,58,"VOX",176
50,"50082",84,63,63,0,0,"VOX",11
46,"46187",1304,991,982,8,9,"VOX",81
8,"8046",13478,10989,10939,67,50,"VOX",255
39,"39010",610,518,512,1,6,"VOX",39
50,"50258",53,33,33,3,0,"VOX",6
19,"19130",61365,49363,48747,383,616,"VOX",7476
10,"10013",266,203,202,2,1,"VOX",27
12,"12119",137,107,104,1,3,"VOX",14
17,"17173",182,156,156,0,0,"VOX",3
16,"16134",4383,3544,3491,34,53,"VOX",674
51,"51001",59934,38342,37884,322,458,"VOX",9079
33,"33064",250,175,174,0,1,"VOX",12
13,"13097",2205,1764,1742,6,22,"VOX",214
50,"50083",84,70,68,0,2,"VOX",9
31,"31126",351,255,254,2,1,"VOX",5
45,"45123",3160,2434,2392,16,42,"VOX",545
29,"29002",1150,851,842,4,9,"VOX",84
5,"5045",80,65,65,0,0,"VOX",19
17,"17114",23269,17558,17474,91,84,"VOX",273
12,"12120",161,138,138,0,0,"VOX",18
48,"48013",79423,59100,58630,458,470,"VOX",1422
17,"17174",162,132,132,4,0,"VOX",3
9,"9238",941,573,567,8,6,"VOX",61
24,"24132",615,405,404,5,1,"VOX",46
39,"39030",1895,1374,1358,6,16,"VOX",126
40,"40122",525,442,434,2,8,"VOX",43
15,"15044",1209,889,876,4,13,"VOX",41
1,"1018",1408,998,993,6,5,"VOX",25
34,"34169",381,314,309,6,5,"VOX",42
24,"24105",1498,1188,1177,18,11,"VOX",184
19,"19183",71,61,59,0,2,"VOX",3
27,"27058",3322,2551,2512,22,39,"VOX",90
45,"45171",1326,1032,1013,6,19,"VOX",179
7,"7042",10785,7256,7191,60,65,"VOX",440
43,"43042",2198,1820,1816,8,4,"VOX",62
20,"20080",7709,5629,5588,28,41,"VOX",78
9,"9257",86,74,71,0,3,"VOX",20
19,"19038",22,19,19,0,0,"VOX",6
40,"40145",1105,906,899,2,7,"VOX",130
44,"44247",287,216,215,6,1,"VOX",16
49,"49058",298,244,242,1,2,"VOX",38
13,"13040",841,690,666,2,24,"VOX",62
30,"30021",9441,6664,6591,32,73,"VOX",1597
20,"20081",7655,5629,5601,22,28,"VOX",33
42,"42165",419,288,285,8,3,"VOX",23
16,"16014",563,444,443,4,1,"VOX",56
25,"25193",767,614,606,6,8,"VOX",3
45,"45173",9729,7664,7558,46,106,"VOX",1421
19,"19303",40,35,35,0,0,"VOX",8
47,"47155",3410,2694,2660,21,34,"VOX",412
16,"16015",351,251,250,4,1,"VOX",37
31,"31253",119,106,105,0,1,"VOX",0
3,"3078",474,372,371,2,1,"VOX",54
46,"46222",394,325,324,1,1,"VOX",19
18,"18137",1002,776,773,0,3,"VOX",108
28,"28073",12751,9940,9838,63,102,"VOX",1725
39,"39042",5930,4722,4676,26,46,"VOX",634
40,"40906",2131,1830,1814,10,16,"VOX",226
44,"44067",108,82,78,0,4,"VOX",8
44,"44263",377,296,285,3,11,"VOX",48
40,"40100",263,219,215,1,4,"VOX",38
8,"8209",6896,5269,5244,25,25,"VOX",220
24,"24029",695,521,520,4,1,"VOX",46
9,"9050",52,36,36,0,0,"VOX",5
42,"42167",236,183,182,3,1,"VOX",16
50,"50234",242,194,187,3,7,"VOX",11
26,"26015",180,145,142,1,3,"VOX",13
49,"49226",239,207,200,3,7,"VOX",31
31,"31038",1336,992,981,8,11,"VOX",25
9,"9428",103,86,86,0,0,"VOX",8
2,"2012",1825,1541,1509,8,32,"VOX",183
37,"37346",252,214,213,3,1,"VOX",22
50,"50235",2412,1826,1807,22,19,"VOX",277
13,"13013",7050,5475,5371,39,104,"VOX",883
30,"30023",3875,3107,3068,20,39,"VOX",538
3,"3049",12143,9418,9302,47,116,"VOX",1729
34,"34228",76,62,62,0,0,"VOX",2
20,"20053",4848,3479,3451,27,28,"VOX",32
28,"28024",168,146,145,1,1,"VOX",33
39,"39044",3868,3019,2985,8,34,"VOX",328
42,"42213",25,16,16,0,0,"VOX",1
22,"22188",76,60,59,1,1,"VOX",1
37,"37010",923,739,735,2,4,"VOX",93
37,"37359",163,122,117,0,5,"VOX",12
18,"18035",1190,965,952,4,13,"VOX",74
15,"15017",19860,14930,14706,204,224,"VOX",948
8,"8052",139,111,110,0,1,"VOX",3
19,"19278",24,24,24,0,0,"VOX",3
46,"46225",348,279,273,2,6,"VOX",25
16,"16018",381,313,312,2,1,"VOX",91
47,"47188",99,77,77,0,0,"VOX",13
45,"45133",2808,2233,2187,14,46,"VOX",400
8,"8289",4457,3605,3594,20,11,"VOX",88
39,"39017",553,416,409,0,7,"VOX",74
37,"37360",215,158,153,3,5,"VOX",13
50,"50237",102,81,81,3,0,"VOX",10
24,"24112",299,226,223,1,3,"VOX",13
6,"6003",766,625,610,3,15,"VOX",33
12,"12098",533,446,440,4,6,"VOX",91
24,"24033",205,146,146,3,0,"VOX",21
10,"10079",858,694,684,1,10,"VOX",70
4,"4041",330,248,247,1,1,"VOX",30
25,"25003",3721,2828,2815,19,13,"VOX",70
38,"38013",3019,2023,1991,12,32,"VOX",98
9,"9086",661,521,518,5,3,"VOX",123
26,"26031",98,89,87,0,2,"VOX",4
29,"29077",214,158,156,1,2,"VOX",34
26,"26044",51,44,42,0,2,"VOX",4
42,"42094",603,484,475,10,9,"VOX",65
8,"8255",137,105,105,1,0,"VOX",0
19,"19177",61,49,48,0,1,"VOX",2
25,"25910",91,70,67,2,3,"VOX",0
19,"19047",55,47,47,0,0,"VOX",5
49,"49038",94,68,68,1,0,"VOX",9
45,"45045",1331,1001,990,2,11,"VOX",176
8,"8158",3108,2458,2453,13,5,"VOX",60
31,"31178",472,354,348,3,6,"VOX",45
4,"4068",174,134,134,0,0,"VOX",15
37,"37098",304,214,210,0,4,"VOX",14
37,"37136",633,448,434,8,14,"VOX",48
26,"26033",163,143,142,3,1,"VOX",9
31,"31220",742,620,615,2,5,"VOX",36
19,"19266",229,194,192,1,2,"VOX",40
3,"3023",1379,1216,1199,6,17,"VOX",100
18,"18062",11041,8531,8355,71,176,"VOX",1335
38,"38015",4067,2951,2926,22,25,"VOX",154
3,"3084",497,429,429,4,0,"VOX",31
17,"17124",1599,1258,1254,6,4,"VOX",6
3,"3054",336,277,272,2,5,"VOX",20
38,"38045",3549,2149,2109,6,40,"VOX",163
27,"27066",12633,9139,8911,84,228,"VOX",440
19,"19049",9,8,8,0,0,"VOX",2
17,"17092",3467,2660,2633,17,27,"VOX",71
8,"8214",6966,5648,5633,21,15,"VOX",136
42,"42129",678,540,539,1,1,"VOX",38
5,"5136",84,64,64,2,0,"VOX",3
19,"19001",41,33,33,0,0,"VOX",1
37,"37213",83,65,64,0,1,"VOX",8
18,"18146",937,690,682,6,8,"VOX",66
9,"9272",259,197,195,2,2,"VOX",12
38,"38016",1178,654,648,6,6,"VOX",31
25,"25006",317,246,245,3,1,"VOX",5
42,"42206",8,4,4,0,0,"VOX",2
6,"6106",413,267,263,3,4,"VOX",27
8,"8902",3937,3176,3164,17,12,"VOX",120
8,"8143",2719,2121,2109,10,12,"VOX",47
49,"49004",111,77,77,4,0,"VOX",8
26,"26151",411,353,351,3,2,"VOX",34
31,"31223",959,718,711,8,7,"VOX",39
31,"31141",107,76,74,0,2,"VOX",23
37,"37253",133,107,103,0,4,"VOX",16
49,"49005",128,87,85,1,2,"VOX",18
10,"10085",319,240,236,1,4,"VOX",28
3,"3056",8629,6838,6737,38,101,"VOX",661
15,"15085",3220,2284,2239,23,45,"VOX",94
48,"48085",10637,8270,8223,54,47,"VOX",132
27,"27038",923,688,677,12,11,"VOX",13
22,"22032",107,74,74,2,0,"VOX",13
44,"44236",59,44,44,0,0,"VOX",1
5,"5126",62,53,52,0,1,"VOX",7
8,"8101",174954,129953,129198,680,755,"VOX",5117
13,"13025",296,260,256,1,4,"VOX",17
40,"40062",57,49,49,0,0,"VOX",9
9,"9275",166,130,130,2,0,"VOX",16
5,"5061",261,214,208,0,6,"VOX",26
7,"7054",22958,14097,13908,123,189,"VOX",1373
8,"8294",2063,1644,1643,10,1,"VOX",56
22,"22110",707,531,528,2,3,"VOX",66
25,"25205",562,451,447,7,4,"VOX",9
45,"45035",293,228,223,1,5,"VOX",35
3,"3058",4967,4031,3967,24,64,"VOX",739
24,"24203",95,72,72,0,0,"VOX",6
39,"39023",6523,5205,5144,22,61,"VOX",390
50,"50067",13788,10562,10413,107,149,"VOX",1480
12,"12132",484,415,412,4,3,"VOX",43
50,"50271",248,197,189,2,8,"VOX",20
26,"26154",10,10,10,1,0,"VOX",4
9,"9277",107,92,89,0,3,"VOX",3
2,"2084",305,221,215,1,6,"VOX",28
45,"45053",7834,6440,6333,46,107,"VOX",899
34,"34139",160,119,118,0,1,"VOX",17
8,"8059",344,292,290,2,2,"VOX",4
25,"25171",2127,1639,1630,8,9,"VOX",20
50,"50157",286,226,220,0,6,"VOX",6
44,"44115",102,96,95,0,1,"VOX",5
19,"19157",56,40,37,0,3,"VOX",4
19,"19201",60,45,45,0,0,"VOX",3
20,"20062",945,727,726,3,1,"VOX",6
40,"40112",2772,2255,2223,21,32,"VOX",265
8,"8287",1057,877,871,7,6,"VOX",12
6,"6122",6562,4837,4723,43,114,"VOX",400
22,"22141",114,86,85,0,1,"VOX",14
21,"21006",3329,2307,2262,20,45,"VOX",153
9,"9279",167,131,128,2,3,"VOX",13
31,"31025",763,562,557,6,5,"VOX",15
5,"5064",102,83,81,2,2,"VOX",13
10,"10048",204,156,154,0,2,"VOX",28
5,"5182",731,494,490,6,4,"VOX",75
8,"8271",67,57,57,0,0,"VOX",0
6,"6023",4170,3088,3045,18,43,"VOX",146
26,"26157",282,233,232,1,1,"VOX",26
31,"31107",1680,1330,1312,16,18,"VOX",129
24,"24086",266,211,210,0,1,"VOX",29
43,"43176",746,588,586,7,2,"VOX",14
10,"10091",350,293,291,1,2,"VOX",34
10,"10171",355,261,255,0,6,"VOX",12
9,"9067",407,285,278,2,7,"VOX",36
31,"31905",2968,2253,2236,21,17,"VOX",160
26,"26030",17,17,17,0,0,"VOX",0
18,"18082",827,587,577,5,10,"VOX",69
38,"38012",2310,1705,1687,6,18,"VOX",66
32,"32027",1000,762,747,5,15,"VOX",10
37,"37024",88,69,69,0,0,"VOX",10
20,"20034",3154,2336,2315,20,21,"VOX",11
3,"3061",1054,830,816,3,14,"VOX",142
50,"50131",210,157,156,0,1,"VOX",27
50,"50071",127,89,88,0,1,"VOX",15
50,"50246",38,28,28,0,0,"VOX",3
31,"31149",2271,1645,1628,9,17,"VOX",25
42,"42050",27,21,21,1,0,"VOX",5
34,"34146",53,47,46,0,1,"VOX",7
9,"9287",199,169,168,1,1,"VOX",32
40,"40010",111,95,94,0,1,"VOX",17
10,"10174",171,129,127,0,2,"VOX",13
42,"42173",29702,22141,21776,301,365,"VOX",1849
45,"45196",1387,1099,1084,6,15,"VOX",250
43,"43047",4209,2878,2856,23,22,"VOX",173
10,"10161",82,50,50,1,0,"VOX",4
44,"44040",191,164,158,2,6,"VOX",14
50,"50266",121,85,80,0,5,"VOX",9
43,"43178",1421,1118,1113,7,5,"VOX",26
3,"3002",3631,2841,2801,16,40,"VOX",338
44,"44021",104,86,85,2,1,"VOX",6
45,"45013",1671,1320,1298,4,22,"VOX",184
37,"37148",404,321,315,2,6,"VOX",54
29,"29022",171,144,143,0,1,"VOX",8
23,"23903",3499,2738,2714,7,24,"VOX",267
42,"42189",53,44,42,0,2,"VOX",6
37,"37026",175,148,148,2,0,"VOX",33
34,"34149",21,18,18,0,0,"VOX",2
25,"25113",1116,912,908,8,4,"VOX",10
3,"3095",4740,3702,3657,23,45,"VOX",236
37,"37262",69,60,60,0,0,"VOX",12
18,"18049",596,485,481,0,4,"VOX",38
29,"29056",1061,783,772,4,11,"VOX",89
25,"25076",134,94,93,0,1,"VOX",2
46,"46147",17133,12260,12120,59,140,"VOX",1621
50,"50073",2117,1735,1706,13,29,"VOX",223
3,"3064",5004,3782,3736,20,46,"VOX",524
4,"4057",1260,970,953,10,17,"VOX",110
3,"3096",5779,4433,4352,30,81,"VOX",423
5,"5151",80,64,64,1,0,"VOX",8
46,"46178",4943,3684,3641,21,43,"VOX",765
9,"9236",35,29,29,1,0,"VOX",3
5,"5188",41,36,34,0,2,"VOX",7
46,"46087",109,98,98,1,0,"VOX",5
31,"31032",1678,1285,1269,25,16,"VOX",51
31,"31154",211,125,124,2,1,"VOX",4
26,"26047",1879,1569,1549,10,20,"VOX",156
9,"9129",89,75,75,0,0,"VOX",5
50,"50074",6166,4547,4444,33,103,"VOX",518
45,"45063",380,294,289,0,5,"VOX",40
50,"50165",1783,1359,1330,20,29,"VOX",115
10,"10165",253,212,210,1,2,"VOX",12
18,"18109",599,452,448,3,4,"VOX",53
50,"50135",88,74,74,3,0,"VOX",3
16,"16165",55,49,48,1,1,"VOX",4
31,"31033",46,29,28,0,1,"VOX",0
28,"28010",10538,8708,8635,54,73,"VOX",1524
8,"8170",442,338,338,0,0,"VOX",5
19,"19255",72,51,51,0,0,"VOX",0
24,"24215",152,125,124,1,1,"VOX",25
16,"16124",1826,1482,1455,6,27,"VOX",181
44,"44024",28,25,24,0,1,"VOX",5
21,"21014",4065,3192,3148,22,44,"VOX",208
10,"10901",1177,818,805,1,13,"VOX",137
31,"31238",115,101,100,2,1,"VOX",1
30,"30040",705,600,596,1,4,"VOX",68
43,"43034",468,393,393,0,0,"VOX",15
20,"20009",11343,8168,8106,46,62,"VOX",95
46,"46089",2170,1692,1672,6,20,"VOX",204
19,"19287",136,107,105,3,2,"VOX",18
36,"36058",4942,3470,3402,37,68,"VOX",168
19,"19302",52,43,41,1,2,"VOX",6
40,"40192",133,104,102,2,2,"VOX",4
18,"18159",999,828,824,1,4,"VOX",73
16,"16125",1599,1314,1295,9,19,"VOX",274
19,"19020",46,35,34,1,1,"VOX",7
26,"26050",130,97,97,0,0,"VOX",11
4,"4061",622,501,494,4,7,"VOX",29
49,"49019",228,170,164,0,6,"VOX",13
37,"37267",182,153,150,1,3,"VOX",24
24,"24217",133,106,105,1,1,"VOX",11
46,"46242",330,279,279,0,0,"VOX",35
8,"8145",2701,2156,2144,7,12,"VOX",52
9,"9301",648,545,536,7,9,"VOX",72
19,"19216",130,100,99,1,1,"VOX",4
9,"9078",37,31,31,0,0,"VOX",3
6,"6132",829,598,593,0,5,"VOX",32
37,"37268",108,72,70,0,2,"VOX",6
32,"32090",738,530,525,3,5,"VOX",19
45,"45159",85,75,74,0,1,"VOX",18
47,"47081",41,36,36,0,0,"VOX",5
50,"50050",86,65,65,1,0,"VOX",9
39,"39033",540,430,423,1,7,"VOX",39
24,"24136",496,375,371,2,4,"VOX",53
23,"23020",1524,1363,1348,12,15,"VOX",85
5,"5193",180,156,156,2,0,"VOX",11
39,"39024",1815,1436,1420,14,16,"VOX",109
8,"8146",1358,1086,1079,2,7,"VOX",47
9,"9244",45,35,35,0,0,"VOX",3
19,"19159",87,77,76,0,1,"VOX",13
8,"8069",3280,2691,2680,17,11,"VOX",83
43,"43037",17902,12787,12695,63,92,"VOX",693
5,"5157",235,175,174,2,1,"VOX",15
29,"29029",380,294,287,2,7,"VOX",24
47,"47114",3911,2864,2807,28,57,"VOX",475
9,"9136",173,130,128,0,2,"VOX",24
8,"8147",17282,13644,13560,94,84,"VOX",473
46,"46001",783,612,607,4,5,"VOX",91
32,"32007",1412,1011,1001,9,10,"VOX",27
26,"26053",195,161,160,3,1,"VOX",17
8,"8001",9079,7383,7341,40,42,"VOX",370
44,"44028",171,140,138,1,2,"VOX",2
34,"34022",1019,856,849,8,7,"VOX",61
20,"20074",11503,8767,8720,26,47,"VOX",35
4,"4024",3225,2558,2534,23,24,"VOX",526
45,"45025",1219,926,913,5,13,"VOX",195
19,"19024",8525,6587,6485,33,102,"VOX",1204
8,"8070",266,232,232,0,0,"VOX",2
42,"42185",25,20,20,0,0,"VOX",0
8,"8044",4136,3193,3175,11,18,"VOX",73
50,"50052",85,64,64,0,0,"VOX",6
50,"50901",140,108,108,0,0,"VOX",17
43,"43038",21861,16504,16406,112,98,"VOX",1086
50,"50080",34,29,29,0,0,"VOX",0
33,"33061",350,201,200,2,1,"VOX",33
20,"20014",1156,772,765,4,7,"VOX",4
42,"42200",76,54,53,0,1,"VOX",10
13,"13001",1195,947,943,5,4,"VOX",74
43,"43137",1905,1515,1499,15,16,"VOX",63
9,"9471",142,113,112,3,1,"VOX",11
3,"3103",245,212,211,4,1,"VOX",17
17,"17200",623,512,510,1,2,"VOX",1
8,"8281",4840,4009,3998,23,11,"VOX",92
25,"25023",4527,3621,3601,23,20,"VOX",135
9,"9308",62,48,48,0,0,"VOX",5
10,"10052",166,124,123,0,1,"VOX",23
37,"37373",700,522,514,0,8,"VOX",46
42,"42188",43,35,34,1,1,"VOX",5
18,"18132",3124,2575,2548,17,27,"VOX",147
25,"25186",207,174,173,7,1,"VOX",2
24,"24101",384,285,283,4,2,"VOX",17
22,"22176",170,136,135,0,1,"VOX",25
44,"44128",59,46,45,0,1,"VOX",2
46,"46156",2024,1642,1628,7,14,"VOX",136
5,"5198",71,51,51,0,0,"VOX",10
23,"23027",716,524,518,2,6,"VOX",46
40,"40022",193,162,159,2,3,"VOX",12
2,"2066",223,172,169,1,3,"VOX",14
22,"22130",10128,7355,7294,61,61,"VOX",817
40,"40199",101,79,78,0,1,"VOX",5
32,"32010",360,276,273,3,3,"VOX",23
1,"1059",189037,133121,131768,792,1353,"VOX",4439
6,"6038",790,583,574,4,9,"VOX",66
37,"37003",107,82,82,1,0,"VOX",8
18,"18167",1850,1330,1317,17,13,"VOX",114
44,"44129",36,29,29,0,0,"VOX",2
26,"26057",51,47,47,1,0,"VOX",5
16,"16176",31,22,22,0,0,"VOX",0
23,"23028",6131,4696,4635,24,61,"VOX",473
3,"3106",564,485,479,4,6,"VOX",28
13,"13006",572,437,430,5,7,"VOX",38
20,"20017",8484,6294,6263,25,31,"VOX",68
38,"38005",5666,3795,3761,24,34,"VOX",189
42,"42162",2325,1721,1699,16,22,"VOX",133
10,"10068",711,576,556,2,20,"VOX",56
34,"34168",45,39,39,0,0,"VOX",4
3,"3014",238879,176118,174768,1105,1350,"VOX",22186
50,"50144",31,26,25,0,1,"VOX",2
16,"16177",82,64,63,0,1,"VOX",15
44,"44033",244,174,172,0,2,"VOX",30
19,"19087",17,14,14,0,0,"VOX",0
19,"19036",248,213,210,1,3,"VOX",36
37,"37151",143,112,111,1,1,"VOX",16
40,"40190",48,40,39,0,1,"VOX",10
28,"28020",169,110,109,0,1,"VOX",8
8,"8206",737,625,624,3,1,"VOX",15
37,"37086",104,88,88,0,0,"VOX",9
16,"16052",537,429,429,2,0,"VOX",61
5,"5201",499,414,407,2,7,"VOX",30
37,"37277",77,56,56,0,0,"VOX",7
19,"19226",41,32,32,0,0,"VOX",2
26,"26060",75,60,60,1,0,"VOX",5
32,"32013",2017,1388,1380,5,8,"VOX",84
24,"24148",1616,1252,1237,11,15,"VOX",192
46,"46190",50023,37273,36976,250,297,"VOX",4660
28,"28021",576,387,386,3,1,"VOX",42
20,"20019",9912,7226,7195,51,31,"VOX",56
50,"50260",32,28,28,0,0,"VOX",3
40,"40134",697,560,548,7,12,"VOX",49
18,"18065",591,482,468,4,14,"VOX",13
50,"50136",534,416,405,2,11,"VOX",89
4,"4033",125,98,95,0,3,"VOX",9
22,"22136",749,579,576,5,3,"VOX",48
49,"49275",51218,38135,37628,388,507,"VOX",4311
12,"12064",80,75,73,1,2,"VOX",3
3,"3016",91,77,77,1,0,"VOX",14
32,"32014",1045,775,769,5,6,"VOX",25
5,"5088",29,23,23,0,0,"VOX",8
47,"47185",87,77,77,0,0,"VOX",13
25,"25030",123,90,90,1,0,"VOX",2
8,"8154",701,587,586,5,1,"VOX",17
46,"46009",3140,2582,2536,14,46,"VOX",245
50,"50086",178,121,119,2,2,"VOX",9
18,"18033",279,221,220,1,1,"VOX",19
18,"18910",730,491,487,0,4,"VOX",74
12,"12065",171,150,147,0,3,"VOX",16
25,"25094",139,116,116,0,0,"VOX",0
1,"1021",469,333,330,1,3,"VOX",22
50,"50205",74,58,57,0,1,"VOX",8
23,"23098",838,721,715,2,6,"VOX",61
25,"25128",127,87,87,0,0,"VOX",1
22,"22186",191,165,164,2,1,"VOX",8
9,"9209",4419,3407,3338,37,69,"VOX",516
2,"2072",1525,1146,1112,4,34,"VOX",197
5,"5207",645,543,540,3,3,"VOX",37
13,"13012",382,279,277,2,2,"VOX",22
41,"41056",3694,3044,3009,36,35,"VOX",235
19,"19075",61,44,43,0,1,"VOX",5
3,"3112",637,526,520,0,6,"VOX",48
1,"1902",730,551,545,6,6,"VOX",18
33,"33069",3419,2557,2533,32,24,"VOX",274
20,"20022",854,621,621,7,0,"VOX",0
25,"25228",3115,2468,2459,19,9,"VOX",86
24,"24190",146,109,109,1,0,"VOX",13
50,"50263",176,119,116,0,3,"VOX",4
18,"18140",42374,29390,29025,221,365,"VOX",4247
46,"46072",3542,3008,2961,33,47,"VOX",213
31,"31256",96,64,64,0,0,"VOX",0
24,"24109",876,635,619,3,16,"VOX",51
9,"9102",33,26,25,0,1,"VOX",2
45,"45177",2023,1693,1651,11,42,"VOX",261
26,"26029",36,29,28,0,1,"VOX",1
8,"8010",4207,3327,3304,13,23,"VOX",76
13,"13015",5226,4010,3959,20,51,"VOX",348
5,"5209",75,58,57,0,1,"VOX",3
15,"15048",5048,3791,3730,38,61,"VOX",237
40,"40139",258,207,202,0,5,"VOX",19
37,"37171",397,297,292,1,5,"VOX",29
28,"28025",404,314,305,3,9,"VOX",48
50,"50179",264,231,228,0,3,"VOX",22
4,"4001",1014,768,763,9,5,"VOX",88
31,"31013",626,427,422,5,5,"VOX",3
25,"25033",1121,899,890,5,9,"VOX",16
20,"20024",391,274,274,1,0,"VOX",4
50,"50089",8584,6951,6912,34,39,"VOX",1516
22,"22061",6583,5027,4973,51,54,"VOX",563
23,"23035",1103,903,882,6,21,"VOX",68
44,"44108",300,228,224,5,4,"VOX",26
12,"12126",24347,19023,18749,152,274,"VOX",2126
15,"15050",1748,1038,1027,15,11,"VOX",58
8,"8079",334,284,282,0,2,"VOX",2
37,"37051",80,59,58,0,1,"VOX",4
17,"17029",199,160,157,1,3,"VOX",3
9,"9105",97,81,76,1,5,"VOX",9
42,"42080",150,116,116,1,0,"VOX",17
4,"4079",54086,38415,38134,239,281,"VOX",8940
37,"37285",366,273,272,1,1,"VOX",35
18,"18143",949,757,740,5,17,"VOX",54
47,"47149",45,39,39,1,0,"VOX",0
12,"12038",156,110,109,1,1,"VOX",9
47,"47063",89,71,71,0,0,"VOX",14
44,"44110",37,33,33,0,0,"VOX",0
5,"5212",197,138,136,0,2,"VOX",15
19,"19330",67,60,60,0,0,"VOX",12
9,"9327",29,22,22,0,0,"VOX",7
3,"3115",255,222,221,2,1,"VOX",22
2,"2041",321,253,251,3,2,"VOX",21
42,"42217",34,26,26,0,0,"VOX",3
43,"43048",763,614,609,7,5,"VOX",11
14,"14036",3676,2850,2766,40,84,"VOX",224
25,"25133",686,528,527,2,1,"VOX",3
16,"16193",58,51,51,2,0,"VOX",6
12,"12128",1362,1099,1076,9,23,"VOX",115
43,"43171",14705,11002,10956,62,46,"VOX",922
9,"9166",98,77,77,1,0,"VOX",16
31,"31179",483,348,344,2,4,"VOX",12
25,"25202",108,75,75,0,0,"VOX",0
50,"50064",438,368,362,1,6,"VOX",28
19,"19194",94,76,76,0,0,"VOX",11
40,"40002",34,30,30,0,0,"VOX",0
32,"32020",2460,1899,1876,6,23,"VOX",50
31,"31180",197,155,154,2,1,"VOX",1
44,"44042",114,84,84,0,0,"VOX",11
2,"2006",561,482,480,2,2,"VOX",31
34,"34042",292,244,243,3,1,"VOX",33
8,"8240",9453,7807,7776,21,31,"VOX",171
5,"5099",457,392,389,2,3,"VOX",61
2,"2080",499,409,400,0,9,"VOX",58
21,"21037",459,363,357,4,6,"VOX",19
12,"12072",1082,901,889,15,12,"VOX",82
48,"48023",580,493,489,0,4,"VOX",1
31,"31263",231,154,154,0,0,"VOX",1
49,"49085",918,673,660,5,13,"VOX",56
44,"44131",27,22,22,0,0,"VOX",1
31,"31046",53,39,39,0,0,"VOX",1
39,"39049",306,209,208,4,1,"VOX",37
28,"28030",1815,1438,1395,10,43,"VOX",212
4,"4083",1740,1342,1326,4,16,"VOX",123
45,"45186",2945,2319,2280,11,39,"VOX",355
26,"26072",285,252,247,1,5,"VOX",15
20,"20029",4272,3257,3239,18,18,"VOX",20
6,"6151",1054,791,778,2,13,"VOX",47
27,"27006",2458,1713,1666,27,47,"VOX",161
27,"27902",7150,5067,4953,74,114,"VOX",315
44,"44113",72,51,50,0,1,"VOX",1
16,"16152",32,28,28,1,0,"VOX",4
18,"18147",3644,2492,2441,18,51,"VOX",289
21,"21039",299,226,223,7,3,"VOX",22
5,"5101",277,224,222,0,2,"VOX",45
49,"49042",230,179,174,1,5,"VOX",13
42,"42043",3838,2897,2855,18,42,"VOX",282
25,"25238",205,163,163,2,0,"VOX",3
39,"39022",969,740,732,2,8,"VOX",110
3,"3026",1316,1040,1024,5,16,"VOX",72
44,"44044",83,65,64,2,1,"VOX",8
23,"23042",317,234,232,1,2,"VOX",27
37,"37058",56,41,41,0,0,"VOX",3
31,"31143",93,58,52,0,6,"VOX",3
46,"46201",62,47,47,0,0,"VOX",1
2,"2083",209,183,183,0,0,"VOX",13
28,"28170",2487,1840,1810,10,30,"VOX",352
18,"18148",803,652,648,0,4,"VOX",62
18,"18182",1917,1391,1381,7,10,"VOX",176
37,"37179",196,172,169,0,3,"VOX",46
25,"25137",8686,6327,6296,46,31,"VOX",128
46,"46232",872,714,706,3,8,"VOX",68
12,"12075",107,89,87,0,2,"VOX",5
48,"48057",5745,4391,4376,13,15,"VOX",14
39,"39052",18957,15123,14985,106,138,"VOX",2042
37,"37059",117,106,100,0,6,"VOX",17
32,"32024",4835,3484,3439,23,45,"VOX",150
30,"30002",9735,7319,7227,33,92,"VOX",1686
41,"41009",1167,820,805,4,15,"VOX",73
25,"25138",547,440,436,1,4,"VOX",1
5,"5103",66,48,48,0,0,"VOX",7
43,"43028",2766,2007,1988,7,19,"VOX",96
22,"22036",88,76,75,0,1,"VOX",17
45,"45099",3635,2741,2684,23,57,"VOX",553
8,"8085",976,812,811,2,1,"VOX",12
19,"19245",1145,904,880,8,24,"VOX",134
30,"30003",25046,17860,17668,99,192,"VOX",2643
31,"31904",1561,1139,1130,7,9,"VOX",39
24,"24164",362,221,220,1,1,"VOX",58
33,"33019",2882,1981,1939,8,42,"VOX",203
13,"13029",90,77,77,0,0,"VOX",15
50,"50187",56,43,43,0,0,"VOX",3
5,"5220",363,312,308,5,4,"VOX",51
46,"46021",23977,18032,17879,125,153,"VOX",1990
18,"18184",2170,1688,1656,3,32,"VOX",192
4,"4052",12767,9352,9269,90,83,"VOX",2008
8,"8138",4432,3435,3413,10,22,"VOX",61
50,"50070",49,28,28,0,0,"VOX",7
24,"24123",716,514,507,2,7,"VOX",56
31,"31147",106,88,86,3,2,"VOX",0
22,"22203",76,61,61,0,0,"VOX",16
43,"43128",905,751,747,4,4,"VOX",26
37,"37259",36,29,29,0,0,"VOX",5
16,"16204",241,198,196,1,2,"VOX",41
27,"27043",1219,814,797,6,17,"VOX",41
31,"31148",92,67,65,4,2,"VOX",0
46,"46205",14233,11274,11145,55,129,"VOX",1349
44,"44117",319,263,256,5,7,"VOX",44
9,"9021",51,36,35,1,1,"VOX",1
6,"6057",537,442,433,1,9,"VOX",42
15,"15029",5403,3682,3622,62,60,"VOX",212
9,"9123",43,39,38,0,1,"VOX",6
16,"16205",107,80,79,0,1,"VOX",9
39,"39055",1075,836,829,8,7,"VOX",139
13,"13032",1084,842,831,9,11,"VOX",129
10,"10133",1154,971,955,3,16,"VOX",32
3,"3031",41857,28648,28362,163,286,"VOX",3417
24,"24047",720,531,523,2,8,"VOX",70
6,"6058",1980,1519,1493,13,26,"VOX",110
10,"10093",393,313,303,4,10,"VOX",16
31,"31150",199,140,139,2,1,"VOX",1
9,"9178",40,27,27,0,0,"VOX",1
10,"10134",553,396,392,2,4,"VOX",52
19,"19296",27,24,24,0,0,"VOX",6
37,"37173",1420,1077,1058,13,19,"VOX",119
37,"37185",537,416,405,1,11,"VOX",63
50,"50247",842,621,616,7,5,"VOX",100
48,"48061",799,636,636,2,0,"VOX",3
24,"24049",1415,1146,1134,8,12,"VOX",74
16,"16078",41517,31810,31486,340,324,"VOX",4065
42,"42052",17,15,15,0,0,"VOX",2
16,"16209",111,97,97,0,0,"VOX",9
44,"44119",119,83,82,0,1,"VOX",7
25,"25013",2108,1570,1557,12,13,"VOX",92
8,"8247",980,832,828,3,4,"VOX",12
5,"5070",30,28,28,0,0,"VOX",5
22,"22206",182,145,145,0,0,"VOX",14
8,"8089",34019,26317,26191,170,126,"VOX",1248
17,"17040",551,465,459,4,6,"VOX",7
2,"2018",796,693,682,5,11,"VOX",104
5,"5110",706,550,546,4,4,"VOX",73
3,"3003",455,395,388,0,7,"VOX",52
16,"16211",322,233,229,0,4,"VOX",26
50,"50102",820,653,642,9,11,"VOX",59
40,"40120",196,176,169,0,7,"VOX",36
31,"31193",1438,1129,1123,13,6,"VOX",64
42,"42096",251,164,160,3,4,"VOX",16
32,"32002",2022,1510,1485,8,25,"VOX",73
39,"39086",362,273,268,1,5,"VOX",36
23,"23016",384,316,311,0,5,"VOX",21
16,"16082",271,207,206,3,1,"VOX",34
47,"47204",235,182,178,0,4,"VOX",48
48,"48063",356,277,274,2,3,"VOX",0
37,"37301",79,69,67,0,2,"VOX",11
47,"47109",171,130,130,1,0,"VOX",27
43,"43155",22619,16724,16624,101,100,"VOX",519
50,"50278",177,137,137,2,0,"VOX",28
8,"8169",48284,37528,37326,218,202,"VOX",1427
9,"9182",76,65,64,0,1,"VOX",5
46,"46108",426,346,342,1,4,"VOX",25
46,"46251",2442,2017,1976,9,41,"VOX",147
19,"19067",69,53,50,1,3,"VOX",5
8,"8091",5413,4301,4283,20,18,"VOX",112
31,"31074",390,310,307,5,3,"VOX",7
9,"9027",48,41,39,0,2,"VOX",2
6,"6063",2938,2299,2264,11,35,"VOX",186
21,"21050",12522,8425,8312,84,113,"VOX",1364
15,"15034",2724,1832,1811,8,21,"VOX",96
10,"10098",381,310,309,1,1,"VOX",29
20,"20039",2144,1704,1692,11,12,"VOX",5
40,"40051",34,33,31,0,2,"VOX",0
43,"43010",337,286,284,2,2,"VOX",8
45,"45203",2713,2092,2053,16,39,"VOX",395
8,"8224",878,697,695,1,2,"VOX",19
3,"3006",494,413,409,1,4,"VOX",30
50,"50279",73,61,60,2,1,"VOX",3
4,"4097",242,184,184,0,0,"VOX",17
24,"24054",417,318,311,0,7,"VOX",56
24,"24015",2209,1714,1672,19,42,"VOX",206
25,"25048",1632,1274,1264,7,10,"VOX",22
9,"9030",119,90,89,1,1,"VOX",8
8,"8251",5127,3972,3940,17,32,"VOX",133
45,"45204",634,500,497,1,3,"VOX",89
43,"43059",250,214,214,1,0,"VOX",2
11,"11034",2331,1708,1670,17,38,"VOX",140
50,"50195",53,42,41,0,1,"VOX",5
32,"32033",676,480,468,4,12,"VOX",29
43,"43011",1079,912,909,1,3,"VOX",29
46,"46090",1633,1413,1392,5,21,"VOX",100
20,"20041",234,156,151,2,5,"VOX",1
8,"8093",24,20,20,0,0,"VOX",0
37,"37192",355,234,227,5,7,"VOX",40
26,"26088",41,38,38,0,0,"VOX",4
14,"14051",1348,1064,1048,7,16,"VOX",59
41,"41091",539730,412509,408312,3804,4197,"VOX",52989
37,"37074",140,107,106,1,1,"VOX",7
50,"50281",68,55,52,0,3,"VOX",4
43,"43158",77,61,61,1,0,"VOX",0
17,"17046",710,574,571,3,3,"VOX",4
3,"3008",159,127,126,0,1,"VOX",14
2,"2024",3374,2657,2613,23,44,"VOX",351
47,"47113",142,117,117,1,0,"VOX",16
40,"40053",83,62,62,1,0,"VOX",4
41,"41092",7679,5668,5568,61,100,"VOX",521
9,"9191",33,24,24,0,0,"VOX",2
34,"34213",52,42,42,0,0,"VOX",4
17,"17018",494,405,402,1,3,"VOX",1
47,"47050",3898,3084,3047,36,37,"VOX",538
43,"43905",14941,10510,10446,40,64,"VOX",934
20,"20042",3172,2247,2231,9,16,"VOX",22
34,"34020",51,38,38,0,0,"VOX",7
26,"26016",28,24,23,0,1,"VOX",0
19,"19174",91,69,69,0,0,"VOX",9
32,"32035",1370,881,872,5,9,"VOX",49
50,"50021",25,23,23,1,0,"VOX",8
10,"10144",920,731,723,4,8,"VOX",57
25,"25253",145,122,121,0,1,"VOX",0
4,"4101",4375,3161,3112,34,49,"VOX",709
27,"27021",1649,1080,1048,14,32,"VOX",53
31,"31080",490,393,390,2,3,"VOX",5
40,"40055",32,26,25,0,1,"VOX",0
10,"10022",412,319,316,1,3,"VOX",5
8,"8306",527,390,388,2,2,"VOX",14
3,"3040",258,223,217,1,6,"VOX",16
8,"8148",2334,1803,1794,6,9,"VOX",125
4,"4065",368,287,284,2,3,"VOX",40
3,"3102",7226,5600,5516,28,84,"VOX",407
13,"13092",1715,1434,1425,1,9,"VOX",243
19,"19078",50,38,37,0,1,"VOX",0
39,"39092",871,635,629,2,6,"VOX",68
39,"39036",971,794,787,5,7,"VOX",87
4,"4102",14110,9871,9765,90,106,"VOX",2578
9,"9037",106,97,97,0,0,"VOX",13
23,"23056",3062,2332,2281,13,51,"VOX",244
44,"44252",75,56,56,1,0,"VOX",6
16,"16091",64,46,46,1,0,"VOX",0
26,"26093",48,38,38,0,0,"VOX",5
19,"19127",90,63,63,0,0,"VOX",4
46,"46034",1811,1407,1389,13,18,"VOX",147
42,"42110",55,43,43,0,0,"VOX",7
43,"43014",14357,10596,10542,60,54,"VOX",300
33,"33032",11086,8028,7849,129,179,"VOX",663
46,"46125",846,681,675,1,6,"VOX",71
42,"42159",40,36,35,0,1,"VOX",3
17,"17162",156,114,111,1,3,"VOX",3
22,"22051",91,78,78,1,0,"VOX",8
32,"32037",681,534,523,6,11,"VOX",19
3,"3042",1462,1025,1008,3,17,"VOX",121
50,"50111",183,144,142,2,2,"VOX",20
9,"9039",56,44,44,0,0,"VOX",3
43,"43015",119,101,101,0,0,"VOX",1
8,"8256",691,571,568,3,3,"VOX",16
5,"5237",155,131,129,1,2,"VOX",23
32,"32038",399,274,271,3,3,"VOX",9
12,"12090",104,85,83,1,2,"VOX",10
40,"40901",414,331,328,8,3,"VOX",39
49,"49147",249,197,196,1,1,"VOX",30
26,"26174",132,116,116,5,0,"VOX",9
40,"40164",185,136,134,3,2,"VOX",27
50,"50113",584,505,495,3,10,"VOX",21
5,"5123",103,85,85,1,0,"VOX",9
25,"25154",118,94,94,0,0,"VOX",0
43,"43090",1169,749,742,2,7,"VOX",67
44,"44160",440,311,306,2,5,"VOX",28
43,"43016",3445,2628,2608,11,20,"VOX",76
21,"21060",12235,8053,7929,93,124,"VOX",1281
50,"50201",444,357,354,1,3,"VOX",59
3,"3138",3183,2390,2359,16,31,"VOX",316
8,"8178",451,389,388,3,1,"VOX",10
37,"37083",176,160,156,1,4,"VOX",27
40,"40165",74,56,54,1,2,"VOX",7
43,"43139",1999,1552,1539,10,13,"VOX",31
41,"41097",3135,2355,2308,11,47,"VOX",264
32,"32040",1418,1083,1075,3,8,"VOX",39
40,"40059",108,90,89,0,1,"VOX",5
47,"47182",1335,1034,1022,6,12,"VOX",184
43,"43017",116,98,98,1,0,"VOX",0
25,"25056",213,163,163,3,0,"VOX",1
20,"20048",184,120,120,2,0,"VOX",0
20,"20018",11218,8145,8109,41,36,"VOX",34
16,"16123",66,43,43,0,0,"VOX",6
47,"47215",48,44,44,0,0,"VOX",3
16,"16096",280,239,234,3,5,"VOX",34
15,"15043",4978,3631,3572,39,59,"VOX",168
3,"3076",8736,6571,6467,40,104,"VOX",769
18,"18135",4434,3169,3105,23,64,"VOX",310
49,"49069",327,211,207,0,4,"VOX",14
26,"26100",56,46,46,0,0,"VOX",9
37,"37201",237,188,187,1,1,"VOX",31
9,"9202",22,22,22,2,0,"VOX",0
16,"16097",139,121,120,1,1,"VOX",10
19,"19269",94,75,75,0,0,"VOX",6
33,"33036",11335,8356,8243,92,113,"VOX",985
50,"50116",170,132,131,0,1,"VOX",13
9,"9046",24,19,19,0,0,"VOX",2
39,"39069",1928,1650,1627,9,23,"VOX",163
40,"40061",65,50,48,2,2,"VOX",4
18,"18909",539,432,426,1,6,"VOX",77
41,"41026",4300,3561,3521,18,40,"VOX",186
18,"18100",7981,5900,5769,44,131,"VOX",652
31,"31170",45,37,36,2,1,"VOX",1
36,"36038",66806,50974,50429,507,545,"VOX",2941
37,"37317",288,240,238,2,2,"VOX",24
26,"26101",34,27,27,0,0,"VOX",2
42,"42119",145,90,89,6,1,"VOX",13
31,"31211",17,13,13,1,0,"VOX",1
5,"5243",81,63,62,1,1,"VOX",6
46,"46039",2121,1730,1698,19,32,"VOX",150
9,"9208",179,130,127,1,3,"VOX",15
36,"36039",15610,11844,11592,103,252,"VOX",525
34,"34076",545,475,473,2,2,"VOX",40
33,"33037",33247,23529,23210,297,319,"VOX",1590
50,"50058",63,54,53,2,1,"VOX",6
42,"42209",135,107,100,5,7,"VOX",8
3,"3017",379,321,311,1,10,"VOX",19
36,"36007",1618,1163,1133,7,30,"VOX",42
37,"37008",4222,3431,3393,19,38,"VOX",539
42,"42073",73,58,57,0,1,"VOX",10
47,"47218",979,757,745,5,12,"VOX",113
5,"5244",41,32,32,0,0,"VOX",0
43,"43019",1336,1020,1008,4,12,"VOX",28
28,"28023",5090,4252,4212,31,40,"VOX",791
20,"20052",1070,833,827,2,6,"VOX",7
34,"34079",1715,1421,1402,10,19,"VOX",255
33,"33008",1705,1285,1273,9,12,"VOX",177
2,"2036",95,75,75,0,0,"VOX",20
18,"18138",2482,1698,1668,20,30,"VOX",172
37,"37245",335,240,240,5,0,"VOX",15
50,"50149",33,25,25,1,0,"VOX",1
50,"50119",872,684,680,4,4,"VOX",117
9,"9051",163,134,133,1,1,"VOX",4
13,"13059",196,169,168,0,1,"VOX",26
31,"31214",87,66,64,0,2,"VOX",1
33,"33009",869,595,591,5,4,"VOX",67
48,"48078",37991,28582,28382,202,200,"VOX",556
8,"8262",6919,5090,5060,33,30,"VOX",176
5,"5246",52,39,39,0,0,"VOX",1
21,"21031",1172,807,764,5,43,"VOX",87
26,"26065",58,49,47,0,2,"VOX",4
37,"37282",194,148,146,1,2,"VOX",23
29,"29041",3599,2570,2532,22,38,"VOX",326
13,"13060",272,219,214,4,5,"VOX",29
31,"31094",105,78,76,0,2,"VOX",0
2,"2038",266,217,216,1,1,"VOX",34
5,"5012",121,100,97,0,3,"VOX",19
50,"50292",129,113,113,1,0,"VOX",30
50,"50207",93,68,67,2,1,"VOX",14
5,"5131",95,72,71,0,1,"VOX",18
42,"42035",741,537,523,7,14,"VOX",51
50,"50264",147,122,120,0,2,"VOX",14
44,"44169",310,250,245,4,5,"VOX",14
18,"18105",3822,2688,2650,12,38,"VOX",332
18,"18913",781,590,577,5,13,"VOX",69
28,"28056",914,715,703,4,12,"VOX",75
5,"5132",881,634,626,2,8,"VOX",81
37,"37322",2466,1764,1723,17,41,"VOX",231
42,"42216",26,20,20,1,0,"VOX",1
25,"25909",140,108,107,2,1,"VOX",0
28,"28026",6703,5422,5367,21,55,"VOX",1065
50,"50121",277,220,218,2,2,"VOX",26
8,"8105",9724,7557,7505,49,52,"VOX",307
35,"35016",300503,203470,201240,1598,2230,"VOX",14897
50,"50208",1748,1360,1344,11,16,"VOX",88
7,"7015",21976,14458,14297,205,161,"VOX",806
50,"50293",392,295,293,6,2,"VOX",34
31,"31096",101,85,84,3,1,"VOX",1
8,"8264",4535,3623,3613,13,10,"VOX",148
44,"44267",71,53,52,0,1,"VOX",2
17,"17121",229,184,184,1,0,"VOX",3
12,"12099",586,449,434,3,15,"VOX",60
22,"22103",676,520,517,6,3,"VOX",52
49,"49159",269,214,213,1,1,"VOX",19
40,"40070",148,110,107,1,3,"VOX",23
23,"23069",5262,4395,4329,15,66,"VOX",408
46,"46015",7477,5857,5808,33,49,"VOX",697
21,"21071",211,155,152,3,3,"VOX",21
4,"4003",17540,12174,12051,75,123,"VOX",2945
49,"49201",285,243,243,7,0,"VOX",8
10,"10040",434,321,314,1,7,"VOX",27
40,"40177",140,114,113,1,1,"VOX",14
44,"44172",295,220,218,4,2,"VOX",18
20,"20057",194,143,143,0,0,"VOX",0
45,"45137",1567,1155,1139,11,16,"VOX",154
26,"26109",73,66,66,0,0,"VOX",1
49,"49039",327,255,246,6,9,"VOX",41
25,"25134",603,492,490,1,2,"VOX",9
42,"42082",7,7,7,0,0,"VOX",0
48,"48053",904,738,728,5,10,"VOX",23
28,"28059",4515,3573,3542,12,31,"VOX",660
24,"24198",547,402,399,4,3,"VOX",24
46,"46137",242,200,200,3,0,"VOX",16
18,"18108",826,677,669,3,8,"VOX",68
23,"23070",3808,2598,2565,34,33,"VOX",338
21,"21073",1891,1191,1156,17,35,"VOX",96
9,"9387",111,91,89,0,2,"VOX",2
26,"26071",8662,6409,6288,52,121,"VOX",554
19,"19151",1083,785,770,5,15,"VOX",117
25,"25912",843,685,684,4,1,"VOX",23
22,"22234",745,587,578,11,9,"VOX",57
33,"33014",8771,6425,6368,51,57,"VOX",551
22,"22150",461,368,362,1,6,"VOX",53
8,"8179",611,496,493,2,3,"VOX",14
22,"22107",100,68,67,0,1,"VOX",5
8,"8267",6748,5389,5362,28,27,"VOX",254
9,"9221",492,413,409,0,4,"VOX",52
16,"16109",41,33,33,3,0,"VOX",3
3,"3055",5247,4042,3991,24,51,"VOX",666
42,"42003",66,55,55,0,0,"VOX",9
6,"6085",3410,2719,2663,28,56,"VOX",183
43,"43172",337,261,257,2,4,"VOX",6
8,"8109",208,184,183,0,1,"VOX",0
32,"32050",2280,1788,1775,19,13,"VOX",41
46,"46139",4512,3612,3567,25,45,"VOX",319
33,"33016",18904,14376,14235,168,141,"VOX",1734
15,"15086",2785,2015,1987,14,28,"VOX",119
13,"13069",618,488,469,3,19,"VOX",97
9,"9389",64,50,50,0,0,"VOX",10
24,"24161",295,223,219,0,4,"VOX",31
40,"40039",180,147,144,1,3,"VOX",12
8,"8268",971,746,737,3,9,"VOX",10
46,"46018",567,483,479,3,4,"VOX",66
37,"37216",294,248,247,2,1,"VOX",31
26,"26113",31,30,30,0,0,"VOX",3
34,"34238",305,261,260,2,1,"VOX",6
10,"10167",307,238,237,1,1,"VOX",15
50,"50038",1405,1112,1099,13,13,"VOX",67
47,"47227",55,46,46,0,0,"VOX",9
37,"37291",269,212,209,2,3,"VOX",47
9,"9115",91,71,66,2,5,"VOX",3
42,"42087",51,45,44,1,1,"VOX",5
19,"19155",66,56,56,0,0,"VOX",7
5,"5141",95,82,82,0,0,"VOX",5
26,"26114",74,62,60,0,2,"VOX",3
29,"29049",2926,2197,2165,9,32,"VOX",121
37,"37331",188,130,130,1,0,"VOX",23
14,"14071",884,641,634,2,7,"VOX",66
43,"43027",164,137,137,0,0,"VOX",4
47,"47039",166,134,134,0,0,"VOX",22
12,"12011",4582,3511,3431,27,80,"VOX",312
44,"44177",101,75,75,1,0,"VOX",3
24,"24205",981,744,732,8,12,"VOX",71
8,"8191",5270,4176,4162,19,14,"VOX",96
7,"7022",11615,8055,7934,91,121,"VOX",960
42,"42135",70,46,45,0,1,"VOX",4
18,"18044",164,113,112,0,1,"VOX",18
44,"44082",89,72,69,0,3,"VOX",11
31,"31105",1478,1203,1189,21,14,"VOX",170
5,"5260",97,81,80,1,1,"VOX",4
19,"19290",851,581,577,5,4,"VOX",111
9,"9227",113,93,91,0,2,"VOX",12
25,"25139",491,390,388,3,2,"VOX",1
47,"47135",82,69,67,1,2,"VOX",5
36,"36050",7650,5616,5506,48,110,"VOX",228
8,"8112",12935,9822,9765,74,57,"VOX",275
22,"22243",39,28,28,0,0,"VOX",2
17,"17160",14733,10833,10766,43,67,"VOX",297
13,"13075",199,157,157,0,0,"VOX",24
9,"9280",27,22,22,0,0,"VOX",0
5,"5024",198,142,139,2,3,"VOX",15
18,"18151",259,194,193,3,1,"VOX",16
37,"37107",10483,7732,7633,78,99,"VOX",844
43,"43078",843,653,644,4,9,"VOX",27
30,"30034",1075,852,831,4,21,"VOX",125
28,"28065",130679,106997,105975,762,1022,"VOX",11962
36,"36051",14315,10396,10223,70,173,"VOX",537
50,"50041",17,14,14,0,0,"VOX",1
45,"45147",590,506,496,2,10,"VOX",88
7,"7025",446,363,362,4,1,"VOX",27
22,"22039",805,667,662,5,5,"VOX",42
44,"44048",53,47,47,0,0,"VOX",11
19,"19248",76,56,56,0,0,"VOX",9
9,"9068",24,18,18,0,0,"VOX",1
47,"47011",557,478,476,5,2,"VOX",85
50,"50274",66,48,47,0,1,"VOX",5
47,"47231",4458,3677,3651,47,26,"VOX",582
38,"38052",1280,893,887,4,6,"VOX",66
32,"32055",1230,908,889,5,19,"VOX",39
6,"6091",3668,2839,2776,26,63,"VOX",339
19,"19162",67,50,48,0,2,"VOX",7
22,"22245",306,266,263,0,3,"VOX",17
40,"40080",48,39,39,0,0,"VOX",10
18,"18083",228,189,188,1,1,"VOX",26
42,"42093",35,29,29,2,0,"VOX",1
37,"37223",112,78,76,0,2,"VOX",9
9,"9231",59,43,43,1,0,"VOX",10
40,"40118",47,38,37,2,1,"VOX",4
1,"1043",2337,1669,1656,18,13,"VOX",72
42,"42144",423,338,336,4,2,"VOX",24
50,"50275",110,55,55,0,0,"VOX",13
5,"5148",23,17,17,0,0,"VOX",3
47,"47139",1004,790,776,2,14,"VOX",132
43,"43031",1446,1180,1178,7,2,"VOX",36
8,"8195",76,69,69,0,0,"VOX",1
39,"39084",874,718,712,4,6,"VOX",100
5,"5109",441,363,356,5,7,"VOX",33
18,"18188",1648,1295,1276,4,19,"VOX",94
40,"40081",119,96,95,2,1,"VOX",12
8,"8167",6048,4833,4822,48,11,"VOX",231
43,"43106",793,656,651,2,5,"VOX",19
5,"5265",79,59,59,0,0,"VOX",13
9,"9232",140,110,107,0,3,"VOX",7
34,"34902",123,98,98,4,0,"VOX",11
19,"19298",55,47,47,0,0,"VOX",6
37,"37225",99,90,86,1,4,"VOX",7
47,"47203",58,48,48,0,0,"VOX",12
22,"22042",117,96,95,1,1,"VOX",6
22,"22004",124,90,88,1,2,"VOX",19
48,"48093",888,720,715,2,5,"VOX",4
40,"40082",106,83,81,0,2,"VOX",9
42,"42015",32,23,23,1,0,"VOX",2
31,"31072",5320,4046,3958,40,88,"VOX",435
40,"40121",249,196,193,4,3,"VOX",22
37,"37339",308,227,226,0,1,"VOX",41
5,"5033",170,146,145,0,1,"VOX",12
1,"1002",8035,6227,6159,17,68,"VOX",152
25,"25077",440,331,330,1,1,"VOX",3
31,"31235",157,121,118,0,3,"VOX",2
8,"8039",402,334,334,2,0,"VOX",5
32,"32058",5225,3915,3857,35,58,"VOX",247
9,"9407",27,23,23,0,0,"VOX",3
46,"46057",474,319,313,1,6,"VOX",28
8,"8275",248,223,222,1,1,"VOX",3
27,"27047",1525,1026,1008,5,18,"VOX",38
22,"22006",272,206,201,2,5,"VOX",15
46,"46118",3670,2930,2894,25,36,"VOX",248
4,"4019",232,181,179,0,2,"VOX",10
39,"39087",41381,32335,31995,194,340,"VOX",2764
12,"12018",283,242,235,0,7,"VOX",16
13,"13084",841,683,673,6,10,"VOX",80
9,"9075",103,87,87,1,0,"VOX",20
44,"44153",1749,1264,1243,11,21,"VOX",136
24,"24173",908,679,667,3,12,"VOX",83
19,"19169",33,26,25,0,1,"VOX",2
26,"26125",2663,2042,2011,32,31,"VOX",189
45,"45156",3338,2805,2750,9,55,"VOX",365
8,"8276",233,180,180,0,0,"VOX",8
49,"49223",716,552,548,0,4,"VOX",26
23,"23085",2182,1733,1717,7,16,"VOX",107
3,"3098",518,412,400,1,12,"VOX",40
22,"22124",182,148,148,1,0,"VOX",22
25,"25148",219,168,168,1,0,"VOX",1
19,"19120",108,90,90,1,0,"VOX",23
37,"37117",1553,1245,1230,14,15,"VOX",176
8,"8040",11004,8468,8431,24,37,"VOX",265
4,"4020",286,218,217,1,1,"VOX",28
46,"46059",1240,1038,1030,3,8,"VOX",40
40,"40086",660,570,548,3,22,"VOX",85
49,"49100",286,210,208,2,2,"VOX",13
5,"5155",46,36,36,0,0,"VOX",4
41,"41046",3006,2464,2427,13,37,"VOX",138
40,"40193",221,163,161,5,2,"VOX",17
48,"48097",1316,979,976,4,3,"VOX",14
12,"12021",4377,3528,3473,23,55,"VOX",432
26,"26127",186,162,159,1,3,"VOX",8
16,"16126",729,622,616,5,6,"VOX",105
22,"22009",585,439,435,4,4,"VOX",28
46,"46060",9287,7184,7110,40,74,"VOX",865
37,"37118",120,93,90,2,3,"VOX",18
24,"24218",444,343,341,6,2,"VOX",41
23,"23087",11185,8500,8363,65,137,"VOX",749
31,"31118",158,120,116,2,4,"VOX",2
44,"44187",193,155,151,1,4,"VOX",19
29,"29061",1033,840,821,5,19,"VOX",110
42,"42020",4186,3027,2988,28,39,"VOX",233
4,"4023",120,95,95,2,0,"VOX",13
39,"39006",1721,1332,1315,3,17,"VOX",177
50,"50297",502835,394653,391387,3269,3266,"VOX",49030
33,"33059",4403,3007,2942,42,65,"VOX",324
37,"37345",150,134,133,0,1,"VOX",12
50,"50078",231,173,171,0,2,"VOX",9
5,"5905",222,165,164,1,1,"VOX",6
30,"30043",25401,20378,19992,131,386,"VOX",2483
36,"36061",8617,6498,6391,59,107,"VOX",331
37,"37157",78,64,64,0,0,"VOX",5
5,"5118",68,44,43,0,1,"VOX",4
39,"39062",1841,1511,1500,9,11,"VOX",217
50,"50139",322,257,256,0,1,"VOX",51
46,"46153",435,364,356,1,8,"VOX",28
16,"16005",232,175,172,0,3,"VOX",15
37,"37120",97,83,81,1,2,"VOX",8
43,"43111",2098,1496,1483,8,13,"VOX",74
47,"47051",321,274,272,1,2,"VOX",51
13,"13091",544,485,476,4,9,"VOX",30
17,"17079",65381,50872,50631,242,241,"VOX",1459
1,"1010",2315,1789,1770,14,19,"VOX",35
10,"10063",161,141,141,1,0,"VOX",12
34,"34110",82,66,65,0,1,"VOX",5
50,"50140",157,108,108,0,0,"VOX",24
40,"40161",35,28,26,0,2,"VOX",5
3,"3010",336,295,280,0,15,"VOX",22
39,"39064",1341,1103,1094,5,9,"VOX",106
28,"28046",4776,3944,3912,22,32,"VOX",684
25,"25254",711,576,571,5,5,"VOX",11
4,"4026",55,46,45,1,1,"VOX",7
22,"22013",275,218,217,6,1,"VOX",22
25,"25185",679,493,491,6,2,"VOX",5
27,"27053",501,384,373,1,11,"VOX",20
8,"8202",12843,10074,10025,57,49,"VOX",213
18,"18128",342,274,272,1,2,"VOX",29
16,"16277",109,82,82,0,0,"VOX",15
9,"9248",78,64,64,0,0,"VOX",7
46,"46155",993,785,772,2,13,"VOX",53
19,"19309",21,18,17,0,1,"VOX",3
13,"13093",3930,2960,2906,34,54,"VOX",385
12,"12026",835,656,639,4,17,"VOX",54
27,"27054",1145,907,890,5,17,"VOX",30
48,"48010",474,368,368,0,0,"VOX",1
30,"30016",152709,110165,109114,717,1051,"VOX",22059
22,"22014",233,185,182,3,3,"VOX",12
6,"6004",1549,1276,1257,6,19,"VOX",72
16,"16133",4387,3607,3544,38,63,"VOX",413
42,"42025",1134,824,813,6,11,"VOX",88
39,"39093",302,256,256,2,0,"VOX",25
18,"18027",2604,1902,1887,6,15,"VOX",134
32,"32066",551,399,396,1,3,"VOX",8
39,"39009",3307,2545,2526,11,19,"VOX",281
19,"19033",48,42,41,0,1,"VOX",5
25,"25088",95,85,83,0,2,"VOX",0
43,"43114",375,306,305,0,1,"VOX",0
6,"6005",1691,1246,1225,15,21,"VOX",128
26,"26135",153,123,123,1,0,"VOX",19
31,"31125",274,211,207,7,4,"VOX",4
1,"1016",421,236,229,3,7,"VOX",5
18,"18133",2109,1632,1618,12,14,"VOX",201
50,"50054",56,48,47,0,1,"VOX",9
44,"44100",175,142,141,2,1,"VOX",9
42,"42026",22,20,20,0,0,"VOX",0
37,"37351",269,234,233,6,1,"VOX",37
24,"24226",193,136,134,2,2,"VOX",16
16,"16280",165,130,128,3,2,"VOX",3
34,"34120",63965,50687,50117,471,570,"VOX",5577
6,"6105",604,406,400,2,6,"VOX",45
50,"50230",1134,853,846,6,7,"VOX",93
8,"8047",3737,2903,2876,16,27,"VOX",65
16,"16011",23,18,18,0,0,"VOX",2
49,"49233",85,58,58,0,0,"VOX",10
18,"18029",1813,1183,1169,9,14,"VOX",145
6,"6006",4494,3395,3325,24,70,"VOX",291
26,"26138",4545,3433,3374,27,59,"VOX",263
50,"50055",3627,2627,2571,41,56,"VOX",298
47,"47056",83,71,71,0,0,"VOX",15
37,"37004",24,19,19,0,0,"VOX",0
6,"6007",1433,1078,1071,5,7,"VOX",78
9,"9422",32,27,26,2,1,"VOX",6
10,"10070",669,516,513,1,3,"VOX",49
10,"10069",785,609,596,2,13,"VOX",48
5,"5001",179,153,152,2,1,"VOX",26
42,"42029",131,98,97,2,1,"VOX",8
25,"25191",321,248,244,3,4,"VOX",1
10,"10193",1412,1158,1145,4,13,"VOX",166
19,"19318",23,18,18,0,0,"VOX",4
28,"28158",678,547,540,1,7,"VOX",106
48,"48908",249,214,213,0,1,"VOX",1
31,"31128",341,255,250,3,5,"VOX",4
6,"6008",613,540,532,0,8,"VOX",22
12,"12121",1044,941,915,4,26,"VOX",85
47,"47057",273,204,200,0,4,"VOX",62
19,"19184",62,45,45,0,0,"VOX",6
22,"22019",175,151,151,0,0,"VOX",13
50,"50146",190,152,149,0,3,"VOX",19
18,"18032",242,180,178,2,2,"VOX",21
23,"23062",1418,1206,1190,5,16,"VOX",138
23,"23096",2571,2099,2063,9,36,"VOX",84
28,"28159",594,493,491,5,2,"VOX",84
1,"1019",148,121,121,0,0,"VOX",0
37,"37242",80,65,64,1,1,"VOX",10
23,"23097",6356,4509,4462,17,47,"VOX",927
25,"25093",629,489,487,4,2,"VOX",12
26,"26141",100,73,73,0,0,"VOX",3
17,"17177",567,459,457,2,2,"VOX",10
19,"19040",57,40,40,0,0,"VOX",7
43,"43043",3289,2624,2613,14,11,"VOX",136
10,"10073",721,553,546,4,7,"VOX",42
32,"32071",1378,963,954,7,9,"VOX",27
24,"24901",860,642,630,7,12,"VOX",65
16,"16904",451,386,383,3,3,"VOX",73
5,"5049",410,310,305,3,5,"VOX",52
37,"37280",71,41,40,0,1,"VOX",3
12,"12095",950,763,756,9,7,"VOX",81
31,"31131",907,719,712,8,7,"VOX",45
26,"26027",143,101,98,1,3,"VOX",0
44,"44198",181,151,145,1,6,"VOX",28
9,"9375",42,38,38,0,0,"VOX",5
44,"44106",153,115,111,2,4,"VOX",10
49,"49238",268,222,216,2,6,"VOX",35
48,"48911",388,323,322,3,1,"VOX",0
16,"16906",71,52,52,1,0,"VOX",5
50,"50291",93,78,77,1,1,"VOX",11
18,"18067",681,511,507,3,4,"VOX",71
8,"8155",6960,5427,5390,39,37,"VOX",239
8,"8051",18437,14951,14887,85,64,"VOX",473
50,"50059",754,599,589,6,10,"VOX",93
8,"8129",484,406,405,3,1,"VOX",9
9,"9377",629,494,488,4,6,"VOX",72
1,"1022",761,577,569,5,8,"VOX",19
5,"5052",87,77,77,0,0,"VOX",19
12,"12034",1400,1108,1080,7,28,"VOX",132
27,"27031",15212,10826,10649,125,177,"VOX",720
39,"39016",23868,19029,18839,108,190,"VOX",2179
37,"37091",164,108,108,3,0,"VOX",10
42,"42168",108,85,85,1,0,"VOX",4
9,"9262",158,137,136,1,1,"VOX",22
24,"24110",1154,895,880,5,15,"VOX",42
40,"40103",146,125,123,0,2,"VOX",15
47,"47061",243,203,197,3,6,"VOX",28
37,"37011",99,75,73,0,2,"VOX",4
46,"46164",12073,8987,8836,63,151,"VOX",1055
22,"22023",389,313,305,6,8,"VOX",36
17,"17181",3467,2664,2648,10,16,"VOX",82
27,"27032",3194,2268,2223,20,45,"VOX",130
28,"28163",429,361,345,4,16,"VOX",41
40,"40104",284,229,224,2,5,"VOX",38
48,"48913",1224,977,967,6,10,"VOX",14
19,"19326",2343,1789,1768,9,21,"VOX",437
44,"44009",799,621,611,7,10,"VOX",68
45,"45180",2834,2269,2239,11,30,"VOX",480
23,"23901",1139,946,934,3,12,"VOX",99
16,"16910",78,54,54,1,0,"VOX",4
2,"2039",952,798,789,9,9,"VOX",62
46,"46074",2678,2158,2135,13,23,"VOX",237
25,"25200",323,253,252,0,1,"VOX",1
44,"44201",478,417,412,3,5,"VOX",36
23,"23002",17399,13575,13341,97,234,"VOX",1587
22,"22024",222,179,177,1,2,"VOX",8
31,"31136",452,337,333,5,4,"VOX",17
4,"4043",511,423,421,3,2,"VOX",88
40,"40105",44,39,38,0,1,"VOX",4
50,"50062",1863,1441,1416,9,25,"VOX",195
6,"6081",1042,825,811,4,14,"VOX",35
37,"37361",81,63,61,0,2,"VOX",5
40,"40106",183,153,151,2,2,"VOX",8
42,"42037",29,19,18,0,1,"VOX",1
1,"1030",143,118,117,1,1,"VOX",0
44,"44203",9,9,9,0,0,"VOX",2
22,"22025",1035,764,755,24,9,"VOX",77
48,"48021",1336,990,983,4,7,"VOX",3
25,"25004",575,470,467,2,3,"VOX",11
26,"26148",150,128,124,1,4,"VOX",14
2,"2078",899,705,691,3,14,"VOX",107
40,"40210",98,70,70,0,0,"VOX",16
42,"42174",179,132,128,1,4,"VOX",5
40,"40107",92,76,74,0,2,"VOX",18
39,"39019",2229,1785,1751,15,34,"VOX",184
24,"24115",53267,39733,39172,433,561,"VOX",3321
50,"50153",922,705,704,6,1,"VOX",77
31,"31017",370,288,286,3,2,"VOX",8
6,"6016",2943,2283,2247,24,36,"VOX",177
44,"44075",326,275,263,0,12,"VOX",41
19,"19331",2643,2043,2009,11,34,"VOX",310
14,"14006",1321,1155,1127,4,28,"VOX",106
9,"9437",270,227,224,2,3,"VOX",26
26,"26034",612,509,497,5,12,"VOX",32
26,"26149",45,36,36,0,0,"VOX",0
44,"44012",310,240,238,5,2,"VOX",27
23,"23904",2604,1727,1701,7,26,"VOX",209
23,"23071",1720,1348,1330,6,18,"VOX",219
31,"31019",1808,1392,1378,18,14,"VOX",40
8,"8292",1062,835,831,3,4,"VOX",15
50,"50154",116,98,98,0,0,"VOX",22
26,"26150",100,83,83,0,0,"VOX",6
14,"14038",32692,24015,23679,213,336,"VOX",4123
32,"32077",1104,820,815,10,5,"VOX",35
4,"4047",2230,1806,1785,8,21,"VOX",175
15,"15022",5574,3846,3798,41,48,"VOX",170
44,"44205",634,444,426,9,18,"VOX",42
16,"16025",25,21,21,0,0,"VOX",3
1,"1033",656,533,525,1,8,"VOX",10
5,"5177",139,117,117,0,0,"VOX",8
24,"24118",104,66,66,0,0,"VOX",1
23,"23006",4582,3607,3543,32,64,"VOX",182
25,"25204",1191,936,930,5,6,"VOX",21
14,"14008",2785,1942,1910,15,32,"VOX",202
7,"7020",3692,2833,2808,42,25,"VOX",212
31,"31142",1390,994,982,8,12,"VOX",56
7,"7053",1164,956,948,4,8,"VOX",76
50,"50066",2835,2199,2177,19,22,"VOX",521
19,"19335",56,45,43,0,2,"VOX",1
16,"16067",119,96,93,2,3,"VOX",11
8,"8057",61,50,50,0,0,"VOX",0
12,"12103",90,75,70,1,5,"VOX",14
5,"5178",345,287,283,1,4,"VOX",55
25,"25103",136,103,102,2,1,"VOX",4
28,"28169",1553,1280,1273,15,7,"VOX",296
40,"40110",316,254,253,2,1,"VOX",23
45,"45051",1634,1336,1290,9,46,"VOX",256
49,"49126",273,161,160,1,1,"VOX",17
10,"10086",303,249,244,3,5,"VOX",28
37,"37019",140,118,117,1,1,"VOX",17
37,"37103",414,309,309,4,0,"VOX",49
6,"6020",1739,1420,1387,5,33,"VOX",105
4,"4049",5603,4104,4054,27,50,"VOX",604
5,"5179",199,181,175,0,6,"VOX",34
40,"40111",52,44,44,0,0,"VOX",9
47,"47165",6822,5456,5296,62,160,"VOX",1159
1,"1036",14772,10850,10746,69,104,"VOX",206
12,"12043",560,460,450,2,10,"VOX",75
17,"17006",1186,880,878,10,2,"VOX",10
31,"31023",7609,6371,6319,70,52,"VOX",379
19,"19200",64,56,56,0,0,"VOX",10
18,"18149",5401,4290,4212,28,78,"VOX",718
50,"50243",311,252,247,1,5,"VOX",38
4,"4051",406,343,339,1,4,"VOX",40
34,"34001",39,32,32,3,0,"VOX",3
42,"42183",106,83,83,1,0,"VOX",9
37,"37369",125,95,93,0,2,"VOX",15
12,"12044",452,403,400,4,3,"VOX",29
8,"8218",8104,6419,6389,34,30,"VOX",199
9,"9119",45,26,26,0,0,"VOX",3
5,"5063",31,27,27,0,0,"VOX",2
6,"6022",2634,2156,2112,7,44,"VOX",106
45,"45054",3831,2980,2944,11,36,"VOX",449
31,"31146",29,25,25,1,0,"VOX",0
47,"47071",398,345,341,2,4,"VOX",53
22,"22037",112,96,96,0,0,"VOX",12
46,"46082",4958,3801,3759,21,42,"VOX",470
2,"2086",2426,1738,1728,8,10,"VOX",147
14,"14073",2772,2124,2069,18,55,"VOX",223
18,"18045",1060,748,737,10,11,"VOX",121
24,"24044",152,116,114,0,2,"VOX",8
50,"50069",67,44,44,0,0,"VOX",3
38,"38051",7326,5418,5352,27,66,"VOX",368
39,"39025",8703,6954,6854,39,100,"VOX",776
37,"37258",137,99,98,1,1,"VOX",3
49,"49129",821,628,616,5,12,"VOX",51
6,"6123",4512,3358,3266,28,92,"VOX",253
9,"9281",135,104,102,1,2,"VOX",17
34,"34004",5533,4345,4286,41,59,"VOX",446
8,"8165",1664,1315,1311,9,4,"VOX",38
19,"19009",247,190,187,0,3,"VOX",26
37,"37023",1586,1316,1298,12,18,"VOX",210
7,"7058",2857,2258,2233,18,25,"VOX",232
12,"12046",182,161,161,1,0,"VOX",16
47,"47042",50,41,39,0,2,"VOX",4
26,"26160",732,578,574,4,4,"VOX",65
31,"31906",2683,2040,2023,28,17,"VOX",126
17,"17009",4051,3263,3248,14,15,"VOX",42
41,"41068",13936,10692,10530,73,162,"VOX",855
19,"19204",149,112,112,1,0,"VOX",22
46,"46175",428,367,354,3,13,"VOX",28
25,"25111",113,90,89,0,1,"VOX",2
28,"28175",935,775,767,3,8,"VOX",163
22,"22002",106,95,94,0,1,"VOX",10
4,"4055",366,315,314,3,1,"VOX",23
47,"47074",141,122,122,2,0,"VOX",9
8,"8140",4778,3756,3737,19,19,"VOX",92
32,"32056",1520,1125,1116,6,9,"VOX",19
9,"9125",552,424,421,3,3,"VOX",44
37,"37110",103,84,82,0,2,"VOX",22
26,"26161",8,7,7,0,0,"VOX",0
22,"22041",152,121,119,2,2,"VOX",12
8,"8063",467,406,405,3,1,"VOX",3
46,"46085",11075,8106,8011,54,95,"VOX",943
31,"31908",1064,810,803,2,7,"VOX",12
21,"21010",14976,9475,9352,145,123,"VOX",1178
44,"44212",41,32,32,0,0,"VOX",6
6,"6026",815,661,653,5,8,"VOX",35
32,"32001",5105,3760,3715,37,45,"VOX",155
26,"26162",112,95,94,0,1,"VOX",2
12,"12049",421,339,329,2,10,"VOX",29
48,"48032",5773,4504,4476,5,28,"VOX",33
31,"31152",1270,937,929,19,8,"VOX",48
19,"19210",18,18,17,0,1,"VOX",0
26,"26045",11,11,11,0,0,"VOX",0
5,"5149",100,82,79,0,3,"VOX",6
47,"47141",118,103,102,0,1,"VOX",12
20,"20007",327,235,230,2,5,"VOX",0
8,"8300",5892,4912,4880,24,32,"VOX",215
44,"44022",463,342,326,6,16,"VOX",19
34,"34151",147,99,97,1,2,"VOX",7
46,"46056",175,156,156,3,0,"VOX",5
19,"19166",152,125,122,0,3,"VOX",24
16,"16162",39,31,30,0,1,"VOX",8
22,"22043",93,68,67,1,1,"VOX",9
42,"42054",19,15,15,0,0,"VOX",1
7,"7062",7902,4889,4828,58,61,"VOX",454
8,"8301",49135,38575,38398,272,177,"VOX",1822
6,"6028",4109,3613,3538,17,75,"VOX",266
5,"5073",289,239,238,0,1,"VOX",25
50,"50164",388,279,272,2,7,"VOX",45
42,"42192",38,26,26,1,0,"VOX",2
34,"34012",340,271,265,2,6,"VOX",29
17,"17102",548,439,435,3,4,"VOX",5
47,"47077",237,187,183,2,4,"VOX",32
37,"37228",325,278,273,0,5,"VOX",24
17,"17013",2774,2180,2173,15,7,"VOX",74
1,"1049",132,100,100,1,0,"VOX",2
22,"22044",234,184,183,3,1,"VOX",11
46,"46088",150,129,127,0,2,"VOX",6
16,"16040",85,72,72,1,0,"VOX",13
29,"29058",1538,1079,1062,5,17,"VOX",177
16,"16270",156,124,124,1,0,"VOX",21
26,"26165",337,289,284,0,5,"VOX",36
47,"47173",885,708,704,7,4,"VOX",72
49,"49017",259,196,195,0,1,"VOX",17
25,"25115",801,638,637,4,1,"VOX",5
26,"26166",147,136,136,2,0,"VOX",12
40,"40123",141,108,104,1,4,"VOX",6
1,"1004",1356,1007,998,3,9,"VOX",20
1,"1051",3558,2448,2433,14,15,"VOX",33
10,"10099",559,412,401,3,11,"VOX",33
45,"45065",261,207,205,2,2,"VOX",21
24,"24133",356,267,267,4,0,"VOX",53
26,"26013",323,258,256,1,2,"VOX",15
16,"16041",339,271,267,2,4,"VOX",42
43,"43133",5605,4202,4168,21,34,"VOX",166
8,"8303",256,215,213,1,2,"VOX",3
17,"17015",12819,10133,10078,38,55,"VOX",95
6,"6031",461,316,301,1,15,"VOX",34
46,"46253",114,85,85,2,0,"VOX",8
16,"16042",1108,948,938,3,10,"VOX",75
25,"25118",327,241,239,2,2,"VOX",2
47,"47080",35,23,21,0,2,"VOX",3
9,"9133",38,33,33,0,0,"VOX",8
19,"19073",16,13,13,0,0,"VOX",6
43,"43134",273,224,223,5,1,"VOX",13
47,"47175",6704,5296,5222,52,74,"VOX",708
9,"9134",220,155,151,1,4,"VOX",7
34,"34157",2364,1881,1846,13,35,"VOX",297
48,"48037",684,537,531,4,6,"VOX",5
42,"42058",102,84,84,0,0,"VOX",4
37,"37380",56,46,45,1,1,"VOX",10
18,"18054",838,649,648,8,1,"VOX",112
37,"37033",92,69,69,2,0,"VOX",14
26,"26169",68,61,61,2,0,"VOX",7
28,"28181",20669,17314,17205,101,109,"VOX",3444
19,"19217",42,38,38,0,0,"VOX",6
22,"22172",520,412,407,3,5,"VOX",75
37,"37381",139,97,95,1,2,"VOX",17
15,"15037",4031,2700,2677,13,23,"VOX",124
28,"28151",3251,2483,2450,11,33,"VOX",382
31,"31159",1105,880,871,3,9,"VOX",23
42,"42059",20,13,13,0,0,"VOX",1
12,"12056",257,218,216,1,2,"VOX",22
19,"19173",51,47,47,0,0,"VOX",13
26,"26129",936,770,759,1,11,"VOX",61
42,"42155",142,92,92,0,0,"VOX",15
50,"50169",336,261,259,2,2,"VOX",22
23,"23021",517,446,440,0,6,"VOX",39
18,"18057",5540,4306,4246,30,60,"VOX",747
4,"4064",2879,2196,2179,12,17,"VOX",312
31,"31039",92,72,70,1,2,"VOX",0
8,"8305",27533,21656,21539,96,117,"VOX",518
9,"9464",33,27,27,0,0,"VOX",7
17,"17199",6955,5328,5308,23,20,"VOX",154
31,"31040",173,139,139,1,0,"VOX",3
9,"9304",192,164,161,2,3,"VOX",30
23,"23024",12224,9586,9329,46,257,"VOX",1026
24,"24141",101,78,78,0,0,"VOX",16
28,"28015",20440,17084,16953,103,131,"VOX",3342
7,"7003",12374,7550,7442,51,108,"VOX",920
47,"47148",423,342,339,2,3,"VOX",51
12,"12025",121,102,99,0,3,"VOX",4
8,"8280",95,78,78,1,0,"VOX",0
8,"8228",288,239,239,2,0,"VOX",3
21,"21020",353,242,236,3,6,"VOX",23
25,"25122",1925,1505,1497,23,8,"VOX",15
46,"46257",5428,4237,4190,23,47,"VOX",243
22,"22050",93,79,79,2,0,"VOX",14
49,"49024",637,465,461,2,4,"VOX",54
18,"18164",1794,1225,1205,9,20,"VOX",179
28,"28016",78,62,61,1,1,"VOX",11
24,"24021",1602,1211,1194,7,17,"VOX",101
17,"17110",1329,1064,1054,5,10,"VOX",32
44,"44222",122,102,102,1,0,"VOX",13
29,"29088",2694,2019,1951,31,68,"VOX",195
12,"12058",64,56,56,0,0,"VOX",6
4,"4067",520,387,379,1,8,"VOX",15
8,"8071",241,200,200,0,0,"VOX",2
50,"50171",96,78,78,1,0,"VOX",14
50,"50081",491,390,384,5,6,"VOX",42
25,"25123",189,151,151,0,0,"VOX",0
37,"37038",751,607,592,4,15,"VOX",51
15,"15040",2675,2011,1979,20,32,"VOX",123
47,"47085",16381,12697,12540,129,157,"VOX",1723
8,"8150",251,211,211,0,0,"VOX",4
9,"9140",115,88,88,2,0,"VOX",5
28,"28903",35344,30490,30287,201,203,"VOX",4059
17,"17021",122,98,98,0,0,"VOX",0
41,"41079",9293,7137,6979,80,158,"VOX",878
25,"25124",157,114,114,0,0,"VOX",1
34,"34165",59,51,50,1,1,"VOX",5
8,"8308",137,118,118,0,0,"VOX",0
42,"42204",54,45,43,2,2,"VOX",7
4,"4069",4757,3633,3588,25,45,"VOX",490
47,"47181",165,143,143,0,0,"VOX",22
49,"49026",201,163,162,0,1,"VOX",10
42,"42065",23,18,18,2,0,"VOX",3
24,"24023",262,208,206,3,2,"VOX",29
37,"37039",282,222,222,1,0,"VOX",30
44,"44224",21,15,15,0,0,"VOX",1
6,"6039",1807,1506,1474,13,32,"VOX",46
24,"24024",638,463,452,8,11,"VOX",68
17,"17022",7008,5386,5354,22,32,"VOX",104
6,"6138",1013,783,767,3,16,"VOX",41
45,"45077",562,442,437,0,5,"VOX",73
15,"15042",2955,2057,2002,16,55,"VOX",86
40,"40131",50,47,47,0,0,"VOX",4
37,"37276",126,101,101,0,0,"VOX",10
47,"47087",368,292,288,3,4,"VOX",27
42,"42068",78,62,61,2,1,"VOX",9
11,"11007",18020,11346,11152,176,194,"VOX",1141
24,"24025",289,234,226,4,8,"VOX",31
40,"40025",128,109,106,1,3,"VOX",6
19,"19225",851,664,650,3,14,"VOX",147
34,"34029",659,557,551,5,6,"VOX",91
6,"6139",502,429,421,5,8,"VOX",43
9,"9480",109,87,85,1,2,"VOX",13
19,"19182",39,32,32,0,0,"VOX",7
31,"31168",241,203,199,2,4,"VOX",9
44,"44034",126,97,97,2,0,"VOX",9
26,"26177",301,250,246,2,4,"VOX",27
31,"31047",236,181,179,5,2,"VOX",3
17,"17024",285,228,227,0,1,"VOX",5
12,"12063",44,37,37,1,0,"VOX",0
22,"22055",310,258,255,2,3,"VOX",36
18,"18064",366,307,306,0,1,"VOX",41
6,"6141",1688,1308,1291,16,17,"VOX",83
19,"19089",25,19,19,1,0,"VOX",2
29,"29003",922,740,727,3,13,"VOX",61
39,"39041",1767,1437,1417,18,20,"VOX",159
45,"45081",19138,15010,14829,110,181,"VOX",3071
3,"3109",2976,2375,2345,11,30,"VOX",233
19,"19321",34,29,29,0,0,"VOX",3
47,"47184",541,447,441,0,6,"VOX",67
49,"49030",80,66,62,0,4,"VOX",9
42,"42071",163,111,108,2,3,"VOX",10
43,"43141",105,86,86,0,0,"VOX",3
21,"21028",370,300,293,1,7,"VOX",14
17,"17025",1170,972,967,6,5,"VOX",12
34,"34033",17,15,15,0,0,"VOX",2
37,"37044",450,342,335,6,7,"VOX",36
40,"40135",269,224,221,1,3,"VOX",38
37,"37045",28,19,18,0,1,"VOX",3
22,"22057",364,286,284,3,2,"VOX",11
9,"9152",248,197,195,0,2,"VOX",21
48,"48077",3376,2656,2647,11,9,"VOX",38
18,"18066",2108,1537,1525,9,12,"VOX",124
31,"31171",669,516,502,3,14,"VOX",12
12,"12123",43,35,34,1,1,"VOX",6
39,"39014",901,709,704,5,5,"VOX",76
31,"31172",365,287,275,4,12,"VOX",9
45,"45083",551,470,465,5,5,"VOX",117
16,"16056",453,323,321,1,2,"VOX",76
22,"22021",1884,1465,1450,13,15,"VOX",141
32,"32015",830,543,541,4,2,"VOX",25
19,"19230",548,437,430,1,7,"VOX",86
6,"6044",29204,21778,21492,203,286,"VOX",2370
43,"43142",1083,850,842,8,8,"VOX",14
43,"43118",425,357,356,0,1,"VOX",6
25,"25194",415,325,325,3,0,"VOX",2
18,"18034",486,376,374,4,2,"VOX",39
16,"16188",77,56,56,0,0,"VOX",5
48,"48048",543,421,419,1,2,"VOX",1
46,"46102",19635,15330,15207,95,123,"VOX",1285
3,"3019",15465,12156,11988,80,168,"VOX",1665
9,"9902",446,345,341,0,4,"VOX",31
44,"44229",143,110,108,4,2,"VOX",9
29,"29096",2756,2061,2018,21,43,"VOX",127
43,"43069",178,146,146,0,0,"VOX",2
6,"6012",3233,2515,2492,15,23,"VOX",247
19,"19232",58,49,49,0,0,"VOX",9
6,"6111",493,374,370,2,4,"VOX",18
9,"9903",3139,2379,2352,27,27,"VOX",301
42,"42076",201,157,151,0,6,"VOX",7
45,"45086",493,373,368,0,5,"VOX",76
31,"31175",64,50,50,0,0,"VOX",0
25,"25032",67,53,53,0,0,"VOX",0
46,"46195",1982,1562,1554,2,8,"VOX",172
32,"32017",1202,821,815,6,6,"VOX",61
36,"36009",4445,3081,2997,26,84,"VOX",120
9,"9160",80,64,64,1,0,"VOX",13
34,"34037",276,224,223,2,1,"VOX",34
6,"6046",1250,1010,995,7,15,"VOX",85
25,"25131",402,321,320,1,1,"VOX",5
29,"29098",1235,953,935,12,18,"VOX",60
19,"19097",14,13,13,0,0,"VOX",2
19,"19233",82,72,72,1,0,"VOX",8
6,"6047",837,677,669,6,8,"VOX",42
46,"46104",1891,1515,1481,17,34,"VOX",120
39,"39046",1343,1002,988,8,14,"VOX",80
17,"17120",820,604,598,3,6,"VOX",16
9,"9905",389,308,303,2,5,"VOX",28
19,"19234",45,32,32,0,0,"VOX",4
50,"50090",134,108,108,0,0,"VOX",21
22,"22062",154,115,115,1,0,"VOX",10
46,"46196",140,115,114,0,1,"VOX",13
6,"6048",824,714,702,2,12,"VOX",72
5,"5095",236,193,191,0,2,"VOX",51
18,"18070",289,224,222,3,2,"VOX",24
19,"19329",59,49,49,0,0,"VOX",6
44,"44231",36,33,32,0,1,"VOX",2
45,"45090",368,287,286,1,1,"VOX",52
2,"2004",606,504,499,5,5,"VOX",63
40,"40141",833,644,627,5,17,"VOX",86
29,"29010",1632,1372,1319,4,53,"VOX",115
49,"49037",177,146,143,1,3,"VOX",12
22,"22193",269,220,217,2,3,"VOX",20
9,"9009",158,139,137,4,2,"VOX",25
29,"29100",2378,1711,1686,22,25,"VOX",114
19,"19237",40,33,33,0,0,"VOX",6
9,"9907",1507,1198,1174,16,24,"VOX",184
29,"29011",2871,1955,1926,11,29,"VOX",178
4,"4081",346,272,271,2,1,"VOX",27
44,"44234",70,57,57,1,0,"VOX",7
15,"15052",4104,2928,2878,30,50,"VOX",154
19,"19103",251,218,216,1,2,"VOX",28
48,"48052",1567,1309,1300,4,9,"VOX",12
50,"50092",300,234,230,1,4,"VOX",27
6,"6116",1512,1158,1144,3,14,"VOX",90
9,"9908",427,294,290,6,4,"VOX",40
41,"41089",6629,4904,4814,48,90,"VOX",471
21,"21036",203,147,143,0,4,"VOX",6
24,"24158",296,226,220,2,6,"VOX",44
34,"34181",422,324,321,3,3,"VOX",23
3,"3024",3948,3210,3164,14,46,"VOX",408
46,"46107",1849,1501,1480,5,21,"VOX",139
28,"28102",891,681,666,4,15,"VOX",80
42,"42083",26,22,22,0,0,"VOX",0
2,"2007",1013,820,813,6,7,"VOX",54
17,"17032",1742,1235,1224,6,11,"VOX",14
27,"27005",2551,1908,1868,26,40,"VOX",113
22,"22064",162,121,121,0,0,"VOX",11
2,"2044",1049,746,737,5,9,"VOX",85
47,"47097",307,258,256,4,2,"VOX",23
37,"37176",130,103,103,1,0,"VOX",11
42,"42084",20,16,16,0,0,"VOX",1
6,"6051",1543,1206,1188,3,18,"VOX",166
41,"41007",12438,9009,8775,135,234,"VOX",931
5,"5100",267,217,212,1,5,"VOX",27
49,"49041",414,309,307,4,2,"VOX",29
50,"50094",1518,1172,1155,20,17,"VOX",105
47,"47098",556,480,475,4,5,"VOX",75
18,"18181",202,150,148,0,2,"VOX",42
45,"45095",660,528,519,3,9,"VOX",87
37,"37366",41,30,30,0,0,"VOX",4
22,"22067",71,52,52,0,0,"VOX",3
37,"37290",134,113,112,0,1,"VOX",12
34,"34046",44,31,31,0,0,"VOX",3
2,"2009",19456,15229,15007,152,222,"VOX",1333
43,"43124",472,379,373,1,6,"VOX",6
46,"46109",6174,4763,4639,30,124,"VOX",494
27,"27007",2756,2148,2084,29,64,"VOX",107
26,"26073",94,72,68,0,4,"VOX",1
42,"42086",33,21,19,0,2,"VOX",5
15,"15055",4485,3097,3057,39,40,"VOX",160
22,"22200",239,181,178,0,3,"VOX",14
19,"19107",315,273,270,2,3,"VOX",35
50,"50270",38,32,30,1,2,"VOX",0
50,"50095",12136,9020,8928,99,92,"VOX",1050
9,"9441",92,81,81,1,0,"VOX",20
39,"39051",73,65,64,0,1,"VOX",8
4,"4086",1643,1226,1209,6,17,"VOX",152
2,"2010",1798,1494,1469,6,25,"VOX",176
8,"8163",19497,14616,14548,67,68,"VOX",756
20,"20031",183,125,125,2,0,"VOX",0
16,"16070",28,26,26,1,0,"VOX",1
31,"31185",470,335,332,6,3,"VOX",2
8,"8016",1812,1454,1448,6,6,"VOX",30
22,"22201",266,192,192,2,0,"VOX",6
21,"21041",112810,77371,76488,900,883,"VOX",10449
31,"31064",1387,1174,1163,9,11,"VOX",40
26,"26075",321,266,265,0,1,"VOX",22
13,"13027",3223,2343,2309,22,34,"VOX",270
10,"10006",1230,1006,995,8,11,"VOX",110
43,"43150",1238,1034,1026,6,8,"VOX",23
19,"19109",33,30,30,1,0,"VOX",8
9,"9174",781,625,608,3,17,"VOX",56
8,"8244",6041,4994,4970,33,24,"VOX",129
9,"9018",24647,18982,18715,184,267,"VOX",1993
17,"17129",144,120,120,1,0,"VOX",5
34,"34050",185,156,156,2,0,"VOX",13
26,"26076",116,93,91,0,2,"VOX",10
9,"9339",126,105,105,1,0,"VOX",8
10,"10007",630,513,507,4,6,"VOX",56
32,"32025",1013,773,761,7,12,"VOX",26
50,"50272",13174,10143,10042,103,101,"VOX",1568
22,"22072",194,141,140,0,1,"VOX",15
44,"44239",22,19,19,0,0,"VOX",3
42,"42089",57,48,48,1,0,"VOX",2
19,"19246",42,30,30,0,0,"VOX",1
12,"12045",328,275,271,2,4,"VOX",10
29,"29018",1996,1523,1481,11,42,"VOX",128
3,"3091",241,201,196,0,5,"VOX",13
27,"27011",2358,1582,1558,12,24,"VOX",81
43,"43152",434,357,356,0,1,"VOX",8
19,"19247",142,118,117,2,1,"VOX",6
46,"46114",574,457,452,1,5,"VOX",64
50,"50099",3042,2299,2265,20,34,"VOX",284
34,"34052",167,144,143,2,1,"VOX",8
4,"4053",12500,9437,9298,56,139,"VOX",1321
31,"31027",814,623,610,8,13,"VOX",3
44,"44148",76,64,63,0,1,"VOX",5
39,"39054",4528,3614,3575,23,39,"VOX",374
50,"50188",27,24,24,0,0,"VOX",2
32,"32083",821,592,587,7,5,"VOX",24
45,"45103",362,306,299,0,7,"VOX",26
10,"10010",2213,1499,1470,6,29,"VOX",163
40,"40151",43,32,32,0,0,"VOX",6
22,"22075",119,87,87,1,0,"VOX",6
31,"31068",2816,2194,2136,17,58,"VOX",135
21,"21045",227,181,178,1,3,"VOX",7
37,"37184",290,199,195,0,4,"VOX",22
10,"10011",532,439,435,3,4,"VOX",38
23,"23012",4018,2835,2804,15,31,"VOX",453
40,"40045",120,92,92,1,0,"VOX",12
25,"25244",362,296,294,2,2,"VOX",3
34,"34053",200,176,171,5,5,"VOX",25
45,"45059",1696,1442,1415,4,27,"VOX",260
19,"19163",60,46,44,0,2,"VOX",4
43,"43129",4611,3528,3495,21,33,"VOX",141
27,"27013",3684,2997,2935,26,62,"VOX",91
22,"22076",288,228,226,1,2,"VOX",17
38,"38023",125528,88323,87456,598,867,"VOX",4712
46,"46025",2455,2002,1981,6,21,"VOX",197
44,"44243",27,24,23,0,1,"VOX",5
40,"40152",748,637,620,6,17,"VOX",70
27,"27014",3162,2181,2139,17,42,"VOX",139
18,"18084",4458,3467,3417,17,50,"VOX",627
34,"34056",1949,1537,1511,7,26,"VOX",144
25,"25044",178,145,144,6,1,"VOX",1
43,"43080",227,195,195,0,0,"VOX",3
12,"12080",1900,1604,1575,10,29,"VOX",118
46,"46116",13608,10792,10731,76,61,"VOX",1403
49,"49053",915,726,715,5,11,"VOX",88
37,"37187",555,437,433,0,4,"VOX",71
19,"19116",12,9,9,1,0,"VOX",0
37,"37375",673,583,573,4,10,"VOX",39
6,"6060",5723,4401,4323,31,78,"VOX",307
29,"29023",2290,1569,1550,3,19,"VOX",364
25,"25143",84,72,71,0,1,"VOX",0
8,"8248",5616,4378,4365,32,13,"VOX",108
46,"46208",1070,875,866,2,9,"VOX",80
48,"48033",204,160,159,1,1,"VOX",2
23,"23049",1747,1321,1305,11,16,"VOX",71
50,"50192",233,189,183,0,6,"VOX",37
9,"9350",430,340,339,9,1,"VOX",51
37,"37069",971,721,704,2,17,"VOX",107
4,"4094",209,156,154,0,2,"VOX",39
9,"9026",371,305,303,2,2,"VOX",54
44,"44052",74,50,49,0,1,"VOX",6
41,"41015",5401,3984,3889,50,95,"VOX",603
27,"27016",6973,5139,5064,66,75,"VOX",294
26,"26083",354,295,291,1,4,"VOX",21
43,"43082",351,303,297,1,6,"VOX",4
31,"31195",171,125,125,2,0,"VOX",2
44,"44216",26922,20603,20279,204,324,"VOX",2517
2,"2019",2368,2009,1975,5,34,"VOX",311
5,"5113",62,49,49,0,0,"VOX",3
13,"13038",1604,1251,1216,14,35,"VOX",82
34,"34206",814,668,660,13,8,"VOX",71
37,"37189",114,88,88,2,0,"VOX",10
10,"10016",327,260,259,1,1,"VOX",22
31,"31155",241,181,180,3,1,"VOX",3
27,"27017",961,667,654,1,13,"VOX",20
8,"8250",7182,5461,5421,38,40,"VOX",254
10,"10139",95,78,77,1,1,"VOX",3
25,"25047",972,784,781,8,3,"VOX",11
37,"37190",193,144,144,1,0,"VOX",8
5,"5114",1264,1061,1030,3,31,"VOX",136
18,"18051",1090,800,795,13,5,"VOX",75
39,"39060",6693,5459,5394,29,65,"VOX",540
39,"39059",7577,5978,5916,47,62,"VOX",559
11,"11033",21702,14645,14436,190,209,"VOX",2084
23,"23052",1108,949,931,8,18,"VOX",42
6,"6064",850,658,647,2,11,"VOX",29
16,"16084",50,36,32,0,4,"VOX",5
17,"17044",6930,5514,5493,26,21,"VOX",91
37,"37072",145,136,134,3,2,"VOX",34
5,"5230",65,58,58,4,0,"VOX",9
42,"42100",31,27,27,0,0,"VOX",1
19,"19257",3283,2448,2424,21,24,"VOX",293
18,"18088",1530,1152,1142,0,10,"VOX",69
37,"37305",218,180,178,3,2,"VOX",21
19,"19258",84,69,66,1,3,"VOX",8
40,"40158",15,13,13,1,0,"VOX",2
5,"5116",96,77,75,0,2,"VOX",11
27,"27019",8189,6148,6039,94,109,"VOX",358
34,"34061",96,77,77,2,0,"VOX",30
23,"23053",9449,6379,6325,25,54,"VOX",272
31,"31199",141,96,94,0,2,"VOX",0
30,"30012",9069,7397,7266,53,131,"VOX",713
46,"46121",111,96,94,2,2,"VOX",11
40,"40159",132,101,101,0,0,"VOX",23
6,"6903",2027,1607,1594,16,13,"VOX",196
46,"46030",796,653,633,7,20,"VOX",54
39,"39061",3488,2833,2798,18,35,"VOX",416
22,"22082",285,230,226,2,4,"VOX",29
10,"10020",1576,1259,1225,9,34,"VOX",75
4,"4099",4931,3781,3719,24,62,"VOX",624
15,"15068",4849,3435,3392,55,43,"VOX",131
24,"24057",1306,1018,997,7,21,"VOX",76
20,"20012",148,113,112,0,1,"VOX",2
21,"21054",8157,6002,5869,60,133,"VOX",1059
18,"18902",755,611,595,1,16,"VOX",62
46,"46122",2730,2103,2071,19,32,"VOX",160
25,"25218",86,79,79,0,0,"VOX",0
34,"34158",286,194,194,0,0,"VOX",16
43,"43159",81,63,62,0,1,"VOX",0
38,"38030",1945,1430,1420,6,10,"VOX",44
6,"6067",1915,1393,1370,7,23,"VOX",172
4,"4100",9266,6046,5988,49,58,"VOX",1059
26,"26091",147,132,131,1,1,"VOX",7
49,"49181",335,227,224,2,3,"VOX",21
34,"34214",178,141,141,1,0,"VOX",16
14,"14053",5925,4442,4348,75,94,"VOX",338
9,"9036",37,33,32,3,1,"VOX",0
46,"46123",1948,1469,1446,5,23,"VOX",139
9,"9360",25,22,22,0,0,"VOX",1
49,"49063",310,246,240,2,6,"VOX",17
9,"9195",55,45,45,1,0,"VOX",3
47,"47210",402,300,289,2,11,"VOX",63
47,"47178",166,144,143,4,1,"VOX",10
4,"4066",13488,9324,9255,73,69,"VOX",2632
40,"40127",35,28,28,0,0,"VOX",3
9,"9361",112,94,94,1,0,"VOX",14
8,"8096",43555,34070,33871,194,199,"VOX",1112
10,"10023",791,619,614,1,5,"VOX",42
50,"50198",49,43,43,1,0,"VOX",1
17,"17048",6251,4565,4537,20,28,"VOX",170
41,"41021",21397,15585,15334,201,251,"VOX",1774
33,"33031",33854,23523,23143,307,380,"VOX",1766
37,"37080",212,173,169,0,4,"VOX",36
43,"43161",17113,12944,12881,64,63,"VOX",345
50,"50110",336,268,266,1,2,"VOX",42
40,"40056",32,21,21,0,0,"VOX",0
18,"18905",15550,11394,11230,132,164,"VOX",1850
10,"10024",675,518,505,4,13,"VOX",54
37,"37197",87,63,63,0,0,"VOX",11
47,"47117",286,240,235,0,5,"VOX",57
9,"9038",111,95,95,0,0,"VOX",9
10,"10025",379,328,317,3,11,"VOX",19
19,"19264",34,28,28,0,0,"VOX",2
22,"22086",209,157,155,1,2,"VOX",27
41,"41095",39970,27911,27583,389,328,"VOX",3797
44,"44061",75,66,65,2,1,"VOX",4
42,"42111",279,209,208,3,1,"VOX",15
43,"43162",4418,3467,3453,20,14,"VOX",175
9,"9198",100,80,79,0,1,"VOX",5
37,"37081",871,725,717,4,8,"VOX",90
31,"31205",420,312,310,7,2,"VOX",13
44,"44257",154,110,109,1,1,"VOX",9
20,"20046",1248,918,909,11,9,"VOX",8
38,"38034",3998,3033,2993,19,40,"VOX",105
2,"2029",3327,2586,2556,15,30,"VOX",361
16,"16093",57,47,47,0,0,"VOX",8
9,"9041",26,26,26,1,0,"VOX",0
49,"49067",336,236,232,0,4,"VOX",32
5,"5238",739,589,586,1,3,"VOX",58
47,"47118",149,111,108,1,3,"VOX",13
50,"50286",75,58,55,0,3,"VOX",6
22,"22088",143,111,111,1,0,"VOX",8
15,"15073",21760,14900,14630,181,270,"VOX",1062
37,"37199",129,97,97,0,0,"VOX",12
9,"9366",75,60,60,2,0,"VOX",9
24,"24183",752,549,543,8,6,"VOX",63
19,"19132",93,72,72,0,0,"VOX",12
39,"39067",759,582,575,3,7,"VOX",37
42,"42115",95,77,77,1,0,"VOX",6
47,"47119",87,66,65,1,1,"VOX",6
50,"50114",132,111,111,1,0,"VOX",10
44,"44063",65,55,55,1,0,"VOX",3
37,"37200",196,145,145,0,0,"VOX",33
16,"16095",81,69,68,1,1,"VOX",6
41,"41098",5152,4046,3986,24,60,"VOX",488
22,"22089",276,216,216,2,0,"VOX",22
44,"44064",63,49,48,0,1,"VOX",6
44,"44260",138,91,90,1,1,"VOX",26
20,"20049",4159,3024,3004,11,20,"VOX",16
30,"30019",25846,18755,18517,172,238,"VOX",3028
42,"42117",133,109,106,0,3,"VOX",20
29,"29036",611,448,444,3,4,"VOX",29
19,"19134",30,24,24,0,0,"VOX",1
47,"47121",521,429,422,5,7,"VOX",49
5,"5241",3041,2242,2204,24,38,"VOX",440
45,"45125",2263,1871,1842,10,29,"VOX",194
18,"18099",1581,1279,1245,5,34,"VOX",142
32,"32041",759,510,502,2,8,"VOX",14
46,"46129",512,408,400,4,8,"VOX",18
34,"34223",205,160,157,1,3,"VOX",49
19,"19135",93,76,72,0,4,"VOX",7
27,"27027",1806,1392,1354,18,38,"VOX",68
47,"47122",2016,1655,1617,15,38,"VOX",197
36,"36037",2554,1839,1793,6,46,"VOX",61
44,"44164",20,18,18,0,0,"VOX",2
22,"22090",85,66,66,1,0,"VOX",4
29,"29037",215,179,179,0,0,"VOX",24
38,"38038",164468,112475,111577,728,898,"VOX",8032
15,"15076",2514,1709,1683,19,26,"VOX",70
12,"12094",875,694,682,2,12,"VOX",74
42,"42118",21,13,13,1,0,"VOX",1
24,"24187",845,641,630,6,11,"VOX",54
9,"9047",54,46,45,0,1,"VOX",5
8,"8023",6915,5339,5299,26,40,"VOX",182
12,"12001",1033,834,825,8,9,"VOX",73
10,"10032",1596,1263,1243,5,20,"VOX",78
50,"50204",2394,1876,1855,21,21,"VOX",138
5,"5005",171,142,142,2,0,"VOX",18
42,"42166",57,49,49,0,0,"VOX",2
31,"31212",129,102,102,6,0,"VOX",0
25,"25905",369,308,307,1,1,"VOX",7
9,"9485",56,50,50,2,0,"VOX",9
17,"17026",543,450,449,4,1,"VOX",10
8,"8260",18400,14471,14406,87,65,"VOX",688
19,"19272",65,58,56,1,2,"VOX",0
45,"45129",109,84,83,0,1,"VOX",8
19,"19138",223,176,172,4,4,"VOX",20
26,"26103",827,655,645,3,10,"VOX",58
40,"40171",39,29,29,1,0,"VOX",3
47,"47219",40,38,34,0,4,"VOX",6
31,"31213",100,69,68,0,1,"VOX",0
3,"3018",12439,9387,9283,50,104,"VOX",752
27,"27030",3134,2209,2162,27,47,"VOX",94
9,"9154",124,101,101,3,0,"VOX",9
37,"37090",66,51,51,1,0,"VOX",2
45,"45130",302,241,235,2,6,"VOX",31
9,"9211",1362,1065,1050,16,15,"VOX",138
10,"10034",336,269,267,0,2,"VOX",13
49,"49193",435,303,287,1,16,"VOX",36
44,"44068",643,518,511,9,7,"VOX",53
22,"22227",199,155,154,1,1,"VOX",9
5,"5130",94,86,86,0,0,"VOX",1
5,"5010",145,119,118,1,1,"VOX",16
29,"29040",1936,1419,1395,7,24,"VOX",170
49,"49034",417,320,317,0,3,"VOX",43
46,"46224",154,124,124,2,0,"VOX",23
37,"37207",325,260,258,1,2,"VOX",54
28,"28130",28508,23566,23305,179,261,"VOX",2641
47,"47126",44,42,42,1,0,"VOX",9
32,"32045",2360,1712,1689,18,23,"VOX",76
21,"21068",962,562,550,14,12,"VOX",92
34,"34081",60,48,48,0,0,"VOX",7
31,"31215",4669,3580,3508,35,72,"VOX",330
10,"10159",317,241,240,0,1,"VOX",71
24,"24071",967,755,741,7,14,"VOX",47
10,"10036",306,240,237,2,3,"VOX",15
16,"16102",1163,951,943,16,8,"VOX",190
44,"44265",181,153,148,1,5,"VOX",13
19,"19279",51,44,44,0,0,"VOX",16
40,"40174",324,254,250,2,4,"VOX",24
43,"43096",98,82,82,0,0,"VOX",0
39,"39073",10200,8230,8150,65,80,"VOX",1117
50,"50032",242,179,176,1,3,"VOX",7
16,"16245",400,329,318,0,11,"VOX",47
37,"37096",203,162,160,1,2,"VOX",12
10,"10037",76855,60447,59702,451,745,"VOX",6530
43,"43022",1435,1130,1123,8,7,"VOX",44
17,"17060",408,311,311,1,0,"VOX",16
28,"28132",12068,9067,8954,63,113,"VOX",1582
32,"32046",1098,793,782,5,11,"VOX",17
45,"45134",1609,1305,1291,6,14,"VOX",263
34,"34083",1664,1244,1229,10,15,"VOX",162
31,"31217",334,233,225,3,8,"VOX",5
31,"31219",81,60,59,1,1,"VOX",2
39,"39074",7041,5612,5551,31,61,"VOX",650
50,"50209",2747,1993,1975,29,18,"VOX",337
37,"37209",410,288,283,3,5,"VOX",38
43,"43023",214,186,186,1,0,"VOX",2
8,"8106",7469,5816,5795,34,21,"VOX",156
19,"19281",18,17,17,3,0,"VOX",2
49,"49082",343,288,286,8,2,"VOX",39
15,"15082",15381,11803,11642,133,161,"VOX",745
19,"19282",143,114,114,1,0,"VOX",20
47,"47129",855,715,696,3,19,"VOX",78
3,"3053",7469,5950,5865,26,85,"VOX",718
31,"31098",1962,1562,1544,14,18,"VOX",83
16,"16106",2708,2200,2163,17,37,"VOX",225
24,"24197",736,556,552,7,4,"VOX",103
9,"9386",55,49,49,0,0,"VOX",7
37,"37211",212,164,163,1,1,"VOX",23
25,"25911",424,332,331,1,1,"VOX",8
37,"37099",61,46,46,1,0,"VOX",1
13,"13020",4729,3461,3416,34,45,"VOX",373
21,"21072",10227,7947,7739,98,208,"VOX",407
15,"15083",1036,784,768,7,16,"VOX",27
40,"40178",90,63,63,1,0,"VOX",12
4,"4005",533,448,442,0,6,"VOX",54
43,"43024",1556,1154,1137,3,17,"VOX",58
37,"37327",179,154,150,0,4,"VOX",16
17,"17063",173,157,156,2,1,"VOX",0
10,"10041",1025,840,825,6,15,"VOX",92
27,"27035",180,127,123,0,4,"VOX",7
10,"10042",88,59,59,0,0,"VOX",7
15,"15084",3059,2236,2217,20,19,"VOX",95
6,"6084",1065,904,890,8,14,"VOX",125
50,"50296",382,288,272,1,16,"VOX",11
6,"6117",1401,1089,1067,6,22,"VOX",105
46,"46138",360,305,303,2,2,"VOX",25
13,"13068",1037,802,783,2,19,"VOX",153
9,"9220",70,59,58,0,1,"VOX",6
4,"4006",7218,5002,4940,33,62,"VOX",584
47,"47131",165,127,127,3,0,"VOX",17
31,"31101",1412,1097,1087,11,10,"VOX",44
40,"40179",626,540,529,2,11,"VOX",54
34,"34236",147,111,111,0,0,"VOX",15
19,"19002",57,45,45,0,0,"VOX",3
10,"10166",313,211,202,0,9,"VOX",23
38,"38047",1756,1276,1259,6,17,"VOX",71
30,"30030",320172,249965,247884,1497,2081,"VOX",46129
29,"29047",1103,909,898,2,11,"VOX",19
16,"16110",91,80,80,0,0,"VOX",22
42,"42004",2294,1807,1767,22,40,"VOX",233
10,"10044",1404,1092,1077,7,15,"VOX",89
42,"42085",178,133,133,3,0,"VOX",9
31,"31224",875,684,677,10,7,"VOX",15
41,"41036",3917,2944,2885,27,59,"VOX",141
21,"21076",2142,1573,1551,24,22,"VOX",69
9,"9390",569,464,459,5,5,"VOX",50
50,"50126",2262,1736,1708,20,28,"VOX",208
46,"46140",377,312,312,2,0,"VOX",39
47,"47133",2776,2317,2292,28,25,"VOX",384
2,"2046",1132,975,953,10,22,"VOX",136
49,"49087",483,322,320,2,2,"VOX",30
43,"43174",144,128,127,0,1,"VOX",1
44,"44080",284,214,212,1,2,"VOX",11
9,"9063",214,185,184,0,1,"VOX",30
10,"10045",970,739,735,6,4,"VOX",49
5,"5021",1871,1469,1440,15,29,"VOX",143
18,"18112",110,80,76,0,4,"VOX",15
49,"49206",794,584,570,7,14,"VOX",59
22,"22111",146,115,115,1,0,"VOX",21
17,"17066",27323,18373,18269,98,104,"VOX",928
45,"45006",1326,983,972,6,11,"VOX",177
9,"9064",305,251,249,3,2,"VOX",42
42,"42134",2652,2028,1989,17,39,"VOX",164
10,"10046",187,154,152,0,2,"VOX",20
40,"40182",173,126,124,1,2,"VOX",6
38,"38049",2683,1781,1743,18,38,"VOX",86
19,"19006",757,556,548,7,8,"VOX",114
45,"45144",740,605,598,7,7,"VOX",56
13,"13073",497,394,390,1,4,"VOX",63
40,"40077",932,747,730,9,17,"VOX",110
45,"45007",665,549,533,0,16,"VOX",60
38,"38050",2436,1564,1529,12,35,"VOX",143
46,"46142",761,580,565,4,15,"VOX",48
24,"24083",1005,800,791,7,9,"VOX",66
29,"29051",41793,29275,28764,249,511,"VOX",4929
46,"46052",508,436,426,3,10,"VOX",43
24,"24206",1611,1286,1268,7,18,"VOX",122
19,"19007",435,328,319,1,9,"VOX",37
45,"45008",142,121,121,0,0,"VOX",6
8,"8192",5679,4605,4589,20,16,"VOX",115
50,"50129",213,151,149,5,2,"VOX",6
8,"8270",18837,14541,14497,66,44,"VOX",613
19,"19291",1131,875,864,1,11,"VOX",139
44,"44178",53,39,39,0,0,"VOX",4
6,"6089",608,524,519,3,5,"VOX",50
29,"29052",222,156,153,2,3,"VOX",23
19,"19008",37,32,32,1,0,"VOX",2
40,"40184",248,205,203,0,2,"VOX",24
9,"9396",153,125,124,0,1,"VOX",19
50,"50216",240,189,181,3,8,"VOX",16
26,"26118",72,63,60,1,3,"VOX",16
34,"34096",50,44,44,0,0,"VOX",7
6,"6090",824,602,578,4,24,"VOX",47
8,"8245",77805,57956,57666,313,290,"VOX",2227
50,"50130",362,252,249,1,3,"VOX",42
13,"13077",3399,2447,2380,30,67,"VOX",324
20,"20064",12436,8730,8652,59,78,"VOX",109
27,"27012",1276,776,768,9,8,"VOX",37
22,"22114",124,86,82,1,4,"VOX",4
12,"12107",351,312,306,1,6,"VOX",29
2,"2051",1665,1253,1222,6,31,"VOX",239
40,"40079",226,179,175,1,4,"VOX",23
34,"34245",310,244,240,3,4,"VOX",29
8,"8114",18648,14251,14170,69,81,"VOX",519
45,"45011",275,241,238,2,3,"VOX",22
9,"9230",33,28,28,0,0,"VOX",1
45,"45104",421,340,335,1,5,"VOX",39
22,"22115",347,262,261,1,1,"VOX",39
18,"18117",507,402,396,5,6,"VOX",30
5,"5147",147,119,117,0,2,"VOX",22
7,"7026",30991,19827,19602,161,225,"VOX",1873
18,"18153",8796,6686,6594,59,92,"VOX",979
49,"49094",213,138,138,0,0,"VOX",6
45,"45012",631,516,509,2,7,"VOX",68
37,"37337",139,114,114,0,0,"VOX",21
22,"22116",1369,1025,1003,8,22,"VOX",101
37,"37224",189,168,165,0,3,"VOX",38
22,"22003",132,114,114,0,0,"VOX",9
50,"50218",110,92,92,0,0,"VOX",11
19,"19013",114,99,99,0,0,"VOX",6
42,"42013",37,29,29,0,0,"VOX",0
31,"31233",93,72,70,1,2,"VOX",16
44,"44181",66,58,57,0,1,"VOX",4
12,"12109",653,544,533,3,11,"VOX",48
5,"5029",99,69,69,0,0,"VOX",8
29,"29055",1880,1493,1470,15,23,"VOX",245
24,"24090",326,213,213,2,0,"VOX",26
33,"33053",1079,738,729,6,9,"VOX",86
44,"44182",198,172,171,2,1,"VOX",22
9,"9025",108,73,72,0,1,"VOX",10
9,"9235",140,105,102,0,3,"VOX",8
46,"46238",13105,9717,9610,57,107,"VOX",671
2,"2054",383,314,309,1,5,"VOX",41
17,"17164",3932,3078,3054,8,24,"VOX",20
34,"34903",183,128,128,1,0,"VOX",34
19,"19252",60,49,47,0,2,"VOX",4
19,"19299",102,78,78,1,0,"VOX",12
50,"50134",118,91,89,0,2,"VOX",14
45,"45153",1560,1243,1230,4,13,"VOX",268
6,"6094",1459,1017,1008,8,9,"VOX",37
30,"30039",20191,14552,14380,96,172,"VOX",3160
16,"16269",393,322,317,3,5,"VOX",47
26,"26123",124,112,110,0,2,"VOX",5
15,"15001",4689,3422,3362,52,60,"VOX",179
17,"17074",532,436,426,2,10,"VOX",11
46,"46148",1509,1208,1195,7,13,"VOX",186
49,"49098",204,157,153,2,4,"VOX",10
10,"10178",729,567,559,4,8,"VOX",44
25,"25177",358,270,268,1,2,"VOX",7
4,"4018",252,215,213,1,2,"VOX",26
12,"12111",334,283,279,4,4,"VOX",9
27,"27048",2019,1499,1467,23,32,"VOX",69
22,"22122",65,58,58,3,0,"VOX",6
31,"31114",374,291,286,4,5,"VOX",14
5,"5901",253,173,171,1,2,"VOX",25
15,"15065",7151,5281,5165,63,116,"VOX",261
6,"6096",207,168,167,1,1,"VOX",25
5,"5035",96,78,78,0,0,"VOX",7
10,"10057",126,97,96,2,1,"VOX",9
10,"10179",277,220,219,0,1,"VOX",18
34,"34104",233,190,189,1,1,"VOX",14
18,"18122",16001,11761,11556,110,205,"VOX",1381
24,"24093",338,239,232,3,7,"VOX",31
17,"17075",334,282,281,5,1,"VOX",10
6,"6097",2283,1803,1762,10,41,"VOX",115
28,"28149",6172,5089,5038,31,51,"VOX",996
33,"33057",1538,1129,1097,14,32,"VOX",105
8,"8277",171,150,150,0,0,"VOX",2
44,"44185",93,73,72,1,1,"VOX",9
10,"10058",993,739,723,4,16,"VOX",85
5,"5036",116,100,100,0,0,"VOX",19
34,"34106",113,101,101,0,0,"VOX",17
10,"10181",680,548,542,2,6,"VOX",53
13,"13086",162,139,136,1,3,"VOX",10
5,"5154",34,25,25,1,0,"VOX",2
23,"23086",11442,8618,8431,80,187,"VOX",659
49,"49224",169,117,115,0,2,"VOX",10
22,"22125",39429,29988,29612,337,376,"VOX",3291
5,"5037",219,143,142,2,1,"VOX",15
43,"43904",2861,2083,2058,27,25,"VOX",65
49,"49101",147,99,96,0,3,"VOX",13
10,"10059",325,234,232,1,2,"VOX",21
50,"50137",964,790,781,9,9,"VOX",61
49,"49102",183,136,135,2,1,"VOX",14
36,"36060",30432,22488,22196,199,292,"VOX",1129
27,"27050",2842,2100,2072,19,28,"VOX",57
9,"9079",48,42,42,1,0,"VOX",6
25,"25181",175,136,135,0,1,"VOX",2
39,"39005",1406,1127,1110,12,17,"VOX",159
4,"4022",357,261,261,0,0,"VOX",31
8,"8200",62161,48645,48330,261,315,"VOX",1864
13,"13088",589,439,429,1,10,"VOX",38
6,"6099",1162,833,813,6,20,"VOX",61
45,"45022",393,290,288,3,2,"VOX",59
10,"10061",1598,1126,1114,5,12,"VOX",51
19,"19305",135,104,103,3,1,"VOX",14
9,"9082",36,34,34,0,0,"VOX",2
9,"9413",408,313,310,2,3,"VOX",52
6,"6100",852,681,677,3,4,"VOX",75
40,"40194",39191,31175,30785,250,390,"VOX",3253
18,"18126",1450,1115,1087,11,28,"VOX",90
10,"10184",740,607,597,5,10,"VOX",41
31,"31120",383,264,260,3,4,"VOX",2
42,"42156",29,23,23,0,0,"VOX",2
39,"39007",393,300,298,1,2,"VOX",30
22,"22127",529,434,432,4,2,"VOX",72
45,"45024",1043,832,821,5,11,"VOX",163
19,"19023",127,98,96,0,2,"VOX",13
23,"23090",1219,1014,1004,5,10,"VOX",103
13,"13090",1023,814,796,5,18,"VOX",132
49,"49104",335,245,240,1,5,"VOX",16
48,"48902",18971,14015,13895,101,120,"VOX",260
9,"9414",181,148,146,0,2,"VOX",7
40,"40091",108,93,93,1,0,"VOX",21
39,"39063",954,726,722,4,4,"VOX",101
43,"43086",5263,4046,4021,17,25,"VOX",74
2,"2026",832,682,673,6,9,"VOX",46
6,"6101",442,359,354,2,5,"VOX",28
24,"24099",155,121,121,1,0,"VOX",13
10,"10064",1409,1103,1072,6,31,"VOX",106
9,"9084",167,132,127,4,5,"VOX",10
44,"44097",126,91,90,2,1,"VOX",13
10,"10186",944,781,758,1,23,"VOX",51
29,"29064",437,319,315,2,4,"VOX",37
16,"16131",127,90,90,1,0,"VOX",28
9,"9085",472,371,365,3,6,"VOX",35
49,"49229",113,88,87,0,1,"VOX",7
44,"44127",57,45,45,0,0,"VOX",4
46,"46246",1042,860,838,2,22,"VOX",151
5,"5042",141,117,116,0,1,"VOX",10
45,"45027",327,276,273,0,3,"VOX",37
9,"9417",42,32,32,0,0,"VOX",7
15,"15009",10615,8066,7919,93,147,"VOX",426
1,"1013",703,491,487,2,4,"VOX",2
19,"19310",7,6,6,0,0,"VOX",0
34,"34113",40,37,37,0,0,"VOX",2
50,"50053",650,505,497,4,8,"VOX",28
6,"6103",4753,3656,3598,35,58,"VOX",385
2,"2065",443,373,370,0,3,"VOX",42
45,"45028",3628,2916,2863,16,53,"VOX",352
44,"44099",649,457,450,2,7,"VOX",30
17,"17081",248,192,190,0,2,"VOX",1
12,"12027",17473,12829,12683,90,146,"VOX",1753
10,"10066",161,141,137,0,4,"VOX",20
5,"5043",75,62,62,0,0,"VOX",5
42,"42160",247,195,194,4,1,"VOX",27
29,"29066",346,266,266,2,0,"VOX",18
27,"27055",1197,857,851,2,6,"VOX",38
40,"40093",76,68,67,0,1,"VOX",2
8,"8204",3115,2548,2534,22,14,"VOX",77
45,"45030",478,368,364,3,4,"VOX",47
19,"19179",76,66,64,1,2,"VOX",11
31,"31248",270,158,154,6,4,"VOX",3
10,"10067",10245,7850,7701,80,149,"VOX",880
22,"22131",83,65,65,0,0,"VOX",0
24,"24102",608,457,448,3,9,"VOX",32
16,"16135",118,86,85,0,1,"VOX",6
19,"19034",23,23,22,0,1,"VOX",2
42,"42161",135,104,104,0,0,"VOX",13
28,"28157",682,530,516,1,14,"VOX",110
44,"44003",17,14,14,0,0,"VOX",2
3,"3074",1750,1433,1427,3,6,"VOX",255
1,"1017",816,579,574,2,5,"VOX",9
46,"46158",1040,805,796,4,9,"VOX",79
18,"18134",6069,4431,4345,30,86,"VOX",768
9,"9091",701,545,533,5,12,"VOX",91
7,"7040",288348,192799,191053,1586,1746,"VOX",24850
45,"45032",444,319,313,2,6,"VOX",46
16,"16012",77,65,65,0,0,"VOX",6
19,"19317",127,98,97,0,1,"VOX",12
8,"8126",8865,7125,7098,33,27,"VOX",202
8,"8284",12482,8959,8887,41,72,"VOX",370
8,"8048",569,442,442,2,0,"VOX",2
34,"34121",183,155,151,1,4,"VOX",33
9,"9093",162,138,137,1,1,"VOX",20
46,"46068",345,308,307,4,1,"VOX",36
45,"45033",298,224,221,1,3,"VOX",43
49,"49234",399,339,333,2,6,"VOX",24
34,"34122",86,68,66,0,2,"VOX",11
47,"47153",104,76,75,0,1,"VOX",10
37,"37241",164,129,127,0,2,"VOX",17
6,"6107",1570,1117,1106,9,11,"VOX",108
13,"13902",449,362,360,2,2,"VOX",69
25,"25192",724,564,558,4,6,"VOX",16
6,"6108",2249,1726,1684,22,42,"VOX",140
44,"44005",46,31,31,1,0,"VOX",3
44,"44196",125,96,95,2,1,"VOX",4
8,"8285",10321,8169,8120,52,49,"VOX",129
8,"8207",2014,1736,1730,9,6,"VOX",28
42,"42164",1589,1201,1172,10,29,"VOX",155
34,"34123",1637,1376,1354,8,22,"VOX",133
42,"42030",89,72,72,0,0,"VOX",13
27,"27059",2055,1508,1471,13,37,"VOX",66
39,"39013",535,434,431,1,3,"VOX",61
10,"10072",835,632,625,3,7,"VOX",19
24,"24106",218,164,162,0,2,"VOX",28
19,"19039",59,56,55,1,1,"VOX",9
40,"40204",151,109,104,1,5,"VOX",20
5,"5167",225,181,175,1,6,"VOX",2
39,"39098",1379,1154,1144,7,10,"VOX",128
44,"44006",223,171,169,2,2,"VOX",5
17,"17086",1745,1223,1210,7,13,"VOX",51
16,"16905",1278,1028,1012,11,16,"VOX",168
37,"37356",87,66,66,0,0,"VOX",3
10,"10196",294,231,231,2,0,"VOX",17
22,"22020",119,91,87,1,4,"VOX",4
34,"34125",79,59,58,0,1,"VOX",6
50,"50148",290,229,227,2,2,"VOX",9
4,"4036",223,188,186,1,2,"VOX",29
46,"46162",1177,954,938,4,16,"VOX",133
45,"45037",1535,1121,1105,7,16,"VOX",141
19,"19323",34,29,29,0,0,"VOX",5
45,"45038",3505,2749,2705,16,44,"VOX",630
39,"39099",3149,2562,2540,22,22,"VOX",229
47,"47156",150,128,128,2,0,"VOX",22
19,"19324",160,128,123,1,5,"VOX",15
16,"16017",340,281,271,2,10,"VOX",43
26,"26028",139,120,117,1,3,"VOX",8
45,"45176",3841,2992,2952,16,40,"VOX",585
46,"46163",1856,1522,1501,4,21,"VOX",217
44,"44008",1565,1158,1138,8,20,"VOX",126
14,"14002",10859,8215,8078,93,137,"VOX",476
45,"45039",208,176,176,0,0,"VOX",47
26,"26143",242,190,189,0,1,"VOX",22
43,"43045",146,128,127,0,1,"VOX",0
17,"17180",8500,6462,6431,28,31,"VOX",156
32,"32072",3687,2715,2682,22,33,"VOX",124
31,"31133",35,28,28,0,0,"VOX",0
22,"22022",543,441,433,4,8,"VOX",35
5,"5053",80,57,57,2,0,"VOX",2
12,"12125",222,189,187,0,2,"VOX",12
50,"50060",170,137,135,2,2,"VOX",19
8,"8130",108,89,86,2,3,"VOX",4
45,"45040",1276,842,828,4,14,"VOX",132
42,"42171",114,80,79,0,1,"VOX",13
2,"2075",1718,1470,1448,4,22,"VOX",181
16,"16019",185,147,147,0,0,"VOX",16
25,"25197",141,109,108,0,1,"VOX",1
15,"15018",1087,771,761,8,10,"VOX",26
9,"9431",120,98,98,3,0,"VOX",12
37,"37012",145,116,114,0,2,"VOX",21
19,"19327",397,333,332,0,1,"VOX",113
6,"6113",2677,2117,2076,13,41,"VOX",198
1,"1027",430,295,293,2,2,"VOX",5
37,"37135",1163,934,924,8,10,"VOX",146
7,"7048",18412,11528,11412,112,116,"VOX",1278
17,"17089",5695,4211,4194,13,17,"VOX",75
26,"26146",86,69,69,1,0,"VOX",1
41,"41059",35105,27781,27472,261,309,"VOX",3493
40,"40208",720,592,585,4,7,"VOX",74
2,"2076",318,256,250,1,6,"VOX",32
5,"5173",59,52,52,0,0,"VOX",15
22,"22144",257,207,204,1,3,"VOX",18
39,"39102",2255,1711,1698,11,13,"VOX",178
50,"50151",603,490,489,3,1,"VOX",67
6,"6114",127,109,108,0,1,"VOX",7
31,"31260",1249,904,901,15,3,"VOX",24
10,"10080",360,256,246,0,10,"VOX",24
50,"50152",1368,1061,1043,6,18,"VOX",124
9,"9108",432,332,326,1,6,"VOX",49
37,"37362",4729,3769,3720,36,49,"VOX",576
46,"46075",147,136,134,2,2,"VOX",16
24,"24114",2893,2017,1989,17,28,"VOX",189
10,"10202",588,469,459,0,10,"VOX",28
3,"3083",5487,3993,3934,28,59,"VOX",312
45,"45183",2337,1743,1704,7,39,"VOX",366
5,"5057",2401,1949,1917,19,32,"VOX",239
19,"19193",23,20,20,0,0,"VOX",0
45,"45046",2369,1860,1832,5,28,"VOX",311
19,"19048",19,13,13,0,0,"VOX",1
42,"42039",210,147,141,2,6,"VOX",17
17,"17091",398,310,305,2,5,"VOX",1
9,"9270",159,119,117,4,2,"VOX",16
45,"45184",201,133,132,0,1,"VOX",10
10,"10082",1810,1495,1476,9,19,"VOX",121
16,"16150",94,75,75,1,0,"VOX",0
4,"4045",1704,1355,1326,12,29,"VOX",203
19,"19332",85,70,70,1,0,"VOX",12
24,"24116",390,283,279,1,4,"VOX",39
49,"49122",778,586,573,6,13,"VOX",94
1,"1032",500,372,362,1,10,"VOX",8
43,"43123",71092,53689,53369,241,320,"VOX",3000
45,"45048",355,277,271,1,6,"VOX",26
5,"5176",223,173,166,2,7,"VOX",21
42,"42176",27,22,22,2,0,"VOX",5
17,"17185",2275,1777,1768,7,9,"VOX",18
27,"27901",2275,1542,1531,27,11,"VOX",98
19,"19050",15,13,13,0,0,"VOX",1
39,"39021",467,392,385,2,7,"VOX",80
22,"22151",88,66,65,0,1,"VOX",2
31,"31020",433,273,272,1,1,"VOX",1
34,"34134",40,31,31,1,0,"VOX",1
49,"49124",237,169,166,1,3,"VOX",19
40,"40109",72,59,54,1,5,"VOX",5
47,"47067",153,119,119,3,0,"VOX",35
46,"46078",28394,20928,20748,156,180,"VOX",2102
34,"34135",399,320,315,4,5,"VOX",48
45,"45049",423,340,335,1,5,"VOX",83
47,"47163",280,238,232,2,6,"VOX",22
9,"9439",1054,867,851,8,16,"VOX",125
5,"5060",109,88,88,0,0,"VOX",10
9,"9440",80,66,66,0,0,"VOX",7
45,"45050",489,381,363,3,18,"VOX",32
16,"16026",93,70,68,1,2,"VOX",17
50,"50242",93,72,70,0,2,"VOX",3
6,"6119",681,551,547,1,4,"VOX",100
28,"28001",80,64,64,0,0,"VOX",8
16,"16027",701,540,531,2,9,"VOX",99
21,"21003",677,505,489,3,16,"VOX",21
45,"45188",2762,2144,2098,14,46,"VOX",315
49,"49248",174,142,139,2,3,"VOX",23
4,"4048",1496,1109,1102,4,7,"VOX",153
21,"21004",1593,1114,1085,16,29,"VOX",89
6,"6120",3373,2757,2719,10,38,"VOX",223
22,"22156",296,246,242,3,4,"VOX",35
16,"16029",102,81,81,1,0,"VOX",16
40,"40215",83,69,69,0,0,"VOX",11
31,"31902",4649,3620,3598,34,22,"VOX",254
9,"9276",389,283,268,5,15,"VOX",16
3,"3089",9497,6952,6794,55,158,"VOX",766
49,"49127",2430,1835,1799,30,36,"VOX",274
44,"44016",436,334,331,1,3,"VOX",35
15,"15025",1000,639,631,6,8,"VOX",22
17,"17095",19938,13998,13918,69,80,"VOX",685
40,"40006",22,18,18,0,0,"VOX",1
18,"18183",624,442,441,1,1,"VOX",52
6,"6121",3268,2558,2531,26,27,"VOX",273
22,"22157",183,136,134,1,2,"VOX",6
16,"16030",22,19,19,1,0,"VOX",1
28,"28003",170,148,148,1,0,"VOX",21
17,"17096",164,113,113,1,0,"VOX",1
44,"44017",272,221,219,0,2,"VOX",16
43,"43126",1211,1005,999,4,6,"VOX",35
10,"10089",1328,1014,982,20,32,"VOX",96
23,"23009",12808,10348,10233,66,115,"VOX",1699
16,"16156",82,65,65,0,0,"VOX",10
26,"26040",63,51,50,0,1,"VOX",1
32,"32081",2035,1592,1565,14,27,"VOX",91
40,"40218",84,62,62,0,0,"VOX",10
22,"22158",11951,8877,8801,69,76,"VOX",997
44,"44209",815,606,592,2,14,"VOX",54
19,"19202",17,13,13,0,0,"VOX",1
14,"14012",6076,4579,4489,38,90,"VOX",292
50,"50159",641,527,526,8,1,"VOX",76
16,"16031",36,25,25,0,0,"VOX",2
10,"10090",494,364,357,6,7,"VOX",36
45,"45055",998,844,828,4,16,"VOX",113
9,"9445",43,36,34,1,2,"VOX",1
15,"15028",1393,1076,1063,8,13,"VOX",39
43,"43053",188,153,149,0,4,"VOX",5
50,"50245",76,58,58,0,0,"VOX",7
40,"40219",565,451,432,2,19,"VOX",70
28,"28005",136050,108267,107316,772,951,"VOX",14486
22,"22160",212,171,170,3,1,"VOX",11
6,"6024",1133,963,941,5,22,"VOX",53
37,"37146",102,86,86,1,0,"VOX",9
19,"19203",29,25,25,0,0,"VOX",2
12,"12135",36194,27266,26961,192,305,"VOX",3241
5,"5066",439,373,367,2,6,"VOX",33
17,"17098",303,245,245,2,0,"VOX",5
49,"49011",212,166,165,7,1,"VOX",38
50,"50161",103,80,80,0,0,"VOX",8
42,"42187",59,51,49,1,2,"VOX",18
47,"47169",61,53,53,0,0,"VOX",2
9,"9447",43,40,40,0,0,"VOX",4
9,"9124",1432,1078,1054,7,24,"VOX",104
49,"49012",73,45,45,0,0,"VOX",5
22,"22040",144,124,120,1,4,"VOX",8
21,"21009",835,575,557,0,18,"VOX",46
3,"3093",19713,15195,14988,108,207,"VOX",1769
44,"44118",158,126,122,1,4,"VOX",7
44,"44180",72,61,61,0,0,"VOX",7
12,"12048",249,181,175,2,6,"VOX",15
24,"24125",421,298,289,2,9,"VOX",22
29,"29076",2335,1661,1614,11,47,"VOX",249
49,"49132",313,252,249,0,3,"VOX",40
35,"35026",82764,55647,54846,499,801,"VOX",3655
10,"10215",413,305,301,2,4,"VOX",18
15,"15030",199972,151737,150397,1576,1340,"VOX",9800
24,"24009",278,154,151,2,3,"VOX",17
25,"25210",1079,867,853,4,14,"VOX",15
40,"40221",48,42,42,0,0,"VOX",3
45,"45060",158,118,118,0,0,"VOX",12
9,"9127",52,45,45,1,0,"VOX",6
17,"17100",195,157,154,0,3,"VOX",2
17,"17011",651,544,544,4,0,"VOX",5
41,"41070",6397,4987,4921,55,66,"VOX",775
8,"8141",4573,3611,3595,26,16,"VOX",78
16,"16036",122,98,97,1,1,"VOX",13
9,"9405",129,99,97,1,2,"VOX",18
47,"47171",384,315,311,5,4,"VOX",48
9,"9128",78,63,61,1,2,"VOX",7
6,"6027",645,572,568,0,4,"VOX",64
49,"49015",201,157,155,0,2,"VOX",12
31,"31031",220,158,157,1,1,"VOX",5
5,"5030",43,36,36,0,0,"VOX",1
4,"4058",342,256,256,0,0,"VOX",21
49,"49134",166,111,111,2,0,"VOX",13
3,"3004",599,465,458,4,7,"VOX",50
42,"42191",180,129,129,1,0,"VOX",11
44,"44215",168,121,120,1,1,"VOX",19
9,"9292",75,62,62,2,0,"VOX",12
32,"32086",2563,1699,1686,19,13,"VOX",59
21,"21013",10570,7195,7089,73,106,"VOX",886
10,"10097",106,88,85,3,3,"VOX",8
43,"43131",4772,3432,3401,18,31,"VOX",216
49,"49135",588,409,405,0,4,"VOX",58
10,"10219",1212,814,806,8,8,"VOX",61
18,"18157",1148,914,898,8,16,"VOX",124
20,"20008",704,455,449,6,6,"VOX",0
24,"24131",677,468,463,1,5,"VOX",96
45,"45064",3998,3166,3117,17,49,"VOX",516
44,"44023",18,14,14,0,0,"VOX",2
6,"6129",573,455,451,2,4,"VOX",11
50,"50250",56,45,45,0,0,"VOX",4
9,"9408",42,33,33,0,0,"VOX",4
22,"22167",473,392,384,4,8,"VOX",34
44,"44122",1284,995,984,15,11,"VOX",102
40,"40015",24,24,24,1,0,"VOX",0
34,"34154",76,59,58,0,1,"VOX",7
42,"42193",16,7,7,0,0,"VOX",0
49,"49137",170,138,134,0,4,"VOX",11
50,"50166",236,200,198,1,2,"VOX",14
40,"40225",1098,902,882,4,20,"VOX",158
39,"39031",1245,990,983,5,7,"VOX",159
21,"21015",654,363,359,8,4,"VOX",38
9,"9297",313,268,267,6,1,"VOX",43
22,"22045",73,57,56,0,1,"VOX",2
32,"32088",1610,1040,1019,11,21,"VOX",71
49,"49262",370,287,286,1,1,"VOX",26
22,"22168",23,21,20,0,1,"VOX",1
47,"47174",270,215,208,2,7,"VOX",31
49,"49138",208,159,154,2,5,"VOX",21
37,"37031",336,261,258,3,3,"VOX",48
40,"40124",234,175,168,3,7,"VOX",26
42,"42057",147,95,93,3,2,"VOX",8
42,"42194",146,111,111,0,0,"VOX",10
28,"28012",918,727,711,6,16,"VOX",176
5,"5076",473,417,413,7,4,"VOX",62
50,"50077",206,158,157,1,1,"VOX",9
40,"40017",84,74,71,2,3,"VOX",8
9,"9458",484,408,401,5,7,"VOX",66
17,"17016",719,584,581,1,3,"VOX",8
16,"16169",51,36,32,0,4,"VOX",11
49,"49263",45,37,37,0,0,"VOX",7
5,"5077",158,133,131,1,2,"VOX",11
37,"37156",4276,2621,2572,27,49,"VOX",403
16,"16043",88,71,71,1,0,"VOX",14
12,"12055",106,85,83,2,2,"VOX",7
47,"47176",202,138,138,1,0,"VOX",28
46,"46182",1310,988,977,5,11,"VOX",99
40,"40018",75,60,60,0,0,"VOX",8
35,"35031",7412,5593,5519,41,74,"VOX",404
45,"45069",1817,1460,1438,4,22,"VOX",257
49,"49141",296,220,218,0,2,"VOX",23
41,"41075",10279,7543,7370,96,173,"VOX",1160
37,"37269",430,331,325,2,6,"VOX",31
16,"16170",653,514,500,3,14,"VOX",51
42,"42197",68,56,56,0,0,"VOX",2
40,"40019",29,26,26,0,0,"VOX",1
17,"17198",433,332,329,0,3,"VOX",14
44,"44220",113,92,89,0,3,"VOX",23
14,"14022",3886,3080,3043,18,37,"VOX",125
42,"42060",29,20,19,0,1,"VOX",1
39,"39035",9169,7135,7045,40,90,"VOX",591
28,"28014",34047,26858,26575,178,283,"VOX",4402
26,"26170",427,343,338,2,5,"VOX",30
3,"3101",4911,3827,3772,20,55,"VOX",206
43,"43061",38,28,28,0,0,"VOX",0
32,"32091",1703,1312,1306,4,6,"VOX",45
44,"44126",317,226,222,1,4,"VOX",13
22,"22174",462,381,377,0,4,"VOX",45
22,"22049",74,63,63,0,0,"VOX",14
9,"9466",112,87,85,2,2,"VOX",9
25,"25219",149,118,118,1,0,"VOX",0
17,"17019",1784,1472,1462,3,10,"VOX",12
19,"19027",131,98,96,0,2,"VOX",9
9,"9137",180,149,147,1,2,"VOX",24
49,"49143",194,141,135,2,6,"VOX",16
42,"42061",272,207,204,2,3,"VOX",28
45,"45072",661,525,517,3,8,"VOX",75
47,"47083",83,66,65,1,1,"VOX",11
26,"26054",292,235,231,2,4,"VOX",18
22,"22175",184,139,137,1,2,"VOX",11
5,"5080",44,31,29,0,2,"VOX",3
6,"6036",4958,3785,3728,22,57,"VOX",302
46,"46094",20691,15841,15672,88,169,"VOX",2064
10,"10146",1513,1128,1104,6,24,"VOX",109
21,"21021",12469,8238,8097,76,141,"VOX",1936
9,"9139",98,82,82,2,0,"VOX",9
25,"25221",117,92,92,0,0,"VOX",0
45,"45074",401,335,326,3,9,"VOX",23
5,"5081",37,29,29,0,0,"VOX",2
33,"33001",1504,875,864,15,11,"VOX",110
32,"32009",10590,7661,7574,68,87,"VOX",524
49,"49146",274,213,209,1,4,"VOX",15
8,"8003",7183,5761,5742,39,19,"VOX",199
40,"40129",164,129,128,2,1,"VOX",21
40,"40234",376,307,299,2,8,"VOX",33
42,"42202",20,12,11,0,1,"VOX",4
45,"45075",124,93,90,0,3,"VOX",19
33,"33002",9474,6779,6662,74,117,"VOX",611
47,"47180",57,46,46,1,0,"VOX",8
28,"28018",4068,3367,3344,15,23,"VOX",714
44,"44223",73,58,58,0,0,"VOX",3
24,"24144",639,469,462,2,7,"VOX",80
25,"25024",352,273,272,0,1,"VOX",1
40,"40024",827,657,645,4,12,"VOX",80
40,"40130",128,102,96,0,6,"VOX",4
16,"16175",5079,4279,4207,40,72,"VOX",515
31,"31044",294,243,242,5,1,"VOX",2
45,"45076",564,389,388,2,1,"VOX",47
39,"39038",1506,1093,1076,2,17,"VOX",111
3,"3013",1070,882,869,3,13,"VOX",70
37,"37162",209,156,153,1,3,"VOX",35
50,"50173",149,107,105,0,2,"VOX",15
9,"9143",27,18,18,0,0,"VOX",3
37,"37163",32,27,27,0,0,"VOX",9
34,"34167",110,88,88,0,0,"VOX",23
49,"49027",126,88,88,0,0,"VOX",2
46,"46097",958,764,756,6,8,"VOX",123
26,"26058",143,116,115,2,1,"VOX",9
41,"41080",1240,940,913,11,27,"VOX",100
37,"37040",382,319,316,1,3,"VOX",36
39,"39039",546,431,428,0,3,"VOX",60
5,"5085",30,27,27,0,0,"VOX",4
18,"18168",781,613,604,6,9,"VOX",53
33,"33004",65515,48686,48245,511,441,"VOX",5156
38,"38006",41302,23632,23415,133,217,"VOX",1854
22,"22181",88,60,59,1,1,"VOX",6
24,"24146",251,206,204,1,2,"VOX",26
22,"22054",1617,1196,1183,15,13,"VOX",108
32,"32012",716,497,487,7,10,"VOX",29
17,"17023",27144,20301,20146,120,155,"VOX",745
8,"8232",1786,1444,1434,9,10,"VOX",15
48,"48044",62054,49055,48840,373,215,"VOX",1838
47,"47183",139,118,118,1,0,"VOX",19
41,"41082",3359,2760,2718,11,42,"VOX",256
10,"10112",1518,1168,1151,4,17,"VOX",104
18,"18170",324,225,224,1,1,"VOX",33
40,"40904",341,302,300,4,2,"VOX",39
45,"45080",3,3,3,0,0,"VOX",0
24,"24026",1099,812,799,5,13,"VOX",85
43,"43140",2438,1847,1837,16,10,"VOX",91
49,"49151",593,453,444,5,9,"VOX",41
34,"34170",51,35,35,0,0,"VOX",4
24,"24027",1219,913,886,8,27,"VOX",78
4,"4072",314,245,240,0,5,"VOX",48
1,"1062",315,236,229,2,7,"VOX",15
26,"26061",1552,1228,1194,14,34,"VOX",44
18,"18171",2111,1679,1638,8,41,"VOX",185
5,"5087",149,112,111,1,1,"VOX",50
9,"9151",445,358,354,3,4,"VOX",27
13,"13010",881,680,666,4,14,"VOX",49
37,"37166",199,146,144,0,2,"VOX",23
28,"28094",959,736,729,6,7,"VOX",131
49,"49152",483,327,322,2,5,"VOX",39
5,"5205",79,66,66,0,0,"VOX",12
10,"10114",962,754,737,2,17,"VOX",43
13,"13011",4506,3111,3044,29,67,"VOX",301
33,"33007",1398,960,951,9,9,"VOX",76
8,"8234",3373,2742,2734,25,8,"VOX",66
1,"1901",2474,1655,1631,13,24,"VOX",93
18,"18173",8972,6594,6459,58,135,"VOX",762
29,"29095",3304,2536,2470,22,66,"VOX",161
10,"10115",3488,2878,2816,15,62,"VOX",221
21,"21029",1509,1183,1160,14,23,"VOX",81
46,"46101",816,696,687,3,9,"VOX",44
40,"40030",428,357,350,3,7,"VOX",26
40,"40136",106,82,81,0,1,"VOX",8
11,"11011",1736,1285,1249,7,36,"VOX",168
25,"25227",664,517,517,1,0,"VOX",3
45,"45084",2121,1708,1676,16,32,"VOX",221
5,"5090",77,70,69,0,1,"VOX",11
6,"6143",3370,2635,2589,23,46,"VOX",160
9,"9901",340,256,255,1,1,"VOX",24
38,"38010",3974,2814,2777,20,37,"VOX",104
15,"15047",2269,1531,1497,25,34,"VOX",57
31,"31173",846,686,674,5,12,"VOX",51
16,"16057",64,53,53,0,0,"VOX",10
22,"22187",294,244,243,2,1,"VOX",24
45,"45085",1511,1141,1128,9,13,"VOX",322
37,"37169",176,138,137,1,1,"VOX",35
11,"11013",2332,1747,1713,16,34,"VOX",184
29,"29007",28584,21525,21318,202,207,"VOX",3491
9,"9321",1597,1293,1280,4,13,"VOX",137
47,"47187",75,54,53,0,1,"VOX",8
17,"17208",976,772,768,5,4,"VOX",6
49,"49155",80,66,65,1,1,"VOX",5
18,"18175",11786,8883,8730,58,153,"VOX",1363
13,"13014",481,400,395,1,5,"VOX",39
34,"34176",127,106,104,2,2,"VOX",27
17,"17119",73,58,58,2,0,"VOX",1
49,"49035",222,195,195,2,0,"VOX",42
14,"14033",1265,994,985,9,9,"VOX",91
8,"8156",11155,8956,8923,60,33,"VOX",356
3,"3113",4342,3194,3154,23,40,"VOX",432
24,"24032",102,84,83,0,1,"VOX",8
26,"26066",259,216,212,3,4,"VOX",18
41,"41002",1427,1057,1024,5,33,"VOX",97
22,"22189",178,143,143,0,0,"VOX",10
45,"45087",8198,6375,6281,36,94,"VOX",939
49,"49036",508,361,355,6,6,"VOX",54
44,"44039",202,166,165,3,1,"VOX",32
45,"45088",2332,1724,1695,16,29,"VOX",344
25,"25230",1555,1221,1208,8,13,"VOX",14
37,"37050",67,54,54,0,0,"VOX",11
50,"50265",74,56,56,0,0,"VOX",6
34,"34178",119,105,104,0,1,"VOX",8
49,"49157",192,153,149,0,4,"VOX",14
37,"37172",853,601,590,4,11,"VOX",101
50,"50180",106,84,84,1,0,"VOX",2
40,"40140",79,58,58,0,0,"VOX",8
41,"41003",2371,1801,1760,8,41,"VOX",184
33,"33011",10659,6448,6332,119,116,"VOX",777
28,"28027",1200,920,906,4,14,"VOX",140
20,"20025",1116,835,830,2,5,"VOX",1
18,"18177",373,253,252,1,1,"VOX",27
21,"21034",1159,863,845,4,18,"VOX",75
9,"9163",578,490,481,5,9,"VOX",57
16,"16062",25,21,21,0,0,"VOX",0
10,"10121",7914,5924,5809,36,115,"VOX",560
3,"3022",137,122,119,0,3,"VOX",9
44,"44141",127,100,100,0,0,"VOX",6
41,"41004",57465,41004,40321,571,683,"VOX",5114
20,"20026",204,182,159,3,23,"VOX",0
47,"47191",115,85,84,0,1,"VOX",21
21,"21035",9726,6628,6520,78,108,"VOX",475
9,"9164",150,116,114,0,2,"VOX",14
50,"50091",40,35,35,0,0,"VOX",1
50,"50182",3675,2846,2810,36,36,"VOX",642
8,"8159",14323,11399,11359,57,40,"VOX",353
25,"25233",285,231,229,2,2,"VOX",5
10,"10122",220,171,164,0,7,"VOX",22
16,"16063",113,86,83,0,3,"VOX",5
12,"12071",1267,1021,1006,11,15,"VOX",96
41,"41005",9250,6925,6809,69,116,"VOX",726
9,"9011",73,50,49,0,1,"VOX",9
45,"45092",223,204,204,1,0,"VOX",29
37,"37287",309,215,214,3,1,"VOX",39
49,"49162",175,134,131,1,3,"VOX",13
46,"46198",871,707,693,4,14,"VOX",32
13,"13021",417,343,343,0,0,"VOX",39
24,"24037",337,234,234,1,0,"VOX",26
6,"6150",780,637,635,2,2,"VOX",37
28,"28029",562,459,456,2,3,"VOX",81
22,"22195",234,193,192,0,1,"VOX",40
28,"28104",15318,12897,12797,87,100,"VOX",2377
44,"44043",88,67,65,1,2,"VOX",2
11,"11019",1753,1353,1295,7,58,"VOX",137
20,"20028",2258,1579,1574,9,5,"VOX",9
22,"22066",748,576,567,6,9,"VOX",56
13,"13022",332,264,256,1,8,"VOX",24
46,"46199",5842,4451,4414,23,37,"VOX",584
19,"19105",2540,2013,1988,13,25,"VOX",461
21,"21038",1076,786,771,8,15,"VOX",68
29,"29903",493,358,354,6,4,"VOX",22
9,"9168",272,222,216,3,6,"VOX",20
10,"10125",862,655,639,4,16,"VOX",69
44,"44144",325,249,247,1,2,"VOX",11
37,"37289",218,159,158,0,1,"VOX",27
29,"29014",222,151,150,6,1,"VOX",16
47,"47194",292,245,243,1,2,"VOX",18
15,"15054",31802,22002,21676,368,326,"VOX",1252
43,"43002",1875,1367,1348,11,19,"VOX",78
8,"8015",156003,117736,117183,704,553,"VOX",4821
25,"25038",1482,1111,1094,11,17,"VOX",17
6,"6152",1285,952,935,4,17,"VOX",57
34,"34047",1738,1439,1420,8,19,"VOX",239
10,"10126",1470,1114,1104,7,10,"VOX",104
39,"39050",255,188,184,2,4,"VOX",34
29,"29904",417,337,335,2,2,"VOX",5
25,"25136",96,79,79,2,0,"VOX",0
38,"38017",30646,18576,18373,100,203,"VOX",1389
10,"10004",690,529,517,8,12,"VOX",44
43,"43149",684,533,533,4,0,"VOX",20
45,"45097",1044,901,890,4,11,"VOX",158
6,"6053",590,461,444,7,17,"VOX",21
38,"38018",4455,3242,3198,24,44,"VOX",103
41,"41008",1040,840,822,4,18,"VOX",52
10,"10127",4706,3508,3423,23,85,"VOX",457
6,"6153",20240,15464,15210,134,254,"VOX",1567
49,"49044",78,64,64,1,0,"VOX",8
37,"37292",94,76,73,1,3,"VOX",11
10,"10128",5628,4238,4126,43,112,"VOX",439
24,"24041",527,371,364,4,7,"VOX",38
25,"25039",261,216,216,1,0,"VOX",0
34,"34049",329,251,247,5,4,"VOX",25
49,"49166",1192,916,899,10,17,"VOX",83
37,"37217",59,48,46,1,2,"VOX",3
38,"38019",13758,8870,8776,46,94,"VOX",469
9,"9173",129,102,102,0,0,"VOX",16
10,"10129",348,263,250,0,13,"VOX",19
17,"17216",155,127,124,0,3,"VOX",3
44,"44146",170,148,146,3,2,"VOX",16
3,"3028",964,804,795,6,9,"VOX",62
13,"13028",10273,8434,8273,42,161,"VOX",1313
47,"47101",1644,1354,1337,9,17,"VOX",115
49,"49167",179,140,136,2,4,"VOX",15
49,"49046",242,178,175,0,3,"VOX",21
47,"47102",264,217,211,1,6,"VOX",51
37,"37181",264,185,184,1,1,"VOX",40
23,"23044",4719,3817,3749,18,68,"VOX",242
44,"44047",229,125,124,2,1,"VOX",5
16,"16071",20,18,18,0,0,"VOX",5
49,"49168",93,74,74,0,0,"VOX",12
10,"10130",1747,1352,1321,12,31,"VOX",56
28,"28035",1394,1057,1043,3,14,"VOX",156
24,"24165",327,236,233,1,3,"VOX",18
10,"10131",12808,9377,9254,67,123,"VOX",1613
4,"4089",694,516,510,1,6,"VOX",54
37,"37182",78,57,57,0,0,"VOX",17
19,"19111",162,142,142,0,0,"VOX",25
46,"46204",6657,5262,5204,27,58,"VOX",561
34,"34196",88,74,74,4,0,"VOX",10
37,"37183",386,296,294,4,2,"VOX",26
24,"24166",1359,1038,1011,11,27,"VOX",129
2,"2014",350,285,280,1,5,"VOX",21
31,"31067",1896,1418,1397,17,21,"VOX",124
24,"24046",899,678,663,7,15,"VOX",67
10,"10132",365,276,271,2,5,"VOX",36
26,"26078",86,71,70,1,1,"VOX",5
19,"19112",53,41,40,1,1,"VOX",9
15,"15059",10255,7423,7262,122,161,"VOX",370
41,"41012",3368,2416,2361,23,55,"VOX",315
9,"9177",1127,883,877,6,6,"VOX",166
23,"23046",2331,1953,1926,3,27,"VOX",184
44,"44049",796,592,578,9,14,"VOX",37
22,"22204",1119,836,832,9,4,"VOX",86
25,"25043",801,613,606,1,7,"VOX",5
9,"9345",117,96,95,1,1,"VOX",11
28,"28111",622,492,487,1,5,"VOX",71
15,"15060",5843,4360,4281,65,79,"VOX",240
44,"44241",506,416,407,1,9,"VOX",37
28,"28037",1578,1196,1180,5,16,"VOX",200
24,"24008",9025,6803,6702,79,101,"VOX",903
20,"20035",484,384,384,2,0,"VOX",1
12,"12079",419,346,336,2,10,"VOX",60
19,"19114",33,25,25,1,0,"VOX",1
17,"17133",1273,1048,1043,7,5,"VOX",8
5,"5108",40,28,28,0,0,"VOX",2
47,"47105",175,152,149,1,3,"VOX",22
6,"6159",2339,1577,1507,25,70,"VOX",116
9,"9179",38,32,32,0,0,"VOX",1
25,"25245",430,346,342,1,4,"VOX",9
10,"10135",1241,995,981,5,14,"VOX",81
39,"39056",2268,1847,1830,7,17,"VOX",217
38,"38024",15310,10234,10088,82,146,"VOX",595
45,"45106",7395,5971,5861,40,110,"VOX",747
46,"46207",6686,5220,5137,36,83,"VOX",625
32,"32029",436,340,337,1,3,"VOX",11
13,"13035",955,739,720,6,19,"VOX",51
18,"18085",701,465,460,1,5,"VOX",84
33,"33023",3271,2448,2397,35,51,"VOX",201
41,"41014",2486,1939,1878,6,61,"VOX",62
6,"6160",3019,2252,2209,10,43,"VOX",170
39,"39057",2367,1831,1796,14,35,"VOX",128
11,"11030",22973,16087,15853,165,234,"VOX",2359
40,"40155",3835,3165,3121,43,44,"VOX",409
47,"47106",44,35,35,0,0,"VOX",6
20,"20037",103,77,77,0,0,"VOX",0
10,"10014",1829,1448,1419,12,29,"VOX",171
8,"8090",137,113,113,2,0,"VOX",0
5,"5112",95,66,64,2,2,"VOX",3
6,"6161",288,226,222,1,4,"VOX",13
28,"28039",125,103,103,2,0,"VOX",7
10,"10137",404,346,344,3,2,"VOX",20
8,"8249",272,248,248,2,0,"VOX",2
15,"15064",2127,1608,1577,29,31,"VOX",87
28,"28040",16648,11709,11551,66,158,"VOX",2002
34,"34058",185,161,161,1,0,"VOX",8
49,"49175",205,150,149,2,1,"VOX",16
37,"37188",160,115,112,3,3,"VOX",0
43,"43156",3956,2993,2965,23,28,"VOX",149
3,"3035",632,529,525,2,4,"VOX",33
4,"4095",690,508,502,2,6,"VOX",94
22,"22079",114,89,88,1,1,"VOX",10
16,"16213",34,29,28,0,1,"VOX",0
17,"17224",302,233,231,2,2,"VOX",2
11,"11032",54469,33144,32810,461,334,"VOX",4125
49,"49056",288,232,230,2,2,"VOX",36
16,"16215",237,157,153,1,4,"VOX",8
5,"5229",82,67,67,1,0,"VOX",10
50,"50105",279,216,213,4,3,"VOX",9
44,"44053",105,81,81,0,0,"VOX",3
43,"43157",345,303,303,0,0,"VOX",1
3,"3036",86,77,75,2,2,"VOX",0
3,"3130",43,23,23,0,0,"VOX",1
48,"48065",3303,2541,2524,15,17,"VOX",21
49,"49057",105,85,81,2,4,"VOX",8
31,"31196",31,28,28,0,0,"VOX",0
6,"6901",2117,1686,1655,17,31,"VOX",201
21,"21052",4429,2951,2891,19,60,"VOX",159
10,"10140",1082,868,855,8,13,"VOX",123
38,"38028",22035,15684,15522,86,162,"VOX",1008
46,"46211",1837,1490,1462,11,28,"VOX",167
47,"47207",260,213,211,2,2,"VOX",42
8,"8171",2066,1607,1597,7,10,"VOX",17
9,"9189",126,102,96,0,6,"VOX",11
28,"28042",1266,1020,1010,2,10,"VOX",211
24,"24055",676,513,508,6,5,"VOX",64
45,"45113",1797,1300,1281,6,19,"VOX",243
9,"9032",103,72,72,0,0,"VOX",10
6,"6902",1663,1273,1252,4,21,"VOX",101
28,"28043",6166,4404,4320,30,84,"VOX",906
25,"25251",713,562,558,4,4,"VOX",19
18,"18901",488,335,329,2,6,"VOX",41
29,"29027",2309,1716,1692,18,24,"VOX",221
2,"2023",515,442,435,1,7,"VOX",51
44,"44155",1056,830,813,9,17,"VOX",37
19,"19122",81,64,64,1,0,"VOX",3
13,"13042",888,699,686,2,13,"VOX",130
3,"3132",515,417,414,4,3,"VOX",38
47,"47208",56,37,37,0,0,"VOX",2
43,"43012",3647,3028,3019,15,9,"VOX",109
41,"41019",4895,3518,3462,36,56,"VOX",495
50,"50196",102,83,81,2,2,"VOX",8
28,"28044",6193,5040,4991,31,49,"VOX",848
16,"16218",187,149,148,2,1,"VOX",8
25,"25252",557,424,422,4,2,"VOX",8
44,"44250",19,15,15,0,0,"VOX",3
5,"5117",193,169,167,0,2,"VOX",28
50,"50108",52,43,42,0,1,"VOX",9
19,"19260",38,33,31,1,2,"VOX",0
37,"37194",237,182,181,0,1,"VOX",25
8,"8253",128,113,113,0,0,"VOX",0
47,"47209",34,25,25,0,0,"VOX",3
41,"41020",12992,8679,8524,117,155,"VOX",762
24,"24058",195,127,125,1,2,"VOX",16
41,"41093",19012,15637,15525,97,112,"VOX",2206
19,"19124",380,271,268,0,3,"VOX",31
19,"19261",32,24,24,0,0,"VOX",1
46,"46214",16415,12723,12610,74,113,"VOX",1442
20,"20043",1734,1254,1248,5,6,"VOX",4
25,"25151",736,592,584,1,8,"VOX",13
18,"18903",851,644,636,1,8,"VOX",121
22,"22084",555,438,433,5,5,"VOX",35
22,"22215",128,91,91,1,0,"VOX",3
18,"18095",2002,1566,1537,11,29,"VOX",223
5,"5195",206,157,157,0,0,"VOX",24
41,"41094",6447,4998,4912,43,86,"VOX",820
17,"17141",6072,4251,4221,14,30,"VOX",182
3,"3041",6093,4444,4398,13,46,"VOX",434
45,"45118",2088,1562,1540,11,22,"VOX",286
42,"42108",10,7,7,0,0,"VOX",0
46,"46215",1397,1104,1093,12,11,"VOX",61
44,"44060",37,28,28,0,0,"VOX",11
49,"49183",93,73,71,2,2,"VOX",12
22,"22217",372,296,290,5,6,"VOX",32
5,"5120",32,25,25,1,0,"VOX",0
9,"9416",60,44,44,0,0,"VOX",5
22,"22085",96,82,81,0,1,"VOX",6
19,"19263",22,13,12,0,1,"VOX",3
17,"17230",499,397,393,0,4,"VOX",17
17,"17142",2673,2250,2241,14,9,"VOX",69
7,"7004",4033,2898,2860,28,38,"VOX",366
6,"6070",7686,6083,5948,44,135,"VOX",472
49,"49184",170,122,121,0,1,"VOX",16
9,"9197",137,108,107,0,1,"VOX",11
41,"41022",4269,3158,3110,16,48,"VOX",187
5,"5121",262,201,199,0,2,"VOX",18
40,"40057",1405,1176,1163,10,13,"VOX",87
38,"38033",3594,2512,2467,11,45,"VOX",99
13,"13049",747,566,553,4,13,"VOX",115
43,"43089",281,209,208,0,1,"VOX",7
10,"10148",32986,23987,23589,201,398,"VOX",2471
17,"17143",144,115,115,0,0,"VOX",0
50,"50200",475,416,407,4,9,"VOX",41
37,"37082",745,546,536,2,10,"VOX",72
6,"6071",238,197,193,0,4,"VOX",7
3,"3043",2899,2466,2434,21,32,"VOX",173
29,"29033",1089,776,761,2,15,"VOX",74
37,"37313",534,413,411,1,2,"VOX",69
28,"28048",504,399,392,6,7,"VOX",51
34,"34071",161,138,138,0,0,"VOX",27
39,"39066",877,711,705,5,6,"VOX",65
28,"28049",57902,47976,47561,329,415,"VOX",4856
44,"44062",31,24,23,1,1,"VOX",1
3,"3044",4557,3650,3600,17,50,"VOX",526
8,"8020",5172,4337,4327,26,10,"VOX",145
10,"10150",331,277,272,6,5,"VOX",15
21,"21061",5089,3358,3290,42,68,"VOX",512
13,"13051",336,272,271,1,1,"VOX",32
10,"10028",82,60,59,0,1,"VOX",0
5,"5124",92,71,70,1,1,"VOX",8
30,"30018",8326,6544,6438,25,106,"VOX",1319
7,"7007",414,326,324,2,2,"VOX",18
5,"5239",231,177,174,1,3,"VOX",52
50,"50287",252,200,196,7,4,"VOX",12
31,"31208",2562,2067,2036,16,31,"VOX",107
41,"41025",2019,1492,1439,7,53,"VOX",193
46,"46219",122,105,104,0,1,"VOX",11
2,"2031",541,432,425,0,7,"VOX",40
49,"49188",110,87,86,0,1,"VOX",23
8,"8100",2092,1792,1782,16,10,"VOX",21
21,"21062",1386,893,885,15,8,"VOX",106
42,"42116",42,30,30,1,0,"VOX",3
25,"25903",229,189,188,0,1,"VOX",3
34,"34073",180,149,145,2,4,"VOX",19
43,"43164",306,228,228,0,0,"VOX",17
40,"40168",28,22,22,0,0,"VOX",3
8,"8022",12219,9089,9038,42,51,"VOX",153
43,"43018",385,335,334,3,1,"VOX",2
12,"12093",165,128,126,0,2,"VOX",11
46,"46220",48968,35430,34964,306,466,"VOX",3466
37,"37316",716,576,565,4,11,"VOX",110
2,"2033",1870,1503,1463,11,40,"VOX",167
25,"25904",162,147,147,3,0,"VOX",1
3,"3046",1619,1213,1190,17,23,"VOX",101
22,"22223",74,63,63,1,0,"VOX",3
37,"37202",989,838,828,7,10,"VOX",124
24,"24185",452,339,332,3,7,"VOX",47
17,"17147",7959,6164,6130,45,34,"VOX",124
5,"5127",608,499,496,0,3,"VOX",61
20,"20050",270,186,183,3,3,"VOX",1
37,"37203",146,113,112,0,1,"VOX",17
3,"3047",9711,6910,6791,36,119,"VOX",676
24,"24067",606,375,371,2,4,"VOX",72
16,"16098",520,441,439,6,2,"VOX",55
46,"46130",857,680,669,6,11,"VOX",51
28,"28127",66441,56199,55932,327,267,"VOX",10837
45,"45127",764,582,577,3,5,"VOX",157
50,"50117",125,100,100,3,0,"VOX",4
19,"19271",41,26,26,0,0,"VOX",0
37,"37318",199,152,152,1,0,"VOX",28
13,"13057",1105,934,919,3,15,"VOX",112
20,"20051",6775,5124,5091,24,33,"VOX",58
38,"38039",11112,8233,8161,54,72,"VOX",538
17,"17056",1766,1438,1433,9,5,"VOX",20
22,"22095",65,57,56,1,1,"VOX",2
5,"5128",342,274,267,1,7,"VOX",38
27,"27029",1427,1068,1047,13,21,"VOX",71
46,"46131",49504,37495,37064,259,431,"VOX",4255
46,"46040",995,807,794,7,13,"VOX",60
34,"34227",72,63,61,4,2,"VOX",7
6,"6077",321,260,256,4,4,"VOX",7
13,"13058",4050,3188,3128,24,60,"VOX",439
15,"15078",78678,60510,59882,621,628,"VOX",2863
5,"5129",116,82,76,1,6,"VOX",16
18,"18102",8227,6100,5969,32,131,"VOX",403
50,"50206",453,371,370,5,1,"VOX",34
38,"38040",5446,3513,3462,13,51,"VOX",199
47,"47125",51,46,45,0,1,"VOX",4
8,"8261",2378,1821,1815,14,6,"VOX",89
19,"19142",249,178,177,1,1,"VOX",20
21,"21067",402,300,299,2,1,"VOX",10
16,"16242",308,266,263,2,3,"VOX",30
5,"5245",348,295,290,3,5,"VOX",39
45,"45131",264,226,225,0,1,"VOX",27
41,"41102",14750,10972,10677,110,295,"VOX",1362
2,"2037",22952,16040,15815,101,225,"VOX",2716
6,"6078",506,415,410,1,5,"VOX",17
9,"9052",29,17,17,1,0,"VOX",5
25,"25163",236,181,179,3,2,"VOX",4
49,"49194",340,236,233,3,3,"VOX",23
12,"12004",4177,3225,3187,13,38,"VOX",436
39,"39072",324,206,204,4,2,"VOX",16
10,"10158",337,269,267,0,2,"VOX",15
49,"49197",162,129,123,2,6,"VOX",3
15,"15080",1640,1177,1150,9,27,"VOX",56
42,"42124",58,41,41,0,0,"VOX",5
20,"20054",459,313,312,1,1,"VOX",0
36,"36042",18072,13314,13091,130,223,"VOX",596
3,"3051",344,312,307,2,5,"VOX",23
7,"7014",7778,4724,4669,50,55,"VOX",322
34,"34230",17,13,13,0,0,"VOX",1
49,"49080",630,499,493,4,6,"VOX",59
43,"43169",450,396,396,3,0,"VOX",2
30,"30025",5001,3951,3898,27,53,"VOX",778
41,"41031",1215,866,848,3,18,"VOX",56
44,"44070",55,45,45,0,0,"VOX",6
37,"37208",69,52,51,0,1,"VOX",6
4,"4002",1039,798,792,7,6,"VOX",113
5,"5133",67,48,48,0,0,"VOX",1
27,"27033",598,423,415,1,8,"VOX",14
5,"5014",5291,4096,4044,29,52,"VOX",463
41,"41902",4600,3141,3092,48,49,"VOX",274
23,"23067",2421,1909,1873,13,36,"VOX",152
33,"33042",4243,3137,3103,36,34,"VOX",349
8,"8027",720,592,588,3,4,"VOX",24
14,"14066",5756,4396,4310,36,86,"VOX",342
37,"37097",44,29,29,0,0,"VOX",4
43,"43097",399,341,341,1,0,"VOX",5
13,"13064",1836,1455,1446,18,9,"VOX",219
44,"44074",444,353,346,3,7,"VOX",52
47,"47223",152,123,120,2,3,"VOX",25
20,"20056",4075,2983,2942,12,41,"VOX",10
32,"32047",1746,1272,1252,6,20,"VOX",42
5,"5134",49,41,40,0,1,"VOX",12
10,"10162",528,430,424,2,6,"VOX",31
46,"46227",888,708,693,6,15,"VOX",51
22,"22105",101,82,82,4,0,"VOX",6
48,"48082",37396,27913,27694,172,219,"VOX",609
50,"50122",67,55,54,0,1,"VOX",14
39,"39075",136968,104358,103487,690,871,"VOX",12642
41,"41904",1792,1171,1162,16,9,"VOX",75
5,"5135",398,324,320,2,4,"VOX",72
5,"5016",6354,5090,5005,40,85,"VOX",917
17,"17062",5978,4358,4334,26,24,"VOX",142
2,"2042",818,631,620,1,11,"VOX",74
7,"7017",882,652,646,6,6,"VOX",66
18,"18916",1778,1249,1236,9,13,"VOX",155
24,"24077",215,178,178,0,0,"VOX",15
47,"47035",902,715,707,5,8,"VOX",93
43,"43098",354,291,291,1,0,"VOX",15
46,"46046",884,654,643,3,11,"VOX",78
26,"26110",150,128,124,1,4,"VOX",7
32,"32049",689,468,462,3,6,"VOX",7
20,"20058",739,555,551,4,4,"VOX",4
10,"10164",720,474,461,3,13,"VOX",46
41,"41034",23480,16510,16250,230,260,"VOX",2025
27,"27037",1017,759,748,10,11,"VOX",50
21,"21074",2698,1979,1945,15,34,"VOX",181
39,"39077",236,175,173,0,2,"VOX",16
43,"43099",286,234,234,0,0,"VOX",1
8,"8030",5209,4318,4305,16,13,"VOX",112
50,"50211",237,177,173,0,4,"VOX",24
44,"44076",2110,1725,1691,22,34,"VOX",125
47,"47225",74,61,60,0,1,"VOX",18
5,"5138",289,224,223,2,1,"VOX",53
50,"50124",399,316,316,3,0,"VOX",48
40,"40180",277,231,224,3,7,"VOX",33
45,"45003",550,435,431,4,4,"VOX",75
37,"37214",116,87,87,4,0,"VOX",13
10,"10043",754,578,572,3,6,"VOX",44
8,"8189",122,106,106,0,0,"VOX",1
49,"49086",111,94,93,1,1,"VOX",6
45,"45141",849,677,665,4,12,"VOX",77
9,"9223",43,39,39,1,0,"VOX",2
50,"50125",345,264,261,3,3,"VOX",27
8,"8190",258,216,215,1,1,"VOX",1
22,"22109",266,207,205,3,2,"VOX",25
5,"5019",44838,36021,35637,287,384,"VOX",5368
6,"6086",1174,869,862,4,7,"VOX",49
45,"45142",7800,6245,6143,67,102,"VOX",803
20,"20060",88,75,75,0,0,"VOX",0
22,"22236",236,207,203,2,4,"VOX",20
50,"50213",93,76,75,0,1,"VOX",8
31,"31103",39,27,27,0,0,"VOX",1
40,"40075",153,128,127,0,1,"VOX",9
27,"27039",4430,3437,3353,53,84,"VOX",203
34,"34240",87,65,63,3,2,"VOX",14
26,"26001",198,171,165,1,6,"VOX",9
39,"39079",8861,6827,6745,47,82,"VOX",849
45,"45143",1190,940,925,3,15,"VOX",138
36,"36049",7019,5414,5283,48,131,"VOX",265
16,"16253",308,250,249,2,1,"VOX",54
20,"20061",4392,3278,3264,11,14,"VOX",23
9,"9225",81,62,62,0,0,"VOX",7
10,"10169",494,405,395,1,10,"VOX",24
22,"22239",88,71,71,0,0,"VOX",17
16,"16112",1468,1108,1096,6,12,"VOX",84
31,"31144",763,504,503,1,1,"VOX",6
19,"19005",91,63,63,0,0,"VOX",6
49,"49207",217,151,148,4,3,"VOX",12
5,"5023",175,158,155,2,3,"VOX",24
10,"10047",937,772,760,3,12,"VOX",58
49,"49208",364,260,255,5,5,"VOX",22
45,"45145",2613,1950,1921,13,29,"VOX",353
9,"9226",56,47,47,0,0,"VOX",10
5,"5142",90,83,81,0,2,"VOX",16
43,"43175",537,426,419,5,7,"VOX",9
6,"6088",12505,9311,9140,93,171,"VOX",1011
28,"28140",3139,2547,2523,12,24,"VOX",613
12,"12012",2613,2217,2180,6,37,"VOX",167
7,"7023",3757,2777,2735,43,42,"VOX",130
21,"21079",687,503,500,5,3,"VOX",32
13,"13074",944,826,813,1,13,"VOX",99
24,"24084",152,113,113,0,0,"VOX",4
34,"34242",93,66,64,1,2,"VOX",9
9,"9395",122,95,94,0,1,"VOX",14
42,"42010",21,18,16,0,2,"VOX",2
46,"46143",4230,3255,3200,20,55,"VOX",260
22,"22113",470,369,369,2,0,"VOX",28
3,"3060",106,84,84,0,0,"VOX",14
9,"9066",54,41,40,1,1,"VOX",2
8,"8034",784,648,646,1,2,"VOX",11
28,"28066",7515,6105,6039,40,66,"VOX",1548
16,"16116",77,59,59,0,0,"VOX",3
31,"31230",95,79,79,0,0,"VOX",3
26,"26005",2480,1687,1661,5,26,"VOX",175
41,"41039",31500,23692,23345,234,347,"VOX",3387
13,"13076",461,377,369,0,8,"VOX",21
46,"46144",628,511,505,1,6,"VOX",77
44,"44085",49,31,31,0,0,"VOX",11
41,"41040",11111,8768,8679,76,89,"VOX",1747
10,"10173",558,445,439,0,6,"VOX",68
31,"31231",108,73,70,1,3,"VOX",5
12,"12014",167,131,127,1,4,"VOX",9
43,"43030",482,373,372,2,1,"VOX",10
20,"20065",2943,2145,2124,11,21,"VOX",23
4,"4014",149,109,108,0,1,"VOX",4
43,"43104",1762,1410,1401,5,9,"VOX",22
46,"46236",937,764,755,5,9,"VOX",67
28,"28067",4361,3548,3509,14,39,"VOX",655
40,"40186",34,29,29,0,0,"VOX",2
38,"38053",3763,2628,2588,21,40,"VOX",92
19,"19011",236,181,181,0,0,"VOX",15
39,"39083",1074,786,777,4,9,"VOX",52
16,"16264",390,338,328,2,10,"VOX",52
9,"9071",40,32,32,0,0,"VOX",6
7,"7027",22047,14986,14853,139,133,"VOX",2243
8,"8273",2353,1944,1934,9,10,"VOX",35
10,"10175",1361,1031,997,8,34,"VOX",113
37,"37112",152,104,103,0,1,"VOX",10
50,"50132",771,589,576,2,13,"VOX",96
44,"44087",68,56,54,0,2,"VOX",7
22,"22246",71,50,50,0,0,"VOX",3
4,"4016",2128,1643,1621,4,22,"VOX",354
17,"17163",2824,2358,2351,13,7,"VOX",26
13,"13080",321,246,246,1,0,"VOX",41
36,"36055",13551,9908,9682,105,226,"VOX",547
40,"40188",83,71,71,0,0,"VOX",6
45,"45014",4020,2910,2854,22,56,"VOX",412
22,"22117",2414,1798,1784,18,14,"VOX",199
39,"39001",2065,1669,1643,16,26,"VOX",195
42,"42145",134,108,108,0,0,"VOX",7
7,"7028",920,686,676,8,10,"VOX",73
43,"43032",466,379,379,1,0,"VOX",13
30,"30038",15674,11755,11675,59,80,"VOX",2309
28,"28069",56,47,45,2,2,"VOX",7
37,"37226",150,119,119,2,0,"VOX",21
10,"10177",1695,1358,1323,9,35,"VOX",109
44,"44183",63,43,43,0,0,"VOX",9
28,"28070",113,94,94,2,0,"VOX",20
8,"8038",1525,1228,1220,2,8,"VOX",32
9,"9074",834,697,694,8,3,"VOX",114
6,"6095",9511,7338,7152,116,186,"VOX",629
8,"8197",7896,6197,6174,28,23,"VOX",268
45,"45154",1479,1163,1149,5,14,"VOX",226
17,"17165",634,516,512,3,4,"VOX",3
50,"50220",43,37,37,0,0,"VOX",3
23,"23082",1875,1402,1389,7,13,"VOX",90
22,"22248",104,83,82,0,1,"VOX",8
41,"41044",7698,5967,5898,59,69,"VOX",854
5,"5152",655,537,534,3,3,"VOX",124
28,"28071",64,56,54,0,2,"VOX",13
7,"7030",1590,1234,1202,8,32,"VOX",114
34,"34103",97,84,81,0,3,"VOX",19
48,"48004",326,261,260,3,1,"VOX",0
37,"37115",110,81,81,2,0,"VOX",13
8,"8198",4640,3713,3691,23,22,"VOX",130
44,"44090",66,49,49,0,0,"VOX",11
17,"17166",547,460,459,2,1,"VOX",16
23,"23084",907,685,670,0,15,"VOX",132
19,"19018",141,112,110,0,2,"VOX",35
32,"32060",765,577,567,2,10,"VOX",20
45,"45018",551,399,397,3,2,"VOX",100
31,"31115",160,116,116,3,0,"VOX",1
10,"10180",4168,2735,2680,18,55,"VOX",580
9,"9076",24,17,17,1,0,"VOX",3
22,"22250",344,271,264,6,7,"VOX",26
46,"46241",389,318,313,4,5,"VOX",26
16,"16002",195,166,164,1,2,"VOX",41
19,"19019",14,10,10,0,0,"VOX",0
41,"41045",5854,4287,4200,58,87,"VOX",420
37,"37230",214,176,176,0,0,"VOX",16
18,"18021",17869,13238,13004,110,234,"VOX",2091
24,"24216",671,504,502,3,2,"VOX",73
9,"9241",247,192,188,2,4,"VOX",32
18,"18123",288,219,219,2,0,"VOX",30
16,"16272",199,162,161,1,1,"VOX",30
22,"22251",334,269,263,4,6,"VOX",38
50,"50223",916,751,745,13,6,"VOX",52
20,"20071",15036,11090,11025,59,65,"VOX",85
31,"31117",589,420,419,5,1,"VOX",1
4,"4021",180,146,143,0,3,"VOX",12
10,"10182",124,91,90,0,1,"VOX",20
32,"32061",1070,862,855,8,7,"VOX",46
18,"18124",359,269,267,0,2,"VOX",60
49,"49225",127,81,81,0,0,"VOX",5
19,"19021",976,744,724,5,20,"VOX",142
30,"30042",2180,1727,1703,6,24,"VOX",350
32,"32062",766,582,579,1,3,"VOX",15
12,"12022",328,273,269,1,4,"VOX",29
40,"40087",87,70,70,0,0,"VOX",3
8,"8042",2362,1910,1904,7,6,"VOX",84
37,"37232",378,322,321,1,1,"VOX",19
10,"10183",958,748,735,3,13,"VOX",51
22,"22011",97,78,75,2,3,"VOX",8
13,"13089",1609,1336,1299,10,37,"VOX",168
22,"22252",118,100,99,0,1,"VOX",10
50,"50224",65,54,54,1,0,"VOX",3
48,"48007",385,281,279,1,2,"VOX",1
7,"7034",1064,906,900,6,6,"VOX",107
45,"45161",15266,11185,11023,69,162,"VOX",2415
19,"19306",22,19,19,0,0,"VOX",1
37,"37233",56,46,46,2,0,"VOX",0
31,"31242",264,194,194,2,0,"VOX",4
32,"32063",1819,1313,1287,6,26,"VOX",63
3,"3070",2106,1554,1528,9,26,"VOX",204
9,"9246",609,449,441,2,8,"VOX",73
8,"8043",3378,2579,2569,20,10,"VOX",127
41,"41048",2198,1561,1512,22,49,"VOX",133
48,"48008",615,454,448,4,6,"VOX",7
35,"35005",1017,751,743,1,8,"VOX",28
31,"31243",302,241,237,5,4,"VOX",4
24,"24098",1149,882,863,7,19,"VOX",86
29,"29063",303,243,239,1,4,"VOX",29
26,"26017",354,293,290,4,3,"VOX",11
37,"37079",80,69,68,2,1,"VOX",13
50,"50227",110,74,73,2,1,"VOX",14
7,"7036",27950,20870,20707,154,163,"VOX",2830
20,"20075",4346,3158,3134,19,24,"VOX",37
45,"45163",8340,6486,6363,38,123,"VOX",1105
46,"46063",1783,1368,1345,9,23,"VOX",104
28,"28154",5525,4283,4222,24,61,"VOX",753
25,"25086",521,414,411,2,3,"VOX",1
17,"17171",172,143,141,0,2,"VOX",0
26,"26055",39,35,35,1,0,"VOX",3
10,"10187",430,316,311,0,5,"VOX",11
37,"37272",133,106,106,1,0,"VOX",16
38,"38002",972,678,640,3,38,"VOX",19
10,"10065",200,149,149,0,0,"VOX",24
32,"32065",630,478,474,5,4,"VOX",18
23,"23091",679,575,571,3,4,"VOX",55
22,"22129",163,117,116,0,1,"VOX",10
24,"24100",754,602,598,7,4,"VOX",68
16,"16008",83,65,65,0,0,"VOX",1
19,"19032",146,102,101,2,1,"VOX",6
10,"10188",478,387,379,0,8,"VOX",41
44,"44001",65,51,50,0,1,"VOX",7
50,"50228",250,217,214,3,3,"VOX",46
8,"8123",19489,16197,16135,58,62,"VOX",433
25,"25087",56,49,49,0,0,"VOX",0
31,"31002",433,324,324,4,0,"VOX",12
37,"37124",196,153,153,2,0,"VOX",17
19,"19178",30,15,15,0,0,"VOX",1
9,"9250",259,215,214,1,1,"VOX",23
22,"22902",208,160,156,0,4,"VOX",22
26,"26021",2752,2132,2105,10,27,"VOX",280
45,"45167",1385,1143,1130,2,13,"VOX",106
40,"40200",38,32,31,0,1,"VOX",2
28,"28156",1084,885,880,6,5,"VOX",162
5,"5162",75,58,58,0,0,"VOX",2
17,"17082",436,341,339,0,2,"VOX",22
46,"46157",2960,2329,2296,12,33,"VOX",176
31,"31004",32,26,26,0,0,"VOX",0
22,"22903",622,538,533,3,5,"VOX",41
39,"39095",2240,1809,1778,12,31,"VOX",154
8,"8283",6113,4832,4813,33,19,"VOX",92
47,"47055",192,157,154,1,3,"VOX",25
44,"44101",51,43,42,1,1,"VOX",3
27,"27056",1206,896,880,9,16,"VOX",63
32,"32067",1193,827,818,10,9,"VOX",37
4,"4030",1066,783,776,5,7,"VOX",95
45,"45031",2824,2104,2068,20,36,"VOX",411
46,"46249",9159,7113,7012,73,101,"VOX",917
8,"8205",61279,51629,51497,360,132,"VOX",2127
23,"23094",3729,3111,3077,16,34,"VOX",252
45,"45169",186,135,134,0,1,"VOX",18
12,"12029",673,566,556,3,10,"VOX",54
24,"24104",245,173,172,1,1,"VOX",22
24,"24227",1548,1148,1128,5,20,"VOX",195
39,"39096",670,523,518,2,5,"VOX",78
39,"39012",6737,5391,5314,52,77,"VOX",494
5,"5164",17,12,12,0,0,"VOX",3
13,"13901",864,687,673,1,14,"VOX",113
5,"5165",370,293,285,4,8,"VOX",36
31,"31251",3152,2437,2402,12,35,"VOX",121
20,"20079",18142,14055,13971,75,84,"VOX",173
45,"45170",199,154,150,1,4,"VOX",18
12,"12031",3942,2976,2931,24,45,"VOX",423
22,"22905",287,226,224,2,2,"VOX",33
9,"9094",51,46,45,0,1,"VOX",0
35,"35011",24705,17099,16823,129,276,"VOX",1055
33,"33066",42882,30942,30529,401,413,"VOX",3772
40,"40202",55,38,38,0,0,"VOX",3
45,"45034",1291,1066,1039,7,27,"VOX",123
46,"46160",1907,1508,1485,5,23,"VOX",80
37,"37128",242,187,184,1,3,"VOX",16
50,"50232",160,116,114,2,2,"VOX",3
22,"22906",174,137,134,5,3,"VOX",1
50,"50233",104,82,82,0,0,"VOX",12
5,"5048",106,98,94,1,4,"VOX",11
49,"49236",70,55,55,0,0,"VOX",7
7,"7043",3430,2465,2438,24,27,"VOX",296
5,"5166",160,128,123,1,5,"VOX",20
42,"42031",26,19,19,1,0,"VOX",2
8,"8286",2919,2210,2199,15,11,"VOX",107
13,"13904",504,394,376,6,18,"VOX",64
6,"6109",3843,3228,3106,26,122,"VOX",176
46,"46161",1472,1200,1172,7,28,"VOX",143
19,"19186",78,67,67,0,0,"VOX",3
10,"10195",7557,5790,5691,38,99,"VOX",755
22,"22137",1015,741,733,9,8,"VOX",89
37,"37130",178,150,150,2,0,"VOX",26
15,"15015",2883,2079,2049,21,30,"VOX",114
6,"6110",137,106,105,0,1,"VOX",7
45,"45174",296,253,250,3,3,"VOX",56
9,"9261",449,343,342,5,1,"VOX",39
45,"45175",614,512,504,3,8,"VOX",67
31,"31132",148,121,121,2,0,"VOX",6
22,"22908",188,133,131,0,2,"VOX",15
24,"24902",335,266,263,1,3,"VOX",27
49,"49116",360,255,248,5,7,"VOX",27
31,"31255",103,87,84,0,3,"VOX",2
5,"5169",219,176,173,1,3,"VOX",15
20,"20902",14229,10567,10495,53,72,"VOX",213
10,"10076",793,597,585,4,12,"VOX",57
31,"31011",709,515,511,4,4,"VOX",20
44,"44107",205,159,158,0,1,"VOX",19
19,"19188",43,34,33,0,1,"VOX",10
44,"44199",39,39,38,5,1,"VOX",6
16,"16143",15,10,10,1,0,"VOX",4
25,"25196",112,94,93,0,1,"VOX",1
19,"19325",144,87,87,1,0,"VOX",7
34,"34127",80,64,64,1,0,"VOX",7
9,"9265",47,38,36,2,2,"VOX",6
4,"4037",1221,975,960,8,15,"VOX",89
7,"7046",16718,10573,10469,94,104,"VOX",1109
41,"41058",17860,12850,12598,152,252,"VOX",1552
20,"20903",4803,3514,3481,24,33,"VOX",39
31,"31257",903,690,679,6,11,"VOX",19
19,"19044",284,226,223,1,3,"VOX",12
45,"45179",495,383,382,3,1,"VOX",38
8,"8211",33731,27698,27561,126,137,"VOX",1000
7,"7047",2371,1775,1747,13,28,"VOX",175
48,"48019",3461,2647,2633,12,14,"VOX",41
5,"5054",1203,946,927,5,19,"VOX",65
5,"5171",67,57,51,1,6,"VOX",5
22,"22143",197,134,132,1,2,"VOX",21
49,"49241",240,199,199,1,0,"VOX",47
19,"19190",2302,1788,1767,13,21,"VOX",143
49,"49119",222,181,180,0,1,"VOX",15
31,"31015",1990,1533,1508,17,25,"VOX",79
12,"12037",17,17,17,1,0,"VOX",0
19,"19045",127,107,107,1,0,"VOX",33
46,"46165",7298,5744,5697,38,47,"VOX",746
44,"44109",102,71,70,1,1,"VOX",14
49,"49242",444,364,359,3,5,"VOX",61
5,"5055",540,448,445,1,3,"VOX",36
3,"3082",12936,9025,8931,57,94,"VOX",958
49,"49120",53,39,39,0,0,"VOX",0
37,"37249",38,28,28,0,0,"VOX",1
7,"7049",1480,1092,1075,10,17,"VOX",102
23,"23003",8644,6604,6523,36,81,"VOX",821
43,"43121",591,463,462,0,1,"VOX",3
19,"19192",1759,1367,1360,3,7,"VOX",336
2,"2077",54,45,44,0,1,"VOX",6
44,"44011",48,32,32,1,0,"VOX",5
6,"6115",1243,898,876,3,22,"VOX",117
4,"4044",1533,1190,1176,8,14,"VOX",125
9,"9433",58,51,50,1,1,"VOX",4
47,"47160",392,317,314,2,3,"VOX",37
40,"40001",706,597,590,7,7,"VOX",85
20,"20906",130,99,98,1,1,"VOX",0
10,"10081",184,142,140,4,2,"VOX",12
35,"35017",27216,17531,17102,133,429,"VOX",1747
31,"31261",237,174,173,3,1,"VOX",23
23,"23004",421,356,355,2,1,"VOX",53
7,"7050",3442,2303,2275,28,28,"VOX",150
33,"33074",3376,2345,2311,41,34,"VOX",181
40,"40211",69,58,58,1,0,"VOX",15
37,"37250",332,232,231,1,1,"VOX",11
9,"9110",77,57,57,0,0,"VOX",8
48,"48022",2316,1645,1631,11,14,"VOX",22
49,"49245",253,183,182,2,1,"VOX",35
44,"44204",27,22,22,0,0,"VOX",6
43,"43049",727,589,584,2,5,"VOX",5
12,"12129",1801,1382,1356,17,26,"VOX",54
31,"31262",234,201,199,2,2,"VOX",7
40,"40003",121,91,89,1,2,"VOX",15
46,"46077",7344,5873,5761,49,112,"VOX",273
46,"46168",1982,1543,1522,5,21,"VOX",163
31,"31018",422,317,312,4,5,"VOX",16
3,"3085",269,243,237,0,6,"VOX",14
47,"47162",68,55,55,0,0,"VOX",12
40,"40212",27,22,20,0,2,"VOX",1
44,"44112",408,303,293,2,10,"VOX",31
22,"22029",119,103,103,0,0,"VOX",20
16,"16151",64,52,52,0,0,"VOX",7
40,"40004",445,348,341,0,7,"VOX",52
46,"46169",32294,24909,24676,157,233,"VOX",2705
40,"40213",95,83,80,1,3,"VOX",8
32,"32078",1108,794,781,15,13,"VOX",24
37,"37365",166,132,131,1,1,"VOX",17
35,"35020",5933,4140,4088,14,52,"VOX",116
9,"9274",1045,875,867,8,8,"VOX",62
14,"14039",2575,2037,1990,14,47,"VOX",139
21,"21002",15922,11918,11773,119,145,"VOX",1898
19,"19334",44,37,37,0,0,"VOX",1
25,"25007",1392,1089,1083,4,6,"VOX",36
19,"19052",21,16,16,0,0,"VOX",0
49,"49247",417,301,294,0,7,"VOX",32
3,"3088",5810,4380,4313,31,67,"VOX",662
26,"26152",27,23,23,1,0,"VOX",3
19,"19198",17,17,17,0,0,"VOX",1
18,"18042",418,344,340,7,4,"VOX",40
46,"46079",313,252,248,1,4,"VOX",35
21,"21040",3181,2303,2227,21,76,"VOX",323
19,"19901",36,32,32,0,0,"VOX",7
37,"37255",42,31,31,2,0,"VOX",3
19,"19053",1929,1472,1458,9,14,"VOX",177
32,"32080",286,223,220,1,3,"VOX",7
14,"14010",4001,3106,3068,15,38,"VOX",214
23,"23008",1434,1155,1133,6,22,"VOX",75
19,"19199",19,17,16,0,1,"VOX",5
24,"24003",608,430,418,0,12,"VOX",65
19,"19054",167,144,141,2,3,"VOX",24
7,"7055",7897,5264,5176,47,88,"VOX",660
37,"37367",185,150,148,4,2,"VOX",15
16,"16155",488,411,408,3,3,"VOX",80
45,"45098",2110,1675,1652,6,23,"VOX",326
50,"50039",467,366,364,3,2,"VOX",37
31,"31024",99,54,54,1,0,"VOX",0
26,"26039",38,34,34,0,0,"VOX",4
45,"45191",521,449,446,0,3,"VOX",49
37,"37256",195,152,150,0,2,"VOX",15
48,"48027",22668,17326,17224,95,102,"VOX",274
49,"49250",1194,954,939,8,15,"VOX",136
41,"41066",1310,1027,1010,1,17,"VOX",26
8,"8217",25355,20935,20855,110,80,"VOX",770
47,"47166",251,196,189,3,7,"VOX",33
49,"49128",533,428,424,7,4,"VOX",34
25,"25009",605,505,491,5,14,"VOX",7
19,"19055",44,34,34,1,0,"VOX",4
7,"7056",5245,3883,3841,32,42,"VOX",362
5,"5181",46,39,39,0,0,"VOX",7
17,"17097",199,172,170,1,2,"VOX",1
20,"20002",355,258,257,8,1,"VOX",0
37,"37144",338,275,273,1,2,"VOX",47
44,"44116",76,62,62,0,0,"VOX",6
16,"16157",190,163,161,1,2,"VOX",35
7,"7057",7404,5117,5028,50,89,"VOX",494
25,"25109",214,179,176,3,3,"VOX",0
47,"47167",242,212,210,0,2,"VOX",38
16,"16032",277,224,223,1,1,"VOX",29
26,"26041",114,84,84,0,0,"VOX",11
21,"21007",6318,4614,4524,50,90,"VOX",382
19,"19058",7375,6122,6061,34,61,"VOX",1067
14,"14013",16604,12618,12388,155,230,"VOX",1537
3,"3092",6688,5444,5370,36,74,"VOX",515
23,"23011",2134,1649,1614,11,35,"VOX",107
37,"37145",244,187,185,3,2,"VOX",22
6,"6124",1656,1323,1296,5,27,"VOX",49
21,"21008",2613,1803,1777,6,26,"VOX",136
34,"34143",157,125,120,1,5,"VOX",9
48,"48029",8613,6697,6642,52,55,"VOX",171
10,"10213",534,447,441,5,6,"VOX",55
39,"39026",1720,1322,1312,5,10,"VOX",203
10,"10092",266,216,211,18,5,"VOX",17
19,"19060",157,128,125,0,3,"VOX",7
31,"31028",220,147,147,0,0,"VOX",2
37,"37147",172,130,127,3,3,"VOX",4
31,"31907",11205,9216,9140,121,76,"VOX",444
44,"44211",35,24,24,0,0,"VOX",1
34,"34006",79,73,70,3,3,"VOX",12
17,"17099",78,59,59,0,0,"VOX",2
3,"3001",345,285,282,1,3,"VOX",17
48,"48031",308,236,236,0,0,"VOX",0
8,"8221",12699,10571,10537,53,34,"VOX",345
31,"31029",916,661,647,7,14,"VOX",20
25,"25112",268,214,212,2,2,"VOX",5
9,"9448",201,161,161,1,0,"VOX",21
6,"6126",2142,1619,1594,9,25,"VOX",154
28,"28007",126831,103108,102202,710,906,"VOX",11780
7,"7060",2665,1976,1964,14,12,"VOX",178
9,"9288",88,73,71,1,2,"VOX",10
10,"10216",1522,1195,1167,9,28,"VOX",125
40,"40012",238,178,175,4,3,"VOX",30
21,"21011",3473,2543,2513,14,30,"VOX",239
12,"12137",37,27,27,0,0,"VOX",0
28,"28176",13836,11415,11326,64,89,"VOX",2490
17,"17192",146,121,120,0,1,"VOX",0
37,"37374",1147,946,923,4,23,"VOX",146
46,"46086",80,69,69,0,0,"VOX",4
5,"5187",1728,1394,1364,7,30,"VOX",151
19,"19064",64,56,56,0,0,"VOX",7
40,"40222",163,143,142,1,1,"VOX",22
5,"5072",94,86,85,1,1,"VOX",25
49,"49014",116,89,88,2,1,"VOX",7
9,"9450",25,17,17,0,0,"VOX",0
12,"12138",19179,14217,14006,124,211,"VOX",1464
40,"40013",56,47,47,0,0,"VOX",3
28,"28080",49801,41938,41705,248,233,"VOX",7834
14,"14017",10945,8514,8386,90,128,"VOX",929
35,"35027",10499,7651,7530,57,121,"VOX",398
26,"26164",51,37,37,1,0,"VOX",2
37,"37376",2164,1606,1581,15,25,"VOX",193
15,"15032",3413,2487,2414,28,73,"VOX",122
10,"10218",1083,810,796,3,14,"VOX",52
34,"34152",125,104,101,0,3,"VOX",13
9,"9294",102,86,85,0,1,"VOX",6
28,"28178",1134,949,935,1,14,"VOX",225
44,"44121",53,38,38,2,0,"VOX",14
25,"25015",335,262,260,8,2,"VOX",2
40,"40014",56,44,43,2,1,"VOX",1
45,"45201",3620,2465,2419,10,46,"VOX",560
7,"7063",1420,1139,1129,10,10,"VOX",130
28,"28082",6063,4939,4889,46,50,"VOX",705
9,"9454",42,37,36,0,1,"VOX",3
29,"29081",261,212,210,2,2,"VOX",30
14,"14018",3611,2802,2741,25,61,"VOX",307
6,"6030",169,147,146,1,1,"VOX",15
4,"4059",1025,742,731,3,11,"VOX",59
25,"25016",2083,1590,1587,8,3,"VOX",17
41,"41073",1685,1172,1157,13,15,"VOX",109
28,"28083",9665,7794,7737,56,57,"VOX",1383
49,"49261",1505,1168,1149,8,19,"VOX",145
5,"5190",53,47,47,1,0,"VOX",20
37,"37266",70,58,56,0,2,"VOX",11
42,"42056",28,25,24,0,1,"VOX",3
31,"31156",239,191,191,1,0,"VOX",8
28,"28011",420,315,311,1,4,"VOX",56
37,"37379",173,152,152,0,0,"VOX",34
25,"25017",232,184,181,0,3,"VOX",0
6,"6130",186,159,154,0,5,"VOX",12
19,"19071",8155,6327,6242,35,85,"VOX",1298
23,"23019",1479,1209,1183,3,26,"VOX",131
14,"14020",338,240,233,2,7,"VOX",30
16,"16167",292,235,229,1,6,"VOX",31
10,"10100",783,584,566,7,18,"VOX",28
22,"22170",668,529,520,4,9,"VOX",48
7,"7065",2302,1633,1603,10,30,"VOX",182
21,"21016",993,770,744,6,26,"VOX",61
34,"34156",50,43,43,0,0,"VOX",3
34,"34018",205,181,177,2,4,"VOX",28
8,"8225",94,81,81,1,0,"VOX",0
17,"17106",143,124,123,0,1,"VOX",0
24,"24134",3294,2540,2479,25,61,"VOX",267
3,"3007",169,145,141,0,4,"VOX",13
50,"50252",5057,3661,3613,36,48,"VOX",471
10,"10904",722,549,543,7,6,"VOX",87
45,"45901",780,593,587,3,6,"VOX",127
20,"20011",1633,1297,1287,2,10,"VOX",9
17,"17197",131,113,113,1,0,"VOX",0
3,"3100",496,402,395,2,7,"VOX",15
46,"46091",115,99,99,0,0,"VOX",17
34,"34019",110,92,91,2,1,"VOX",14
10,"10905",632,491,485,4,6,"VOX",61
24,"24017",538,427,424,2,3,"VOX",49
40,"40125",75,61,61,2,0,"VOX",4
28,"28119",2245,1839,1821,10,18,"VOX",367
44,"44125",65,50,50,0,0,"VOX",4
40,"40126",67,53,51,0,2,"VOX",6
49,"49021",14258,10333,10206,102,127,"VOX",1289
47,"47177",100,80,79,0,1,"VOX",4
25,"25120",92704,68713,68361,445,352,"VOX",2724
22,"22173",218,162,160,1,2,"VOX",16
11,"11001",4342,2928,2870,32,58,"VOX",352
5,"5194",132,111,111,0,0,"VOX",16
28,"28086",5390,3992,3936,26,56,"VOX",743
9,"9303",75,67,67,0,0,"VOX",8
21,"21019",584,441,425,10,16,"VOX",35
17,"17228",285,229,229,1,0,"VOX",8
25,"25021",2541,1891,1882,14,9,"VOX",29
46,"46256",7211,5263,5209,27,54,"VOX",697
49,"49266",70,51,49,2,2,"VOX",3
40,"40020",155,125,119,4,6,"VOX",13
14,"14023",2007,1734,1711,9,23,"VOX",160
10,"10105",2476,1798,1760,21,38,"VOX",229
29,"29086",774,537,532,1,5,"VOX",61
46,"46002",1215,963,959,5,4,"VOX",59
48,"48039",256,218,217,1,1,"VOX",4
6,"6135",1096,915,902,3,13,"VOX",208
5,"5196",57,45,42,0,3,"VOX",2
34,"34160",134,114,112,0,2,"VOX",8
49,"49023",909,682,674,5,8,"VOX",84
48,"48040",1309,979,973,5,6,"VOX",18
13,"13047",5780,4553,4461,32,92,"VOX",527
9,"9467",60,46,46,0,0,"VOX",6
11,"11039",9945,6824,6726,111,98,"VOX",445
16,"16227",108,85,85,1,0,"VOX",12
31,"31163",2002,1507,1475,14,32,"VOX",99
9,"9307",112,87,86,0,1,"VOX",3
35,"35034",8396,4599,4546,55,53,"VOX",442
31,"31042",2695,2071,2043,21,28,"VOX",152
41,"41078",2459,1910,1895,24,15,"VOX",127
18,"18061",1000,827,822,1,5,"VOX",98
6,"6037",1668,1137,1125,6,12,"VOX",122
16,"16048",409,331,330,1,1,"VOX",74
28,"28902",523,418,415,2,3,"VOX",72
37,"37161",121,88,88,0,0,"VOX",16
46,"46258",2636,2100,2079,9,21,"VOX",212
5,"5197",100,84,83,0,1,"VOX",15
11,"11004",89545,60056,59323,741,733,"VOX",11655
39,"39037",2019,1572,1560,2,12,"VOX",185
28,"28089",3842,3087,3048,12,39,"VOX",658
21,"21022",186,132,129,0,3,"VOX",9
36,"36002",3076,2225,2185,19,40,"VOX",103
28,"28090",9128,7590,7516,54,74,"VOX",1178
5,"5083",141,104,103,2,1,"VOX",15
31,"31165",2763,2121,2091,21,30,"VOX",114
15,"15041",9581,7223,7082,96,141,"VOX",247
3,"3105",5471,4099,4003,14,96,"VOX",503
46,"46096",257,220,217,0,3,"VOX",41
8,"8004",209,194,191,0,3,"VOX",0
46,"46005",23013,17487,17286,112,201,"VOX",1845
37,"37275",101,69,67,0,2,"VOX",7
47,"47086",3823,3090,3046,24,44,"VOX",398
49,"49270",137,111,111,0,0,"VOX",14
19,"19082",99,76,75,0,1,"VOX",20
29,"29090",1653,1215,1200,8,15,"VOX",225
43,"43065",382,308,304,1,4,"VOX",6
10,"10110",2224,1618,1559,5,59,"VOX",237
25,"25223",911,732,723,6,9,"VOX",9
46,"46260",2647,2136,2113,8,23,"VOX",178
25,"25025",1378,996,983,8,13,"VOX",43
22,"22178",103,84,84,2,0,"VOX",25
8,"8005",6380,5122,5106,18,16,"VOX",166
19,"19086",1392,1095,1083,7,12,"VOX",113
21,"21025",3898,2765,2705,39,60,"VOX",270
18,"18063",1217,712,702,6,10,"VOX",108
26,"26059",1122,861,841,7,20,"VOX",88
28,"28092",153428,121511,120211,807,1300,"VOX",15246
50,"50259",84,58,58,0,0,"VOX",3
9,"9144",44,37,37,2,0,"VOX",3
40,"40026",113,106,105,2,1,"VOX",8
16,"16051",126,102,100,0,2,"VOX",12
3,"3107",2769,2011,1986,10,25,"VOX",232
42,"42069",1491,1073,1048,20,25,"VOX",65
17,"17204",596,461,460,2,1,"VOX",22
13,"13008",427,304,302,0,2,"VOX",34
25,"25126",284,233,232,1,1,"VOX",0
8,"8006",11774,9039,8981,33,58,"VOX",243
16,"16181",57,46,46,1,0,"VOX",2
43,"43066",155,121,121,1,0,"VOX",1
22,"22182",233,178,174,1,4,"VOX",10
38,"38007",1625,1124,1104,2,20,"VOX",50
9,"9314",92,75,74,1,1,"VOX",5
49,"49273",166,111,110,0,1,"VOX",7
24,"24149",146,123,123,0,0,"VOX",17
13,"13009",1397,1145,1123,4,22,"VOX",194
9,"9149",34,27,27,0,0,"VOX",1
31,"31048",160,133,132,2,1,"VOX",25
8,"8007",6775,5447,5419,21,28,"VOX",96
25,"25029",1607,1270,1265,6,5,"VOX",10
8,"8153",559,460,458,2,2,"VOX",11
19,"19090",90,73,72,1,1,"VOX",2
46,"46263",239,204,200,3,4,"VOX",16
8,"8904",10514,7733,7697,38,36,"VOX",456
48,"48046",12644,9809,9744,46,65,"VOX",81
49,"49031",145,107,103,0,4,"VOX",13
26,"26062",86,74,72,1,2,"VOX",2
11,"11010",6351,4472,4385,140,87,"VOX",391
9,"9483",189,153,150,1,3,"VOX",17
29,"29005",4499,3202,3171,37,31,"VOX",560
36,"36006",11468,8959,8782,66,177,"VOX",399
26,"26063",118,96,95,2,1,"VOX",4
6,"6043",686,553,544,6,9,"VOX",61
43,"43068",483,367,365,5,2,"VOX",32
24,"24151",445,334,328,3,6,"VOX",58
5,"5089",455,354,340,1,14,"VOX",39
14,"14031",566,453,446,2,7,"VOX",75
47,"47186",244448,197042,195276,1561,1766,"VOX",23966
19,"19091",23,19,19,0,0,"VOX",6
46,"46010",950,727,718,6,9,"VOX",85
26,"26181",14,14,14,0,0,"VOX",0
23,"23032",523,443,439,1,4,"VOX",21
25,"25031",57,39,39,0,0,"VOX",3
49,"49154",109,64,63,0,1,"VOX",2
32,"32016",724,543,535,3,8,"VOX",31
41,"41001",1565,1224,1213,8,11,"VOX",75
39,"39043",1523,1246,1220,10,26,"VOX",146
36,"36008",21884,16428,16170,165,258,"VOX",563
40,"40031",540,429,424,6,5,"VOX",57
8,"8009",9480,7649,7620,35,29,"VOX",263
26,"26064",2337,1764,1724,14,40,"VOX",180
12,"12067",523,423,416,1,7,"VOX",24
6,"6144",512,422,416,1,6,"VOX",9
22,"22059",1139,867,855,10,12,"VOX",54
5,"5208",38,31,31,0,0,"VOX",8
4,"4076",1221,951,933,8,18,"VOX",87
37,"37047",228,93,92,1,1,"VOX",5
37,"37170",1370,1009,990,10,19,"VOX",103
46,"46904",805,643,628,13,15,"VOX",70
23,"23034",2490,2033,1999,15,34,"VOX",254
19,"19096",101,81,79,1,2,"VOX",5
9,"9323",59,41,41,2,0,"VOX",7
37,"37049",127,89,89,0,0,"VOX",12
8,"8078",219,176,172,1,4,"VOX",5
10,"10118",281,242,242,2,0,"VOX",19
5,"5093",353,275,269,0,6,"VOX",53
40,"40032",378,287,278,1,9,"VOX",46
44,"44137",188,148,146,0,2,"VOX",20
33,"33010",1724,1211,1202,15,9,"VOX",115
48,"48049",545,448,448,0,0,"VOX",4
10,"10119",574,458,455,0,3,"VOX",40
9,"9325",177,117,117,2,0,"VOX",10
47,"47093",797,628,615,6,13,"VOX",53
29,"29009",1441,1097,1073,8,24,"VOX",32
14,"14034",304,246,239,1,7,"VOX",22
42,"42079",21,18,18,1,0,"VOX",0
5,"5210",79,57,57,0,0,"VOX",10
3,"3114",1581,1263,1237,9,26,"VOX",188
47,"47094",123,110,109,1,1,"VOX",16
19,"19098",18,18,17,0,1,"VOX",0
29,"29099",969,757,735,5,22,"VOX",77
48,"48050",187,153,149,0,4,"VOX",0
34,"34038",268,198,197,0,1,"VOX",40
43,"43071",891,713,706,6,7,"VOX",10
25,"25231",494,410,408,2,2,"VOX",4
16,"16192",43,30,29,0,1,"VOX",5
31,"31056",185,141,134,3,7,"VOX",4
23,"23037",520,431,425,6,6,"VOX",30
46,"46014",3130,2488,2462,7,26,"VOX",296
11,"11017",3194,2265,2221,38,44,"VOX",145
40,"40034",75,63,62,1,1,"VOX",9
12,"12070",499,434,430,3,4,"VOX",32
40,"40071",43,37,31,0,6,"VOX",3
47,"47034",72,57,57,1,0,"VOX",7
17,"17211",831,694,691,1,3,"VOX",9
40,"40142",52,42,40,0,2,"VOX",0
8,"8012",1721,1340,1331,8,9,"VOX",13
23,"23038",3785,3182,3162,16,20,"VOX",531
36,"36014",1872,1373,1345,14,28,"VOX",46
26,"26069",230,187,186,0,1,"VOX",16
6,"6149",10203,8194,8051,72,143,"VOX",974
3,"3116",1159,901,884,3,17,"VOX",86
50,"50267",573,440,434,7,6,"VOX",19
25,"25035",366,306,302,2,4,"VOX",9
37,"37174",983,788,768,0,20,"VOX",94
5,"5097",476,332,327,0,5,"VOX",42
16,"16248",862,730,720,10,10,"VOX",136
16,"16107",98,76,75,1,1,"VOX",4
26,"26070",155,133,132,0,1,"VOX",8
14,"14037",3182,2388,2319,22,69,"VOX",204
37,"37288",276,225,224,5,1,"VOX",41
16,"16195",458,368,364,3,4,"VOX",56
50,"50268",42,33,32,1,1,"VOX",2
50,"50007",49,34,34,0,0,"VOX",0
3,"3117",377,320,313,1,7,"VOX",30
8,"8082",1143,868,861,4,7,"VOX",58
43,"43147",521,446,442,4,4,"VOX",4
44,"44235",89,67,66,2,1,"VOX",4
17,"17213",5535,3998,3985,20,13,"VOX",129
3,"3025",1292,1009,991,7,18,"VOX",223
5,"5215",159,126,124,0,2,"VOX",3
25,"25037",366,286,284,3,2,"VOX",4
32,"32022",1238,924,916,5,8,"VOX",28
34,"34045",73,67,65,0,2,"VOX",6
46,"46017",32990,23940,23694,155,246,"VOX",2946
50,"50008",5185,3753,3711,35,42,"VOX",420
8,"8083",1672,1478,1471,7,7,"VOX",15
12,"12073",132,110,107,1,3,"VOX",11
6,"6052",3969,3043,2970,21,73,"VOX",293
43,"43074",1812,1419,1412,4,7,"VOX",31
17,"17064",326,263,261,2,2,"VOX",3
50,"50269",279,189,186,1,3,"VOX",27
34,"34185",68,53,51,1,2,"VOX",6
8,"8241",69,56,56,0,0,"VOX",1
9,"9334",48,37,35,0,2,"VOX",5
50,"50009",97,72,71,1,1,"VOX",12
23,"23041",491,383,382,0,1,"VOX",73
28,"28106",78429,59182,58471,417,711,"VOX",8181
20,"20030",21198,15734,15654,100,80,"VOX",210
45,"45096",987,829,813,3,16,"VOX",120
12,"12074",761,659,645,7,14,"VOX",86
9,"9014",192,143,142,0,1,"VOX",14
42,"42132",135,114,113,1,1,"VOX",17
9,"9335",87,71,71,0,0,"VOX",2
26,"26074",107,97,96,2,1,"VOX",7
5,"5217",54,44,43,0,1,"VOX",4
31,"31063",83,63,60,2,3,"VOX",0
46,"46019",8948,7150,7067,40,83,"VOX",667
5,"5218",105,82,81,0,1,"VOX",15
9,"9172",168,132,132,1,0,"VOX",25
13,"13026",415,342,340,1,2,"VOX",22
33,"33017",2997,2096,2058,29,38,"VOX",194
30,"30001",4539,3615,3567,16,48,"VOX",497
8,"8243",156,139,139,0,0,"VOX",0
50,"50186",37,28,28,0,0,"VOX",2
23,"23074",2971,2410,2378,8,32,"VOX",181
35,"35021",15014,10909,10792,71,117,"VOX",844
37,"37180",68,39,39,1,0,"VOX",5
46,"46111",11326,8603,8492,55,111,"VOX",1359
40,"40041",967,773,764,9,9,"VOX",82
47,"47196",28,24,24,0,0,"VOX",5
25,"25240",1385,1116,1110,10,6,"VOX",34
8,"8017",2827,2192,2182,16,10,"VOX",56
25,"25040",10614,7791,7734,58,57,"VOX",163
47,"47197",867,721,717,2,4,"VOX",176
8,"8164",934,784,776,1,8,"VOX",17
28,"28109",1622,1205,1192,3,13,"VOX",229
11,"11025",4388,3092,3045,30,47,"VOX",145
15,"15057",12051,8814,8660,89,154,"VOX",313
40,"40043",1791,1472,1447,9,25,"VOX",152
34,"34192",82,68,68,0,0,"VOX",11
50,"50012",96,79,79,1,0,"VOX",8
24,"24043",122,71,69,0,2,"VOX",4
3,"3122",43704,31952,31681,218,271,"VOX",3967
39,"39053",213,146,145,2,1,"VOX",29
37,"37294",11787,9201,9083,76,118,"VOX",1262
9,"9175",119,93,93,0,0,"VOX",7
8,"8018",2551,1998,1984,6,14,"VOX",56
45,"45101",3709,3052,3002,14,50,"VOX",479
34,"34051",91,81,79,0,2,"VOX",10
46,"46022",15325,11197,11072,70,125,"VOX",1168
37,"37296",298,241,239,2,2,"VOX",24
25,"25042",208,160,160,1,0,"VOX",1
18,"18185",542,454,453,2,1,"VOX",86
4,"4090",312,253,249,0,4,"VOX",34
3,"3030",563,474,466,2,8,"VOX",45
36,"36022",9061,6640,6482,47,158,"VOX",233
44,"44240",149,121,121,0,0,"VOX",10
47,"47103",255,215,214,3,1,"VOX",36
48,"48060",3620,2615,2606,13,9,"VOX",10
44,"44149",100,74,73,0,1,"VOX",3
17,"17218",570,468,465,5,3,"VOX",2
50,"50100",306,238,235,3,3,"VOX",9
49,"49050",504,351,351,3,0,"VOX",40
19,"19113",446,352,342,3,10,"VOX",47
38,"38022",18629,12903,12759,84,144,"VOX",544
8,"8088",12248,9945,9904,57,41,"VOX",190
29,"29020",3280,2531,2485,23,46,"VOX",222
50,"50189",678,544,534,5,10,"VOX",63
17,"17220",805,673,665,2,8,"VOX",6
5,"5224",100,91,90,1,1,"VOX",15
8,"8166",962,753,745,7,8,"VOX",6
46,"46206",557,461,455,6,6,"VOX",34
34,"34201",171,139,139,0,0,"VOX",6
29,"29021",159,121,120,0,1,"VOX",8
21,"21046",1714,1097,1071,13,26,"VOX",242
23,"23047",1579,1260,1247,13,13,"VOX",101
3,"3125",336,259,257,1,2,"VOX",25
33,"33022",813,555,543,6,12,"VOX",31
36,"36024",16395,12372,12165,102,207,"VOX",658
40,"40046",82,69,69,1,0,"VOX",8
47,"47013",90,80,78,4,2,"VOX",4
19,"19115",32,23,23,0,0,"VOX",5
28,"28113",36716,29939,29607,224,332,"VOX",4054
23,"23048",820,644,636,1,8,"VOX",109
31,"31070",2628,1930,1881,16,49,"VOX",185
9,"9347",135,108,108,0,0,"VOX",5
40,"40047",32,25,25,0,0,"VOX",0
9,"9180",133,104,99,1,5,"VOX",9
40,"40154",23,20,20,0,0,"VOX",1
5,"5226",65,52,52,0,0,"VOX",7
37,"37300",547,392,391,5,1,"VOX",30
8,"8168",394,287,287,1,0,"VOX",10
15,"15062",5652,3803,3728,25,75,"VOX",142
50,"50276",119,91,91,1,0,"VOX",11
21,"21048",313,243,237,4,6,"VOX",26
27,"27015",4020,2809,2730,33,79,"VOX",147
22,"22207",121,78,78,1,0,"VOX",4
19,"19117",1611,1279,1257,7,22,"VOX",236
44,"44152",67,48,48,2,0,"VOX",8
43,"43081",633,532,531,7,1,"VOX",22
17,"17041",218,166,165,3,1,"VOX",0
13,"13037",790,633,620,3,13,"VOX",50
50,"50277",49,37,37,3,0,"VOX",4
47,"47205",355,263,258,3,5,"VOX",30
14,"14048",1189,948,933,5,15,"VOX",71
40,"40048",35,29,29,0,0,"VOX",1
24,"24172",415,240,237,1,3,"VOX",34
31,"31073",296,218,217,3,1,"VOX",1
3,"3129",1218,994,982,5,12,"VOX",130
22,"22208",194,159,156,1,3,"VOX",7
6,"6162",2895,2289,2254,11,35,"VOX",182
38,"38026",33514,26298,26076,191,222,"VOX",1120
6,"6062",576,435,430,0,5,"VOX",75
30,"30009",12689,10036,9909,50,127,"VOX",1548
9,"9351",62,51,50,1,1,"VOX",10
40,"40156",281,223,222,1,1,"VOX",31
18,"18193",14802,11165,10973,110,192,"VOX",1667
36,"36027",4380,3262,3206,26,56,"VOX",142
25,"25249",176,139,138,1,1,"VOX",3
41,"41017",15712,12048,11896,118,152,"VOX",1905
13,"13039",14212,10929,10761,107,168,"VOX",1247
50,"50106",127,97,96,0,1,"VOX",14
19,"19256",44,32,32,0,0,"VOX",0
45,"45111",53,43,41,0,2,"VOX",1
50,"50018",893,705,696,3,9,"VOX",90
43,"43083",144,116,113,1,3,"VOX",4
2,"2021",1014,836,827,5,9,"VOX",149
17,"17225",207,161,161,0,0,"VOX",3
33,"33027",769,505,497,14,8,"VOX",29
29,"29026",1010,747,736,3,11,"VOX",59
18,"18194",2045,1394,1370,11,24,"VOX",196
31,"31197",65,56,56,0,0,"VOX",0
45,"45112",1841,1250,1220,7,30,"VOX",202
41,"41018",9410,6987,6882,52,105,"VOX",491
31,"31076",2520,2110,2094,21,16,"VOX",278
9,"9190",86,68,67,0,1,"VOX",11
16,"16217",94,77,77,0,0,"VOX",8
25,"25049",155,113,111,0,2,"VOX",4
21,"21053",3287,2375,2322,17,53,"VOX",279
36,"36029",16086,12196,12005,126,191,"VOX",339
34,"34211",175,160,160,0,0,"VOX",29
38,"38029",1493,839,823,5,16,"VOX",43
6,"6065",298,258,255,1,3,"VOX",14
15,"15067",7953,6004,5925,51,79,"VOX",285
33,"33028",1158,635,630,6,5,"VOX",63
17,"17226",895,673,669,3,4,"VOX",48
50,"50020",802,606,600,7,6,"VOX",76
42,"42105",46,37,37,1,0,"VOX",5
36,"36030",3946,2847,2810,26,37,"VOX",119
8,"8172",20417,16196,16144,88,52,"VOX",551
2,"2060",1280,1039,1020,5,19,"VOX",165
17,"17140",639,539,527,4,12,"VOX",5
43,"43110",251,184,184,1,0,"VOX",2
29,"29062",651,576,567,4,9,"VOX",29
3,"3133",41499,26593,26308,151,285,"VOX",3693
22,"22214",118,98,97,1,1,"VOX",10
49,"49180",138,95,95,0,0,"VOX",17
50,"50282",57,47,45,0,2,"VOX",11
49,"49062",105,69,69,1,0,"VOX",5
47,"47020",272,228,225,5,3,"VOX",39
44,"44056",457,352,341,4,11,"VOX",74
13,"13044",2569,1984,1951,12,33,"VOX",297
23,"23055",46343,33603,33225,243,378,"VOX",4643
40,"40089",214,176,170,1,6,"VOX",27
11,"11037",5644,4567,4433,34,134,"VOX",144
12,"12024",133,117,117,0,0,"VOX",14
50,"50022",504,396,386,11,10,"VOX",39
11,"11038",13613,10879,10676,101,203,"VOX",1339
48,"48069",13094,10021,9954,49,67,"VOX",269
3,"3134",141,119,117,0,2,"VOX",8
7,"7002",6612,4721,4672,43,49,"VOX",266
34,"34215",162,143,142,3,1,"VOX",18
47,"47115",276,231,223,1,8,"VOX",41
50,"50023",208,165,164,2,1,"VOX",5
19,"19126",1687,1306,1285,9,21,"VOX",250
47,"47211",48,43,43,1,0,"VOX",14
8,"8254",1753,1485,1482,3,3,"VOX",4
25,"25052",1562,1273,1264,3,9,"VOX",12
35,"35006",31309,23434,23019,221,415,"VOX",1299
37,"37310",172,125,124,3,1,"VOX",4
24,"24142",24730,18823,18504,201,319,"VOX",2393
31,"31245",77,60,59,4,1,"VOX",0
47,"47116",403,321,320,3,1,"VOX",47
47,"47212",358,312,311,3,1,"VOX",94
24,"24060",574,371,369,1,2,"VOX",36
21,"21058",2556,1732,1709,21,23,"VOX",95
20,"20045",46866,33932,33700,191,232,"VOX",1123
28,"28047",42847,33561,33215,216,346,"VOX",4768
14,"14055",18446,13919,13711,148,208,"VOX",1998
26,"26094",69,56,56,0,0,"VOX",1
44,"44159",37,32,32,1,0,"VOX",6
3,"3136",410,329,323,3,6,"VOX",22
48,"48071",6038,4711,4674,27,37,"VOX",79
8,"8019",1117818,875679,872180,4327,3499,"VOX",29374
36,"36034",3319,2384,2347,16,37,"VOX",82
8,"8097",1080,891,880,2,11,"VOX",20
11,"11041",9858,6916,6763,70,153,"VOX",750
40,"40058",309,277,271,0,6,"VOX",39
31,"31084",1948,1483,1472,9,11,"VOX",7
47,"47213",108,84,84,0,0,"VOX",5
25,"25901",287,209,207,1,2,"VOX",3
3,"3137",657,484,480,5,4,"VOX",23
9,"9365",27,19,19,1,0,"VOX",0
27,"27024",1451,1122,1102,5,20,"VOX",22
26,"26096",260,221,212,2,9,"VOX",10
34,"34070",135,101,101,1,0,"VOX",5
42,"42113",521,382,380,3,2,"VOX",34
24,"24063",355,261,261,2,0,"VOX",41
16,"16231",50,40,40,0,0,"VOX",6
11,"11042",1155,870,852,7,18,"VOX",106
9,"9043",186,128,128,1,0,"VOX",15
25,"25055",163,130,129,0,1,"VOX",0
20,"20047",462,337,335,2,2,"VOX",2
14,"14057",6139,5054,4964,51,90,"VOX",308
10,"10027",76,66,66,0,0,"VOX",5
37,"37314",82,72,68,0,4,"VOX",16
31,"31086",13640,11040,10966,116,74,"VOX",633
19,"19133",81,70,70,0,0,"VOX",12
17,"17052",134,104,104,1,0,"VOX",1
19,"19267",21,17,17,1,0,"VOX",0
13,"13052",6313,4844,4762,38,82,"VOX",706
47,"47025",114,98,98,0,0,"VOX",4
44,"44161",430,320,316,1,4,"VOX",33
9,"9044",53,49,47,1,2,"VOX",5
31,"31087",181,136,135,6,1,"VOX",2
29,"29035",1505,1151,1133,6,18,"VOX",86
10,"10151",198,161,157,2,4,"VOX",15
17,"17146",3127,2404,2381,11,23,"VOX",67
48,"48074",3273,2480,2460,14,20,"VOX",50
10,"10152",446,354,350,2,4,"VOX",32
26,"26099",1216,993,973,14,20,"VOX",65
34,"34222",109,81,79,1,2,"VOX",13
15,"15075",12785,9638,9519,121,119,"VOX",750
21,"21063",2620,2037,1992,11,45,"VOX",126
7,"7008",6047,4570,4513,31,57,"VOX",391
28,"28126",47,35,35,0,0,"VOX",6
9,"9045",274,199,196,1,3,"VOX",15
45,"45126",239,173,168,0,5,"VOX",17
9,"9372",204,176,175,1,1,"VOX",22
47,"47027",2775,2246,2222,14,24,"VOX",300
11,"11903",1791,1234,1211,16,23,"VOX",106
43,"43165",572,492,492,1,0,"VOX",8
43,"43092",7235,5200,5174,21,26,"VOX",343
8,"8259",6904,5626,5601,27,25,"VOX",130
25,"25058",4358,3269,3254,7,15,"VOX",54
31,"31089",228,187,184,0,3,"VOX",9
5,"5242",686,588,585,11,3,"VOX",48
48,"48076",284,226,224,1,2,"VOX",2
9,"9206",55,47,47,1,0,"VOX",12
25,"25157",162,137,137,4,0,"VOX",3
49,"49075",134,118,114,1,4,"VOX",7
9,"9373",406,284,268,3,16,"VOX",44
43,"43093",3884,2956,2933,14,23,"VOX",67
50,"50029",604,475,467,7,8,"VOX",19
34,"34224",42,30,29,0,1,"VOX",1
15,"15077",8155,5554,5433,59,121,"VOX",292
21,"21065",255,178,173,2,5,"VOX",28
25,"25059",813,621,612,3,9,"VOX",56
49,"49191",266,216,214,1,2,"VOX",8
44,"44262",143,115,112,0,3,"VOX",13
37,"37204",255,197,195,0,2,"VOX",23
17,"17903",889,726,721,4,5,"VOX",11
41,"41028",2071,1741,1713,18,28,"VOX",185
8,"8181",8061,6442,6402,28,40,"VOX",203
44,"44066",87,66,65,0,1,"VOX",2
41,"41101",6016,4524,4480,42,44,"VOX",409
28,"28054",11891,9476,9395,64,81,"VOX",1655
16,"16240",100,77,76,0,1,"VOX",11
18,"18001",230,173,170,1,3,"VOX",25
3,"3903",2577,1996,1973,11,23,"VOX",297
25,"25060",69,49,49,1,0,"VOX",1
37,"37320",88,67,67,1,0,"VOX",19
39,"39071",422,318,316,0,2,"VOX",20
41,"41029",13483,10357,10199,120,158,"VOX",1261
22,"22096",320,274,272,2,2,"VOX",33
25,"25161",343,243,243,0,0,"VOX",1
12,"12003",943,745,731,6,14,"VOX",97
25,"25907",497,389,386,2,3,"VOX",4
10,"10157",245,185,185,1,0,"VOX",16
31,"31093",275,212,206,0,6,"VOX",3
38,"38041",6970,5288,5258,38,30,"VOX",288
18,"18912",1367,990,984,5,6,"VOX",83
30,"30024",60183,45738,45317,290,421,"VOX",8784
47,"47220",154,119,119,1,0,"VOX",19
45,"45132",2376,1915,1908,13,7,"VOX",450
9,"9378",29,21,20,0,1,"VOX",1
22,"22099",465,365,362,3,3,"VOX",34
37,"37321",149,121,121,0,0,"VOX",9
36,"36041",13621,10098,9939,97,159,"VOX",701
40,"40068",22,21,21,0,0,"VOX",2
13,"13061",5639,4119,4071,56,48,"VOX",562
43,"43021",345,270,269,3,1,"VOX",12
9,"9380",73,53,53,0,0,"VOX",0
28,"28131",13432,10500,10387,81,113,"VOX",1830
47,"47031",196,155,155,3,0,"VOX",31
41,"41901",2703,2242,2201,29,41,"VOX",85
31,"31095",72,61,60,0,1,"VOX",0
47,"47221",100,84,83,1,1,"VOX",17
22,"22229",108,80,80,2,0,"VOX",9
14,"14064",300,231,227,6,4,"VOX",20
26,"26106",76,66,65,0,1,"VOX",1
25,"25062",695,578,573,3,5,"VOX",7
21,"21070",6222,4413,4322,47,91,"VOX",403
9,"9055",48,34,34,1,0,"VOX",4
5,"5249",96,69,69,0,0,"VOX",1
33,"33041",7112,5251,5194,63,57,"VOX",413
46,"46226",31,27,27,0,0,"VOX",1
10,"10038",83,70,69,0,1,"VOX",11
46,"46135",9827,7928,7883,44,45,"VOX",925
2,"2040",563,516,513,3,3,"VOX",53
19,"19280",3611,2805,2767,25,38,"VOX",587
29,"29043",2474,1764,1720,25,44,"VOX",196
41,"41032",3843,3018,2944,17,74,"VOX",249
18,"18914",1657,1315,1278,5,37,"VOX",81
9,"9217",349,268,266,5,2,"VOX",28
17,"17152",11026,7610,7564,70,46,"VOX",459
5,"5251",56,39,39,0,0,"VOX",14
37,"37324",335,276,274,1,2,"VOX",43
47,"47064",37,32,29,0,3,"VOX",4
5,"5174",65,53,52,1,1,"VOX",4
28,"28133",6116,4581,4486,22,95,"VOX",788
27,"27034",1025,647,636,4,11,"VOX",38
9,"9218",347,277,271,0,6,"VOX",19
19,"19148",42,35,33,0,2,"VOX",3
46,"46045",1243,1033,1018,3,15,"VOX",80
33,"33043",658,462,455,4,7,"VOX",50
42,"42128",46,41,41,0,0,"VOX",0
4,"4004",400,320,315,2,5,"VOX",32
22,"22233",80,50,50,0,0,"VOX",2
8,"8029",3560,3027,3019,13,8,"VOX",78
37,"37212",101,85,83,0,2,"VOX",13
16,"16247",63,53,53,1,0,"VOX",7
16,"16064",651,575,569,4,6,"VOX",90
20,"20907",117,88,87,0,1,"VOX",0
15,"15021",5244,3884,3806,70,78,"VOX",162
31,"31139",155,105,105,0,0,"VOX",1
44,"44173",102,85,80,0,5,"VOX",4
19,"19283",32,26,26,0,0,"VOX",2
18,"18006",4087,3109,3042,28,67,"VOX",666
8,"8266",43383,35117,34994,178,123,"VOX",1189
40,"40072",224,198,194,3,4,"VOX",44
40,"40073",385,339,335,6,4,"VOX",38
13,"13067",342,298,295,0,3,"VOX",24
12,"12101",356,297,289,2,8,"VOX",28
12,"12008",224,197,194,1,3,"VOX",21
38,"38046",9271,7297,7212,53,85,"VOX",327
30,"30029",12055,9003,8882,58,121,"VOX",1228
9,"9388",33,28,28,0,0,"VOX",2
18,"18007",741,533,527,6,6,"VOX",48
5,"5254",181,155,153,0,2,"VOX",17
26,"26111",250,209,205,2,4,"VOX",15
23,"23072",1885,1485,1468,5,17,"VOX",161
19,"19285",20,18,18,0,0,"VOX",2
45,"45140",1089,887,870,5,17,"VOX",107
19,"19153",22,22,22,0,0,"VOX",1
46,"46230",14084,10694,10599,67,95,"VOX",1174
43,"43100",3489,2820,2816,15,4,"VOX",163
15,"15023",6318,4501,4436,40,65,"VOX",232
16,"16250",65,41,41,0,0,"VOX",4
4,"4007",731,570,569,0,1,"VOX",104
36,"36047",2287,1601,1585,14,16,"VOX",93
5,"5139",66,59,59,0,0,"VOX",7
25,"25913",86,77,77,0,0,"VOX",0
42,"42006",152,115,112,2,3,"VOX",8
36,"36048",5244,3859,3786,33,73,"VOX",124
40,"40074",245,219,214,5,5,"VOX",16
4,"4008",464,386,383,4,3,"VOX",57
45,"45004",552,434,434,4,0,"VOX",56
19,"19197",27,22,22,0,0,"VOX",0
24,"24040",412,322,320,2,2,"VOX",48
14,"14070",1284,988,969,5,19,"VOX",90
9,"9391",361,286,283,3,3,"VOX",28
4,"4009",151,126,124,3,2,"VOX",17
47,"47038",101,79,79,0,0,"VOX",7
34,"34091",122,103,102,4,1,"VOX",10
25,"25170",261,230,228,4,2,"VOX",1
27,"27040",3035,2285,2234,19,51,"VOX",80
21,"21077",1725,1307,1286,10,21,"VOX",123
33,"33047",1074,841,835,12,6,"VOX",101
42,"42007",109,89,89,1,0,"VOX",7
48,"48087",432,357,356,0,1,"VOX",7
48,"48026",1139,920,913,4,7,"VOX",6
19,"19108",102,92,89,0,3,"VOX",9
30,"30032",2851,2256,2218,14,38,"VOX",349
44,"44114",238,188,184,1,4,"VOX",27
46,"46050",186,157,154,1,3,"VOX",10
50,"50214",18,10,10,0,0,"VOX",0
47,"47229",231,174,168,0,6,"VOX",28
8,"8033",13218,10480,10435,50,45,"VOX",316
16,"16254",203,168,166,1,2,"VOX",16
37,"37332",70,53,53,0,0,"VOX",11
9,"9394",662,495,490,10,5,"VOX",33
26,"26003",389,329,328,1,1,"VOX",19
22,"22242",63,47,45,1,2,"VOX",4
3,"3059",20590,15909,15766,96,143,"VOX",2853
44,"44084",55,45,45,0,0,"VOX",0
42,"42009",77,69,69,2,0,"VOX",8
31,"31228",494,383,382,0,1,"VOX",28
16,"16255",136,108,108,0,0,"VOX",10
25,"25172",1779,1407,1405,3,2,"VOX",18
23,"23076",768,653,646,3,7,"VOX",104
18,"18013",4152,3168,3103,16,65,"VOX",426
46,"46234",327,264,263,5,1,"VOX",15
5,"5144",66,51,51,0,0,"VOX",3
32,"32054",86475,64472,63712,676,760,"VOX",3573
47,"47137",31,23,23,0,0,"VOX",2
7,"7024",7294,4213,4160,44,53,"VOX",332
34,"34094",61,44,44,0,0,"VOX",9
37,"37221",394,299,299,2,0,"VOX",15
19,"19160",905,618,613,3,5,"VOX",145
33,"33050",558,381,375,2,6,"VOX",32
46,"46235",21270,15754,15592,101,162,"VOX",1218
16,"16259",27,22,21,0,1,"VOX",3
48,"48090",6016,4700,4639,24,61,"VOX",91
42,"42011",17,11,11,0,0,"VOX",1
45,"45148",275,209,209,1,0,"VOX",20
31,"31108",1829,1460,1437,16,23,"VOX",88
5,"5262",323,254,254,0,0,"VOX",20
5,"5145",47,27,27,1,0,"VOX",2
40,"40185",815,624,618,4,6,"VOX",68
29,"29053",1694,1263,1245,18,18,"VOX",177
9,"9398",74,59,58,1,1,"VOX",13
30,"30035",19268,14248,14103,92,145,"VOX",3126
33,"33051",6811,4879,4809,63,70,"VOX",662
5,"5263",163,121,120,0,1,"VOX",36
8,"8036",163,134,133,0,1,"VOX",0
14,"14075",557,429,411,5,18,"VOX",20
3,"3062",221,182,180,1,2,"VOX",20
26,"26120",1460,1130,1109,3,21,"VOX",120
23,"23079",3639,2859,2818,20,41,"VOX",306
12,"12108",438,382,379,4,3,"VOX",31
42,"42012",29,23,23,0,0,"VOX",3
5,"5264",57,40,38,1,2,"VOX",2
49,"49095",279,221,217,0,4,"VOX",25
12,"12015",114,99,98,0,1,"VOX",7
34,"34901",1071,854,847,4,7,"VOX",130
41,"41041",9760,7835,7646,44,189,"VOX",1014
28,"28068",11554,9122,9022,44,100,"VOX",1820
28,"28145",2640,2014,1987,11,27,"VOX",314
46,"46055",1284,1031,1021,2,10,"VOX",108
23,"23080",1721,1370,1355,8,15,"VOX",68
23,"23081",1483,1137,1109,7,28,"VOX",110
31,"31234",149,115,114,0,1,"VOX",5
48,"48001",5885,4359,4334,35,25,"VOX",81
8,"8196",19444,15361,15263,90,98,"VOX",889
14,"14902",1121,928,900,7,28,"VOX",36
19,"19015",84,74,73,0,1,"VOX",10
24,"24212",1002,772,764,7,8,"VOX",60
15,"15093",4048,2761,2720,41,41,"VOX",110
45,"45152",547,448,442,1,6,"VOX",52
13,"13081",590,449,440,0,9,"VOX",51
31,"31112",93,71,70,0,1,"VOX",0
33,"33054",1611,1145,1124,8,21,"VOX",140
45,"45015",662,506,500,2,6,"VOX",84
12,"12110",219,168,166,1,2,"VOX",6
40,"40189",479,392,380,2,12,"VOX",57
12,"12017",148,120,116,0,4,"VOX",10
36,"36056",4961,3719,3635,30,84,"VOX",179
19,"19167",129,104,102,0,2,"VOX",34
18,"18121",130,104,103,3,1,"VOX",7
28,"28147",990,779,769,2,10,"VOX",148
48,"48003",14444,11233,11162,43,71,"VOX",113
46,"46239",453,372,366,2,6,"VOX",38
37,"37264",55,42,42,0,0,"VOX",6
22,"22119",1256,963,954,5,9,"VOX",70
26,"26124",776,635,624,5,11,"VOX",40
47,"47046",125,107,104,1,3,"VOX",8
50,"50046",167,134,130,3,4,"VOX",12
37,"37340",142,101,101,0,0,"VOX",17
22,"22007",756,576,571,5,5,"VOX",49
40,"40083",72,53,51,3,2,"VOX",14
46,"46058",1734,1349,1325,9,24,"VOX",100
15,"15002",24007,18075,17857,216,218,"VOX",1061
47,"47047",202,164,161,3,3,"VOX",38
20,"20069",147441,111102,110598,762,504,"VOX",3016
25,"25179",171,134,134,1,0,"VOX",2
40,"40191",204,166,165,1,1,"VOX",30
49,"49222",370,284,282,2,2,"VOX",19
34,"34015",39,32,31,0,1,"VOX",2
47,"47079",54,48,48,0,0,"VOX",12
37,"37116",69,51,51,0,0,"VOX",5
12,"12020",120,107,107,0,0,"VOX",29
25,"25079",285,228,227,0,1,"VOX",6
50,"50047",43,32,31,1,1,"VOX",4
43,"43108",1778,1374,1365,6,9,"VOX",40
47,"47048",175,148,148,0,0,"VOX",25
26,"26126",29,29,29,1,0,"VOX",0
47,"47144",75,63,63,1,0,"VOX",19
19,"19170",189,116,116,0,0,"VOX",15
17,"17167",2609,2122,2102,14,20,"VOX",18
30,"30041",13970,9796,9682,80,114,"VOX",1533
8,"8199",651,542,542,4,0,"VOX",8
8,"8119",6838,5352,5326,31,26,"VOX",239
37,"37343",66,50,48,1,2,"VOX",10
15,"15004",4873,3689,3623,31,66,"VOX",200
37,"37231",239,204,203,6,1,"VOX",24
3,"3068",42,40,40,3,0,"VOX",8
1,"1006",176,127,127,2,0,"VOX",13
43,"43109",2704,1937,1922,16,15,"VOX",165
19,"19171",5302,4297,4238,24,59,"VOX",602
16,"16273",303,236,231,2,5,"VOX",68
18,"18022",13804,9877,9714,92,163,"VOX",1619
26,"26128",96,74,74,1,0,"VOX",5
16,"16003",133,111,110,1,1,"VOX",2
37,"37344",235,171,168,1,3,"VOX",29
20,"20072",4752,3445,3412,24,33,"VOX",50
19,"19022",571,443,434,7,9,"VOX",70
27,"27051",8012,5936,5832,70,104,"VOX",378
29,"29084",27218,19648,19352,173,296,"VOX",3039
24,"24096",108,69,69,0,0,"VOX",6
44,"44219",173,142,136,1,6,"VOX",18
29,"29028",1224,875,858,4,17,"VOX",56
40,"40088",268,200,200,0,0,"VOX",15
23,"23088",6020,4779,4703,56,76,"VOX",352
18,"18023",15645,11708,11561,91,147,"VOX",1862
25,"25082",295,229,229,2,0,"VOX",1
28,"28075",5952,4797,4758,25,39,"VOX",817
24,"24097",204,155,155,7,0,"VOX",12
24,"24219",492,374,371,5,3,"VOX",48
42,"42021",68,44,44,2,0,"VOX",2
26,"26130",201,164,163,0,1,"VOX",12
22,"22048",12593,9614,9528,82,86,"VOX",1155
49,"49227",313,255,254,1,1,"VOX",33
49,"49022",280,243,241,1,2,"VOX",25
50,"50298",5427,4373,4323,30,50,"VOX",620
5,"5158",345,279,274,2,5,"VOX",53
39,"39091",1885,1512,1503,6,9,"VOX",173
10,"10062",393,339,334,0,5,"VOX",17
18,"18127",16822,12735,12537,106,198,"VOX",1631
31,"31244",156,95,94,5,1,"VOX",3
49,"49228",55,47,47,0,0,"VOX",9
18,"18024",831,682,667,6,15,"VOX",72
25,"25085",141,118,117,2,1,"VOX",10
19,"19175",30,19,19,1,0,"VOX",2
28,"28153",795,566,564,5,2,"VOX",69
28,"28076",425,354,349,3,5,"VOX",56
34,"34112",39,30,30,0,0,"VOX",2
40,"40196",32,28,28,1,0,"VOX",7
16,"16046",223,162,161,1,1,"VOX",11
50,"50170",364,286,279,1,7,"VOX",17
13,"13046",693,558,547,0,11,"VOX",56
19,"19220",2536,1833,1813,9,20,"VOX",416
14,"14024",1859,1461,1418,10,43,"VOX",160
9,"9249",50,39,39,0,0,"VOX",3
8,"8045",71,52,49,0,3,"VOX",0
49,"49107",116,82,81,1,1,"VOX",5
4,"4027",226,147,147,1,0,"VOX",28
46,"46064",525,427,424,4,3,"VOX",52
7,"7037",3357,2142,2120,16,22,"VOX",161
33,"33062",388,250,245,9,5,"VOX",10
26,"26132",106,87,87,0,0,"VOX",3
48,"48904",3542,2832,2811,27,21,"VOX",28
37,"37349",103,69,68,0,1,"VOX",6
41,"41050",5180,4217,4149,34,68,"VOX",421
29,"29065",194,150,150,0,0,"VOX",18
49,"49108",454,325,322,2,3,"VOX",30
42,"42064",85,71,71,0,0,"VOX",9
5,"5161",550,444,434,2,10,"VOX",85
50,"50903",2238,1750,1732,11,18,"VOX",239
31,"31124",207,151,150,2,1,"VOX",7
44,"44193",69,57,56,1,1,"VOX",6
47,"47054",613,501,498,0,3,"VOX",71
8,"8282",6711,5696,5677,27,19,"VOX",130
37,"37002",126,81,81,0,0,"VOX",8
34,"34114",198,152,152,0,0,"VOX",28
31,"31247",147,117,115,0,2,"VOX",0
9,"9419",67,53,52,0,1,"VOX",5
35,"35008",6207,4733,4654,42,79,"VOX",274
15,"15010",1819,1194,1181,16,13,"VOX",47
12,"12028",12955,10391,10301,68,90,"VOX",1405
22,"22016",566,423,420,4,3,"VOX",20
21,"21024",466,355,341,4,14,"VOX",24
19,"19314",45,38,38,1,0,"VOX",13
16,"16010",137,104,101,0,3,"VOX",11
39,"39011",1575,1249,1242,3,7,"VOX",177
26,"26136",92,80,80,3,0,"VOX",3
27,"27025",2743,2191,2138,31,53,"VOX",82
48,"48907",340,283,281,1,2,"VOX",1
3,"3075",149,125,125,0,0,"VOX",17
49,"49110",345,222,220,2,2,"VOX",24
46,"46067",1744,1451,1432,4,19,"VOX",212
31,"31249",1823,1381,1373,21,8,"VOX",35
25,"25089",97,72,71,1,1,"VOX",1
40,"40095",464,379,369,2,10,"VOX",95
43,"43115",128,112,111,1,1,"VOX",0
23,"23095",8591,6634,6571,27,63,"VOX",985
33,"33065",1084,761,746,18,15,"VOX",66
42,"42163",46,37,37,0,0,"VOX",3
37,"37352",201,159,158,0,1,"VOX",29
22,"22018",308,234,232,2,2,"VOX",20
44,"44195",84,66,65,1,1,"VOX",8
16,"16902",127,101,101,0,0,"VOX",15
31,"31006",1877,1453,1436,16,17,"VOX",117
15,"15012",3611,2695,2616,36,79,"VOX",141
26,"26139",55,43,43,0,0,"VOX",3
44,"44102",27,22,22,0,0,"VOX",1
37,"37005",67,48,48,2,0,"VOX",4
19,"19227",73,55,53,0,2,"VOX",3
5,"5047",4118,3334,3248,25,86,"VOX",447
10,"10071",124,85,84,0,1,"VOX",3
49,"49235",422,312,301,0,11,"VOX",39
31,"31129",384,260,259,0,1,"VOX",2
40,"40097",125,96,95,1,1,"VOX",13
32,"32070",512,307,304,8,3,"VOX",4
46,"46069",157,130,129,0,1,"VOX",15
15,"15013",6299,4549,4486,45,63,"VOX",249
43,"43116",463,381,379,2,2,"VOX",2
48,"48909",202,172,172,2,0,"VOX",0
12,"12122",767,655,646,3,9,"VOX",71
37,"37007",399,311,306,3,5,"VOX",37
40,"40099",52,46,44,0,2,"VOX",6
31,"31130",322,237,235,7,2,"VOX",1
16,"16055",679,478,477,4,1,"VOX",70
8,"8208",5760,4660,4643,25,17,"VOX",174
24,"24230",410,312,309,5,3,"VOX",20
44,"44227",72,61,61,0,0,"VOX",9
16,"16141",130,105,105,0,0,"VOX",11
19,"19185",27,19,19,0,0,"VOX",2
47,"47059",97,75,75,0,0,"VOX",7
37,"37355",162,137,135,0,2,"VOX",5
28,"28161",51559,41390,40922,255,468,"VOX",8251
37,"37244",128,99,97,1,2,"VOX",13
12,"12033",1951,1528,1506,10,22,"VOX",166
6,"6010",1075,859,846,8,13,"VOX",70
31,"31254",1920,1457,1435,8,22,"VOX",78
8,"8050",136,115,114,0,1,"VOX",0
6,"6011",24665,18486,18253,178,233,"VOX",3014
5,"5051",162,135,131,0,4,"VOX",19
46,"46071",470,382,366,0,16,"VOX",22
25,"25096",888,663,661,2,2,"VOX",14
9,"9427",1364,1002,972,13,30,"VOX",123
35,"35013",6584,5067,4974,49,93,"VOX",295
47,"47060",231,198,195,4,3,"VOX",13
27,"27061",1016,784,763,9,21,"VOX",41
7,"7045",1300,1038,1030,6,8,"VOX",53
37,"37131",171,138,137,0,1,"VOX",28
9,"9101",74,57,57,0,0,"VOX",10
17,"17178",1056,804,798,3,6,"VOX",12
37,"37358",164,142,135,2,7,"VOX",20
37,"37132",325,232,231,0,1,"VOX",13
12,"12124",1840,1477,1460,8,17,"VOX",167
19,"19231",10,7,7,0,0,"VOX",4
22,"22909",301,233,231,4,2,"VOX",24
31,"31012",771,571,564,5,7,"VOX",21
9,"9001",30,27,27,0,0,"VOX",4
10,"10198",1071,945,924,3,21,"VOX",44
9,"9429",55,41,41,0,0,"VOX",8
42,"42034",44,36,36,1,0,"VOX",4
16,"16908",163,135,133,0,2,"VOX",13
19,"19189",115,93,92,0,1,"VOX",21
27,"27063",1715,1236,1198,10,38,"VOX",42
37,"37133",101,84,80,0,4,"VOX",14
1,"1023",262,210,206,3,4,"VOX",7
4,"4038",3110,2235,2203,23,32,"VOX",335
43,"43120",421,302,297,2,5,"VOX",30
46,"46073",1077,867,862,10,5,"VOX",30
8,"8053",2865,2105,2098,17,7,"VOX",74
9,"9103",200,179,179,1,0,"VOX",5
10,"10200",341,262,261,0,1,"VOX",37
44,"44200",39,25,25,0,0,"VOX",5
10,"10078",370,289,278,4,11,"VOX",21
47,"47062",157,134,134,0,0,"VOX",24
32,"32074",993,737,734,4,3,"VOX",37
42,"42036",40,34,33,2,1,"VOX",0
31,"31258",7879,6189,6140,57,49,"VOX",123
24,"24113",351,277,272,2,5,"VOX",24
28,"28164",3202,2553,2530,19,23,"VOX",578
26,"26068",79,62,62,1,0,"VOX",7
17,"17001",580,459,454,3,5,"VOX",15
24,"24156",220,146,144,2,2,"VOX",13
33,"33072",1455,973,963,14,10,"VOX",101
1,"1028",1068,774,772,7,2,"VOX",28
8,"8290",1534,1289,1284,9,5,"VOX",20
23,"23902",2229,1843,1820,7,23,"VOX",83
18,"18037",528,435,426,2,9,"VOX",77
44,"44010",184,137,137,1,0,"VOX",18
16,"16022",78,70,70,0,0,"VOX",9
8,"8054",9155,7468,7428,43,40,"VOX",330
36,"36013",2242,1468,1452,15,16,"VOX",76
46,"46136",2619,2030,2003,24,27,"VOX",253
49,"49121",368,269,266,1,3,"VOX",35
47,"47190",95,81,81,1,0,"VOX",14
24,"24036",272,181,179,4,2,"VOX",11
8,"8213",6547,5270,5245,23,25,"VOX",134
9,"9434",1280,1089,1077,12,12,"VOX",114
8,"8055",541,443,442,2,1,"VOX",13
31,"31138",954,699,698,8,1,"VOX",3
46,"46076",591,497,487,0,10,"VOX",34
12,"12039",792,688,680,3,8,"VOX",32
29,"29067",430670,312817,309994,2768,2823,"VOX",41326
47,"47065",817,658,653,2,5,"VOX",73
9,"9058",395,325,317,1,8,"VOX",55
29,"29045",1681,1263,1242,9,21,"VOX",208
48,"48083",6946,5238,5201,35,37,"VOX",72
11,"11018",1446,1126,1100,6,26,"VOX",134
25,"25005",274,202,202,2,0,"VOX",4
31,"31140",115,83,83,2,0,"VOX",3
4,"4046",848,653,649,5,4,"VOX",77
41,"41062",2175,1763,1746,8,17,"VOX",59
6,"6017",257,211,210,1,1,"VOX",16
5,"5058",72,52,52,0,0,"VOX",6
23,"23005",29940,19587,19330,191,257,"VOX",2744
41,"41006",2738,1971,1945,16,26,"VOX",132
25,"25234",4201,3087,3072,13,15,"VOX",61
8,"8160",316,252,247,2,5,"VOX",2
47,"47192",94,82,81,2,1,"VOX",14
50,"50065",55,43,43,1,0,"VOX",2
42,"42041",31,23,23,1,0,"VOX",3
9,"9438",561,485,473,6,12,"VOX",46
49,"49123",532,406,402,2,4,"VOX",46
40,"40108",110,91,90,0,1,"VOX",8
12,"12130",420,345,341,0,4,"VOX",33
12,"12041",100,76,75,0,1,"VOX",10
19,"19196",90,77,70,1,7,"VOX",19
6,"6018",740,543,536,5,7,"VOX",28
43,"43050",2634,1881,1868,13,13,"VOX",110
49,"49164",139,103,102,2,1,"VOX",15
13,"13023",8950,6359,6271,76,88,"VOX",1454
8,"8215",2589,2044,2034,19,10,"VOX",36
22,"22155",65,54,54,0,0,"VOX",8
8,"8135",6735,5445,5421,36,24,"VOX",166
24,"24001",168,105,104,0,1,"VOX",11
6,"6019",2012,1539,1495,14,44,"VOX",105
33,"33077",1118,772,761,4,11,"VOX",39
50,"50156",209,174,171,1,3,"VOX",23
42,"42178",101,75,75,0,0,"VOX",12
29,"29070",43090,30294,29928,243,366,"VOX",5000
41,"41064",5611,3763,3667,47,96,"VOX",250
4,"4085",371,305,303,2,2,"VOX",47
16,"16111",163,125,122,1,3,"VOX",7
8,"8084",1167,941,936,6,5,"VOX",14
31,"31184",65,48,46,0,2,"VOX",1
10,"10208",121,94,94,2,0,"VOX",4
24,"24002",233,183,183,1,0,"VOX",21
42,"42181",391,319,317,0,2,"VOX",8
46,"46080",985,799,788,5,11,"VOX",80
37,"37142",566,446,444,6,2,"VOX",98
45,"45052",3134,2670,2652,23,18,"VOX",483
22,"22035",226,174,174,0,0,"VOX",9
37,"37368",17,15,11,0,4,"VOX",0
43,"43052",934,765,756,2,9,"VOX",19
17,"17215",2227,1936,1925,12,11,"VOX",38
13,"13072",729,542,531,3,11,"VOX",132
46,"46141",437,367,360,5,7,"VOX",19
36,"36019",1463,1041,1030,14,11,"VOX",48
28,"28171",4382,3202,3134,11,68,"VOX",580
37,"37020",425,341,339,4,2,"VOX",39
46,"46172",5412,3878,3832,18,46,"VOX",591
49,"49008",431,293,289,2,4,"VOX",46
46,"46081",9993,7972,7882,51,90,"VOX",989
35,"35022",51302,33009,32566,198,443,"VOX",2263
37,"37021",69,52,51,1,1,"VOX",9
4,"4087",156,117,116,1,1,"VOX",25
10,"10210",492,362,358,3,4,"VOX",32
31,"31186",288,220,216,1,4,"VOX",3
6,"6155",1825,1316,1292,21,24,"VOX",165
15,"15027",1555,1227,1204,18,23,"VOX",71
40,"40113",408,339,335,6,4,"VOX",44
17,"17007",1752,1430,1422,2,8,"VOX",10
24,"24005",345,255,250,2,5,"VOX",18
25,"25010",196,156,155,2,1,"VOX",0
28,"28172",9751,7994,7928,38,66,"VOX",1694
37,"37022",245,200,196,2,4,"VOX",21
37,"37370",308,256,254,2,2,"VOX",24
9,"9122",88,64,64,0,0,"VOX",10
32,"32082",1178,880,872,12,8,"VOX",24
31,"31026",132,116,112,0,4,"VOX",4
49,"49169",34,28,26,0,2,"VOX",1
37,"37062",77,65,63,0,2,"VOX",11
46,"46113",2527,1906,1892,12,14,"VOX",219
25,"25208",333,252,249,0,3,"VOX",1
34,"34141",176,154,152,0,2,"VOX",25
24,"24006",487,393,387,3,6,"VOX",61
8,"8061",1590,1236,1233,8,3,"VOX",66
43,"43054",2792,2145,2134,21,11,"VOX",40
45,"45194",65,49,48,0,1,"VOX",12
37,"37372",134,104,104,0,0,"VOX",13
24,"24007",753,569,563,4,6,"VOX",57
18,"18046",1753,1206,1185,1,21,"VOX",249
24,"24124",346,231,226,2,5,"VOX",27
9,"9446",12,8,8,0,0,"VOX",0
45,"45195",2072,1615,1583,4,32,"VOX",164
5,"5183",123,104,96,0,8,"VOX",9
45,"45058",352,270,269,5,1,"VOX",24
28,"28174",1840,1363,1349,10,14,"VOX",276
49,"49131",238,182,178,0,4,"VOX",20
8,"8220",2411,2119,2115,13,4,"VOX",24
10,"10214",217,175,175,1,0,"VOX",18
44,"44020",22,18,18,0,0,"VOX",1
5,"5067",74,61,60,0,1,"VOX",8
18,"18047",6074,4437,4353,33,84,"VOX",672
16,"16034",155,124,122,1,2,"VOX",16
8,"8062",1004,829,826,11,3,"VOX",31
49,"49256",242,204,202,4,2,"VOX",37
17,"17010",327,264,263,2,1,"VOX",2
19,"19208",41,34,34,0,0,"VOX",3
40,"40119",166,133,132,1,1,"VOX",33
42,"42051",15,10,10,0,0,"VOX",1
22,"22163",419,363,361,1,2,"VOX",62
49,"49257",310,205,202,2,3,"VOX",26
47,"47075",4775,3849,3784,38,65,"VOX",519
19,"19209",41,35,34,0,1,"VOX",13
4,"4056",164,135,133,1,2,"VOX",14
23,"23015",1332,1066,1048,4,18,"VOX",69
44,"44213",65,46,46,0,0,"VOX",3
45,"45061",2485,1850,1822,7,28,"VOX",249
10,"10217",521,436,432,0,4,"VOX",35
8,"8064",1920,1516,1506,6,10,"VOX",29
34,"34010",553,454,449,3,5,"VOX",55
15,"15031",23779,17963,17787,213,176,"VOX",1137
37,"37263",338,251,246,0,5,"VOX",16
24,"24130",418,331,326,0,5,"VOX",44
42,"42190",92,74,73,1,1,"VOX",4
50,"50163",3787,3041,3022,31,19,"VOX",599
28,"28177",10722,9093,9029,64,64,"VOX",1836
12,"12050",1230,987,972,10,15,"VOX",76
24,"24011",189,122,121,1,1,"VOX",6
47,"47076",17721,14605,14438,134,167,"VOX",1969
19,"19065",114,92,91,0,1,"VOX",9
46,"46250",581614,454786,451184,2675,3602,"VOX",54634
30,"30008",14450,10832,10675,60,157,"VOX",1930
16,"16266",358,281,279,3,2,"VOX",41
6,"6128",4415,3345,3288,34,57,"VOX",325
8,"8065",1180,967,964,4,3,"VOX",20
28,"28009",14500,11656,11564,62,92,"VOX",2065
29,"29024",372,265,250,3,15,"VOX",27
49,"49260",700,558,548,8,10,"VOX",60
12,"12139",302,219,217,3,2,"VOX",26
12,"12051",448,324,319,2,5,"VOX",27
24,"24012",285,204,202,2,2,"VOX",47
37,"37377",218,181,176,2,5,"VOX",24
46,"46179",2116,1723,1678,18,45,"VOX",234
5,"5189",396,325,321,1,4,"VOX",58
37,"37029",193,139,133,1,6,"VOX",18
48,"48034",12639,9519,9443,77,76,"VOX",232
17,"17195",342,296,295,3,1,"VOX",2
32,"32087",1675,1313,1288,18,25,"VOX",61
28,"28179",1450,1115,1100,3,15,"VOX",208
43,"43132",363,292,291,2,1,"VOX",4
17,"17014",63,51,50,0,1,"VOX",2
40,"40157",43,33,33,2,0,"VOX",5
22,"22209",159,139,136,5,3,"VOX",11
46,"46180",651,525,519,0,6,"VOX",39
29,"29082",34113,26248,26002,304,246,"VOX",3647
44,"44123",99,69,69,1,0,"VOX",5
39,"39032",1426,1156,1141,8,15,"VOX",175
44,"44217",31,25,25,0,0,"VOX",6
26,"26049",153,115,115,1,0,"VOX",12
28,"28180",5317,4266,4222,26,44,"VOX",572
19,"19215",144,121,119,0,2,"VOX",24
1,"1052",268,188,187,1,1,"VOX",1
15,"15035",11208,8175,8068,105,107,"VOX",281
26,"26167",50,38,38,1,0,"VOX",3
34,"34017",889,743,738,6,5,"VOX",55
17,"17105",247,194,194,1,0,"VOX",4
46,"46029",20423,15450,15274,100,176,"VOX",2383
46,"46181",16908,12749,12597,82,152,"VOX",1368
45,"45067",2289,1860,1820,17,40,"VOX",244
22,"22046",714,592,587,13,5,"VOX",48
44,"44026",95,76,75,2,1,"VOX",19
41,"41074",2998,2364,2322,17,42,"VOX",134
31,"31036",895,665,659,8,6,"VOX",26
37,"37032",549,431,430,3,1,"VOX",74
6,"6032",78,65,64,0,1,"VOX",12
1,"1053",592,376,373,2,3,"VOX",3
31,"31158",248,182,177,2,5,"VOX",2
49,"49020",261,215,210,2,5,"VOX",25
12,"12142",145,123,121,1,2,"VOX",24
49,"49264",540,372,369,1,3,"VOX",35
28,"28085",4141,3337,3296,13,41,"VOX",528
49,"49179",346,233,232,0,1,"VOX",19
8,"8120",7048,5892,5881,49,11,"VOX",213
46,"46243",124,105,104,0,1,"VOX",3
19,"19172",50,35,35,1,0,"VOX",6
25,"25150",165,136,133,0,3,"VOX",5
31,"31200",748,555,546,5,9,"VOX",7
17,"17047",4968,3447,3429,22,18,"VOX",196
17,"17107",269,221,219,2,2,"VOX",1
18,"18162",929,730,719,4,11,"VOX",122
1,"1054",1013,729,726,2,3,"VOX",13
48,"48038",1158,891,891,2,0,"VOX",3
25,"25020",274,221,221,2,0,"VOX",2
37,"37382",164,135,134,0,1,"VOX",7
16,"16088",101,85,85,1,0,"VOX",6
31,"31160",105,87,86,1,1,"VOX",3
16,"16275",12,12,12,0,0,"VOX",0
22,"22253",57,48,47,0,1,"VOX",2
29,"29030",774,660,657,3,3,"VOX",12
28,"28087",3259,2643,2623,16,20,"VOX",496
42,"42198",19,15,15,0,0,"VOX",1
1,"1055",840,608,602,10,6,"VOX",13
15,"15038",2123,1441,1413,25,28,"VOX",65
26,"26171",156,131,127,0,4,"VOX",11
43,"43062",259,223,220,2,3,"VOX",9
43,"43136",10463,7789,7749,36,40,"VOX",162
24,"24020",434,302,299,1,3,"VOX",35
12,"12057",578,485,473,3,12,"VOX",29
26,"26172",25,23,23,0,0,"VOX",1
16,"16172",349,278,275,3,3,"VOX",36
29,"29087",371,266,263,2,3,"VOX",35
30,"30902",8225,5797,5715,22,82,"VOX",1026
5,"5235",139,106,101,0,5,"VOX",15
19,"19079",8,7,7,1,0,"VOX",1
49,"49064",483,319,317,1,2,"VOX",53
31,"31203",30,22,22,1,0,"VOX",2
23,"23025",2727,2125,2090,8,35,"VOX",298
49,"49145",210,133,131,1,2,"VOX",20
44,"44029",579,466,457,3,9,"VOX",42
42,"42062",20,14,13,0,1,"VOX",0
3,"3011",8014,5870,5810,38,60,"VOX",823
10,"10107",1030,840,828,5,12,"VOX",35
5,"5082",495,399,394,1,5,"VOX",59
17,"17020",3671,3021,3006,11,15,"VOX",31
28,"28017",1280,1017,1012,9,5,"VOX",190
37,"37273",88,67,67,0,0,"VOX",5
42,"42063",47,31,28,0,3,"VOX",0
19,"19222",96,73,72,2,1,"VOX",13
31,"31164",545,438,433,6,5,"VOX",31
19,"19129",27,25,25,0,0,"VOX",2
9,"9472",52,45,44,0,1,"VOX",4
38,"38003",1510,1058,1047,4,11,"VOX",43
12,"12059",228,191,188,0,3,"VOX",21
6,"6137",933,730,723,5,7,"VOX",70
49,"49025",159,126,124,0,2,"VOX",6
13,"13004",996,769,763,3,6,"VOX",75
9,"9309",292,224,223,3,1,"VOX",46
37,"37274",118473,91137,90221,811,916,"VOX",10248
9,"9473",87,76,73,0,3,"VOX",13
19,"19223",101,66,66,1,0,"VOX",3
38,"38004",4490,3242,3202,18,40,"VOX",187
22,"22177",97,81,81,1,0,"VOX",6
16,"16049",144,111,108,1,3,"VOX",13
31,"31166",250,184,184,2,0,"VOX",3
45,"45122",5516,4611,4561,28,50,"VOX",835
9,"9310",15,14,13,1,1,"VOX",0
4,"4070",1545,1192,1182,7,10,"VOX",183
8,"8073",62572,48770,48527,255,243,"VOX",1826
5,"5084",69,46,46,0,0,"VOX",11
10,"10191",523,406,398,3,8,"VOX",53
11,"11006",24522,16656,16392,220,264,"VOX",1958
8,"8231",21132,15940,15880,75,60,"VOX",637
9,"9476",60,50,50,0,0,"VOX",2
9,"9478",45,40,40,0,0,"VOX",3
26,"26176",53,48,48,0,0,"VOX",5
5,"5200",40,27,26,0,1,"VOX",2
22,"22053",786,573,567,3,6,"VOX",37
50,"50084",66,47,47,0,0,"VOX",6
6,"6040",987,747,739,6,8,"VOX",88
49,"49272",77,55,51,0,4,"VOX",5
29,"29092",579,434,426,5,8,"VOX",35
46,"46098",2403,1807,1772,8,35,"VOX",151
25,"25027",977,765,763,4,2,"VOX",10
9,"9312",89,75,74,2,1,"VOX",8
17,"17115",278,226,222,2,4,"VOX",2
11,"11008",17840,12434,12236,181,198,"VOX",1922
10,"10111",1306,1006,994,12,12,"VOX",120
42,"42207",47,41,41,0,0,"VOX",6
31,"31169",2205,1597,1568,17,29,"VOX",97
8,"8074",11054,8273,8235,34,38,"VOX",382
8,"8258",813,661,657,6,4,"VOX",4
5,"5086",76,64,61,0,3,"VOX",13
25,"25127",214,172,172,0,0,"VOX",0
33,"33006",1480,1001,992,9,9,"VOX",63
21,"21027",50,40,39,0,1,"VOX",7
9,"9482",35,28,28,0,0,"VOX",5
40,"40028",105,96,96,1,0,"VOX",16
8,"8903",197,177,176,0,1,"VOX",0
29,"29004",295,233,226,0,7,"VOX",28
4,"4073",336,243,243,0,0,"VOX",44
36,"36005",8122,5895,5776,65,119,"VOX",249
42,"42208",20,16,16,0,0,"VOX",1
6,"6042",981,714,705,4,9,"VOX",39
28,"28052",3949,2890,2818,8,72,"VOX",615
1,"1063",1830,1363,1353,4,10,"VOX",44
17,"17085",291,248,246,0,2,"VOX",1
46,"46100",281,210,205,0,5,"VOX",25
47,"47090",2435,1956,1921,12,35,"VOX",252
40,"40170",1307,1066,1054,7,12,"VOX",191
29,"29094",59350,42199,41749,419,450,"VOX",6544
34,"34171",941,702,688,9,14,"VOX",86
8,"8076",16497,12734,12667,82,67,"VOX",515
20,"20021",186,112,112,0,0,"VOX",0
49,"49032",287,224,222,0,2,"VOX",22
49,"49153",151,110,108,0,2,"VOX",15
25,"25226",242,184,183,4,1,"VOX",1
3,"3902",10578,7654,7530,56,124,"VOX",1784
3,"3111",5565,4183,4149,29,34,"VOX",686
5,"5206",29,21,20,1,1,"VOX",0
16,"16187",55,43,43,0,0,"VOX",5
50,"50002",125,96,91,1,5,"VOX",16
47,"47091",74,64,63,1,1,"VOX",7
25,"25129",159,115,115,2,0,"VOX",1
34,"34034",115,96,95,3,1,"VOX",11
22,"22058",191,157,157,3,0,"VOX",14
37,"37281",39,34,33,0,1,"VOX",3
41,"41085",4170,3337,3270,27,67,"VOX",457
8,"8077",34578,27617,27501,134,116,"VOX",1079
24,"24030",4201,3080,3024,25,56,"VOX",190
8,"8905",2308,1943,1938,7,5,"VOX",32
26,"26183",66,50,50,0,0,"VOX",8
17,"17207",2411,2006,1992,8,14,"VOX",14
46,"46011",7523,5320,5235,28,85,"VOX",820
6,"6045",476,368,362,3,6,"VOX",36
40,"40065",469,376,373,1,3,"VOX",41
10,"10117",243,156,154,1,2,"VOX",9
16,"16189",262,220,220,1,0,"VOX",44
3,"3904",1420,1112,1095,5,17,"VOX",147
34,"34036",238,199,198,1,1,"VOX",22
22,"22060",1172,906,901,13,5,"VOX",65
18,"18068",1606,1293,1277,11,16,"VOX",175
12,"12068",41,26,25,1,1,"VOX",0
50,"50088",282,233,227,2,6,"VOX",16
46,"46042",3348,2825,2774,11,51,"VOX",171
31,"31053",503,375,370,4,5,"VOX",18
49,"49156",230,189,182,0,7,"VOX",26
46,"46194",15813,11654,11511,83,143,"VOX",1346
43,"43070",238,194,193,1,1,"VOX",2
4,"4078",1110,819,814,2,5,"VOX",118
9,"9904",468,371,369,3,2,"VOX",53
2,"2002",435,358,352,2,6,"VOX",51
43,"43144",1236,1025,1021,8,4,"VOX",51
42,"42215",735,540,529,5,11,"VOX",71
32,"32018",1179,950,936,3,14,"VOX",37
18,"18069",497,374,366,4,8,"VOX",45
24,"24155",442,374,371,6,3,"VOX",30
47,"47189",151,126,123,0,3,"VOX",23
2,"2003",133957,105024,104115,786,909,"VOX",16092
12,"12069",53,45,44,1,1,"VOX",10
31,"31177",251,172,168,1,4,"VOX",7
12,"12005",8052,6056,5935,50,121,"VOX",672
49,"49158",203,163,155,0,8,"VOX",8
24,"24194",266,199,199,1,0,"VOX",26
13,"13017",247,189,188,2,1,"VOX",28
43,"43145",4209,3409,3391,9,18,"VOX",106
27,"27003",1772,1271,1241,6,30,"VOX",64
25,"25132",143,118,118,0,0,"VOX",4
9,"9906",1200,975,958,8,17,"VOX",152
19,"19235",98,82,81,0,1,"VOX",5
8,"8080",39,30,30,0,0,"VOX",0
17,"17030",650,479,477,4,2,"VOX",22
34,"34084",155,127,126,1,1,"VOX",35
12,"12127",67,50,50,1,0,"VOX",1
42,"42127",38,27,27,1,0,"VOX",2
39,"39047",1976,1564,1538,8,26,"VOX",131
8,"8185",197,172,171,2,1,"VOX",9
26,"26108",290,241,237,0,4,"VOX",13
47,"47095",41,36,34,2,2,"VOX",12
18,"18071",5612,4271,4184,29,87,"VOX",538
43,"43146",41,35,35,0,0,"VOX",0
22,"22063",159,133,132,2,1,"VOX",27
34,"34041",84,73,72,3,1,"VOX",8
9,"9010",32,27,27,1,0,"VOX",12
19,"19238",44,30,30,1,0,"VOX",8
17,"17031",182,130,129,0,1,"VOX",2
34,"34132",107,84,83,0,1,"VOX",14
8,"8081",353,299,297,2,2,"VOX",4
5,"5175",149,122,119,1,3,"VOX",15
10,"10204",419,342,339,4,3,"VOX",24
37,"37055",118,96,95,0,1,"VOX",6
6,"6050",4042,3246,3163,27,83,"VOX",288
44,"44142",28,21,21,0,0,"VOX",1
10,"10123",575,470,465,2,5,"VOX",30
42,"42219",40,33,32,1,1,"VOX",2
18,"18072",664,481,473,0,8,"VOX",54
24,"24038",3048,2360,2315,23,45,"VOX",163
8,"8108",5192,4204,4189,26,15,"VOX",164
48,"48084",21858,15943,15796,116,147,"VOX",284
46,"46229",911,755,752,5,3,"VOX",112
7,"7018",379,287,286,1,1,"VOX",12
25,"25135",1000,773,769,2,4,"VOX",13
10,"10002",359,284,279,2,5,"VOX",30
29,"29013",1602,1262,1238,12,24,"VOX",84
9,"9332",140,103,102,0,1,"VOX",11
31,"31181",134,94,93,1,1,"VOX",4
24,"24039",1954,1563,1552,28,11,"VOX",241
2,"2008",1123,857,842,9,15,"VOX",126
50,"50184",90,79,79,0,0,"VOX",15
43,"43001",694,543,543,5,0,"VOX",6
16,"16196",602,522,510,3,12,"VOX",37
47,"47132",39,33,33,0,0,"VOX",9
25,"25069",425,329,327,1,2,"VOX",7
17,"17034",7205,5337,5291,16,46,"VOX",154
19,"19106",76,57,57,0,0,"VOX",9
22,"22199",6926,5113,5051,44,62,"VOX",342
31,"31183",713,569,555,6,14,"VOX",42
11,"11021",4926,3592,3486,50,106,"VOX",302
3,"3119",17223,13244,13116,75,128,"VOX",1578
13,"13024",891,636,628,2,8,"VOX",103
18,"18111",2849,2193,2160,24,33,"VOX",346
18,"18076",790,607,604,1,3,"VOX",53
24,"24081",122,91,88,0,3,"VOX",20
30,"30031",500,435,433,3,2,"VOX",55
12,"12042",574,486,479,8,7,"VOX",59
43,"43101",145,122,122,1,0,"VOX",2
37,"37330",318,255,248,2,7,"VOX",47
31,"31062",1075,870,861,10,9,"VOX",41
22,"22068",65,46,44,1,2,"VOX",2
9,"9016",84,55,54,0,1,"VOX",2
47,"47100",119,104,102,2,2,"VOX",10
19,"19243",36,32,31,0,1,"VOX",4
18,"18077",471,372,366,5,6,"VOX",32
49,"49043",265,210,208,1,2,"VOX",18
16,"16199",28,23,23,1,0,"VOX",6
19,"19244",74,54,54,0,0,"VOX",6
6,"6087",2030,1592,1571,16,21,"VOX",198
26,"26038",81,61,61,0,0,"VOX",5
41,"41065",22550,16215,16010,189,205,"VOX",1408
28,"28063",254,203,202,2,1,"VOX",26
12,"12104",6814,5486,5406,35,80,"VOX",539
22,"22069",418,337,334,5,3,"VOX",19
50,"50096",36,22,22,0,0,"VOX",2
28,"28108",3642,2878,2841,16,37,"VOX",518
44,"44238",2294,1763,1743,10,20,"VOX",75
12,"12076",76,64,64,1,0,"VOX",3
40,"40148",228,185,180,0,5,"VOX",14
29,"29050",398,274,269,2,5,"VOX",17
42,"42088",60,53,53,0,0,"VOX",6
12,"12105",816,639,625,5,14,"VOX",98
31,"31106",718,585,581,3,4,"VOX",64
5,"5104",33,24,23,0,1,"VOX",2
43,"43004",6274,4744,4691,39,53,"VOX",151
19,"19110",56,47,47,0,0,"VOX",10
15,"15058",28606,22203,22022,261,181,"VOX",1595
14,"14042",18727,15069,14837,201,232,"VOX",1090
38,"38020",15899,11057,10924,90,133,"VOX",713
40,"40149",486,383,376,3,7,"VOX",45
8,"8086",14017,10746,10677,89,69,"VOX",418
17,"17037",114,98,98,6,0,"VOX",2
12,"12077",4790,3594,3565,39,29,"VOX",447
25,"25041",528,399,396,4,3,"VOX",3
4,"4012",187,163,162,1,1,"VOX",11
48,"48089",3463,2746,2732,10,14,"VOX",29
21,"21902",1144,829,824,9,5,"VOX",26
22,"22074",275,223,221,10,2,"VOX",12
32,"32026",2659,1988,1957,26,31,"VOX",134
38,"38021",1599,1079,1057,8,22,"VOX",50
40,"40044",139,105,103,2,2,"VOX",14
40,"40150",61,53,53,1,0,"VOX",2
13,"13031",2471,2044,2020,15,24,"VOX",291
16,"16073",188,159,155,0,4,"VOX",33
10,"10009",263,196,193,2,3,"VOX",18
49,"49048",114,85,85,0,0,"VOX",11
37,"37063",60,45,45,1,0,"VOX",6
30,"30005",30193,22648,22419,136,229,"VOX",4424
17,"17038",380,312,308,3,4,"VOX",2
37,"37222",86,64,62,0,2,"VOX",8
14,"14044",1620,1279,1264,12,15,"VOX",95
28,"28036",2675,2135,2093,17,42,"VOX",406
3,"3124",460,401,390,2,11,"VOX",18
24,"24167",716,516,505,4,11,"VOX",67
5,"5107",55,43,43,2,0,"VOX",6
43,"43006",676,531,525,4,6,"VOX",10
18,"18187",512,388,387,0,1,"VOX",32
49,"49052",179,125,123,1,2,"VOX",26
16,"16206",196,146,144,3,2,"VOX",27
6,"6158",13362,10282,10112,73,170,"VOX",915
4,"4091",326,267,266,3,1,"VOX",24
50,"50015",81,61,59,1,2,"VOX",1
37,"37067",3254,2742,2714,29,28,"VOX",332
31,"31191",3018,2365,2337,22,28,"VOX",152
10,"10012",564,469,464,1,5,"VOX",38
3,"3032",99,87,87,0,0,"VOX",13
45,"45105",380,284,275,2,9,"VOX",39
4,"4092",2789,2207,2173,6,34,"VOX",318
43,"43154",126,111,111,0,0,"VOX",2
31,"31192",157,133,130,1,3,"VOX",2
25,"25142",365,300,299,2,1,"VOX",9
4,"4093",1919,1346,1326,10,20,"VOX",209
19,"19251",39,31,31,0,0,"VOX",2
49,"49173",344,220,216,1,4,"VOX",12
3,"3127",351,290,277,2,13,"VOX",26
31,"31071",15,13,13,0,0,"VOX",0
44,"44244",68,48,48,4,0,"VOX",4
47,"47014",47,43,43,1,0,"VOX",4
30,"30007",6484,4774,4727,25,47,"VOX",1087
37,"37068",340,256,256,3,0,"VOX",44
22,"22078",438,326,323,3,3,"VOX",27
50,"50191",445,341,337,2,4,"VOX",22
50,"50016",44,31,31,0,0,"VOX",6
49,"49054",849,641,629,5,12,"VOX",92
38,"38025",7088,5166,5089,39,77,"VOX",363
12,"12081",602,488,481,0,7,"VOX",47
24,"24051",394,290,283,3,7,"VOX",28
6,"6061",1084,915,905,8,10,"VOX",43
45,"45016",4442,3621,3583,21,38,"VOX",572
3,"3128",4295,3007,2982,24,25,"VOX",351
32,"32030",944,690,685,7,5,"VOX",19
16,"16212",230,198,196,2,2,"VOX",21
49,"49174",130,93,91,0,2,"VOX",12
35,"35028",10044,6188,6105,52,83,"VOX",482
50,"50104",326,264,259,4,5,"VOX",22
47,"47110",438,352,347,4,5,"VOX",54
44,"44245",245,176,171,1,5,"VOX",23
12,"12082",9573,7672,7570,55,102,"VOX",1143
40,"40049",40,30,29,0,1,"VOX",1
43,"43009",1391,1086,1078,3,8,"VOX",38
10,"10138",540,422,415,3,7,"VOX",12
48,"48064",613,494,492,1,2,"VOX",1
42,"42098",9,8,8,0,0,"VOX",1
28,"28041",4788,4012,3973,23,39,"VOX",803
22,"22249",118,93,93,2,0,"VOX",8
9,"9183",47,41,41,0,0,"VOX",3
33,"33026",8270,5540,5474,69,66,"VOX",618
46,"46028",388,324,319,1,5,"VOX",26
49,"49136",312,227,220,3,7,"VOX",35
17,"17103",5084,3575,3543,13,32,"VOX",176
9,"9184",7,5,5,0,0,"VOX",0
28,"28116",759,621,618,7,3,"VOX",111
12,"12083",89,73,71,1,2,"VOX",10
17,"17043",167,135,134,0,1,"VOX",4
34,"34060",135,111,110,0,1,"VOX",7
44,"44054",94,79,79,0,0,"VOX",8
15,"15066",4008,2931,2886,30,45,"VOX",132
19,"19121",264,219,217,0,2,"VOX",49
22,"22212",70,56,56,0,0,"VOX",5
40,"40052",72,56,56,0,0,"VOX",9
30,"30011",4695,3665,3610,16,55,"VOX",639
7,"7031",24784,16683,16527,160,156,"VOX",2424
9,"9354",33,29,29,2,0,"VOX",5
45,"45158",2546,2026,2001,9,25,"VOX",327
42,"42103",554,448,442,2,6,"VOX",41
18,"18089",14540,10725,10583,65,142,"VOX",1677
31,"31198",37,32,32,0,0,"VOX",2
44,"44249",46,37,37,1,0,"VOX",2
37,"37073",620,481,471,6,10,"VOX",81
49,"49178",747,574,564,4,10,"VOX",100
16,"16086",881,751,747,3,4,"VOX",89
9,"9033",81,69,68,1,1,"VOX",6
49,"49059",88,72,71,0,1,"VOX",14
28,"28118",61,52,51,0,1,"VOX",12
45,"45114",560,441,436,0,5,"VOX",41
32,"32034",1074,855,846,1,9,"VOX",37
3,"3038",335,275,267,1,8,"VOX",35
9,"9243",73,57,55,0,2,"VOX",7
31,"31037",90,72,72,0,0,"VOX",0
16,"16128",51,44,44,0,0,"VOX",2
34,"34108",502,424,415,6,9,"VOX",59
19,"19123",36,33,32,2,1,"VOX",2
22,"22126",87,66,66,0,0,"VOX",4
47,"47146",278,232,230,3,2,"VOX",30
10,"10021",5045,3932,3840,32,92,"VOX",274
22,"22083",445,379,372,5,7,"VOX",21
24,"24177",472,330,326,3,4,"VOX",53
9,"9034",292,239,238,2,1,"VOX",30
23,"23054",376,296,289,1,7,"VOX",22
17,"17227",139,106,106,0,0,"VOX",0
34,"34109",63,42,41,0,1,"VOX",4
12,"12115",208,170,167,1,3,"VOX",28
49,"49265",120,93,92,1,1,"VOX",11
27,"27052",862,645,640,4,5,"VOX",25
44,"44190",65,45,43,0,2,"VOX",0
37,"37078",788,670,658,6,12,"VOX",87
50,"50109",98,69,67,3,2,"VOX",6
43,"43160",1322,1051,1045,0,6,"VOX",56
44,"44251",242,197,187,0,10,"VOX",43
42,"42107",67,48,48,0,0,"VOX",3
25,"25051",1510,1176,1172,6,4,"VOX",21
37,"37195",37,29,29,1,0,"VOX",1
31,"31081",334,259,256,7,3,"VOX",6
12,"12088",57,54,54,0,0,"VOX",5
19,"19262",123,98,97,0,1,"VOX",8
46,"46124",785,680,675,5,5,"VOX",55
24,"24059",821,575,572,3,3,"VOX",22
18,"18059",4253,3166,3123,22,43,"VOX",352
9,"9138",87,74,72,2,2,"VOX",10
37,"37347",464,368,359,2,9,"VOX",54
28,"28088",286,193,193,2,0,"VOX",18
37,"37235",219,170,166,4,4,"VOX",32
3,"3135",192,157,155,0,2,"VOX",4
23,"23057",732,613,611,4,2,"VOX",47
45,"45119",3485,2478,2430,21,48,"VOX",461
25,"25152",144,106,106,1,0,"VOX",2
12,"12089",4546,3353,3304,12,49,"VOX",579
18,"18096",344,265,265,2,0,"VOX",26
2,"2028",118,99,98,4,1,"VOX",6
46,"46216",5252,4291,4263,23,28,"VOX",612
40,"40163",41,38,38,0,0,"VOX",5
25,"25153",192,152,150,1,2,"VOX",4
24,"24061",1736,1350,1328,10,22,"VOX",193
29,"29032",6657,5314,5190,30,124,"VOX",464
34,"34069",2184,1737,1701,16,36,"VOX",166
3,"3104",27091,21366,21119,250,247,"VOX",2074
9,"9363",922,733,725,3,8,"VOX",128
4,"4901",494,381,378,0,3,"VOX",65
4,"4902",45395,31127,30881,251,246,"VOX",9272
17,"17050",674,585,582,5,3,"VOX",8
19,"19265",135,107,107,1,0,"VOX",16
46,"46126",5574,4565,4528,25,37,"VOX",500
8,"8098",2409,1916,1912,9,4,"VOX",87
37,"37198",203,163,162,3,1,"VOX",9
10,"10026",656,515,507,8,8,"VOX",77
23,"23058",8817,6964,6873,48,91,"VOX",665
9,"9199",94,72,70,0,2,"VOX",13
8,"8177",39,31,31,0,0,"VOX",1
18,"18097",995,708,702,4,6,"VOX",116
12,"12091",176,131,130,0,1,"VOX",11
46,"46066",1285,1058,1043,6,15,"VOX",96
44,"44258",53,44,44,0,0,"VOX",7
11,"11901",5698,4167,4080,81,87,"VOX",290
17,"17144",210,171,170,0,1,"VOX",2
26,"26098",99,77,77,1,0,"VOX",4
9,"9311",59,47,46,0,1,"VOX",0
4,"4903",4308,3102,3075,17,27,"VOX",798
25,"25155",618,493,489,2,4,"VOX",9
49,"49187",1202,930,921,8,9,"VOX",139
17,"17145",1432,1113,1103,7,10,"VOX",16
23,"23060",19153,14444,14281,87,163,"VOX",2256
9,"9200",58,40,40,0,0,"VOX",4
22,"22222",517,407,398,5,9,"VOX",70
28,"28050",4367,3411,3384,14,27,"VOX",724
6,"6073",700,506,492,11,14,"VOX",20
45,"45124",2069,1757,1718,14,39,"VOX",227
50,"50115",3275,2399,2355,32,44,"VOX",321
9,"9368",28,21,21,1,0,"VOX",1
37,"37085",5002,3994,3951,40,43,"VOX",721
17,"17054",347,271,271,0,0,"VOX",7
28,"28125",3216,2459,2444,11,15,"VOX",544
17,"17901",983,790,789,3,1,"VOX",7
9,"9201",28,20,19,0,1,"VOX",0
18,"18908",784,599,581,0,18,"VOX",69
39,"39068",649,515,509,7,6,"VOX",56
10,"10030",472,323,318,1,5,"VOX",44
9,"9256",333,260,256,2,4,"VOX",23
41,"41099",3968,2666,2642,23,24,"VOX",328
31,"31210",186,156,156,1,0,"VOX",9
5,"5002",1890,1497,1468,8,29,"VOX",169
34,"34074",683,545,540,4,5,"VOX",55
44,"44065",57,37,36,0,1,"VOX",3
17,"17055",143,126,125,0,1,"VOX",0
6,"6075",475,379,369,2,10,"VOX",23
44,"44261",722,584,578,8,6,"VOX",48
8,"8180",27072,21218,21100,126,118,"VOX",940
47,"47154",146,122,118,2,4,"VOX",10
10,"10031",164,136,135,0,1,"VOX",8
27,"27028",78798,58316,57546,629,770,"VOX",3865
31,"31252",83,57,57,0,0,"VOX",2
46,"46221",345,294,294,0,0,"VOX",26
9,"9315",393,291,286,4,5,"VOX",44
21,"21064",6641,4689,4597,66,92,"VOX",561
8,"8102",28794,22420,22317,92,103,"VOX",563
37,"37129",252,206,202,2,4,"VOX",23
41,"41100",967,765,727,8,38,"VOX",29
10,"10155",1082,825,819,4,6,"VOX",67
16,"16099",184,126,121,0,5,"VOX",22
14,"14061",688,567,556,2,11,"VOX",56
25,"25158",1606,1291,1277,5,14,"VOX",23
2,"2035",1946,1592,1576,15,16,"VOX",291
18,"18101",9410,7280,7181,72,99,"VOX",1036
26,"26026",1265,1061,1049,2,12,"VOX",77
10,"10033",403,306,302,6,4,"VOX",55
40,"40063",6944,5479,5352,39,127,"VOX",634
23,"23063",3764,2812,2781,22,31,"VOX",391
37,"37319",93,67,65,1,2,"VOX",14
37,"37089",62,51,50,0,1,"VOX",4
17,"17057",968,826,822,1,4,"VOX",5
5,"5008",208,168,163,1,5,"VOX",33
24,"24069",39,27,27,0,0,"VOX",2
43,"43094",2120,1659,1646,9,13,"VOX",37
28,"28129",8578,6925,6853,45,72,"VOX",1165
50,"50030",201,138,136,1,2,"VOX",14
37,"37205",217,177,174,0,3,"VOX",30
31,"31092",685,514,511,6,3,"VOX",3
49,"49078",142,113,113,1,0,"VOX",6
23,"23065",1550,1199,1186,4,13,"VOX",119
36,"36040",2517,1895,1853,18,42,"VOX",79
46,"46041",327,251,250,2,1,"VOX",16
50,"50178",276,193,193,4,0,"VOX",15
40,"40173",142,122,117,1,5,"VOX",16
40,"40138",2127,1729,1696,18,33,"VOX",223
8,"8104",653,516,516,2,0,"VOX",7
24,"24070",3941,3007,2947,27,60,"VOX",187
37,"37206",91,66,63,1,3,"VOX",3
34,"34229",58,42,40,1,2,"VOX",1
6,"6079",644,492,487,3,5,"VOX",67
22,"22142",94,80,80,2,0,"VOX",1
48,"48079",395,313,312,2,1,"VOX",2
8,"8183",4563,3628,3613,9,15,"VOX",72
23,"23066",4299,3603,3545,13,58,"VOX",352
28,"28055",907,671,666,5,5,"VOX",103
25,"25908",221,159,158,1,1,"VOX",4
40,"40207",800,662,652,6,10,"VOX",85
38,"38042",3781,2799,2774,11,25,"VOX",94
46,"46134",2380,1836,1825,5,11,"VOX",240
5,"5247",227,182,177,1,5,"VOX",13
50,"50120",55,43,43,2,0,"VOX",5
29,"29042",14447,10383,10199,98,184,"VOX",1604
22,"22102",181,153,151,1,2,"VOX",12
47,"47127",138,92,89,1,3,"VOX",7
24,"24073",442,328,324,2,4,"VOX",37
42,"42125",75,62,62,2,0,"VOX",6
49,"49199",241,174,171,4,3,"VOX",13
22,"22230",288,229,228,3,1,"VOX",23
9,"9267",113,102,101,2,1,"VOX",6
14,"14065",1813,1439,1421,11,18,"VOX",111
9,"9382",30,24,23,0,1,"VOX",3
15,"15081",982,755,741,11,14,"VOX",12
44,"44171",182,130,128,0,2,"VOX",3
25,"25063",95,61,61,0,0,"VOX",8
13,"13063",3652,2692,2649,32,43,"VOX",272
38,"38044",2199,1443,1429,10,14,"VOX",66
17,"17061",183,148,148,0,0,"VOX",0
5,"5056",94,83,83,0,0,"VOX",27
31,"31097",10521,7602,7550,76,52,"VOX",276
46,"46166",8202,6482,6399,39,83,"VOX",643
10,"10039",402,302,301,0,1,"VOX",27
26,"26032",45,37,37,1,0,"VOX",3
43,"43170",878,706,704,7,2,"VOX",11
50,"50294",64,49,47,0,2,"VOX",0
13,"13065",2813,1993,1971,13,22,"VOX",307
8,"8187",153380,120687,120090,637,597,"VOX",4467
41,"41033",4965,3634,3580,27,54,"VOX",437
22,"22232",87,66,65,2,1,"VOX",8
8,"8107",11900,9303,9187,43,116,"VOX",353
49,"49083",50,41,41,1,0,"VOX",4
25,"25167",226,185,185,2,0,"VOX",3
2,"2005",545,443,436,5,7,"VOX",84
13,"13066",2604,2182,2146,6,36,"VOX",328
46,"46228",2417,1953,1913,13,40,"VOX",341
44,"44268",32,30,30,0,0,"VOX",0
49,"49244",49,32,32,1,0,"VOX",2
25,"25036",184,144,143,0,1,"VOX",2
50,"50295",49,46,46,0,0,"VOX",4
6,"6083",46489,34360,33989,270,371,"VOX",4422
50,"50123",436,344,338,1,6,"VOX",39
47,"47130",99,76,76,2,0,"VOX",16
29,"29046",2540,1896,1855,13,41,"VOX",200
37,"37364",757,549,536,7,13,"VOX",53
19,"19104",18,16,16,0,0,"VOX",1
40,"40143",83,73,73,2,0,"VOX",8
34,"34182",753,609,604,6,5,"VOX",56
28,"28135",985,762,756,1,6,"VOX",148
17,"17155",14861,10307,10234,52,73,"VOX",490
20,"20059",8867,6792,6759,21,33,"VOX",18
42,"42130",51,46,45,0,1,"VOX",6
9,"9060",128,111,111,1,0,"VOX",15
5,"5018",24,18,17,0,1,"VOX",1
24,"24199",405,302,297,3,5,"VOX",28
21,"21075",335,256,249,0,7,"VOX",15
37,"37329",39,36,36,0,0,"VOX",9
37,"37101",142,119,117,0,2,"VOX",16
17,"17004",533,445,441,3,4,"VOX",2
41,"41063",2713,1988,1944,17,44,"VOX",207
5,"5216",213,166,165,0,1,"VOX",22
46,"46048",3509,2758,2720,11,38,"VOX",215
24,"24201",1039,775,765,5,10,"VOX",122
19,"19154",59,48,47,0,1,"VOX",12
5,"5257",135,104,104,0,0,"VOX",7
16,"16251",1809,1469,1443,11,26,"VOX",276
49,"49205",367,286,282,5,4,"VOX",30
17,"17005",460,336,331,0,5,"VOX",7
9,"9062",40,39,39,0,0,"VOX",4
8,"8058",1787,1357,1340,5,17,"VOX",53
49,"49006",142,111,111,1,0,"VOX",8
32,"32051",1407,1158,1153,12,5,"VOX",23
46,"46170",3408,2769,2720,16,49,"VOX",374
14,"14040",3755,3047,3006,21,41,"VOX",191
8,"8032",2087,1607,1598,9,9,"VOX",35
40,"40181",4166,3405,3337,21,68,"VOX",362
45,"45005",227,180,174,5,6,"VOX",10
7,"7021",230,183,178,3,5,"VOX",13
13,"13071",38130,27060,26802,237,258,"VOX",2888
26,"26002",827,643,639,5,4,"VOX",87
5,"5022",1571,1295,1282,5,13,"VOX",226
10,"10168",320,209,202,1,7,"VOX",20
2,"2047",107,89,88,1,1,"VOX",10
9,"9442",370,305,301,5,4,"VOX",21
32,"32052",1819,1399,1379,15,20,"VOX",48
33,"33048",136,87,87,1,0,"VOX",6
15,"15024",4346,3210,3151,19,59,"VOX",180
49,"49007",365,271,265,7,6,"VOX",36
24,"24121",616,491,484,4,7,"VOX",71
20,"20001",257,174,172,1,2,"VOX",0
19,"19289",23,19,19,0,0,"VOX",4
22,"22112",9516,7043,6956,84,87,"VOX",984
2,"2048",1178,989,967,7,22,"VOX",134
49,"49090",193,153,151,0,2,"VOX",24
33,"33018",2819,2072,2044,28,28,"VOX",184
37,"37106",249,173,173,1,0,"VOX",14
47,"47009",99,84,84,0,0,"VOX",13
37,"37293",106,75,74,0,1,"VOX",9
16,"16113",3067,2416,2383,15,33,"VOX",339
5,"5143",62,51,51,0,0,"VOX",7
32,"32053",1363,1114,1098,14,16,"VOX",46
45,"45146",101,86,85,0,1,"VOX",14
43,"43029",314,253,252,0,1,"VOX",0
49,"49091",248,185,183,4,2,"VOX",15
17,"17068",246,194,193,0,1,"VOX",1
49,"49209",474,338,334,4,4,"VOX",41
9,"9228",157,136,136,0,0,"VOX",6
45,"45009",464,303,301,2,2,"VOX",51
34,"34243",320,260,258,1,2,"VOX",26
17,"17189",1476,1278,1275,2,3,"VOX",12
26,"26077",17,17,17,0,0,"VOX",4
49,"49047",100,72,72,0,0,"VOX",16
40,"40078",151,123,122,2,1,"VOX",13
28,"28141",6246,4943,4890,44,53,"VOX",967
2,"2050",90,75,75,0,0,"VOX",19
15,"15090",1125,811,800,7,11,"VOX",39
10,"10050",1015,831,823,2,8,"VOX",75
8,"8113",52518,39750,39592,198,158,"VOX",1210
19,"19293",1905,1513,1499,10,14,"VOX",252
25,"25173",1649,1278,1262,5,16,"VOX",29
17,"17161",1018,859,855,1,4,"VOX",5
37,"37109",177,149,149,3,0,"VOX",23
24,"24087",586,469,460,4,9,"VOX",89
8,"8272",165,133,133,0,0,"VOX",0
29,"29075",12890,9033,8949,73,84,"VOX",1307
15,"15091",1103,773,758,16,15,"VOX",50
31,"31109",1664,1290,1283,10,7,"VOX",76
28,"28006",80622,64905,64483,400,422,"VOX",9339
16,"16118",1350,1126,1093,6,33,"VOX",161
46,"46145",22099,16685,16499,128,186,"VOX",1627
6,"6092",555,428,419,3,9,"VOX",44
42,"42142",45,35,35,0,0,"VOX",6
27,"27044",2719,1848,1797,29,51,"VOX",72
25,"25174",390,324,324,0,0,"VOX",3
49,"49216",147,122,114,0,8,"VOX",11
46,"46054",11390,8717,8604,52,113,"VOX",913
31,"31232",25574,19124,18913,236,211,"VOX",2039
24,"24211",263,219,214,3,5,"VOX",40
20,"20066",439,327,326,0,1,"VOX",0
26,"26121",30,21,21,1,0,"VOX",2
30,"30036",15256,10884,10703,56,181,"VOX",2501
43,"43105",156,132,132,3,0,"VOX",1
34,"34100",131,100,97,1,3,"VOX",19
46,"46146",1641,1314,1281,11,33,"VOX",155
8,"8115",3825,2994,2975,12,19,"VOX",92
6,"6093",4345,3356,3281,18,75,"VOX",319
50,"50133",100,82,82,2,0,"VOX",6
16,"16119",179,128,128,0,0,"VOX",20
38,"38901",1456,1024,1010,9,14,"VOX",32
28,"28146",1792,1308,1293,8,15,"VOX",217
16,"16121",233,183,179,0,4,"VOX",18
1,"1001",2005,1438,1419,4,19,"VOX",41
17,"17073",1939,1695,1693,7,2,"VOX",18
44,"44088",23,21,21,0,0,"VOX",3
49,"49096",157,129,123,2,6,"VOX",22
44,"44120",219,158,152,1,6,"VOX",14
14,"14016",1283,1005,994,4,11,"VOX",71
10,"10054",524,435,422,1,13,"VOX",45
34,"34101",45,39,38,0,1,"VOX",5
17,"17193",4312,3202,3179,15,23,"VOX",134
26,"26010",85,68,68,1,0,"VOX",8
44,"44089",52,44,44,0,0,"VOX",12
16,"16122",249,197,196,3,1,"VOX",23
45,"45200",4478,3666,3565,35,101,"VOX",509
4,"4017",1276,907,900,4,7,"VOX",153
20,"20068",188,142,142,1,0,"VOX",1
29,"29057",341,236,233,0,3,"VOX",18
37,"37150",36,31,31,0,0,"VOX",5
23,"23050",90596,69591,68903,460,688,"VOX",10372
15,"15033",2422,1887,1866,13,21,"VOX",76
49,"49259",79,62,61,0,1,"VOX",6
31,"31236",1318,958,950,8,8,"VOX",33
5,"5034",14,12,12,0,0,"VOX",4
19,"19300",788,664,652,2,12,"VOX",146
34,"34904",300,220,220,0,0,"VOX",29
10,"10056",532,434,428,3,6,"VOX",27
42,"42151",38,31,30,0,1,"VOX",0
49,"49099",98,75,74,0,1,"VOX",11
31,"31237",186,151,149,1,2,"VOX",3
50,"50221",32,22,22,0,0,"VOX",2
32,"32059",1703,1248,1228,12,20,"VOX",64
9,"9131",480,412,402,2,10,"VOX",47
45,"45110",1697,1339,1326,11,13,"VOX",225
50,"50194",81,59,59,1,0,"VOX",4
12,"12140",1140,936,922,7,14,"VOX",84
14,"14019",6408,5163,5086,58,77,"VOX",349
45,"45019",7545,5831,5740,52,91,"VOX",772
47,"47143",110,78,78,1,0,"VOX",8
2,"2058",313,218,214,1,4,"VOX",16
42,"42152",67,47,46,0,1,"VOX",13
46,"46150",1797,1275,1257,9,18,"VOX",133
25,"25180",228,176,174,1,2,"VOX",1
45,"45157",2261,1627,1603,8,24,"VOX",372
44,"44092",70,56,55,1,1,"VOX",7
48,"48005",113,80,80,0,0,"VOX",0
17,"17138",845,650,646,0,4,"VOX",21
7,"7032",20888,14257,14096,108,161,"VOX",1114
34,"34210",103,90,90,1,0,"VOX",10
24,"24094",1326,982,966,4,16,"VOX",173
45,"45020",1239,987,973,4,14,"VOX",124
5,"5191",124,105,105,0,0,"VOX",5
3,"3099",42876,32576,32172,192,404,"VOX",5253
24,"24095",307,237,235,0,2,"VOX",69
17,"17077",567,434,434,2,0,"VOX",10
45,"45021",2605,1987,1950,23,37,"VOX",315
42,"42154",99,81,81,1,0,"VOX",5
35,"35003",5582,3441,3391,26,50,"VOX",311
9,"9411",154,118,118,0,0,"VOX",21
5,"5156",234,153,151,0,2,"VOX",32
10,"10102",503,407,403,3,4,"VOX",27
8,"8226",926,811,807,1,4,"VOX",13
1,"1008",802,576,570,3,6,"VOX",11
8,"8068",6878,5456,5437,25,19,"VOX",225
25,"25081",287,221,220,2,1,"VOX",3
28,"28074",140580,113723,112489,776,1234,"VOX",11891
9,"9412",765,564,558,7,6,"VOX",37
43,"43036",865,605,602,1,3,"VOX",25
25,"25050",3269,2457,2446,23,11,"VOX",30
9,"9192",55,48,47,2,1,"VOX",1
17,"17078",336,252,251,3,1,"VOX",2
2,"2061",618,504,500,7,4,"VOX",67
45,"45023",2248,1799,1784,16,15,"VOX",366
49,"49103",394,343,339,3,4,"VOX",41
37,"37034",75,66,66,0,0,"VOX",15
40,"40195",813,630,623,5,7,"VOX",50
34,"34159",370,247,244,5,3,"VOX",21
40,"40230",95,70,67,0,3,"VOX",4
7,"7035",1596,1242,1234,13,8,"VOX",68
24,"24018",174,141,139,0,2,"VOX",19
28,"28152",16839,14205,14151,87,54,"VOX",2940
45,"45116",680,547,537,4,10,"VOX",115
45,"45162",632,481,471,2,10,"VOX",56
41,"41076",2143,1419,1403,14,16,"VOX",71
9,"9083",27,24,23,0,1,"VOX",5
47,"47147",102,85,85,0,0,"VOX",11
43,"43112",250,204,204,1,0,"VOX",2
22,"22254",1094,857,850,11,7,"VOX",52
12,"12116",67,57,57,0,0,"VOX",5
22,"22128",192,155,154,2,1,"VOX",23
26,"26018",10441,8400,8311,64,89,"VOX",515
31,"31121",65,51,51,0,0,"VOX",4
6,"6002",4314,3181,3086,44,95,"VOX",279
32,"32064",480,348,346,2,2,"VOX",13
47,"47052",6752,5665,5589,57,76,"VOX",770
26,"26131",34,34,34,1,0,"VOX",1
46,"46033",196,169,168,3,1,"VOX",10
47,"47179",373,275,273,1,2,"VOX",18
44,"44221",384,320,315,2,5,"VOX",11
11,"11003",1240,898,876,7,22,"VOX",113
6,"6102",1019,852,842,2,10,"VOX",68
45,"45164",172,143,143,1,0,"VOX",17
12,"12117",3545,2770,2698,11,72,"VOX",269
37,"37123",162,122,117,3,5,"VOX",18
16,"16278",63,51,51,0,0,"VOX",8
40,"40198",24,20,20,0,0,"VOX",1
3,"3072",348,297,295,2,2,"VOX",27
31,"31246",128,105,101,3,4,"VOX",6
7,"7038",2025,1581,1556,14,25,"VOX",111
26,"26134",83,70,67,0,3,"VOX",10
35,"35007",518,405,401,0,4,"VOX",23
17,"17232",149,117,116,0,1,"VOX",0
13,"13003",449,346,343,0,3,"VOX",42
46,"46065",1576,1246,1228,6,18,"VOX",137
9,"9088",64,42,42,4,0,"VOX",4
16,"16009",54,49,49,0,0,"VOX",5
50,"50142",24,18,18,0,0,"VOX",0
44,"44002",46,42,42,0,0,"VOX",2
49,"49109",562,445,444,5,1,"VOX",49
45,"45029",188,160,159,0,1,"VOX",10
41,"41051",2311,1770,1734,5,36,"VOX",221
37,"37238",106,88,87,1,1,"VOX",9
5,"5044",250,189,189,1,0,"VOX",21
23,"23093",3131,2428,2380,22,48,"VOX",146
47,"47151",28,22,22,0,0,"VOX",1
34,"34116",55,45,45,0,0,"VOX",9
12,"12060",430,368,365,1,3,"VOX",44
50,"50172",178,134,131,3,3,"VOX",10
10,"10190",521,372,361,2,11,"VOX",44
41,"41052",3027,2357,2288,14,69,"VOX",140
43,"43041",228,179,177,3,2,"VOX",9
32,"32039",1142,895,890,7,5,"VOX",37
8,"8021",61,47,45,0,2,"VOX",1
31,"31045",509,395,390,5,5,"VOX",14
17,"17203",165,135,135,0,0,"VOX",1
26,"26022",187,153,148,0,5,"VOX",15
9,"9255",84,70,70,1,0,"VOX",5
19,"19181",55,47,46,1,1,"VOX",5
37,"37239",206,184,181,3,3,"VOX",7
20,"20078",1145,882,879,4,3,"VOX",1
37,"37164",238,194,193,4,1,"VOX",29
37,"37127",200,145,145,1,0,"VOX",24
47,"47152",68,59,59,0,0,"VOX",8
19,"19037",132,114,112,0,2,"VOX",37
44,"44004",379,312,310,5,2,"VOX",39
32,"32068",1419,998,987,4,11,"VOX",24
49,"49112",118,78,78,2,0,"VOX",5
26,"26023",435,351,347,5,4,"VOX",27
46,"46159",23051,17496,17359,104,137,"VOX",1974
31,"31250",2748,1995,1982,21,13,"VOX",18
35,"35010",3797,2601,2572,9,29,"VOX",104
32,"32069",4256,3358,3309,39,49,"VOX",113
40,"40903",77,63,62,0,1,"VOX",12
37,"37165",31,22,21,0,1,"VOX",4
44,"44132",58,47,47,0,0,"VOX",5
31,"31007",126,101,95,3,6,"VOX",3
37,"37042",41,32,31,1,1,"VOX",6
44,"44035",105,86,84,1,2,"VOX",8
2,"2070",384,318,318,2,0,"VOX",15
8,"8049",1320,981,977,5,4,"VOX",9
26,"26025",89,77,77,0,0,"VOX",9
48,"48045",5194,4138,4098,25,40,"VOX",65
16,"16140",19,16,16,0,0,"VOX",1
31,"31008",63,51,49,1,2,"VOX",0
8,"8233",1846,1485,1478,8,7,"VOX",18
49,"49113",166,139,139,1,0,"VOX",27
22,"22094",98,72,71,2,1,"VOX",3
16,"16186",412,358,354,1,4,"VOX",62
9,"9258",171,142,141,2,1,"VOX",21
14,"14030",7797,6116,6036,54,80,"VOX",516
31,"31049",679,512,505,2,7,"VOX",3
35,"35012",10765,6327,6270,32,57,"VOX",480
24,"24107",214,170,170,2,0,"VOX",16
45,"45036",634,490,482,0,8,"VOX",94
4,"4034",165,107,106,1,1,"VOX",14
8,"8128",577,454,451,0,3,"VOX",12
44,"44197",50,35,35,0,0,"VOX",5
28,"28053",6840,5797,5739,32,58,"VOX",1009
9,"9100",58,46,46,0,0,"VOX",15
9,"9259",227,198,197,2,1,"VOX",41
5,"5168",3500,2774,2730,25,44,"VOX",459
40,"40205",229,185,180,1,5,"VOX",18
42,"42032",142,120,120,0,0,"VOX",6
39,"39015",824,646,644,2,2,"VOX",118
17,"17087",222,177,176,0,1,"VOX",0
16,"16016",216,175,174,3,1,"VOX",43
17,"17118",12916,9521,9460,37,61,"VOX",295
24,"24108",348,268,265,2,3,"VOX",34
10,"10197",108,84,84,0,0,"VOX",13
10,"10116",3728,2849,2776,27,73,"VOX",236
8,"8235",3829,3176,3167,14,9,"VOX",41
3,"3079",18403,14632,14382,114,250,"VOX",1393
34,"34126",254,220,219,3,1,"VOX",48
23,"23099",4822,3687,3633,28,54,"VOX",403
49,"49239",617,437,420,7,17,"VOX",49
50,"50003",119,95,95,1,0,"VOX",12
41,"41057",253,189,188,0,1,"VOX",7
27,"27062",584,467,466,3,1,"VOX",18
16,"16101",139,123,122,0,1,"VOX",18
25,"25130",183,142,140,0,2,"VOX",4
47,"47092",102,86,85,0,1,"VOX",18
37,"37246",5155,4153,4107,33,46,"VOX",476
48,"48018",867,605,603,3,2,"VOX",2
40,"40206",162,132,128,2,4,"VOX",8
17,"17028",297,238,237,1,1,"VOX",2
43,"43046",90,73,73,1,0,"VOX",2
9,"9266",103,85,85,0,0,"VOX",16
25,"25001",139,104,103,1,1,"VOX",0
6,"6112",383,334,334,1,0,"VOX",34
16,"16909",661,540,535,1,5,"VOX",57
16,"16190",4957,4006,3945,36,61,"VOX",674
49,"49118",194,151,151,1,0,"VOX",14
13,"13016",661,508,495,2,13,"VOX",113
16,"16146",87,68,68,0,0,"VOX",3
8,"8131",741,585,585,4,0,"VOX",11
31,"31135",112,76,75,2,1,"VOX",6
45,"45041",3897,2959,2904,28,55,"VOX",622
15,"15049",1091,805,796,8,9,"VOX",24
34,"34129",170,134,132,2,2,"VOX",21
20,"20904",89,50,49,0,1,"VOX",0
14,"14004",1981,1522,1509,8,13,"VOX",215
9,"9162",132,102,102,1,0,"VOX",10
3,"3021",5578,4720,4626,35,94,"VOX",468
8,"8011",1745,1414,1407,10,7,"VOX",11
11,"11015",64073,43152,42713,710,439,"VOX",6366
17,"17090",544,469,468,0,1,"VOX",6
31,"31259",476,347,346,0,1,"VOX",2
45,"45043",783,670,664,6,6,"VOX",67
31,"31016",7752,6114,6064,47,50,"VOX",136
34,"34131",58,51,51,0,0,"VOX",5
33,"33012",5105,3601,3566,46,35,"VOX",416
37,"37013",107,73,72,0,1,"VOX",11
34,"34232",735,595,584,8,11,"VOX",70
17,"17183",255,216,216,0,0,"VOX",1
28,"28058",141251,112674,111423,778,1251,"VOX",14148
41,"41903",6769,5018,4919,73,99,"VOX",484
7,"7016",2931,2201,2178,31,23,"VOX",180
24,"24157",2545,2028,1972,25,56,"VOX",223
9,"9109",1066,686,650,11,36,"VOX",51
8,"8133",128,98,98,5,0,"VOX",1
42,"42175",21,15,15,0,0,"VOX",3
46,"46167",345,255,255,0,0,"VOX",21
8,"8291",4919,3865,3854,28,11,"VOX",197
50,"50210",36,29,29,0,0,"VOX",1
18,"18038",1047,810,787,4,23,"VOX",106
14,"14067",3870,3057,2998,24,59,"VOX",394
36,"36045",24478,18627,18327,157,300,"VOX",631
35,"35018",13056,8699,8618,73,81,"VOX",599
10,"10203",4428,3212,3152,25,60,"VOX",365
47,"47161",3945,3370,3344,20,26,"VOX",710
17,"17003",102,75,75,0,0,"VOX",0
37,"37138",219,180,176,1,4,"VOX",32
10,"10083",96,74,73,0,1,"VOX",16
50,"50240",965,720,702,9,18,"VOX",66
24,"24159",1746,1393,1368,6,25,"VOX",237
39,"39076",3483,2770,2734,21,36,"VOX",304
37,"37100",77,60,59,1,1,"VOX",1
33,"33045",4382,3214,3156,23,58,"VOX",260
42,"42001",251,186,186,2,0,"VOX",23
37,"37252",101,80,79,1,1,"VOX",8
9,"9273",51,46,46,3,0,"VOX",9
44,"44013",11250,8525,8420,95,105,"VOX",1040
5,"5059",92,63,63,0,0,"VOX",12
24,"24117",412,336,335,0,1,"VOX",51
29,"29069",86694,58863,58127,561,736,"VOX",9315
8,"8056",42727,33215,33054,220,161,"VOX",1744
37,"37056",40,33,33,0,0,"VOX",1
31,"31182",30,28,28,1,0,"VOX",1
19,"19240",51,42,41,1,1,"VOX",4
34,"34088",264,211,207,1,4,"VOX",28
23,"23905",1840,1358,1341,9,17,"VOX",158
45,"45187",3976,3365,3308,24,57,"VOX",397
31,"31021",60,47,47,3,0,"VOX",0
2,"2082",95,83,83,0,0,"VOX",11
37,"37140",642,422,418,2,4,"VOX",87
31,"31265",78,52,47,1,5,"VOX",2
16,"16197",66,45,45,0,0,"VOX",1
26,"26037",131,99,98,1,1,"VOX",8
49,"49165",55,53,50,0,3,"VOX",10
13,"13070",766,620,604,6,16,"VOX",76
47,"47164",350,290,286,2,4,"VOX",49
12,"12131",59,50,50,0,0,"VOX",6
5,"5140",106,91,89,0,2,"VOX",13
8,"8162",2124,1659,1651,7,8,"VOX",64
40,"40146",238,205,202,0,3,"VOX",33
8,"8136",11614,9159,9079,84,80,"VOX",433
31,"31022",483,349,345,3,4,"VOX",1
24,"24120",311,209,209,0,0,"VOX",26
45,"45190",458,378,365,2,13,"VOX",64
16,"16154",4752,3798,3732,37,66,"VOX",588
5,"5180",82,61,60,0,1,"VOX",9
25,"25239",595,367,366,3,1,"VOX",12
10,"10209",265,184,184,2,0,"VOX",7
25,"25104",122,91,91,0,0,"VOX",1
15,"15087",5692,3883,3838,53,45,"VOX",159
8,"8295",11184,8566,8529,43,37,"VOX",420
49,"49139",153,111,110,1,1,"VOX",24
25,"25149",1378,1108,1102,3,6,"VOX",6
28,"28033",4082,3172,3140,13,32,"VOX",650
37,"37143",375,308,306,2,2,"VOX",39
12,"12133",60,53,52,1,1,"VOX",14
44,"44208",26,22,22,0,0,"VOX",7
34,"34241",18,17,14,4,3,"VOX",1
21,"21042",15579,8742,8579,138,163,"VOX",1411
43,"43102",463,384,379,2,5,"VOX",7
28,"28064",135,110,104,1,6,"VOX",22
43,"43077",455,342,339,2,3,"VOX",13
35,"35023",11694,8785,8607,67,178,"VOX",514
37,"37257",49,40,40,1,0,"VOX",5
46,"46173",1319,1084,1062,6,22,"VOX",79
42,"42048",60,50,50,0,0,"VOX",7
40,"40008",45,37,37,0,0,"VOX",2
12,"12134",135,102,100,0,2,"VOX",16
29,"29073",1645,1200,1185,13,15,"VOX",134
10,"10212",1645,1283,1238,7,45,"VOX",94
30,"30004",1126,884,876,5,8,"VOX",162
12,"12106",1163,980,951,7,29,"VOX",36
10,"10049",3758,3167,3086,19,81,"VOX",268
27,"27042",1648,1247,1233,21,14,"VOX",32
36,"36021",12099,9105,8974,85,131,"VOX",476
17,"17190",838,681,677,0,4,"VOX",4
49,"49252",304,244,241,6,3,"VOX",14
2,"2901",2185,1633,1613,9,20,"VOX",301
25,"25110",2731,2121,2106,14,15,"VOX",28
28,"28173",519,417,412,4,5,"VOX",78
8,"8139",177,156,156,0,0,"VOX",1
45,"45057",224,188,184,0,4,"VOX",36
44,"44019",68,42,42,0,0,"VOX",9
25,"25011",5260,3908,3871,30,37,"VOX",123
16,"16033",1644,1345,1320,11,25,"VOX",87
17,"17132",1333,1088,1080,9,8,"VOX",30
37,"37335",389,308,301,3,7,"VOX",55
8,"8035",12871,9574,9538,31,36,"VOX",288
26,"26079",620,526,521,0,5,"VOX",74
16,"16159",209,147,144,0,3,"VOX",16
7,"7059",3035,2257,2226,13,31,"VOX",290
35,"35025",1773,1247,1235,9,12,"VOX",79
26,"26043",349,272,268,2,4,"VOX",9
17,"17191",166,145,144,2,1,"VOX",1
12,"12136",2606,2262,2223,17,39,"VOX",375
43,"43055",1988,1631,1622,7,9,"VOX",22
41,"41069",29569,21075,20657,361,418,"VOX",3254
48,"48030",601,490,489,0,1,"VOX",0
23,"23014",2552,2056,2020,11,36,"VOX",176
24,"24168",439,365,360,3,5,"VOX",49
44,"44050",3115,2333,2299,27,34,"VOX",294
24,"24127",268,204,201,3,3,"VOX",11
46,"46176",2045,1450,1434,12,16,"VOX",203
14,"14015",2067,1575,1551,16,24,"VOX",137
34,"34147",160,125,124,1,1,"VOX",26
50,"50162",137,112,110,2,2,"VOX",4
16,"16035",238,190,188,0,2,"VOX",17
24,"24129",111,91,91,1,0,"VOX",17
39,"39028",3870,3131,3094,19,37,"VOX",391
50,"50248",502,390,377,6,13,"VOX",29
28,"28079",2374366,1872679,1859094,11998,13585,"VOX",236874
39,"39029",636,512,512,5,0,"VOX",66
25,"25211",672,513,512,6,1,"VOX",3
10,"10095",314,260,255,2,5,"VOX",19
6,"6127",2809,2285,2258,13,27,"VOX",262
8,"8142",139,126,126,1,0,"VOX",1
26,"26082",100,85,85,0,0,"VOX",5
45,"45107",3423,2806,2770,18,36,"VOX",513
7,"7061",9564,6678,6583,67,95,"VOX",564
40,"40223",228,181,181,0,0,"VOX",25
24,"24170",1839,1417,1391,7,26,"VOX",90
41,"41071",5598,3993,3915,34,78,"VOX",311
34,"34011",386,326,321,2,5,"VOX",47
9,"9451",238,211,207,2,4,"VOX",7
43,"43008",307,202,200,1,2,"VOX",21
33,"33024",225188,169937,168490,1483,1447,"VOX",19604
34,"34057",462,345,330,3,15,"VOX",43
5,"5267",107,71,70,3,1,"VOX",12
19,"19016",57,40,40,0,0,"VOX",6
19,"19066",50,43,43,0,0,"VOX",10
18,"18192",1466,1171,1156,1,15,"VOX",128
20,"20038",380,296,295,0,1,"VOX",0
16,"16163",60,50,50,0,0,"VOX",4
32,"32003",889,667,654,3,13,"VOX",18
9,"9130",66,55,52,0,3,"VOX",9
8,"8223",1886,1434,1425,4,9,"VOX",45
37,"37265",208,184,181,1,3,"VOX",27
9,"9295",54,38,38,0,0,"VOX",1
40,"40224",19,16,16,0,0,"VOX",1
6,"6029",1183,946,935,12,11,"VOX",38
43,"43058",96,77,77,0,0,"VOX",1
40,"40084",53,40,39,0,1,"VOX",6
23,"23018",2268,1738,1722,8,16,"VOX",120
41,"41016",7767,5937,5829,56,108,"VOX",915
45,"45202",3982,3094,3055,8,39,"VOX",565
34,"34208",47,38,38,0,0,"VOX",10
31,"31075",118,96,95,2,1,"VOX",10
26,"26086",15,15,15,0,0,"VOX",2
48,"48035",404,334,331,2,3,"VOX",0
12,"12052",539,453,439,5,14,"VOX",89
44,"44025",5825,4337,4197,50,140,"VOX",415
8,"8144",713,565,563,5,2,"VOX",1
5,"5075",99,79,79,1,0,"VOX",13
9,"9132",171,136,130,1,6,"VOX",18
45,"45066",7770,6064,5962,21,102,"VOX",1194
28,"28117",98,89,87,2,2,"VOX",4
49,"49018",288,225,222,1,3,"VOX",14
19,"19070",67,53,51,0,2,"VOX",5
18,"18053",1561,1102,1099,3,3,"VOX",161
50,"50261",205,171,167,1,4,"VOX",4
44,"44154",248,200,195,2,5,"VOX",21
32,"32089",1220,872,857,15,15,"VOX",18
5,"5231",151,126,126,0,0,"VOX",23
24,"24175",1831,1433,1412,17,21,"VOX",229
7,"7901",594,454,446,6,8,"VOX",46
13,"13041",249,179,171,2,8,"VOX",30
10,"10101",179,140,138,2,2,"VOX",8
26,"26051",210,178,176,1,2,"VOX",27
32,"32005",827,628,622,4,6,"VOX",39
40,"40229",28,24,24,0,0,"VOX",2
28,"28095",1677,1310,1293,4,17,"VOX",274
34,"34077",381,301,293,2,8,"VOX",59
47,"47019",91,74,73,0,1,"VOX",9
32,"32006",1434,1033,1019,8,14,"VOX",37
45,"45068",171,142,142,0,0,"VOX",13
9,"9302",98,75,73,0,2,"VOX",8
37,"37168",407,305,300,0,5,"VOX",48
8,"8278",4893,4034,4018,17,16,"VOX",44
44,"44093",79,73,73,4,0,"VOX",2
29,"29006",665,491,483,5,8,"VOX",70
37,"37306",242,184,181,2,3,"VOX",20
7,"7001",3628,2792,2753,18,39,"VOX",209
6,"6033",1269,1026,1010,4,16,"VOX",100
44,"44027",149,120,119,0,1,"VOX",5
6,"6133",1799,1476,1453,12,23,"VOX",185
28,"28120",1209,991,974,3,17,"VOX",184
46,"46092",263,182,179,1,3,"VOX",15
46,"46244",59626,44018,43679,342,339,"VOX",6117
44,"44094",123,112,112,0,0,"VOX",18
37,"37270",183,143,140,1,3,"VOX",25
42,"42022",206,161,161,1,0,"VOX",28
7,"7902",1091,776,743,10,33,"VOX",28
46,"46062",4572,3571,3510,20,61,"VOX",390
44,"44059",550,446,437,7,9,"VOX",44
33,"33030",873,678,671,1,7,"VOX",91
18,"18163",315,246,241,1,5,"VOX",28
40,"40231",98,80,80,2,0,"VOX",9
16,"16045",185,142,141,0,1,"VOX",17
31,"31162",48,34,33,1,1,"VOX",0
11,"11002",4200,3287,3257,5,30,"VOX",42
9,"9306",98,82,81,1,1,"VOX",12
38,"38001",20907,12323,12197,70,126,"VOX",1038
37,"37159",79,68,68,0,0,"VOX",12
31,"31041",1659,1245,1228,23,17,"VOX",64
37,"37035",165,134,134,0,0,"VOX",14
44,"44191",722,567,561,7,6,"VOX",26
34,"34177",176,154,152,2,2,"VOX",11
39,"39045",351,280,277,1,3,"VOX",15
21,"21057",995,631,629,3,2,"VOX",33
47,"47022",59,56,54,1,2,"VOX",13
6,"6069",3005,2172,2133,24,39,"VOX",168
25,"25022",107,88,88,0,0,"VOX",0
16,"16173",190,141,141,0,0,"VOX",20
40,"40233",396,323,320,2,3,"VOX",43
8,"8176",161,132,131,2,1,"VOX",5
43,"43063",536,401,397,1,4,"VOX",26
16,"16174",168,143,141,1,2,"VOX",25
8,"8149",984,770,768,3,2,"VOX",7
48,"48041",686,581,579,2,2,"VOX",5
19,"19221",35,26,26,0,0,"VOX",3
46,"46186",19529,15294,15125,69,169,"VOX",1957
29,"29089",3161,2477,2426,19,51,"VOX",147
36,"36001",2401,1739,1715,19,24,"VOX",81
31,"31204",36,27,27,1,0,"VOX",1
20,"20016",1524,997,997,1,0,"VOX",7
31,"31043",32,24,24,0,0,"VOX",1
24,"24143",495,388,380,2,8,"VOX",33
11,"11005",4520,3212,3128,23,84,"VOX",207
46,"46217",893,733,723,6,10,"VOX",85
21,"21023",2051,1356,1332,5,24,"VOX",58
44,"44031",82,52,52,1,0,"VOX",7
50,"50025",4516,3417,3364,35,53,"VOX",427
43,"43064",2017,1569,1558,9,11,"VOX",40
10,"10109",1730,1208,1181,12,27,"VOX",113
10,"10108",203,131,130,1,1,"VOX",26
22,"22052",885,708,702,6,6,"VOX",73
5,"5199",37,31,31,0,0,"VOX",2
7,"7006",5332,3769,3722,25,47,"VOX",228
13,"13050",479,399,394,2,5,"VOX",67
24,"24182",411,302,295,4,7,"VOX",25
44,"44032",17,13,13,0,0,"VOX",0
32,"32011",918,526,521,6,5,"VOX",19
25,"25190",257,215,215,0,0,"VOX",1
24,"24103",264,162,161,1,1,"VOX",9
47,"47214",1364,1112,1074,7,38,"VOX",159
25,"25902",542,449,439,3,10,"VOX",12
14,"14027",7876,6227,6103,81,124,"VOX",342
29,"29091",9407,6859,6719,63,140,"VOX",866
42,"42205",85,64,62,0,2,"VOX",7
49,"49149",365,285,282,2,3,"VOX",43
31,"31167",831,651,636,3,15,"VOX",27
18,"18098",5994,4293,4247,29,46,"VOX",518
8,"8152",116,94,94,0,0,"VOX",1
25,"25224",126,98,98,0,0,"VOX",0
45,"45078",1328,1152,1133,6,19,"VOX",211
45,"45079",349,272,272,1,0,"VOX",35
50,"50174",83,58,58,0,0,"VOX",7
5,"5240",3323,2389,2346,16,43,"VOX",384
23,"23029",806,651,637,0,14,"VOX",76
9,"9148",79,63,63,5,0,"VOX",4
46,"46007",12284,9370,9265,65,105,"VOX",1271
49,"49029",614,497,488,9,9,"VOX",69
49,"49150",123,90,90,3,0,"VOX",2
50,"50203",1057,849,837,9,12,"VOX",135
3,"3045",213,178,173,4,5,"VOX",17
50,"50027",224,170,165,1,5,"VOX",16
46,"46262",213,170,165,1,5,"VOX",21
10,"10153",283,204,199,0,5,"VOX",7
7,"7009",741,554,544,4,10,"VOX",51
17,"17116",354,283,282,0,1,"VOX",3
26,"26178",71,57,56,1,1,"VOX",3
17,"17205",211,184,184,1,0,"VOX",1
20,"20020",113,67,67,0,0,"VOX",0
14,"14060",3694,2878,2798,26,80,"VOX",312
26,"26179",41,33,32,0,1,"VOX",3
32,"32042",1505,1097,1091,12,6,"VOX",50
49,"49190",50,45,45,1,0,"VOX",3
47,"47028",30,17,17,0,0,"VOX",2
41,"41055",14804,10863,10720,79,143,"VOX",1253
45,"45172",641,504,496,4,8,"VOX",45
3,"3027",172,156,153,0,3,"VOX",22
9,"9425",476,366,362,1,4,"VOX",30
37,"37243",90,71,70,0,1,"VOX",11
23,"23031",765,659,647,4,12,"VOX",25
41,"41083",1128,865,859,6,6,"VOX",84
40,"40905",128,101,100,4,1,"VOX",8
31,"31050",6002,4111,4061,58,50,"VOX",70
34,"34174",178,150,149,2,1,"VOX",11
8,"8008",179,139,138,0,1,"VOX",4
19,"19322",26,21,21,1,0,"VOX",3
24,"24068",443,343,336,1,7,"VOX",23
24,"24056",2762,2062,2013,24,49,"VOX",203
14,"14021",260397,195951,193914,2025,2037,"VOX",29114
9,"9317",19,19,19,1,0,"VOX",0
41,"41084",2815,2177,2111,3,66,"VOX",156
48,"48047",149,115,115,1,0,"VOX",0
24,"24152",447,301,296,1,5,"VOX",42
44,"44046",43,32,32,0,0,"VOX",2
24,"24189",5816,4434,4382,49,52,"VOX",804
49,"49033",666,515,508,1,7,"VOX",51
17,"17036",2643,2076,2071,12,5,"VOX",33
50,"50118",2110,1622,1605,19,17,"VOX",167
42,"42121",55,42,42,0,0,"VOX",8
46,"46193",8964,7206,7156,27,50,"VOX",730
9,"9318",58,37,37,0,0,"VOX",2
44,"44037",449,334,331,1,3,"VOX",22
43,"43143",51,45,44,0,1,"VOX",0
42,"42033",50,45,44,1,1,"VOX",3
43,"43151",109,98,98,0,0,"VOX",2
23,"23033",1319,1076,1057,8,19,"VOX",141
5,"5092",146,118,116,0,2,"VOX",23
42,"42123",158,118,118,2,0,"VOX",7
16,"16243",379,323,318,5,5,"VOX",39
24,"24153",233,187,183,1,4,"VOX",16
44,"44136",51,43,43,1,0,"VOX",1
9,"9003",184,143,142,2,1,"VOX",16
3,"3080",1328,1077,1064,4,13,"VOX",249
12,"12097",65,54,54,1,0,"VOX",4
20,"20023",446,299,299,1,0,"VOX",2
41,"41086",16209,11006,10881,116,125,"VOX",1305
16,"16058",97,73,73,0,0,"VOX",2
37,"37283",119,96,96,0,0,"VOX",18
18,"18003",14413,11095,10883,92,212,"VOX",1763
11,"11014",17141,11836,11705,214,131,"VOX",1040
37,"37247",173,144,143,1,1,"VOX",25
18,"18176",241,182,180,0,2,"VOX",4
16,"16060",722,571,560,3,11,"VOX",65
50,"50013",200,166,166,3,0,"VOX",29
49,"49093",280,239,238,2,1,"VOX",37
6,"6013",265,227,221,0,6,"VOX",7
40,"40033",67,57,57,1,0,"VOX",8
8,"8237",1662,1334,1327,7,7,"VOX",14
21,"21033",561,428,427,4,1,"VOX",20
47,"47032",153,121,121,1,0,"VOX",44
3,"3052",967,805,790,4,15,"VOX",108
13,"13062",559,478,471,1,7,"VOX",62
19,"19147",45,36,36,0,0,"VOX",3
11,"11016",15051,10188,10042,131,146,"VOX",1542
34,"34179",26,20,19,0,1,"VOX",1
32,"32019",11512,8281,8161,96,120,"VOX",468
22,"22190",122,89,89,0,0,"VOX",3
19,"19099",289,217,214,0,3,"VOX",11
14,"14035",5817,4373,4314,44,59,"VOX",466
25,"25034",2288,1733,1719,9,14,"VOX",32
44,"44071",585,449,447,6,2,"VOX",42
8,"8238",14851,12472,12428,50,44,"VOX",438
14,"14005",6318,4464,4380,59,84,"VOX",415
12,"12006",174,149,149,2,0,"VOX",11
9,"9057",148,120,116,0,4,"VOX",7
18,"18005",362,268,265,0,3,"VOX",17
36,"36044",2539,1768,1708,18,60,"VOX",93
49,"49200",936,744,726,10,18,"VOX",57
5,"5096",79,62,62,1,0,"VOX",11
28,"28028",1820,1493,1483,8,10,"VOX",188
29,"29901",44578,31840,31537,286,303,"VOX",5001
49,"49160",43,29,26,0,3,"VOX",4
20,"20027",2758,1980,1958,19,22,"VOX",5
31,"31058",202,163,160,2,3,"VOX",4
41,"41061",2144,1763,1712,7,51,"VOX",84
12,"12100",1281,1118,1102,5,16,"VOX",115
6,"6082",393,314,305,5,9,"VOX",26
49,"49202",172,125,124,2,1,"VOX",12
12,"12007",731,649,642,8,7,"VOX",42
5,"5214",27,22,22,0,0,"VOX",2
29,"29012",9718,7243,7123,47,120,"VOX",702
36,"36015",4076,2903,2834,37,69,"VOX",99
47,"47005",502,420,414,2,6,"VOX",73
9,"9167",53,39,36,0,3,"VOX",4
16,"16108",43,40,39,1,1,"VOX",10
29,"29068",7716,5347,5230,58,117,"VOX",1108
10,"10001",283,233,232,3,1,"VOX",28
10,"10124",858,710,701,3,9,"VOX",62
49,"49040",112,97,97,0,0,"VOX",9
32,"32021",874,616,615,4,1,"VOX",37
22,"22197",439,356,353,10,3,"VOX",41
49,"49163",215,151,148,1,3,"VOX",25
43,"43025",590,476,472,0,4,"VOX",13
23,"23040",1443,1164,1149,3,15,"VOX",65
45,"45094",367,290,288,4,2,"VOX",40
8,"8161",11625,8521,8470,44,51,"VOX",393
19,"19241",35,24,23,2,1,"VOX",5
42,"42177",64,55,54,6,1,"VOX",2
34,"34237",573,479,472,4,7,"VOX",55
49,"49204",57,42,42,0,0,"VOX",3
37,"37017",222,177,177,1,0,"VOX",22
17,"17126",318,279,279,0,0,"VOX",3
37,"37057",209,165,162,2,3,"VOX",20
26,"26112",223,177,174,0,3,"VOX",15
17,"17214",723,584,580,7,4,"VOX",10
37,"37215",134,97,96,3,1,"VOX",14
31,"31061",48,46,46,0,0,"VOX",1
47,"47037",163,134,128,2,6,"VOX",15
39,"39078",1406,1101,1090,7,11,"VOX",113
19,"19004",59,52,52,0,0,"VOX",17
34,"34136",149,105,102,0,3,"VOX",9
24,"24080",207,162,161,0,1,"VOX",11
44,"44077",74,55,54,0,1,"VOX",3
28,"28137",1744,1385,1366,8,19,"VOX",308
28,"28062",288,243,236,0,7,"VOX",71
12,"12010",237,203,198,1,5,"VOX",12
12,"12032",23649,17680,17505,118,175,"VOX",2507
5,"5102",1681,1358,1329,4,29,"VOX",173
50,"50185",136,103,102,0,1,"VOX",11
28,"28107",442,336,325,3,11,"VOX",45
34,"34189",53,39,39,1,0,"VOX",6
44,"44045",368,302,298,8,4,"VOX",43
15,"15056",5648,4033,3979,39,54,"VOX",194
41,"41037",3192,2505,2479,15,26,"VOX",130
40,"40040",2495,1913,1895,20,18,"VOX",317
49,"49088",82,59,59,0,0,"VOX",2
25,"25008",1088,867,857,7,10,"VOX",6
49,"49114",40,33,32,1,1,"VOX",1
7,"7011",28642,19567,19396,147,171,"VOX",2530
36,"36059",4663,3196,3115,31,81,"VOX",175
21,"21005",15697,9910,9778,72,132,"VOX",1832
6,"6154",2799,2075,2022,15,53,"VOX",237
25,"25217",10819,8163,8120,64,43,"VOX",150
46,"46020",3792,3028,2973,11,55,"VOX",246
27,"27041",2238,1640,1615,10,25,"VOX",84
33,"33039",1641,1251,1243,6,8,"VOX",114
6,"6055",1998,1552,1523,9,29,"VOX",161
21,"21078",2646,1926,1895,14,31,"VOX",82
16,"16202",741,573,568,4,5,"VOX",83
16,"16203",10167,7720,7591,49,129,"VOX",1248
22,"22202",145,127,126,0,1,"VOX",8
45,"45100",179,150,148,1,2,"VOX",17
41,"41010",4573,3407,3345,27,62,"VOX",442
16,"16219",81,64,63,0,1,"VOX",6
27,"27010",4402,3015,2940,49,75,"VOX",214
28,"28034",370,284,280,0,4,"VOX",51
21,"21043",1857,1465,1424,7,41,"VOX",143
16,"16115",47,35,35,0,0,"VOX",3
9,"9340",76,56,56,1,0,"VOX",7
47,"47230",288,236,233,1,3,"VOX",33
16,"16072",133,96,95,1,1,"VOX",20
42,"42140",14,13,12,0,1,"VOX",5
23,"23045",2057,1519,1507,7,12,"VOX",114
14,"14043",7408,5721,5619,76,102,"VOX",540
33,"33020",13000,9476,9338,108,138,"VOX",890
8,"8087",149,135,133,0,2,"VOX",0
45,"45102",3585,2724,2676,20,48,"VOX",522
50,"50273",32,24,24,0,0,"VOX",0
21,"21044",17955,11674,11479,136,195,"VOX",1903
49,"49170",98,75,75,1,0,"VOX",8
47,"47198",66,47,47,0,0,"VOX",11
34,"34023",5098,4016,3973,48,43,"VOX",367
8,"8184",54876,41661,41447,248,214,"VOX",1903
35,"35024",14243,9496,9394,65,102,"VOX",645
22,"22001",214,162,162,0,0,"VOX",22
4,"4013",143321,101501,100814,750,687,"VOX",16458
9,"9022",61,54,54,0,0,"VOX",7
37,"37297",401,319,315,2,4,"VOX",37
8,"8246",1672,1412,1406,7,6,"VOX",15
31,"31069",830,639,638,3,1,"VOX",23
34,"34199",1159,910,880,7,30,"VOX",76
47,"47200",71,62,62,0,0,"VOX",9
28,"28112",154,137,137,1,0,"VOX",25
9,"9346",89,69,68,1,1,"VOX",5
6,"6059",1759,1300,1285,12,15,"VOX",85
17,"17039",1740,1385,1380,8,5,"VOX",14
25,"25074",180,157,155,2,2,"VOX",2
11,"11028",32791,24276,24028,279,248,"VOX",1515
43,"43007",640,510,509,0,1,"VOX",7
11,"11029",5423,3161,3105,55,56,"VOX",326
17,"17134",223,189,189,1,0,"VOX",0
24,"24169",2809,2165,2146,18,19,"VOX",85
13,"13034",58768,46017,45585,385,432,"VOX",6595
41,"41013",4807,3480,3425,30,55,"VOX",170
22,"22205",459,347,345,1,2,"VOX",31
21,"21047",1869,1242,1206,8,36,"VOX",96
28,"28038",5155,4142,4090,20,52,"VOX",576
2,"2017",777,588,584,0,4,"VOX",74
47,"47140",110,91,90,0,1,"VOX",10
22,"22077",362,301,293,3,8,"VOX",31
3,"3033",102,87,85,0,2,"VOX",8
18,"18189",772,619,611,4,8,"VOX",81
25,"25247",147,100,100,2,0,"VOX",9
49,"49219",7221,5301,5186,62,115,"VOX",610
37,"37149",61,56,54,1,2,"VOX",9
36,"36025",2137,1387,1381,7,6,"VOX",73
44,"44051",2588,2034,1997,26,37,"VOX",178
8,"8116",558,459,459,0,0,"VOX",8
14,"14047",1629,1300,1285,18,15,"VOX",204
21,"21049",3282,2294,2214,21,80,"VOX",116
16,"16081",49,42,42,0,0,"VOX",5
31,"31113",127,84,83,1,1,"VOX",2
49,"49220",139,110,104,2,6,"VOX",7
31,"31194",326,251,250,1,1,"VOX",6
34,"34205",55,44,44,0,0,"VOX",9
46,"46026",1202,1012,997,1,15,"VOX",71
49,"49097",74,43,43,0,0,"VOX",4
16,"16038",28,21,21,0,0,"VOX",4
11,"11031",76294,54123,53583,589,540,"VOX",8255
19,"19118",10,10,10,1,0,"VOX",0
46,"46209",1901,1517,1500,5,17,"VOX",176
16,"16083",45,29,28,0,1,"VOX",10
24,"24052",139,99,99,0,0,"VOX",9
47,"47016",70,62,61,0,1,"VOX",5
28,"28115",62352,53136,52912,268,224,"VOX",10474
26,"26084",7187,5620,5558,36,62,"VOX",763
46,"46027",932,769,755,1,14,"VOX",155
23,"23017",1480,1227,1202,6,25,"VOX",54
16,"16237",98,83,83,0,0,"VOX",19
37,"37303",181,137,137,1,0,"VOX",18
49,"49176",610,426,426,4,0,"VOX",34
33,"33005",1376,929,916,14,13,"VOX",122
50,"50028",77,59,58,1,1,"VOX",11
30,"30010",6857,5533,5457,38,76,"VOX",1043
17,"17137",3467,2925,2912,15,13,"VOX",33
22,"22080",264,208,202,2,6,"VOX",25
21,"21051",221,180,177,1,3,"VOX",22
18,"18087",182514,141305,139588,865,1717,"VOX",20413
22,"22008",155,127,125,0,2,"VOX",12
47,"47017",198,162,160,1,2,"VOX",31
20,"20040",15753,11440,11364,69,76,"VOX",108
8,"8092",3714,2912,2889,8,23,"VOX",28
17,"17076",122,101,100,1,1,"VOX",0
9,"9353",76,64,63,2,1,"VOX",8
15,"15003",1701,1234,1210,10,24,"VOX",53
47,"47007",4036,3261,3217,25,44,"VOX",541
39,"39097",679,437,435,2,2,"VOX",61
3,"3067",93,87,87,0,0,"VOX",14
5,"5115",516,397,395,3,2,"VOX",57
34,"34107",73,54,54,2,0,"VOX",9
35,"35030",9949,6611,6462,65,149,"VOX",397
37,"37191",104,65,65,1,0,"VOX",9
26,"26168",5515,4130,4077,36,53,"VOX",503
10,"10141",289,224,223,0,1,"VOX",39
17,"17168",379,332,329,0,3,"VOX",3
34,"34062",150,108,107,1,1,"VOX",28
46,"46171",16429,12527,12373,61,154,"VOX",1442
47,"47049",91,66,64,0,2,"VOX",12
20,"20901",1412,1034,1030,2,4,"VOX",5
46,"46254",943,751,734,4,17,"VOX",93
25,"25119",2245,1798,1792,10,6,"VOX",12
25,"25019",4646,3224,3199,22,25,"VOX",80
16,"16100",640,570,565,1,5,"VOX",60
32,"32043",2512,1805,1789,16,16,"VOX",90
40,"40101",923,737,728,8,9,"VOX",138
27,"27009",2022,1514,1488,17,26,"VOX",57
26,"26104",11,9,9,0,0,"VOX",1
10,"10075",236,186,182,1,4,"VOX",13
17,"17169",2497,2047,2042,8,5,"VOX",72
16,"16087",226,191,184,3,7,"VOX",20
30,"30013",7467,5621,5553,26,68,"VOX",782
40,"40054",107,91,88,0,3,"VOX",17
46,"46255",3209,2415,2381,18,34,"VOX",183
2,"2073",4844,3828,3772,28,56,"VOX",609
29,"29085",138,100,98,0,2,"VOX",12
8,"8227",2410,1882,1877,10,5,"VOX",28
8,"8279",155280,121081,120515,802,566,"VOX",5018
39,"39034",257,167,162,2,5,"VOX",41
8,"8121",87292,67638,67328,362,310,"VOX",2981
39,"39090",772,619,609,1,10,"VOX",50
15,"15006",5169,3527,3436,32,91,"VOX",132
21,"21056",2922,2307,2228,27,79,"VOX",193
45,"45117",715,571,556,1,15,"VOX",79
20,"20044",364,263,262,0,1,"VOX",6
8,"8175",3368,2496,2486,16,10,"VOX",42
38,"38032",13536,9924,9867,63,57,"VOX",954
19,"19125",40,28,28,0,0,"VOX",3
6,"6068",431,324,317,4,7,"VOX",26
10,"10145",125,106,104,1,2,"VOX",2
37,"37309",37,27,27,0,0,"VOX",3
48,"48070",528,392,390,2,2,"VOX",0
28,"28121",205,166,165,1,1,"VOX",26
31,"31216",3871,2861,2832,32,29,"VOX",75
26,"26006",1825,1496,1470,8,26,"VOX",107
16,"16244",708,627,617,1,10,"VOX",58
25,"25220",994,822,816,3,6,"VOX",22
44,"44158",1166,921,904,7,17,"VOX",87
8,"8002",220,184,183,2,1,"VOX",4
27,"27022",4683,3131,3059,30,72,"VOX",146
34,"34216",60,46,46,0,0,"VOX",3
47,"47053",126,100,97,0,3,"VOX",1
31,"31122",4946,3915,3882,59,33,"VOX",119
16,"16092",154,113,112,0,1,"VOX",39
50,"50284",132,105,104,1,1,"VOX",6
9,"9362",205,177,177,3,0,"VOX",23
13,"13048",506,388,384,3,4,"VOX",22
10,"10147",1283,1038,1007,4,31,"VOX",41
24,"24180",1101,844,833,8,11,"VOX",144
45,"45120",121,96,96,0,0,"VOX",15
26,"26056",403,334,328,2,6,"VOX",22
26,"26173",6,6,6,0,0,"VOX",0
14,"14025",2857,2482,2436,14,46,"VOX",83
8,"8229",521,435,433,3,2,"VOX",3
49,"49185",156,126,120,1,6,"VOX",18
22,"22220",150,120,117,0,3,"VOX",17
43,"43040",326,278,276,0,2,"VOX",7
5,"5122",119,90,88,1,2,"VOX",7
7,"7005",6975,4824,4775,43,49,"VOX",453
37,"37237",304,238,234,0,4,"VOX",29
41,"41096",6134,4926,4845,44,81,"VOX",646
24,"24062",130,90,90,2,0,"VOX",7
28,"28123",61103,52177,51832,338,345,"VOX",5584
49,"49186",235,181,178,4,3,"VOX",31
45,"45121",7273,5362,5291,27,71,"VOX",1301
37,"37125",227,171,169,0,2,"VOX",25
19,"19311",87,71,71,2,0,"VOX",2
34,"34220",149,133,132,0,1,"VOX",20
44,"44194",104,80,80,1,0,"VOX",10
36,"36035",14571,11096,10917,105,179,"VOX",591
48,"48043",4539,3566,3556,22,10,"VOX",43
25,"25125",389,303,300,1,3,"VOX",2
46,"46218",1031,907,885,6,22,"VOX",81
28,"28124",59,52,52,0,0,"VOX",5
23,"23059",5728,4259,4187,18,72,"VOX",331
49,"49271",181,147,144,1,3,"VOX",7
49,"49068",435,287,286,1,1,"VOX",40
8,"8257",103,86,86,1,0,"VOX",3
33,"33034",10043,6765,6671,69,94,"VOX",634
9,"9421",242,197,196,2,1,"VOX",23
50,"50202",131,90,88,1,2,"VOX",10
12,"12092",126,108,106,1,2,"VOX",4
43,"43091",123,93,93,1,0,"VOX",1
13,"13053",14075,10930,10798,98,132,"VOX",1368
46,"46037",1109,927,918,4,9,"VOX",109
22,"22135",174,132,132,5,0,"VOX",22
31,"31209",147,116,116,0,0,"VOX",7
16,"16236",865,669,665,2,4,"VOX",188
37,"37315",86,68,67,0,1,"VOX",8
3,"3139",23061,16378,16178,128,200,"VOX",1768
47,"47193",1609,1347,1332,9,15,"VOX",200
48,"48014",1242,915,910,4,5,"VOX",9
23,"23030",1208,1022,1011,6,11,"VOX",43
25,"25068",531,402,399,6,3,"VOX",0
12,"12009",17859,13054,12911,98,143,"VOX",1716
40,"40132",46,32,31,1,1,"VOX",3
16,"16185",35,29,29,0,0,"VOX",2
43,"43067",528,450,445,1,5,"VOX",2
28,"28051",1640,1301,1292,9,9,"VOX",225
49,"49071",715,500,499,3,1,"VOX",67
13,"13055",615,475,465,5,10,"VOX",59
10,"10194",524,440,435,4,5,"VOX",57
13,"13903",493,412,406,1,6,"VOX",48
9,"9424",34,24,24,0,0,"VOX",1
48,"48015",33109,24697,24475,161,222,"VOX",502
24,"24229",388,312,307,2,5,"VOX",36
37,"37087",910,755,747,3,8,"VOX",144
40,"40203",958,801,788,6,13,"VOX",130
3,"3057",177,148,147,0,1,"VOX",22
24,"24202",7559,5449,5363,63,86,"VOX",347
8,"8075",4059,3127,3119,14,8,"VOX",147
44,"44133",15,12,12,0,0,"VOX",4
16,"16239",118,89,88,0,1,"VOX",6
13,"13056",11657,9236,9142,85,94,"VOX",1160
41,"41027",3966,2830,2784,32,46,"VOX",345
3,"3048",4971,3808,3739,19,69,"VOX",478
9,"9374",90,79,78,1,1,"VOX",7
49,"49076",328,260,258,6,2,"VOX",32
7,"7033",28373,17884,17684,201,200,"VOX",1800
26,"26102",6057,4672,4579,37,93,"VOX",410
4,"4098",1455,1097,1087,9,10,"VOX",165
28,"28128",445,352,352,2,0,"VOX",45
8,"8182",2892,2217,2204,18,13,"VOX",166
37,"37218",48,29,29,0,0,"VOX",4
4,"4010",580,445,434,2,11,"VOX",29
31,"31227",8111,6198,6129,69,69,"VOX",147
44,"44228",99,83,83,0,0,"VOX",13
20,"20032",8681,6491,6429,22,62,"VOX",52
15,"15088",3415,2349,2323,28,26,"VOX",111
31,"31051",234,183,182,2,1,"VOX",21
40,"40172",45,37,37,0,0,"VOX",7
7,"7012",1909,1358,1343,15,15,"VOX",108
48,"48017",13150,9546,9504,38,42,"VOX",48
8,"8025",1535,1221,1214,7,7,"VOX",52
4,"4011",2757,2171,2136,11,35,"VOX",265
33,"33049",6044,4152,4079,56,73,"VOX",364
19,"19095",11,10,10,1,0,"VOX",4
23,"23010",14241,10186,10015,68,171,"VOX",1527
31,"31052",103,79,78,0,1,"VOX",2
9,"9213",270,196,196,1,0,"VOX",29
26,"26105",2211,1744,1723,19,21,"VOX",150
8,"8026",193,161,161,1,0,"VOX",2
25,"25061",80,59,58,0,1,"VOX",2
28,"28097",125,100,100,0,0,"VOX",8
19,"19043",99,87,84,2,3,"VOX",12
12,"12036",546,428,420,9,8,"VOX",72
22,"22228",529,421,417,3,4,"VOX",63
41,"41030",500,419,410,6,9,"VOX",63
23,"23001",920,769,766,3,3,"VOX",81
33,"33071",563,413,407,2,6,"VOX",20
14,"14003",1258,989,968,12,21,"VOX",91
50,"50004",478,380,376,2,4,"VOX",41
21,"21069",1667,1214,1198,13,16,"VOX",93
8,"8193",984,792,790,5,2,"VOX",14
19,"19219",9,7,7,0,0,"VOX",1
49,"49255",396,324,323,3,1,"VOX",51
27,"27002",1546,1136,1103,9,33,"VOX",24
10,"10160",237,189,183,3,6,"VOX",9
37,"37323",476,380,377,7,3,"VOX",60
17,"17151",185,150,150,1,0,"VOX",4
17,"17209",615,519,517,2,2,"VOX",19
46,"46105",16132,11703,11582,64,121,"VOX",1354
28,"28099",1923,1490,1475,7,15,"VOX",346
16,"16061",941,790,763,8,27,"VOX",83
25,"25165",276,221,219,1,2,"VOX",1
9,"9056",4812,3585,3533,36,52,"VOX",448
46,"46044",4198,3399,3337,13,62,"VOX",300
47,"47128",56,49,46,0,3,"VOX",11
20,"20905",153,124,124,1,0,"VOX",0
48,"48081",1883,1532,1518,3,14,"VOX",15
47,"47222",86,71,71,0,0,"VOX",19
32,"32075",4382,3546,3489,35,57,"VOX",214
47,"47033",204,167,167,2,0,"VOX",22
45,"45182",987,815,800,7,15,"VOX",166
27,"27065",12076,8393,8183,128,210,"VOX",433
6,"6015",117934,87081,86114,785,967,"VOX",12856
32,"32057",514,367,365,5,2,"VOX",6
5,"5015",68,48,48,1,0,"VOX",1
25,"25166",172,137,136,1,1,"VOX",1
8,"8028",1088,783,780,2,3,"VOX",47
50,"50034",787,568,556,3,12,"VOX",60
18,"18915",731,539,532,1,7,"VOX",38
25,"25064",98,88,88,0,0,"VOX",0
45,"45136",5825,4314,4260,22,54,"VOX",655
34,"34233",128,118,117,2,1,"VOX",9
27,"27004",1149,741,722,2,19,"VOX",56
42,"42038",34,27,27,1,0,"VOX",2
19,"19150",126,102,100,0,2,"VOX",14
42,"42218",75,52,51,0,1,"VOX",6
17,"17153",188,162,162,0,0,"VOX",1
21,"21012",286,238,233,4,5,"VOX",0
10,"10163",339,275,269,0,6,"VOX",16
17,"17184",1264,1068,1060,5,8,"VOX",15
33,"33044",177352,134444,133352,1391,1092,"VOX",18897
5,"5253",78,62,60,0,2,"VOX",11
9,"9219",27153,20116,19831,215,285,"VOX",1330
19,"19195",37,29,28,2,1,"VOX",1
46,"46016",1075,887,880,8,7,"VOX",47
25,"25067",706,537,532,4,5,"VOX",16
28,"28060",1565,1262,1247,5,15,"VOX",143
45,"45001",1837,1371,1340,12,31,"VOX",190
49,"49203",287,229,223,2,6,"VOX",32
19,"19152",550,413,405,3,8,"VOX",54
46,"46047",532,447,441,4,6,"VOX",23
3,"3086",166,143,143,1,0,"VOX",11
45,"45002",2608,1840,1821,7,19,"VOX",343
10,"10206",201,146,144,1,2,"VOX",12
37,"37328",164,127,127,4,0,"VOX",7
7,"7019",164,124,124,0,0,"VOX",20
9,"9113",460,369,364,3,5,"VOX",31
5,"5228",167,124,124,0,0,"VOX",6
18,"18040",226,146,145,0,1,"VOX",4
5,"5256",112,94,92,1,2,"VOX",7
19,"19168",266,211,206,4,5,"VOX",12
44,"44163",114,92,92,0,0,"VOX",20
26,"26036",17013,12543,12354,95,189,"VOX",1386
2,"2045",3617,3020,2969,38,51,"VOX",251
19,"19051",61,54,54,0,0,"VOX",2
19,"19286",742,610,603,4,7,"VOX",151
40,"40005",25,21,21,0,0,"VOX",1
44,"44014",2499,2015,1963,25,52,"VOX",143
50,"50155",90,70,69,0,1,"VOX",6
48,"48086",2015,1504,1486,6,18,"VOX",19
17,"17186",3824,3115,3098,15,17,"VOX",85
47,"47226",149,124,123,0,1,"VOX",16
10,"10902",735,537,521,2,16,"VOX",35
13,"13085",2287,1911,1885,13,26,"VOX",219
47,"47112",2570,2098,2075,13,23,"VOX",338
28,"28072",6088,5001,4961,23,40,"VOX",927
9,"9170",209,164,159,0,5,"VOX",21
18,"18011",4376,3286,3248,18,38,"VOX",445
47,"47069",118,96,92,1,4,"VOX",16
31,"31226",574,380,377,3,3,"VOX",5
44,"44176",153,124,124,0,0,"VOX",9
43,"43125",890,700,698,12,2,"VOX",10
49,"49249",63,52,52,1,0,"VOX",12
6,"6021",908,708,698,9,10,"VOX",74
6,"6142",259,214,208,1,6,"VOX",4
42,"42195",92,53,53,1,0,"VOX",3
19,"19041",167,133,129,1,4,"VOX",13
43,"43060",2684,2158,2152,8,6,"VOX",27
46,"46061",343,285,280,4,5,"VOX",34
19,"19156",933,756,745,1,11,"VOX",128
48,"48016",5437,4282,4248,21,34,"VOX",108
26,"26142",784,651,641,5,10,"VOX",35
7,"7044",8791,6335,6196,66,139,"VOX",591
31,"31145",161,131,129,1,2,"VOX",6
42,"42075",78,60,60,1,0,"VOX",4
31,"31010",5728,4211,4153,30,58,"VOX",97
29,"29017",6428,4943,4871,32,72,"VOX",365
26,"26117",2097,1680,1647,17,33,"VOX",80
37,"37219",165,101,97,2,4,"VOX",14
25,"25072",5874,4468,4450,24,18,"VOX",148
48,"48088",133,99,98,2,1,"VOX",0
37,"37077",252,216,213,2,3,"VOX",13
10,"10103",426,330,327,0,3,"VOX",22
17,"17008",3594,2763,2741,16,22,"VOX",55
16,"16129",90,78,77,0,1,"VOX",19
15,"15089",4324,3258,3200,33,58,"VOX",154
49,"49010",348,301,295,6,6,"VOX",28
2,"2049",796,582,574,1,8,"VOX",64
17,"17217",353,312,311,1,1,"VOX",2
26,"26004",66,54,54,0,0,"VOX",6
28,"28110",2003,1596,1571,7,25,"VOX",256
15,"15069",6588,4914,4830,58,84,"VOX",204
42,"42090",88,69,68,2,1,"VOX",8
5,"5261",33,26,26,0,0,"VOX",4
12,"12013",137,113,113,0,0,"VOX",8
39,"39082",1622,1261,1252,16,9,"VOX",163
25,"25073",546,420,418,2,2,"VOX",5
49,"49210",448,372,370,3,2,"VOX",33
9,"9229",183,136,136,2,0,"VOX",19
44,"44179",325,233,231,7,2,"VOX",11
15,"15039",1224,874,850,11,24,"VOX",50
26,"26145",237,207,204,0,3,"VOX",23
31,"31014",266,195,195,4,0,"VOX",6
16,"16117",1022,822,809,6,13,"VOX",103
18,"18014",6898,5262,5162,43,100,"VOX",850
34,"34005",792,659,645,5,14,"VOX",60
5,"5184",240,207,204,1,3,"VOX",26
34,"34246",69,53,53,0,0,"VOX",13
16,"16263",966,763,755,2,8,"VOX",89
49,"49214",664,519,510,2,9,"VOX",65
44,"44086",421,332,327,3,5,"VOX",32
26,"26007",481,391,383,0,8,"VOX",27
24,"24088",995,813,802,12,11,"VOX",65
15,"15092",6250,4358,4297,28,61,"VOX",164
14,"14901",915,795,782,8,13,"VOX",11
2,"2016",538,405,401,4,4,"VOX",65
17,"17070",110,94,94,0,0,"VOX",0
47,"47232",100,76,76,1,0,"VOX",17
9,"9403",103,90,89,0,1,"VOX",9
50,"50043",246,172,170,2,2,"VOX",42
18,"18016",308,232,231,5,1,"VOX",13
4,"4015",118,97,97,2,0,"VOX",12
1,"1014",366,283,277,7,6,"VOX",18
3,"3063",27121,19869,19713,131,156,"VOX",1857
30,"30037",19254,14416,14217,67,199,"VOX",3542
19,"19297",32,27,27,0,0,"VOX",8
31,"31111",91,69,69,1,0,"VOX",4
45,"45198",1790,1488,1464,5,24,"VOX",307
37,"37338",78,66,64,0,2,"VOX",14
8,"8274",4674,3710,3698,12,12,"VOX",81
26,"26009",391,317,314,2,3,"VOX",27
43,"43901",8750,6057,6004,43,53,"VOX",149
17,"17101",562,415,413,2,2,"VOX",9
10,"10136",285,223,223,1,0,"VOX",21
25,"25045",54,31,31,5,0,"VOX",0
24,"24213",170,140,139,0,1,"VOX",28
42,"42027",73,63,63,0,0,"VOX",12
31,"31153",2173,1591,1580,10,11,"VOX",17
19,"19211",356,301,300,0,1,"VOX",50
34,"34102",202,173,171,2,2,"VOX",27
28,"28114",143,104,104,0,0,"VOX",18
46,"46036",558,391,379,2,12,"VOX",62
37,"37113",409,330,329,3,1,"VOX",35
45,"45108",482,385,382,0,3,"VOX",57
35,"35009",20109,15017,14803,78,214,"VOX",718
46,"46117",500,407,399,1,8,"VOX",39
50,"50017",1779,1386,1373,14,13,"VOX",288
12,"12061",380,277,274,2,3,"VOX",13
17,"17223",800,623,616,5,7,"VOX",19
24,"24092",745,606,601,6,5,"VOX",89
3,"3065",169399,128218,127256,967,962,"VOX",16576
26,"26011",7229,5355,5277,64,78,"VOX",424
48,"48095",2326,1691,1680,11,11,"VOX",16
42,"42016",20,13,13,0,0,"VOX",0
34,"34059",402,326,320,3,6,"VOX",24
45,"45155",319,261,253,1,8,"VOX",25
26,"26024",210,171,169,1,2,"VOX",17
16,"16137",37,27,25,0,2,"VOX",11
46,"46240",206,175,169,2,6,"VOX",25
3,"3140",26027,19805,19438,230,367,"VOX",2302
6,"6140",611,515,506,1,9,"VOX",50
25,"25057",214,162,161,0,1,"VOX",8
31,"31088",5675,4331,4285,59,46,"VOX",272
23,"23061",7691,5636,5531,51,105,"VOX",702
9,"9455",43,37,36,0,1,"VOX",7
26,"26012",33,28,26,0,2,"VOX",2
37,"37342",255,200,199,1,1,"VOX",31
35,"35029",4357,2869,2832,32,37,"VOX",131
31,"31116",58,45,43,2,2,"VOX",5
20,"20070",1083,831,823,2,8,"VOX",1
39,"39088",59,51,51,0,0,"VOX",6
16,"16238",464,387,383,2,4,"VOX",51
10,"10113",2258,1695,1657,6,38,"VOX",113
17,"17902",1306,1076,1074,3,2,"VOX",11
3,"3077",1374,1131,1114,9,17,"VOX",170
19,"19214",72,56,55,0,1,"VOX",8
48,"48025",860,694,694,3,0,"VOX",1
43,"43035",235,205,203,7,2,"VOX",2
43,"43084",521,424,423,2,1,"VOX",2
48,"48066",347,291,291,0,0,"VOX",0
9,"9298",75,62,62,1,0,"VOX",4
48,"48067",1134,877,872,5,5,"VOX",3
33,"33058",1664,1205,1176,5,29,"VOX",81
28,"28084",16103,12519,12378,82,141,"VOX",1720
17,"17035",550,460,460,3,0,"VOX",5
26,"26153",10,9,9,0,0,"VOX",0
21,"21017",2325,1450,1419,22,31,"VOX",112
33,"33068",1047,624,620,8,4,"VOX",73
49,"49115",169,137,136,0,1,"VOX",14
9,"9460",167,149,149,5,0,"VOX",20
3,"3121",21787,15670,15453,81,217,"VOX",2364
10,"10088",196,139,138,0,1,"VOX",17
14,"14011",572,498,495,5,3,"VOX",65
47,"47029",50,43,43,1,0,"VOX",4
23,"23075",3220,2559,2524,18,35,"VOX",193
17,"17067",697,581,578,4,3,"VOX",6
44,"44135",102,85,85,0,0,"VOX",15
8,"8252",24729,19751,19642,125,109,"VOX",909
35,"35004",41728,23957,23683,219,274,"VOX",1597
31,"31119",36,26,25,0,1,"VOX",0
41,"41047",10411,8348,8242,84,106,"VOX",1131
19,"19042",21,19,18,1,1,"VOX",3
10,"10211",447,345,343,2,2,"VOX",19
31,"31079",67,60,60,0,0,"VOX",1
50,"50040",86,71,71,0,0,"VOX",10
35,"35032",3348,2585,2542,20,43,"VOX",99
20,"20073",4698,3530,3515,29,15,"VOX",24
46,"46183",6028,4620,4534,29,86,"VOX",618
17,"17058",170,139,139,0,0,"VOX",0
33,"33070",3293,2499,2473,32,26,"VOX",170
31,"31134",175,130,128,1,2,"VOX",3
46,"46133",472,374,374,2,0,"VOX",19
5,"5234",46,43,43,0,0,"VOX",4
16,"16006",110,99,98,1,1,"VOX",6
46,"46154",797,645,630,1,15,"VOX",103
48,"48903",1807,1471,1462,6,9,"VOX",39
24,"24222",14431,11296,11135,117,161,"VOX",1675
5,"5159",228,160,159,2,1,"VOX",17
18,"18025",279,214,212,0,2,"VOX",17
15,"15007",3179,2333,2304,22,29,"VOX",107
47,"47001",52,47,46,0,1,"VOX",9
19,"19059",74,53,46,0,7,"VOX",3
4,"4054",352,280,278,2,2,"VOX",33
9,"9104",47,39,39,0,0,"VOX",10
39,"39101",236,173,171,1,2,"VOX",4
31,"31176",2930,2204,2134,33,70,"VOX",187
43,"43088",2026,1565,1562,9,3,"VOX",66
50,"50283",69,53,52,3,1,"VOX",8
1,"1011",215,179,175,3,4,"VOX",8
41,"41077",8631,6441,6289,46,152,"VOX",571
46,"46003",953,828,811,5,17,"VOX",78
24,"24223",2540,1971,1929,37,42,"VOX",185
50,"50902",79,69,69,0,0,"VOX",6
8,"8203",2472,1884,1873,4,11,"VOX",65
17,"17080",144,124,124,2,0,"VOX",4
24,"24224",574,435,427,3,8,"VOX",40
26,"26019",350,270,256,3,14,"VOX",21
49,"49230",82,67,66,0,1,"VOX",4
49,"49065",1073,789,777,3,12,"VOX",70
44,"44256",34,32,32,1,0,"VOX",2
34,"34163",46,40,40,1,0,"VOX",4
46,"46095",578,467,458,1,9,"VOX",64
48,"48011",9652,7293,7251,37,42,"VOX",128
19,"19046",22148,17383,17137,125,246,"VOX",2671
34,"34025",53,37,37,2,0,"VOX",7
3,"3073",222,200,196,3,4,"VOX",20
24,"24225",992,762,751,5,11,"VOX",113
25,"25222",66,57,57,0,0,"VOX",1
48,"48906",753,611,608,1,3,"VOX",2
50,"50229",65,57,56,0,1,"VOX",3
7,"7039",4970,3557,3489,36,68,"VOX",393
49,"49231",293,212,209,0,3,"VOX",20
9,"9090",50,45,45,2,0,"VOX",4
31,"31206",2082,1610,1589,15,21,"VOX",57
17,"17112",194,154,152,2,2,"VOX",3
47,"47004",1136,950,939,5,11,"VOX",177
25,"25014",249,203,200,2,3,"VOX",0
32,"32048",864,550,544,1,6,"VOX",19
50,"50143",546,409,401,5,8,"VOX",46
31,"31085",502,401,399,5,2,"VOX",4
45,"45168",62790,50868,50335,359,533,"VOX",7776
8,"8013",1280,1040,1031,5,9,"VOX",21
49,"49003",869,627,624,3,3,"VOX",73
17,"17234",179,147,146,2,1,"VOX",6
22,"22904",761,581,566,2,15,"VOX",71
50,"50035",75,63,62,0,1,"VOX",0
52,"52001",54124,34068,33749,237,319,"VOX",5804
34,"34221",170,138,136,2,2,"VOX",14
34,"34087",122,105,105,0,0,"VOX",7
5,"5046",39,37,37,0,0,"VOX",3
22,"22017",822,664,660,5,4,"VOX",75
37,"37126",30,26,26,0,0,"VOX",6
41,"41053",21618,16549,16150,194,399,"VOX",1695
47,"47026",49,40,39,0,1,"VOX",8
17,"17175",564,381,381,1,0,"VOX",37
25,"25092",127,101,99,1,2,"VOX",0
10,"10192",767,625,614,1,11,"VOX",45
36,"36016",1064,707,696,7,11,"VOX",29
49,"49246",217,180,177,2,3,"VOX",20
21,"21026",253,189,183,1,6,"VOX",11
5,"5153",87,65,65,1,0,"VOX",8
37,"37240",939,694,686,3,8,"VOX",122
33,"33015",1428,1003,993,7,10,"VOX",115
34,"34184",49,39,38,0,1,"VOX",1
2,"2081",18331,14219,13987,108,232,"VOX",1962
46,"46038",307,243,241,0,2,"VOX",16
28,"28093",2142,1751,1728,9,23,"VOX",404
9,"9095",112,70,68,1,2,"VOX",6
33,"33067",747,608,596,9,12,"VOX",61
46,"46008",2624,2036,1996,9,40,"VOX",170
34,"34032",37,34,34,1,0,"VOX",2
6,"6009",228,190,187,2,3,"VOX",31
20,"20010",1528,1156,1151,5,5,"VOX",10
48,"48096",6510,5247,5185,36,62,"VOX",73
7,"7064",5528,3793,3765,23,28,"VOX",278
41,"41054",713,596,588,4,8,"VOX",68
50,"50010",66,56,55,2,1,"VOX",8
28,"28002",3281,2481,2455,24,26,"VOX",551
9,"9316",108,89,89,0,0,"VOX",11
27,"27060",2463,1695,1669,12,26,"VOX",68
22,"22907",1444,1149,1137,12,12,"VOX",109
1,"1020",320,239,238,1,1,"VOX",4
17,"17206",155,118,115,0,3,"VOX",0
43,"43044",3949,3060,3032,31,28,"VOX",181
36,"36028",4069,3012,2960,27,52,"VOX",147
6,"6098",534,421,411,8,10,"VOX",43
34,"34225",5001,4070,4021,48,49,"VOX",430
44,"44124",73,58,57,0,1,"VOX",2
28,"28013",41563,32024,31693,194,331,"VOX",5242
50,"50001",88,71,70,0,1,"VOX",4
18,"18161",251,222,220,1,2,"VOX",19
46,"46902",356,300,296,8,4,"VOX",30
12,"12002",115,99,97,0,2,"VOX",1
11,"11024",6583,4774,4682,40,92,"VOX",279
31,"31091",327,224,224,1,0,"VOX",2
19,"19139",26,20,20,1,0,"VOX",1
43,"43076",460,378,377,2,1,"VOX",5
46,"46132",2196,1877,1853,10,24,"VOX",176
37,"37046",10749,8133,7989,84,144,"VOX",940
19,"19092",395,317,309,1,8,"VOX",55
9,"9155",25,20,20,0,0,"VOX",1
8,"8060",135,111,109,0,2,"VOX",2
40,"40160",93,72,72,0,0,"VOX",10
9,"9120",38,32,31,2,1,"VOX",2
5,"5078",100,87,86,0,1,"VOX",15
34,"34140",96,69,69,1,0,"VOX",7
28,"28096",19809,15584,15392,118,192,"VOX",2969
6,"6056",454,378,376,1,2,"VOX",38
28,"28004",6564,4798,4767,26,31,"VOX",995
39,"39081",437,356,347,2,9,"VOX",41
18,"18115",2650,1988,1975,20,13,"VOX",202
9,"9430",22,20,20,0,0,"VOX",0
50,"50031",139,97,90,0,7,"VOX",3
2,"2074",5891,4435,4375,41,60,"VOX",628
8,"8210",4584,3455,3435,23,20,"VOX",82
7,"7013",7231,5372,5253,43,119,"VOX",714
50,"50236",101,82,80,1,2,"VOX",3
8,"8236",1557,1204,1202,2,2,"VOX",26
50,"50061",193,173,169,1,4,"VOX",11
1,"1042",907,723,721,4,2,"VOX",10
41,"41049",9493,7463,7312,78,151,"VOX",727
45,"45010",389,280,280,3,0,"VOX",55
25,"25140",773,573,571,5,2,"VOX",10
47,"47168",30,29,29,0,0,"VOX",12
26,"26042",799,605,596,5,9,"VOX",40
5,"5172",116,95,93,0,2,"VOX",11
6,"6014",6535,4757,4679,36,78,"VOX",488
19,"19146",46,41,41,1,0,"VOX",2
6,"6080",1890,1482,1467,18,15,"VOX",157
9,"9381",33,25,25,0,0,"VOX",1
40,"40069",74,65,65,0,0,"VOX",14
8,"8157",8547,6949,6918,39,31,"VOX",234
27,"27064",1503,1078,1039,12,39,"VOX",34
48,"48020",272959,203643,202331,1472,1312,"VOX",6210
41,"41060",15100,11304,11105,113,199,"VOX",1287
44,"44138",118,90,89,2,1,"VOX",10
50,"50238",86,66,66,2,0,"VOX",13
31,"31137",198,106,103,3,3,"VOX",2
34,"34039",62,49,49,0,0,"VOX",0
33,"33073",8186,5090,5023,65,67,"VOX",888
8,"8212",491,406,402,1,4,"VOX",3
16,"16246",452,348,340,1,8,"VOX",38
12,"12016",1550,1281,1260,11,21,"VOX",190
19,"19061",53,45,45,0,0,"VOX",11
5,"5186",1558,1255,1247,9,8,"VOX",163
32,"32085",10634,7655,7551,66,104,"VOX",470
9,"9328",74,51,50,0,1,"VOX",1
16,"16149",154,130,130,2,0,"VOX",8
49,"49243",109,86,83,0,3,"VOX",7
15,"15020",3593,2491,2469,18,22,"VOX",72
50,"50239",63,47,47,0,0,"VOX",5
37,"37325",90,70,70,0,0,"VOX",5
6,"6148",957,762,746,12,16,"VOX",52
26,"26008",1822,1436,1420,14,16,"VOX",152
34,"34180",64,55,55,2,0,"VOX",0
49,"49258",110,93,92,0,1,"VOX",9
48,"48042",1365,1136,1130,7,6,"VOX",27
17,"17135",395,309,307,0,2,"VOX",11
17,"17212",142,117,117,2,0,"VOX",0
44,"44151",182,139,138,1,1,"VOX",3
7,"7029",4366,3270,3229,25,41,"VOX",293
37,"37251",107,79,79,1,0,"VOX",24
43,"43073",84,68,67,0,1,"VOX",1
46,"46006",4468,3731,3683,22,48,"VOX",368
45,"45185",7600,6094,5999,19,95,"VOX",653
37,"37175",404,321,319,8,2,"VOX",33
29,"29080",6895,5005,4934,59,71,"VOX",606
16,"16249",1938,1544,1529,13,15,"VOX",166
50,"50036",100,80,80,0,0,"VOX",10
8,"8014",2000,1578,1567,5,11,"VOX",28
9,"9330",1480,1180,1161,8,19,"VOX",92
10,"10084",1294,899,869,5,30,"VOX",72
17,"17033",5587,4157,4130,13,27,"VOX",170
7,"7052",4816,3276,3258,39,18,"VOX",216
33,"33076",12147,8532,8452,104,80,"VOX",1213
26,"26048",22,22,22,0,0,"VOX",2
36,"36036",2556,1953,1914,14,39,"VOX",107
43,"43148",90763,69756,69423,299,333,"VOX",4388
5,"5125",56,47,43,0,4,"VOX",9
48,"48054",24938,19329,19197,124,132,"VOX",542
9,"9369",422,328,325,8,3,"VOX",18
4,"4071",363,303,301,2,2,"VOX",17
9,"9169",97,86,85,0,1,"VOX",9
48,"48055",2596,2023,2005,12,18,"VOX",27
23,"23007",3026,2317,2301,13,16,"VOX",186
22,"22235",88,72,72,1,0,"VOX",10
31,"31102",136,75,75,2,0,"VOX",1
8,"8031",2336,1886,1882,11,4,"VOX",39
14,"14009",2669,1863,1844,19,19,"VOX",177
25,"25169",167,118,117,0,1,"VOX",3
16,"16053",391,334,327,4,7,"VOX",37
44,"44103",123,101,100,1,1,"VOX",19
17,"17176",123,110,110,1,0,"VOX",2
29,"29019",864,687,679,7,8,"VOX",73
9,"9409",110,87,87,0,0,"VOX",12
35,"35002",24129,16979,16736,116,243,"VOX",1090
43,"43075",86,71,69,0,2,"VOX",0
47,"47008",22,15,15,0,0,"VOX",3
16,"16068",127,104,104,4,0,"VOX",11
9,"9117",71,55,53,0,2,"VOX",2
4,"4050",751,522,519,1,3,"VOX",79
10,"10005",530,407,384,3,23,"VOX",33
17,"17187",625,530,529,4,1,"VOX",1
15,"15046",6163,4625,4497,49,128,"VOX",223
7,"7010",5070,3815,3777,47,38,"VOX",403
46,"46151",757,586,579,0,7,"VOX",55
39,"39070",123,101,99,0,2,"VOX",17
44,"44165",173,136,135,2,1,"VOX",7
8,"8304",816,686,678,1,8,"VOX",12
44,"44105",69,54,54,1,0,"VOX",3
9,"9443",152,115,112,0,3,"VOX",25
23,"23043",518,398,397,0,1,"VOX",58
16,"16142",120,95,95,0,0,"VOX",15
40,"40076",6537,5130,5012,22,118,"VOX",929
9,"9338",231,193,189,2,4,"VOX",35
34,"34175",87,67,66,0,1,"VOX",10
37,"37333",202,138,137,4,1,"VOX",28
50,"50011",116,100,99,0,1,"VOX",10
5,"5219",37,30,30,0,0,"VOX",12
49,"49009",389,305,304,2,1,"VOX",38
5,"5233",226,198,197,0,1,"VOX",22
44,"44147",398,293,286,3,7,"VOX",18
42,"42106",14,12,12,0,0,"VOX",2
25,"25242",689,539,531,0,8,"VOX",8
16,"16171",1749,1449,1422,6,27,"VOX",180
31,"31066",812,636,628,10,8,"VOX",25
26,"26052",148,113,113,1,0,"VOX",9
31,"31187",101,68,68,1,0,"VOX",1
49,"49251",161,125,124,0,1,"VOX",13
34,"34080",5291,3802,3728,35,74,"VOX",397
15,"15079",1466,1076,1052,11,24,"VOX",28
9,"9035",284,213,210,1,3,"VOX",22
19,"19143",1754,1422,1402,11,20,"VOX",250
9,"9348",133,105,104,0,1,"VOX",6
20,"20003",551,401,399,2,2,"VOX",1
40,"40009",40,34,34,0,0,"VOX",4
8,"8219",15629,12910,12865,58,45,"VOX",334
46,"46174",949,789,770,4,19,"VOX",72
42,"42049",109,73,72,1,1,"VOX",7
32,"32092",482,337,334,2,3,"VOX",21
49,"49240",185,141,136,0,5,"VOX",21
23,"23101",352,273,271,0,2,"VOX",21
25,"25164",357,264,261,4,3,"VOX",4
48,"48080",9946,7574,7499,46,75,"VOX",132
34,"34082",80,68,68,0,0,"VOX",13
47,"47073",116,91,89,0,2,"VOX",15
5,"5222",152,111,109,0,2,"VOX",20
46,"46023",328,277,269,1,8,"VOX",31
47,"47104",2836,2339,2267,23,72,"VOX",343
16,"16074",28,23,23,0,0,"VOX",1
36,"36053",5784,4407,4327,28,80,"VOX",209
25,"25012",2342,1748,1739,10,9,"VOX",43
39,"39027",3066,2511,2467,15,44,"VOX",299
40,"40220",62,48,48,0,0,"VOX",6
32,"32084",902,636,631,2,5,"VOX",17
5,"5027",260,217,211,3,6,"VOX",41
34,"34099",52,45,41,0,4,"VOX",9
5,"5225",353,300,297,2,3,"VOX",32
5,"5185",90,71,70,0,1,"VOX",13
3,"3094",9626,7206,7138,42,68,"VOX",963
45,"45197",1894,1525,1499,6,26,"VOX",202
24,"24022",306,227,224,1,3,"VOX",28
46,"46004",1919,1641,1616,14,25,"VOX",154
16,"16228",176,150,150,1,0,"VOX",9
50,"50285",650,466,462,7,4,"VOX",97
9,"9024",150,116,114,0,2,"VOX",18
9,"9449",92,75,74,1,1,"VOX",21
24,"24050",105,88,87,3,1,"VOX",19
25,"25175",176,135,135,1,0,"VOX",3
31,"31030",135,105,105,3,0,"VOX",3
9,"9289",1379,1002,994,9,8,"VOX",121
47,"47111",998,806,795,6,11,"VOX",104
41,"41023",7975,5918,5812,51,106,"VOX",542
22,"22164",43,33,31,0,2,"VOX",2
17,"17221",4152,3260,3247,11,13,"VOX",140
47,"47003",204,171,168,4,3,"VOX",35
17,"17123",345,304,303,4,1,"VOX",5
5,"5227",340,237,234,0,3,"VOX",34
24,"24145",618,443,435,3,8,"VOX",62
17,"17012",1171,916,914,10,2,"VOX",21
17,"17051",207,174,173,3,1,"VOX",7
48,"48073",6837,4950,4921,33,29,"VOX",19
19,"19284",10,9,9,1,0,"VOX",1
44,"44130",27,24,24,0,0,"VOX",2
40,"40902",117,96,96,1,0,"VOX",16
28,"28091",5474,4027,3977,26,50,"VOX",611
50,"50026",421,340,328,4,12,"VOX",26
41,"41081",29840,22819,22465,228,354,"VOX",2027
49,"49055",95,83,83,1,0,"VOX",17
17,"17194",78,62,62,0,0,"VOX",1
3,"3097",996,833,816,4,17,"VOX",45
19,"19212",674,528,519,2,9,"VOX",80
49,"49016",229,189,187,2,2,"VOX",20
41,"41072",4037,3256,3221,19,35,"VOX",184
14,"14028",307,258,257,0,1,"VOX",18
40,"40037",34,19,19,0,0,"VOX",0
48,"48075",2067,1591,1565,11,26,"VOX",26
33,"33046",483,370,367,6,3,"VOX",89
37,"37307",148,110,107,2,3,"VOX",12
34,"34035",100,84,82,1,2,"VOX",11
8,"8201",447,327,324,5,3,"VOX",1
46,"46203",3544,2851,2810,21,41,"VOX",223
14,"14029",4029,3089,3039,15,50,"VOX",242
10,"10017",772,595,591,3,4,"VOX",72
24,"24014",7180,5189,5097,46,92,"VOX",354
46,"46252",128,106,106,2,0,"VOX",10
14,"14049",16282,12515,12301,121,214,"VOX",1142
31,"31035",50,34,32,0,2,"VOX",1
50,"50251",8207,6352,6242,46,110,"VOX",526
44,"44175",113,84,82,1,2,"VOX",9
8,"8118",17542,14101,14059,56,42,"VOX",361
44,"44168",184,137,136,4,1,"VOX",13
6,"6035",865,678,670,4,8,"VOX",71
46,"46184",26453,21076,20810,172,266,"VOX",1901
5,"5079",68,56,56,0,0,"VOX",13
34,"34155",120,104,103,0,1,"VOX",13
50,"50222",1570,1126,1105,17,21,"VOX",134
44,"44237",368,299,293,2,6,"VOX",20
14,"14050",2352,1840,1801,11,39,"VOX",154
3,"3131",179,147,139,0,8,"VOX",11
10,"10019",1416,1120,1094,3,26,"VOX",190
31,"31077",5407,4148,4081,39,67,"VOX",365
17,"17128",316,255,252,1,3,"VOX",2
22,"22081",243,187,186,0,1,"VOX",23
34,"34137",24,23,22,2,1,"VOX",1
5,"5192",93,81,78,0,3,"VOX",9
43,"43166",1628,1292,1285,3,7,"VOX",60
30,"30022",17056,12158,11954,126,204,"VOX",1545
45,"45205",7342,5347,5275,30,72,"VOX",1145
45,"45128",2552,1874,1839,9,35,"VOX",320
48,"48910",2802,2082,2073,3,9,"VOX",39
49,"49237",143,95,93,0,2,"VOX",7
8,"8269",2712,2258,2250,19,8,"VOX",40
19,"19187",42,36,36,0,0,"VOX",3
5,"5259",106,87,87,0,0,"VOX",10
18,"18911",7869,5871,5765,49,106,"VOX",1108
21,"21066",495,401,396,4,5,"VOX",11
44,"44156",46,36,33,1,3,"VOX",4
50,"50199",325,238,232,3,6,"VOX",34
36,"36033",12244,9553,9358,80,195,"VOX",331
14,"14045",3013,2508,2468,13,40,"VOX",210
25,"25100",184,145,144,1,1,"VOX",1
16,"16044",43,31,30,0,1,"VOX",0
34,"34003",150,122,120,2,2,"VOX",23
49,"49142",249,175,173,0,2,"VOX",12
50,"50244",191,153,150,1,3,"VOX",25
45,"45193",589,512,507,6,5,"VOX",88
48,"48028",691,576,573,1,3,"VOX",2
26,"26155",149,119,119,0,0,"VOX",1
17,"17150",1426,1199,1192,8,7,"VOX",14
16,"16145",425,362,357,8,5,"VOX",41
34,"34027",1046,791,783,13,8,"VOX",76
13,"13096",7533,5766,5696,43,70,"VOX",852
31,"31221",1235,944,938,11,6,"VOX",19
9,"9251",365,278,277,0,1,"VOX",40
46,"46093",2134,1700,1687,8,13,"VOX",204
37,"37271",351,286,280,0,6,"VOX",35
35,"35033",6403,4565,4502,34,63,"VOX",308
9,"9176",59,50,47,2,3,"VOX",7
23,"23077",611,483,479,0,4,"VOX",60
9,"9343",93,73,72,1,1,"VOX",4
14,"14074",2237,1859,1839,8,20,"VOX",115
26,"26119",177,150,147,2,3,"VOX",2
46,"46053",537,459,457,2,2,"VOX",33
35,"35015",10728,6233,6108,54,125,"VOX",427
44,"44230",152,112,111,1,1,"VOX",0
14,"14054",13796,11042,10799,102,243,"VOX",981
49,"49267",97,73,68,1,5,"VOX",5
5,"5013",847,708,701,0,7,"VOX",40
19,"19176",230,184,183,0,1,"VOX",44
11,"11040",398,348,342,4,6,"VOX",27
10,"10106",127,108,106,0,2,"VOX",5
18,"18165",4251,3113,3073,20,40,"VOX",435
19,"19080",65,51,51,0,0,"VOX",7
42,"42201",23,20,20,0,0,"VOX",4
50,"50256",74,46,45,0,1,"VOX",7
23,"23026",3450,2625,2573,17,52,"VOX",179
28,"28078",40,37,37,0,0,"VOX",4
17,"17084",231,181,180,1,1,"VOX",3
32,"32044",809,625,617,2,8,"VOX",26
34,"34190",49,36,36,3,0,"VOX",5
46,"46223",7781,6057,5995,42,62,"VOX",756
1,"1044",231,171,166,0,5,"VOX",0
34,"34055",263,214,213,3,1,"VOX",46
34,"34202",28,20,20,1,0,"VOX",3
17,"17111",958,772,771,3,1,"VOX",16
17,"17233",2328,1924,1912,6,12,"VOX",35
49,"49066",449,319,314,4,5,"VOX",40
46,"46259",462,395,394,2,1,"VOX",62
14,"14026",2014,1502,1474,10,28,"VOX",102
8,"8230",7666,6202,6168,30,34,"VOX",262
34,"34031",26,24,24,0,0,"VOX",11
40,"40016",54,43,43,1,0,"VOX",7
18,"18002",526,400,400,0,0,"VOX",35
5,"5170",50,38,38,0,0,"VOX",0
28,"28101",229,183,182,2,1,"VOX",19
50,"50006",908,705,689,3,16,"VOX",60
26,"26081",15,14,14,1,0,"VOX",0
49,"49232",84,71,70,0,1,"VOX",6
10,"10096",3326,2553,2501,14,52,"VOX",153
28,"28019",1269,990,981,4,9,"VOX",149
41,"41090",3507,2766,2694,15,72,"VOX",257
31,"31059",183,145,143,0,2,"VOX",1
28,"28134",63352,51185,50776,336,409,"VOX",6905
44,"44111",78,64,64,1,0,"VOX",5
45,"45093",154,124,123,0,1,"VOX",12
47,"47224",97,74,74,0,0,"VOX",18
36,"36046",4043,3157,3084,27,73,"VOX",149
44,"44174",409,306,300,3,6,"VOX",36
1,"1060",201,174,166,1,8,"VOX",7
36,"36004",10123,7396,7273,93,123,"VOX",285
13,"13007",1233,1005,967,11,38,"VOX",82
49,"49111",121,100,100,3,0,"VOX",10
40,"40166",253,214,213,1,1,"VOX",18
33,"33035",11226,8326,8252,112,74,"VOX",1128
40,"40144",18,16,16,0,0,"VOX",6
32,"32031",1014,764,756,5,8,"VOX",51
26,"26035",16,14,13,0,1,"VOX",0
8,"8103",640,507,505,4,2,"VOX",17
45,"45135",4173,3402,3349,18,53,"VOX",433
26,"26147",34,30,29,0,1,"VOX",0
48,"48914",325,286,285,0,1,"VOX",1
16,"16274",103,86,85,0,1,"VOX",4
36,"36017",17419,12867,12610,120,257,"VOX",478
42,"42070",32,24,24,0,0,"VOX",2
6,"6074",4755,3719,3638,27,81,"VOX",273
25,"25225",541,427,420,4,7,"VOX",6
46,"46099",772,620,614,1,6,"VOX",66
8,"8127",2240,1694,1683,13,11,"VOX",69
11,"11009",580,429,420,2,9,"VOX",45
25,"25146",221,172,170,3,2,"VOX",2
31,"31229",38,36,36,2,0,"VOX",2
5,"5213",95,77,75,0,2,"VOX",7
37,"37363",107,81,80,0,1,"VOX",11
22,"22247",30,21,21,0,0,"VOX",1
29,"29097",4168,3086,3009,37,77,"VOX",261
10,"10077",637,501,499,3,2,"VOX",26
36,"36018",3073,2184,2144,9,40,"VOX",87
23,"23073",4389,3400,3363,13,37,"VOX",404
34,"34186",47,41,41,0,0,"VOX",7
28,"28022",36550,31559,31436,207,123,"VOX",6175
3,"3110",312,271,269,1,2,"VOX",22
22,"22226",771,598,591,6,7,"VOX",56
48,"48036",24038,18180,18050,94,130,"VOX",344
17,"17117",14471,10565,10504,52,61,"VOX",354
44,"44055",77,58,56,0,2,"VOX",11
40,"40029",24,21,21,0,0,"VOX",3
26,"26087",170,136,135,3,1,"VOX",6
10,"10903",796,623,614,4,9,"VOX",54
6,"6076",824,631,620,0,11,"VOX",51
24,"24188",3820,3107,3056,33,51,"VOX",404
10,"10120",156,110,108,0,2,"VOX",13
40,"40176",375,325,322,6,3,"VOX",18
45,"45089",1432,1159,1134,5,25,"VOX",137
9,"9326",154,129,127,4,2,"VOX",24
29,"29039",2728,2084,2050,14,34,"VOX",183
18,"18012",2143,1651,1634,8,17,"VOX",181
18,"18078",710,561,554,4,7,"VOX",60
41,"41088",512,383,377,1,6,"VOX",26
11,"11020",166423,117732,116448,1427,1284,"VOX",16087
42,"42008",56,41,41,0,0,"VOX",5
48,"48901",5151,4042,4012,22,30,"VOX",69
31,"31151",57,42,42,1,0,"VOX",0
10,"10170",239,180,179,1,1,"VOX",12
48,"48068",1528,1218,1211,5,7,"VOX",7
44,"44018",16,16,16,0,0,"VOX",0
43,"43085",235,198,194,0,4,"VOX",3
31,"31078",2419,1924,1899,18,25,"VOX",129
11,"11036",687,457,447,7,10,"VOX",29
8,"8239",460,380,378,2,2,"VOX",13
45,"45192",2412,2103,2068,7,35,"VOX",249
16,"16194",220,181,173,1,8,"VOX",15
33,"33056",4877,3469,3420,30,49,"VOX",452
14,"14069",7376,5511,5398,47,113,"VOX",394
18,"18103",722,556,555,3,1,"VOX",77
25,"25201",110,89,89,0,0,"VOX",1
16,"16094",120,89,88,0,1,"VOX",19
35,"35014",11908,7101,6947,63,154,"VOX",596
32,"32073",1281,941,932,9,9,"VOX",48
16,"16225",59,40,40,0,0,"VOX",5
26,"26092",109,84,82,1,2,"VOX",4
46,"46245",528,430,426,2,4,"VOX",39
42,"42141",114,89,89,0,0,"VOX",17
8,"8297",135,111,111,1,0,"VOX",3
20,"20004",227,156,154,4,2,"VOX",0
40,"40115",156,131,130,4,1,"VOX",22
37,"37371",258,176,175,0,1,"VOX",30
6,"6146",1048,837,819,4,18,"VOX",47
37,"37248",152,125,121,1,4,"VOX",13
40,"40162",387,286,278,3,8,"VOX",54
16,"16191",858,707,701,8,6,"VOX",80
45,"45139",145,118,117,1,1,"VOX",4
14,"14068",516,405,400,1,5,"VOX",35
31,"31100",256,181,178,1,3,"VOX",4
48,"48024",999,813,811,2,2,"VOX",3
41,"41087",10496,7661,7477,57,184,"VOX",1285
26,"26107",91,78,77,0,1,"VOX",9
28,"28100",4409,3425,3382,20,43,"VOX",653
10,"10205",1965,1344,1300,8,44,"VOX",104
14,"14072",999,763,754,4,9,"VOX",21
44,"44150",26,21,21,0,0,"VOX",1
25,"25071",42,32,31,0,1,"VOX",0
9,"9268",88,71,71,0,0,"VOX",5
25,"25053",1092,879,873,8,6,"VOX",20
8,"8072",10699,8226,8193,45,33,"VOX",310
17,"17071",1128,978,978,3,0,"VOX",7
47,"47044",323,282,279,1,3,"VOX",32
31,"31057",1741,1365,1344,12,21,"VOX",90
49,"49125",1401,1031,1010,7,21,"VOX",136
43,"43072",93,74,74,0,0,"VOX",3
41,"41035",1060,803,788,8,15,"VOX",80
43,"43095",2564,1995,1984,14,11,"VOX",92
17,"17222",105,95,95,1,0,"VOX",0
34,"34067",129,87,87,0,0,"VOX",6
41,"41011",15454,11892,11591,160,301,"VOX",734
17,"17002",564,491,488,3,3,"VOX",8
15,"15051",4562,3302,3249,36,53,"VOX",133
41,"41043",667,475,453,3,22,"VOX",38
34,"34028",134,110,107,3,3,"VOX",13
43,"43056",806,616,613,5,3,"VOX",7
9,"9181",277,220,219,2,1,"VOX",34
23,"23039",2154,1644,1605,6,39,"VOX",108
34,"34124",63,58,58,0,0,"VOX",9
22,"22221",90,58,56,0,2,"VOX",1
36,"36003",10038,7747,7632,79,115,"VOX",459
34,"34234",68,59,57,0,2,"VOX",13
7,"7051",5414,3610,3575,37,35,"VOX",349
16,"16234",23,16,16,0,0,"VOX",0
27,"27026",2315,1620,1599,17,21,"VOX",93
18,"18015",425,333,333,0,0,"VOX",43
19,"19010",9,10,10,0,0,"VOX",2
11,"11027",68637,48919,48441,519,478,"VOX",7731
37,"37298",172,126,125,0,1,"VOX",26
31,"31060",14185,10582,10485,103,97,"VOX",313
24,"24171",349,201,198,4,3,"VOX",21
38,"38036",6831,4947,4829,58,118,"VOX",232
42,"42211",81,74,73,2,1,"VOX",7
46,"46035",6855,5500,5422,34,78,"VOX",501
21,"21001",610,480,461,3,19,"VOX",33
1,"1009",1265,920,914,6,6,"VOX",13
48,"48091",1090,862,857,9,5,"VOX",5
30,"30033",10363,8115,7979,54,136,"VOX",1477
46,"46031",10521,7735,7607,62,128,"VOX",749
28,"28136",680,569,563,0,6,"VOX",125
18,"18010",532,420,416,2,4,"VOX",43
10,"10207",464,349,340,3,9,"VOX",31
9,"9114",76,63,63,0,0,"VOX",6
15,"15061",5199,3694,3601,40,93,"VOX",146
32,"32079",1287,1016,1006,6,10,"VOX",43
18,"18048",2462,1873,1832,16,41,"VOX",270
48,"48062",293,247,245,0,2,"VOX",0
37,"37152",402,308,302,1,6,"VOX",39
39,"39094",841,676,670,3,6,"VOX",62
17,"17202",3813,2876,2851,8,25,"VOX",53
29,"29079",2335,1796,1765,7,31,"VOX",135
3,"3123",7576,5900,5814,36,86,"VOX",737
28,"28138",63,49,49,0,0,"VOX",5
16,"16198",1299,1044,1027,11,17,"VOX",145
46,"46049",268,231,228,1,3,"VOX",20
3,"3120",2421,1823,1786,9,37,"VOX",248
9,"9337",114,93,93,0,0,"VOX",16
34,"34092",260,210,206,0,4,"VOX",18
25,"25243",3730,2637,2606,20,31,"VOX",182
9,"9017",90,72,70,2,2,"VOX",6
31,"31090",141,86,86,0,0,"VOX",4
47,"47018",36,31,29,0,2,"VOX",7
50,"50019",64,48,47,0,1,"VOX",11
33,"33038",2234,1669,1644,16,25,"VOX",152
40,"40036",502,413,406,11,7,"VOX",83
49,"49084",268,226,223,9,3,"VOX",37
17,"17042",408,313,311,0,2,"VOX",7
33,"33025",8996,6369,6309,81,60,"VOX",672
37,"37302",262,182,181,2,1,"VOX",31
46,"46115",352,261,260,0,1,"VOX",49
17,"17159",626,487,483,1,4,"VOX",13
43,"43167",384,334,333,2,1,"VOX",11
31,"31083",50,41,41,1,0,"VOX",1
4,"4904",1879,1328,1322,4,6,"VOX",445
17,"17027",2866,2375,2364,8,11,"VOX",20
25,"25099",1291,981,978,2,3,"VOX",11
50,"50177",276,226,223,0,3,"VOX",25
13,"13079",12265,9441,9218,123,223,"VOX",1247
13,"13033",1560,1278,1262,9,16,"VOX",181
47,"47040",61,45,44,0,1,"VOX",4
12,"12901",3357,2693,2675,19,18,"VOX",324
49,"49061",145,111,108,0,3,"VOX",9
45,"45115",2586,2158,2114,8,44,"VOX",430
16,"16001",64,51,51,0,0,"VOX",3
27,"27045",944,700,698,13,2,"VOX",27
5,"5902",293,246,242,1,4,"VOX",30
35,"35001",4571,3523,3463,8,60,"VOX",123
37,"37312",244,198,197,1,1,"VOX",25
37,"37278",789,618,613,8,5,"VOX",100
26,"26175",47,40,40,2,0,"VOX",3
18,"18178",671,535,532,0,3,"VOX",33
37,"37286",203,147,142,2,5,"VOX",8
11,"11026",4695,3656,3564,18,92,"VOX",484
5,"5106",28,22,22,0,0,"VOX",5
17,"17069",364,286,284,2,2,"VOX",6
36,"36052",7234,5292,5151,44,141,"VOX",246
26,"26158",246,207,206,2,1,"VOX",20
5,"5025",82,70,70,0,0,"VOX",11
50,"50289",51,40,38,1,2,"VOX",2
22,"22244",46,37,37,2,0,"VOX",3
9,"9283",44,33,33,0,0,"VOX",7
50,"50160",2150,1652,1619,14,33,"VOX",149
49,"49130",158,131,131,5,0,"VOX",12
46,"46083",15374,11259,11096,56,163,"VOX",1498
17,"17148",1531,1165,1153,4,12,"VOX",35
50,"50280",301,246,240,1,6,"VOX",12
37,"37304",159,105,105,0,0,"VOX",7
36,"36043",4682,3345,3303,17,42,"VOX",189
26,"26067",20,19,19,0,0,"VOX",2
50,"50193",663,536,516,1,20,"VOX",59
37,"37065",271,187,184,0,3,"VOX",16
43,"43153",11092,8327,8291,34,36,"VOX",381
35,"35019",32841,21136,20850,125,286,"VOX",1672
18,"18174",434,362,357,0,5,"VOX",52
48,"48915",347,259,259,4,0,"VOX",0
49,"49192",124,102,102,2,0,"VOX",12
16,"16148",546,481,479,1,2,"VOX",51
34,"34063",87,77,77,1,0,"VOX",7
46,"46213",15504,11420,11232,124,188,"VOX",1716
50,"50014",119,85,85,0,0,"VOX",6
36,"36054",11074,8032,7873,77,159,"VOX",357
9,"9418",73,58,55,2,3,"VOX",14
33,"33033",9439,6565,6468,78,97,"VOX",638
20,"20063",8061,6042,5999,36,43,"VOX",36
12,"12112",110,97,96,1,1,"VOX",13
20,"20077",5254,4083,4059,22,24,"VOX",21
10,"10149",434,308,304,2,4,"VOX",24
16,"16013",26,21,20,0,1,"VOX",1
9,"9384",295,222,216,1,6,"VOX",41
30,"30027",49767,39111,38724,245,387,"VOX",7282
28,"28166",347,287,286,1,1,"VOX",44
44,"44157",64,38,38,1,0,"VOX",4
49,"49133",291,213,211,0,2,"VOX",27
28,"28008",1961,1477,1456,6,21,"VOX",280
13,"13019",5095,3758,3717,25,41,"VOX",426
45,"45199",3107,2221,2184,8,37,"VOX",462
47,"47195",430,335,320,2,15,"VOX",43
16,"16216",278,243,240,0,3,"VOX",27
36,"36032",3537,2676,2626,16,50,"VOX",118
10,"10087",1606,1239,1223,5,16,"VOX",148
18,"18039",3382,2517,2490,20,27,"VOX",356
39,"39048",1765,1429,1420,4,9,"VOX",144
16,"16024",123,96,95,0,1,"VOX",3
9,"9329",117,90,89,8,1,"VOX",7
47,"47021",72,63,63,0,0,"VOX",11
19,"19250",15,13,13,0,0,"VOX",1
36,"36020",2184,1621,1599,13,22,"VOX",70
24,"24064",1515,1159,1141,11,18,"VOX",82
34,"34072",143,130,128,1,2,"VOX",24
50,"50024",556,427,426,6,1,"VOX",41
9,"9432",174,145,137,0,8,"VOX",7
44,"44143",394,327,327,2,0,"VOX",53
45,"45165",62598,47784,47120,345,664,"VOX",8044
4,"4075",5427,3989,3961,15,28,"VOX",617
10,"10201",179,157,156,1,1,"VOX",16
16,"16023",507,401,398,2,3,"VOX",50
30,"30014",1585,1226,1202,3,24,"VOX",186
14,"14052",9080,5999,5909,63,90,"VOX",783
46,"46119",752,627,614,8,13,"VOX",29
19,"19119",75,68,66,2,2,"VOX",9
34,"34009",30,26,26,0,0,"VOX",1
48,"48905",2490,1911,1891,16,20,"VOX",27
13,"13054",4914,3946,3890,31,56,"VOX",424
5,"5204",583,486,482,4,4,"VOX",57
9,"9269",29,25,23,1,2,"VOX",3
17,"17065",324,254,253,0,1,"VOX",2
26,"26122",116,98,97,0,1,"VOX",12
8,"8094",1586,1310,1306,10,4,"VOX",28
10,"10156",100,78,78,0,0,"VOX",3
13,"13045",616,482,479,4,3,"VOX",68
9,"9194",1969,1526,1511,14,15,"VOX",130
48,"48056",989,791,785,4,6,"VOX",6
42,"42023",60,49,48,0,1,"VOX",7
24,"24139",2087,1558,1540,20,18,"VOX",213
45,"45189",616,506,498,2,8,"VOX",100
19,"19308",60,57,57,1,0,"VOX",8
5,"5221",323,249,244,1,5,"VOX",20
11,"11035",13715,9510,9385,128,125,"VOX",1313
44,"44145",972,741,732,11,9,"VOX",71
16,"16085",135,109,109,1,0,"VOX",14
14,"14059",687,571,563,7,8,"VOX",76
48,"48092",869,676,674,9,2,"VOX",10
49,"49013",229,176,175,4,1,"VOX",27
15,"15019",26006,18323,18075,280,248,"VOX",871
40,"40060",68,46,46,0,0,"VOX",5
17,"17049",3204,2634,2615,9,19,"VOX",47
27,"27023",2470,1833,1797,20,36,"VOX",86
28,"28122",570,457,448,3,9,"VOX",112
11,"11902",3656,2427,2383,29,44,"VOX",293
9,"9070",33,28,25,0,3,"VOX",0
28,"28168",1329,976,969,3,7,"VOX",196
19,"19031",10,8,8,0,0,"VOX",0
18,"18116",2853,2265,2233,15,32,"VOX",221
39,"39018",4272,3533,3476,17,57,"VOX",351
19,"19165",41,36,36,0,0,"VOX",5
40,"40035",135,111,110,0,1,"VOX",20
50,"50215",20,18,18,0,0,"VOX",1
47,"47070",30,26,25,0,1,"VOX",7
19,"19088",95,82,82,2,0,"VOX",23
44,"44226",124,87,83,2,4,"VOX",7
10,"10094",228,180,180,0,0,"VOX",19
5,"5252",58,38,38,0,0,"VOX",5
29,"29048",1370,1149,1135,10,14,"VOX",25
20,"20006",254,169,169,0,0,"VOX",0
10,"10053",279,226,224,5,2,"VOX",11
17,"17149",364,314,314,0,0,"VOX",3
26,"26020",454,347,337,4,10,"VOX",25
50,"50141",109,90,90,1,0,"VOX",6
50,"50262",1163,930,912,15,18,"VOX",71
46,"46012",929,727,707,3,20,"VOX",74
16,"16130",536,445,444,0,1,"VOX",60
16,"16158",511,428,417,4,11,"VOX",52
41,"41067",7227,5367,5271,56,96,"VOX",568
9,"9020",237,184,180,5,4,"VOX",10
17,"17158",468,337,336,1,1,"VOX",49
46,"46070",17700,13558,13437,115,121,"VOX",2298
19,"19161",211,165,163,2,2,"VOX",26
32,"32008",8572,6301,6216,65,85,"VOX",387
4,"4096",281,239,237,1,2,"VOX",32
17,"17196",242,198,198,1,0,"VOX",4
18,"18017",18148,12712,12523,96,189,"VOX",1928
26,"26163",124,106,104,1,2,"VOX",12
16,"16004",227,193,191,0,2,"VOX",20
45,"45150",414,326,320,2,6,"VOX",28
33,"33021",4361,3098,3043,31,55,"VOX",307
15,"15074",3919,2865,2808,33,57,"VOX",162
13,"13098",1983,1537,1485,22,52,"VOX",245
17,"17093",922,716,715,2,1,"VOX",18
42,"42182",51,42,42,1,0,"VOX",1
47,"47006",186,153,149,1,4,"VOX",20
16,"16132",34,26,26,0,0,"VOX",3
28,"28045",35264,27864,27597,180,267,"VOX",4275
17,"17210",580,449,445,2,4,"VOX",5
48,"48058",946,724,715,3,9,"VOX",5
25,"25906",210,157,155,0,2,"VOX",1
10,"10199",159,123,123,1,0,"VOX",25
42,"42014",60,44,44,1,0,"VOX",6
33,"33052",704,520,513,5,7,"VOX",65
33,"33029",323,172,170,2,2,"VOX",7
9,"9356",43,36,36,0,0,"VOX",0
34,"34089",140,119,114,2,5,"VOX",16
41,"41042",5849,4730,4692,20,38,"VOX",267
16,"16166",239,176,174,3,2,"VOX",27
47,"47172",135,119,119,0,0,"VOX",21
22,"22087",58,47,47,0,0,"VOX",12
47,"47089",132,116,115,1,1,"VOX",19
13,"13095",72,60,60,1,0,"VOX",16
17,"17182",272,220,220,3,0,"VOX",14
19,"19249",28,28,28,0,0,"VOX",2
47,"47041",153,119,116,2,3,"VOX",21
48,"48009",772,628,622,2,6,"VOX",4
25,"25121",635,436,429,1,7,"VOX",21
12,"12902",2248,1678,1653,7,25,"VOX",221
48,"48059",400,329,325,0,4,"VOX",0
10,"10172",696,517,513,0,4,"VOX",70
37,"37158",233,168,166,0,2,"VOX",17
34,"34218",445,352,345,2,7,"VOX",87
13,"13030",120,97,96,0,1,"VOX",24
50,"50255",197,162,160,2,2,"VOX",5
44,"44266",102,89,86,1,3,"VOX",4
22,"22015",300,232,226,5,6,"VOX",20
42,"42081",136,95,93,0,2,"VOX",12
26,"26089",111800,87863,86778,700,1085,"VOX",7652
49,"49028",105,94,93,1,1,"VOX",14
50,"50005",239,204,201,2,3,"VOX",38
28,"28057",1549,1246,1239,5,7,"VOX",240
49,"49081",1322,1051,1030,11,21,"VOX",126
24,"24074",96,73,73,0,0,"VOX",11
13,"13078",8936,6820,6733,46,87,"VOX",1168
34,"34048",63,54,53,2,1,"VOX",11
31,"31123",617,392,388,3,4,"VOX",7
48,"48051",216,157,157,0,0,"VOX",6
47,"47096",126,106,105,0,1,"VOX",17
22,"22218",40,32,31,1,1,"VOX",3
49,"49077",159,104,103,0,1,"VOX",10
24,"24178",72,65,65,1,0,"VOX",3
50,"50288",3444,2689,2668,24,21,"VOX",517
40,"40007",68,58,58,0,0,"VOX",4
26,"26095",95,78,78,1,0,"VOX",1
6,"6066",1725,1297,1286,9,11,"VOX",96
33,"33063",374,284,283,3,1,"VOX",18
5,"5074",665,571,565,2,6,"VOX",65
7,"7041",2097,1662,1634,20,28,"VOX",142
49,"49189",192,132,128,1,4,"VOX",18
16,"16903",996,816,806,9,10,"VOX",170
36,"36026",19924,14342,14132,171,210,"VOX",839
32,"32032",7932,5956,5831,55,125,"VOX",404
33,"33003",612,373,369,6,4,"VOX",55
5,"5232",106,87,84,1,3,"VOX",16
42,"42157",10,10,10,0,0,"VOX",1
38,"38014",1341,991,981,6,10,"VOX",35
43,"43119",838,630,628,4,2,"VOX",17
9,"9358",248,186,179,1,7,"VOX",18
46,"46032",5692,4518,4476,22,42,"VOX",440
11,"11022",48682,28113,27794,294,319,"VOX",4212
49,"49269",220,163,162,1,1,"VOX",10
3,"3071",3988,3125,3088,28,37,"VOX",170
28,"28032",5042,4039,3992,23,47,"VOX",742
5,"5069",74,63,62,0,1,"VOX",9
36,"36023",8279,6187,6085,46,102,"VOX",267
44,"44167",39,30,30,0,0,"VOX",3
25,"25232",1356,1066,1061,2,5,"VOX",18
46,"46024",444,339,335,1,4,"VOX",51
3,"3039",89,70,70,0,0,"VOX",10
17,"17125",131,98,97,1,1,"VOX",0
47,"47066",1407,1131,1122,11,9,"VOX",215
47,"47036",205,162,157,1,5,"VOX",34
45,"45017",260,218,213,1,5,"VOX",15
16,"16089",377,308,308,1,0,"VOX",52
15,"15071",7805,5476,5401,62,75,"VOX",230
47,"47142",124,94,92,0,2,"VOX",26
5,"5119",24,16,16,1,0,"VOX",0
19,"19003",29,28,28,2,0,"VOX",1
46,"46106",1466,1156,1142,3,14,"VOX",117
13,"13002",1419,1021,995,5,26,"VOX",174
14,"14046",4443,3550,3486,38,64,"VOX",215
33,"33013",429,320,316,1,4,"VOX",43
47,"47124",388,322,319,2,3,"VOX",43
6,"6118",157,125,125,1,0,"VOX",3
37,"37261",217,166,163,0,3,"VOX",24
32,"32004",1671,907,899,7,8,"VOX",37
28,"28144",6423,5274,5222,35,52,"VOX",959
17,"17157",124,107,107,0,0,"VOX",1
16,"16079",26,17,17,0,0,"VOX",4
5,"5211",430,364,357,6,7,"VOX",40
37,"37284",314,241,237,2,4,"VOX",26
49,"49171",610,477,473,8,4,"VOX",42
37,"37052",278,201,199,2,2,"VOX",12
34,"34161",22,17,16,0,1,"VOX",4
21,"21030",1879,1523,1504,14,19,"VOX",190
46,"46197",1926,1473,1455,9,18,"VOX",111
43,"43113",397,325,323,2,2,"VOX",19
15,"15070",8797,6312,6173,108,139,"VOX",240
31,"31188",296,200,197,0,3,"VOX",17
36,"36057",238171,181891,180030,1636,1861,"VOX",8384
17,"17170",180,147,147,2,0,"VOX",0
10,"10104",5151,3862,3782,22,80,"VOX",479
9,"9216",374,283,281,2,2,"VOX",34
16,"16153",936,786,768,7,18,"VOX",51
15,"15072",9436,6962,6860,60,102,"VOX",334
40,"40021",19,18,18,0,0,"VOX",2
44,"44041",58,48,44,1,4,"VOX",6
18,"18119",1712,1352,1317,11,35,"VOX",150
24,"24176",299,243,238,3,5,"VOX",27
8,"8263",21151,16360,16269,116,91,"VOX",807
37,"37336",52,46,45,3,1,"VOX",1
47,"47043",309,276,273,1,3,"VOX",25
36,"36010",2828,2217,2184,15,33,"VOX",55
33,"33055",1492,1156,1121,6,35,"VOX",144
19,"19268",43,42,42,0,0,"VOX",3
40,"40201",43,39,37,0,2,"VOX",4
32,"32036",1261,954,938,9,16,"VOX",42
10,"10015",627,488,475,0,13,"VOX",21
23,"23051",2727,2060,2023,5,37,"VOX",199
26,"26115",23,21,19,0,2,"VOX",0
45,"45073",287,226,225,1,1,"VOX",16
17,"17172",457,352,349,1,3,"VOX",6
6,"6049",974,732,712,7,20,"VOX",54
46,"46051",8384,6550,6452,24,98,"VOX",936
27,"27020",3380,2764,2713,32,51,"VOX",80
50,"50042",16,16,16,0,0,"VOX",2
45,"45149",539,448,440,0,8,"VOX",39
31,"31202",4345,3132,3085,36,47,"VOX",163
6,"6104",656,530,524,6,6,"VOX",20
16,"16039",367,263,262,2,1,"VOX",39
47,"47012",101,80,80,0,0,"VOX",13
25,"25046",407,349,347,1,2,"VOX",2
12,"12118",76,64,63,0,1,"VOX",12
22,"22149",308,247,246,3,1,"VOX",20
11,"11012",97629,73036,72347,715,689,"VOX",6079
49,"49172",481,316,310,2,6,"VOX",27
44,"44192",349,288,284,1,4,"VOX",40
31,"31003",117,97,97,1,0,"VOX",1
14,"14056",23513,17065,16684,147,381,"VOX",1912
50,"50033",65,50,50,1,0,"VOX",1
46,"46210",344,265,258,2,7,"VOX",22
17,"17201",143,120,120,0,0,"VOX",1
44,"44225",103,82,81,0,1,"VOX",10
24,"24010",8268,5968,5847,66,121,"VOX",919
21,"21059",220,184,180,0,4,"VOX",2
46,"46013",17712,14181,14075,88,106,"VOX",1758
45,"45181",2337,1846,1818,7,28,"VOX",260
39,"39065",232,190,189,5,1,"VOX",27
16,"16103",239,203,203,0,0,"VOX",39
27,"27057",11097,7917,7735,88,182,"VOX",577
17,"17136",195,156,155,0,1,"VOX",3
45,"45166",1564,1298,1279,6,19,"VOX",93
34,"34217",1251,1053,1042,7,11,"VOX",202
43,"43177",284,243,242,0,1,"VOX",9
50,"50219",4283,3274,3213,53,61,"VOX",599
10,"10143",141,118,113,1,5,"VOX",5
43,"43138",2648,1926,1896,8,30,"VOX",105
9,"9400",310,250,247,4,3,"VOX",11
45,"45091",374,275,274,1,1,"VOX",33
6,"6125",1679,1348,1324,5,24,"VOX",159
49,"49268",368,282,279,2,3,"VOX",39
28,"28155",485,414,409,0,5,"VOX",51
16,"16265",20,20,19,0,1,"VOX",0
14,"14062",963,753,745,4,8,"VOX",56
10,"10189",2527,1958,1907,12,51,"VOX",194
31,"31055",263,199,197,3,2,"VOX",0
23,"23064",1678,1413,1404,10,9,"VOX",174
5,"5236",106,77,77,0,0,"VOX",3
10,"10029",380,320,315,1,5,"VOX",33
9,"9029",144,120,118,3,2,"VOX",18
16,"16104",55,46,46,0,0,"VOX",13
50,"50037",127,93,93,0,0,"VOX",25
47,"47024",232,189,188,0,1,"VOX",14
2,"2052",466,394,394,3,0,"VOX",66
17,"17083",2961,2321,2300,12,21,"VOX",46
16,"16161",52,47,47,0,0,"VOX",1
16,"16160",60,44,43,1,1,"VOX",10
9,"9215",365,267,264,1,3,"VOX",35
20,"20076",7025,5263,5237,31,26,"VOX",54
8,"8194",25674,17691,17585,115,106,"VOX",920
43,"43907",4359,3370,3346,22,24,"VOX",190
26,"26080",453,385,383,2,2,"VOX",34
16,"16279",174,125,125,0,0,"VOX",31
47,"47206",78,64,64,0,0,"VOX",5
9,"9196",135,108,107,0,1,"VOX",6
25,"25075",131,102,102,0,0,"VOX",0
47,"47002",18,18,18,0,0,"VOX",1
4,"4029",8819,6149,6073,45,76,"VOX",1056
48,"48072",970,735,730,1,5,"VOX",1
32,"32028",1550,1176,1171,10,5,"VOX",64
18,"18004",687,521,515,4,6,"VOX",95
20,"20055",17378,12565,12482,55,83,"VOX",106
